,qtr,cur_home_score,cur_away_score,score_differential,week,home_possession
187334,1,7,7,0,16,0
123222,4,13,21,-8,4,0
83603,4,3,17,-14,4,1
74131,4,23,6,17,17,1
260554,4,27,8,19,14,1
334204,1,0,0,0,13,1
111767,1,3,7,-4,17,1
32104,3,21,13,8,15,0
75892,3,21,7,14,1,0
252407,1,0,0,0,10,1
300478,2,16,0,16,14,0
221308,4,6,32,-26,14,0
319925,2,16,7,9,6,1
367928,1,0,7,-7,11,1
139476,4,27,10,17,12,1
50369,1,0,0,0,6,1
328140,2,6,7,-1,10,1
175646,1,3,0,3,11,1
257297,1,0,0,0,13,0
29577,2,7,13,-6,14,0
222284,1,0,0,0,14,0
265030,2,7,3,4,16,1
282117,3,16,8,8,6,1
347149,3,16,10,6,1,1
299918,4,16,11,5,14,0
360532,1,0,7,-7,7,0
89970,2,2,14,-12,7,0
181783,4,10,17,-7,13,0
33939,2,0,27,-27,16,1
258990,2,3,16,-13,13,0
409817,2,10,0,10,12,0
3203,4,16,9,7,2,0
62999,2,6,14,-8,12,1
156400,4,38,20,18,2,1
136489,4,17,13,4,11,1
227169,3,10,7,3,16,1
29474,3,10,14,-4,14,1
108909,5,17,17,0,15,0
303424,2,10,7,3,16,1
398039,2,14,14,0,7,0
234569,1,0,0,0,2,1
236704,4,24,7,17,3,0
178469,2,10,3,7,12,1
33572,4,17,10,7,16,1
179851,2,3,9,-6,13,1
96752,3,0,10,-10,10,1
254134,2,3,9,-6,11,1
141124,1,0,7,-7,13,1
259687,1,0,0,0,14,1
377227,2,7,0,7,15,1
225171,2,3,6,-3,15,0
196922,1,0,0,0,3,1
146930,1,7,0,7,15,0
105338,2,7,7,0,14,0
388829,4,14,17,-3,3,1
138253,4,10,12,-2,11,1
35753,2,3,0,3,17,1
108917,1,0,0,0,15,1
344616,1,0,3,-3,17,0
271416,2,7,0,7,1,1
87770,4,6,20,-14,6,1
363312,4,33,14,19,8,1
93717,2,0,3,-3,9,1
8442,2,9,0,9,4,0
110046,4,48,10,38,16,0
370106,1,7,0,7,12,1
71756,3,24,23,1,16,0
37132,4,16,20,-4,17,1
388803,3,14,7,7,3,0
262091,1,7,3,4,15,1
135588,4,28,6,22,10,1
207513,4,31,21,10,7,1
301984,4,27,20,7,15,0
248011,2,21,3,18,8,0
314652,3,7,14,-7,3,1
418525,1,0,0,0,16,0
202048,1,0,0,0,5,0
247335,4,42,48,-6,8,1
141946,2,10,6,4,13,0
201675,3,10,20,-10,5,1
311933,3,21,10,11,2,1
407455,4,14,10,4,11,0
407864,2,6,7,-1,11,0
387173,4,10,41,-31,2,1
410073,1,14,7,7,13,1
62880,3,10,3,7,12,0
346625,1,7,3,4,1,1
333818,3,14,14,0,12,0
113896,2,10,3,7,17,0
251671,2,6,3,3,10,0
337444,1,0,6,-6,14,0
52644,2,3,7,-4,7,0
396323,4,6,13,-7,6,0
239805,1,0,0,0,4,1
343300,1,0,9,-9,16,0
66172,2,17,0,17,13,0
42503,3,10,12,-2,3,0
115639,1,0,0,0,1,1
103303,1,0,0,0,13,0
70314,3,10,17,-7,15,0
239449,3,9,17,-8,4,1
121997,3,16,7,9,4,0
173392,1,0,0,0,10,0
297205,2,0,3,-3,13,0
264937,3,20,17,3,16,1
240910,2,14,3,11,5,1
103171,1,0,0,0,13,1
195755,1,0,0,0,2,1
396029,4,38,20,18,6,1
198868,1,0,6,-6,3,0
19224,4,27,19,8,10,1
283394,1,13,7,6,7,0
281474,2,7,10,-3,6,0
381540,3,21,13,8,17,0
337580,1,7,0,7,14,0
62851,2,3,3,0,12,0
198921,2,6,16,-10,3,1
151427,1,14,0,14,17,0
407087,2,0,13,-13,11,0
121314,1,0,0,0,3,0
266065,2,10,3,7,16,1
49594,4,28,10,18,6,0
217396,1,0,0,0,12,0
212245,1,0,0,0,10,0
409478,1,0,0,0,12,1
380547,3,14,17,-3,16,0
158951,3,14,15,-1,3,0
408588,2,14,0,14,12,0
231670,4,24,16,8,1,0
5132,4,13,7,6,3,1
326867,4,10,20,-10,9,1
308849,3,10,10,0,1,0
194013,2,14,7,7,1,0
306920,3,6,30,-24,17,1
214549,1,0,0,0,11,1
372436,2,6,7,-1,13,0
67121,1,0,0,0,14,1
354538,4,33,31,2,4,1
96222,4,3,22,-19,10,1
69828,2,14,3,11,15,0
18337,4,22,17,5,9,1
237889,4,7,27,-20,4,1
88530,4,19,14,5,6,0
81697,2,14,17,-3,3,0
413996,3,3,31,-28,14,1
381039,2,7,6,1,16,1
114662,3,3,10,-7,1,1
191353,2,0,14,-14,17,0
3029,4,20,34,-14,2,1
224836,4,11,16,-5,15,1
43137,1,0,0,0,3,0
280152,3,28,0,28,5,0
155632,1,0,0,0,2,1
219002,2,14,0,14,13,0
276460,1,10,7,3,4,1
408439,2,0,0,0,12,1
21826,1,0,0,0,11,0
249049,2,21,16,5,9,0
75617,3,7,6,1,17,1
93511,4,3,31,-28,9,1
252115,2,7,10,-3,10,1
242148,2,13,7,6,6,0
18447,3,7,7,0,9,0
35510,3,27,7,20,17,1
64976,1,0,7,-7,13,1
290562,4,23,20,3,10,0
223296,4,3,12,-9,15,1
331581,2,17,20,-3,11,0
403053,4,24,24,0,9,0
275952,4,20,18,2,3,0
180674,4,24,6,18,13,1
376189,2,7,7,0,14,1
64388,1,0,3,-3,13,0
71268,1,7,0,7,16,0
380918,2,3,0,3,16,1
239940,1,0,0,0,5,1
227885,2,17,6,11,16,1
16647,3,7,27,-20,8,1
84044,4,30,22,8,4,1
132841,2,3,7,-4,9,0
64421,2,0,6,-6,13,1
272425,3,31,10,21,2,1
269847,4,22,10,12,1,0
108515,2,14,7,7,15,0
287056,3,26,24,2,8,0
160969,3,10,7,3,4,1
30141,2,10,10,0,14,1
46268,4,24,31,-7,4,0
29765,4,41,3,38,14,0
111483,1,7,0,7,16,0
185051,1,0,3,-3,15,1
350387,4,31,20,11,2,1
405690,1,3,0,3,10,1
11556,4,6,10,-4,6,1
72101,4,10,17,-7,16,1
65067,4,6,17,-11,13,1
152373,3,21,3,18,17,1
160637,2,7,0,7,4,0
418827,1,0,3,-3,16,1
28736,4,10,16,-6,14,1
196378,2,10,0,10,2,1
49386,3,10,17,-7,6,0
11186,1,0,0,0,6,0
394375,4,31,17,14,5,0
350540,1,7,0,7,2,0
250742,1,3,0,3,10,1
56372,1,0,0,0,9,1
78614,4,23,13,10,2,1
314024,2,3,0,3,3,1
386709,4,17,19,-2,2,1
195650,2,7,7,0,2,0
199939,1,3,10,-7,4,1
201261,1,0,0,0,5,1
44974,1,3,0,3,4,0
108888,4,17,17,0,15,1
14325,3,2,7,-5,7,1
251857,3,14,13,1,10,0
401182,4,51,13,38,8,1
279887,4,24,13,11,5,1
100219,3,17,0,17,12,0
39188,4,34,24,10,1,1
318133,3,9,10,-1,5,1
289453,2,3,7,-4,10,1
139705,3,7,7,0,12,1
242843,1,7,0,7,6,0
281726,4,38,38,0,6,1
16081,2,30,7,23,8,0
68627,1,7,0,7,15,1
152337,2,7,3,4,17,0
212563,1,7,3,4,10,0
397461,3,13,13,0,6,0
269865,4,22,10,12,1,1
192045,4,24,27,-3,1,1
68018,2,0,10,-10,14,1
370620,3,14,14,0,12,0
37785,3,7,9,-2,1,0
399653,3,16,6,10,8,0
414937,1,0,7,-7,15,1
373958,2,7,0,7,13,1
365833,1,6,0,6,9,1
312536,3,23,0,23,3,1
3244,1,0,0,0,2,1
13387,1,0,0,0,7,0
137905,3,24,8,16,11,0
202853,2,7,0,7,5,1
211213,3,14,17,-3,9,0
349848,1,3,3,0,2,0
240946,3,14,9,5,5,1
218582,2,7,17,-10,13,0
182425,1,7,0,7,14,1
205653,2,14,9,5,7,0
54195,2,0,3,-3,8,0
11208,2,7,14,-7,6,0
352795,2,14,0,14,3,0
371028,2,7,10,-3,12,1
395174,2,10,7,3,5,0
228173,2,7,20,-13,17,0
287861,4,28,20,8,9,0
37433,1,0,0,0,17,0
145034,3,13,6,7,14,0
92098,2,3,10,-7,8,0
122751,4,10,23,-13,4,0
78200,4,41,3,38,2,1
336932,4,14,21,-7,14,0
45284,2,7,7,0,4,0
28849,3,16,7,9,14,1
311353,2,21,10,11,2,0
31651,3,24,9,15,15,1
369689,2,16,10,6,11,0
129419,3,22,13,9,7,1
170031,4,35,17,18,8,0
24427,4,16,7,9,12,0
366302,4,28,10,18,10,0
173355,4,28,27,1,10,1
382217,2,10,3,7,17,1
381104,3,24,21,3,16,0
292979,4,10,14,-4,11,1
99354,3,23,9,14,11,0
310936,3,3,16,-13,2,1
192597,2,3,7,-4,1,1
98870,2,7,7,0,11,0
68431,4,3,21,-18,14,1
79199,3,20,10,10,2,0
274975,1,7,0,7,3,0
273471,2,7,13,-6,2,0
121780,1,0,0,0,4,1
53340,1,3,0,3,8,0
403394,1,0,0,0,9,1
264083,2,10,20,-10,15,0
413416,2,3,31,-28,14,1
380026,2,21,7,14,16,0
51627,3,21,20,1,7,1
331245,1,0,0,0,11,0
253175,1,0,0,0,11,1
42824,3,6,31,-25,3,0
286962,4,26,19,7,8,0
328537,4,15,3,12,10,1
152266,4,21,0,21,17,0
195928,2,0,17,-17,2,0
109908,4,23,0,23,16,0
210857,1,0,3,-3,9,1
414675,2,3,7,-4,14,1
265295,1,0,0,0,16,1
123960,3,10,0,10,5,0
164891,2,0,3,-3,6,0
356610,5,9,9,0,5,1
302223,3,28,13,15,15,1
142855,1,0,0,0,13,1
347877,1,0,0,0,1,1
226038,1,0,0,0,16,1
235434,3,28,25,3,3,1
156570,1,0,0,0,2,1
175545,2,20,0,20,11,0
216382,3,14,23,-9,12,1
57283,1,0,0,0,10,1
405461,3,24,10,14,10,0
140648,3,38,10,28,12,0
308880,4,10,19,-9,1,0
44369,1,0,0,0,3,1
230963,1,0,0,0,1,0
341951,2,6,0,6,16,0
236306,2,0,9,-9,3,0
162468,1,7,3,4,4,1
371357,4,42,10,32,12,0
321028,3,10,7,3,6,1
255418,4,24,6,18,12,0
346789,1,3,0,3,1,1
352326,1,0,0,0,3,1
393871,3,13,17,-4,5,0
52722,4,6,23,-17,7,1
22822,4,13,21,-8,11,0
288404,3,10,0,10,9,1
254065,4,14,23,-9,11,0
271710,2,13,10,3,2,0
201398,4,28,29,-1,5,1
381927,1,0,7,-7,17,0
274226,2,17,0,17,3,0
98175,4,21,19,2,11,1
5190,1,7,3,4,3,0
14191,3,0,31,-31,7,0
387860,2,10,28,-18,2,1
3810,4,23,10,13,2,1
67694,1,7,0,7,14,0
272405,3,24,3,21,2,0
238219,3,3,16,-13,4,1
90279,2,0,14,-14,7,1
372027,3,13,3,10,13,1
66598,2,0,14,-14,14,0
288265,3,10,34,-24,9,0
42726,4,7,20,-13,3,1
364311,4,3,32,-29,9,1
2062,1,0,7,-7,1,1
238044,4,10,13,-3,4,1
22183,3,10,15,-5,11,0
186523,4,17,33,-16,15,1
132276,3,21,7,14,9,1
335330,4,3,23,-20,13,1
25980,2,10,9,1,13,1
146407,3,13,3,10,15,0
13629,3,13,10,3,7,0
140376,4,17,29,-12,12,1
113777,3,10,17,-7,17,1
165082,3,10,24,-14,6,0
200443,3,13,18,-5,4,1
343866,4,24,6,18,17,0
138517,4,31,30,1,12,1
186459,2,10,10,0,15,0
104142,3,24,27,-3,13,0
98253,2,7,24,-17,11,1
97020,1,10,0,10,10,1
300181,3,21,3,18,14,0
5629,2,0,14,-14,3,0
293313,1,0,0,0,11,0
211704,3,23,16,7,9,1
325048,3,26,24,2,8,0
307660,3,14,17,-3,17,0
244045,2,20,17,3,6,0
210139,2,0,0,0,9,1
351817,2,20,14,6,3,1
282303,4,28,17,11,6,1
301345,3,17,7,10,15,1
343621,2,15,7,8,17,1
295438,4,10,13,-3,12,1
130035,2,10,20,-10,8,0
114190,2,3,0,3,1,0
339913,3,26,0,26,15,1
294611,1,0,0,0,12,0
131761,4,24,28,-4,8,1
75801,4,42,26,16,1,0
64697,2,14,0,14,13,1
401969,2,0,9,-9,9,1
188016,4,23,14,9,16,0
71928,3,15,13,2,16,0
142167,4,2,7,-5,13,0
20616,1,0,0,0,10,1
177170,4,40,13,27,11,0
24584,4,10,23,-13,12,1
222623,2,7,7,0,14,0
134439,2,0,20,-20,10,1
334186,4,37,14,23,13,0
323912,1,7,0,7,8,0
32670,2,7,0,7,15,0
197685,1,6,3,3,3,1
241608,4,6,27,-21,5,1
141104,5,17,17,0,13,0
251270,4,13,24,-11,10,0
168842,2,14,0,14,7,0
218704,1,0,0,0,13,0
288783,1,0,7,-7,9,1
298047,1,0,14,-14,13,1
88888,1,9,0,9,6,1
416824,4,19,10,9,15,0
173405,1,0,0,0,10,1
23264,1,0,0,0,11,0
46588,2,3,0,3,4,1
281636,2,21,3,18,6,1
74903,4,23,20,3,17,1
332774,3,28,9,19,12,1
51098,1,0,0,0,7,1
43098,4,3,17,-14,3,1
231192,3,10,7,3,1,1
128599,1,3,0,3,7,0
317371,3,0,3,-3,5,1
235635,1,0,0,0,3,0
371380,1,0,0,0,12,0
214117,2,3,6,-3,11,1
252130,2,7,10,-3,10,1
67285,1,7,0,7,14,1
403168,2,10,14,-4,9,1
301762,2,0,24,-24,15,1
38157,1,0,0,0,1,1
169114,4,39,30,9,7,1
419907,3,6,18,-12,17,1
158978,3,21,29,-8,3,1
115553,2,3,3,0,1,1
407565,2,10,9,1,11,1
264496,1,0,0,0,16,0
34344,4,23,9,14,16,0
421487,2,0,3,-3,17,0
28879,4,23,10,13,14,1
95938,1,0,0,0,10,1
316643,4,12,12,0,4,0
400995,4,22,7,15,8,0
315925,1,0,0,0,4,0
252346,3,0,22,-22,10,1
173887,2,6,10,-4,10,1
403223,4,24,17,7,9,0
53247,2,3,0,3,8,0
188968,1,0,0,0,16,0
117770,2,3,6,-3,2,1
167604,1,0,0,0,7,1
145857,1,0,0,0,15,1
567,4,14,27,-13,1,1
328958,3,16,7,9,10,1
146848,3,24,0,24,15,1
291988,2,0,3,-3,11,1
232123,1,0,0,0,1,0
179526,2,0,16,-16,12,1
170290,3,0,12,-12,8,1
351262,4,28,17,11,3,0
10351,2,10,35,-25,5,1
169053,3,26,14,12,7,1
283397,2,13,7,6,7,0
319649,2,24,3,21,6,0
103098,3,27,7,20,13,1
145781,3,13,10,3,15,0
5680,3,0,17,-17,3,1
192069,5,34,34,0,1,0
3658,4,20,28,-8,2,0
252085,1,0,0,0,10,0
328986,4,30,7,23,10,1
300110,1,7,0,7,14,0
102979,4,12,38,-26,13,1
209961,1,0,3,-3,8,1
333762,1,6,0,6,12,1
285045,1,0,0,0,7,0
133784,3,13,10,3,9,1
72345,2,0,14,-14,16,0
171706,1,0,0,0,9,0
325196,3,13,20,-7,8,0
308378,2,0,6,-6,1,0
152668,3,17,6,11,17,0
236692,3,17,7,10,3,1
158902,1,14,0,14,3,1
421480,1,0,0,0,17,0
149026,1,0,0,0,16,0
53337,1,0,0,0,8,1
301665,4,10,6,4,15,1
207440,2,14,14,0,7,0
264373,1,0,7,-7,15,1
227301,3,13,20,-7,16,1
96023,3,13,7,6,10,0
80830,3,3,3,0,3,1
183560,3,7,10,-3,14,0
50807,1,0,7,-7,6,0
68012,1,0,10,-10,14,1
10501,2,20,0,20,5,0
117999,3,20,6,14,2,0
172223,2,7,13,-6,9,1
113370,1,0,0,0,17,0
388229,4,14,13,1,2,0
303091,2,0,14,-14,16,1
115568,3,24,3,21,1,1
403019,3,13,21,-8,9,0
247296,3,35,28,7,8,0
87904,3,13,15,-2,6,0
401722,3,16,14,2,8,1
260227,3,10,3,7,14,0
48255,2,3,10,-7,5,1
270433,3,10,7,3,1,1
134539,1,0,0,0,10,0
76815,3,33,0,33,1,0
394774,3,21,0,21,5,0
198780,2,3,6,-3,3,1
107098,4,40,6,34,15,1
413587,3,9,17,-8,14,0
58213,2,0,3,-3,10,0
159965,1,0,0,0,3,0
282383,3,10,20,-10,6,1
156685,3,14,14,0,2,0
320228,2,14,0,14,6,0
16963,3,27,20,7,8,0
141354,2,3,17,-14,13,1
305302,4,42,21,21,16,0
78534,1,3,7,-4,2,1
16536,4,30,13,17,8,0
378285,2,3,3,0,15,0
413061,1,13,7,6,14,0
195505,2,0,0,0,2,1
223327,1,0,0,0,15,0
54285,1,0,0,0,8,1
239215,1,0,0,0,4,0
250730,1,3,0,3,10,0
45586,2,7,13,-6,4,1
136339,4,18,14,4,11,1
393311,4,30,29,1,5,0
190968,3,12,0,12,17,1
316673,5,12,12,0,4,0
54914,2,0,0,0,8,0
303382,1,7,0,7,16,0
63118,1,7,10,-3,12,1
99334,3,20,3,17,11,0
369424,2,24,7,17,11,0
174341,2,17,0,17,10,1
92595,3,17,3,14,8,0
1033,1,7,0,7,1,0
23198,3,23,12,11,11,0
32898,4,26,7,19,15,0
81210,1,0,7,-7,3,0
408725,1,3,7,-4,12,1
313637,4,25,30,-5,3,1
376301,1,0,0,0,14,0
222942,2,13,13,0,14,0
228363,3,7,17,-10,17,0
275811,4,16,3,13,3,0
119264,2,7,3,4,3,1
407884,2,9,10,-1,11,1
381968,2,0,20,-20,17,0
260546,4,27,8,19,14,0
241622,4,6,30,-24,5,1
219156,2,0,3,-3,13,0
172247,3,14,13,1,9,1
48238,2,0,10,-10,5,1
92659,1,0,3,-3,8,1
258948,1,0,7,-7,13,0
413546,2,3,10,-7,14,1
416713,1,0,0,0,15,0
172319,1,0,0,0,9,1
154433,2,14,0,14,1,0
101969,1,0,0,0,12,1
279145,4,21,20,1,5,0
42381,3,14,9,5,2,0
287061,3,26,24,2,8,0
279141,4,21,20,1,5,0
6096,3,7,10,-3,3,1
265116,4,13,10,3,16,0
365825,1,0,0,0,9,0
299023,4,16,18,-2,14,0
366786,1,0,0,0,10,1
204740,2,14,14,0,6,1
94240,4,24,30,-6,9,1
365696,1,7,3,4,9,0
379132,1,6,3,3,16,0
413127,3,33,35,-2,14,0
344863,4,30,10,20,17,0
386560,4,14,24,-10,2,0
37943,3,10,14,-4,1,0
10706,4,17,17,0,5,0
4038,2,10,13,-3,2,0
277912,4,7,20,-13,4,0
32811,2,6,0,6,15,0
342621,4,22,27,-5,16,0
285247,2,0,6,-6,7,1
117457,2,7,7,0,2,1
69650,1,0,0,0,15,0
219202,3,0,3,-3,13,1
30568,2,10,0,10,14,0
116879,2,7,7,0,2,1
211503,3,26,7,19,9,1
25487,1,0,0,0,12,1
365190,4,14,28,-14,9,0
82512,3,10,20,-10,3,1
290059,3,7,6,1,10,1
359102,1,0,0,0,6,1
361507,2,7,7,0,7,1
289811,4,17,17,0,10,1
259193,4,14,25,-11,13,0
133109,1,0,0,0,9,0
61131,3,0,7,-7,11,0
297139,4,31,6,25,13,0
72431,1,7,0,7,16,0
27484,2,17,7,10,13,1
372377,4,24,17,7,13,0
152227,3,21,0,21,17,0
23657,3,7,20,-13,12,1
333003,1,3,3,0,12,1
68827,3,6,14,-8,15,0
215159,2,7,3,4,11,0
235324,4,25,14,11,3,1
176022,3,17,0,17,11,1
333956,2,14,7,7,12,0
357449,4,31,30,1,5,0
389338,2,20,6,14,3,0
408153,2,6,0,6,12,0
195200,2,10,0,10,2,0
338249,3,27,24,3,14,0
418930,4,27,17,10,16,0
230095,1,0,3,-3,17,0
222816,3,10,13,-3,14,1
168627,4,17,16,1,7,1
321096,1,0,3,-3,6,0
357542,3,10,6,4,5,1
258557,2,0,0,0,13,1
328297,2,3,7,-4,10,0
335877,3,28,14,14,13,0
4717,1,0,0,0,3,1
183487,1,0,0,0,14,0
172256,4,21,13,8,9,0
319373,4,23,28,-5,6,0
195635,1,7,7,0,2,1
49941,2,14,0,14,6,1
214320,4,21,10,11,11,0
168524,1,0,0,0,7,0
218513,4,34,17,17,13,1
323540,3,24,16,8,7,0
296824,4,14,7,7,13,0
63664,4,20,36,-16,12,1
229212,1,3,0,3,17,0
357156,4,6,14,-8,5,1
250748,1,3,0,3,10,0
360536,1,0,7,-7,7,1
380620,1,7,0,7,16,0
7158,4,34,21,13,4,0
265716,1,0,0,0,16,1
101503,1,10,0,10,12,0
26762,3,6,27,-21,13,1
174206,3,3,23,-20,10,0
151478,2,28,7,21,17,0
391085,1,7,7,0,4,0
263706,1,0,0,0,15,1
279907,4,24,13,11,5,1
167967,2,0,7,-7,7,0
250269,1,7,0,7,9,0
234893,4,9,19,-10,2,1
232248,4,15,12,3,1,1
263905,2,9,0,9,15,0
101313,4,17,23,-6,12,1
248710,1,3,0,3,9,0
168755,4,13,6,7,7,0
150539,1,0,3,-3,17,1
372992,1,0,0,0,13,0
62795,4,17,0,17,12,1
131154,4,27,12,15,8,0
244878,4,7,10,-3,7,0
240387,5,24,23,1,5,1
308661,1,0,6,-6,1,1
403697,1,3,3,0,9,0
82562,1,0,0,0,3,0
168738,3,10,6,4,7,1
363015,4,33,26,7,8,1
192297,2,24,3,21,1,1
7563,2,7,0,7,4,1
131044,1,0,0,0,8,1
365080,1,0,7,-7,9,1
414404,2,7,17,-10,14,0
185954,1,0,6,-6,15,0
283656,4,23,33,-10,7,1
115237,2,0,3,-3,1,0
243069,2,0,9,-9,6,1
50495,4,20,17,3,6,0
32341,1,14,0,14,15,0
235370,1,14,7,7,3,1
68672,2,10,0,10,15,1
377525,2,0,6,-6,15,1
117302,2,7,0,7,2,1
270246,2,3,21,-18,1,1
106102,1,0,0,0,14,0
150236,4,12,26,-14,16,0
418186,4,24,6,18,16,0
48101,2,7,3,4,5,0
60457,1,0,0,0,11,1
398587,1,0,0,0,7,1
41073,4,3,16,-13,2,0
256023,4,25,12,13,12,0
310942,3,3,16,-13,2,0
59715,1,6,0,6,11,0
355895,3,20,10,10,5,0
274811,1,0,0,0,3,1
239972,2,0,10,-10,5,0
403828,4,18,30,-12,9,1
22377,1,0,0,0,11,0
135542,3,14,6,8,10,0
362817,3,7,21,-14,8,1
165940,1,3,7,-4,6,0
39480,4,13,12,1,1,0
59871,1,0,0,0,11,1
323314,1,0,0,0,7,1
238306,1,3,9,-6,4,0
346311,1,0,3,-3,1,1
246387,4,26,10,16,7,1
77255,3,16,7,9,1,0
363717,3,16,13,3,8,1
229601,4,30,13,17,17,1
227673,1,0,0,0,16,0
216845,2,7,14,-7,12,1
40114,1,6,0,6,2,1
61374,2,7,3,4,11,1
406144,4,3,29,-26,11,1
141182,2,3,21,-18,13,1
188514,1,0,3,-3,16,1
86845,2,9,16,-7,5,0
325392,1,0,0,0,8,0
27569,1,0,0,0,13,1
197737,3,14,10,4,3,0
351619,1,0,7,-7,3,1
153275,3,2,7,-5,1,0
219600,1,3,0,3,13,1
339123,2,10,6,4,15,0
285083,2,3,0,3,7,1
188386,2,3,0,3,16,0
297232,3,7,6,1,13,1
231373,4,9,16,-7,1,0
389256,4,31,7,24,3,0
143255,4,17,16,1,13,0
169874,4,27,17,10,8,0
157128,3,16,20,-4,2,1
1557,3,13,13,0,1,0
275968,4,20,21,-1,3,0
260606,1,0,7,-7,14,0
178907,1,0,3,-3,12,1
108640,1,12,0,12,15,1
89210,2,3,0,3,7,0
403156,2,10,14,-4,9,0
357014,4,26,3,23,5,0
259685,1,0,0,0,14,1
67311,2,14,3,11,14,1
291368,1,7,7,0,10,0
41849,4,28,14,14,2,1
328898,2,6,0,6,10,0
278484,3,36,0,36,4,0
248619,2,14,10,4,9,1
239609,4,20,10,10,4,0
336735,3,10,10,0,14,1
391870,3,13,13,0,4,1
39426,3,10,10,0,1,1
131813,2,7,7,0,8,0
229615,4,33,13,20,17,1
398985,1,0,2,-2,7,1
318829,2,7,6,1,5,1
100191,2,14,0,14,12,1
338162,1,7,7,0,14,1
55796,2,0,7,-7,9,1
114591,1,3,0,3,1,1
390837,2,0,27,-27,3,0
148014,2,7,3,4,15,0
117730,4,34,27,7,2,0
173722,1,0,3,-3,10,1
148025,2,7,3,4,15,0
37547,4,10,10,0,17,1
377473,4,14,13,1,15,1
92521,1,10,0,10,8,0
189488,3,14,0,14,17,1
330903,4,16,31,-15,11,1
356353,3,24,8,16,5,1
177371,2,10,7,3,11,1
10755,2,7,0,7,5,0
240615,2,20,7,13,5,0
363237,2,21,7,14,8,0
337721,1,0,0,0,14,1
121256,4,21,30,-9,3,1
93522,1,0,0,0,9,1
206505,1,0,0,0,7,1
409531,2,7,3,4,12,1
219603,1,3,0,3,13,0
361906,2,0,0,0,7,0
90320,3,14,17,-3,7,0
60691,3,21,3,18,11,1
171541,4,30,10,20,9,1
406202,2,7,10,-3,11,0
125371,4,38,3,35,5,1
110708,1,0,3,-3,16,0
1904,1,0,0,0,1,0
381574,4,35,16,19,17,0
44797,4,16,19,-3,3,1
281851,4,13,6,7,6,0
308097,2,13,13,0,1,0
250324,2,7,7,0,9,0
330330,1,7,3,4,11,0
416523,4,35,17,18,15,1
28289,4,24,14,10,13,1
166312,3,10,9,1,6,0
169753,1,0,7,-7,8,0
139284,3,13,13,0,12,0
284668,4,14,27,-13,7,0
312185,1,0,7,-7,2,1
262966,1,0,0,0,15,1
114790,2,7,17,-10,1,0
282717,4,9,27,-18,6,1
1669,2,7,0,7,1,0
54047,2,10,3,7,8,1
219013,2,14,0,14,13,1
136002,3,3,10,-7,10,0
53287,4,3,7,-4,8,0
300938,4,17,27,-10,15,0
336076,1,0,0,0,13,1
412808,3,21,27,-6,14,0
42784,2,6,21,-15,3,1
240082,4,20,27,-7,5,0
96526,4,17,24,-7,10,0
6456,4,15,20,-5,3,1
282577,4,23,24,-1,6,0
398929,3,10,10,0,7,1
370929,4,20,20,0,12,1
224142,2,0,20,-20,15,1
297975,3,30,7,23,13,1
69781,1,0,0,0,15,1
333834,3,14,21,-7,12,0
27291,1,7,3,4,13,0
336837,1,0,7,-7,14,1
94918,1,0,3,-3,9,0
86549,2,23,3,20,5,0
387714,3,0,16,-16,2,1
254235,1,0,0,0,11,0
319752,1,0,0,0,6,1
377422,3,7,13,-6,15,0
248659,4,24,10,14,9,1
165274,4,17,14,3,6,1
185251,3,17,9,8,15,1
291737,3,0,14,-14,11,1
157503,1,0,0,0,2,0
111434,4,0,20,-20,16,1
69480,4,31,17,14,15,0
366490,1,6,0,6,10,1
357516,2,7,6,1,5,1
41051,3,3,13,-10,2,0
334919,4,30,10,20,13,0
46007,1,7,7,0,4,0
170639,4,47,9,38,8,1
357432,3,31,24,7,5,0
22225,4,18,15,3,11,0
359958,4,30,30,0,6,1
330327,1,0,3,-3,11,1
349403,2,0,7,-7,2,1
30425,2,10,16,-6,14,1
342486,4,26,3,23,16,1
389446,1,3,0,3,3,0
315178,2,7,10,-3,4,0
334799,1,0,0,0,13,1
262356,4,16,16,0,15,0
148701,1,7,0,7,16,0
405071,2,0,3,-3,10,1
116106,1,0,0,0,1,1
193460,4,23,20,3,1,0
330802,1,3,10,-7,11,1
388663,4,17,7,10,3,1
173716,1,0,3,-3,10,0
403229,4,24,17,7,9,1
41801,3,13,14,-1,2,1
135472,1,7,0,7,10,0
261039,1,0,7,-7,14,1
185771,4,25,3,22,15,0
67928,3,19,3,16,14,1
10160,2,0,0,0,5,0
175235,2,12,0,12,10,1
319342,3,13,21,-8,6,1
224706,1,0,0,0,15,1
211708,3,23,16,7,9,1
299427,2,0,20,-20,14,0
184922,2,0,7,-7,15,0
194240,1,0,0,0,2,0
347953,3,0,21,-21,1,0
247889,3,10,3,7,8,1
66468,2,7,10,-3,14,0
64300,2,6,10,-4,13,1
339212,1,0,0,0,15,1
49653,2,7,7,0,6,1
227914,3,27,13,14,16,0
143205,2,7,10,-3,13,1
163184,4,30,28,2,5,1
157127,3,13,20,-7,2,1
232544,4,20,17,3,1,1
390766,1,0,0,0,3,0
368309,4,9,12,-3,11,0
122620,4,27,7,20,4,0
120885,3,14,24,-10,3,1
248044,3,31,13,18,8,1
293612,1,7,0,7,12,0
124611,4,13,17,-4,5,1
47765,1,0,0,0,5,1
384494,4,28,6,22,1,0
281278,1,7,6,1,6,1
287396,4,20,3,17,8,0
380961,3,9,14,-5,16,1
978,3,0,6,-6,1,1
417815,2,10,0,10,16,0
28798,2,3,0,3,14,0
138447,2,14,7,7,12,0
142347,4,6,3,3,13,1
133658,4,17,34,-17,9,0
212121,2,3,7,-4,10,0
221048,4,21,42,-21,14,0
354707,4,17,17,0,4,0
349194,4,27,14,13,2,1
273834,4,17,14,3,2,0
110081,1,0,0,0,16,0
234532,4,20,20,0,2,1
221848,2,6,0,6,14,1
307544,4,38,25,13,17,0
10093,3,41,7,34,5,0
124977,2,3,3,0,5,1
241284,3,10,0,10,5,0
193199,2,3,0,3,1,1
276607,2,7,3,4,4,0
394338,3,24,17,7,5,1
142776,3,12,10,2,13,0
123331,2,21,7,14,4,0
161226,2,7,3,4,4,0
383223,2,21,3,18,17,0
226731,2,7,6,1,16,0
94701,4,24,43,-19,9,1
130503,3,10,3,7,8,0
411909,2,17,3,14,13,0
379545,1,13,3,10,16,0
133036,3,9,14,-5,9,1
374605,4,20,20,0,14,1
351902,1,0,0,0,3,0
357428,3,24,24,0,5,1
246185,2,14,3,11,7,0
41132,1,0,0,0,2,1
105131,4,33,14,19,14,0
376546,3,8,6,2,14,1
416466,2,14,10,4,15,1
47636,1,3,17,-14,5,1
56549,2,16,7,9,9,0
172096,3,10,9,1,9,0
391518,1,7,14,-7,4,0
334888,4,27,10,17,13,1
277877,3,7,17,-10,4,0
11338,1,14,0,14,6,0
399712,1,0,3,-3,8,1
32634,1,0,0,0,15,1
137186,1,0,0,0,11,1
265147,4,20,17,3,16,1
379042,3,7,6,1,15,0
115676,2,3,3,0,1,1
299492,4,10,23,-13,14,0
198341,3,20,14,6,3,0
98818,1,6,0,6,11,1
255294,1,0,0,0,12,0
228047,2,3,3,0,17,1
247000,4,20,24,-4,8,0
114348,2,17,13,4,1,1
92578,3,17,3,14,8,1
93950,4,27,16,11,9,0
305969,1,0,0,0,17,1
323596,1,0,0,0,8,0
319920,1,16,7,9,6,0
323476,2,3,3,0,7,0
71737,2,10,20,-10,16,1
246321,2,7,3,4,7,0
88611,2,19,7,12,6,1
411996,1,0,0,0,13,1
39130,3,13,10,3,1,1
380370,2,10,10,0,16,0
378329,3,9,6,3,15,1
317221,3,7,16,-9,5,1
296304,2,3,10,-7,13,0
332583,2,16,3,13,12,1
353503,1,3,0,3,4,0
385436,3,21,7,14,1,0
119982,3,23,24,-1,3,0
267876,4,26,24,2,17,1
63149,2,13,10,3,12,1
66226,3,31,3,28,13,1
308149,4,16,19,-3,1,0
170828,1,7,0,7,8,1
111141,4,31,10,21,16,1
242071,4,17,16,1,5,1
201307,2,27,3,24,5,1
373830,2,13,0,13,13,1
75221,1,0,0,0,17,1
391414,2,10,10,0,4,1
31976,4,16,13,3,15,1
399358,3,27,7,20,7,0
311086,3,10,3,7,2,0
400991,3,22,7,15,8,0
333604,4,27,23,4,12,1
405826,5,24,24,0,10,1
83454,4,10,23,-13,4,0
21416,2,9,7,2,11,0
299371,1,0,7,-7,14,0
411649,4,26,28,-2,13,1
168100,1,6,0,6,7,0
234938,2,10,3,7,2,0
415087,1,0,0,0,15,0
401453,4,24,10,14,8,1
157434,3,9,17,-8,2,1
143761,2,3,0,3,14,0
216031,2,10,12,-2,11,0
335262,2,0,3,-3,13,0
20372,3,10,13,-3,10,0
189804,3,17,9,8,17,0
318632,4,10,13,-3,5,0
251387,3,27,14,13,10,1
103978,3,6,10,-4,13,0
33836,3,3,31,-28,16,0
38206,2,3,7,-4,1,0
303759,3,17,10,7,16,1
219168,2,0,3,-3,13,1
324221,1,3,0,3,8,1
316250,2,7,13,-6,4,0
257486,2,6,3,3,13,1
244337,2,0,7,-7,7,1
338831,2,10,7,3,15,0
6003,4,17,36,-19,3,1
149994,2,14,3,11,16,1
414983,2,10,7,3,15,0
356882,4,25,16,9,5,0
381809,2,0,7,-7,17,0
145112,1,3,0,3,14,1
373970,2,7,0,7,13,1
311233,3,6,0,6,2,1
220717,3,13,6,7,13,0
82091,1,0,0,0,3,0
46534,4,40,6,34,4,0
53069,2,10,7,3,7,0
220340,1,0,0,0,13,1
161424,2,7,3,4,4,1
221323,4,6,35,-29,14,0
18595,3,17,10,7,9,1
360059,3,10,33,-23,7,0
243169,4,23,22,1,6,0
409256,3,13,13,0,12,1
392292,1,0,7,-7,4,1
135308,1,0,0,0,10,0
366061,4,51,14,37,10,0
156474,2,0,3,-3,2,1
193923,4,31,17,14,1,1
32106,3,21,13,8,15,0
395176,2,10,7,3,5,0
154750,2,10,10,0,1,0
286458,4,17,10,7,8,0
208849,1,0,0,0,8,1
233873,2,7,6,1,2,1
225521,3,0,21,-21,15,0
175272,3,15,7,8,10,1
420608,2,7,10,-3,17,0
302509,3,3,10,-7,15,1
240119,2,6,3,3,5,1
419711,2,0,10,-10,17,1
43273,4,24,10,14,3,0
392269,1,0,7,-7,4,1
165862,3,6,16,-10,6,0
294404,4,19,9,10,12,0
54786,2,10,0,10,8,0
263504,3,20,23,-3,15,0
262000,3,17,17,0,14,1
77641,2,0,7,-7,1,0
190734,4,42,17,25,17,1
22542,1,3,0,3,11,0
106874,2,9,0,9,14,0
415563,2,7,7,0,15,0
243834,1,0,0,0,6,0
56806,4,17,20,-3,9,1
367983,2,10,14,-4,11,1
21523,1,7,6,1,11,0
374588,3,20,13,7,14,1
296201,3,16,26,-10,13,0
37166,1,0,0,0,17,0
366002,2,23,14,9,10,1
398035,2,14,14,0,7,0
274084,3,10,0,10,3,1
341595,4,19,17,2,16,1
276974,3,17,20,-3,4,1
255687,3,3,10,-7,12,1
130478,2,3,3,0,8,1
302986,3,20,16,4,16,1
294109,4,7,27,-20,12,1
187292,4,10,13,-3,16,1
167617,1,7,0,7,7,0
213158,1,3,0,3,10,0
106349,3,14,19,-5,14,0
239300,3,3,14,-11,4,1
384578,2,3,42,-39,1,1
1492,2,3,6,-3,1,0
31640,3,24,9,15,15,1
295852,2,7,14,-7,12,1
370367,4,20,35,-15,12,1
202036,5,17,17,0,5,0
79567,2,6,0,6,2,1
22387,1,0,3,-3,11,1
107833,4,13,30,-17,15,1
93432,2,3,14,-11,9,1
108648,2,13,0,13,15,1
214680,4,17,19,-2,11,1
371372,4,45,10,35,12,0
364942,1,7,0,7,9,0
76931,2,14,13,1,1,0
83630,4,10,17,-7,4,0
323216,3,7,3,4,7,1
389790,2,10,6,4,3,1
132474,4,8,30,-22,9,0
344781,2,0,0,0,17,1
414273,3,21,21,0,14,1
104304,2,31,14,17,13,0
256380,2,6,7,-1,12,1
40487,4,7,20,-13,2,1
18520,1,0,0,0,9,0
20700,3,17,17,0,10,0
45588,2,7,13,-6,4,1
170134,3,7,10,-3,8,1
418558,2,14,3,11,16,1
236980,4,38,7,31,3,1
15827,4,8,12,-4,8,0
29198,4,3,26,-23,14,0
61483,1,0,7,-7,11,1
56766,3,14,13,1,9,1
323749,1,6,0,6,8,0
309480,4,17,9,8,1,1
36194,2,10,17,-7,17,1
160591,1,0,0,0,4,0
149409,3,13,27,-14,16,0
272529,2,7,3,4,2,1
393947,1,0,0,0,5,1
157443,3,9,17,-8,2,1
44897,3,7,38,-31,4,1
221100,2,0,6,-6,14,0
374707,2,0,30,-30,14,1
315748,1,0,0,0,4,0
29172,4,3,19,-16,14,0
205607,1,7,3,4,7,0
111941,2,7,21,-14,17,0
156282,1,3,0,3,2,0
226233,2,6,0,6,16,0
192850,4,10,15,-5,1,0
387575,3,6,3,3,2,0
272605,4,16,9,7,2,1
363187,1,0,0,0,8,0
244571,4,25,16,9,7,0
266338,2,10,0,10,16,0
198639,3,10,14,-4,3,0
190600,1,0,0,0,17,1
108810,2,0,10,-10,15,0
14017,2,3,14,-11,7,0
375633,3,17,17,0,14,0
160301,2,3,7,-4,4,1
67917,3,19,3,16,14,0
19952,1,0,3,-3,10,1
341783,1,0,3,-3,16,1
419751,3,10,10,0,17,0
286235,2,3,6,-3,8,0
254724,2,3,3,0,11,1
12473,4,13,9,4,6,0
388886,2,10,14,-4,3,1
148962,3,10,12,-2,16,1
44729,2,0,12,-12,3,1
225542,4,8,24,-16,15,1
41736,1,0,0,0,2,0
363468,1,0,0,0,8,0
56586,3,16,17,-1,9,1
125398,1,0,0,0,5,1
82870,1,0,0,0,4,1
188211,1,0,0,0,16,0
232676,3,7,0,7,1,1
131120,3,26,9,17,8,1
175207,1,7,0,7,10,1
18870,3,3,6,-3,9,0
392478,2,3,10,-7,4,0
231171,3,10,7,3,1,1
127757,2,7,14,-7,6,0
332663,4,27,20,7,12,1
151168,2,3,10,-7,17,0
122811,1,7,3,4,4,1
184033,1,0,0,0,14,0
302461,1,3,3,0,15,1
392741,1,7,0,7,4,0
87441,3,20,7,13,6,0
238449,1,0,0,0,4,1
217597,2,3,9,-6,12,1
152448,1,7,0,7,17,0
379968,4,24,6,18,16,0
131969,2,0,10,-10,8,0
95762,1,0,0,0,10,1
371174,2,11,19,-8,12,0
292552,1,0,6,-6,11,1
40284,2,6,0,6,2,0
383365,2,0,6,-6,17,0
227657,4,42,0,42,16,0
260277,4,24,3,21,14,1
273907,2,7,3,4,2,1
229139,3,19,7,12,17,0
56250,2,3,7,-4,9,0
263908,2,9,0,9,15,1
15190,2,3,0,3,8,1
15329,2,7,3,4,8,0
412693,4,30,10,20,14,1
8972,4,35,27,8,4,1
403494,3,17,12,5,9,1
135963,2,3,3,0,10,0
138798,2,0,26,-26,12,0
79596,2,14,7,7,2,1
267486,1,3,7,-4,17,0
281021,3,17,13,4,6,1
285735,1,0,3,-3,8,1
136036,4,6,10,-4,10,0
333842,3,20,21,-1,12,1
191728,3,16,17,-1,17,1
369738,3,29,30,-1,11,1
51436,2,3,17,-14,7,1
368793,1,0,0,0,11,0
97452,1,6,0,6,10,0
323711,4,26,0,26,8,1
162617,1,0,10,-10,5,0
277615,4,19,21,-2,4,0
246796,3,3,13,-10,8,0
194372,4,26,6,20,2,0
68177,2,7,7,0,14,0
205228,4,20,13,7,6,1
175137,3,28,10,18,10,1
414413,3,7,20,-13,14,0
286611,4,17,38,-21,8,0
160230,4,37,14,23,3,1
253909,3,41,14,27,11,0
304102,4,13,30,-17,16,1
166313,3,10,9,1,6,0
332598,2,17,6,11,12,0
39471,4,13,12,1,1,1
350460,2,0,12,-12,2,1
206134,4,20,13,7,7,0
87288,3,24,17,7,6,0
306334,3,24,10,14,17,1
291859,2,0,7,-7,11,1
75403,2,10,0,10,17,0
304145,1,0,0,0,16,1
323588,1,0,0,0,8,1
124675,1,0,3,-3,5,1
320540,2,14,0,14,6,1
84879,3,27,17,10,4,1
205830,3,20,0,20,7,0
267884,4,26,24,2,17,1
409724,3,10,6,4,12,1
249444,4,18,15,3,9,1
250115,1,0,0,0,9,1
72041,2,7,10,-3,16,1
388590,2,14,0,14,3,1
286675,1,10,0,10,8,0
125642,3,14,24,-10,5,1
312026,1,7,0,7,2,0
80734,1,0,0,0,3,1
357783,1,3,7,-4,6,1
12042,4,27,14,13,6,1
199118,3,14,31,-17,4,1
123150,2,3,7,-4,4,0
178741,1,7,0,7,12,0
396478,4,28,32,-4,6,0
193055,1,0,0,0,1,1
287052,3,19,24,-5,8,1
240449,2,0,7,-7,5,1
37852,1,0,0,0,1,1
239162,3,19,16,3,4,1
149729,3,34,0,34,16,1
199667,2,7,7,0,4,1
401784,1,7,0,7,9,1
399458,2,0,17,-17,7,0
335140,2,17,0,17,13,1
167880,3,14,16,-2,7,1
36254,4,17,27,-10,17,0
221755,3,10,14,-4,14,1
49958,2,21,0,21,6,0
106253,1,0,0,0,14,0
143358,3,7,13,-6,14,1
382434,3,0,24,-24,17,1
186889,1,7,0,7,15,0
353557,2,23,0,23,4,1
132771,4,20,31,-11,9,1
344016,4,23,6,17,17,0
143065,2,3,14,-11,13,1
356956,2,10,3,7,5,1
385857,1,0,0,0,1,1
271821,4,42,27,15,2,1
342555,2,9,6,3,16,0
139760,4,21,21,0,12,0
248098,4,34,20,14,8,0
76093,4,13,23,-10,1,1
345589,3,14,23,-9,17,1
21898,4,28,3,25,11,1
386145,1,0,0,0,2,0
388557,1,7,0,7,3,1
374171,3,23,15,8,13,1
105568,3,29,21,8,14,1
48298,3,13,13,0,5,0
102231,4,30,14,16,13,0
333876,4,28,28,0,12,1
37446,1,0,7,-7,17,1
103207,2,3,0,3,13,0
26561,2,10,3,7,13,0
412745,1,0,7,-7,14,0
185088,2,0,10,-10,15,0
376050,2,0,0,0,14,0
367624,4,31,12,19,10,0
349659,1,0,0,0,2,0
188650,5,20,19,1,16,0
126477,2,0,6,-6,6,0
13214,4,22,26,-4,6,1
310514,4,20,9,11,2,1
199749,4,38,10,28,4,0
51320,3,16,17,-1,7,1
309127,2,23,3,20,1,1
128180,2,7,7,0,7,1
29081,1,0,6,-6,14,0
26132,2,0,13,-13,13,1
68086,3,3,10,-7,14,0
328823,4,17,13,4,10,1
61398,2,13,3,10,11,1
67366,4,27,6,21,14,1
333011,2,3,3,0,12,0
263970,3,23,7,16,15,1
57336,2,7,0,7,10,0
66065,3,7,3,4,13,1
394580,2,7,0,7,5,1
390007,4,31,25,6,3,1
140577,2,17,7,10,12,0
34133,3,10,3,7,16,0
137997,2,7,14,-7,11,0
196505,2,7,3,4,2,1
128242,3,20,7,13,7,0
318902,4,21,22,-1,5,1
83199,2,3,7,-4,4,1
214703,1,3,0,3,11,0
349189,4,27,14,13,2,0
380591,4,21,27,-6,16,1
284279,1,3,0,3,7,0
284171,3,6,20,-14,7,1
42457,1,0,5,-5,3,1
271239,1,0,0,0,1,1
203323,2,14,24,-10,6,0
115805,1,0,0,0,1,1
148363,4,14,6,8,16,1
167805,1,0,6,-6,7,1
260335,2,0,0,0,14,0
208730,2,0,6,-6,8,1
294829,3,35,21,14,12,0
413213,1,7,0,7,14,0
245481,4,23,6,17,7,0
3122,2,0,6,-6,2,1
87578,3,17,3,14,6,0
415837,1,0,13,-13,15,1
44920,4,13,38,-25,4,1
359784,3,27,26,1,6,1
266332,2,7,0,7,16,1
261801,1,3,7,-4,14,0
87090,1,0,0,0,5,1
48913,4,15,7,8,5,0
268559,1,7,3,4,17,0
159809,1,0,0,0,3,0
317780,2,9,0,9,5,0
218107,1,7,0,7,12,0
183220,2,7,7,0,14,0
42061,3,20,7,13,2,0
279962,2,0,10,-10,5,1
253423,3,14,28,-14,11,0
68818,2,6,14,-8,15,1
193197,2,0,0,0,1,1
388727,1,8,0,8,3,0
77234,3,16,0,16,1,0
105190,2,7,0,7,14,0
250291,2,7,0,7,9,0
354459,2,14,21,-7,4,1
245755,3,16,17,-1,7,1
58202,1,0,3,-3,10,0
83484,1,0,0,0,4,1
76471,2,0,14,-14,1,1
374252,2,7,3,4,13,1
291636,4,23,13,10,11,0
302791,2,9,13,-4,15,0
14082,4,3,31,-28,7,0
132097,2,7,0,7,9,1
110494,3,20,6,14,16,1
116615,3,13,3,10,2,1
52918,1,0,0,0,7,1
337239,4,16,23,-7,14,0
375019,3,21,27,-6,14,0
375948,3,17,12,5,14,1
221536,1,13,12,1,14,1
94958,2,3,6,-3,9,1
273885,1,0,3,-3,2,1
143085,3,10,17,-7,13,1
351183,2,14,3,11,3,0
186527,4,17,33,-16,15,1
217907,4,17,28,-11,12,1
174702,3,9,7,2,10,0
121254,4,21,30,-9,3,1
207360,4,13,21,-8,7,0
158659,3,14,7,7,3,1
58534,2,10,3,7,10,0
6736,4,3,23,-20,3,0
255050,2,3,18,-15,12,0
385600,3,3,17,-14,1,1
305399,2,17,3,14,17,1
300811,4,10,33,-23,15,1
128289,1,0,0,0,7,0
258552,2,0,0,0,13,0
24491,1,0,7,-7,12,0
53645,1,0,0,0,8,0
320582,3,30,0,30,6,1
417458,1,3,7,-4,16,0
373253,4,13,16,-3,13,0
307146,2,0,3,-3,17,0
187899,4,7,23,-16,16,1
381882,4,32,28,4,17,1
377344,1,0,0,0,15,1
289781,3,10,10,0,10,0
234203,3,20,10,10,2,0
109538,2,0,7,-7,16,0
317161,2,0,3,-3,5,0
251604,4,19,20,-1,10,1
136088,1,0,7,-7,10,0
166262,2,0,3,-3,6,1
221665,1,0,0,0,14,0
343463,2,7,7,0,16,0
346562,4,24,47,-23,1,1
13532,1,0,0,0,7,0
107048,2,17,0,17,15,1
303992,1,0,6,-6,16,0
412869,4,38,35,3,14,0
97509,2,16,0,16,10,1
56192,1,0,0,0,9,0
250864,4,10,12,-2,10,0
234932,1,10,3,7,2,0
72858,4,45,17,28,16,1
365066,4,23,9,14,9,0
292640,3,22,16,6,11,0
390217,2,0,6,-6,3,0
268908,2,6,30,-24,17,1
105270,4,10,24,-14,14,0
32435,4,31,6,25,15,1
94899,1,0,0,0,9,0
406874,4,26,23,3,11,1
253648,1,0,0,0,11,0
189395,4,33,24,9,16,0
306464,3,3,17,-14,17,1
389428,4,33,28,5,3,1
168540,1,6,3,3,7,1
318505,1,0,0,0,5,0
415008,3,10,13,-3,15,0
15839,4,8,12,-4,8,0
158733,1,0,0,0,3,0
407649,4,10,17,-7,11,1
215911,2,3,7,-4,11,0
417693,3,28,12,16,16,0
70194,4,30,14,16,15,0
417964,2,14,21,-7,16,1
89666,2,6,10,-4,7,1
161909,3,13,9,4,4,0
370623,3,14,14,0,12,0
184535,3,27,14,13,14,1
31006,2,0,3,-3,15,1
87808,1,3,0,3,6,1
320057,1,0,0,0,6,1
176619,1,0,12,-12,11,1
311807,3,17,20,-3,2,0
15954,3,12,14,-2,8,0
400272,4,24,9,15,8,0
143147,1,0,0,0,13,1
206183,1,0,0,0,7,0
355879,3,13,10,3,5,0
290490,2,14,0,14,10,1
295543,2,23,7,16,12,0
202195,4,13,14,-1,5,0
100263,4,24,14,10,12,1
292545,1,0,0,0,11,0
164436,1,7,0,7,5,1
51760,3,3,19,-16,7,1
7049,1,0,7,-7,4,1
325984,4,22,7,15,9,1
376340,2,3,0,3,14,0
147402,2,14,7,7,15,0
135596,4,28,6,22,10,1
170218,1,0,3,-3,8,1
251567,3,16,13,3,10,0
74018,4,37,6,31,17,0
221086,1,0,0,0,14,1
114820,3,13,27,-14,1,1
111289,4,17,16,1,16,0
29905,4,23,23,0,14,0
397097,1,0,0,0,6,1
374775,4,16,39,-23,14,0
109149,3,31,7,24,15,0
239003,3,21,15,6,4,0
36812,3,17,17,0,17,0
363698,3,8,10,-2,8,0
323796,2,6,3,3,8,0
205667,3,17,12,5,7,0
197346,4,26,10,16,3,1
331913,4,0,16,-16,12,1
354162,1,3,0,3,4,1
260819,3,22,12,10,14,0
375024,3,21,27,-6,14,0
292114,1,7,0,7,11,1
204044,4,16,7,9,6,0
202096,2,13,0,13,5,0
414136,3,10,13,-3,14,1
186271,2,13,3,10,15,1
136757,3,13,10,3,11,1
370800,4,26,17,9,12,0
303663,4,38,19,19,16,1
193031,1,0,0,0,1,1
45436,2,14,7,7,4,0
375703,4,26,20,6,14,1
157310,4,19,3,16,2,0
62425,2,0,10,-10,12,0
124267,2,24,17,7,5,0
198796,3,3,9,-6,3,0
110282,2,0,17,-17,16,0
298940,2,3,9,-6,14,1
87877,3,10,12,-2,6,1
277289,4,0,16,-16,4,0
359135,2,7,0,7,6,1
31376,4,7,3,4,15,0
263216,4,17,17,0,15,1
263921,2,16,0,16,15,1
321422,2,14,17,-3,7,1
243992,1,7,0,7,6,0
186809,3,26,7,19,15,1
341725,4,26,13,13,16,0
278805,3,7,14,-7,5,1
113436,2,0,7,-7,17,0
396869,3,26,10,16,6,1
395278,4,10,16,-6,5,0
397934,4,10,9,1,7,0
104336,2,45,21,24,13,0
374128,2,13,7,6,13,0
187179,1,0,0,0,16,0
10186,2,6,3,3,5,1
395515,3,21,14,7,6,1
217748,3,10,7,3,12,0
407851,2,3,0,3,11,1
207476,3,21,14,7,7,0
35447,1,7,7,0,17,0
164458,2,14,0,14,5,1
95085,2,0,7,-7,9,1
261086,2,7,14,-7,14,0
47149,2,3,0,3,5,1
4379,3,7,7,0,2,1
346846,3,10,3,7,1,0
371431,2,7,7,0,12,1
328290,2,3,7,-4,10,1
128054,2,3,6,-3,7,0
130770,2,7,3,4,8,0
74258,3,10,10,0,17,0
129924,4,13,0,13,7,1
48279,3,10,13,-3,5,1
244101,4,20,34,-14,6,1
197683,1,0,3,-3,3,1
58505,1,0,3,-3,10,0
316798,3,16,7,9,4,1
277827,2,7,7,0,4,0
147441,4,23,10,13,15,0
397851,2,0,0,0,7,1
365870,2,7,14,-7,9,1
179,1,3,0,3,1,0
183173,4,22,25,-3,14,0
74245,3,3,10,-7,17,0
373256,4,13,16,-3,13,1
63554,1,10,0,10,12,0
338849,3,13,7,6,15,0
90263,2,0,7,-7,7,0
15087,4,10,26,-16,7,0
248002,2,21,3,18,8,1
211665,2,22,3,19,9,1
346554,4,24,40,-16,1,0
1119,3,10,36,-26,1,0
69512,1,0,0,0,15,1
137750,4,10,34,-24,11,1
393676,2,0,0,0,5,0
351594,4,6,27,-21,3,1
370258,2,0,14,-14,12,0
38576,4,38,12,26,1,0
197340,4,20,10,10,3,0
351250,4,28,17,11,3,0
212542,4,20,16,4,10,0
156838,3,23,23,0,2,1
116025,3,13,7,6,1,1
132384,2,0,0,0,9,0
259599,2,0,3,-3,13,1
213544,3,10,14,-4,10,1
92453,4,20,10,10,8,1
109851,2,17,0,17,16,0
98859,2,7,0,7,11,0
372983,4,28,13,15,13,0
123991,4,13,7,6,5,0
77622,2,0,7,-7,1,0
64053,3,20,17,3,13,1
232852,4,16,17,-1,2,1
345631,4,24,26,-2,17,1
230091,1,0,3,-3,17,1
247524,1,6,3,3,8,0
84922,4,41,17,24,4,1
342248,2,3,0,3,16,1
277060,2,3,7,-4,4,1
409685,2,10,6,4,12,1
265562,1,0,0,0,16,0
400325,1,3,0,3,8,0
81652,1,7,7,0,3,0
27428,1,3,0,3,13,1
405411,2,14,10,4,10,0
66021,2,7,0,7,13,1
334027,4,20,16,4,12,1
400507,2,7,3,4,8,1
106840,1,0,0,0,14,1
241314,4,13,13,0,5,0
53416,3,3,27,-24,8,0
20768,1,0,0,0,10,0
393538,2,7,9,-2,5,0
313878,2,21,19,2,3,0
135932,1,0,0,0,10,0
275218,4,17,29,-12,3,0
254457,3,20,7,13,11,0
404492,3,21,19,2,10,0
79105,1,0,0,0,2,0
140567,1,7,7,0,12,1
139074,1,6,3,3,12,1
251745,4,24,9,15,10,1
33723,4,35,7,28,16,1
176439,1,0,0,0,11,0
160063,4,20,26,-6,3,1
294124,4,14,27,-13,12,1
290719,4,44,25,19,10,0
67875,2,12,3,9,14,1
66843,1,0,0,0,14,0
197872,2,11,7,4,3,1
279581,4,10,16,-6,5,0
83547,3,0,14,-14,4,0
173632,3,7,20,-13,10,1
267452,4,20,24,-4,17,0
16940,3,27,19,8,8,0
353437,3,25,3,22,4,1
42581,4,10,31,-21,3,1
386559,4,14,24,-10,2,0
306433,2,0,10,-10,17,1
378640,4,23,23,0,15,1
213644,2,7,14,-7,10,0
187533,2,6,13,-7,16,1
407739,3,10,0,10,11,0
139981,3,25,3,22,12,0
238105,5,13,13,0,4,0
100137,1,0,0,0,12,1
63621,3,13,26,-13,12,0
393079,2,7,3,4,4,1
77461,1,0,0,0,1,0
177542,2,7,0,7,11,1
414677,2,3,7,-4,14,0
319363,4,16,28,-12,6,1
400430,4,24,10,14,8,0
145788,3,13,10,3,15,1
101050,1,0,3,-3,12,0
377398,2,7,13,-6,15,0
164671,4,21,27,-6,5,0
344562,3,0,0,0,17,0
313037,4,20,0,20,3,0
190046,1,17,0,17,17,0
421191,1,3,0,3,17,0
49871,4,21,17,4,6,1
72118,4,17,17,0,16,0
406189,1,7,3,4,11,1
248032,3,28,13,15,8,1
300912,3,10,13,-3,15,0
264116,3,13,27,-14,15,1
222077,4,27,10,17,14,0
83142,4,13,30,-17,4,1
295900,3,10,17,-7,12,1
389824,4,24,6,18,3,1
404447,2,14,7,7,10,1
315824,3,3,19,-16,4,0
185562,2,10,17,-7,15,1
75550,1,7,0,7,17,0
306139,2,0,0,0,17,1
290792,2,3,0,3,10,1
219639,2,10,0,10,13,0
235156,4,0,10,-10,2,1
120636,4,3,27,-24,3,1
257439,4,23,21,2,13,1
383387,3,3,9,-6,17,1
338792,2,7,0,7,15,1
172116,4,13,12,1,9,0
197122,2,14,20,-6,3,1
220797,2,0,0,0,14,0
375744,2,6,0,6,14,0
398378,3,3,27,-24,7,1
166207,4,35,19,16,6,1
109064,4,23,41,-18,15,1
167167,2,13,0,13,7,0
267937,1,0,0,0,17,0
51781,4,3,19,-16,7,1
280474,4,34,31,3,5,1
191419,3,0,31,-31,17,0
328451,2,3,0,3,10,0
249504,2,14,3,11,9,0
191325,1,0,0,0,17,0
97122,4,34,6,28,10,1
128406,4,14,13,1,7,0
1801,2,10,0,10,1,1
349181,4,27,14,13,2,1
394999,1,0,7,-7,5,0
255325,2,14,0,14,12,1
4307,1,0,0,0,2,0
311680,4,6,6,0,2,0
146090,3,19,10,9,15,1
317057,3,7,10,-3,4,1
233241,2,0,3,-3,2,1
357289,3,6,19,-13,5,0
304308,2,7,0,7,16,0
3861,1,13,0,13,2,1
356832,3,0,16,-16,5,1
76967,3,17,13,4,1,0
355,2,14,10,4,1,1
415627,4,30,13,17,15,0
163268,2,6,6,0,5,0
235050,1,0,0,0,2,1
20724,4,30,20,10,10,1
278228,4,31,21,10,4,1
293778,2,10,3,7,12,0
51648,4,27,20,7,7,1
128218,3,20,7,13,7,0
199502,2,14,0,14,4,1
337268,4,16,26,-10,14,1
44114,2,0,13,-13,3,1
310397,1,0,0,0,2,1
4277,4,27,6,21,2,1
391278,2,14,0,14,4,0
11358,2,17,0,17,6,0
62341,4,24,22,2,12,1
246182,2,14,3,11,7,1
124609,4,13,17,-4,5,1
318127,2,9,7,2,5,0
21762,4,31,17,14,11,0
81298,4,10,14,-4,3,0
155777,4,30,30,0,2,0
84960,1,6,7,-1,4,1
165649,2,0,7,-7,6,1
338268,4,34,31,3,14,0
277466,4,47,32,15,4,0
219866,4,45,0,45,13,0
102805,3,10,3,7,13,1
333647,2,0,0,0,12,1
396408,2,20,18,2,6,1
348027,1,0,7,-7,1,1
91596,1,0,7,-7,8,1
93311,2,21,3,18,9,0
317771,1,0,0,0,5,1
167505,2,0,3,-3,7,1
184470,1,0,7,-7,14,1
102396,4,19,34,-15,13,1
27298,2,7,3,4,13,1
21144,3,0,13,-13,10,0
148583,2,0,6,-6,16,1
324686,2,0,7,-7,8,1
122826,2,10,3,7,4,0
276851,4,26,20,6,4,0
281614,2,21,0,21,6,0
414202,1,0,0,0,14,0
168354,4,24,24,0,7,0
405532,1,0,7,-7,10,0
328203,4,14,17,-3,10,1
82920,2,3,3,0,4,1
370618,3,14,14,0,12,1
45607,3,10,13,-3,4,0
63045,3,16,21,-5,12,1
260512,3,27,0,27,14,0
184293,4,34,14,20,14,1
93039,3,13,9,4,8,0
237915,4,14,27,-13,4,0
252520,4,17,25,-8,10,0
167849,2,7,13,-6,7,0
160059,4,20,26,-6,3,1
99294,2,10,0,10,11,1
191826,2,10,10,0,1,1
299217,1,3,0,3,14,0
418552,2,14,0,14,16,0
129063,2,14,21,-7,7,1
100367,3,9,20,-11,12,1
27446,1,3,0,3,13,0
165845,3,6,16,-10,6,0
402619,4,20,16,4,9,0
252373,4,0,29,-29,10,1
212295,2,7,3,4,10,1
17915,1,0,6,-6,9,0
103703,3,3,17,-14,13,0
358534,1,10,3,7,6,1
385205,4,21,20,1,1,0
127088,1,3,0,3,6,0
206650,1,0,0,0,7,0
412166,2,7,3,4,13,1
165528,3,3,21,-18,6,1
116250,1,10,0,10,1,0
207449,3,14,14,0,7,0
82544,4,17,27,-10,3,0
93641,4,23,6,17,9,0
413450,4,10,38,-28,14,1
276048,2,13,3,10,3,1
279854,3,17,13,4,5,1
132786,1,0,0,0,9,0
250589,1,0,0,0,10,1
395238,3,10,13,-3,5,0
244795,2,0,0,0,7,0
41937,3,21,6,15,2,1
29648,4,14,21,-7,14,0
362221,3,6,10,-4,8,0
101030,1,0,0,0,12,0
115515,1,0,3,-3,1,1
207796,4,27,16,11,7,1
35180,3,0,14,-14,16,0
360,2,20,10,10,1,1
36034,1,7,0,7,17,1
59568,1,0,3,-3,11,1
105304,4,10,26,-16,14,0
235074,1,0,7,-7,2,0
299495,4,10,23,-13,14,1
372448,2,6,14,-8,13,0
105851,3,16,10,6,14,1
196967,2,20,0,20,3,0
179667,5,31,30,1,12,0
149604,4,17,26,-9,16,1
135191,2,10,0,10,10,0
412569,4,31,24,7,14,0
320831,1,3,4,-1,6,0
336411,2,3,3,0,14,1
309093,1,9,3,6,1,1
124940,1,0,0,0,5,0
411343,3,17,10,7,13,0
279243,2,16,13,3,5,0
158137,1,0,0,0,3,1
212865,1,0,0,0,10,0
363559,3,3,12,-9,8,1
180950,3,17,14,3,13,1
152766,2,7,7,0,17,0
143203,2,7,3,4,13,0
300872,2,0,7,-7,15,1
105210,2,7,17,-10,14,1
5770,2,14,0,14,3,0
211097,4,37,0,37,9,0
191413,3,0,31,-31,17,1
357379,2,14,10,4,5,0
225799,3,10,14,-4,16,1
176791,2,3,7,-4,11,1
24237,3,10,17,-7,12,1
145594,2,21,0,21,14,0
32420,4,31,6,25,15,0
206926,4,17,23,-6,7,0
67780,4,21,0,21,14,1
256190,4,30,22,8,12,1
120427,3,19,9,10,3,0
2913,1,0,0,0,2,0
189166,2,21,0,21,16,0
139562,3,6,7,-1,12,1
410063,1,7,7,0,13,1
251686,2,6,3,3,10,1
361909,2,0,0,0,7,0
230531,1,3,7,-4,1,1
262666,4,29,16,13,15,0
286914,3,16,13,3,8,1
130874,4,20,15,5,8,1
97354,2,2,6,-4,10,0
260880,1,0,0,0,14,0
330182,1,0,0,0,11,1
17982,2,13,21,-8,9,1
348674,2,3,10,-7,2,1
406973,3,3,20,-17,11,1
10352,3,10,35,-25,5,1
80220,3,21,24,-3,2,1
367299,3,3,17,-14,10,0
133347,3,14,9,5,9,1
199863,3,10,17,-7,4,0
224571,1,3,7,-4,15,1
7218,2,0,13,-13,4,1
411380,4,20,13,7,13,1
319849,4,23,10,13,6,0
166477,3,20,17,3,6,1
3821,4,23,10,13,2,0
173695,1,0,0,0,10,1
146983,2,17,0,17,15,0
261789,1,0,6,-6,14,0
323273,4,7,17,-10,7,0
128164,1,7,0,7,7,0
88914,2,16,3,13,6,0
275173,3,14,16,-2,3,0
9515,4,13,13,0,5,1
92911,4,34,7,27,8,0
189010,2,7,7,0,16,1
106181,4,0,10,-10,14,1
386411,4,20,17,3,2,1
299490,4,10,23,-13,14,0
189462,2,14,0,14,17,1
342821,1,7,0,7,16,0
116898,3,7,10,-3,2,1
338918,1,3,0,3,15,0
321325,3,15,19,-4,6,1
47352,3,3,10,-7,5,0
29707,2,10,0,10,14,0
228405,4,10,20,-10,17,0
328911,2,6,7,-1,10,1
390276,3,16,13,3,3,1
417052,2,17,0,17,15,0
214434,3,7,14,-7,11,0
181565,2,13,0,13,13,0
20101,1,0,0,0,10,1
197127,2,14,20,-6,3,1
252437,2,0,0,0,10,0
130093,4,17,36,-19,8,1
84986,2,16,7,9,4,1
216476,2,17,1,16,12,1
285658,4,27,27,0,8,1
44700,2,0,9,-9,3,1
143657,3,16,10,6,14,1
345047,1,0,0,0,17,0
67355,3,26,6,20,14,1
174300,1,10,0,10,10,0
133612,2,10,7,3,9,0
27011,2,10,0,10,13,1
336467,4,10,17,-7,14,1
28372,2,6,0,6,14,1
12636,1,0,0,0,6,0
299228,1,3,0,3,14,0
73650,2,10,0,10,17,0
252257,1,0,7,-7,10,0
8866,1,13,0,13,4,1
248432,2,10,6,4,8,0
47348,3,3,10,-7,5,1
415465,3,23,3,20,15,0
68944,1,7,7,0,15,1
368704,2,7,16,-9,11,0
250869,4,10,12,-2,10,0
200820,1,0,0,0,4,1
218714,2,0,7,-7,13,0
197807,1,0,0,0,3,1
203773,2,14,10,4,6,1
14171,3,0,24,-24,7,0
176049,3,24,0,24,11,1
27065,3,17,6,11,13,0
206756,4,7,24,-17,7,1
58463,4,48,17,31,10,0
85964,3,14,14,0,5,0
416908,2,3,7,-4,15,0
347289,3,0,7,-7,1,1
108581,4,26,14,12,15,0
238419,4,17,33,-16,4,0
69328,4,19,3,16,15,1
130448,1,3,0,3,8,0
202516,1,0,0,0,5,0
27833,4,17,14,3,13,1
313957,4,34,32,2,3,1
69887,4,24,16,8,15,1
286889,3,9,7,2,8,0
370435,2,7,6,1,12,1
128731,1,0,0,0,7,1
395043,2,0,17,-17,5,1
318287,3,6,7,-1,5,1
237003,1,0,0,0,3,1
230880,3,14,10,4,1,0
393989,2,3,7,-4,5,0
80091,4,24,22,2,2,0
233522,1,0,7,-7,2,1
105123,4,26,14,12,14,1
287271,5,29,23,6,8,1
60838,3,17,16,1,11,0
95354,1,0,0,0,10,1
289685,4,21,23,-2,10,0
248968,4,27,3,24,9,0
93898,3,17,6,11,9,1
91734,1,0,0,0,8,0
220955,2,7,7,0,14,1
54680,4,27,29,-2,8,0
356526,3,9,3,6,5,0
163019,4,16,3,13,5,1
359281,2,3,6,-3,6,0
203638,2,7,10,-3,6,0
99941,3,10,9,1,12,1
137175,1,0,0,0,11,0
242914,3,21,13,8,6,0
352736,4,24,12,12,3,0
220312,4,26,9,17,13,1
25665,2,7,7,0,12,1
326208,2,10,27,-17,9,1
250923,2,3,6,-3,10,0
5347,2,10,6,4,3,0
306822,1,0,0,0,17,0
132960,1,0,7,-7,9,0
273749,1,0,7,-7,2,0
39730,3,9,0,9,1,1
325701,4,34,21,13,9,1
11266,3,17,28,-11,6,0
61628,1,0,0,0,12,0
177408,2,17,10,7,11,0
270855,3,9,13,-4,1,1
59694,4,31,6,25,11,0
245612,4,40,13,27,7,0
14845,1,0,0,0,7,0
393033,1,0,0,0,4,1
242842,1,7,0,7,6,0
417840,2,10,0,10,16,0
178744,1,7,0,7,12,1
362759,1,0,0,0,8,1
140534,4,21,29,-8,12,0
313453,3,17,7,10,3,0
147055,1,0,7,-7,15,1
136052,4,6,13,-7,10,1
85431,1,7,0,7,5,0
199843,3,3,17,-14,4,1
125806,4,17,23,-6,5,1
196663,2,27,0,27,3,0
241885,3,13,13,0,5,0
324195,1,0,0,0,8,0
417580,1,0,0,0,16,1
108899,4,17,17,0,15,0
286586,3,17,31,-14,8,0
344134,3,20,3,17,17,0
18800,4,16,20,-4,9,0
32251,3,21,14,7,15,1
290121,4,21,15,6,10,0
114590,1,3,0,3,1,0
255272,4,13,17,-4,12,0
228956,2,14,9,5,17,0
313935,4,28,29,-1,3,0
358096,2,14,0,14,6,0
385430,3,21,7,14,1,0
251144,4,10,20,-10,10,0
187453,4,41,14,27,16,1
77914,1,0,0,0,1,1
200980,1,14,0,14,5,0
37142,4,23,20,3,17,0
122789,1,0,0,0,4,1
421385,2,13,20,-7,17,1
14373,4,9,17,-8,7,0
225053,2,0,14,-14,15,0
308228,2,7,10,-3,1,1
288565,3,23,31,-8,9,1
94657,2,17,25,-8,9,0
63638,3,13,33,-20,12,0
302564,4,3,16,-13,15,0
52405,4,12,17,-5,7,0
83564,3,0,17,-17,4,0
294707,3,6,14,-8,12,1
266012,1,0,0,0,16,1
340128,1,6,6,0,15,0
359965,1,0,0,0,7,1
355716,2,7,3,4,5,1
26526,1,3,0,3,13,0
96295,2,0,15,-15,10,0
224313,3,9,12,-3,15,1
76702,4,16,7,9,1,0
115204,1,0,0,0,1,0
95916,5,23,23,0,10,1
169240,3,17,6,11,7,1
409502,2,0,0,0,12,0
396918,4,27,27,0,6,1
382011,4,6,30,-24,17,1
38958,2,23,3,20,1,0
59958,3,3,24,-21,11,1
290028,2,7,3,4,10,0
5040,2,7,0,7,3,0
355905,3,27,10,17,5,0
414354,1,7,3,4,14,1
105257,3,10,24,-14,14,0
380653,2,7,7,0,16,0
272879,3,20,17,3,2,0
301119,1,7,0,7,15,0
173745,2,3,3,0,10,0
46086,4,21,14,7,4,0
142486,3,21,10,11,13,0
184116,3,16,14,2,14,0
362227,3,6,17,-11,8,1
234105,4,27,14,13,2,0
323085,3,23,14,9,7,0
365100,1,0,7,-7,9,0
92395,2,10,7,3,8,1
405703,2,10,0,10,10,0
233970,1,0,0,0,2,0
200695,1,7,0,7,4,0
114608,2,3,3,0,1,1
269120,4,16,16,0,17,1
172563,3,7,24,-17,9,1
210217,4,10,21,-11,9,0
224021,3,14,6,8,15,0
332572,2,9,3,6,12,1
37803,3,14,9,5,1,0
63964,4,6,27,-21,12,0
66920,3,12,7,5,14,0
181543,2,6,0,6,13,0
83078,2,6,14,-8,4,0
88573,1,3,7,-4,6,1
121368,3,7,3,4,3,0
250999,4,3,6,-3,10,0
76001,1,7,13,-6,1,0
34154,3,10,3,7,16,0
314267,5,24,23,1,3,0
289026,3,19,21,-2,9,1
70604,3,10,10,0,15,1
232150,1,6,0,6,1,1
156771,2,14,7,7,2,0
63683,4,33,36,-3,12,0
356667,2,16,10,6,5,1
381710,4,20,24,-4,17,1
382880,4,35,3,32,17,0
273425,1,0,0,0,2,1
345307,4,19,24,-5,17,1
120771,4,23,6,17,3,0
95689,3,10,6,4,10,0
125935,3,16,13,3,6,1
125523,4,30,7,23,5,1
406065,2,0,13,-13,11,1
195139,1,0,0,0,2,0
259918,3,17,10,7,14,1
405869,1,7,0,7,11,1
25928,1,3,0,3,13,0
196294,4,21,10,11,2,0
170309,3,0,12,-12,8,1
230923,4,31,10,21,1,0
24329,1,0,0,0,12,1
400407,4,24,10,14,8,0
106069,1,0,0,0,14,1
311660,3,6,6,0,2,0
97880,4,20,27,-7,11,1
317407,4,7,16,-9,5,0
282371,2,7,13,-6,6,1
225035,2,0,7,-7,15,1
253313,4,13,13,0,11,1
310411,2,7,0,7,2,1
375528,4,33,14,19,14,1
113252,2,7,7,0,17,1
195812,3,20,14,6,2,1
84240,1,0,7,-7,4,1
262025,3,24,24,0,14,0
368404,2,14,7,7,11,0
417728,4,35,19,16,16,0
79923,3,10,16,-6,2,0
241807,1,3,3,0,5,1
21491,4,15,17,-2,11,0
376114,4,0,9,-9,14,0
238550,4,16,20,-4,4,1
132646,1,0,3,-3,9,0
385598,3,3,17,-14,1,1
390434,4,14,27,-13,3,0
348565,3,28,17,11,2,1
25895,4,31,17,14,12,1
14805,4,45,10,35,7,1
334101,2,10,0,10,13,1
33669,2,21,0,21,16,1
122130,3,17,14,3,4,0
318297,3,6,7,-1,5,1
121374,3,7,3,4,3,1
183763,1,7,14,-7,14,1
211039,2,20,0,20,9,1
311989,4,35,17,18,2,0
387757,4,0,37,-37,2,1
352679,2,14,3,11,3,0
182836,4,29,20,9,14,1
367877,4,20,20,0,10,0
116739,3,13,23,-10,2,0
208678,4,9,6,3,8,0
119293,3,14,10,4,3,1
394326,3,24,10,14,5,0
153347,1,0,0,0,1,0
375513,3,33,7,26,14,1
250539,4,16,14,2,9,1
9837,4,20,17,3,5,1
175125,3,28,10,18,10,0
231782,3,13,20,-7,1,1
191938,1,0,6,-6,1,0
270063,2,3,10,-7,1,1
410122,2,17,10,7,13,1
96657,4,3,16,-13,10,0
267576,4,27,27,0,17,0
411127,2,0,13,-13,13,1
394096,4,23,26,-3,5,0
196421,3,20,7,13,2,0
248092,4,34,20,14,8,0
272167,1,0,0,0,2,0
337844,4,30,6,24,14,0
285831,4,14,27,-13,8,0
95817,2,6,10,-4,10,1
112612,4,31,34,-3,17,0
252592,1,0,0,0,10,1
200419,2,10,18,-8,4,0
340301,1,10,0,10,15,0
207266,2,0,7,-7,7,1
16851,4,26,38,-12,8,1
411471,3,10,17,-7,13,0
339633,4,31,17,14,15,0
298035,1,0,0,0,13,0
47204,3,9,6,3,5,0
59803,3,12,13,-1,11,0
253524,2,0,7,-7,11,1
119576,2,10,0,10,3,0
67838,1,3,3,0,14,0
153096,2,6,10,-4,1,0
222680,3,14,24,-10,14,1
224809,4,11,10,1,15,0
156294,1,3,0,3,2,1
310915,3,3,6,-3,2,1
107774,2,7,13,-6,15,1
36072,2,31,0,31,17,0
120345,1,0,3,-3,3,1
264896,2,17,14,3,16,0
180617,2,7,6,1,13,1
60878,4,17,26,-9,11,1
193566,3,0,10,-10,1,1
319965,3,30,10,20,6,0
327564,3,7,15,-8,10,1
357745,4,43,13,30,5,0
201743,1,3,0,3,5,0
82588,1,0,9,-9,3,0
195687,3,14,10,4,2,0
51059,3,3,20,-17,6,0
382830,3,21,3,18,17,0
107949,3,6,6,0,15,0
395119,4,24,34,-10,5,0
300945,4,17,27,-10,15,1
361800,3,24,7,17,7,1
288798,1,3,7,-4,9,0
223926,4,30,6,24,15,0
192240,1,3,0,3,1,0
1930,2,0,0,0,1,1
412329,2,10,14,-4,13,0
58781,4,10,29,-19,10,1
334060,1,0,0,0,13,0
348622,4,34,23,11,2,0
3833,1,0,0,0,2,0
297685,3,10,6,4,13,0
224361,4,16,12,4,15,0
83129,4,13,30,-17,4,0
345294,4,19,17,2,17,0
168522,1,0,0,0,7,0
244374,2,0,17,-17,7,1
343631,2,15,7,8,17,1
334826,2,10,0,10,13,0
202372,1,0,0,0,5,1
96785,4,7,10,-3,10,0
321602,2,10,6,4,7,0
362804,3,7,21,-14,8,1
158896,1,14,0,14,3,0
71287,2,7,10,-3,16,1
356534,4,9,6,3,5,1
30811,1,0,0,0,15,0
231964,4,14,41,-27,1,1
80807,3,3,0,3,3,0
245988,1,0,0,0,7,0
156317,2,17,0,17,2,1
119844,4,24,19,5,3,1
221430,3,3,30,-27,14,0
349741,3,20,7,13,2,0
139901,1,0,0,0,12,0
19118,1,7,3,4,10,1
1722,4,28,0,28,1,1
421705,3,17,10,7,17,1
91129,1,0,7,-7,8,1
301226,4,20,17,3,15,1
52831,2,7,37,-30,7,0
164556,4,26,17,9,5,1
211500,3,26,7,19,9,1
157282,3,13,3,10,2,1
271920,3,17,13,4,2,0
164272,4,48,51,-3,5,0
239971,2,0,10,-10,5,0
400380,3,17,10,7,8,1
191286,4,10,17,-7,17,1
370243,1,0,7,-7,12,1
80501,2,5,3,2,3,1
171343,3,16,3,13,9,0
330284,4,30,21,9,11,1
419922,4,13,18,-5,17,1
241046,1,7,0,7,5,0
367204,4,29,26,3,10,1
281352,3,21,13,8,6,0
126539,3,7,6,1,6,1
14416,1,14,3,11,7,1
198450,2,10,3,7,3,1
56996,1,0,10,-10,9,1
194614,3,21,7,14,2,0
166084,1,7,0,7,6,1
12982,2,0,7,-7,6,1
364491,1,0,0,0,9,1
259305,2,13,13,0,13,1
413859,3,14,6,8,14,1
411073,4,17,17,0,13,1
170883,3,7,7,0,8,1
162501,2,14,10,4,4,1
26406,2,10,3,7,13,0
398975,1,0,0,0,7,1
311562,1,0,0,0,2,1
52682,3,3,13,-10,7,0
78389,1,7,0,7,2,0
55148,4,29,17,12,8,1
241654,1,0,0,0,5,1
153313,4,2,10,-8,1,1
18697,1,0,7,-7,9,0
218244,1,0,0,0,12,0
283651,4,23,20,3,7,0
201194,3,20,21,-1,5,0
95407,2,27,7,20,10,1
30319,3,3,10,-7,14,0
105027,1,0,7,-7,14,1
269866,4,22,10,12,1,1
415140,2,3,21,-18,15,0
28794,1,0,0,0,14,1
173651,4,10,20,-10,10,1
1152,4,10,36,-26,1,1
394455,2,7,13,-6,5,0
266781,2,3,14,-11,16,0
227562,1,14,0,14,16,1
77892,4,17,38,-21,1,1
305976,1,3,0,3,17,0
369191,4,22,20,2,11,0
240484,3,3,7,-4,5,0
357144,4,6,14,-8,5,0
51646,3,27,20,7,7,1
50563,2,0,6,-6,6,1
374885,3,14,11,3,14,1
90530,4,0,26,-26,7,0
22999,2,0,7,-7,11,0
197084,1,7,14,-7,3,1
158036,2,0,6,-6,3,1
242038,3,7,3,4,5,1
64588,2,10,14,-4,13,0
150198,3,6,26,-20,16,1
6989,3,10,7,3,3,0
43091,3,3,10,-7,3,0
222438,1,3,7,-4,14,1
391422,2,10,10,0,4,0
309085,1,9,3,6,1,1
298536,3,13,0,13,14,1
72589,1,0,0,0,16,1
266269,4,38,19,19,16,0
279237,2,13,13,0,5,1
99165,2,3,3,0,11,0
108855,3,7,17,-10,15,1
14364,4,8,17,-9,7,1
165240,2,14,7,7,6,1
125888,2,13,10,3,6,0
393477,4,34,27,7,5,0
106136,2,0,0,0,14,0
63758,3,14,15,-1,12,0
85767,2,10,7,3,5,0
200432,2,10,18,-8,4,1
39057,1,3,0,3,1,0
260487,2,13,0,13,14,0
81149,4,16,14,2,3,1
38117,4,9,6,3,1,0
291010,4,20,13,7,10,1
155518,2,20,3,17,2,0
184684,3,10,24,-14,15,1
287269,5,23,23,0,8,1
311495,3,10,10,0,2,1
260947,2,10,0,10,14,1
226143,3,14,17,-3,16,1
369547,2,11,0,11,11,1
147277,3,0,24,-24,15,0
175173,4,42,17,25,10,0
33625,1,0,0,0,16,0
138698,4,13,35,-22,12,1
412913,2,0,3,-3,14,1
131047,1,7,0,7,8,0
204109,2,3,10,-7,6,0
92153,3,3,37,-34,8,1
205292,1,10,0,10,6,0
143597,1,7,3,4,14,1
340066,4,17,12,5,15,0
397456,3,13,13,0,6,0
247818,1,0,3,-3,8,1
342121,2,12,9,3,16,0
235498,1,0,7,-7,3,1
174421,4,17,10,7,10,0
374654,1,0,0,0,14,0
263538,4,20,29,-9,15,1
143260,4,17,16,1,13,1
344178,4,35,11,24,17,0
124309,4,34,20,14,5,1
337155,2,3,0,3,14,0
112700,2,3,0,3,17,1
119739,2,10,3,7,3,0
321118,2,0,10,-10,6,1
407614,4,10,17,-7,11,1
67346,3,20,6,14,14,0
392226,4,10,16,-6,4,0
296711,4,10,19,-9,13,1
32858,3,6,7,-1,15,1
105184,1,7,0,7,14,1
370403,1,7,0,7,12,0
81718,3,17,17,0,3,1
172368,2,10,21,-11,9,0
250755,2,3,0,3,10,0
284265,1,0,0,0,7,1
221930,4,19,19,0,14,1
308276,3,13,16,-3,1,1
349874,2,3,3,0,2,1
346192,2,17,0,17,1,1
138844,3,12,33,-21,12,0
360823,4,24,37,-13,7,1
385284,3,7,6,1,1,0
315634,2,3,0,3,4,0
267969,2,0,3,-3,17,0
327223,1,0,3,-3,9,1
253538,2,3,7,-4,11,1
97915,1,0,6,-6,11,0
262852,2,7,20,-13,15,1
281066,4,24,16,8,6,1
63981,1,7,0,7,13,0
105331,1,0,7,-7,14,1
344925,2,3,7,-4,17,0
407373,1,0,7,-7,11,1
253857,2,27,14,13,11,1
136796,4,13,10,3,11,1
332480,3,23,6,17,12,0
68556,3,13,28,-15,14,0
262879,2,7,23,-16,15,1
83718,3,22,20,2,4,1
267457,1,0,0,0,17,0
233665,1,0,0,0,2,1
19584,3,14,21,-7,10,0
247726,3,7,6,1,8,1
132307,3,24,14,10,9,0
28247,3,17,0,17,13,0
274102,3,20,0,20,3,0
106922,3,12,3,9,14,0
345554,2,7,17,-10,17,0
254657,4,31,27,4,11,0
235298,4,25,6,19,3,0
122720,2,7,17,-10,4,0
382281,3,17,3,14,17,0
169883,4,27,17,10,8,1
354164,1,3,0,3,4,0
409316,4,16,16,0,12,1
156588,1,0,0,0,2,1
124561,2,6,7,-1,5,0
243872,2,13,3,10,6,1
139101,2,9,3,6,12,0
188529,2,3,3,0,16,1
266406,4,36,8,28,16,1
339524,1,0,0,0,15,1
318453,3,24,7,17,5,1
280806,1,7,0,7,6,0
152281,4,28,0,28,17,0
224800,3,11,10,1,15,0
16981,4,27,23,4,8,0
10970,3,9,28,-19,5,0
411557,1,0,10,-10,13,0
75739,2,28,16,12,1,0
103157,1,0,0,0,13,0
111088,3,24,0,24,16,0
230346,4,25,17,8,17,1
297615,1,0,0,0,13,1
354355,3,38,3,35,4,0
304015,1,0,13,-13,16,1
416233,4,10,39,-29,15,1
296585,2,0,0,0,13,0
228391,3,10,17,-7,17,0
165107,4,10,24,-14,6,1
412103,4,31,3,28,13,1
80481,2,5,3,2,3,1
202557,2,7,6,1,5,0
299278,2,23,0,23,14,0
197987,2,0,17,-17,3,0
343792,2,14,3,11,17,0
168382,1,0,0,0,7,0
407148,3,10,27,-17,11,1
214477,4,7,17,-10,11,0
238209,3,3,16,-13,4,1
314452,1,7,0,7,3,0
146043,2,10,0,10,15,0
178534,4,16,13,3,12,0
262437,2,7,14,-7,15,0
342963,4,37,25,12,16,0
144053,1,7,0,7,14,0
341380,3,0,10,-10,16,1
190702,3,35,17,18,17,1
403332,3,12,0,12,9,1
171606,2,3,3,0,9,1
220314,4,26,9,17,13,1
300173,3,21,3,18,14,0
290976,3,20,10,10,10,1
390791,1,0,7,-7,3,1
358568,2,10,9,1,6,0
230809,1,0,0,0,1,1
169887,4,27,17,10,8,0
40177,3,20,7,13,2,0
283659,4,23,33,-10,7,1
271715,2,13,10,3,2,1
391944,4,30,27,3,4,0
67988,1,0,0,0,14,0
8912,3,21,0,21,4,0
114322,2,7,6,1,1,1
233207,1,0,0,0,2,1
7178,4,48,24,24,4,0
44300,3,17,20,-3,3,1
168465,3,0,24,-24,7,1
251644,1,3,3,0,10,1
56676,1,0,0,0,9,1
123177,2,6,21,-15,4,1
49145,1,3,0,3,6,1
141637,2,16,7,9,13,1
380854,4,9,31,-22,16,0
141185,2,3,21,-18,13,1
184925,2,0,7,-7,15,0
198142,2,0,3,-3,3,1
124921,4,9,16,-7,5,0
16478,2,10,0,10,8,0
324695,2,7,7,0,8,0
145026,3,12,3,9,14,1
86195,4,34,10,24,5,0
223167,1,0,0,0,15,0
69452,3,24,10,14,15,1
86419,2,20,7,13,5,1
98973,1,0,0,0,11,1
334134,3,16,7,9,13,0
96075,4,16,14,2,10,0
1607,4,16,20,-4,1,1
403933,3,20,17,3,10,0
268579,2,7,3,4,17,0
100632,2,7,7,0,12,1
287192,3,10,19,-9,8,0
387222,2,6,7,-1,2,1
300849,1,0,7,-7,15,0
62274,2,21,10,11,12,1
391126,2,7,17,-10,4,0
364871,3,6,20,-14,9,0
120158,4,10,6,4,3,1
363254,2,21,7,14,8,1
181930,4,28,35,-7,13,0
421643,2,3,7,-4,17,1
368526,2,6,0,6,11,1
307902,1,0,0,0,1,1
99933,3,10,6,4,12,0
210260,1,3,0,3,9,1
180332,3,12,7,5,13,0
319698,4,33,9,24,6,0
180049,3,21,20,1,13,1
331996,2,0,0,0,12,0
310644,3,13,30,-17,2,1
219294,1,10,7,3,13,1
348840,2,3,14,-11,2,0
46440,1,7,0,7,4,0
302369,3,10,13,-3,15,1
268694,1,0,0,0,17,1
204746,3,14,14,0,6,0
30804,1,0,0,0,15,1
14797,4,45,3,42,7,0
53354,1,3,7,-4,8,0
358912,4,6,35,-29,6,1
112313,4,45,17,28,17,1
399231,3,13,13,0,7,0
188442,3,3,3,0,16,1
397459,3,13,13,0,6,0
334787,1,0,0,0,13,0
368356,1,7,0,7,11,0
83588,4,0,17,-17,4,1
264520,2,7,7,0,16,1
289867,1,0,3,-3,10,1
370788,3,19,17,2,12,1
93213,4,3,20,-17,9,1
121904,4,0,33,-33,4,0
2192,1,0,0,0,1,1
37831,4,14,9,5,1,0
106684,1,0,0,0,14,0
128282,1,0,0,0,7,1
329324,2,6,17,-11,10,1
271877,2,7,10,-3,2,1
67898,3,16,3,13,14,1
325180,3,13,17,-4,8,0
369847,2,7,0,7,12,0
87627,4,17,13,4,6,0
190806,2,13,3,10,17,1
90003,3,5,21,-16,7,0
137024,1,7,0,7,11,0
226280,2,16,0,16,16,0
47115,1,0,0,0,5,1
5129,4,13,7,6,3,0
55933,1,0,0,0,9,0
212126,2,3,14,-11,10,0
316291,3,10,16,-6,4,1
263364,4,31,10,21,15,0
133504,4,27,20,7,9,1
387582,3,6,3,3,2,1
123284,1,7,0,7,4,0
340757,2,10,7,3,15,0
414133,3,10,13,-3,14,1
99866,1,0,0,0,12,0
320008,4,43,24,19,6,0
141540,3,24,10,14,13,1
3183,4,13,9,4,2,1
287958,3,14,13,1,9,1
184599,1,7,0,7,15,0
395394,3,28,3,25,5,0
248777,3,27,14,13,9,1
213782,2,20,0,20,10,1
249715,3,21,14,7,9,0
317045,2,7,10,-3,4,1
189933,2,3,7,-4,17,1
72085,4,10,10,0,16,0
265446,1,0,7,-7,16,1
221129,3,0,6,-6,14,0
355586,3,24,3,21,5,0
144906,3,20,7,13,14,0
131719,3,24,22,2,8,1
106564,2,14,0,14,14,1
402424,2,21,7,14,9,0
302304,1,7,0,7,15,0
327891,4,23,24,-1,10,1
55522,2,10,0,10,9,1
249235,3,19,7,12,9,0
108656,2,20,0,20,15,0
322815,3,3,33,-30,7,1
198031,3,0,30,-30,3,0
384290,2,6,0,6,1,1
51271,1,6,0,6,7,0
40221,4,34,7,27,2,0
172849,2,14,3,11,9,1
242381,4,34,13,21,6,0
33943,2,0,27,-27,16,1
344055,1,0,0,0,17,0
224318,3,16,12,4,15,0
111249,3,10,10,0,16,0
408120,1,0,0,0,12,1
29960,1,7,0,7,14,0
210413,1,9,0,9,9,0
11380,2,20,0,20,6,1
90687,1,0,0,0,7,0
56204,1,3,0,3,9,0
269869,4,22,10,12,1,1
200094,1,7,3,4,4,0
372215,4,9,25,-16,13,1
396131,3,17,23,-6,6,0
355001,3,10,19,-9,4,0
270154,4,24,19,5,1,1
20480,2,0,0,0,10,1
164512,3,17,3,14,5,1
101561,3,13,24,-11,12,0
254237,1,0,0,0,11,0
163901,2,16,10,6,5,1
368781,4,21,22,-1,11,1
139104,2,9,3,6,12,0
318022,4,17,13,4,5,0
94604,1,7,0,7,9,0
179319,4,36,11,25,12,1
245083,1,7,0,7,7,0
368614,4,16,6,10,11,0
256355,1,3,0,3,12,1
217888,3,17,21,-4,12,0
352333,1,0,0,0,3,1
88747,2,3,3,0,6,1
68646,2,7,0,7,15,0
339597,3,17,14,3,15,1
309329,4,3,23,-20,1,0
416334,3,16,3,13,15,0
152860,1,0,0,0,1,0
29752,3,34,3,31,14,0
24812,2,6,3,3,12,1
79346,4,32,3,29,2,1
410475,4,9,23,-14,13,1
368380,2,14,0,14,11,1
291743,3,3,14,-11,11,0
110565,2,10,7,3,16,1
306429,2,0,10,-10,17,0
308163,4,16,19,-3,1,0
263904,2,9,0,9,15,0
196080,2,6,21,-15,2,0
162749,1,0,0,0,5,0
27381,4,24,10,14,13,0
293694,4,10,10,0,12,0
89806,2,3,3,0,7,1
339127,3,10,6,4,15,1
186259,1,6,3,3,15,0
152333,2,7,3,4,17,1
97929,1,0,7,-7,11,1
293980,4,7,28,-21,12,1
322794,3,3,27,-24,7,1
296800,3,7,7,0,13,0
379489,4,23,3,20,16,1
302056,2,13,17,-4,15,0
181195,1,0,0,0,13,1
340962,4,10,17,-7,15,1
257950,2,0,7,-7,13,0
375275,1,0,0,0,14,1
147727,3,17,17,0,15,0
217301,2,0,7,-7,12,1
61479,1,0,6,-6,11,0
329841,4,24,23,1,11,0
350047,3,20,10,10,2,0
124603,4,13,17,-4,5,0
162817,2,3,0,3,5,0
263254,1,0,0,0,15,0
153968,1,7,7,0,1,1
404760,2,10,6,4,10,0
210000,2,7,3,4,8,0
22633,3,23,10,13,11,1
281568,1,0,0,0,6,1
334500,1,7,14,-7,13,1
60187,2,3,0,3,11,0
26170,3,0,26,-26,13,1
196073,2,3,21,-18,2,1
176699,3,29,19,10,11,1
349901,3,3,6,-3,2,0
236195,3,17,16,1,3,1
45727,2,7,7,0,4,0
193178,1,0,0,0,1,0
5682,3,0,17,-17,3,0
113061,4,16,16,0,17,0
248630,3,14,10,4,9,0
352980,3,13,10,3,3,1
106015,4,24,3,21,14,1
91205,3,10,17,-7,8,1
369488,4,48,7,41,11,1
286808,1,0,0,0,8,1
108146,4,20,42,-22,15,0
335911,4,28,14,14,13,1
168164,3,19,5,14,7,0
174429,4,17,10,7,10,1
235317,4,25,6,19,3,0
89828,2,6,6,0,7,1
408334,3,10,7,3,12,0
281311,2,14,6,8,6,0
12302,4,6,6,0,6,1
121737,4,21,35,-14,4,1
282002,4,21,28,-7,6,1
143959,3,0,10,-10,14,1
152014,1,0,0,0,17,0
122389,1,0,17,-17,4,1
264061,2,7,20,-13,15,0
107185,2,0,21,-21,15,0
287869,4,28,23,5,9,1
408956,3,24,18,6,12,1
166465,3,17,17,0,6,1
295249,2,14,5,9,12,1
163562,2,7,13,-6,5,0
355539,2,7,0,7,5,1
239749,4,13,13,0,4,0
58864,2,3,9,-6,10,1
122099,2,10,7,3,4,0
8607,2,7,10,-3,4,0
390097,3,10,14,-4,3,1
300122,1,7,3,4,14,0
288481,1,0,0,0,9,1
133540,1,0,0,0,9,0
346951,2,0,3,-3,1,1
302691,4,20,20,0,15,1
98186,4,28,19,9,11,0
109925,4,23,13,10,16,0
245966,4,21,37,-16,7,1
308763,4,10,20,-10,1,0
84102,1,0,0,0,4,1
317665,3,9,6,3,5,0
384097,2,0,10,-10,1,1
47796,1,7,0,7,5,0
157510,1,0,0,0,2,0
93352,4,30,6,24,9,0
38288,4,13,14,-1,1,1
225189,2,3,7,-4,15,0
207799,4,30,16,14,7,1
59680,4,24,6,18,11,0
380888,1,0,0,0,16,1
22126,2,3,6,-3,11,1
313136,2,7,10,-3,3,0
393844,2,10,17,-7,5,1
160277,1,3,0,3,4,0
294521,3,17,13,4,12,1
96566,2,0,3,-3,10,1
59821,4,15,13,2,11,0
411351,3,17,10,7,13,1
275588,2,14,0,14,3,1
325122,1,10,7,3,8,0
396799,1,0,7,-7,6,1
275386,1,0,0,0,3,0
309739,4,19,9,10,1,1
17958,2,13,21,-8,9,1
262621,3,23,10,13,15,1
315629,2,0,0,0,4,1
251482,2,16,3,13,10,1
267970,2,0,3,-3,17,0
59606,2,14,3,11,11,0
192054,4,31,27,4,1,0
403060,4,24,24,0,9,0
312268,4,10,23,-13,2,0
267681,2,7,24,-17,17,1
350245,4,34,0,34,2,0
269774,2,10,0,10,1,1
143503,3,14,21,-7,14,0
271571,2,7,13,-6,2,0
197826,1,6,0,6,3,0
359737,2,17,9,8,6,1
402370,1,0,7,-7,9,0
33657,2,14,0,14,16,0
188747,3,0,17,-17,16,0
263600,2,7,7,0,15,1
34441,3,24,3,21,16,1
367357,1,0,7,-7,10,1
350675,1,0,0,0,2,0
75450,3,24,7,17,17,0
8504,3,15,10,5,4,1
269266,4,10,19,-9,17,0
66202,2,24,3,21,13,0
258698,2,0,17,-17,13,1
48874,3,9,0,9,5,1
328588,2,10,14,-4,10,1
190028,1,7,0,7,17,1
88354,3,24,7,17,6,0
392560,4,10,20,-10,4,0
162409,4,13,27,-14,4,0
138003,2,19,14,5,11,0
178161,1,0,7,-7,12,1
23289,2,0,10,-10,11,1
89349,1,3,6,-3,7,0
186150,2,6,3,3,15,0
331186,3,10,13,-3,11,0
224897,2,0,6,-6,15,1
338997,3,20,3,17,15,0
267118,3,10,10,0,17,1
40294,2,6,0,6,2,1
238650,2,13,14,-1,4,0
321206,4,3,19,-16,6,0
387364,2,21,7,14,2,1
223415,3,13,19,-6,15,0
277673,1,7,0,7,4,0
267134,3,10,10,0,17,1
282300,4,28,17,11,6,0
266578,1,0,0,0,16,0
376685,3,3,0,3,14,1
380799,2,9,21,-12,16,0
39524,1,0,3,-3,1,1
37114,4,16,17,-1,17,0
74890,4,20,20,0,17,0
4800,3,27,0,27,3,0
403869,2,10,0,10,10,0
65269,2,0,14,-14,13,1
253386,2,14,21,-7,11,0
168084,1,6,0,6,7,0
347397,5,21,21,0,1,0
243447,3,3,17,-14,6,0
88615,2,20,7,13,6,0
94143,2,3,7,-4,9,0
286288,3,16,16,0,8,1
416083,4,21,6,15,15,0
332713,2,14,6,8,12,1
242740,2,7,17,-10,6,0
219163,2,0,3,-3,13,0
413933,1,0,0,0,14,1
244047,2,20,17,3,6,0
139338,4,20,13,7,12,1
169592,1,3,0,3,8,0
26425,2,17,10,7,13,0
296314,3,6,13,-7,13,0
256949,4,26,27,-1,12,1
57316,2,7,0,7,10,0
165305,4,17,24,-7,6,0
281132,1,0,0,0,6,0
26432,2,17,16,1,13,1
354322,2,21,3,18,4,1
18134,2,3,17,-14,9,1
79270,1,9,3,6,2,1
364163,4,31,3,28,9,0
205933,2,3,3,0,7,0
350009,2,10,7,3,2,1
392495,2,3,17,-14,4,1
420328,3,17,3,14,17,1
24858,3,13,3,10,12,0
376886,4,28,21,7,15,0
7301,4,17,13,4,4,1
364460,4,35,28,7,9,1
202540,1,7,3,4,5,0
342504,1,0,0,0,16,0
45344,4,20,16,4,4,1
373898,4,37,16,21,13,0
81407,3,10,10,0,3,0
417529,3,24,28,-4,16,1
314693,4,17,28,-11,3,0
9703,4,19,28,-9,5,1
366850,2,3,6,-3,10,0
224105,1,0,0,0,15,0
152542,4,24,7,17,17,0
38803,2,3,10,-7,1,1
76345,2,16,3,13,1,1
102993,4,19,38,-19,13,1
61516,2,7,7,0,11,0
62334,4,21,22,-1,12,1
219517,3,9,21,-12,13,0
16718,1,0,0,0,8,1
99004,1,3,0,3,11,0
168106,1,6,2,4,7,0
269494,2,10,10,0,1,0
244844,3,7,10,-3,7,1
121528,3,9,7,2,4,1
267707,3,14,24,-10,17,0
269409,4,14,17,-3,1,1
327526,2,7,9,-2,10,0
269296,4,13,19,-6,17,1
89423,3,16,20,-4,7,1
77861,4,17,28,-11,1,0
343526,4,10,10,0,16,0
228190,2,7,27,-20,17,1
284077,4,13,10,3,7,0
165441,4,13,36,-23,6,0
212709,1,0,7,-7,10,0
62354,4,24,22,2,12,0
309912,4,24,21,3,1,0
113231,1,0,0,0,17,1
407583,3,10,17,-7,11,1
7548,1,7,0,7,4,1
52345,2,3,10,-7,7,1
133475,3,20,17,3,9,0
56887,2,14,0,14,9,1
284202,3,9,23,-14,7,1
260757,1,3,3,0,14,0
245594,3,40,6,34,7,1
368643,1,0,0,0,11,0
197166,3,27,20,7,3,1
149106,3,17,17,0,16,0
288826,2,10,17,-7,9,0
284427,1,0,9,-9,7,1
312708,3,28,14,14,3,1
69540,2,0,0,0,15,0
99348,3,20,3,17,11,1
146324,1,0,3,-3,15,1
42211,2,17,0,17,2,0
162842,3,3,3,0,5,1
55103,3,23,3,20,8,0
98745,3,28,6,22,11,0
375461,2,10,7,3,14,0
350280,1,14,0,14,2,0
259052,4,3,16,-13,13,0
401900,4,25,28,-3,9,0
111392,3,0,14,-14,16,1
273922,2,7,6,1,2,1
321714,2,3,3,0,7,1
88795,3,13,10,3,6,0
341443,1,0,0,0,16,1
290994,3,20,13,7,10,1
339842,1,16,0,16,15,1
20143,2,10,0,10,10,0
266647,2,16,3,13,16,1
391678,2,0,3,-3,4,0
314136,1,0,7,-7,3,1
64698,2,14,0,14,13,1
70211,4,30,30,0,15,1
338269,4,34,31,3,14,0
209762,4,16,6,10,8,0
25843,2,17,10,7,12,1
16809,3,13,24,-11,8,1
164376,3,23,3,20,5,0
337330,2,14,7,7,14,0
12755,4,59,0,59,6,1
297218,2,0,6,-6,13,1
74632,1,0,3,-3,17,0
6256,3,13,14,-1,3,1
357848,2,6,24,-18,6,1
191437,4,0,31,-31,17,1
411778,3,0,20,-20,13,0
200890,3,17,0,17,4,1
320041,4,49,36,13,6,1
389292,1,0,0,0,3,0
336734,3,10,10,0,14,1
272401,3,24,3,21,2,0
305444,4,20,3,17,17,0
14461,2,24,3,21,7,0
195479,1,0,0,0,2,0
421830,2,0,13,-13,17,1
232374,4,13,15,-2,1,0
57227,4,20,7,13,10,0
33691,3,28,0,28,16,0
395689,4,18,34,-16,6,0
321208,4,3,19,-16,6,0
66239,4,38,3,35,13,1
239757,4,13,13,0,4,1
154463,3,14,7,7,1,1
231183,3,10,7,3,1,1
127853,4,23,42,-19,6,0
401957,2,0,3,-3,9,0
164855,1,0,3,-3,6,0
337515,3,7,12,-5,14,0
195227,3,16,10,6,2,1
41819,4,21,14,7,2,0
74231,2,3,7,-4,17,0
151400,4,34,20,14,17,1
396371,2,20,9,11,6,1
202653,4,34,20,14,5,1
359548,1,0,0,0,6,1
326977,3,2,7,-5,9,1
27308,2,14,3,11,13,1
4442,1,0,0,0,2,0
280808,1,7,0,7,6,1
300964,4,24,27,-3,15,1
335243,1,0,0,0,13,0
38813,3,3,10,-7,1,0
355479,4,23,20,3,4,1
184544,3,27,14,13,14,1
12259,3,3,3,0,6,0
111617,1,7,3,4,16,0
409868,3,30,8,22,12,0
175990,2,14,0,14,11,0
238040,4,10,13,-3,4,1
89346,1,3,6,-3,7,1
330076,2,0,3,-3,11,1
245589,3,40,0,40,7,0
175334,1,0,0,0,11,1
209588,4,41,34,7,8,1
117263,4,33,24,9,2,0
397108,1,3,0,3,6,1
349954,4,18,18,0,2,1
144109,3,16,0,16,14,1
211769,1,0,7,-7,9,1
46508,3,30,6,24,4,0
319278,2,3,3,0,6,0
96481,3,17,17,0,10,0
347919,2,0,14,-14,1,0
278090,4,13,17,-4,4,0
362,2,21,10,11,1,0
411782,3,0,20,-20,13,0
275995,1,0,0,0,3,0
29470,3,10,14,-4,14,0
171737,1,3,7,-4,9,1
28013,1,0,0,0,13,0
83278,4,21,10,11,4,1
397033,3,21,9,12,6,1
53599,4,14,15,-1,8,0
9618,2,12,14,-2,5,0
93823,1,0,0,0,9,0
419947,4,19,18,1,17,0
143841,4,12,7,5,14,1
51576,1,7,3,4,7,1
221790,4,13,21,-8,14,0
381421,4,16,7,9,16,1
35285,2,3,0,3,16,1
319131,2,2,0,2,5,0
93442,3,3,14,-11,9,1
326719,1,0,0,0,9,0
360295,2,0,13,-13,7,1
192845,4,7,15,-8,1,1
147792,1,0,7,-7,15,1
180530,4,21,20,1,13,0
420983,3,14,21,-7,17,0
42820,3,6,28,-22,3,0
24185,2,0,0,0,12,1
269904,1,7,0,7,1,1
40273,2,6,0,6,2,0
260990,4,10,3,7,14,0
223698,3,20,13,7,15,1
77954,2,3,10,-7,1,1
184516,2,17,14,3,14,1
26078,1,0,10,-10,13,1
49759,1,0,7,-7,6,0
76609,2,7,0,7,1,0
353487,1,0,0,0,4,1
302869,4,12,23,-11,15,1
11943,2,0,0,0,6,1
44275,3,17,20,-3,3,0
204680,1,7,0,7,6,0
249706,3,21,14,7,9,1
58149,4,23,17,6,10,0
302661,3,17,13,4,15,1
19233,4,28,19,9,10,1
156237,4,16,23,-7,2,1
284602,2,14,7,7,7,1
240257,1,7,7,0,5,1
162695,3,23,24,-1,5,0
228967,3,14,9,5,17,1
380645,2,7,7,0,16,1
260690,4,10,25,-15,14,1
79483,4,12,14,-2,2,0
161248,2,17,3,14,4,0
58918,3,19,32,-13,10,1
248022,3,28,6,22,8,0
368229,1,0,0,0,11,0
347260,2,0,7,-7,1,1
363677,2,0,10,-10,8,1
401235,2,7,7,0,8,0
281605,2,14,0,14,6,1
415551,2,0,0,0,15,0
356092,4,34,16,18,5,0
2708,3,9,7,2,2,0
364472,4,42,28,14,9,0
60970,2,21,6,15,11,0
296561,1,0,0,0,13,0
362087,3,21,10,11,8,0
245595,3,40,6,34,7,1
165519,2,0,14,-14,6,1
126098,4,20,9,11,6,1
143329,2,0,13,-13,14,0
350674,1,0,0,0,2,0
414234,2,14,14,0,14,0
334962,2,3,7,-4,13,1
95725,4,13,9,4,10,0
116264,2,17,3,14,1,0
175395,2,17,3,14,11,0
5395,3,13,13,0,3,0
330065,2,0,3,-3,11,1
309665,1,3,3,0,1,0
26514,5,30,29,1,13,0
126918,4,17,14,3,6,0
213144,1,0,0,0,10,1
358979,2,7,0,7,6,1
71566,1,3,7,-4,16,0
167777,5,26,26,0,7,1
279004,4,13,30,-17,5,0
366394,2,26,0,26,10,0
21810,1,0,0,0,11,0
87953,4,19,25,-6,6,1
243526,1,0,0,0,6,0
340880,1,0,3,-3,15,1
245792,4,29,20,9,7,1
33886,1,0,3,-3,16,0
122051,4,19,13,6,4,1
402526,1,7,0,7,9,0
82345,3,13,10,3,3,0
170261,2,0,9,-9,8,0
31320,2,7,3,4,15,1
243058,2,0,9,-9,6,0
47660,2,3,17,-14,5,1
128837,4,20,13,7,7,0
178016,3,7,20,-13,12,1
51786,4,10,19,-9,7,0
166730,2,7,3,4,6,0
210316,3,9,10,-1,9,1
1793,2,3,0,3,1,1
10408,4,10,45,-35,5,1
414721,3,3,17,-14,14,1
194970,4,14,22,-8,2,0
292732,2,7,10,-3,11,1
409612,1,0,0,0,12,0
1622,1,0,0,0,1,0
210613,3,13,17,-4,9,0
403135,1,7,7,0,9,1
327788,1,0,0,0,10,0
158542,4,10,17,-7,3,0
348271,4,16,46,-30,1,1
244345,2,0,7,-7,7,0
222810,3,10,13,-3,14,0
332679,1,0,0,0,12,1
209186,2,7,7,0,8,0
406671,3,14,0,14,11,1
204302,3,0,10,-10,6,1
43845,3,21,16,5,3,1
266347,2,10,0,10,16,0
304552,4,18,28,-10,16,0
311030,2,10,0,10,2,0
355367,1,3,3,0,4,1
275724,2,7,0,7,3,0
167846,2,7,13,-6,7,1
227658,4,42,6,36,16,0
19028,3,7,6,1,10,1
352877,4,14,13,1,3,0
218306,2,16,14,2,12,1
298028,1,0,0,0,13,1
119023,4,7,26,-19,3,0
333870,4,28,21,7,12,0
229529,2,17,6,11,17,0
75057,1,0,0,0,17,1
387780,1,0,0,0,2,1
9417,1,0,0,0,5,0
245251,2,6,3,3,7,0
175210,1,7,0,7,10,1
175108,2,14,10,4,10,1
403269,1,3,0,3,9,0
256370,1,6,0,6,12,1
192441,2,0,17,-17,1,0
29641,4,14,21,-7,14,0
300544,4,30,20,10,14,0
180479,2,14,17,-3,13,1
286491,1,3,0,3,8,1
140423,1,7,7,0,12,0
101336,1,3,0,3,12,0
66713,1,0,0,0,14,0
383806,2,3,7,-4,1,1
177593,4,17,10,7,11,0
67439,2,10,7,3,14,0
308247,3,10,13,-3,1,1
50775,4,24,21,3,6,0
410089,2,14,7,7,13,0
333718,4,21,0,21,12,0
330794,1,3,3,0,11,0
171291,2,0,3,-3,9,0
359918,4,23,27,-4,6,0
104706,1,0,0,0,14,1
56214,1,3,0,3,9,0
282934,1,7,0,7,6,1
262753,3,21,0,21,15,0
319299,2,10,3,7,6,0
298310,4,20,13,7,14,0
397181,3,6,0,6,6,1
78224,1,0,0,0,2,0
372852,1,0,0,0,13,1
395462,1,0,0,0,6,0
416272,1,7,3,4,15,1
112900,3,16,6,10,17,0
380314,1,0,0,0,16,1
34124,3,3,3,0,16,1
250532,4,16,13,3,9,0
197463,3,13,9,4,3,1
253305,4,13,13,0,11,0
242030,3,7,3,4,5,0
419446,2,10,6,4,16,1
402363,1,0,0,0,9,0
117736,1,0,0,0,2,0
158823,3,20,3,17,3,1
208125,1,0,0,0,8,0
409856,3,23,0,23,12,0
201076,4,41,10,31,5,1
79685,1,0,0,0,2,1
211991,2,3,13,-10,9,0
52040,2,10,10,0,7,1
201727,1,0,0,0,5,1
366517,1,10,7,3,10,0
407485,4,17,10,7,11,1
20048,3,19,9,10,10,0
291567,2,13,3,10,11,0
319057,4,20,26,-6,5,0
33058,1,3,0,3,16,0
157893,3,6,15,-9,3,1
279963,2,3,10,-7,5,1
177180,1,0,0,0,11,1
242685,4,16,10,6,6,1
24972,2,10,14,-4,12,1
254557,1,0,6,-6,11,0
93502,4,3,31,-28,9,0
52847,3,14,37,-23,7,0
118599,4,31,10,21,2,1
78201,4,41,3,38,2,1
264285,3,10,23,-13,15,1
129065,2,14,21,-7,7,1
195033,2,7,10,-3,2,0
132560,2,2,29,-27,9,1
418803,4,17,24,-7,16,1
80363,3,20,9,11,2,1
421008,4,14,28,-14,17,1
323564,4,34,17,17,7,0
295996,2,3,0,3,13,1
61791,1,0,17,-17,12,1
24013,1,0,0,0,12,0
152375,3,21,3,18,17,1
106027,4,24,3,21,14,1
215525,4,13,3,10,11,1
125238,4,31,21,10,5,0
328095,1,0,0,0,10,0
309666,1,3,3,0,1,0
289830,4,17,23,-6,10,0
167432,1,0,0,0,7,0
321762,3,12,6,6,7,0
52962,2,14,17,-3,7,1
374445,3,32,0,32,14,0
81365,2,0,7,-7,3,1
194054,3,27,7,20,1,0
417813,2,10,0,10,16,0
409778,1,7,0,7,12,1
18823,1,3,0,3,9,1
395835,3,3,17,-14,6,1
78318,3,17,21,-4,2,1
299622,4,19,16,3,14,1
119000,3,0,23,-23,3,1
66395,4,21,27,-6,14,0
194941,4,14,10,4,2,0
360477,4,17,0,17,7,0
212759,2,10,21,-11,10,1
204226,1,0,7,-7,6,1
378875,2,10,13,-3,15,1
201020,2,27,0,27,5,1
380487,1,0,13,-13,16,0
151928,3,20,17,3,17,0
39782,4,9,7,2,1,1
36995,4,6,32,-26,17,1
175878,3,20,27,-7,11,0
232066,3,0,24,-24,1,0
239622,4,20,17,3,4,0
40475,3,7,17,-10,2,0
262454,3,7,21,-14,15,0
313740,2,21,3,18,3,1
107419,1,0,0,0,15,0
407938,4,17,24,-7,11,1
326930,2,2,0,2,9,1
103200,2,3,0,3,13,1
186830,4,29,14,15,15,1
285234,1,0,3,-3,7,0
63680,4,33,36,-3,12,0
94365,3,17,14,3,9,1
332638,3,27,13,14,12,0
24880,4,13,6,7,12,1
145220,4,49,0,49,14,1
264219,1,3,7,-4,15,0
233852,1,7,3,4,2,1
51254,1,3,0,3,7,1
419036,3,7,20,-13,16,0
297173,1,0,0,0,13,1
360406,1,0,0,0,7,1
109056,4,23,41,-18,15,0
94233,4,24,24,0,9,0
116188,4,14,19,-5,1,1
334830,2,10,3,7,13,1
34252,2,10,6,4,16,0
214827,1,0,0,0,11,0
28805,2,3,0,3,14,1
44891,3,7,31,-24,4,1
189155,2,21,0,21,16,1
217015,3,6,3,3,12,1
164240,4,41,38,3,5,0
12198,1,0,0,0,6,0
288591,4,23,38,-15,9,1
56913,3,33,7,26,9,1
199736,4,35,10,25,4,0
290055,2,7,6,1,10,1
225765,2,10,7,3,16,0
38634,1,0,0,0,1,0
45812,4,16,14,2,4,0
34718,2,6,3,3,16,1
331947,1,0,0,0,12,0
185825,1,3,0,3,15,0
391952,1,0,0,0,4,0
226618,3,10,3,7,16,0
257479,2,6,3,3,13,0
409166,4,3,17,-14,12,1
27250,4,22,7,15,13,1
67924,3,19,3,16,14,1
272357,2,21,0,21,2,1
281996,4,21,28,-7,6,1
301393,4,17,10,7,15,0
211288,1,3,0,3,9,0
221229,2,0,16,-16,14,1
372687,4,21,17,4,13,0
76837,4,33,0,33,1,1
340719,1,0,0,0,15,1
135834,3,7,14,-7,10,0
172172,1,0,0,0,9,1
396521,2,17,7,10,6,1
257378,3,17,0,17,13,1
387658,1,0,7,-7,2,0
7368,5,20,22,-2,4,0
307214,3,0,10,-10,17,1
11062,2,10,7,3,5,0
381834,3,10,14,-4,17,1
400957,2,16,7,9,8,1
10717,5,17,17,0,5,1
262421,2,7,7,0,15,1
43869,4,24,16,8,3,1
122547,2,14,0,14,4,1
162548,4,35,10,25,4,0
29829,2,6,3,3,14,0
108176,1,0,0,0,15,1
10366,3,10,35,-25,5,0
249453,4,18,18,0,9,0
105216,2,7,24,-17,14,1
221722,2,10,0,10,14,0
69153,3,14,17,-3,15,0
277595,4,12,14,-2,4,0
163357,4,22,26,-4,5,0
76329,2,13,3,10,1,0
34803,4,20,6,14,16,1
364798,1,0,0,0,9,1
14286,2,2,7,-5,7,1
274296,4,29,16,13,3,1
244240,3,16,7,9,6,1
228973,3,14,9,5,17,1
105970,2,17,0,17,14,0
345332,4,28,24,4,17,1
181216,2,0,0,0,13,0
372782,3,3,0,3,13,1
98085,1,0,0,0,11,1
11289,4,17,28,-11,6,0
98140,3,21,10,11,11,1
389564,4,27,24,3,3,1
383314,4,48,32,16,17,1
379185,3,9,10,-1,16,1
178443,1,7,3,4,12,0
243667,1,0,0,0,6,0
77976,2,3,10,-7,1,0
314035,2,6,0,6,3,0
202647,4,34,20,14,5,0
7939,4,3,26,-23,4,0
66235,4,38,3,35,13,0
121967,2,3,7,-4,4,1
233344,4,19,23,-4,2,0
135154,1,0,0,0,10,0
253669,2,3,0,3,11,1
170686,2,7,3,4,8,0
389368,3,23,13,10,3,0
23680,4,7,27,-20,12,1
106552,1,14,0,14,14,0
348937,1,7,0,7,2,0
322405,4,17,19,-2,7,0
124771,4,3,9,-6,5,1
190939,2,9,0,9,17,1
357474,1,0,0,0,5,0
55390,2,10,7,3,9,1
55226,2,7,0,7,9,0
125,4,7,10,-3,1,1
212581,2,7,10,-3,10,0
279048,1,7,0,7,5,0
352874,4,14,13,1,3,0
165366,2,3,10,-7,6,0
231669,4,23,16,7,1,1
242196,3,16,7,9,6,1
227056,4,17,9,8,16,1
191712,3,10,17,-7,17,1
120114,2,10,3,7,3,1
85901,1,7,7,0,5,1
394165,2,16,10,6,5,0
295802,5,27,27,0,12,0
376641,1,0,0,0,14,1
96365,4,9,30,-21,10,0
286294,3,16,16,0,8,1
203596,1,0,0,0,6,1
39738,3,9,0,9,1,0
6281,4,13,17,-4,3,1
391515,1,7,14,-7,4,0
251919,4,20,19,1,10,1
126700,3,7,13,-6,6,0
192044,4,24,27,-3,1,1
45231,4,14,17,-3,4,0
401881,4,14,28,-14,9,1
251326,1,7,7,0,10,1
325937,3,13,7,6,9,1
95773,1,0,0,0,10,1
397480,3,13,19,-6,6,0
364162,4,31,3,28,9,0
93506,4,3,31,-28,9,1
276366,3,17,35,-18,3,1
161008,3,16,7,9,4,0
168468,3,0,24,-24,7,1
256784,4,13,13,0,12,0
135759,1,0,0,0,10,0
389648,3,24,10,14,3,0
325664,4,24,7,17,9,1
2990,3,13,23,-10,2,0
1455,1,0,0,0,1,1
289679,4,13,23,-10,10,1
198355,4,20,14,6,3,1
27474,2,17,0,17,13,0
72386,4,10,23,-13,16,1
373926,1,0,0,0,13,0
249141,4,28,28,0,9,1
379951,4,24,6,18,16,0
132660,1,0,3,-3,9,1
367773,4,20,27,-7,10,1
399925,3,3,6,-3,8,0
252757,2,3,3,0,11,0
264297,3,10,23,-13,15,0
241241,2,3,0,3,5,1
224597,2,6,7,-1,15,1
330149,4,0,16,-16,11,0
91621,2,14,7,7,8,0
141858,3,17,14,3,13,1
190020,1,7,0,7,17,0
33598,4,17,16,1,16,1
128132,4,13,6,7,7,1
387055,1,7,7,0,2,0
70766,3,20,24,-4,15,1
243081,2,0,9,-9,6,1
384608,3,10,49,-39,1,0
176326,2,13,14,-1,11,1
10573,1,0,0,0,5,0
226304,3,16,7,9,16,1
309798,1,0,0,0,1,1
288248,3,10,28,-18,9,1
205160,2,7,10,-3,6,1
8957,4,28,13,15,4,1
203791,3,17,10,7,6,1
363394,2,14,10,4,8,0
155471,1,0,0,0,2,1
350396,1,0,0,0,2,0
325549,1,0,0,0,9,1
254845,1,0,0,0,12,0
221964,4,22,19,3,14,0
379135,1,6,3,3,16,0
342687,1,0,0,0,16,0
2495,1,0,0,0,2,1
157746,3,10,10,0,2,1
79772,3,20,7,13,2,0
80579,1,0,0,0,3,0
389639,2,17,10,7,3,1
261117,3,21,21,0,14,0
110628,3,17,10,7,16,1
148952,3,10,12,-2,16,0
123425,1,0,0,0,4,0
270163,4,33,27,6,1,1
44761,3,7,12,-5,3,0
217376,4,21,10,11,12,0
323153,1,0,0,0,7,0
164472,2,17,0,17,5,0
45207,4,7,10,-3,4,1
197811,1,6,0,6,3,0
108853,3,7,16,-9,15,0
146321,1,0,3,-3,15,1
222832,4,17,13,4,14,1
364710,3,6,3,3,9,0
191566,4,14,24,-10,17,1
70260,1,7,0,7,15,0
149264,3,10,20,-10,16,1
286997,2,10,7,3,8,0
47712,3,6,17,-11,5,1
127346,3,10,20,-10,6,1
290845,3,17,21,-4,10,1
296708,4,10,16,-6,13,0
174773,1,6,7,-1,10,0
246003,2,0,3,-3,7,0
45634,3,13,13,0,4,0
137189,1,6,0,6,11,1
285217,1,0,0,0,7,0
4957,3,21,17,4,3,1
136331,4,18,7,11,11,0
165372,2,3,10,-7,6,0
294999,4,31,14,17,12,0
402890,3,17,6,11,9,1
181137,4,24,14,10,13,1
22036,3,17,17,0,11,1
304444,1,0,7,-7,16,1
234874,4,3,12,-9,2,1
181933,4,28,35,-7,13,1
45148,2,7,7,0,4,0
255694,4,3,10,-7,12,0
79833,1,0,3,-3,2,1
216424,4,24,23,1,12,0
344609,1,0,0,0,17,0
275690,4,37,18,19,3,1
109237,2,6,0,6,15,0
271607,3,23,20,3,2,1
255804,2,17,0,17,12,0
117627,2,6,10,-4,2,0
207318,3,10,14,-4,7,1
130325,2,7,0,7,8,0
195819,3,20,14,6,2,1
357332,4,21,22,-1,5,0
378956,4,23,30,-7,15,0
305317,4,42,21,21,16,0
133207,3,20,17,3,9,0
291573,2,13,3,10,11,0
414975,2,10,7,3,15,1
78984,2,0,7,-7,2,1
63609,2,13,23,-10,12,0
402671,1,0,0,0,9,1
257911,4,23,19,4,13,0
103859,4,26,0,26,13,0
269629,2,3,0,3,1,1
141476,1,7,0,7,13,0
352858,3,14,10,4,3,0
63492,3,31,13,18,12,0
293186,2,6,7,-1,11,1
303838,4,20,17,3,16,0
324863,2,10,10,0,8,1
349528,1,0,7,-7,2,1
318950,1,0,0,0,5,0
171225,4,9,14,-5,8,1
249598,4,21,16,5,9,0
211941,1,0,3,-3,9,1
400804,2,14,13,1,8,1
282660,2,6,10,-4,6,1
129987,1,0,10,-10,8,1
217271,2,0,7,-7,12,1
414434,3,13,23,-10,14,0
81295,4,10,14,-4,3,1
131677,2,7,22,-15,8,1
412432,1,0,7,-7,14,1
325237,4,19,26,-7,8,1
14587,2,0,7,-7,7,1
180133,2,7,0,7,13,0
27673,4,14,27,-13,13,0
73652,3,10,0,10,17,1
311245,3,6,0,6,2,1
88981,4,39,10,29,6,0
185487,1,0,0,0,15,1
98927,4,7,17,-10,11,1
40922,3,16,20,-4,2,1
91478,2,12,0,12,8,1
39400,2,0,3,-3,1,1
8242,4,16,10,6,4,1
352936,2,10,0,10,3,1
214846,1,0,3,-3,11,1
107470,2,0,17,-17,15,0
238196,2,3,16,-13,4,1
97796,2,7,10,-3,11,1
354409,4,48,10,38,4,0
365800,4,31,17,14,9,0
256871,2,7,3,4,12,0
299312,3,26,10,16,14,1
89849,3,16,6,10,7,0
403700,1,3,3,0,9,0
265209,2,6,6,0,16,1
139280,3,13,13,0,12,1
103416,4,10,23,-13,13,1
126152,1,0,3,-3,6,1
373542,3,10,19,-9,13,0
338655,2,6,0,6,14,0
236609,1,0,0,0,3,0
255600,1,0,0,0,12,0
56239,2,3,7,-4,9,0
329479,2,10,0,10,10,0
12969,1,0,0,0,6,0
339973,1,7,3,4,15,1
401873,3,14,28,-14,9,0
260064,2,3,7,-4,14,0
85872,4,20,29,-9,5,1
208677,4,9,6,3,8,1
238298,1,0,9,-9,4,1
170915,3,14,20,-6,8,1
131104,3,20,6,14,8,0
237746,5,20,20,0,4,1
414197,1,0,0,0,14,0
44210,1,7,7,0,3,1
42372,3,14,9,5,2,0
62928,4,17,10,7,12,0
361433,4,17,24,-7,7,1
205793,2,7,0,7,7,1
185556,2,10,10,0,15,0
50085,2,0,14,-14,6,1
324050,1,0,0,0,8,1
316358,1,0,0,0,4,0
374553,2,17,13,4,14,0
104564,1,0,3,-3,14,1
48514,1,11,0,11,5,0
350678,1,0,0,0,2,0
208558,4,50,23,27,8,1
75893,3,27,7,20,1,1
278341,3,17,14,3,4,0
97850,3,7,27,-20,11,0
283797,4,21,3,18,7,0
84371,1,0,0,0,4,0
42480,2,0,12,-12,3,1
296412,1,7,0,7,13,0
71424,2,17,0,17,16,1
344683,2,6,20,-14,17,1
21719,3,17,14,3,11,1
109282,3,6,0,6,15,1
80465,2,5,0,5,3,0
187902,4,7,23,-16,16,0
259195,4,14,31,-17,13,0
325076,4,33,38,-5,8,1
254523,4,29,13,16,11,1
272816,1,20,0,20,2,0
389159,1,7,0,7,3,1
166625,3,22,20,2,6,0
117518,3,17,17,0,2,0
321580,2,10,6,4,7,1
214113,2,3,6,-3,11,1
211897,4,36,23,13,9,1
379306,2,0,6,-6,16,1
356121,1,7,0,7,5,1
360637,4,10,20,-10,7,0
73732,1,0,0,0,17,1
148773,2,13,13,0,16,1
67895,3,16,3,13,14,1
80663,3,17,16,1,3,0
187314,4,17,13,4,16,0
4392,3,7,14,-7,2,0
317349,2,0,0,0,5,0
210575,2,6,14,-8,9,1
74049,1,3,0,3,17,1
351408,4,13,16,-3,3,1
409363,2,3,3,0,12,1
158661,3,14,7,7,3,1
73072,3,7,10,-3,16,0
264853,1,0,0,0,16,0
145042,3,13,6,7,14,1
67831,1,0,3,-3,14,0
247678,2,7,6,1,8,1
406101,3,0,20,-20,11,0
92816,1,7,0,7,8,1
419344,3,0,17,-17,16,1
226096,2,7,14,-7,16,1
220490,1,0,7,-7,13,1
271404,2,7,0,7,1,0
301951,4,17,20,-3,15,0
18859,2,3,6,-3,9,0
324935,4,23,23,0,8,0
309956,2,3,3,0,2,0
4967,4,24,17,7,3,1
282393,3,10,23,-13,6,1
160283,2,3,0,3,4,1
330230,2,10,14,-4,11,1
359249,1,0,0,0,6,1
415198,4,17,24,-7,15,0
354658,3,10,7,3,4,0
205,2,6,10,-4,1,0
341006,1,0,0,0,15,1
141211,3,3,21,-18,13,0
342593,3,12,20,-8,16,1
173230,4,20,24,-4,9,0
174031,2,0,13,-13,10,1
219850,4,38,0,38,13,1
203102,4,42,17,25,5,0
387200,1,0,0,0,2,0
217196,4,12,16,-4,12,0
3371,4,10,13,-3,2,1
230439,3,21,9,12,1,0
27630,3,7,13,-6,13,0
70878,2,7,17,-10,15,0
30184,3,13,17,-4,14,1
57050,3,7,20,-13,9,0
304037,2,3,13,-10,16,0
223379,2,7,12,-5,15,0
112848,2,7,3,4,17,0
238959,2,14,9,5,4,0
394568,1,0,0,0,5,1
313311,3,6,24,-18,3,1
256329,4,21,17,4,12,0
23108,4,17,17,0,11,1
15370,3,10,9,1,8,1
363819,2,13,10,3,8,1
350189,3,19,0,19,2,0
103993,4,13,13,0,13,0
281856,4,13,7,6,6,1
349196,4,27,14,13,2,1
211355,3,10,10,0,9,0
295777,4,24,16,8,12,0
399490,2,0,24,-24,7,0
277855,2,7,14,-7,4,0
164568,1,0,0,0,5,1
181079,2,10,7,3,13,0
353835,2,7,14,-7,4,1
207928,4,35,14,21,8,0
338035,2,0,0,0,14,0
202836,1,7,0,7,5,1
373726,4,13,21,-8,13,1
278983,3,7,30,-23,5,1
51725,2,0,10,-10,7,0
226120,3,7,17,-10,16,0
187819,2,7,10,-3,16,0
220981,3,14,10,4,14,1
367811,2,10,7,3,10,0
75454,3,31,7,24,17,0
335119,2,3,0,3,13,0
368605,4,16,6,10,11,0
92533,2,10,0,10,8,1
104355,3,45,31,14,13,0
159957,1,0,0,0,3,0
311953,3,35,10,25,2,0
293582,4,27,20,7,11,0
389146,1,0,0,0,3,1
196583,3,20,13,7,2,0
194638,3,24,7,17,2,0
210370,4,22,17,5,9,1
24428,4,16,7,9,12,0
289091,1,0,0,0,9,1
15936,2,6,7,-1,8,0
365920,4,14,21,-7,9,1
254506,4,29,13,16,11,0
228509,3,20,7,13,17,0
17438,4,17,7,10,9,0
266769,2,0,14,-14,16,0
222382,4,24,10,14,14,1
177573,3,10,3,7,11,0
186955,3,7,12,-5,15,1
109185,4,34,14,20,15,1
143372,3,7,16,-9,14,1
303507,4,37,17,20,16,0
233906,3,14,13,1,2,0
300018,2,0,20,-20,14,0
211165,2,0,10,-10,9,1
324790,4,33,14,19,8,1
154195,4,10,13,-3,1,0
102704,4,32,34,-2,13,0
279256,3,16,13,3,5,1
158323,2,6,14,-8,3,0
218558,2,0,14,-14,13,1
12034,4,27,14,13,6,1
255573,4,30,7,23,12,1
193665,1,3,13,-10,1,1
136675,1,0,0,0,11,0
270362,1,0,0,0,1,0
328343,3,3,30,-27,10,0
421359,2,6,10,-4,17,1
222483,2,6,14,-8,14,1
381160,1,0,0,0,16,1
72718,4,34,20,14,16,1
95537,2,6,7,-1,10,1
174087,3,8,36,-28,10,0
98944,4,7,17,-10,11,1
199083,2,7,21,-14,4,0
58661,1,0,0,0,10,1
218445,2,23,14,9,13,1
60672,2,21,3,18,11,0
194561,1,7,0,7,2,0
414074,1,0,0,0,14,0
238616,1,6,0,6,4,0
389192,2,21,0,21,3,0
406354,2,10,7,3,11,1
360486,4,17,6,11,7,1
201355,4,28,13,15,5,0
67396,4,30,13,17,14,1
332794,4,28,15,13,12,0
283517,1,6,0,6,7,0
169028,2,19,14,5,7,1
291362,1,7,7,0,10,1
21993,2,7,10,-3,11,0
270478,4,13,7,6,1,1
358093,1,14,0,14,6,0
184246,3,24,6,18,14,0
47584,4,49,6,43,5,0
342591,3,12,20,-8,16,1
400848,3,24,19,5,8,0
411804,3,0,34,-34,13,0
11841,3,34,17,17,6,0
346427,4,15,19,-4,1,1
15578,1,0,3,-3,8,1
286120,4,16,17,-1,8,0
300,4,18,34,-16,1,1
162858,4,6,3,3,5,1
379827,1,0,0,0,16,1
258039,4,7,38,-31,13,0
246439,1,7,0,7,8,1
36904,1,0,14,-14,17,1
129129,4,34,28,6,7,0
276410,4,32,44,-12,3,1
190836,3,16,3,13,17,1
421102,2,20,3,17,17,0
161800,4,30,6,24,4,0
254377,1,0,0,0,11,0
53777,5,10,10,0,8,1
77796,2,7,14,-7,1,0
240216,4,16,6,10,5,0
381799,2,0,7,-7,17,1
255823,3,17,0,17,12,1
367240,1,3,0,3,10,0
321763,3,12,6,6,7,0
2629,1,0,0,0,2,1
350646,4,13,3,10,2,1
396906,4,27,26,1,6,0
180021,2,14,20,-6,13,0
101905,3,6,13,-7,12,0
354616,2,3,7,-4,4,0
169138,1,0,0,0,7,1
38226,3,13,14,-1,1,1
160489,3,20,7,13,4,1
135771,1,0,7,-7,10,0
101181,1,0,7,-7,12,1
247493,1,0,0,0,8,0
3874,2,16,7,9,2,1
256239,2,6,7,-1,12,1
235581,3,27,13,14,3,0
279528,2,10,6,4,5,1
264186,4,34,27,7,15,1
314896,2,0,0,0,4,0
321659,4,20,20,0,7,0
321242,1,3,0,3,6,0
255829,3,17,0,17,12,0
278852,4,14,24,-10,5,0
318763,3,17,23,-6,5,0
353303,4,38,28,10,4,1
83908,4,23,17,6,4,0
404410,1,0,0,0,10,1
189380,4,27,17,10,16,0
229763,4,20,17,3,17,1
376007,4,26,21,5,14,1
11879,4,41,20,21,6,1
270417,3,10,7,3,1,0
175629,1,0,0,0,11,0
170420,2,21,3,18,8,0
127220,4,16,16,0,6,0
330385,3,7,20,-13,11,1
42848,4,6,37,-31,3,1
265327,2,7,0,7,16,0
307800,3,17,14,3,1,0
285270,2,14,6,8,7,1
230623,4,16,24,-8,1,0
336321,4,20,10,10,13,1
239011,4,29,15,14,4,0
202632,4,24,20,4,5,1
110717,1,3,3,0,16,1
131292,4,21,23,-2,8,0
340076,4,17,15,2,15,1
155481,1,7,0,7,2,0
302515,3,3,10,-7,15,0
43050,2,3,7,-4,3,1
253782,4,24,17,7,11,1
110525,4,20,13,7,16,1
112577,3,24,19,5,17,0
32496,2,7,3,4,15,1
151791,3,14,13,1,17,0
34245,2,10,6,4,16,1
38781,2,0,10,-10,1,1
98618,3,7,7,0,11,1
78208,4,48,3,45,2,1
184573,4,45,21,24,14,1
275752,2,16,3,13,3,1
405501,4,24,16,8,10,0
90434,2,0,13,-13,7,0
400623,1,0,0,0,8,1
193079,2,0,6,-6,1,0
233001,3,10,10,0,2,1
173675,4,20,22,-2,10,0
326582,1,3,0,3,9,0
180535,4,21,20,1,13,0
293203,2,16,7,9,11,1
359263,1,0,3,-3,6,0
309499,1,0,0,0,1,0
78241,1,0,0,0,2,0
45628,3,13,13,0,4,1
158931,2,14,12,2,3,1
382984,4,10,13,-3,17,0
279786,1,7,3,4,5,0
62273,2,21,10,11,12,1
333909,1,0,7,-7,12,1
26967,1,0,0,0,13,1
270257,3,3,21,-18,1,0
335536,2,0,0,0,13,1
133994,1,0,0,0,9,0
255890,1,0,0,0,12,1
296391,4,13,28,-15,13,1
360653,4,17,27,-10,7,1
13703,1,0,7,-7,7,0
290276,4,17,12,5,10,0
54769,2,10,0,10,8,0
159496,1,7,0,7,3,1
319440,2,0,3,-3,6,0
231935,4,7,41,-34,1,1
288384,2,10,0,10,9,0
159877,2,17,0,17,3,1
159084,3,17,0,17,3,1
270588,3,13,14,-1,1,1
398953,4,23,13,10,7,0
131241,2,14,17,-3,8,0
360430,2,10,0,10,7,1
131986,2,0,17,-17,8,1
9825,4,20,17,3,5,0
300280,2,0,7,-7,14,1
333358,2,17,10,7,12,1
120580,2,0,13,-13,3,0
357842,2,6,24,-18,6,1
358587,3,20,9,11,6,0
385259,2,7,3,4,1,0
171531,4,17,10,7,9,1
374499,1,0,0,0,14,1
248036,3,31,13,18,8,0
129609,4,13,23,-10,7,1
386768,2,7,0,7,2,0
98611,3,7,7,0,11,0
299735,3,17,6,11,14,1
274344,1,3,7,-4,3,0
69381,1,6,0,6,15,1
379326,3,10,13,-3,16,1
12916,5,13,13,0,6,1
71530,4,33,14,19,16,1
145783,3,13,10,3,15,0
306893,2,6,13,-7,17,1
414046,4,10,45,-35,14,1
328910,2,6,7,-1,10,1
88858,4,13,16,-3,6,1
355889,3,13,10,3,5,1
287887,1,0,0,0,9,0
311414,1,0,0,0,2,1
320129,3,17,0,17,6,0
268718,2,0,3,-3,17,1
97359,2,2,6,-4,10,1
152812,4,14,10,4,17,1
283387,1,7,7,0,7,0
399010,2,7,9,-2,7,1
244131,4,20,34,-14,6,1
385609,3,6,17,-11,1,0
39045,1,0,0,0,1,1
42236,3,24,7,17,2,1
5509,2,10,10,0,3,0
178255,4,6,13,-7,12,0
405236,2,7,7,0,10,0
289609,2,10,13,-3,10,1
81030,4,23,23,0,3,0
403239,4,24,24,0,9,1
322352,3,14,7,7,7,0
76741,1,0,0,0,1,1
249527,2,14,3,11,9,1
153589,3,12,14,-2,1,1
37488,2,7,7,0,17,1
329527,3,31,14,17,10,1
87239,2,7,14,-7,6,1
130356,3,7,3,4,8,1
72508,3,13,17,-4,16,0
213234,3,10,16,-6,10,1
142386,1,0,0,0,13,0
356938,2,3,3,0,5,1
125847,1,3,0,3,6,0
421553,3,13,3,10,17,0
92848,2,21,0,21,8,1
420057,4,24,14,10,17,0
197547,2,10,0,10,3,0
235662,1,0,3,-3,3,1
260937,2,6,0,6,14,1
393,3,28,17,11,1,1
24141,4,24,14,10,12,0
364096,2,14,3,11,9,0
332574,2,10,3,7,12,0
166939,4,16,6,10,6,0
174480,1,7,7,0,10,0
90685,1,0,0,0,7,0
8197,2,0,7,-7,4,0
137900,3,24,8,16,11,0
13866,2,7,0,7,7,1
15755,2,0,5,-5,8,0
65742,3,14,16,-2,13,0
409468,1,0,0,0,12,0
281513,3,10,13,-3,6,0
59427,1,0,7,-7,11,0
309447,3,7,6,1,1,1
242215,4,23,14,9,6,1
118179,4,31,27,4,2,1
39421,2,3,10,-7,1,1
368494,1,0,0,0,11,0
53432,3,3,28,-25,8,0
96972,4,22,17,5,10,1
226027,5,34,34,0,16,1
419851,2,0,6,-6,17,1
125706,1,0,7,-7,5,0
287102,1,0,0,0,8,1
84086,4,30,32,-2,4,1
107847,4,20,30,-10,15,1
320099,2,10,0,10,6,1
58580,3,10,10,0,10,1
355795,4,10,12,-2,5,1
225498,3,0,14,-14,15,0
363720,3,16,13,3,8,1
400036,1,7,3,4,8,1
277657,1,6,0,6,4,1
175632,1,0,0,0,11,1
365121,2,0,14,-14,9,1
38362,2,7,6,1,1,0
336976,1,0,0,0,14,1
373289,4,16,30,-14,13,1
195421,4,24,3,21,2,0
201619,2,7,10,-3,5,0
262866,2,7,20,-13,15,1
247780,4,10,6,4,8,1
371747,3,14,14,0,12,0
82950,3,6,16,-10,4,0
246809,3,3,20,-17,8,1
71752,3,17,23,-6,16,0
219619,2,10,0,10,13,0
101342,1,3,0,3,12,1
326649,3,16,6,10,9,0
192642,3,10,7,3,1,1
70546,1,0,7,-7,15,1
145477,3,16,17,-1,14,0
268955,4,6,36,-30,17,1
254341,4,13,27,-14,11,0
210962,4,33,23,10,9,1
258368,1,7,0,7,13,0
157381,2,3,7,-4,2,1
220521,2,0,14,-14,13,0
332630,3,27,13,14,12,1
164515,3,17,3,14,5,0
270745,4,6,3,3,1,0
412349,3,16,17,-1,13,1
421513,2,3,3,0,17,1
28019,1,0,7,-7,13,1
81171,4,16,29,-13,3,1
97971,2,7,10,-3,11,1
88357,4,24,7,17,6,1
412020,1,7,0,7,13,0
262264,2,3,6,-3,15,0
211375,4,10,10,0,9,0
407389,2,0,7,-7,11,1
104814,4,27,33,-6,14,1
12772,1,0,0,0,6,1
354429,1,7,7,0,4,1
318091,2,9,7,2,5,0
103755,1,0,0,0,13,0
305641,1,0,0,0,17,1
178429,1,0,0,0,12,1
194870,2,0,10,-10,2,1
352727,4,24,6,18,3,1
325486,3,19,6,13,8,1
42025,2,13,7,6,2,0
4978,4,24,17,7,3,0
121242,4,21,30,-9,3,1
135836,3,7,14,-7,10,0
371304,2,21,10,11,12,0
396350,1,14,6,8,6,0
132743,4,13,17,-4,9,1
175603,4,33,14,19,11,1
255715,4,3,20,-17,12,1
357820,2,3,14,-11,6,1
65191,3,3,3,0,13,0
136639,4,15,19,-4,11,0
241837,2,10,3,7,5,1
289007,3,19,14,5,9,0
213558,4,10,14,-4,10,1
286178,5,24,24,0,8,0
105020,1,0,7,-7,14,1
71355,4,10,20,-10,16,1
375903,2,14,3,11,14,0
54904,1,0,0,0,8,0
12320,4,6,9,-3,6,0
164414,4,33,3,30,5,0
81631,1,0,0,0,3,1
221019,4,21,20,1,14,0
3196,4,16,9,7,2,1
179230,2,17,3,14,12,1
118677,2,14,6,8,2,1
264335,4,17,36,-19,15,0
339875,2,23,0,23,15,1
186043,3,24,34,-10,15,1
144953,4,20,14,6,14,1
115487,1,0,0,0,1,0
262287,2,10,9,1,15,0
194208,4,12,17,-5,1,0
306662,4,14,35,-21,17,1
95582,3,9,10,-1,10,1
232827,4,16,17,-1,2,0
297145,4,38,6,32,13,0
339108,2,10,0,10,15,0
361147,5,23,23,0,7,0
14025,2,3,21,-18,7,1
256681,1,0,0,0,12,0
25062,1,0,0,0,12,1
397504,4,20,22,-2,6,0
202273,2,3,0,3,5,1
77708,4,17,24,-7,1,1
105924,1,0,0,0,14,0
60302,1,0,0,0,11,0
359181,3,10,21,-11,6,1
367713,3,3,13,-10,10,1
27098,4,17,9,8,13,1
38856,4,3,13,-10,1,0
212465,2,10,0,10,10,0
190039,1,14,0,14,17,1
208635,3,6,3,3,8,0
160938,2,7,7,0,4,0
165281,4,17,14,3,6,0
355669,1,0,0,0,5,1
206631,4,10,16,-6,7,0
368428,3,23,7,16,11,0
89715,3,16,20,-4,7,0
309334,4,3,23,-20,1,0
380812,3,9,21,-12,16,0
282732,4,16,30,-14,6,1
327165,4,21,17,4,9,1
108626,1,6,0,6,15,0
293237,3,16,7,9,11,1
336747,3,10,10,0,14,1
124604,4,13,17,-4,5,0
66185,2,24,3,21,13,0
174605,1,0,0,0,10,1
250265,1,7,0,7,9,0
41492,3,8,7,1,2,1
315579,4,7,14,-7,4,0
113916,3,10,9,1,17,0
313170,3,13,13,0,3,0
354899,5,41,42,-1,4,1
128530,4,21,28,-7,7,0
17330,1,14,0,14,9,0
127456,2,3,7,-4,6,0
189876,1,0,7,-7,17,1
373557,3,16,26,-10,13,0
9587,1,3,7,-4,5,1
295883,2,10,14,-4,12,1
210168,3,0,14,-14,9,1
28773,1,0,0,0,14,0
395824,3,3,14,-11,6,1
240400,5,24,23,1,5,1
287788,2,21,10,11,9,1
331136,2,7,13,-6,11,1
270169,4,34,27,7,1,0
116238,1,3,0,3,1,1
228368,3,7,17,-10,17,0
294934,2,7,7,0,12,1
122998,2,0,10,-10,4,1
52730,4,6,23,-17,7,1
238570,4,16,20,-4,4,0
304755,1,0,0,0,16,0
408465,2,7,3,4,12,1
124593,3,6,17,-11,5,0
22244,1,0,0,0,11,1
11372,2,20,0,20,6,0
344288,4,16,13,3,17,0
106711,1,7,5,2,14,0
362610,1,0,7,-7,8,1
271546,1,7,3,4,2,0
200779,4,31,3,28,4,1
312883,4,14,7,7,3,0
131725,4,24,22,2,8,0
421555,3,13,3,10,17,1
333580,4,24,16,8,12,0
350919,3,3,14,-11,3,0
195240,3,16,17,-1,2,1
336014,3,13,18,-5,13,0
241520,1,3,3,0,5,0
314386,4,10,17,-7,3,1
287920,2,14,10,4,9,0
199061,2,0,14,-14,4,1
151115,1,0,0,0,17,1
374084,1,7,0,7,13,0
383478,1,0,3,-3,17,1
344577,4,0,6,-6,17,0
44299,3,17,20,-3,3,1
198335,3,13,14,-1,3,1
258833,2,7,7,0,13,0
215415,1,7,0,7,11,0
155947,1,0,0,0,2,0
27339,2,21,10,11,13,1
47034,2,17,0,17,5,0
153988,2,7,7,0,1,0
421282,3,16,10,6,17,1
81741,3,17,17,0,3,1
69642,4,14,17,-3,15,0
181215,2,0,0,0,13,0
193734,3,3,27,-24,1,1
21622,4,7,38,-31,11,1
194323,3,10,6,4,2,1
230690,2,6,17,-11,1,1
169958,2,13,10,3,8,1
189576,1,0,0,0,17,1
246352,3,17,10,7,7,0
247095,2,10,3,7,8,1
137165,4,31,6,25,11,0
325688,4,34,7,27,9,0
164411,4,33,3,30,5,1
384997,3,17,9,8,1,1
49672,3,7,14,-7,6,0
213692,3,14,17,-3,10,1
174333,2,17,0,17,10,0
146004,1,0,0,0,15,1
274552,3,21,16,5,3,0
339121,2,10,6,4,15,1
291955,1,0,0,0,11,0
270075,2,10,10,0,1,1
294968,3,17,13,4,12,0
80616,2,0,10,-10,3,1
158555,4,13,17,-4,3,0
400588,4,13,31,-18,8,0
173587,2,0,10,-10,10,0
324427,3,14,3,11,8,0
65794,4,27,25,2,13,0
170483,4,21,10,11,8,0
44470,4,17,12,5,3,1
402895,3,17,6,11,9,0
107181,2,0,21,-21,15,1
146646,2,7,14,-7,15,0
30090,1,0,0,0,14,1
382536,3,0,10,-10,17,0
33321,1,0,0,0,16,1
103552,3,33,0,33,13,1
416034,3,14,3,11,15,0
324884,3,10,13,-3,8,1
292432,2,3,0,3,11,0
352757,4,24,13,11,3,0
215783,3,29,6,23,11,0
309758,4,26,12,14,1,1
264076,2,10,20,-10,15,0
220953,2,7,7,0,14,0
105855,3,16,10,6,14,0
385262,2,7,3,4,1,0
396207,1,0,0,0,6,0
324660,1,0,7,-7,8,1
303845,1,0,0,0,16,0
396045,1,7,0,7,6,0
97453,1,6,0,6,10,0
96539,1,0,0,0,10,1
41820,4,21,14,7,2,0
376843,3,21,14,7,15,1
269034,2,10,3,7,17,0
4852,1,0,0,0,3,1
128119,4,10,6,4,7,1
369605,4,20,6,14,11,0
194940,4,14,10,4,2,0
142427,2,7,10,-3,13,1
31429,1,3,0,3,15,1
242836,1,0,0,0,6,1
399309,1,14,7,7,7,0
174065,3,0,33,-33,10,0
226479,3,14,10,4,16,0
381790,2,0,0,0,17,0
5442,4,20,23,-3,3,1
296940,3,26,0,26,13,1
143721,4,19,17,2,14,0
110125,2,7,10,-3,16,0
300707,1,7,0,7,15,1
381470,1,7,0,7,17,0
148321,3,14,3,11,16,0
31945,3,9,13,-4,15,1
322308,2,7,0,7,7,0
388572,1,14,0,14,3,0
303135,3,7,21,-14,16,1
283710,2,0,0,0,7,0
183106,3,7,6,1,14,0
351261,4,28,17,11,3,0
302104,3,27,27,0,15,0
305008,4,24,20,4,16,0
96593,2,3,3,0,10,0
245495,1,0,0,0,7,1
122714,2,7,17,-10,4,1
215540,4,13,3,10,11,0
356471,2,0,3,-3,5,1
337334,2,14,7,7,14,1
324759,4,26,7,19,8,0
304026,2,0,13,-13,16,1
18250,1,0,17,-17,9,1
240850,4,39,10,29,5,0
182033,3,14,14,0,13,1
238312,1,3,9,-6,4,0
262317,3,13,9,4,15,0
338668,2,13,7,6,14,0
335871,3,21,14,7,13,1
402247,2,3,10,-7,9,1
204117,2,3,10,-7,6,0
330590,4,21,7,14,11,1
284209,4,9,23,-14,7,0
130242,4,3,26,-23,8,1
193687,2,3,20,-17,1,0
26068,1,0,0,0,13,0
319938,2,23,7,16,6,0
203,2,6,10,-4,1,0
32201,2,14,7,7,15,1
271564,2,7,13,-6,2,1
416045,3,21,3,18,15,0
267550,3,20,21,-1,17,0
64472,3,21,16,5,13,1
218231,4,37,3,34,12,0
167737,4,26,23,3,7,0
272587,4,13,6,7,2,1
202187,4,13,14,-1,5,1
157707,2,10,3,7,2,0
89765,1,0,0,0,7,1
125278,1,3,0,3,5,0
319158,2,2,0,2,5,0
367553,2,14,9,5,10,0
39547,2,0,3,-3,1,0
404384,4,20,13,7,10,1
317456,1,3,3,0,5,1
199464,4,22,17,5,4,1
293360,2,7,7,0,11,1
202802,4,22,17,5,5,1
395091,3,10,31,-21,5,1
179669,5,31,30,1,12,1
289085,4,41,35,6,9,1
21195,4,0,16,-16,10,0
190477,1,7,0,7,17,0
130155,2,0,16,-16,8,0
221525,1,6,9,-3,14,1
296383,4,13,28,-15,13,1
189459,2,14,0,14,17,0
158258,4,38,0,38,3,0
206044,1,0,3,-3,7,0
125766,2,7,14,-7,5,1
220414,3,23,14,9,13,1
9129,1,0,7,-7,5,1
43979,3,3,14,-11,3,0
161751,3,24,6,18,4,1
160667,3,10,0,10,4,1
419283,2,0,10,-10,16,1
37688,4,30,0,30,17,1
280035,4,3,20,-17,5,1
371371,4,45,10,35,12,0
408229,4,20,3,17,12,0
186632,2,24,3,21,15,0
35882,2,0,0,0,17,0
14747,2,28,0,28,7,0
115437,3,39,7,32,1,0
246893,1,0,7,-7,8,0
92511,1,7,0,7,8,1
173419,1,0,7,-7,10,0
34556,2,7,0,7,16,1
360241,1,0,3,-3,7,1
78880,3,17,0,17,2,1
350985,1,0,6,-6,3,0
157760,3,17,10,7,2,1
237583,4,38,22,16,3,0
119591,2,10,3,7,3,1
259502,4,28,10,18,13,1
269568,4,21,31,-10,1,1
252225,4,23,24,-1,10,1
297149,4,38,6,32,13,1
409793,1,7,0,7,12,1
360308,3,0,13,-13,7,0
193097,3,13,6,7,1,0
90302,2,7,14,-7,7,0
86376,1,7,0,7,5,1
31898,2,6,7,-1,15,0
139412,2,21,0,21,12,0
164153,1,14,6,8,5,0
139524,2,6,0,6,12,0
6607,1,0,0,0,3,1
18360,4,25,20,5,9,1
412148,1,0,3,-3,13,0
419789,4,17,20,-3,17,1
63158,2,14,10,4,12,0
168175,3,26,12,14,7,0
69417,2,14,3,11,15,1
268047,4,21,9,12,17,1
131277,4,14,17,-3,8,1
233616,3,23,41,-18,2,0
85313,2,14,3,11,5,1
243428,2,3,17,-14,6,0
320602,3,31,6,25,6,1
138458,2,21,14,7,12,0
191824,2,10,10,0,1,1
398081,3,21,28,-7,7,1
132832,2,3,7,-4,9,0
262130,2,21,3,18,15,1
194812,4,10,26,-16,2,1
61556,3,28,7,21,11,0
190395,3,7,0,7,17,0
412336,2,10,17,-7,13,0
149089,2,14,14,0,16,0
328432,2,3,0,3,10,0
338565,4,23,31,-8,14,1
235906,4,7,14,-7,3,1
245170,4,17,28,-11,7,1
345929,4,20,23,-3,17,0
167078,4,13,31,-18,7,1
325488,3,19,6,13,8,1
158758,2,0,3,-3,3,0
138069,4,42,17,25,11,0
179724,2,0,10,-10,12,1
404830,4,20,20,0,10,1
154682,1,0,0,0,1,1
87624,4,17,13,4,6,0
249149,4,28,28,0,9,0
391560,2,10,21,-11,4,1
343523,4,10,10,0,16,1
118002,3,20,6,14,2,0
253860,2,28,14,14,11,0
320515,1,6,0,6,6,1
202164,4,13,6,7,5,0
44202,1,7,0,7,3,1
53807,5,10,10,0,8,0
51259,1,3,0,3,7,1
353913,4,17,28,-11,4,1
56443,3,0,35,-35,9,1
321059,4,16,14,2,6,1
345438,3,0,19,-19,17,1
180377,4,15,14,1,13,0
29622,4,14,21,-7,14,1
209784,4,23,6,17,8,0
258103,2,13,13,0,13,1
172094,3,10,9,1,9,0
159597,3,20,12,8,3,1
171106,1,0,0,0,8,1
312386,3,13,27,-14,3,1
364709,3,6,3,3,9,0
39617,4,27,6,21,1,0
324416,3,14,3,11,8,1
376232,3,10,14,-4,14,1
117459,2,7,7,0,2,1
24878,4,13,6,7,12,0
264319,4,17,36,-19,15,0
380651,2,7,7,0,16,0
94477,2,0,0,0,9,0
128274,4,20,7,13,7,0
313591,3,12,20,-8,3,0
103783,2,3,0,3,13,1
344123,3,20,3,17,17,0
55478,4,26,10,16,9,0
46478,2,27,6,21,4,0
314534,4,24,10,14,3,1
332287,2,0,6,-6,12,1
13148,2,10,16,-6,6,1
102756,2,10,0,10,13,0
17098,3,23,3,20,9,0
411558,1,0,10,-10,13,0
22500,4,31,29,2,11,0
22850,1,0,7,-7,11,1
158648,2,14,7,7,3,0
20386,3,10,13,-3,10,1
211582,4,42,21,21,9,1
157619,4,19,3,16,2,1
126412,4,33,17,16,6,0
172716,3,14,10,4,9,0
39504,4,13,19,-6,1,1
101776,4,13,13,0,12,0
205994,3,13,10,3,7,1
113515,4,3,7,-4,17,1
408156,2,6,0,6,12,1
119154,3,10,7,3,3,1
241076,1,13,0,13,5,0
12617,4,3,27,-24,6,0
132031,4,3,24,-21,8,1
313875,2,21,19,2,3,0
347009,3,10,3,7,1,1
84652,4,23,16,7,4,1
345652,1,7,0,7,17,1
157804,4,20,10,10,2,0
149610,4,17,26,-9,16,1
112070,1,7,0,7,17,0
266715,4,49,10,39,16,0
282404,3,10,23,-13,6,1
270982,2,0,14,-14,1,1
285834,4,14,27,-13,8,1
71605,2,3,23,-20,16,0
81732,3,17,17,0,3,0
33111,3,10,21,-11,16,1
17979,2,13,21,-8,9,1
418544,1,14,0,14,16,0
355916,4,34,17,17,5,0
160785,2,10,7,3,4,0
289408,1,0,0,0,10,0
134189,2,0,17,-17,10,0
384544,2,0,28,-28,1,1
195324,1,3,0,3,2,0
129762,4,17,24,-7,7,1
211686,3,23,9,14,9,1
35906,2,0,0,0,17,1
373052,2,0,0,0,13,0
313152,2,10,10,0,3,0
274006,1,0,0,0,3,0
104751,2,17,13,4,14,0
389878,1,6,0,6,3,0
358622,4,27,9,18,6,0
139102,2,9,3,6,12,0
304567,4,25,31,-6,16,1
71843,1,7,0,7,16,1
364630,4,21,37,-16,9,1
97879,4,14,27,-13,11,1
77086,2,7,17,-10,1,1
36181,2,10,14,-4,17,1
264256,2,10,17,-7,15,1
384749,4,13,37,-24,1,1
26708,2,3,7,-4,13,0
335926,1,0,0,0,13,0
135346,2,14,10,4,10,0
78567,2,16,7,9,2,0
354262,4,23,17,6,4,0
130332,2,7,0,7,8,1
317426,4,14,17,-3,5,0
235326,4,32,21,11,3,1
92275,2,10,0,10,8,1
358205,4,23,17,6,6,1
40197,4,33,7,26,2,1
72714,4,34,20,14,16,1
270250,2,3,21,-18,1,1
329669,3,23,14,9,11,0
105037,2,0,14,-14,14,1
329167,1,3,3,0,10,1
393031,1,0,0,0,4,0
202391,1,3,0,3,5,0
1130,4,10,36,-26,1,0
76103,4,13,30,-17,1,1
179507,1,0,13,-13,12,0
290475,1,7,0,7,10,1
404351,3,20,6,14,10,0
133051,4,12,14,-2,9,0
9676,4,12,28,-16,5,1
219301,2,10,7,3,13,1
351269,4,28,17,11,3,1
3649,4,20,28,-8,2,1
150234,4,6,26,-20,16,0
287709,4,16,16,0,9,0
234661,3,20,20,0,2,1
84090,1,0,0,0,4,1
18687,1,0,7,-7,9,0
417328,2,7,3,4,16,1
393414,3,28,24,4,5,1
11198,2,7,7,0,6,0
397046,4,21,9,12,6,0
68698,3,24,0,24,15,0
169063,3,33,14,19,7,0
145758,2,10,10,0,15,0
1316,1,0,0,0,1,1
17264,4,14,34,-20,9,0
340645,2,16,10,6,15,1
46914,3,20,20,0,5,0
253695,2,3,3,0,11,1
415545,2,0,0,0,15,1
116157,3,7,10,-3,1,0
301125,1,7,0,7,15,1
45597,2,7,13,-6,4,1
296648,3,3,16,-13,13,0
166360,1,0,0,0,6,1
88943,3,26,3,23,6,1
345372,2,0,10,-10,17,1
330200,2,7,0,7,11,0
74484,1,0,0,0,17,0
385998,1,0,0,0,1,1
167120,4,22,34,-12,7,1
373210,2,3,13,-10,13,1
181113,3,24,7,17,13,0
71819,4,38,33,5,16,0
108875,4,14,17,-3,15,0
245370,2,9,0,9,7,0
349637,4,13,31,-18,2,0
87037,4,14,22,-8,5,0
301787,3,0,27,-27,15,1
5135,4,13,7,6,3,1
11440,4,26,0,26,6,1
120898,3,21,30,-9,3,0
98182,4,28,19,9,11,0
261119,3,21,21,0,14,0
355397,2,9,10,-1,4,1
362254,4,15,23,-8,8,0
34573,2,14,0,14,16,1
122236,2,3,10,-7,4,1
229320,4,24,27,-3,17,1
179006,4,19,3,16,12,1
380846,4,9,31,-22,16,1
127094,1,3,2,1,6,0
14925,3,14,17,-3,7,1
375365,3,14,24,-10,14,1
324355,1,7,0,7,8,0
313576,2,12,17,-5,3,0
58762,3,10,23,-13,10,0
370849,1,3,0,3,12,0
402117,2,12,0,12,9,0
34789,4,20,3,17,16,0
108878,4,14,17,-3,15,1
142757,2,9,10,-1,13,1
68969,2,21,7,14,15,1
302065,2,13,24,-11,15,1
93070,4,20,20,0,8,0
190187,1,0,0,0,17,0
290128,4,21,15,6,10,0
82018,2,10,0,10,3,0
30197,4,13,17,-4,14,0
312858,3,7,0,7,3,1
351667,3,7,10,-3,3,1
245050,4,14,27,-13,7,1
96975,4,22,17,5,10,1
165665,2,7,7,0,6,0
42624,2,0,7,-7,3,0
319408,1,0,0,0,6,0
124991,2,3,3,0,5,1
310125,2,14,0,14,2,0
171645,3,19,17,2,9,1
387161,4,10,41,-31,2,0
93089,5,20,20,0,8,0
175168,4,35,17,18,10,1
369996,2,7,7,0,12,1
348124,4,17,19,-2,1,0
254074,4,14,23,-9,11,0
170276,2,0,12,-12,8,1
206809,1,0,0,0,7,0
128512,3,21,28,-7,7,0
415157,3,3,21,-18,15,1
58040,1,6,0,6,10,1
196252,3,21,10,11,2,0
144332,1,0,0,0,14,1
61869,3,20,23,-3,12,0
279560,3,10,13,-3,5,0
397847,2,0,0,0,7,0
368701,2,7,16,-9,11,1
131856,3,24,7,17,8,0
202122,2,13,3,10,5,0
170441,3,21,3,18,8,0
86585,3,30,3,27,5,1
130214,3,3,26,-23,8,0
55444,4,20,10,10,9,0
45058,4,23,13,10,4,0
349862,2,3,3,0,2,0
137998,2,13,14,-1,11,0
346856,3,16,6,10,1,1
122806,1,7,3,4,4,1
125972,4,16,23,-7,6,1
228184,2,7,27,-20,17,1
194132,2,3,0,3,1,0
187178,1,0,0,0,16,0
53685,2,0,0,0,8,1
318970,2,0,3,-3,5,0
35132,1,0,7,-7,16,1
168789,4,16,16,0,7,1
111162,1,0,0,0,16,1
325883,1,0,0,0,9,1
83103,3,6,24,-18,4,1
337795,3,23,6,17,14,1
204518,1,0,0,0,6,0
54772,2,10,0,10,8,1
369946,1,0,0,0,12,1
287468,2,14,13,1,9,0
7296,4,17,13,4,4,0
75402,2,10,0,10,17,0
398018,2,14,7,7,7,0
9637,3,12,21,-9,5,1
243768,3,17,17,0,6,0
196323,1,0,0,0,2,0
282743,1,0,0,0,6,0
337407,4,21,14,7,14,0
204082,1,3,7,-4,6,0
400324,1,3,0,3,8,0
347145,3,16,10,6,1,1
140294,2,14,6,8,12,1
40452,3,7,14,-7,2,1
139895,4,23,24,-1,12,0
150041,4,24,6,18,16,1
261921,1,0,0,0,14,0
158932,2,14,12,2,3,1
418546,1,14,0,14,16,0
291961,1,0,0,0,11,0
209589,4,41,34,7,8,1
260751,1,3,3,0,14,1
183676,3,0,8,-8,14,1
274739,4,24,12,12,3,0
65927,3,17,14,3,13,1
402239,2,3,3,0,9,0
318963,1,0,3,-3,5,1
374136,2,16,7,9,13,0
323287,4,7,24,-17,7,1
114652,2,3,3,0,1,0
416507,4,28,17,11,15,0
255280,4,13,17,-4,12,1
380160,1,7,0,7,16,0
379406,1,0,0,0,16,1
205635,2,7,9,-2,7,0
395213,2,10,10,0,5,0
255042,2,3,18,-15,12,0
326667,3,16,6,10,9,1
199327,1,0,0,0,4,1
209797,1,0,0,0,8,0
64552,1,7,0,7,13,0
260280,4,24,3,21,14,1
240338,3,7,23,-16,5,1
163723,2,0,9,-9,5,0
229552,2,17,6,11,17,1
360413,1,0,0,0,7,1
400431,4,24,10,14,8,0
356808,2,0,7,-7,5,1
86214,1,0,7,-7,5,1
212867,1,0,0,0,10,0
52288,4,27,19,8,7,1
382710,3,3,13,-10,17,1
327340,1,0,0,0,9,1
60886,4,17,26,-9,11,1
202998,2,14,0,14,5,0
273649,3,13,6,7,2,0
18084,1,0,14,-14,9,1
229740,3,13,17,-4,17,1
62639,4,17,17,0,12,0
403997,1,0,7,-7,10,0
15645,3,21,10,11,8,0
412010,1,7,0,7,13,1
233000,3,10,10,0,2,1
72030,2,7,10,-3,16,1
286005,4,29,20,9,8,1
158817,3,17,3,14,3,1
141547,3,27,10,17,13,0
217715,2,7,0,7,12,0
32057,2,7,10,-3,15,1
349201,4,27,14,13,2,0
251645,1,3,3,0,10,1
384203,4,32,20,12,1,0
346702,3,24,6,18,1,0
352804,2,14,0,14,3,1
285953,3,26,7,19,8,1
30312,3,3,10,-7,14,1
391423,2,10,16,-6,4,0
388454,2,3,13,-10,2,0
411442,2,7,17,-10,13,1
54936,2,0,3,-3,8,1
187590,4,13,23,-10,16,1
253674,2,3,0,3,11,1
382048,1,0,0,0,17,0
232187,2,6,3,3,1,1
114716,4,15,10,5,1,1
122297,3,6,19,-13,4,0
132890,4,6,20,-14,9,0
75055,1,0,0,0,17,1
273631,2,10,6,4,2,1
197058,1,0,0,0,3,0
284511,4,24,15,9,7,1
2785,1,7,7,0,2,1
110034,3,34,10,24,16,0
1017,1,0,0,0,1,1
349766,4,23,14,9,2,0
196442,4,20,21,-1,2,1
413783,1,0,0,0,14,0
79892,2,3,13,-10,2,0
250434,1,7,0,7,9,0
407003,3,3,20,-17,11,0
317350,2,0,0,0,5,0
69988,2,21,3,18,15,1
350715,2,7,0,7,2,0
154776,3,13,16,-3,1,0
402713,2,10,0,10,9,1
380011,2,7,0,7,16,1
54205,2,0,3,-3,8,1
361983,4,20,6,14,7,0
395831,3,3,14,-11,6,0
134741,2,10,0,10,10,0
178303,2,7,3,4,12,0
388258,1,3,0,3,2,1
353409,3,18,0,18,4,1
274830,1,0,0,0,3,0
94501,2,0,0,0,9,1
146003,1,0,0,0,15,1
342156,4,15,19,-4,16,0
129029,1,0,0,0,7,0
337514,3,7,12,-5,14,0
186134,2,3,3,0,15,1
229537,2,17,6,11,17,0
269972,3,16,13,3,1,1
163169,4,22,28,-6,5,1
417490,2,17,21,-4,16,0
182538,4,35,21,14,14,0
327786,1,0,0,0,10,0
10211,3,6,3,3,5,1
125437,2,10,0,10,5,1
69955,1,21,0,21,15,0
328402,1,0,0,0,10,1
68912,1,0,0,0,15,0
364793,1,0,0,0,9,1
347380,5,21,21,0,1,0
7702,1,10,0,10,4,0
130831,3,13,12,1,8,1
406943,2,3,13,-10,11,1
359405,1,0,0,0,6,1
383189,1,14,0,14,17,0
186402,1,0,0,0,15,1
348688,2,10,10,0,2,1
64723,3,21,0,21,13,0
337311,2,7,7,0,14,0
355622,4,24,10,14,5,0
29349,4,21,16,5,14,1
126537,3,7,6,1,6,1
189955,3,6,7,-1,17,1
295612,4,31,32,-1,12,1
256025,4,25,12,13,12,0
263320,3,17,7,10,15,0
284022,3,3,3,0,7,0
301042,3,17,3,14,15,1
387833,2,10,7,3,2,0
175644,1,0,0,0,11,1
176986,3,13,6,7,11,0
315112,4,53,14,39,4,1
217581,2,3,9,-6,12,0
6385,2,0,13,-13,3,0
139123,2,9,6,3,12,1
166801,4,30,16,14,6,0
2967,2,7,10,-3,2,1
223779,1,0,0,0,15,0
30455,3,17,28,-11,14,1
65960,4,24,21,3,13,0
176156,2,14,7,7,11,0
61350,1,0,0,0,11,1
93508,4,3,31,-28,9,1
119143,3,10,7,3,3,0
68824,2,6,14,-8,15,1
37485,2,7,7,0,17,1
347220,1,0,0,0,1,1
300583,1,0,0,0,15,1
383328,1,0,0,0,17,1
66276,1,0,0,0,14,0
64959,1,0,0,0,13,1
131763,4,24,28,-4,8,1
84873,2,20,17,3,4,1
235104,2,0,7,-7,2,0
86317,4,26,23,3,5,1
345217,2,7,14,-7,17,0
380364,2,10,10,0,16,1
176979,3,13,6,7,11,0
44259,2,17,13,4,3,1
374597,4,20,13,7,14,0
201464,2,12,0,12,5,0
172025,1,0,0,0,9,0
359724,2,17,6,11,6,0
369869,2,7,9,-2,12,1
152979,3,35,17,18,1,0
4035,2,10,7,3,2,0
47000,2,7,0,7,5,1
340958,3,10,17,-7,15,1
213671,2,14,14,0,10,0
217089,1,0,0,0,12,1
78806,1,0,0,0,2,0
312626,1,0,0,0,3,0
31730,1,0,7,-7,15,1
5431,4,20,23,-3,3,1
5296,1,0,0,0,3,0
211240,4,21,26,-5,9,1
53208,1,0,0,0,8,1
73599,1,0,0,0,17,1
259061,4,3,16,-13,13,0
232773,2,13,0,13,2,0
163752,2,0,9,-9,5,0
247311,4,42,28,14,8,0
26093,1,0,10,-10,13,0
24264,4,13,17,-4,12,1
149360,2,3,0,3,16,1
14294,2,2,7,-5,7,0
82044,3,17,7,10,3,0
412662,3,19,10,9,14,1
269959,2,16,13,3,1,0
127057,4,31,23,8,6,0
226170,4,28,34,-6,16,0
102534,4,31,10,21,13,0
169964,2,14,10,4,8,1
304347,3,13,7,6,16,0
356455,2,0,3,-3,5,1
38999,4,30,17,13,1,1
254428,2,20,0,20,11,0
397173,3,6,0,6,6,0
158990,4,21,29,-8,3,1
238703,4,16,17,-1,4,1
246835,4,10,20,-10,8,1
400570,4,13,24,-11,8,0
36020,1,7,0,7,17,0
26480,4,30,19,11,13,0
119683,4,20,19,1,3,0
415893,3,10,20,-10,15,0
344002,4,23,6,17,17,0
228115,4,13,10,3,17,1
23394,4,20,17,3,11,0
274469,4,10,17,-7,3,1
208844,1,0,0,0,8,1
306704,1,3,3,0,17,1
36196,2,10,17,-7,17,1
186296,2,16,3,13,15,1
157902,3,6,15,-9,3,0
8376,3,30,3,27,4,0
206887,3,10,17,-7,7,1
237072,2,0,23,-23,3,1
353071,2,7,6,1,3,0
246343,3,14,10,4,7,1
348837,2,3,14,-11,2,0
254924,3,24,7,17,12,1
305509,1,6,0,6,17,0
135833,3,7,14,-7,10,0
340313,2,10,6,4,15,0
315080,3,37,14,23,4,1
400998,4,22,13,9,8,0
341858,3,13,15,-2,16,1
184416,3,24,6,18,14,0
24786,1,6,0,6,12,1
293542,3,10,17,-7,11,1
37157,1,0,0,0,17,0
125638,3,14,24,-10,5,0
340152,2,20,7,13,15,0
317694,4,23,9,14,5,0
352245,2,3,3,0,3,1
312362,2,13,17,-4,3,0
412697,4,33,10,23,14,1
336876,2,7,14,-7,14,0
48188,4,10,19,-9,5,1
276955,3,17,17,0,4,0
386016,1,7,0,7,1,1
382638,1,0,0,0,17,0
124234,2,7,14,-7,5,0
211525,3,35,14,21,9,1
8728,1,0,0,0,4,1
81669,2,7,14,-7,3,1
156293,1,3,0,3,2,1
234628,2,17,17,0,2,1
243244,2,6,7,-1,6,1
59962,3,3,24,-21,11,0
229708,2,13,10,3,17,1
59432,1,0,7,-7,11,0
209332,2,7,7,0,8,0
256907,3,14,18,-4,12,1
3960,4,22,14,8,2,1
159574,3,17,6,11,3,1
340366,3,17,13,4,15,1
326960,2,2,7,-5,9,1
210523,4,16,28,-12,9,0
405570,2,7,14,-7,10,1
245468,4,23,6,17,7,0
345077,2,6,3,3,17,1
7979,4,16,27,-11,4,1
307862,4,27,28,-1,1,0
117159,2,6,3,3,2,1
284829,4,29,26,3,7,0
2568,3,10,17,-7,2,0
82961,3,6,16,-10,4,1
209423,4,14,17,-3,8,1
124798,1,0,0,0,5,0
274875,2,7,10,-3,3,0
30207,4,13,24,-11,14,0
124814,1,0,3,-3,5,1
285941,3,26,7,19,8,0
322805,3,3,27,-24,7,0
268408,1,7,0,7,17,1
130774,2,13,3,10,8,0
360733,2,17,14,3,7,1
103362,2,10,17,-7,13,0
301481,3,20,9,11,15,0
78499,4,24,0,24,2,1
155854,2,7,10,-3,2,1
313661,4,25,30,-5,3,1
64712,2,21,0,21,13,0
403,3,31,17,14,1,0
122569,2,14,7,7,4,1
160037,3,10,26,-16,3,1
30634,4,17,9,8,14,1
279126,3,21,20,1,5,0
123083,4,14,21,-7,4,1
104917,2,3,6,-3,14,0
223326,1,0,0,0,15,0
140154,3,10,3,7,12,0
416089,4,21,13,8,15,1
24668,2,17,6,11,12,0
188553,2,3,10,-7,16,1
165231,2,14,7,7,6,0
124054,2,0,7,-7,5,0
415053,4,13,27,-14,15,0
239409,2,6,10,-4,4,1
109571,2,16,7,9,16,0
61788,1,0,10,-10,12,0
325381,4,15,20,-5,8,1
362466,2,0,6,-6,8,0
11215,2,7,14,-7,6,1
266554,4,10,22,-12,16,1
54762,2,3,0,3,8,1
141116,1,0,0,0,13,0
378614,4,20,20,0,15,1
174682,3,9,7,2,10,1
366433,3,26,10,16,10,1
284033,3,3,3,0,7,1
365308,3,10,16,-6,9,1
156537,4,14,6,8,2,0
66568,1,0,7,-7,14,0
123314,2,14,7,7,4,1
395628,2,7,17,-10,6,1
412782,2,14,17,-3,14,1
67967,4,29,13,16,14,1
363112,3,7,3,4,8,1
117874,4,12,20,-8,2,0
143968,3,7,10,-3,14,0
275524,4,26,36,-10,3,1
239452,3,9,17,-8,4,1
336357,4,20,20,0,13,0
300724,2,7,0,7,15,0
271548,1,7,3,4,2,0
295855,2,7,14,-7,12,0
377558,3,10,9,1,15,1
134583,2,10,3,7,10,1
377395,2,7,13,-6,15,0
369626,4,23,14,9,11,0
283553,2,6,14,-8,7,0
39572,2,14,6,8,1,0
102758,2,10,0,10,13,0
231497,4,23,12,11,1,0
343231,3,16,0,16,16,1
72235,4,24,17,7,16,0
16516,3,20,13,7,8,1
114883,4,24,33,-9,1,0
247747,3,10,6,4,8,0
156582,1,0,0,0,2,0
148390,4,17,6,11,16,1
359295,2,3,13,-10,6,1
219995,4,16,28,-12,13,0
33644,2,14,0,14,16,0
65009,2,0,14,-14,13,0
5829,3,27,7,20,3,0
8317,2,9,0,9,4,0
350487,3,7,19,-12,2,1
19017,3,7,3,4,10,1
351120,4,37,37,0,3,1
22643,3,23,10,13,11,1
93041,3,13,9,4,8,0
52549,3,16,7,9,7,1
245220,1,0,0,0,7,1
319406,1,0,0,0,6,0
2496,1,3,0,3,2,1
215621,2,14,3,11,11,0
118721,4,20,9,11,2,0
281845,3,13,0,13,6,0
262615,3,23,10,13,15,1
208605,2,6,3,3,8,1
324317,4,25,7,18,8,1
292958,4,10,0,10,11,0
287418,1,0,0,0,9,1
164623,3,7,17,-10,5,0
407693,1,0,0,0,11,0
205921,1,3,3,0,7,0
232366,3,13,15,-2,1,1
216267,4,24,20,4,12,0
285723,1,0,3,-3,8,1
88048,3,24,3,21,6,1
363578,4,10,15,-5,8,0
152118,4,13,13,0,17,0
238193,2,3,16,-13,4,0
59401,4,0,16,-16,11,1
291677,1,0,0,0,11,0
411095,1,0,0,0,13,0
349474,3,6,20,-14,2,1
52548,3,16,7,9,7,1
197652,4,33,7,26,3,0
27556,4,23,18,5,13,1
235826,1,0,7,-7,3,0
419693,1,0,3,-3,17,0
352339,1,7,0,7,3,0
152869,1,0,7,-7,1,1
302185,2,21,0,21,15,0
354706,4,17,17,0,4,0
374871,3,14,3,11,14,1
330437,4,13,20,-7,11,0
121360,3,7,0,7,3,0
24461,4,16,7,9,12,1
154100,1,0,3,-3,1,1
352932,2,10,0,10,3,0
286135,4,16,17,-1,8,1
179984,1,7,6,1,13,0
235522,2,0,13,-13,3,1
150916,3,7,7,0,17,1
277770,4,17,6,11,4,0
249183,1,9,0,9,9,0
101176,1,0,0,0,12,0
132622,4,20,49,-29,9,0
350709,2,7,0,7,2,0
292449,2,3,6,-3,11,0
189722,1,0,3,-3,17,0
260863,4,36,15,21,14,1
140285,2,13,6,7,12,1
79303,2,12,3,9,2,0
310405,1,7,0,7,2,0
148761,2,13,6,7,16,0
8354,3,16,3,13,4,1
338561,4,23,31,-8,14,0
208287,1,0,14,-14,8,1
92448,3,20,10,10,8,1
260108,4,6,27,-21,14,0
53759,4,10,3,7,8,0
48538,2,11,7,4,5,1
195086,3,7,26,-19,2,0
163683,1,0,0,0,5,0
219874,4,51,0,51,13,1
137223,2,7,10,-3,11,1
197026,4,23,20,3,3,0
325377,4,15,20,-5,8,1
410127,3,17,10,7,13,1
377036,4,22,29,-7,15,0
340603,1,6,0,6,15,0
19507,4,33,17,16,10,1
317283,4,14,19,-5,5,1
250305,2,7,7,0,9,1
6724,4,3,23,-20,3,0
106502,4,36,9,27,14,0
87861,2,10,9,1,6,1
35149,2,0,7,-7,16,1
228910,1,7,3,4,17,1
239724,3,10,10,0,4,0
34167,4,10,10,0,16,0
56427,2,0,35,-35,9,1
301370,4,17,7,10,15,0
6654,2,3,10,-7,3,0
97599,1,0,0,0,11,1
322996,4,20,0,20,7,0
61360,1,7,0,7,11,0
59162,1,0,28,-28,10,1
247452,3,13,9,4,8,1
228686,3,16,23,-7,17,0
415069,4,13,34,-21,15,0
259633,3,6,6,0,13,1
38790,2,3,10,-7,1,0
164171,2,17,7,10,5,0
181274,3,0,13,-13,13,1
8991,1,0,0,0,4,0
37849,4,14,9,5,1,1
294102,4,7,27,-20,12,1
9333,3,21,7,14,5,1
324401,2,14,3,11,8,0
326563,4,51,22,29,9,1
60054,2,7,3,4,11,0
241981,2,7,0,7,5,1
128958,2,25,3,22,7,1
239334,4,3,17,-14,4,1
72006,1,0,10,-10,16,0
229134,3,19,7,12,17,1
314813,3,28,7,21,4,1
201021,2,27,0,27,5,1
314175,2,7,20,-13,3,0
140564,1,7,7,0,12,1
57280,1,0,0,0,10,1
64592,2,17,14,3,13,0
212679,4,9,31,-22,10,1
390455,4,21,33,-12,3,1
200630,3,27,21,6,4,1
212013,3,9,23,-14,9,1
168399,1,0,3,-3,7,0
258210,1,0,0,0,13,0
271504,4,21,0,21,1,1
176656,2,20,12,8,11,0
403653,4,30,20,10,9,1
419543,1,0,7,-7,17,1
153419,3,13,10,3,1,0
233063,1,0,0,0,2,1
93147,2,0,0,0,9,1
8306,1,0,0,0,4,1
107352,3,16,6,10,15,0
146931,1,7,0,7,15,0
205374,3,27,0,27,6,0
47496,2,10,3,7,5,1
297253,3,21,6,15,13,0
305337,1,0,0,0,17,1
387612,4,13,6,7,2,1
48648,1,0,0,0,5,1
42417,4,14,22,-8,2,0
283287,3,10,9,1,7,1
105879,4,19,10,9,14,0
258180,4,13,13,0,13,0
195847,4,27,21,6,2,1
320133,3,17,0,17,6,0
199717,3,28,10,18,4,0
129233,3,14,6,8,7,0
320298,3,14,21,-7,6,0
104307,2,31,21,10,13,1
225283,1,0,7,-7,15,0
344229,2,7,10,-3,17,1
378020,3,0,7,-7,15,1
413846,2,14,6,8,14,0
116416,2,3,3,0,1,0
178627,2,3,3,0,12,0
293680,3,10,10,0,12,1
148429,2,7,0,7,16,1
287328,2,13,0,13,8,0
150185,3,6,26,-20,16,0
192241,1,3,0,3,1,0
340157,2,20,7,13,15,1
169458,1,0,7,-7,8,1
28267,3,17,14,3,13,1
18173,4,20,20,0,9,0
146601,4,21,38,-17,15,0
309522,1,3,0,3,1,1
343252,4,22,0,22,16,0
21893,3,28,0,28,11,0
204434,2,7,17,-10,6,1
128154,1,0,0,0,7,1
250466,2,13,0,13,9,0
252550,4,29,32,-3,10,0
200139,3,7,24,-17,4,0
155755,4,27,23,4,2,0
355708,2,7,3,4,5,0
52793,2,0,23,-23,7,0
355836,2,13,0,13,5,0
335609,4,19,7,12,13,0
311607,2,6,0,6,2,1
359370,4,10,20,-10,6,0
180171,3,10,0,10,13,1
176151,2,14,7,7,11,0
177122,3,24,13,11,11,0
107017,1,10,0,10,15,0
132983,2,3,14,-11,9,0
240153,2,13,3,10,5,1
193026,1,0,0,0,1,1
241028,5,30,30,0,5,0
102792,3,10,3,7,13,0
103309,1,0,3,-3,13,1
308041,1,0,7,-7,1,1
405217,1,0,7,-7,10,1
270398,2,10,0,10,1,0
393428,3,28,24,4,5,0
106458,3,16,0,16,14,0
262253,2,3,6,-3,15,1
126976,2,10,10,0,6,0
363024,4,33,26,7,8,0
374167,3,23,7,16,13,0
112409,3,13,13,0,17,0
334,1,14,3,11,1,1
196782,1,0,7,-7,3,1
382612,1,0,0,0,17,1
415999,2,7,0,7,15,0
210044,4,10,17,-7,8,1
179710,1,0,7,-7,12,1
217293,2,0,7,-7,12,0
107769,2,7,13,-6,15,0
410298,3,7,16,-9,13,0
396744,4,7,17,-10,6,0
345252,2,13,14,-1,17,1
344103,2,10,3,7,17,1
313894,3,28,19,9,3,0
89045,2,6,3,3,6,0
272847,2,20,0,20,2,1
283419,2,20,7,13,7,1
124140,3,13,21,-8,5,1
55740,4,23,29,-6,9,0
336152,3,10,3,7,13,1
113939,4,17,10,7,17,1
268701,1,0,0,0,17,0
304169,1,0,0,0,16,1
339788,4,24,13,11,15,1
43546,3,17,3,14,3,0
249023,1,7,3,4,9,1
246268,4,24,16,8,7,1
304000,1,0,7,-7,16,0
159699,1,7,7,0,3,0
259775,3,17,10,7,14,1
331246,1,0,0,0,11,0
285815,4,14,24,-10,8,0
315192,2,10,10,0,4,1
409032,1,0,0,0,12,1
333049,2,10,12,-2,12,0
12595,4,3,24,-21,6,1
272414,3,31,3,28,2,0
335533,2,0,0,0,13,0
179618,4,31,23,8,12,1
117799,2,6,6,0,2,0
270175,4,34,27,7,1,0
245410,2,9,3,6,7,1
77785,2,7,14,-7,1,0
98164,3,21,13,8,11,0
196594,4,20,20,0,2,1
146183,1,0,3,-3,15,1
124418,2,6,7,-1,5,1
417953,2,14,14,0,16,0
144403,2,0,10,-10,14,0
25432,3,13,10,3,12,0
274497,1,14,3,11,3,0
247338,4,42,48,-6,8,1
243701,2,14,3,11,6,0
135090,3,17,6,11,10,0
413186,1,0,0,0,14,0
399062,3,10,19,-9,7,0
20027,3,19,6,13,10,1
91492,3,19,0,19,8,0
322635,3,3,6,-3,7,1
339654,4,31,24,7,15,0
11179,1,0,0,0,6,0
250264,1,7,0,7,9,0
202155,3,13,3,10,5,0
193733,3,3,27,-24,1,1
187181,1,0,0,0,16,0
144606,4,20,19,1,14,0
419741,3,10,10,0,17,1
219042,3,24,7,17,13,1
141135,1,3,7,-4,13,0
141117,1,0,0,0,13,0
58166,4,29,17,12,10,0
18872,3,3,6,-3,9,0
360567,2,7,7,0,7,0
65116,1,0,0,0,13,1
332557,1,3,3,0,12,0
293045,2,10,13,-3,11,0
208563,1,0,0,0,8,1
117521,3,17,17,0,2,1
63782,3,14,24,-10,12,1
85613,1,7,0,7,5,1
251154,4,10,27,-17,10,1
38880,4,10,15,-5,1,0
16483,2,13,0,13,8,1
372850,1,0,0,0,13,1
386289,1,0,0,0,2,0
330508,2,7,7,0,11,0
125981,4,23,23,0,6,0
343839,3,24,3,21,17,0
183300,4,22,20,2,14,0
358510,1,0,0,0,6,0
339618,3,24,17,7,15,1
179801,4,6,27,-21,12,0
204172,4,23,17,6,6,1
149015,4,13,19,-6,16,0
83612,4,10,17,-7,4,1
301965,4,17,20,-3,15,1
400229,2,10,6,4,8,1
120009,4,23,31,-8,3,0
254979,4,45,14,31,12,0
273992,4,7,29,-22,2,0
330444,4,13,20,-7,11,1
50511,1,0,0,0,6,0
342238,2,3,0,3,16,1
374937,1,0,0,0,14,0
108500,2,13,7,6,15,1
71293,2,7,10,-3,16,0
41871,1,7,3,4,2,1
158998,4,27,29,-2,3,0
421533,3,10,3,7,17,1
47305,2,0,7,-7,5,0
324303,3,25,7,18,8,0
323965,2,17,10,7,8,0
329031,1,0,7,-7,10,1
374616,4,20,20,0,14,1
311059,2,10,3,7,2,1
238804,2,20,0,20,4,1
173826,4,20,3,17,10,0
225597,2,0,7,-7,16,0
62541,1,0,0,0,12,1
66932,3,12,7,5,14,1
144513,1,0,7,-7,14,0
58627,4,13,17,-4,10,0
397580,2,6,20,-14,7,1
44169,4,13,20,-7,3,0
67110,1,0,0,0,14,1
314838,4,35,14,21,4,0
59453,2,3,10,-7,11,0
367520,1,7,0,7,10,0
301089,4,33,13,20,15,0
109039,4,23,34,-11,15,0
131597,4,9,26,-17,8,1
281591,1,7,0,7,6,1
185639,4,20,27,-7,15,1
155302,1,0,0,0,2,1
404630,3,13,13,0,10,0
225486,2,0,7,-7,15,0
333607,1,0,0,0,12,1
308326,1,0,0,0,1,0
140854,2,14,0,14,13,1
367302,3,3,17,-14,10,1
123023,3,7,13,-6,4,0
282990,3,14,3,11,6,1
129483,5,29,26,3,7,0
72461,2,7,10,-3,16,1
92735,3,3,17,-14,8,1
276977,4,17,20,-3,4,1
52395,3,9,17,-8,7,1
352696,3,17,3,14,3,0
80849,4,3,3,0,3,1
242085,4,20,16,4,5,0
103415,4,10,23,-13,13,1
215980,4,20,42,-22,11,1
325447,2,13,3,10,8,1
321191,4,3,19,-16,6,0
359165,3,7,7,0,6,1
167522,3,0,10,-10,7,1
193762,4,10,27,-17,1,0
27687,4,14,30,-16,13,1
11487,2,6,7,-1,6,1
291627,4,23,13,10,11,1
154676,4,34,28,6,1,0
183271,3,13,20,-7,14,1
327104,2,7,3,4,9,0
142566,1,0,3,-3,13,1
119738,2,10,3,7,3,0
77005,4,17,20,-3,1,0
138074,4,42,24,18,11,1
280536,2,7,0,7,5,0
80907,1,6,0,6,3,1
165437,4,6,36,-30,6,1
121265,4,28,30,-2,3,0
235713,3,3,17,-14,3,1
145008,2,3,3,0,14,1
160522,3,20,14,6,4,1
330183,1,0,0,0,11,1
416419,1,7,0,7,15,0
340173,2,20,13,7,15,0
48301,3,13,13,0,5,1
351522,2,0,27,-27,3,1
302660,3,17,12,5,15,0
398059,2,20,21,-1,7,1
241938,4,30,27,3,5,0
294898,1,0,0,0,12,0
298360,2,0,14,-14,14,1
342754,3,7,7,0,16,0
15573,1,0,3,-3,8,0
136046,4,6,10,-4,10,0
100274,1,6,0,6,12,0
93566,2,6,3,3,9,0
30244,1,3,0,3,14,0
261506,2,6,0,6,14,1
88064,3,24,3,21,6,1
202972,1,7,0,7,5,0
183822,3,20,21,-1,14,1
315205,3,10,10,0,4,0
420568,1,0,0,0,17,0
97717,4,9,13,-4,11,1
328655,4,27,35,-8,10,0
290860,4,17,21,-4,10,1
251080,2,10,14,-4,10,0
30758,4,31,28,3,15,1
162007,1,14,3,11,4,0
122324,4,6,19,-13,4,1
77046,1,7,7,0,1,0
271123,2,0,10,-10,1,0
314998,1,7,0,7,4,1
267715,3,14,27,-13,17,0
180388,4,15,14,1,13,1
42118,4,27,27,0,2,1
66101,4,10,6,4,13,1
291000,3,20,13,7,10,0
12687,2,31,0,31,6,1
3763,3,20,10,10,2,1
237555,4,31,14,17,3,1
43751,1,14,0,14,3,0
174001,1,0,6,-6,10,1
111618,1,7,9,-2,16,0
291287,3,14,19,-5,10,1
107529,4,3,23,-20,15,0
359213,4,21,21,0,6,0
129637,4,23,23,0,7,0
98812,1,0,0,0,11,1
311599,2,6,0,6,2,1
255807,3,17,0,17,12,1
211250,4,21,26,-5,9,1
298107,3,3,31,-28,13,1
257467,1,0,3,-3,13,1
158316,2,6,14,-8,3,1
210516,4,9,28,-19,9,1
2422,3,21,13,8,2,0
75182,4,13,6,7,17,1
390254,3,3,6,-3,3,1
123632,2,0,3,-3,4,1
332765,3,28,9,19,12,0
156607,2,0,0,0,2,1
262710,2,7,0,7,15,1
16619,2,7,27,-20,8,1
311387,4,35,13,22,2,0
14119,1,0,7,-7,7,0
202494,4,9,16,-7,5,1
269566,4,21,31,-10,1,1
414690,2,3,10,-7,14,0
162745,4,35,24,11,5,0
139502,1,3,0,3,12,0
217618,3,19,15,4,12,0
375985,4,20,15,5,14,1
200813,4,38,17,21,4,0
266827,4,17,14,3,16,0
244418,4,3,20,-17,7,0
316099,2,17,13,4,4,1
178931,2,6,3,3,12,0
207780,4,24,16,8,7,1
259854,1,7,7,0,14,0
260308,1,0,0,0,14,1
228226,3,10,27,-17,17,1
267820,2,13,14,-1,17,1
121578,4,22,13,9,4,0
256889,2,7,10,-3,12,1
368737,3,14,16,-2,11,0
63659,4,20,36,-16,12,0
31713,1,0,0,0,15,1
301662,4,10,6,4,15,1
299945,4,16,11,5,14,0
180394,4,22,14,8,13,0
171420,1,0,0,0,9,0
281886,4,16,17,-1,6,1
330625,1,0,0,0,11,1
105592,4,32,28,4,14,1
110640,3,20,10,10,16,1
125548,1,0,0,0,5,0
333231,3,6,7,-1,12,0
111516,2,7,3,4,16,1
37525,3,10,7,3,17,0
85759,2,7,7,0,5,0
316048,1,0,0,0,4,1
25350,1,3,0,3,12,0
35560,1,7,0,7,17,1
409216,2,10,3,7,12,1
419756,3,10,17,-7,17,1
398704,1,0,7,-7,7,1
417770,5,35,35,0,16,1
318432,2,21,7,14,5,0
376082,2,0,3,-3,14,0
410003,3,6,35,-29,12,0
119305,3,14,13,1,3,1
308503,1,0,6,-6,1,0
279021,4,13,33,-20,5,1
184335,1,0,6,-6,14,0
344342,1,7,0,7,17,1
86897,4,9,26,-17,5,1
8185,2,0,7,-7,4,0
279180,1,0,0,0,5,0
405443,3,21,10,11,10,0
216121,1,0,0,0,12,1
398788,3,14,24,-10,7,1
76040,2,10,13,-3,1,0
217692,1,7,0,7,12,1
336424,2,10,9,1,14,0
314655,3,14,14,0,3,0
21540,2,7,7,0,11,0
49755,1,0,7,-7,6,1
40306,3,6,0,6,2,0
275954,4,20,21,-1,3,0
238203,3,3,16,-13,4,0
400950,2,16,7,9,8,0
10512,3,20,0,20,5,0
396796,1,0,0,0,6,0
359179,3,10,21,-11,6,1
251646,1,3,3,0,10,1
58708,2,7,10,-3,10,1
406582,4,20,37,-17,11,1
127424,1,0,0,0,6,1
248230,4,12,10,2,8,0
419301,2,0,10,-10,16,0
186341,3,29,10,19,15,0
334676,2,15,3,12,13,0
406307,1,0,0,0,11,0
44325,4,24,23,1,3,1
102587,2,5,6,-1,13,1
333681,3,14,0,14,12,0
289876,2,6,3,3,10,0
259160,3,14,13,1,13,0
45428,2,7,7,0,4,0
151833,4,28,16,12,17,1
331911,4,0,16,-16,12,1
61741,4,24,31,-7,12,0
369822,1,0,0,0,12,0
240503,3,3,7,-4,5,1
322292,1,7,0,7,7,1
138161,2,7,9,-2,11,0
251556,3,16,13,3,10,1
405550,2,0,14,-14,10,1
309537,2,6,0,6,1,1
396188,4,24,31,-7,6,0
310995,1,0,0,0,2,1
410306,3,7,23,-16,13,1
177399,2,17,10,7,11,1
339277,2,24,0,24,15,1
56446,3,0,35,-35,9,0
308077,2,0,13,-13,1,0
20885,4,28,16,12,10,0
90199,4,6,3,3,7,0
173244,4,20,27,-7,9,1
2610,4,13,27,-14,2,0
127366,4,10,20,-10,6,0
86432,3,20,7,13,5,1
344679,2,3,20,-17,17,1
148766,2,13,6,7,16,0
370851,1,3,0,3,12,0
227444,2,10,7,3,16,1
325053,4,26,24,2,8,1
292843,1,0,0,0,11,0
246715,1,0,0,0,8,1
221392,2,3,17,-14,14,0
115940,4,20,30,-10,1,1
43285,4,24,10,14,3,0
403027,3,13,21,-8,9,1
49893,1,0,0,0,6,0
350821,4,23,17,6,2,1
94938,2,3,3,0,9,0
336481,4,17,17,0,14,1
280345,4,19,29,-10,5,1
16103,3,33,7,26,8,0
409477,1,0,0,0,12,1
108890,4,17,17,0,15,1
70409,1,7,14,-7,15,1
52497,2,3,0,3,7,0
202710,2,6,10,-4,5,1
281984,3,21,21,0,6,0
14735,2,21,0,21,7,1
140827,1,7,0,7,13,0
236434,1,0,0,0,3,0
420244,1,0,0,0,17,0
293158,1,6,0,6,11,0
78982,2,0,7,-7,2,1
379250,1,0,3,-3,16,0
258252,2,7,6,1,13,1
369601,4,14,6,8,11,1
376612,4,15,6,9,14,1
230683,2,6,14,-8,1,0
157597,3,12,0,12,2,0
175876,3,20,27,-7,11,1
203755,2,14,7,7,6,0
216462,1,14,0,14,12,1
167266,4,30,20,10,7,0
30235,1,0,0,0,14,1
9504,3,13,10,3,5,1
20785,1,7,0,7,10,1
169183,2,10,6,4,7,1
173719,1,0,3,-3,10,0
386640,2,7,13,-6,2,1
214872,2,0,9,-9,11,0
10582,1,0,7,-7,5,1
148311,2,7,3,4,16,1
322338,2,14,7,7,7,0
21182,4,0,16,-16,10,0
106578,2,24,0,24,14,0
368484,1,0,0,0,11,1
84894,3,34,17,17,4,0
18752,3,13,10,3,9,1
249430,4,18,15,3,9,0
14377,4,9,20,-11,7,1
170495,4,21,10,11,8,0
300969,4,27,27,0,15,0
69825,2,14,3,11,15,0
167244,4,30,17,13,7,0
192342,4,27,20,7,1,0
110041,4,48,10,38,16,0
104580,2,7,3,4,14,1
188926,4,23,10,13,16,0
107093,3,40,6,34,15,0
209926,4,37,16,21,8,0
171943,3,14,7,7,9,0
193115,3,13,6,7,1,0
299345,4,28,16,12,14,0
262801,4,35,17,18,15,1
118831,2,20,0,20,2,0
393193,1,0,6,-6,5,1
70577,2,7,7,0,15,0
31679,4,24,16,8,15,0
376503,2,3,3,0,14,1
277294,4,0,16,-16,4,0
122076,1,0,7,-7,4,1
338863,3,13,14,-1,15,0
228161,1,7,17,-10,17,1
387394,2,21,7,14,2,1
5290,4,24,31,-7,3,0
83206,2,3,7,-4,4,0
369644,1,6,0,6,11,0
43472,1,0,0,0,3,0
242151,2,13,7,6,6,0
137168,1,0,0,0,11,0
261834,2,6,10,-4,14,0
387293,3,6,10,-4,2,1
263621,2,14,10,4,15,1
308239,2,10,10,0,1,0
122279,3,6,19,-13,4,1
26293,3,13,21,-8,13,1
412619,2,3,3,0,14,0
316691,5,12,15,-3,4,1
137834,2,7,6,1,11,0
269688,3,10,12,-2,1,1
362697,4,3,13,-10,8,1
119657,4,17,12,5,3,1
156219,4,16,16,0,2,0
156698,4,14,17,-3,2,0
246975,3,20,24,-4,8,1
361018,2,9,2,7,7,1
335558,2,6,0,6,13,0
372290,2,10,7,3,13,1
333688,3,14,0,14,12,1
270464,4,10,7,3,1,1
392548,4,3,20,-17,4,1
139677,2,0,0,0,12,0
207884,3,14,7,7,8,1
163941,3,23,13,10,5,0
184353,2,7,6,1,14,1
287781,2,21,10,11,9,1
282814,3,3,13,-10,6,0
28005,4,30,24,6,13,1
216478,2,17,1,16,12,1
47094,4,31,10,21,5,0
386470,1,0,0,0,2,1
44373,1,0,0,0,3,1
350947,4,14,14,0,3,0
417281,4,20,23,-3,16,0
162382,3,10,13,-3,4,1
273508,3,14,21,-7,2,1
278263,1,0,0,0,4,0
298392,2,7,14,-7,14,1
181526,1,3,0,3,13,1
264752,2,10,16,-6,16,0
30543,1,7,0,7,14,0
118075,1,3,6,-3,2,1
126606,4,23,20,3,6,0
141144,1,3,7,-4,13,0
126992,3,17,10,7,6,0
190460,1,0,0,0,17,1
357628,5,16,16,0,5,1
245368,1,9,0,9,7,0
394150,2,13,10,3,5,1
403127,1,7,0,7,9,0
255177,2,7,0,7,12,0
2104,3,10,13,-3,1,0
169866,4,26,17,9,8,1
315512,2,7,3,4,4,0
153386,2,3,10,-7,1,0
331184,3,10,13,-3,11,0
73274,4,14,23,-9,16,1
224054,4,14,6,8,15,0
267528,2,13,21,-8,17,1
68626,1,7,0,7,15,1
421763,4,31,24,7,17,1
420331,3,17,3,14,17,1
289210,4,20,13,7,9,1
145010,2,3,3,0,14,1
227967,4,30,27,3,16,0
332447,2,13,3,10,12,1
388720,1,0,0,0,3,1
280637,4,23,16,7,5,1
26523,1,3,0,3,13,0
237065,2,0,17,-17,3,1
367936,1,0,7,-7,11,1
297500,2,5,0,5,13,0
180642,3,17,6,11,13,1
211180,2,0,10,-10,9,1
309974,2,3,3,0,2,1
91494,3,19,0,19,8,0
309264,2,0,10,-10,1,1
38311,1,0,0,0,1,0
100234,4,17,7,10,12,0
201296,2,14,3,11,5,1
143289,1,0,6,-6,14,0
341982,3,6,3,3,16,1
62271,2,21,10,11,12,1
367955,1,3,14,-11,11,1
243164,4,23,22,1,6,0
124830,2,0,3,-3,5,0
310838,1,0,0,0,2,0
196141,3,31,24,7,2,1
340088,4,20,15,5,15,0
275417,1,6,10,-4,3,1
281519,4,17,13,4,6,0
43123,4,6,27,-21,3,1
184299,4,37,14,23,14,1
119130,3,10,7,3,3,0
354079,3,19,0,19,4,0
27176,2,13,7,6,13,1
229436,3,10,6,4,17,1
252054,4,14,20,-6,10,0
258075,1,6,0,6,13,1
95485,1,0,0,0,10,0
87080,1,0,0,0,5,0
178264,4,6,13,-7,12,1
256725,2,0,6,-6,12,1
376468,1,0,0,0,14,1
323764,1,6,3,3,8,0
355339,4,14,23,-9,4,0
249640,1,0,7,-7,9,1
119029,4,7,33,-26,3,1
243281,3,7,10,-3,6,1
363429,4,28,21,7,8,0
220037,4,24,35,-11,13,1
46603,2,3,0,3,4,1
164047,2,3,3,0,5,0
395717,4,24,37,-13,6,1
290693,3,41,22,19,10,0
78810,1,0,0,0,2,1
201275,2,7,0,7,5,1
104857,1,0,3,-3,14,1
121934,1,3,7,-4,4,0
210149,2,0,6,-6,9,0
272990,2,3,3,0,2,0
58544,2,10,10,0,10,1
117469,2,7,14,-7,2,0
289929,3,6,3,3,10,0
358588,3,20,9,11,6,0
319772,2,7,7,0,6,1
332854,1,7,0,7,12,1
382463,4,0,31,-31,17,0
328300,2,3,14,-11,10,1
53854,2,0,0,0,8,1
417413,4,24,17,7,16,0
385304,3,14,20,-6,1,0
77383,3,7,14,-7,1,0
380461,1,0,0,0,16,0
157734,3,10,10,0,2,1
107342,3,9,6,3,15,1
382948,2,0,13,-13,17,1
78466,4,24,0,24,2,0
110932,3,7,10,-3,16,0
286858,2,9,7,2,8,0
308748,4,10,20,-10,1,0
248816,4,36,14,22,9,1
106374,4,21,19,2,14,1
380701,4,7,7,0,16,0
130937,2,7,21,-14,8,1
28472,1,10,0,10,14,0
305873,3,7,14,-7,17,0
380683,3,7,7,0,16,0
371981,1,10,0,10,13,0
313526,1,0,7,-7,3,1
15445,1,0,0,0,8,1
388717,1,0,0,0,3,1
8179,2,0,7,-7,4,1
237794,1,0,10,-10,4,0
360784,3,24,30,-6,7,1
223748,4,40,13,27,15,0
160843,4,34,17,17,4,0
130910,1,0,7,-7,8,0
183025,1,0,0,0,14,1
108800,2,0,10,-10,15,1
230282,2,16,10,6,17,1
129511,1,3,0,3,7,0
252364,4,0,22,-22,10,1
335421,2,7,6,1,13,0
101669,1,3,0,3,12,1
284478,3,14,15,-1,7,1
323809,2,13,9,4,8,0
165886,4,6,19,-13,6,0
329249,4,24,13,11,10,0
349176,3,27,7,20,2,0
47936,1,0,13,-13,5,0
144375,2,0,3,-3,14,1
61401,2,13,3,10,11,1
80856,4,6,3,3,3,0
348129,4,17,19,-2,1,0
146400,3,10,3,7,15,0
371538,1,0,0,0,12,1
124662,1,0,0,0,5,0
135385,3,21,17,4,10,1
186019,2,17,34,-17,15,0
305743,3,9,10,-1,17,1
385592,3,3,17,-14,1,1
277147,4,10,24,-14,4,0
187895,4,7,23,-16,16,1
253212,2,0,7,-7,11,0
192300,2,27,3,24,1,1
62864,2,3,3,0,12,1
380564,4,21,24,-3,16,0
197694,1,7,3,4,3,1
85411,4,38,17,21,5,0
191762,4,16,24,-8,17,1
63086,4,23,42,-19,12,1
316197,1,0,0,0,4,1
316168,4,24,32,-8,4,1
239405,2,6,7,-1,4,0
31412,1,0,0,0,15,1
138250,4,10,12,-2,11,0
77640,2,0,7,-7,1,0
388088,1,3,0,3,2,1
354700,4,17,17,0,4,1
405417,2,14,10,4,10,1
155872,3,7,13,-6,2,0
64365,4,27,27,0,13,0
18490,4,17,14,3,9,0
29221,1,7,0,7,14,0
100845,4,12,19,-7,12,1
117327,2,20,0,20,2,1
20990,3,14,24,-10,10,0
67856,2,6,3,3,14,0
234206,3,20,10,10,2,0
291782,4,9,17,-8,11,0
381532,3,14,13,1,17,1
72876,1,0,0,0,16,1
217143,2,3,9,-6,12,0
71768,3,31,30,1,16,1
154048,4,17,21,-4,1,1
361230,3,7,20,-13,7,0
299731,3,17,6,11,14,1
170751,4,24,6,18,8,1
303307,3,27,0,27,16,1
61443,4,16,17,-1,11,1
101309,4,17,20,-3,12,0
180290,2,6,7,-1,13,1
225692,4,21,13,8,16,1
276422,4,32,44,-12,3,0
395923,2,10,0,10,6,0
221344,4,6,35,-29,14,1
219951,2,6,14,-8,13,1
13644,4,13,10,3,7,0
354465,2,14,21,-7,4,1
184456,1,0,0,0,14,0
52157,1,0,0,0,7,1
150297,2,17,7,10,16,0
236144,2,0,10,-10,3,1
327988,2,10,0,10,10,1
233465,3,23,10,13,2,0
419491,3,10,9,1,16,0
117745,1,0,3,-3,2,0
42604,1,0,0,0,3,0
215815,4,45,13,32,11,0
208535,4,47,15,32,8,0
196339,1,7,0,7,2,1
391099,1,7,14,-7,4,1
196520,2,10,3,7,2,0
247166,4,20,6,14,8,0
49113,5,20,20,0,6,1
226151,4,21,17,4,16,0
382277,3,17,3,14,17,1
359338,3,3,13,-10,6,0
61548,2,21,7,14,11,0
255659,2,3,7,-4,12,1
247302,3,35,28,7,8,1
274377,2,3,10,-7,3,1
307396,4,23,25,-2,17,0
161445,3,7,3,4,4,0
378171,3,24,16,8,15,0
179523,2,0,16,-16,12,0
79601,3,14,7,7,2,1
190297,4,7,14,-7,17,0
100073,3,6,3,3,12,0
408537,4,10,13,-3,12,1
25280,3,34,7,27,12,0
54570,4,28,18,10,8,0
386911,2,7,7,0,2,0
94928,2,0,3,-3,9,1
414887,3,28,7,21,15,1
90701,1,7,0,7,7,0
168571,2,7,10,-3,7,1
407424,3,14,7,7,11,0
343800,2,14,3,11,17,1
300428,1,2,0,2,14,1
392587,1,0,0,0,4,1
251698,2,14,3,11,10,0
254884,2,7,7,0,12,1
183059,2,7,0,7,14,0
269329,1,0,7,-7,1,0
396809,1,3,7,-4,6,0
216265,4,24,20,4,12,0
14909,3,14,10,4,7,0
174798,2,13,14,-1,10,0
153203,4,20,20,0,1,0
99969,4,17,16,1,12,0
97162,1,0,0,0,10,0
212798,3,17,21,-4,10,1
242668,4,13,10,3,6,1
284925,2,7,14,-7,7,0
391210,4,10,24,-14,4,0
212678,4,9,31,-22,10,1
142346,3,0,3,-3,13,1
48802,1,0,0,0,5,1
233868,2,7,3,4,2,0
265487,2,7,7,0,16,1
10511,3,20,0,20,5,0
389515,3,20,10,10,3,0
57057,3,7,20,-13,9,0
339638,4,31,17,14,15,0
381762,1,0,0,0,17,1
171950,3,14,14,0,9,1
304357,3,20,7,13,16,0
14033,3,3,21,-18,7,0
33261,3,10,0,10,16,0
101288,4,17,14,3,12,1
77793,2,7,14,-7,1,1
64661,1,7,0,7,13,0
400062,2,14,6,8,8,1
134895,2,7,13,-6,10,0
6343,1,0,3,-3,3,1
46701,1,0,0,0,4,1
213896,1,0,0,0,10,0
256581,2,7,0,7,12,1
153064,1,0,10,-10,1,1
113691,1,0,7,-7,17,0
246747,2,3,3,0,8,1
208060,4,21,13,8,8,1
23583,1,7,0,7,12,0
162198,2,10,14,-4,4,1
53038,1,0,0,0,7,1
234112,1,0,0,0,2,0
315297,5,20,19,1,4,1
256490,4,19,31,-12,12,1
305975,1,3,0,3,17,0
33357,2,12,3,9,16,1
21263,2,3,0,3,11,0
62650,4,17,20,-3,12,1
205205,3,14,13,1,6,1
165354,2,0,7,-7,6,0
368417,3,20,7,13,11,0
38739,1,0,0,0,1,1
418501,4,24,12,12,16,0
321699,1,0,3,-3,7,1
128413,4,14,16,-2,7,1
47959,2,3,21,-18,5,0
146538,3,14,10,4,15,0
205811,2,13,0,13,7,1
379276,1,0,3,-3,16,0
302472,2,3,10,-7,15,1
368804,1,0,0,0,11,0
376354,2,3,0,3,14,0
47292,1,0,7,-7,5,1
369651,1,6,0,6,11,1
26065,1,0,0,0,13,0
164267,4,48,48,0,5,0
375860,4,20,14,6,14,1
94814,3,6,9,-3,9,0
121790,1,0,0,0,4,0
250283,1,7,0,7,9,1
227189,3,13,10,3,16,0
389937,2,25,10,15,3,0
288267,3,10,35,-25,9,1
366522,2,10,7,3,10,1
299857,2,13,0,13,14,0
175820,2,14,3,11,11,1
216189,2,14,3,11,12,1
397957,4,10,17,-7,7,1
168262,2,7,7,0,7,1
121479,2,6,0,6,4,0
69982,2,21,3,18,15,1
348522,2,28,7,21,2,0
300007,2,0,20,-20,14,0
21604,3,7,31,-24,11,0
315601,1,0,0,0,4,0
113747,3,3,17,-14,17,1
53000,4,27,24,3,7,1
270555,3,10,14,-4,1,1
104420,1,0,0,0,13,0
316023,4,0,31,-31,4,0
399724,1,0,3,-3,8,1
403190,3,17,14,3,9,0
269424,4,21,20,1,1,1
22082,5,24,24,0,11,0
148653,4,10,9,1,16,0
409639,1,0,0,0,12,0
31625,3,17,6,11,15,1
2261,3,10,10,0,1,1
150226,4,6,26,-20,16,0
120696,2,10,0,10,3,1
57080,4,14,27,-13,9,0
123441,1,0,0,0,4,1
319228,4,17,17,0,5,1
116248,1,10,0,10,1,0
142638,3,13,13,0,13,0
405991,4,21,7,14,11,1
351835,3,20,14,6,3,1
193144,4,13,6,7,1,1
292677,4,22,16,6,11,1
67839,1,3,3,0,14,0
151550,1,0,0,0,17,1
14451,2,24,3,21,7,1
386724,4,17,19,-2,2,1
348857,3,3,14,-11,2,1
65035,3,0,17,-17,13,1
418195,4,24,6,18,16,1
262122,2,14,3,11,15,1
81665,2,7,7,0,3,0
20359,3,10,13,-3,10,0
324367,1,7,0,7,8,0
356891,4,25,16,9,5,0
402689,2,0,0,0,9,1
85543,4,17,19,-2,5,0
166015,3,17,21,-4,6,1
293248,3,23,7,16,11,1
180041,3,21,20,1,13,0
81252,3,10,7,3,3,1
53497,1,7,0,7,8,0
410066,1,7,7,0,13,1
377457,4,14,13,1,15,0
64818,1,0,0,0,13,0
257997,3,0,21,-21,13,0
223496,2,7,3,4,15,0
15276,4,30,7,23,8,0
342094,2,3,3,0,16,1
124322,4,34,20,14,5,1
38402,3,17,16,1,1,1
418587,2,14,3,11,16,1
221692,1,10,0,10,14,0
210369,4,22,17,5,9,1
50306,3,13,16,-3,6,0
365204,4,14,38,-24,9,1
316985,1,0,7,-7,4,1
46406,4,12,17,-5,4,0
78795,4,16,23,-7,2,0
314313,2,7,14,-7,3,0
383790,2,3,7,-4,1,1
139251,2,10,6,4,12,1
23093,4,10,17,-7,11,0
34087,2,0,0,0,16,1
119527,1,0,0,0,3,1
119365,1,0,0,0,3,1
280596,3,17,9,8,5,0
406704,3,27,0,27,11,0
303689,1,0,0,0,16,0
239728,3,10,13,-3,4,0
12266,3,3,3,0,6,1
280405,2,6,7,-1,5,0
88527,4,19,14,5,6,0
180972,3,24,21,3,13,0
381720,4,20,31,-11,17,1
113225,1,0,0,0,17,0
152129,4,13,13,0,17,1
232584,1,0,0,0,1,1
308061,1,0,7,-7,1,0
287442,1,7,10,-3,9,1
286427,3,14,3,11,8,1
281171,2,14,13,1,6,1
238993,3,21,15,6,4,1
31307,2,7,3,4,15,0
316241,2,0,10,-10,4,0
361933,3,10,3,7,7,0
169126,4,39,30,9,7,0
351373,3,10,7,3,3,0
355652,4,38,17,21,5,1
396675,2,7,7,0,6,0
42968,4,31,23,8,3,1
287243,4,16,23,-7,8,1
373407,3,10,17,-7,13,1
91964,3,6,23,-17,8,1
296570,1,0,0,0,13,0
98193,4,34,26,8,11,1
127679,4,30,20,10,6,0
387446,4,21,16,5,2,0
339775,4,24,6,18,15,1
161935,3,13,16,-3,4,1
183093,2,7,3,4,14,1
354485,3,24,28,-4,4,0
267846,3,26,14,12,17,0
172080,3,10,3,7,9,1
146302,4,17,33,-16,15,1
345170,4,15,9,6,17,1
220557,3,10,20,-10,13,0
131010,4,17,30,-13,8,0
320278,3,14,14,0,6,0
61950,1,0,0,0,12,0
364735,4,6,3,3,9,0
80514,3,5,10,-5,3,0
343246,4,22,0,22,16,0
350046,3,20,10,10,2,0
345606,4,17,23,-6,17,0
27882,1,0,0,0,13,0
57035,2,7,17,-10,9,0
255369,3,14,6,8,12,1
72400,4,17,23,-6,16,1
250214,4,24,16,8,9,0
67713,2,7,0,7,14,1
118204,1,0,0,0,2,1
189724,1,0,3,-3,17,0
208462,2,16,0,16,8,1
246262,4,24,16,8,7,0
61836,2,3,20,-17,12,1
54916,2,0,0,0,8,0
31884,2,6,0,6,15,0
140459,2,14,7,7,12,0
34733,3,6,3,3,16,0
24910,1,0,7,-7,12,1
267661,2,0,21,-21,17,0
186626,2,24,3,21,15,0
302217,2,28,7,21,15,0
252942,3,9,0,9,11,0
55852,3,7,14,-7,9,1
89579,4,7,27,-20,7,0
151139,1,3,7,-4,17,0
399882,2,0,0,0,8,0
222668,3,14,24,-10,14,1
365319,3,17,16,1,9,0
98007,4,17,10,7,11,0
196828,2,3,10,-7,3,1
52693,3,3,13,-10,7,0
87370,1,7,0,7,6,1
48069,1,0,0,0,5,1
155064,2,6,19,-13,1,0
41003,1,3,7,-4,2,0
76921,2,14,13,1,1,0
362750,1,0,0,0,8,1
18878,3,9,13,-4,9,1
259381,4,35,40,-5,13,0
78884,3,17,7,10,2,0
267508,2,13,14,-1,17,0
370028,3,10,13,-3,12,1
325289,2,6,3,3,8,0
182937,2,10,37,-27,14,1
420022,3,10,7,3,17,0
168066,4,6,24,-18,7,0
325388,4,15,20,-5,8,0
284349,3,6,17,-11,7,1
299200,4,17,22,-5,14,1
240723,1,0,6,-6,5,0
257010,1,0,7,-7,12,0
416975,4,10,17,-7,15,1
188860,2,3,7,-4,16,1
195445,4,24,10,14,2,1
360419,2,6,0,6,7,1
355037,4,18,26,-8,4,0
174433,4,17,10,7,10,0
21819,1,0,0,0,11,1
154012,3,10,14,-4,1,0
226571,2,3,3,0,16,0
205311,2,10,0,10,6,1
345080,2,6,3,3,17,1
267035,1,0,0,0,17,1
44936,4,14,38,-24,4,0
214177,4,19,9,10,11,1
13238,1,0,6,-6,7,1
374736,3,0,39,-39,14,1
128191,2,14,7,7,7,0
264349,1,0,0,0,15,0
114555,4,17,40,-23,1,0
399330,2,21,7,14,7,0
230201,4,3,32,-29,17,0
416695,4,44,15,29,15,0
201141,2,6,21,-15,5,1
6884,4,10,31,-21,3,0
369081,1,3,0,3,11,0
32076,3,14,13,1,15,0
103979,3,6,10,-4,13,0
117497,3,7,17,-10,2,1
93329,3,24,3,21,9,1
55050,2,13,0,13,8,0
309150,3,35,3,32,1,0
285456,3,33,8,25,8,1
330921,4,31,31,0,11,0
349049,4,17,17,0,2,1
389475,2,10,0,10,3,1
411608,2,14,13,1,13,0
252719,1,0,0,0,11,0
167730,4,26,23,3,7,1
378247,1,0,0,0,15,0
284691,4,17,34,-17,7,1
160905,1,0,0,0,4,0
126192,2,14,6,8,6,1
174655,2,6,0,6,10,1
421262,3,16,7,9,17,0
19000,2,7,0,7,10,0
239415,2,6,10,-4,4,1
79849,1,0,6,-6,2,1
374948,1,0,6,-6,14,1
223557,3,17,13,4,15,0
267908,1,0,0,0,17,1
16345,2,7,7,0,8,1
154817,4,24,23,1,1,0
372302,3,17,7,10,13,0
301873,2,0,3,-3,15,1
174877,4,26,17,9,10,0
38339,2,7,6,1,1,1
50959,1,0,7,-7,6,1
361327,2,0,0,0,7,1
118069,1,3,6,-3,2,0
33805,2,0,24,-24,16,0
324093,2,0,7,-7,8,1
328010,3,17,3,14,10,0
145580,2,21,0,21,14,0
124266,2,24,17,7,5,0
354178,2,3,7,-4,4,1
241468,4,10,42,-32,5,1
364633,1,0,0,0,9,1
188660,1,0,0,0,16,1
194705,1,0,0,0,2,1
232131,1,0,0,0,1,1
22690,1,3,0,3,11,0
419685,1,0,0,0,17,0
346067,3,3,6,-3,1,1
259473,3,28,10,18,13,0
181424,3,17,24,-7,13,1
287813,3,21,17,4,9,1
107536,4,3,23,-20,15,1
171744,1,3,7,-4,9,0
3916,3,19,14,5,2,1
79460,3,9,14,-5,2,1
271266,2,6,6,0,1,0
295272,3,14,5,9,12,1
224055,4,14,6,8,15,0
394631,3,17,7,10,5,0
37624,2,10,0,10,17,0
9981,4,3,3,0,5,1
409115,3,3,10,-7,12,0
378441,3,10,0,10,15,1
35853,1,0,0,0,17,1
346233,3,40,0,40,1,0
54383,3,17,19,-2,8,1
388442,2,0,13,-13,2,1
61859,3,13,23,-10,12,1
351865,4,27,14,13,3,0
317624,2,3,3,0,5,0
90059,4,18,21,-3,7,0
101303,4,17,20,-3,12,0
229443,4,10,6,4,17,0
27389,4,24,10,14,13,0
188595,4,12,13,-1,16,1
123186,3,6,21,-15,4,0
251724,3,24,3,21,10,0
94915,1,0,3,-3,9,0
317561,4,17,27,-10,5,1
63203,4,14,23,-9,12,0
66349,3,14,21,-7,14,0
11732,4,30,17,13,6,1
197523,1,0,0,0,3,0
266331,2,7,0,7,16,1
58419,3,40,10,30,10,1
194280,2,10,0,10,2,0
215940,3,13,21,-8,11,0
85016,2,25,13,12,4,0
367762,4,20,27,-7,10,1
229364,1,3,0,3,17,1
185272,3,27,9,18,15,0
138678,3,6,28,-22,12,1
271211,4,21,23,-2,1,1
60103,3,20,12,8,11,0
328349,3,3,30,-27,10,0
396137,3,17,23,-6,6,1
144137,3,23,7,16,14,0
219623,2,10,0,10,13,0
228198,2,10,27,-17,17,0
179378,2,3,13,-10,12,1
136000,3,3,10,-7,10,1
338450,1,0,0,0,14,1
282968,2,14,3,11,6,0
16229,2,3,3,0,8,0
374325,4,25,13,12,13,0
250776,2,3,0,3,10,0
60245,3,10,13,-3,11,1
2126,3,10,13,-3,1,0
414817,1,7,0,7,15,1
416399,4,16,13,3,15,0
274113,3,20,0,20,3,0
145170,3,42,0,42,14,1
352684,2,14,3,11,3,1
205166,2,7,10,-3,6,1
201107,1,6,0,6,5,0
265740,2,3,0,3,16,0
372856,1,0,0,0,13,1
298084,2,3,17,-14,13,0
177657,1,7,0,7,12,0
31470,3,3,14,-11,15,0
108958,2,16,7,9,15,0
6106,3,7,10,-3,3,0
149921,1,0,0,0,16,1
271406,2,7,0,7,1,0
57161,2,7,0,7,10,1
242185,3,16,7,9,6,1
367463,4,29,24,5,10,1
388531,4,3,23,-20,2,0
408626,3,28,3,25,12,0
101485,1,7,0,7,12,0
355112,2,6,16,-10,4,1
78186,4,34,3,31,2,1
64062,3,20,17,3,13,0
207834,1,0,0,0,8,0
360196,4,17,13,4,7,1
98342,4,42,35,7,11,0
132545,2,2,29,-27,9,1
361568,4,19,10,9,7,0
62166,3,7,14,-7,12,0
117824,3,9,6,3,2,1
92737,3,3,17,-14,8,1
116391,1,3,0,3,1,0
129119,3,27,28,-1,7,1
13464,3,3,21,-18,7,0
360499,4,17,12,5,7,0
28115,4,27,10,17,13,0
174178,2,3,6,-3,10,0
14181,3,0,24,-24,7,1
241207,1,0,0,0,5,1
95169,4,23,27,-4,9,1
140282,2,7,6,1,12,1
126489,2,0,6,-6,6,1
415043,4,10,27,-17,15,1
179945,4,40,9,31,13,0
236246,4,27,22,5,3,0
45110,1,0,0,0,4,1
339545,2,7,7,0,15,1
377614,4,20,12,8,15,1
153379,2,0,10,-10,1,1
15910,2,6,7,-1,8,0
294990,4,24,14,10,12,1
355523,1,7,0,7,5,0
383332,1,0,0,0,17,0
91109,1,0,0,0,8,1
354028,2,12,0,12,4,1
169033,2,26,14,12,7,0
392346,2,14,28,-14,4,1
93119,1,0,0,0,9,0
159898,3,31,0,31,3,1
127289,2,10,7,3,6,0
53560,3,14,12,2,8,1
73540,3,3,38,-35,17,0
165546,3,3,28,-25,6,1
371743,3,14,14,0,12,0
141930,1,7,0,7,13,1
119904,1,6,7,-1,3,1
243478,4,10,23,-13,6,0
164969,4,10,16,-6,6,0
100469,2,7,7,0,12,0
405887,2,7,0,7,11,1
274687,2,10,9,1,3,1
59640,3,21,3,18,11,0
85215,3,10,17,-7,4,1
297656,2,7,3,4,13,1
407252,2,7,16,-9,11,0
50356,1,0,0,0,6,1
74115,3,23,6,17,17,0
150841,1,0,0,0,17,0
410896,3,14,12,2,13,0
376398,3,9,6,3,14,0
41942,3,24,6,18,2,0
352155,4,15,20,-5,3,1
296384,4,13,28,-15,13,1
79656,4,24,21,3,2,0
111927,1,0,21,-21,17,1
70999,2,10,0,10,16,0
247084,2,2,3,-1,8,0
145015,2,3,3,0,14,1
221050,4,21,42,-21,14,0
394572,1,0,0,0,5,1
70423,2,14,17,-3,15,1
417335,2,10,3,7,16,0
264759,3,10,16,-6,16,0
202865,2,14,0,14,5,1
252114,2,7,10,-3,10,1
305306,4,42,21,21,16,0
106317,3,7,12,-5,14,1
314752,2,14,0,14,4,0
378325,3,9,6,3,15,0
31839,4,23,24,-1,15,0
203444,2,0,3,-3,6,1
382090,2,21,3,18,17,0
193699,2,3,20,-17,1,0
361907,2,0,0,0,7,0
153053,1,0,7,-7,1,1
121269,4,28,30,-2,3,0
193227,2,3,7,-4,1,1
241255,2,3,0,3,5,0
342281,3,13,3,10,16,0
136718,2,13,10,3,11,0
100047,2,3,3,0,12,1
1007,4,7,6,1,1,0
112268,2,24,17,7,17,0
372559,1,0,0,0,13,1
106643,4,46,7,39,14,0
298063,2,0,14,-14,13,1
48555,2,11,14,-3,5,1
232786,2,13,7,6,2,0
44046,1,0,0,0,3,1
40801,4,17,28,-11,2,1
176989,3,13,6,7,11,1
120426,3,19,9,10,3,0
142572,1,0,3,-3,13,1
206843,2,3,7,-4,7,0
244174,1,7,7,0,6,1
255496,2,16,7,9,12,1
171883,1,0,7,-7,9,1
387203,1,0,6,-6,2,0
135908,5,24,24,0,10,0
185533,2,10,3,7,15,1
129756,4,17,23,-6,7,0
392677,3,16,0,16,4,0
39687,2,3,0,3,1,0
410825,1,7,0,7,13,1
266806,3,10,14,-4,16,0
153913,4,7,12,-5,1,0
54183,2,0,3,-3,8,1
175524,2,3,0,3,11,1
166892,2,10,3,7,6,1
383248,2,28,10,18,17,1
353859,2,7,14,-7,4,0
408678,4,31,17,14,12,1
25449,4,13,17,-4,12,0
172189,2,0,0,0,9,0
16197,2,0,0,0,8,1
92529,2,10,0,10,8,1
146499,2,7,7,0,15,1
17932,1,7,7,0,9,0
144048,1,7,0,7,14,0
386381,3,17,9,8,2,0
255211,3,13,14,-1,12,0
195642,2,7,7,0,2,1
146309,4,17,33,-16,15,1
393796,1,0,0,0,5,0
202352,4,20,13,7,5,1
51389,1,0,0,0,7,0
268203,4,12,25,-13,17,0
217904,3,17,28,-11,12,1
364607,4,21,37,-16,9,1
155161,1,7,0,7,1,1
216166,2,14,0,14,12,0
231868,2,7,20,-13,1,0
319443,2,0,3,-3,6,1
260225,3,10,3,7,14,0
289277,1,7,14,-7,9,1
37236,3,10,14,-4,17,1
236153,2,7,10,-3,3,0
37571,4,13,17,-4,17,1
161448,3,7,3,4,4,0
375012,3,21,27,-6,14,1
375083,1,0,0,0,14,1
65244,1,0,0,0,13,0
225373,3,24,21,3,15,0
146423,4,16,3,13,15,0
264330,4,17,36,-19,15,0
315485,2,0,3,-3,4,1
15222,3,13,7,6,8,1
277670,1,7,0,7,4,0
207638,4,42,10,32,7,0
216454,1,14,0,14,12,0
151233,4,17,23,-6,17,0
100611,2,0,7,-7,12,1
308614,4,21,16,5,1,0
291685,2,0,3,-3,11,1
124037,1,0,0,0,5,1
287801,2,21,10,11,9,1
105377,2,23,7,16,14,0
55141,4,26,17,9,8,1
30712,2,17,14,3,15,0
194006,2,14,7,7,1,1
37804,3,14,9,5,1,0
394055,4,9,13,-4,5,0
17679,2,14,6,8,9,0
39693,2,3,0,3,1,1
283087,1,3,0,3,7,1
230655,1,0,7,-7,1,1
120296,4,24,13,11,3,1
118983,2,0,20,-20,3,0
118307,4,19,7,12,2,1
93064,4,20,12,8,8,0
158688,4,17,7,10,3,1
412670,3,20,10,10,14,0
27172,2,13,7,6,13,1
229551,2,17,6,11,17,1
299951,1,0,7,-7,14,1
257895,4,16,19,-3,13,0
322796,3,3,27,-24,7,1
283907,3,31,17,14,7,0
58034,1,0,0,0,10,0
92369,1,7,0,7,8,1
372610,2,7,6,1,13,1
413820,2,14,0,14,14,1
357523,2,10,6,4,5,0
176279,1,0,7,-7,11,1
382405,3,0,21,-21,17,1
67308,2,14,3,11,14,0
264516,1,7,7,0,16,1
191111,3,14,13,1,17,0
1420,4,16,0,16,1,0
117425,1,0,0,0,2,0
1478,1,0,3,-3,1,0
228276,4,17,36,-19,17,1
195297,4,23,24,-1,2,1
44045,1,0,0,0,3,0
256197,1,0,0,0,12,0
381363,2,13,0,13,16,0
344432,4,28,24,4,17,0
339978,1,7,3,4,15,1
355049,1,0,0,0,4,1
349772,4,23,21,2,2,1
98208,1,0,0,0,11,0
248832,4,37,22,15,9,0
64734,3,21,0,21,13,1
189127,1,0,0,0,16,1
123701,4,10,32,-22,4,0
285209,1,0,0,0,7,0
344126,3,20,3,17,17,1
247956,1,0,0,0,8,0
182798,2,19,3,16,14,1
168291,2,10,7,3,7,0
374091,1,7,0,7,13,1
319297,2,10,3,7,6,0
208293,2,6,14,-8,8,1
110543,1,0,0,0,16,0
96277,1,0,9,-9,10,0
64995,2,0,7,-7,13,0
360274,2,0,6,-6,7,1
326341,2,0,10,-10,9,1
29119,2,0,9,-9,14,1
341811,2,9,9,0,16,1
230263,2,9,10,-1,17,0
414213,1,7,0,7,14,0
339781,4,24,6,18,15,0
49735,4,35,31,4,6,0
20021,3,19,6,13,10,0
384899,4,13,29,-16,1,0
130428,1,0,0,0,8,1
147200,1,0,7,-7,15,1
109381,1,3,10,-7,16,1
239552,2,13,0,13,4,0
302430,1,0,3,-3,15,1
360461,3,10,0,10,7,1
215026,2,13,0,13,11,1
402332,4,26,24,2,9,0
196467,1,0,0,0,2,1
110663,4,23,10,13,16,1
272128,4,17,9,8,2,1
198491,3,17,3,14,3,0
409053,1,3,7,-4,12,1
226303,3,16,7,9,16,1
228291,1,0,0,0,17,0
47733,4,6,17,-11,5,0
50733,3,14,14,0,6,1
2831,2,24,24,0,2,1
137183,1,0,0,0,11,1
115182,4,13,30,-17,1,1
36268,4,24,27,-3,17,0
205534,4,14,24,-10,6,0
3220,1,0,0,0,2,0
139266,2,13,6,7,12,0
115403,2,20,7,13,1,1
397864,2,0,3,-3,7,1
93307,2,21,3,18,9,0
138208,3,7,12,-5,11,1
349197,4,27,14,13,2,1
54215,3,0,3,-3,8,1
348530,2,28,7,21,2,1
315647,2,3,7,-4,4,1
14020,2,3,14,-11,7,0
180372,4,15,14,1,13,1
231157,2,10,0,10,1,0
7257,3,7,13,-6,4,1
389354,3,23,6,17,3,0
104547,4,14,38,-24,13,1
237002,1,0,0,0,3,1
159337,1,0,0,0,3,0
179987,2,7,6,1,13,0
338783,1,7,0,7,15,0
148170,2,6,21,-15,16,1
64779,4,31,7,24,13,0
189243,4,46,11,35,16,0
136773,3,13,10,3,11,1
210147,2,0,0,0,9,1
3098,1,0,3,-3,2,0
119987,3,23,24,-1,3,1
275527,4,26,36,-10,3,1
52268,4,20,19,1,7,0
74328,1,0,3,-3,17,1
51835,1,0,0,0,7,0
382264,3,17,3,14,17,0
26315,4,19,21,-2,13,1
150519,4,41,13,28,16,1
27808,3,14,14,0,13,1
75281,3,7,16,-9,17,0
163117,2,13,19,-6,5,1
202565,2,7,6,1,5,1
173222,4,20,24,-4,9,1
80631,2,7,13,-6,3,0
244966,2,0,20,-20,7,0
49959,2,21,0,21,6,1
368000,3,17,21,-4,11,0
247884,3,10,3,7,8,1
102477,3,17,3,14,13,1
296566,1,0,0,0,13,1
123235,4,19,21,-2,4,0
30618,3,17,3,14,14,0
69155,3,14,17,-3,15,0
120194,1,0,0,0,3,1
405135,3,3,10,-7,10,1
249580,4,21,13,8,9,1
412630,2,10,3,7,14,0
48629,4,27,27,0,5,0
206069,2,14,3,11,7,0
218246,1,0,0,0,12,0
112437,3,13,13,0,17,0
126932,1,3,0,3,6,1
420311,2,14,0,14,17,0
362285,1,0,0,0,8,0
56108,2,17,7,10,9,0
420024,3,17,14,3,17,0
27576,1,7,0,7,13,0
44232,1,10,10,0,3,0
57814,3,19,10,9,10,1
92192,4,10,43,-33,8,0
210439,2,9,13,-4,9,0
8238,3,16,10,6,4,0
112968,1,7,0,7,17,1
366180,4,7,48,-41,10,0
120205,1,7,0,7,3,0
125192,3,30,7,23,5,1
204797,4,28,21,7,6,0
304733,4,21,22,-1,16,0
169465,1,0,7,-7,8,0
261211,2,21,0,21,14,1
31923,2,6,13,-7,15,1
133640,3,10,21,-11,9,1
294324,2,10,3,7,12,1
357321,4,14,19,-5,5,0
294905,1,0,7,-7,12,1
182995,4,10,44,-34,14,0
340807,3,17,16,1,15,1
132402,2,0,14,-14,9,1
389977,3,28,25,3,3,1
198387,1,0,0,0,3,1
266018,1,7,0,7,16,1
363771,1,0,7,-7,8,1
34505,4,48,10,38,16,1
188391,2,3,0,3,16,0
315083,3,37,14,23,4,0
380709,4,7,10,-3,16,0
103452,1,3,0,3,13,1
356775,1,0,0,0,5,0
145293,2,14,9,5,14,1
189206,3,26,3,23,16,1
225469,2,0,7,-7,15,0
222709,4,14,24,-10,14,1
42354,2,7,9,-2,2,0
219526,3,9,21,-12,13,0
255605,1,0,6,-6,12,0
62205,4,13,17,-4,12,0
282218,2,3,0,3,6,0
416537,4,38,17,21,15,0
198602,2,0,0,0,3,1
53618,4,14,22,-8,8,1
46999,2,7,0,7,5,1
405772,4,10,21,-11,10,1
164642,3,14,17,-3,5,1
96465,3,10,17,-7,10,0
27233,4,19,7,12,13,1
286918,4,16,13,3,8,1
381581,4,42,16,26,17,0
31053,3,10,13,-3,15,1
363609,4,10,15,-5,8,1
368121,2,7,7,0,11,1
63326,3,17,3,14,12,0
295200,1,7,0,7,12,0
391926,4,23,27,-4,4,1
272254,3,6,3,3,2,1
121170,2,7,13,-6,3,0
137830,2,0,6,-6,11,1
301583,2,7,3,4,15,1
8430,1,3,0,3,4,0
186454,2,10,10,0,15,1
136373,1,0,0,0,11,0
171892,2,0,7,-7,9,1
168629,4,17,16,1,7,1
258910,4,20,32,-12,13,1
73261,4,14,16,-2,16,0
186593,2,17,0,17,15,1
203293,1,0,17,-17,6,0
5859,4,34,7,27,3,0
24296,4,13,17,-4,12,1
323938,2,10,7,3,8,0
76922,2,14,13,1,1,0
302734,1,0,3,-3,15,0
56574,3,16,17,-1,9,1
68156,1,0,7,-7,14,1
350616,3,13,0,13,2,0
228562,4,20,14,6,17,0
28782,1,0,0,0,14,1
252949,3,9,7,2,11,1
346232,3,40,0,40,1,0
228997,3,14,16,-2,17,1
371246,4,22,22,0,12,1
101687,2,10,0,10,12,0
36359,3,13,13,0,17,0
317477,2,10,10,0,5,0
26490,4,30,22,8,13,1
189988,4,16,7,9,17,1
99825,4,8,24,-16,12,0
25386,2,6,0,6,12,0
221281,3,0,29,-29,14,1
328320,2,3,17,-14,10,1
348748,4,31,17,14,2,1
81506,2,0,14,-14,3,0
301282,1,7,0,7,15,1
134328,2,16,14,2,10,0
71688,1,0,0,0,16,1
265698,4,12,18,-6,16,1
54123,4,20,10,10,8,0
168802,1,7,0,7,7,0
340799,3,17,16,1,15,1
300931,4,10,27,-17,15,1
421119,3,20,13,7,17,1
291041,4,20,20,0,10,1
36466,2,3,3,0,17,0
331555,2,7,20,-13,11,1
182134,2,16,7,9,13,1
16922,2,20,13,7,8,1
98095,1,7,0,7,11,0
400696,3,16,7,9,8,0
83351,2,0,14,-14,4,1
118741,4,27,12,15,2,0
234857,4,3,12,-9,2,0
31391,4,7,3,4,15,0
155670,2,3,10,-7,2,0
92999,2,10,3,7,8,0
256726,2,0,6,-6,12,1
379700,2,3,0,3,16,0
245310,3,16,10,6,7,1
348005,4,6,24,-18,1,1
194908,3,7,10,-3,2,0
61879,4,20,23,-3,12,1
195065,3,7,23,-16,2,0
285862,1,0,0,0,8,0
29193,4,3,26,-23,14,1
52737,4,13,23,-10,7,1
242238,4,30,14,16,6,0
359459,2,0,14,-14,6,1
168529,1,0,3,-3,7,0
299223,1,3,0,3,14,1
236756,1,0,3,-3,3,0
354822,3,20,28,-8,4,0
92332,4,20,0,20,8,1
258901,4,20,26,-6,13,0
329229,3,17,13,4,10,0
75149,3,7,6,1,17,0
157566,2,5,0,5,2,0
179628,4,31,23,8,12,0
105443,4,23,24,-1,14,0
107247,4,14,31,-17,15,1
385754,2,10,0,10,1,1
402333,4,26,24,2,9,0
177951,1,7,3,4,12,1
339893,3,23,0,23,15,1
392262,1,0,0,0,4,0
144495,1,0,0,0,14,0
332302,2,3,6,-3,12,1
329705,4,40,17,23,11,1
328404,1,0,0,0,10,1
162033,2,14,13,1,4,1
314867,1,0,0,0,4,0
46665,4,10,3,7,4,1
120583,2,0,20,-20,3,1
1127,4,10,36,-26,1,1
164620,2,7,17,-10,5,1
45502,4,27,23,4,4,0
356904,1,3,0,3,5,0
184584,4,45,27,18,14,0
420018,2,10,7,3,17,1
314289,1,0,7,-7,3,0
17125,4,29,17,12,9,1
391654,1,0,0,0,4,1
391402,2,10,10,0,4,0
289041,3,32,21,11,9,0
127151,2,10,9,1,6,0
281891,4,16,17,-1,6,1
179331,1,0,0,0,12,0
234496,3,20,20,0,2,1
237192,2,3,0,3,3,0
60585,4,30,41,-11,11,0
277795,1,0,7,-7,4,1
231874,2,7,20,-13,1,0
146252,3,3,30,-27,15,1
195301,1,0,0,0,2,0
122602,3,27,7,20,4,0
26854,2,10,0,10,13,0
131567,3,9,23,-14,8,1
226471,3,7,10,-3,16,1
114009,1,0,0,0,17,1
137171,1,0,0,0,11,0
346370,3,6,13,-7,1,1
379270,1,0,3,-3,16,0
174609,1,0,0,0,10,1
371451,3,14,14,0,12,1
161544,1,0,3,-3,4,1
58036,1,0,0,0,10,1
189369,4,20,10,10,16,0
153222,1,2,0,2,1,0
350918,3,3,14,-11,3,1
388528,4,3,23,-20,2,0
394252,1,0,0,0,5,0
306045,3,10,13,-3,17,1
98643,4,14,10,4,11,1
144357,1,0,3,-3,14,1
17161,1,0,7,-7,9,1
322344,2,14,7,7,7,1
221562,2,20,12,8,14,0
66699,4,10,31,-21,14,1
406697,3,24,0,24,11,1
172104,3,10,12,-2,9,1
23482,2,14,7,7,11,0
249059,2,21,17,4,9,1
91968,3,13,23,-10,8,0
97353,2,0,6,-6,10,0
164603,2,7,10,-3,5,0
385236,1,0,3,-3,1,1
193137,4,13,6,7,1,0
195372,2,10,3,7,2,1
388347,3,17,12,5,2,1
265436,1,0,0,0,16,0
267299,4,17,17,0,17,0
338405,4,24,10,14,14,1
157047,1,0,0,0,2,0
421668,2,10,7,3,17,1
361199,2,0,10,-10,7,1
140653,4,38,10,28,12,1
286218,1,0,6,-6,8,1
134499,4,3,30,-27,10,0
335750,3,10,7,3,13,1
33045,1,0,0,0,16,1
278243,4,34,28,6,4,1
180918,2,10,7,3,13,0
248148,2,3,3,0,8,0
403238,4,24,24,0,9,1
348123,4,17,19,-2,1,0
348931,1,0,0,0,2,1
219693,4,13,14,-1,13,0
113024,3,13,13,0,17,0
365060,4,23,6,17,9,0
59720,1,6,0,6,11,0
12547,2,3,17,-14,6,0
220864,3,7,35,-28,14,1
288841,2,10,17,-7,9,0
217625,3,19,16,3,12,1
99426,1,0,0,0,11,1
345092,2,6,3,3,17,1
395367,3,21,3,18,5,1
120349,1,0,3,-3,3,1
406198,2,7,10,-3,11,1
292386,4,12,16,-4,11,1
418030,4,28,35,-7,16,0
404364,4,20,6,14,10,1
326262,4,17,48,-31,9,0
125804,4,14,23,-9,5,1
276554,4,22,7,15,4,1
342090,2,3,3,0,16,1
75338,4,21,33,-12,17,0
62443,3,0,13,-13,12,0
128177,2,7,7,0,7,1
240181,3,16,3,13,5,0
73968,3,30,0,30,17,1
10690,4,16,17,-1,5,1
54199,2,0,3,-3,8,0
216044,2,10,12,-2,11,0
60416,4,23,7,16,11,0
226929,4,3,13,-10,16,1
155204,2,14,7,7,1,0
90790,4,20,7,13,7,1
257294,1,0,0,0,13,0
187399,3,27,7,20,16,1
112108,2,7,17,-10,17,0
178467,2,10,3,7,12,1
305447,4,20,3,17,17,1
421713,3,17,10,7,17,0
146795,2,7,0,7,15,1
12789,1,0,3,-3,6,1
265182,1,6,3,3,16,1
110898,2,7,3,4,16,1
182641,2,0,6,-6,14,1
27433,1,3,0,3,13,1
14486,3,24,16,8,7,1
354128,4,19,0,19,4,1
382766,1,7,0,7,17,1
412342,3,10,17,-7,13,1
2546,3,10,7,3,2,0
384164,3,21,20,1,1,1
404126,1,6,0,6,10,1
171671,4,19,17,2,9,1
139194,1,0,6,-6,12,1
265169,1,0,3,-3,16,1
317587,1,3,0,3,5,0
104864,1,0,3,-3,14,0
361769,2,14,0,14,7,0
37964,4,10,14,-4,1,1
76289,1,3,0,3,1,0
225199,2,3,7,-4,15,1
146240,3,3,22,-19,15,0
204603,3,0,38,-38,6,1
208269,1,0,7,-7,8,0
231268,1,0,3,-3,1,1
199474,1,0,0,0,4,1
132970,2,0,14,-14,9,1
236879,1,12,0,12,3,0
376123,4,0,9,-9,14,1
381086,3,17,14,3,16,1
75386,1,7,0,7,17,1
367370,1,7,13,-6,10,0
348282,4,16,46,-30,1,1
198972,3,16,23,-7,3,0
21176,4,0,16,-16,10,1
64744,3,28,0,28,13,0
77867,4,17,31,-14,1,0
347343,4,7,21,-14,1,1
10021,1,7,0,7,5,1
156411,1,0,0,0,2,1
398924,3,10,10,0,7,1
381214,2,13,10,3,16,1
369227,1,7,7,0,11,0
168240,1,0,7,-7,7,1
207296,2,7,14,-7,7,0
307327,2,14,19,-5,17,1
411015,2,14,14,0,13,1
184266,3,31,7,24,14,0
266920,2,13,0,13,17,0
369269,2,14,14,0,11,1
279672,2,23,0,23,5,0
316751,2,10,0,10,4,1
250992,3,3,6,-3,10,1
391068,1,0,0,0,4,0
266298,1,0,0,0,16,1
168674,1,6,0,6,7,1
64546,1,7,0,7,13,0
402098,2,6,0,6,9,0
351574,4,0,27,-27,3,1
261292,4,38,0,38,14,0
91884,1,0,0,0,8,0
302151,1,0,0,0,15,0
240311,3,7,10,-3,5,0
95566,3,9,10,-1,10,1
87925,4,19,15,4,6,1
129848,2,10,0,10,7,0
98546,1,0,0,0,11,0
92439,3,20,10,10,8,0
68473,1,0,7,-7,14,1
373187,2,3,3,0,13,0
387207,1,0,7,-7,2,1
399864,1,0,0,0,8,1
386936,2,7,21,-14,2,1
131371,2,7,13,-6,8,1
225857,4,24,24,0,16,0
231409,1,0,0,0,1,1
226538,1,0,0,0,16,1
73790,2,6,0,6,17,1
187177,1,0,0,0,16,0
33959,3,3,27,-24,16,1
345917,3,17,23,-6,17,1
259339,3,21,27,-6,13,0
211692,3,23,9,14,9,0
298196,1,0,3,-3,14,0
62023,3,17,7,10,12,0
271851,1,0,3,-3,2,0
29570,2,0,13,-13,14,1
119378,1,0,7,-7,3,1
41946,3,24,6,18,2,0
118286,3,12,7,5,2,1
355501,1,0,0,0,5,1
372769,2,3,0,3,13,0
414688,2,3,10,-7,14,1
146233,3,0,16,-16,15,1
30727,3,17,21,-4,15,1
7506,4,29,6,23,4,1
415011,3,10,19,-9,15,0
5890,1,0,3,-3,3,0
24751,4,20,33,-13,12,0
149919,1,0,0,0,16,1
213285,4,17,27,-10,10,1
389103,3,30,0,30,3,0
61837,2,3,20,-17,12,1
66358,3,14,24,-10,14,1
358671,1,0,0,0,6,1
33276,3,23,0,23,16,0
126035,2,7,0,7,6,0
15488,3,16,0,16,8,1
51038,3,0,20,-20,6,0
154002,2,7,14,-7,1,0
387483,4,21,16,5,2,0
123823,3,10,3,7,5,0
346620,1,7,0,7,1,0
94349,3,17,7,10,9,0
392588,1,0,0,0,4,1
159388,2,7,13,-6,3,1
203655,3,7,20,-13,6,1
295779,4,24,24,0,12,1
327516,2,7,7,0,10,0
260491,2,13,0,13,14,1
321594,2,10,6,4,7,1
161112,2,3,16,-13,4,0
295520,2,14,7,7,12,1
52525,3,10,0,10,7,1
400885,4,31,19,12,8,0
325866,1,0,0,0,9,1
153332,4,2,13,-11,1,0
125690,4,31,24,7,5,0
382068,1,7,0,7,17,0
54222,3,0,3,-3,8,0
136683,1,0,7,-7,11,1
252452,2,0,5,-5,10,0
68502,2,0,14,-14,14,1
192147,2,0,6,-6,1,0
75171,4,13,6,7,17,1
336181,4,17,10,7,13,1
188095,2,0,3,-3,16,1
309265,2,0,10,-10,1,1
185209,2,10,3,7,15,0
386783,2,7,7,0,2,0
83331,1,0,7,-7,4,1
188472,4,10,9,1,16,0
267038,1,0,0,0,17,1
25957,2,3,3,0,13,1
99673,4,26,3,23,11,1
157123,3,13,20,-7,2,1
288120,3,16,7,9,9,0
367308,4,3,17,-14,10,1
247111,2,13,6,7,8,1
147575,3,12,0,12,15,0
110800,3,6,10,-4,16,1
239030,4,29,18,11,4,1
227536,1,0,0,0,16,1
133029,3,9,14,-5,9,1
226297,3,16,7,9,16,1
85753,1,7,7,0,5,1
36543,4,19,20,-1,17,1
390014,4,31,25,6,3,0
58604,4,10,17,-7,10,1
277536,2,3,13,-10,4,0
394538,4,10,28,-18,5,0
281315,2,14,6,8,6,0
341279,4,23,16,7,16,1
145391,1,0,0,0,14,0
405531,1,0,7,-7,10,0
160632,2,7,0,7,4,1
73062,3,7,10,-3,16,1
240460,2,3,7,-4,5,1
115275,3,14,9,5,1,0
120254,2,14,3,11,3,1
133727,1,0,0,0,9,0
48435,3,17,17,0,5,1
258687,2,0,14,-14,13,1
326091,3,30,3,27,9,1
381488,2,14,0,14,17,1
286612,4,17,38,-21,8,0
369989,2,7,7,0,12,1
256597,3,14,0,14,12,1
167152,1,6,0,6,7,0
309362,1,0,0,0,1,1
418723,2,0,7,-7,16,1
89226,3,6,0,6,7,0
120397,2,16,9,7,3,0
154823,4,24,23,1,1,1
59228,3,21,58,-37,10,1
338927,1,3,0,3,15,0
124338,4,41,27,14,5,1
92894,3,27,0,27,8,1
295009,4,31,21,10,12,0
77817,3,7,14,-7,1,0
228462,1,3,0,3,17,1
176731,4,39,19,20,11,0
60642,2,7,3,4,11,0
378214,4,41,16,25,15,0
29473,3,10,14,-4,14,0
415675,1,0,0,0,15,0
295688,2,0,9,-9,12,1
300891,2,10,7,3,15,0
355703,2,7,3,4,5,1
189478,3,14,0,14,17,0
316524,1,0,0,0,4,1
251697,2,14,3,11,10,0
177422,3,17,10,7,11,1
327619,4,10,22,-12,10,0
89561,3,0,27,-27,7,1
119035,4,7,33,-26,3,1
189196,3,24,3,21,16,1
101086,2,10,10,0,12,0
278181,3,24,14,10,4,0
306030,3,10,10,0,17,1
143214,2,10,10,0,13,0
174829,3,13,17,-4,10,1
64810,1,0,0,0,13,1
198442,2,9,3,6,3,1
57213,4,13,7,6,10,1
179756,3,6,10,-4,12,0
62155,3,7,14,-7,12,1
76522,3,7,20,-13,1,0
85650,2,17,7,10,5,1
117850,4,9,13,-4,2,0
170618,4,47,9,38,8,0
223106,3,31,17,14,14,1
189287,1,3,0,3,16,1
333340,2,10,7,3,12,1
279585,4,10,16,-6,5,1
361008,1,3,2,1,7,1
50513,1,0,0,0,6,0
41621,2,14,0,14,2,1
393681,2,0,0,0,5,1
75384,1,7,0,7,17,1
159234,2,17,24,-7,3,0
81328,1,0,0,0,3,1
207623,3,42,10,32,7,0
166111,2,14,3,11,6,1
29979,2,14,0,14,14,0
256627,4,21,7,14,12,1
89139,4,23,6,17,6,1
319724,1,0,0,0,6,0
49610,1,0,0,0,6,0
361722,1,0,0,0,7,0
306649,4,14,27,-13,17,1
219448,1,0,0,0,13,0
16252,3,6,16,-10,8,1
239195,4,27,19,8,4,0
180889,1,7,0,7,13,0
88805,3,13,13,0,6,1
245449,4,16,6,10,7,0
397139,2,3,0,3,6,0
247277,3,28,28,0,8,1
13989,1,0,0,0,7,1
107246,4,14,31,-17,15,1
373399,3,10,10,0,13,1
199046,1,0,7,-7,4,1
360018,2,3,26,-23,7,0
395800,2,0,7,-7,6,1
205645,2,7,9,-2,7,1
226601,3,10,3,7,16,0
179257,3,26,3,23,12,0
62027,3,17,7,10,12,1
211850,3,22,10,12,9,1
150392,1,0,0,0,16,0
29171,4,3,19,-16,14,0
374222,1,0,0,0,13,1
8003,1,3,0,3,4,0
265855,1,0,6,-6,16,1
12308,4,6,6,0,6,0
397278,2,0,14,-14,6,0
56601,3,19,17,2,9,1
213631,1,7,7,0,10,1
419961,1,0,0,0,17,1
3299,3,3,3,0,2,1
102772,2,10,3,7,13,1
131805,1,7,0,7,8,0
125512,4,30,7,23,5,0
73015,1,0,0,0,16,0
392868,4,17,23,-6,4,1
307783,2,17,7,10,1,0
181140,4,24,14,10,13,0
130881,4,23,15,8,8,0
12819,2,6,3,3,6,0
237122,4,8,33,-25,3,1
175961,1,0,0,0,11,0
274293,4,29,16,13,3,1
399247,4,13,20,-7,7,0
33085,2,3,14,-11,16,1
86101,2,28,3,25,5,1
324666,1,0,7,-7,8,1
98547,2,0,0,0,11,0
341121,4,14,24,-10,15,1
181120,3,24,14,10,13,0
239597,3,20,10,10,4,1
348888,4,9,14,-5,2,0
375111,2,7,6,1,14,0
177191,1,0,0,0,11,1
30645,4,24,9,15,14,1
210940,4,26,10,16,9,0
8667,4,7,10,-3,4,1
253544,2,6,7,-1,11,0
247596,3,16,23,-7,8,1
182823,3,26,17,9,14,1
251209,2,10,10,0,10,0
91072,4,9,0,9,7,1
383435,4,13,9,4,17,0
234897,1,0,0,0,2,1
295335,1,0,0,0,12,1
154243,1,0,0,0,1,1
4211,2,10,6,4,2,1
198771,2,3,6,-3,3,1
415943,4,17,30,-13,15,1
358762,4,14,17,-3,6,0
156004,2,10,14,-4,2,1
368310,4,9,18,-9,11,0
70159,3,20,7,13,15,0
340953,3,10,10,0,15,0
305211,1,13,7,6,16,1
67005,1,0,0,0,14,1
415292,2,0,14,-14,15,1
90995,2,3,0,3,7,1
247088,2,8,3,5,8,1
283493,4,23,14,9,7,0
176750,4,39,19,20,11,1
218699,1,0,0,0,13,0
236315,2,0,16,-16,3,0
378547,2,7,6,1,15,1
126208,3,21,6,15,6,0
94029,2,6,21,-15,9,1
272979,2,3,3,0,2,0
156508,3,7,6,1,2,0
386378,3,17,6,11,2,0
269564,4,21,31,-10,1,1
279566,3,10,13,-3,5,0
197152,3,27,20,7,3,0
302159,1,6,0,6,15,1
226313,3,19,7,12,16,0
189669,4,17,6,11,17,0
72822,4,31,17,14,16,0
28196,2,3,0,3,13,0
123883,1,0,0,0,5,0
63507,4,31,16,15,12,0
349186,4,27,14,13,2,0
252492,3,10,22,-12,10,0
236790,2,3,9,-6,3,0
40308,3,6,0,6,2,0
336056,4,16,28,-12,13,0
212083,1,0,0,0,10,1
49827,3,14,10,4,6,1
340247,4,29,31,-2,15,0
123081,4,14,21,-7,4,1
253555,2,6,7,-1,11,0
266246,4,31,19,12,16,1
34504,4,48,10,38,16,1
285816,4,14,24,-10,8,0
102327,3,13,10,3,13,1
114954,2,7,3,4,1,0
253369,2,7,14,-7,11,0
38024,1,3,0,3,1,0
36764,2,7,7,0,17,0
406253,3,21,27,-6,11,0
70495,4,30,20,10,15,0
29684,1,0,0,0,14,1
303563,2,14,3,11,16,0
44035,4,3,28,-25,3,1
233813,4,25,37,-12,2,0
241309,4,13,7,6,5,0
174349,2,17,0,17,10,1
282597,1,0,0,0,6,0
12018,4,24,14,10,6,1
308120,3,13,19,-6,1,1
263105,1,0,0,0,15,0
382924,2,0,7,-7,17,0
379793,4,9,24,-15,16,0
191356,2,0,14,-14,17,0
80947,2,13,0,13,3,0
8399,4,30,10,20,4,1
44452,3,17,7,10,3,0
357662,2,6,3,3,5,1
269653,2,9,0,9,1,1
33405,3,20,17,3,16,0
216050,2,10,12,-2,11,0
147577,3,12,0,12,15,0
317756,1,0,0,0,5,0
184788,2,17,14,3,15,0
269318,1,0,7,-7,1,1
206757,4,7,24,-17,7,1
187073,2,10,0,10,16,0
231261,1,0,3,-3,1,1
194514,4,26,10,16,2,1
54111,4,20,3,17,8,0
273731,1,0,0,0,2,0
197294,2,14,0,14,3,0
195220,2,16,3,13,2,0
9982,4,3,3,0,5,1
381867,4,25,21,4,17,0
314828,4,35,7,28,4,0
323754,1,6,0,6,8,0
414185,4,17,23,-6,14,0
347379,5,21,21,0,1,1
314610,2,7,0,7,3,0
365657,1,0,0,0,9,1
409071,2,3,10,-7,12,0
28539,3,24,7,17,14,0
326078,3,23,3,20,9,0
231187,3,10,7,3,1,1
173273,1,7,3,4,10,0
34142,3,10,3,7,16,1
248641,3,17,10,7,9,0
97241,3,12,6,6,10,0
91766,2,3,0,3,8,0
94515,3,0,3,-3,9,1
267322,4,17,17,0,17,0
313448,3,17,7,10,3,1
406245,3,21,24,-3,11,0
187589,4,13,23,-10,16,1
39515,1,0,0,0,1,0
240545,4,19,16,3,5,0
13072,4,14,14,0,6,1
293420,4,29,17,12,11,0
318192,4,22,17,5,5,0
221936,4,19,19,0,14,0
86248,2,6,10,-4,5,0
105641,1,7,3,4,14,1
383757,1,0,0,0,1,1
183801,2,10,21,-11,14,1
42944,3,24,23,1,3,0
340481,2,0,13,-13,15,0
273986,4,7,29,-22,2,1
304116,4,16,30,-14,16,0
363298,4,27,14,13,8,1
43425,5,24,24,0,3,0
240458,2,3,7,-4,5,1
284786,3,26,17,9,7,1
231527,4,23,29,-6,1,1
110824,4,6,10,-4,16,0
386022,2,7,0,7,1,0
407850,2,3,0,3,11,1
201066,4,41,7,34,5,0
332087,4,17,9,8,12,0
146083,3,19,10,9,15,0
34199,1,7,0,7,16,0
143102,3,17,24,-7,13,1
142646,3,20,13,7,13,0
162523,3,28,10,18,4,0
307315,2,14,13,1,17,0
154242,1,0,0,0,1,1
124102,2,3,21,-18,5,1
137882,3,17,8,9,11,0
380093,4,35,23,12,16,0
265573,1,0,2,-2,16,0
1424,4,16,0,16,1,1
144528,2,7,7,0,14,0
86634,1,0,0,0,5,1
16746,1,3,7,-4,8,1
256200,1,0,0,0,12,1
397467,3,13,16,-3,6,1
328694,1,0,0,0,10,0
142037,4,20,14,6,13,1
39685,2,3,0,3,1,0
362236,3,12,17,-5,8,0
411207,4,3,23,-20,13,1
226146,4,20,17,3,16,1
5534,3,13,10,3,3,1
106947,3,12,6,6,14,1
6362,2,0,13,-13,3,1
368447,4,30,14,16,11,0
88781,3,13,10,3,6,1
81200,1,0,0,0,3,0
286084,3,10,3,7,8,0
98867,2,7,7,0,11,0
99610,2,0,3,-3,11,1
280008,3,3,13,-10,5,0
411164,2,0,23,-23,13,1
177490,4,27,17,10,11,0
366682,2,17,10,7,10,0
337732,1,3,0,3,14,0
330057,2,0,3,-3,11,1
358585,3,13,9,4,6,1
367688,2,0,6,-6,10,1
191285,4,10,17,-7,17,1
13103,1,0,0,0,6,0
414410,2,7,20,-13,14,1
113863,2,7,0,7,17,0
92492,4,23,17,6,8,1
205448,1,7,0,7,6,0
86542,2,20,3,17,5,1
130335,2,7,0,7,8,1
174226,3,3,26,-23,10,1
233572,2,14,27,-13,2,1
70408,1,7,14,-7,15,1
307977,3,14,6,8,1,0
278011,2,3,10,-7,4,0
294823,2,28,21,7,12,1
350301,2,14,0,14,2,0
131855,3,24,7,17,8,0
292197,3,21,14,7,11,0
255384,3,21,6,15,12,1
49712,4,21,31,-10,6,1
168752,3,13,6,7,7,0
281869,4,16,7,9,6,0
94019,2,6,21,-15,9,1
71980,1,0,3,-3,16,1
257561,4,19,10,9,13,0
343868,4,26,6,20,17,0
172500,1,0,0,0,9,0
395766,1,0,0,0,6,1
12397,2,10,3,7,6,0
284035,3,3,3,0,7,1
356768,1,0,0,0,5,1
22589,2,13,3,10,11,1
156764,1,13,7,6,2,1
202087,2,13,0,13,5,0
253481,4,17,44,-27,11,1
147488,1,0,0,0,15,0
206953,1,7,0,7,7,0
206102,3,20,6,14,7,0
180054,4,27,20,7,13,1
221647,4,23,21,2,14,0
34195,1,0,0,0,16,1
256022,4,25,12,13,12,0
246302,2,7,3,4,7,0
256626,4,21,7,14,12,1
123164,2,3,21,-18,4,1
372488,4,23,14,9,13,1
16979,4,27,23,4,8,1
44401,2,3,0,3,3,0
382958,3,3,13,-10,17,0
72153,1,0,3,-3,16,0
366309,4,28,10,18,10,0
57988,4,13,20,-7,10,1
240695,1,0,0,0,5,1
185493,1,0,3,-3,15,1
119364,1,0,0,0,3,1
29740,3,27,3,24,14,0
372589,2,7,0,7,13,0
420846,4,17,27,-10,17,1
318205,4,22,27,-5,5,1
83456,4,10,23,-13,4,0
287625,2,3,3,0,9,0
391033,4,27,34,-7,4,1
342318,4,20,6,14,16,0
34899,3,27,10,17,16,0
24957,2,10,14,-4,12,0
389815,3,17,6,11,3,1
395339,2,14,3,11,5,1
72189,2,10,10,0,16,1
139498,1,0,0,0,12,1
198598,2,0,0,0,3,1
109,3,7,7,0,1,1
320503,4,26,24,2,6,0
283262,2,10,9,1,7,0
91344,3,14,7,7,8,0
26778,3,6,33,-27,13,1
56733,2,0,10,-10,9,0
88326,3,14,7,7,6,1
315586,4,7,14,-7,4,0
396642,1,0,0,0,6,0
364182,4,34,3,31,9,1
105196,2,7,7,0,14,0
173210,4,20,24,-4,9,1
122775,4,10,27,-17,4,0
266226,3,24,12,12,16,0
164182,2,17,21,-4,5,1
353349,1,0,0,0,4,1
255157,1,6,0,6,12,1
398129,4,30,42,-12,7,1
83130,4,13,30,-17,4,0
135990,2,3,10,-7,10,1
45921,3,17,3,14,4,0
227011,2,10,6,4,16,0
156011,2,17,14,3,2,0
396469,4,28,25,3,6,0
512,2,7,6,1,1,0
110939,3,7,10,-3,16,0
368289,3,6,6,0,11,1
151904,2,13,7,6,17,1
405268,2,14,7,7,10,0
88819,4,13,13,0,6,0
291517,1,3,0,3,11,0
362672,3,3,7,-4,8,0
62850,2,3,3,0,12,1
235288,4,18,6,12,3,1
343414,1,0,0,0,16,1
66173,2,17,3,14,13,0
357322,4,14,22,-8,5,0
396757,4,7,20,-13,6,1
84377,1,0,0,0,4,1
141456,1,0,0,0,13,1
300187,3,21,3,18,14,1
152249,3,21,0,21,17,1
293361,2,7,7,0,11,1
180952,3,17,14,3,13,1
226598,3,10,3,7,16,0
144591,3,14,19,-5,14,1
83139,4,13,30,-17,4,1
91945,2,3,23,-20,8,1
157901,3,6,15,-9,3,0
371009,2,7,7,0,12,0
69264,2,13,0,13,15,0
220253,2,17,9,8,13,1
153303,4,2,10,-8,1,0
114380,3,34,13,21,1,0
262870,2,7,20,-13,15,0
96393,1,0,0,0,10,1
252679,4,6,10,-4,10,1
67978,4,42,13,29,14,0
152167,1,6,0,6,17,1
8288,1,0,0,0,4,1
373484,1,0,10,-10,13,1
240918,2,14,3,11,5,0
200120,2,7,17,-10,4,1
293966,4,7,21,-14,12,0
25223,1,0,0,0,12,1
188814,4,7,33,-26,16,1
178186,2,0,10,-10,12,1
340588,1,3,0,3,15,0
298625,1,3,0,3,14,1
106563,2,14,0,14,14,1
98459,3,17,14,3,11,0
323673,3,20,0,20,8,0
297618,1,7,0,7,13,0
288971,2,16,7,9,9,1
188546,2,3,10,-7,16,1
302817,3,9,20,-11,15,1
28809,2,3,0,3,14,1
248469,3,10,6,4,8,1
294556,4,24,13,11,12,1
334939,1,0,6,-6,13,0
26772,3,6,33,-27,13,1
119600,3,10,9,1,3,0
34317,4,20,9,11,16,1
12357,1,7,3,4,6,0
310162,3,21,7,14,2,0
284558,1,7,0,7,7,0
102530,4,31,10,21,13,0
164771,3,26,14,12,6,1
387747,4,0,36,-36,2,1
168217,4,29,15,14,7,1
94215,3,24,17,7,9,1
203896,5,37,37,0,6,1
199315,1,0,0,0,4,0
406723,4,34,0,34,11,0
218538,1,0,7,-7,13,1
234530,4,20,20,0,2,0
189909,2,0,7,-7,17,1
234608,2,10,10,0,2,1
330969,2,16,7,9,11,1
232811,3,16,14,2,2,1
105362,2,22,7,15,14,1
233856,1,7,3,4,2,1
330946,1,6,7,-1,11,1
212361,4,13,10,3,10,1
187502,2,3,10,-7,16,1
244484,2,7,3,4,7,0
285123,4,3,0,3,7,1
320865,3,3,14,-11,6,1
697,3,0,17,-17,1,1
396631,4,23,10,13,6,0
296065,4,6,7,-1,13,1
222885,1,0,0,0,14,0
251801,1,0,0,0,10,0
384130,2,7,17,-10,1,0
104461,2,7,10,-3,13,1
100856,4,19,19,0,12,0
338776,1,7,0,7,15,0
100376,3,9,20,-11,12,0
210388,1,6,0,6,9,0
117107,4,7,27,-20,2,0
419193,3,10,6,4,16,1
282475,1,7,0,7,6,0
171111,1,0,0,0,8,0
184914,2,0,7,-7,15,0
42844,4,6,37,-31,3,0
418425,2,14,3,11,16,0
201904,1,0,0,0,5,0
232836,4,16,17,-1,2,1
90591,2,14,10,4,7,1
103113,4,34,7,27,13,0
70842,1,7,3,4,15,1
341126,4,14,24,-10,15,1
3283,2,3,3,0,2,0
267202,1,3,0,3,17,0
375662,3,17,20,-3,14,0
116245,1,10,0,10,1,0
254088,1,0,0,0,11,0
185192,1,7,0,7,15,0
335496,4,13,12,1,13,0
409510,2,6,0,6,12,1
210821,4,24,10,14,9,0
163441,3,7,23,-16,5,1
322527,4,15,3,12,7,1
169740,1,0,0,0,8,0
103754,1,0,0,0,13,0
342712,2,0,7,-7,16,0
27208,3,19,7,12,13,0
280723,3,7,6,1,5,0
256971,4,39,30,9,12,0
375448,2,7,7,0,14,0
112351,1,3,0,3,17,0
47725,4,6,17,-11,5,0
204224,1,0,7,-7,6,0
51101,1,0,0,0,7,1
234472,2,17,13,4,2,0
139327,4,20,13,7,12,0
334975,2,3,7,-4,13,0
233484,4,23,10,13,2,1
356705,3,19,16,3,5,1
40538,1,7,0,7,2,0
36893,1,0,7,-7,17,1
297762,1,7,0,7,13,0
183759,1,7,14,-7,14,0
147692,2,10,3,7,15,0
370769,3,12,10,2,12,1
166931,4,13,6,7,6,1
50342,4,13,23,-10,6,0
141545,3,27,10,17,13,0
50138,3,0,17,-17,6,1
395873,4,10,17,-7,6,0
160495,3,20,7,13,4,0
179857,2,3,9,-6,13,0
189899,1,0,7,-7,17,1
250416,1,0,0,0,9,0
351073,3,21,16,5,3,1
107913,2,3,3,0,15,1
319776,2,7,7,0,6,1
58446,4,41,17,24,10,1
248019,3,21,6,15,8,1
247205,1,0,0,0,8,0
69017,3,24,17,7,15,0
362271,4,18,24,-6,8,1
223828,2,9,0,9,15,0
319532,4,13,23,-10,6,1
798,2,7,6,1,1,1
287882,1,0,0,0,9,0
192258,2,10,3,7,1,1
146997,3,24,0,24,15,0
34993,1,6,0,6,16,1
290093,4,13,9,4,10,0
175221,1,10,0,10,10,1
79053,4,10,14,-4,2,1
182140,2,16,7,9,13,1
23895,2,3,0,3,12,1
389546,4,27,17,10,3,0
400762,1,7,0,7,8,0
45746,2,10,7,3,4,0
155964,1,3,7,-4,2,0
360192,3,17,13,4,7,1
17280,4,21,34,-13,9,0
309617,4,16,3,13,1,1
176620,1,0,12,-12,11,1
225068,3,10,14,-4,15,0
401184,1,0,0,0,8,0
415279,2,0,7,-7,15,1
321513,4,24,30,-6,7,1
197724,2,7,10,-3,3,0
65315,3,3,21,-18,13,1
112516,1,3,9,-6,17,1
131830,2,14,7,7,8,0
51401,1,3,0,3,7,1
275593,2,14,0,14,3,0
299188,4,17,19,-2,14,0
103839,3,19,0,19,13,1
101798,5,13,13,0,12,1
161292,3,20,6,14,4,0
171890,2,0,7,-7,9,1
396430,3,20,18,2,6,0
348690,2,10,10,0,2,1
246613,2,14,3,11,8,0
412596,1,0,0,0,14,1
198930,2,13,16,-3,3,0
36924,2,0,16,-16,17,0
85647,2,17,7,10,5,1
76193,2,9,20,-11,1,1
389170,1,7,0,7,3,1
280858,3,10,3,7,6,0
348575,3,28,17,11,2,0
245782,4,23,20,3,7,0
226028,5,34,34,0,16,0
361585,4,19,17,2,7,0
127124,2,3,9,-6,6,1
80287,1,0,3,-3,2,1
238486,2,6,0,6,4,1
157234,2,7,3,4,2,1
176568,4,19,17,2,11,0
344570,4,0,0,0,17,0
241187,4,23,10,13,5,0
154106,2,0,6,-6,1,0
411534,4,13,31,-18,13,0
98097,1,7,0,7,11,1
249642,1,0,7,-7,9,1
337739,1,3,0,3,14,1
348772,1,0,0,0,2,0
122250,2,3,10,-7,4,0
132897,4,6,21,-15,9,0
402353,1,0,0,0,9,0
25813,1,3,7,-4,12,1
192488,3,7,17,-10,1,0
408175,3,6,0,6,12,1
319479,3,3,10,-7,6,0
144621,4,20,22,-2,14,1
10109,4,44,7,37,5,0
161715,2,10,3,7,4,0
122525,1,7,0,7,4,1
168294,2,10,14,-4,7,1
246298,1,7,3,4,7,0
222287,1,0,0,0,14,0
348101,3,3,19,-16,1,0
79547,1,0,0,0,2,1
65309,3,3,21,-18,13,0
344029,4,23,9,14,17,0
185328,1,0,0,0,15,1
168430,2,0,17,-17,7,1
236467,2,7,3,4,3,1
41075,4,3,16,-13,2,1
45320,3,17,13,4,4,0
300645,3,10,3,7,15,1
298424,4,7,21,-14,14,0
233700,2,7,21,-14,2,1
297226,3,7,6,1,13,1
240584,1,3,0,3,5,0
179294,4,33,3,30,12,0
40665,4,41,7,34,2,0
242545,1,0,0,0,6,1
276026,2,10,0,10,3,0
275317,3,10,14,-4,3,0
291154,3,18,16,2,10,1
207997,2,14,0,14,8,0
313866,2,14,19,-5,3,1
128876,1,0,0,0,7,0
10770,2,7,0,7,5,1
248494,4,23,6,17,8,0
43582,4,24,3,21,3,1
311277,4,9,3,6,2,0
232034,2,0,17,-17,1,1
219718,4,13,14,-1,13,1
401948,2,0,3,-3,9,0
341,2,14,10,4,1,1
195327,1,3,0,3,2,0
210588,2,6,14,-8,9,1
130951,2,7,21,-14,8,0
361793,2,21,7,14,7,1
370057,4,31,20,11,12,1
147530,2,6,0,6,15,0
365627,4,35,27,8,9,0
64631,4,20,17,3,13,0
195971,3,0,24,-24,2,0
391632,4,17,31,-14,4,1
356618,1,0,0,0,5,1
415863,2,7,20,-13,15,1
195827,3,20,14,6,2,1
227790,4,6,14,-8,16,0
258295,3,21,12,9,13,0
300516,3,23,17,6,14,0
339569,2,10,7,3,15,1
175570,3,20,7,13,11,0
385848,4,33,3,30,1,0
236781,2,0,9,-9,3,1
297328,1,3,3,0,13,0
206691,2,0,7,-7,7,0
201975,3,3,0,3,5,0
413818,2,14,0,14,14,0
142553,1,0,0,0,13,0
404219,4,12,9,3,10,0
130405,4,7,6,1,8,0
298976,3,9,9,0,14,1
290892,1,0,0,0,10,1
115898,3,7,23,-16,1,0
115902,4,7,23,-16,1,1
379583,2,13,6,7,16,1
386305,1,7,0,7,2,0
205593,1,7,0,7,7,0
367105,2,14,7,7,10,1
402973,2,7,14,-7,9,1
397358,4,10,24,-14,6,0
130118,1,0,0,0,8,0
169333,2,3,14,-11,8,1
317110,4,20,17,3,4,0
173941,3,13,19,-6,10,0
325963,4,22,7,15,9,0
36228,3,10,17,-7,17,0
373154,1,0,0,0,13,1
184391,3,21,6,15,14,1
367028,3,10,37,-27,10,0
297478,1,0,0,0,13,1
8307,1,0,0,0,4,1
378392,2,7,0,7,15,0
339416,2,7,10,-3,15,1
214630,4,3,16,-13,11,0
23635,2,7,13,-6,12,1
24629,1,0,0,0,12,1
202736,3,13,10,3,5,1
355301,3,14,17,-3,4,1
378411,2,7,0,7,15,0
248205,4,12,10,2,8,0
245284,3,9,3,6,7,0
76419,4,29,12,17,1,0
386119,4,24,9,15,1,0
155833,2,7,10,-3,2,1
81466,4,10,16,-6,3,1
391584,3,10,21,-11,4,0
365619,3,35,27,8,9,1
265691,4,12,18,-6,16,1
149138,4,17,24,-7,16,0
192873,4,16,23,-7,1,1
383881,4,3,10,-7,1,0
278485,3,36,0,36,4,0
281109,1,0,0,0,6,1
151432,1,14,0,14,17,1
381944,2,0,13,-13,17,1
148382,4,14,6,8,16,1
209358,2,7,7,0,8,0
259262,1,7,0,7,13,0
43844,3,21,16,5,3,0
138946,2,7,3,4,12,1
118663,2,14,6,8,2,1
197946,1,0,0,0,3,0
157507,1,0,0,0,2,1
58371,2,21,0,21,10,1
413085,2,27,21,6,14,1
233746,3,13,24,-11,2,0
206878,3,9,17,-8,7,1
10086,3,38,7,31,5,0
282764,1,0,3,-3,6,1
382475,1,0,0,0,17,0
250363,4,14,20,-6,9,1
115106,2,3,13,-10,1,0
235596,4,27,13,14,3,0
328373,4,3,40,-37,10,1
72217,3,17,10,7,16,0
74702,3,7,17,-10,17,1
361939,3,10,3,7,7,1
357993,3,24,13,11,6,0
313991,1,0,0,0,3,0
370310,3,7,35,-28,12,1
23795,3,17,0,17,12,0
169326,2,3,7,-4,8,0
358214,1,0,0,0,6,0
197836,1,6,0,6,3,0
100682,3,21,21,0,12,0
146464,1,0,0,0,15,1
165270,3,17,14,3,6,0
386041,2,7,0,7,1,1
246278,1,0,0,0,7,1
79341,3,29,3,26,2,1
15699,4,37,17,20,8,0
86826,2,9,13,-4,5,1
155496,1,7,0,7,2,1
39784,4,9,7,2,1,1
393579,3,7,19,-12,5,1
244801,2,7,0,7,7,0
374448,3,32,0,32,14,0
208363,3,17,27,-10,8,1
265982,4,0,33,-33,16,1
234447,2,10,6,4,2,0
136290,3,18,7,11,11,1
147506,1,0,0,0,15,1
121219,3,21,27,-6,3,1
193783,1,0,0,0,1,0
140896,3,17,7,10,13,0
283153,3,13,9,4,7,0
17483,1,10,0,10,9,0
167930,4,21,19,2,7,0
340820,4,24,16,8,15,1
121549,3,16,10,6,4,1
48513,1,11,0,11,5,0
308229,2,7,10,-3,1,1
312444,4,39,41,-2,3,1
146840,2,24,0,24,15,0
221305,4,6,32,-26,14,1
302859,4,12,23,-11,15,0
237892,4,13,27,-14,4,1
18341,4,25,17,8,9,1
200576,2,14,7,7,4,0
162349,2,10,10,0,4,0
172890,3,24,24,0,9,1
338209,2,14,21,-7,14,0
270877,3,16,13,3,1,1
360096,4,10,43,-33,7,1
407874,2,6,10,-4,11,1
401019,4,29,15,14,8,0
306550,1,0,7,-7,17,1
339373,1,0,3,-3,15,1
3826,4,23,10,13,2,0
129815,1,7,0,7,7,0
134922,2,7,16,-9,10,0
109218,1,3,0,3,15,0
388140,2,3,6,-3,2,1
329216,3,17,13,4,10,0
4577,1,0,7,-7,2,1
404880,1,0,0,0,10,0
216523,3,27,11,16,12,1
148421,1,7,0,7,16,0
113366,1,0,0,0,17,0
132626,4,20,49,-29,9,1
19966,1,6,3,3,10,0
315814,2,0,19,-19,4,1
240231,4,16,12,4,5,0
373639,1,0,9,-9,13,1
306164,2,7,3,4,17,1
14477,3,24,16,8,7,0
133993,1,0,0,0,9,0
110629,3,20,10,10,16,1
131166,4,27,12,15,8,1
297274,4,24,6,18,13,1
143655,3,13,10,3,14,1
337764,2,20,6,14,14,0
380748,1,3,0,3,16,0
402646,4,23,23,0,9,0
4521,3,17,19,-2,2,0
214373,1,0,7,-7,11,0
149562,3,14,16,-2,16,0
127634,3,24,9,15,6,0
153886,3,7,3,4,1,1
157388,2,3,7,-4,2,1
351931,2,7,7,0,3,1
43552,3,17,3,14,3,1
203096,4,39,17,22,5,1
419707,2,0,3,-3,17,0
332932,4,24,3,21,12,1
347940,3,0,21,-21,1,1
360566,2,7,7,0,7,0
250090,4,17,16,1,9,1
364837,2,6,14,-8,9,0
228425,4,10,27,-17,17,0
297492,1,2,0,2,13,1
346365,3,6,13,-7,1,1
54877,1,0,0,0,8,0
49162,1,10,0,10,6,0
311561,1,0,0,0,2,1
324476,4,17,12,5,8,0
342403,2,3,3,0,16,0
311947,3,28,10,18,2,0
91839,4,24,6,18,8,0
96449,2,10,14,-4,10,0
42151,1,0,0,0,2,1
157910,3,6,15,-9,3,1
121223,3,21,27,-6,3,1
370172,3,23,3,20,12,1
396157,3,24,23,1,6,1
79584,2,14,0,14,2,0
187686,2,7,6,1,16,1
147640,1,0,0,0,15,1
224947,3,3,9,-6,15,0
66728,1,0,3,-3,14,0
144024,4,21,16,5,14,0
129023,4,42,13,29,7,1
111032,1,7,0,7,16,0
29866,3,9,16,-7,14,0
96488,3,17,17,0,10,0
113624,3,6,13,-7,17,1
368439,4,23,14,9,11,1
248994,4,27,3,24,9,0
31783,3,0,17,-17,15,1
133753,2,7,7,0,9,0
204375,1,0,3,-3,6,0
227611,3,28,0,28,16,1
358772,4,14,20,-6,6,1
373954,1,7,0,7,13,0
208386,4,17,43,-26,8,1
336538,2,0,0,0,14,1
171866,1,0,6,-6,9,0
234135,1,0,0,0,2,0
409635,1,0,0,0,12,1
130935,2,7,21,-14,8,1
196005,4,7,30,-23,2,1
303076,1,0,7,-7,16,1
88691,4,26,20,6,6,0
328593,2,10,14,-4,10,1
307985,3,14,6,8,1,0
178710,4,3,20,-17,12,1
384478,4,28,0,28,1,0
98161,3,21,13,8,11,0
242854,1,7,3,4,6,1
94884,4,13,13,0,9,0
245390,2,9,3,6,7,0
367324,4,6,20,-14,10,0
333527,3,13,3,10,12,1
21586,3,7,24,-17,11,1
291907,3,17,10,7,11,1
302483,2,3,10,-7,15,1
155629,1,0,0,0,2,1
71743,2,17,20,-3,16,0
150845,1,0,0,0,17,1
312411,4,26,34,-8,3,1
411009,2,14,13,1,13,0
217656,4,26,16,10,12,0
369357,1,0,0,0,11,0
164696,1,0,0,0,6,0
195408,3,24,3,21,2,0
211353,3,10,10,0,9,0
297920,2,10,0,10,13,1
166639,4,22,20,2,6,1
87753,4,6,20,-14,6,1
192665,3,13,7,6,1,0
102520,4,31,10,21,13,0
365378,1,0,0,0,9,1
70635,4,17,17,0,15,0
321556,1,3,3,0,7,0
4268,4,20,6,14,2,0
380521,2,7,17,-10,16,1
260238,3,10,3,7,14,0
340678,4,16,13,3,15,0
420621,2,7,13,-6,17,0
229459,4,13,6,7,17,0
105307,1,0,0,0,14,0
234319,2,10,0,10,2,1
326869,4,10,20,-10,9,1
357926,1,0,6,-6,6,1
274166,1,0,0,0,3,1
311396,4,42,13,29,2,0
401087,2,21,3,18,8,1
222356,3,21,3,18,14,0
189402,1,0,0,0,17,0
191082,2,7,3,4,17,0
324168,4,3,17,-14,8,1
30303,3,3,10,-7,14,0
270184,1,0,0,0,1,1
213301,1,0,0,0,10,1
420554,4,10,42,-32,17,1
419746,3,10,10,0,17,0
301936,3,14,20,-6,15,0
185757,3,23,3,20,15,0
83084,3,6,21,-15,4,0
302971,3,20,13,7,16,0
62635,4,9,17,-8,12,1
297844,3,14,10,4,13,0
116807,4,40,33,7,2,1
54470,2,0,7,-7,8,1
221969,4,22,25,-3,14,1
96293,2,0,9,-9,10,0
294684,3,6,14,-8,12,0
240530,4,12,13,-1,5,0
413918,4,20,15,5,14,0
237365,3,6,14,-8,3,0
406027,1,0,3,-3,11,1
420496,3,3,35,-32,17,1
152246,3,21,0,21,17,1
273801,3,10,7,3,2,0
38734,4,24,17,7,1,0
320280,3,14,14,0,6,0
294479,2,7,10,-3,12,1
212611,2,7,17,-10,10,1
164178,2,17,14,3,5,0
207687,1,0,7,-7,7,1
348819,2,3,7,-4,2,0
43806,2,14,13,1,3,1
313318,3,6,24,-18,3,0
253031,1,0,0,0,11,1
90085,1,0,0,0,7,0
75849,1,7,0,7,1,1
272658,1,9,0,9,2,0
147312,4,7,31,-24,15,0
124542,2,6,0,6,5,0
175530,2,9,0,9,11,1
253816,1,7,7,0,11,1
218336,3,17,23,-6,12,0
268375,4,29,6,23,17,0
122796,1,6,0,6,4,1
47922,1,0,0,0,5,0
260093,3,6,21,-15,14,1
298008,4,37,7,30,13,0
208095,4,21,19,2,8,0
97945,2,0,7,-7,11,0
279041,1,0,0,0,5,1
66881,2,0,7,-7,14,1
295093,2,7,7,0,12,0
405978,4,14,7,7,11,1
49879,4,28,20,8,6,1
258349,1,0,0,0,13,0
360956,4,31,5,26,7,1
115021,4,13,19,-6,1,1
101150,4,19,27,-8,12,0
315267,4,20,19,1,4,0
73586,1,0,0,0,17,0
195233,3,16,10,6,2,0
219224,3,13,3,10,13,1
44113,2,0,13,-13,3,1
279592,4,10,16,-6,5,1
209206,2,7,7,0,8,1
178098,5,26,23,3,12,0
281790,2,3,0,3,6,1
403880,2,10,7,3,10,1
218621,3,10,30,-20,13,1
402803,4,30,20,10,9,0
241067,1,7,0,7,5,0
267197,1,0,0,0,17,1
207000,2,21,0,21,7,1
329445,1,0,0,0,10,1
194808,4,10,23,-13,2,0
293423,4,29,17,12,11,0
154815,4,24,23,1,1,0
53857,2,0,0,0,8,0
355219,1,0,14,-14,4,1
170360,1,7,0,7,8,0
168445,3,0,17,-17,7,0
161676,1,0,0,0,4,1
91496,3,19,0,19,8,0
125378,1,0,0,0,5,0
93866,2,14,0,14,9,1
407194,1,0,0,0,11,0
254410,2,13,0,13,11,0
338356,2,3,0,3,14,1
123650,3,7,16,-9,4,1
151650,3,23,26,-3,17,0
192314,3,27,10,17,1,0
201720,4,30,20,10,5,0
394814,4,31,6,25,5,0
163524,1,7,3,4,5,1
15341,2,7,3,4,8,0
145998,4,13,21,-8,15,1
234473,2,17,13,4,2,0
359757,3,24,16,8,6,1
46277,1,0,6,-6,4,0
409317,4,16,16,0,12,1
8961,4,35,13,22,4,0
351134,5,37,37,0,3,0
264243,2,10,10,0,15,0
34838,1,7,0,7,16,1
50247,2,10,14,-4,6,1
29592,3,14,13,1,14,0
389357,3,23,6,17,3,0
285302,3,14,9,5,7,1
208197,3,0,10,-10,8,1
171444,1,7,0,7,9,0
96478,3,17,17,0,10,0
22824,4,13,21,-8,11,1
75029,4,34,17,17,17,1
416371,4,16,6,10,15,0
282924,1,7,0,7,6,1
309962,2,3,3,0,2,1
167205,3,23,10,13,7,0
5901,2,0,9,-9,3,1
342133,3,12,16,-4,16,1
86493,1,0,0,0,5,0
172419,3,13,42,-29,9,1
41872,1,7,3,4,2,1
94411,4,17,21,-4,9,0
7786,4,30,9,21,4,1
131187,1,0,0,0,8,0
356140,2,10,0,10,5,0
248093,4,34,20,14,8,0
382165,4,36,3,33,17,1
2204,1,7,0,7,1,0
94418,4,17,24,-7,9,1
73337,2,13,0,13,17,1
342759,3,7,14,-7,16,1
221497,4,10,41,-31,14,1
142458,3,7,10,-3,13,1
81012,4,20,20,0,3,1
415038,4,10,27,-17,15,0
53961,4,20,25,-5,8,1
143752,1,3,0,3,14,0
146215,2,0,10,-10,15,0
236395,4,14,23,-9,3,0
53533,2,7,6,1,8,1
291384,2,7,7,0,10,0
301687,4,17,6,11,15,1
29769,4,41,3,38,14,1
325246,1,0,3,-3,8,0
270440,3,10,7,3,1,1
7294,4,17,13,4,4,1
379647,4,26,13,13,16,1
228771,1,0,7,-7,17,1
213736,4,38,17,21,10,0
40315,3,6,7,-1,2,1
82917,2,3,3,0,4,1
418891,3,13,10,3,16,0
56722,2,0,10,-10,9,0
319350,3,16,21,-5,6,0
159300,4,27,24,3,3,0
189965,3,13,7,6,17,1
117965,2,10,6,4,2,1
132317,4,31,17,14,9,1
407644,4,10,17,-7,11,1
148414,1,0,0,0,16,1
359852,1,17,14,3,6,1
148174,3,6,21,-15,16,0
44994,2,10,3,7,4,1
50645,4,17,9,8,6,1
378754,3,14,7,7,15,0
122780,4,10,27,-17,4,0
411960,4,17,16,1,13,0
10492,2,6,0,6,5,1
27323,2,14,3,11,13,1
394005,2,6,10,-4,5,0
109391,2,3,10,-7,16,1
347513,4,12,30,-18,1,1
161317,4,20,13,7,4,1
161888,2,13,9,4,4,0
308822,2,3,3,0,1,0
164638,3,14,17,-3,5,0
58425,3,41,10,31,10,0
368174,3,21,21,0,11,1
283821,1,7,0,7,7,0
302570,4,3,16,-13,15,1
7683,1,3,0,3,4,1
329426,1,0,0,0,10,0
64406,1,0,3,-3,13,0
410927,4,14,15,-1,13,0
54602,1,7,6,1,8,1
296553,1,0,0,0,13,1
162584,1,0,0,0,5,0
384223,1,0,0,0,1,0
204164,4,17,17,0,6,0
226631,4,10,6,4,16,0
217837,2,3,7,-4,12,0
271192,4,14,20,-6,1,1
309194,4,44,9,35,1,1
234413,1,0,0,0,2,1
193617,4,7,17,-10,1,0
77166,1,0,0,0,1,0
132332,4,31,17,14,9,0
130252,4,9,26,-17,8,1
278527,4,36,6,30,4,0
248342,3,24,10,14,8,1
372599,2,7,6,1,13,0
169154,1,3,0,3,7,1
110310,3,0,17,-17,16,1
45326,3,17,16,1,4,1
355562,2,14,3,11,5,1
283335,4,10,16,-6,7,1
271391,1,6,0,6,1,1
301052,3,17,3,14,15,0
124497,1,0,0,0,5,1
278192,3,24,21,3,4,1
198287,2,6,7,-1,3,0
51997,1,3,7,-4,7,0
405204,1,0,7,-7,10,0
327372,2,0,7,-7,9,0
340012,2,14,6,8,15,0
82879,1,0,0,0,4,1
114085,3,21,0,21,17,0
220669,2,10,0,10,13,1
413834,2,14,0,14,14,0
245683,1,3,3,0,7,0
189868,1,0,0,0,17,0
204296,3,0,10,-10,6,0
22055,4,17,24,-7,11,1
187076,2,10,0,10,16,0
393772,4,7,14,-7,5,1
368093,1,7,0,7,11,1
228816,2,6,17,-11,17,1
261241,3,28,0,28,14,0
263446,2,6,13,-7,15,0
126230,3,27,6,21,6,1
357781,1,3,7,-4,6,0
66249,4,45,3,42,13,0
390709,3,6,10,-4,3,1
81685,2,7,14,-7,3,0
413282,3,17,0,17,14,0
75240,2,7,7,0,17,0
207838,1,0,0,0,8,1
264340,4,17,39,-22,15,0
101330,1,3,0,3,12,0
131057,1,10,0,10,8,0
114449,1,0,7,-7,1,1
335436,2,13,6,7,13,0
90633,3,17,30,-13,7,1
150624,3,10,22,-12,17,1
128763,2,6,3,3,7,1
40110,1,3,0,3,2,1
19289,2,14,14,0,10,0
49817,3,14,10,4,6,0
331117,2,7,6,1,11,0
410241,2,7,0,7,13,1
20250,4,27,10,17,10,0
120206,1,7,0,7,3,0
382981,4,10,13,-3,17,0
344227,2,7,10,-3,17,1
72687,4,20,10,10,16,0
234996,3,13,17,-4,2,1
270858,3,15,13,2,1,1
4778,3,20,0,20,3,1
347670,3,20,17,3,1,0
406554,3,14,30,-16,11,1
150136,2,3,13,-10,16,0
208325,2,7,24,-17,8,1
274018,1,0,0,0,3,0
135553,3,14,6,8,10,0
275585,2,14,0,14,3,0
246147,2,7,0,7,7,0
204707,2,7,7,0,6,0
416609,2,14,7,7,15,1
140481,3,21,26,-5,12,0
232834,4,16,17,-1,2,1
13956,4,24,21,3,7,0
124551,2,6,7,-1,5,1
360916,3,24,0,24,7,0
241345,1,0,0,0,5,1
366431,3,26,10,16,10,1
25674,2,7,7,0,12,0
183167,4,7,12,-5,14,1
417762,5,35,35,0,16,0
208819,4,6,22,-16,8,1
302669,3,17,13,4,15,0
263801,3,6,24,-18,15,1
79279,2,12,3,9,2,0
61515,2,7,7,0,11,0
349951,4,18,18,0,2,0
253048,2,7,0,7,11,0
91394,4,24,14,10,8,1
204877,2,3,10,-7,6,0
68623,1,7,0,7,15,1
378212,4,41,16,25,15,0
95084,2,0,7,-7,9,1
296881,2,10,0,10,13,0
43118,4,6,24,-18,3,0
125203,3,31,14,17,5,1
289970,4,6,9,-3,10,1
42465,2,0,5,-5,3,0
283501,4,26,21,5,7,0
366639,1,6,0,6,10,1
383428,4,10,9,1,17,1
131370,2,7,13,-6,8,1
15344,2,7,6,1,8,1
323280,4,7,24,-17,7,1
369516,1,3,0,3,11,1
303505,4,37,17,20,16,0
318568,2,10,0,10,5,0
168636,4,17,16,1,7,1
28002,4,30,17,13,13,0
340159,2,20,7,13,15,0
362975,3,27,16,11,8,0
410609,3,17,17,0,13,0
361540,4,10,7,3,7,1
420574,1,0,7,-7,17,0
397149,2,6,0,6,6,1
269658,2,10,0,10,1,0
322685,4,9,9,0,7,0
338139,4,12,7,5,14,0
359468,2,0,14,-14,6,0
92995,2,10,3,7,8,0
104006,4,13,13,0,13,0
886,1,0,0,0,1,1
317847,3,9,10,-1,5,1
186924,2,7,6,1,15,1
416627,3,28,7,21,15,1
337537,4,7,26,-19,14,0
332362,4,16,13,3,12,0
64111,4,34,24,10,13,0
4266,4,20,6,14,2,0
350752,3,10,3,7,2,1
251967,1,0,10,-10,10,1
211641,2,16,3,13,9,1
191623,5,27,24,3,17,0
411549,1,0,7,-7,13,0
365969,1,13,7,6,10,1
178120,5,26,26,0,12,1
387448,4,21,16,5,2,0
266728,1,0,0,0,16,0
283476,4,23,14,9,7,1
402865,2,17,3,14,9,0
79490,4,12,17,-5,2,1
44105,2,0,13,-13,3,1
195282,4,23,24,-1,2,0
340440,1,0,3,-3,15,0
303152,4,21,28,-7,16,0
76275,4,19,27,-8,1,1
372452,2,6,14,-8,13,1
34755,3,20,3,17,16,0
270500,1,0,7,-7,1,1
19444,3,17,14,3,10,0
220943,2,0,0,0,14,0
343775,2,7,3,4,17,0
138941,2,7,3,4,12,0
157997,1,0,3,-3,3,1
20256,4,27,10,17,10,1
418539,1,7,0,7,16,1
364746,4,12,3,9,9,0
276489,2,13,7,6,4,1
58141,3,20,17,3,10,1
156958,3,7,10,-3,2,1
315870,4,9,19,-10,4,1
52701,3,3,20,-17,7,1
408116,1,0,0,0,12,1
205968,3,6,10,-4,7,0
75693,1,14,0,14,1,0
174696,3,9,7,2,10,0
298015,4,37,7,30,13,1
97682,3,3,10,-7,11,0
262781,4,28,17,11,15,1
325157,2,13,14,-1,8,1
91342,3,14,7,7,8,0
338188,2,7,20,-13,14,0
263087,4,10,13,-3,15,0
380751,1,3,0,3,16,0
109737,3,13,0,13,16,1
415358,4,14,21,-7,15,0
407498,1,3,0,3,11,0
336958,4,21,21,0,14,0
252049,4,14,20,-6,10,0
104442,1,0,10,-10,13,1
339137,3,10,13,-3,15,1
329472,2,3,0,3,10,1
186859,4,29,20,9,15,1
415108,1,0,14,-14,15,0
396873,3,27,10,17,6,0
346271,4,40,3,37,1,1
362812,3,7,21,-14,8,0
293033,2,9,13,-4,11,1
363067,1,7,0,7,8,0
62902,3,10,10,0,12,1
243239,2,0,7,-7,6,1
105812,2,6,3,3,14,0
368361,1,7,0,7,11,0
219791,2,35,0,35,13,1
35155,2,0,14,-14,16,1
401380,2,17,0,17,8,1
181454,4,31,24,7,13,0
316825,4,16,10,6,4,0
276676,3,23,6,17,4,0
216011,1,7,9,-2,11,0
399675,4,19,9,10,8,1
128553,4,21,35,-14,7,1
88720,1,0,0,0,6,1
328808,4,17,13,4,10,0
284504,3,23,15,8,7,1
85696,4,24,21,3,5,0
19369,4,27,17,10,10,0
110555,1,9,0,9,16,1
127496,3,3,23,-20,6,1
279779,1,0,3,-3,5,1
70255,1,7,0,7,15,0
182867,4,36,27,9,14,0
32146,4,24,24,0,15,0
377301,4,14,14,0,15,1
19265,1,7,14,-7,10,1
260055,2,3,7,-4,14,1
36241,4,10,24,-14,17,0
178749,1,14,0,14,12,0
346474,1,10,7,3,1,0
403163,2,10,14,-4,9,1
120429,3,19,9,10,3,0
288933,1,0,0,0,9,1
377146,3,10,10,0,15,1
401007,4,22,15,7,8,0
317622,2,3,3,0,5,1
95511,2,3,6,-3,10,0
309927,1,0,0,0,2,0
257066,3,7,14,-7,12,0
25809,1,3,0,3,12,0
28969,2,0,7,-7,14,0
225639,3,7,10,-3,16,1
155477,1,0,0,0,2,1
196334,1,7,0,7,2,1
235821,1,0,7,-7,3,1
89250,3,6,0,6,7,1
35289,2,6,0,6,16,0
276637,2,14,6,8,4,1
397971,4,10,27,-17,7,1
3504,4,17,30,-13,2,0
6645,2,0,10,-10,3,1
300521,4,23,17,6,14,1
116843,1,7,0,7,2,0
273848,4,17,14,3,2,0
148925,2,3,9,-6,16,1
292289,2,6,10,-4,11,1
371268,1,0,7,-7,12,0
328773,3,17,13,4,10,1
272070,3,10,6,4,2,0
415099,1,0,7,-7,15,0
111451,4,0,20,-20,16,0
292862,1,7,0,7,11,0
30960,1,0,0,0,15,0
370863,2,3,3,0,12,1
339253,2,21,0,21,15,0
136531,1,0,10,-10,11,1
256788,4,13,13,0,12,0
346329,2,3,3,0,1,0
325656,3,24,7,17,9,1
48808,1,0,0,0,5,0
140157,3,10,3,7,12,0
283870,2,14,10,4,7,0
289209,4,20,13,7,9,1
379995,1,0,0,0,16,1
55320,4,20,10,10,9,0
256109,2,7,16,-9,12,0
194066,4,27,14,13,1,1
236380,4,7,23,-16,3,1
192236,1,3,0,3,1,0
32783,1,0,0,0,15,0
38152,1,0,0,0,1,1
11703,3,17,10,7,6,1
87912,4,13,15,-2,6,1
358130,2,17,6,11,6,0
373420,4,10,17,-7,13,0
78713,2,13,7,6,2,0
395975,3,24,17,7,6,1
224962,4,3,16,-13,15,1
253877,3,31,14,17,11,1
244289,4,26,7,19,6,0
218036,3,21,17,4,12,1
100517,3,10,17,-7,12,0
38004,1,3,0,3,1,0
90980,1,0,0,0,7,1
170949,4,38,20,18,8,0
164253,4,48,41,7,5,0
305621,4,23,17,6,17,1
99441,2,0,0,0,11,0
31657,4,24,9,15,15,0
404030,2,3,28,-25,10,1
130217,3,3,26,-23,8,0
164192,2,17,21,-4,5,0
77075,2,7,17,-10,1,1
375063,4,28,30,-2,14,1
232166,2,6,0,6,1,0
329858,4,24,26,-2,11,1
56210,1,3,0,3,9,0
117111,4,7,27,-20,2,1
374,2,28,10,18,1,0
117368,3,28,3,25,2,0
330382,3,7,20,-13,11,1
86678,2,10,0,10,5,0
276112,4,34,3,31,3,0
29117,2,0,9,-9,14,1
350376,4,31,13,18,2,0
39570,2,14,6,8,1,0
60032,1,7,0,7,11,0
51364,4,19,20,-1,7,1
79275,2,12,3,9,2,0
133958,4,16,6,10,9,0
233547,2,7,14,-7,2,1
135239,3,13,3,10,10,1
144457,4,10,26,-16,14,1
229489,1,0,0,0,17,1
63982,1,7,0,7,13,0
213945,2,22,7,15,10,1
68165,1,7,7,0,14,0
251561,3,16,13,3,10,1
252706,4,6,10,-4,10,0
13355,4,7,27,-20,7,0
55744,4,23,29,-6,9,1
275265,1,10,2,8,3,0
122191,4,27,28,-1,4,0
391506,1,0,14,-14,4,1
143796,2,3,0,3,14,1
11259,3,17,21,-4,6,0
165143,5,24,24,0,6,0
272455,4,31,24,7,2,1
67668,4,7,35,-28,14,0
46591,2,3,0,3,4,0
287679,4,9,13,-4,9,1
103241,3,3,10,-7,13,1
187768,1,0,0,0,16,1
133132,2,7,10,-3,9,1
133925,3,6,6,0,9,1
75518,4,37,7,30,17,1
354730,1,6,0,6,4,0
146463,1,0,0,0,15,1
413066,1,13,7,6,14,1
279389,2,13,21,-8,5,1
142535,4,30,16,14,13,0
320803,1,0,0,0,6,0
67007,2,0,0,0,14,1
314740,1,14,0,14,4,1
20621,1,0,0,0,10,0
342462,4,20,3,17,16,0
132731,3,10,17,-7,9,1
26529,1,3,0,3,13,0
244092,4,20,34,-14,6,1
88830,4,13,13,0,6,1
146486,1,7,0,7,15,0
158933,2,14,12,2,3,0
257891,4,16,19,-3,13,0
63315,2,10,3,7,12,1
52671,2,3,10,-7,7,1
411400,1,0,0,0,13,1
410940,4,14,22,-8,13,0
228789,2,3,7,-4,17,0
402983,2,7,14,-7,9,0
295469,4,17,22,-5,12,0
210473,3,9,14,-5,9,0
266285,1,0,0,0,16,1
151988,4,34,34,0,17,1
370115,1,7,3,4,12,0
103136,4,34,7,27,13,1
324795,1,0,0,0,8,0
98360,1,0,0,0,11,1
403075,4,33,27,6,9,1
305468,4,20,10,10,17,0
239710,2,7,10,-3,4,1
171413,5,19,20,-1,9,1
278743,1,0,0,0,5,0
324100,2,0,7,-7,8,0
170169,4,10,20,-10,8,1
33896,1,0,3,-3,16,0
155648,1,3,3,0,2,0
225966,3,27,20,7,16,1
170046,4,35,17,18,8,1
90517,4,0,26,-26,7,0
264728,2,7,13,-6,16,1
74893,4,20,20,0,17,1
31662,4,24,9,15,15,0
390874,3,9,28,-19,3,1
83236,2,9,7,2,4,1
9341,3,27,7,20,5,1
322440,1,6,0,6,7,1
278518,4,36,0,36,4,1
283977,1,0,0,0,7,0
412122,1,0,0,0,13,1
360888,2,14,0,14,7,0
10328,2,10,14,-4,5,1
74652,2,0,3,-3,17,0
279985,2,3,10,-7,5,0
384168,3,21,20,1,1,1
188941,4,23,13,10,16,1
33301,4,23,3,20,16,1
19411,2,14,7,7,10,0
379748,3,9,14,-5,16,0
64152,2,14,6,8,13,1
208906,2,7,3,4,8,0
388567,1,14,0,14,3,0
93653,4,23,13,10,9,1
183424,3,24,6,18,14,0
6539,3,3,3,0,3,0
173581,2,0,10,-10,10,1
337250,4,16,23,-7,14,0
136040,4,6,10,-4,10,1
374899,4,14,18,-4,14,1
329994,4,7,10,-3,11,0
390126,3,20,27,-7,3,0
295829,1,0,7,-7,12,1
197584,2,19,0,19,3,0
199050,1,0,7,-7,4,0
366731,3,24,10,14,10,1
314581,1,7,0,7,3,1
404071,3,10,49,-39,10,1
370808,4,26,17,9,12,0
89043,1,6,3,3,6,0
247024,4,20,34,-14,8,1
219779,2,28,0,28,13,0
158666,3,14,7,7,3,0
320953,1,0,0,0,6,1
12432,3,10,6,4,6,1
373047,2,0,0,0,13,1
195448,4,24,10,14,2,0
131373,2,7,13,-6,8,1
124807,1,0,3,-3,5,0
67318,2,14,3,11,14,0
123225,4,13,21,-8,4,0
296428,2,7,0,7,13,1
284892,1,0,7,-7,7,1
292936,3,10,0,10,11,0
324198,1,0,0,0,8,1
275516,4,26,30,-4,3,0
182341,3,24,10,14,14,0
398476,2,7,6,1,7,1
265036,2,7,3,4,16,1
89712,3,15,20,-5,7,1
56668,1,0,0,0,9,0
18632,4,20,17,3,9,0
338752,4,27,17,10,14,0
160401,4,11,35,-24,4,1
363040,4,36,34,2,8,1
236069,4,44,10,34,3,0
312553,3,37,0,37,3,0
81427,4,10,13,-3,3,1
100549,4,20,20,0,12,0
316990,1,0,7,-7,4,0
47269,1,0,0,0,5,1
202545,1,7,6,1,5,1
10167,2,6,0,6,5,0
411260,1,0,0,0,13,0
194144,2,3,0,3,1,0
214248,2,7,10,-3,11,1
272660,1,9,0,9,2,0
207488,4,21,14,7,7,0
313804,4,34,17,17,3,1
114915,1,0,0,0,1,1
366435,3,26,10,16,10,1
28745,4,10,16,-6,14,1
192355,4,27,27,0,1,1
370425,2,7,6,1,12,1
233793,4,13,37,-24,2,1
51965,4,13,16,-3,7,0
314607,2,7,0,7,3,0
121910,4,0,33,-33,4,0
198311,2,6,14,-8,3,0
317503,3,10,17,-7,5,0
221253,2,0,16,-16,14,0
408607,2,21,0,21,12,1
294215,2,6,7,-1,12,0
413254,2,10,0,10,14,0
152511,3,17,7,10,17,0
235219,2,12,0,12,3,0
162658,2,16,10,6,5,0
336816,1,0,0,0,14,0
222748,1,3,0,3,14,0
140824,1,7,0,7,13,1
152436,4,38,3,35,17,1
115381,2,14,0,14,1,0
12941,5,13,13,0,6,0
222391,4,24,10,14,14,0
226691,1,7,3,4,16,1
50914,4,17,24,-7,6,1
342546,2,3,6,-3,16,0
135434,4,31,27,4,10,0
392945,2,6,3,3,4,1
85119,1,0,3,-3,4,1
364192,1,0,0,0,9,1
247964,1,0,3,-3,8,1
325983,4,22,7,15,9,1
306454,2,3,17,-14,17,0
373628,1,0,3,-3,13,0
188609,4,20,13,7,16,0
156602,2,0,0,0,2,1
388957,4,17,27,-10,3,1
96083,4,16,21,-5,10,1
389148,1,0,0,0,3,1
28077,2,21,10,11,13,0
244628,1,0,10,-10,7,1
13219,4,22,26,-4,6,0
199067,2,7,14,-7,4,0
252215,4,23,24,-1,10,1
276679,4,23,12,11,4,0
134365,4,23,21,2,10,0
129093,3,20,21,-1,7,0
254544,1,0,0,0,11,1
27591,1,7,3,4,13,1
168688,2,7,3,4,7,1
357005,4,20,3,17,5,1
308767,4,10,20,-10,1,1
288171,1,0,0,0,9,1
139048,1,0,0,0,12,1
28087,3,21,10,11,13,0
4898,2,14,7,7,3,0
151621,3,16,13,3,17,1
155487,1,7,0,7,2,1
186923,2,7,6,1,15,1
128787,2,10,13,-3,7,0
218007,2,21,10,11,12,1
102641,3,15,13,2,13,1
187426,3,41,14,27,16,1
243905,3,16,6,10,6,0
408320,2,0,7,-7,12,1
73173,2,7,0,7,16,1
411951,3,17,10,7,13,0
119483,4,14,17,-3,3,1
417957,2,14,14,0,16,0
115008,4,13,12,1,1,0
167642,2,10,13,-3,7,0
104705,1,0,0,0,14,1
2230,2,7,7,0,1,0
141044,3,7,10,-3,13,1
353316,4,38,28,10,4,0
117858,4,9,20,-11,2,0
145976,4,10,21,-11,15,1
308011,4,21,12,9,1,1
411562,1,0,10,-10,13,0
325946,3,16,7,9,9,0
217108,1,0,7,-7,12,1
146735,4,22,32,-10,15,0
64718,2,21,0,21,13,1
368630,4,16,19,-3,11,0
92288,3,20,0,20,8,0
175515,2,3,0,3,11,0
133213,4,20,17,3,9,0
85960,3,14,14,0,5,1
314688,4,17,28,-11,3,1
337336,2,14,7,7,14,1
186516,4,17,20,-3,15,0
178503,3,16,6,10,12,0
374240,1,7,0,7,13,0
164506,3,17,0,17,5,0
358867,2,3,21,-18,6,1
64954,1,0,0,0,13,1
11331,1,14,0,14,6,1
405376,1,0,6,-6,10,0
48631,4,27,27,0,5,0
413540,2,0,10,-10,14,1
185552,2,10,10,0,15,0
165455,1,0,0,0,6,1
239973,2,0,10,-10,5,0
104847,1,0,0,0,14,0
295209,1,14,0,14,12,0
70474,3,17,17,0,15,1
112225,1,14,7,7,17,0
270091,2,17,10,7,1,1
258274,2,14,12,2,13,1
32211,2,14,7,7,15,1
183851,3,34,28,6,14,1
281098,4,45,16,29,6,1
128345,3,7,3,4,7,0
76988,4,17,13,4,1,1
105587,4,32,21,11,14,0
402304,3,20,16,4,9,1
204061,1,0,7,-7,6,1
281472,2,7,10,-3,6,0
368679,2,7,10,-3,11,0
172351,2,3,14,-11,9,1
313412,2,7,0,7,3,0
158617,2,7,7,0,3,1
108827,2,7,10,-3,15,0
360038,2,3,26,-23,7,0
143348,2,7,13,-6,14,0
271543,1,7,3,4,2,0
418297,3,6,14,-8,16,0
390208,2,0,6,-6,3,0
232094,4,0,33,-33,1,1
80508,3,5,10,-5,3,0
320179,4,17,20,-3,6,1
340888,2,0,3,-3,15,0
8462,2,15,0,15,4,0
277718,2,7,3,4,4,0
343444,2,7,0,7,16,1
271095,1,0,7,-7,1,1
53586,3,14,15,-1,8,1
84537,1,0,0,0,4,0
261819,2,6,10,-4,14,0
268523,4,23,16,7,17,0
237044,2,0,14,-14,3,0
174061,3,0,33,-33,10,1
79877,2,3,13,-10,2,0
35598,2,7,3,4,17,1
299047,4,16,25,-9,14,1
257162,1,0,6,-6,12,1
321880,2,14,14,0,7,0
76970,3,17,13,4,1,0
289533,4,28,7,21,10,0
347328,4,7,21,-14,1,0
27809,3,14,14,0,13,1
154116,2,0,6,-6,1,0
329762,2,10,6,4,11,1
12145,4,14,21,-7,6,1
253202,2,0,7,-7,11,0
1898,1,0,0,0,1,1
244409,4,3,17,-14,7,0
418011,3,21,28,-7,16,0
213781,1,14,0,14,10,1
421249,2,16,7,9,17,0
281328,3,14,13,1,6,0
363149,4,17,3,14,8,0
399252,4,13,20,-7,7,0
86793,1,0,3,-3,5,1
127380,4,17,23,-6,6,0
51805,4,10,22,-12,7,1
236685,3,17,7,10,3,1
183109,3,7,6,1,14,1
142185,4,8,10,-2,13,0
351397,3,13,13,0,3,0
49094,4,13,20,-7,6,1
44301,3,17,20,-3,3,1
335215,4,37,20,17,13,0
252980,4,9,13,-4,11,1
293624,2,7,7,0,12,1
276273,1,0,0,0,3,1
311643,3,6,6,0,2,0
197631,4,26,0,26,3,1
180291,2,9,7,2,13,1
399066,3,10,19,-9,7,1
322488,3,15,3,12,7,0
261981,2,14,10,4,14,1
285964,3,29,13,16,8,0
337086,4,26,0,26,14,0
115971,1,10,0,10,1,0
245465,4,23,6,17,7,0
325258,1,3,3,0,8,0
357315,4,14,19,-5,5,0
366880,3,3,6,-3,10,0
269722,4,10,24,-14,1,0
100750,1,6,0,6,12,1
210701,1,7,0,7,9,0
137371,2,3,14,-11,11,1
377917,4,23,16,7,15,0
179359,1,0,6,-6,12,1
7463,3,29,6,23,4,0
311570,1,0,0,0,2,1
399738,2,0,10,-10,8,1
394408,1,0,3,-3,5,1
284942,3,10,14,-4,7,0
116647,4,23,10,13,2,1
11285,4,17,28,-11,6,0
136079,1,0,7,-7,10,1
5843,4,27,7,20,3,0
285881,1,6,0,6,8,1
180763,2,7,6,1,13,1
263196,3,10,17,-7,15,1
210399,1,6,0,6,9,1
326327,2,0,10,-10,9,0
277357,2,14,6,8,4,1
136674,1,0,0,0,11,0
66863,1,0,7,-7,14,1
364309,4,3,32,-29,9,1
36900,1,0,7,-7,17,0
192230,1,0,0,0,1,1
153641,4,15,17,-2,1,1
249539,2,14,3,11,9,1
239070,1,0,0,0,4,0
35420,1,0,0,0,17,0
59315,2,0,6,-6,11,1
152481,2,10,7,3,17,1
392848,4,17,20,-3,4,0
399137,1,0,0,0,7,0
35402,5,30,30,0,16,1
52454,1,0,0,0,7,1
219026,2,17,0,17,13,0
281933,2,7,13,-6,6,0
75642,4,13,6,7,17,0
331971,1,0,0,0,12,1
341734,4,26,13,13,16,1
396395,2,20,12,8,6,1
114806,2,7,20,-13,1,0
417268,4,20,23,-3,16,1
157209,1,7,0,7,2,0
377934,1,0,0,0,15,0
407837,1,3,0,3,11,1
82861,1,0,0,0,4,0
144008,4,21,10,11,14,0
53612,4,14,22,-8,8,0
294985,3,24,14,10,12,0
187559,3,13,16,-3,16,1
383952,2,0,10,-10,1,1
91194,3,10,17,-7,8,1
206894,3,10,17,-7,7,0
79810,4,28,21,7,2,1
330954,1,6,7,-1,11,1
296573,1,0,0,0,13,1
146202,2,0,10,-10,15,0
21532,2,7,7,0,11,1
31481,3,3,14,-11,15,0
386010,1,7,0,7,1,1
337007,2,10,0,10,14,1
128308,1,0,0,0,7,0
350242,4,34,0,34,2,0
247103,2,13,3,10,8,0
7342,5,20,19,1,4,1
179382,2,3,13,-10,12,1
271037,3,18,28,-10,1,1
107034,2,17,0,17,15,0
314316,2,7,14,-7,3,0
356243,4,29,14,15,5,0
240621,2,20,14,6,5,1
199971,2,17,10,7,4,0
417058,2,17,0,17,15,1
384722,3,13,23,-10,1,0
136889,2,0,10,-10,11,0
217371,4,21,10,11,12,0
234397,4,24,10,14,2,0
192490,3,7,17,-10,1,1
323720,4,33,0,33,8,0
64831,1,7,0,7,13,0
420746,1,0,3,-3,17,1
373262,4,13,16,-3,13,0
104418,1,0,0,0,13,0
266787,3,3,14,-11,16,1
385058,5,24,24,0,1,1
219646,2,10,7,3,13,0
243560,2,10,7,3,6,0
156574,1,0,0,0,2,1
195538,3,6,0,6,2,0
381495,2,14,0,14,17,0
141413,4,10,20,-10,13,1
16726,1,0,0,0,8,0
81133,3,13,14,-1,3,1
182699,4,14,19,-5,14,1
324667,1,0,7,-7,8,1
71574,2,3,14,-11,16,1
370353,4,20,35,-15,12,1
107828,4,7,23,-16,15,1
292267,1,0,7,-7,11,1
396532,2,17,7,10,6,1
174979,3,6,21,-15,10,0
198128,2,0,3,-3,3,0
116473,3,6,16,-10,1,0
411661,4,34,28,6,13,0
128430,1,0,0,0,7,0
245689,2,3,9,-6,7,0
284966,3,13,20,-7,7,1
69682,2,0,7,-7,15,1
400277,4,24,9,15,8,1
250914,1,0,3,-3,10,1
26519,1,0,0,0,13,1
8883,2,14,0,14,4,1
369672,1,13,7,6,11,1
55552,2,17,7,10,9,0
152661,3,10,6,4,17,1
51443,2,10,17,-7,7,0
207413,2,7,0,7,7,0
86395,2,7,7,0,5,1
404144,2,6,0,6,10,0
368281,3,6,3,3,11,0
6815,2,3,21,-18,3,1
260976,3,10,3,7,14,0
384601,3,10,49,-39,1,1
13721,2,0,17,-17,7,1
201939,2,0,0,0,5,0
401369,1,16,0,16,8,1
76172,2,9,6,3,1,0
57401,4,14,6,8,10,1
375882,1,7,0,7,14,0
412109,4,38,3,35,13,0
414598,4,28,9,19,14,0
357050,1,6,7,-1,5,1
145766,2,10,10,0,15,0
114384,3,34,13,21,1,0
299997,2,0,14,-14,14,1
78851,2,7,0,7,2,1
420478,2,0,34,-34,17,0
270264,3,3,21,-18,1,0
369221,1,0,7,-7,11,1
71429,2,24,0,24,16,0
155840,2,7,10,-3,2,0
147133,3,17,37,-20,15,0
73050,2,7,10,-3,16,0
30858,2,3,14,-11,15,0
104528,4,14,38,-24,13,1
120053,1,3,0,3,3,0
174375,3,17,3,14,10,1
46838,1,7,0,7,5,1
143832,4,12,7,5,14,0
737,1,0,0,0,1,1
165765,1,0,0,0,6,1
29365,4,28,16,12,14,0
248119,1,0,3,-3,8,1
360353,4,7,20,-13,7,1
376887,4,28,21,7,15,0
345045,1,0,0,0,17,0
177461,4,24,10,14,11,1
147379,2,7,7,0,15,0
42194,2,7,0,7,2,1
126360,3,7,14,-7,6,1
192540,4,17,17,0,1,0
148017,2,7,3,4,15,0
150355,3,27,7,20,16,1
248280,2,14,0,14,8,1
333483,2,3,0,3,12,0
409798,1,10,0,10,12,0
304150,1,0,0,0,16,0
131065,2,10,0,10,8,0
326452,1,10,3,7,9,1
90061,4,18,24,-6,7,1
188435,3,3,3,0,16,0
363869,4,13,29,-16,8,0
207099,1,0,0,0,7,0
213964,2,23,7,16,10,1
31593,2,10,3,7,15,0
368256,2,3,3,0,11,1
282800,2,0,13,-13,6,1
117681,3,27,13,14,2,1
288385,3,10,0,10,9,1
26413,2,10,10,0,13,1
321992,1,0,0,0,7,1
173196,3,20,17,3,9,1
366990,2,0,24,-24,10,0
55465,4,23,10,13,9,1
100064,3,6,3,3,12,0
55991,3,10,20,-10,9,1
405680,1,3,0,3,10,1
213431,4,10,41,-31,10,0
248575,1,7,0,7,9,0
399491,2,0,24,-24,7,1
97308,1,0,3,-3,10,0
45689,1,0,0,0,4,1
300221,4,31,10,21,14,1
380551,3,14,23,-9,16,0
304185,2,7,7,0,16,1
156787,2,14,13,1,2,1
88778,2,13,9,4,6,0
243381,1,3,7,-4,6,0
333301,1,7,0,7,12,0
276387,3,25,38,-13,3,1
6761,1,0,0,0,3,0
395772,1,0,0,0,6,0
261816,2,3,10,-7,14,1
92398,2,10,7,3,8,1
297273,4,24,6,18,13,1
257760,4,3,27,-24,13,0
141444,1,0,0,0,13,0
355077,1,0,13,-13,4,1
250035,3,17,13,4,9,1
420941,2,7,14,-7,17,0
266860,5,17,17,0,16,1
85361,3,28,3,25,5,0
388556,1,7,0,7,3,1
342454,4,13,3,10,16,1
53070,2,10,7,3,7,0
308130,3,13,19,-6,1,1
190934,2,6,0,6,17,1
55912,1,0,0,0,9,1
375473,2,16,7,9,14,1
270024,4,22,23,-1,1,1
22475,3,24,27,-3,11,1
185260,3,24,9,15,15,1
340293,1,3,0,3,15,1
151768,2,14,6,8,17,1
391854,2,10,10,0,4,1
86233,1,6,10,-4,5,0
139430,3,24,3,21,12,1
58657,5,20,20,0,10,1
258265,2,14,6,8,13,0
342638,4,22,27,-5,16,0
88501,3,16,14,2,6,0
222462,2,3,7,-4,14,1
386917,2,7,14,-7,2,1
25061,4,27,24,3,12,1
9665,3,12,28,-16,5,1
228498,2,17,7,10,17,1
217870,2,16,21,-5,12,1
204637,4,10,45,-35,6,1
192678,4,13,7,6,1,1
230536,2,3,7,-4,1,1
57540,4,24,16,8,10,0
172139,4,13,18,-5,9,1
16566,4,30,13,17,8,1
198547,5,20,20,0,3,1
184068,2,6,0,6,14,0
413911,4,20,9,11,14,0
86752,4,27,14,13,5,0
141582,4,34,18,16,13,0
80376,3,27,9,18,2,0
380471,1,0,7,-7,16,1
45667,4,13,13,0,4,1
187302,4,10,13,-3,16,0
167832,2,0,13,-13,7,1
188515,1,0,3,-3,16,1
297250,3,21,6,15,13,1
159022,1,0,0,0,3,0
44472,4,17,12,5,3,0
168553,2,7,10,-3,7,0
417470,2,10,14,-4,16,0
21037,4,21,31,-10,10,0
99716,1,0,0,0,12,1
93772,4,3,16,-13,9,0
78728,2,13,7,6,2,1
227711,2,0,0,0,16,0
69447,3,24,3,21,15,1
257985,2,0,21,-21,13,1
374094,1,13,0,13,13,1
10531,3,34,0,34,5,0
101216,2,7,7,0,12,0
294326,2,10,3,7,12,1
392970,3,9,10,-1,4,1
12683,2,31,0,31,6,0
373391,3,10,7,3,13,1
109982,2,17,7,10,16,0
90494,3,0,20,-20,7,1
259073,1,0,0,0,13,0
376448,5,23,23,0,14,1
43139,1,0,0,0,3,1
182467,2,7,0,7,14,1
365081,1,0,7,-7,9,1
267897,4,29,24,5,17,0
282689,3,6,20,-14,6,1
361125,4,23,23,0,7,1
309387,2,0,0,0,1,0
362474,2,6,6,0,8,1
266592,1,0,0,0,16,1
400644,2,3,0,3,8,1
191984,2,7,20,-13,1,1
147823,2,0,7,-7,15,1
264368,1,0,7,-7,15,1
219705,4,13,14,-1,13,1
399970,4,12,13,-1,8,0
410917,3,14,15,-1,13,0
338586,4,36,38,-2,14,0
134933,3,7,16,-9,10,1
371312,2,21,10,11,12,1
204649,4,17,48,-31,6,1
20847,3,21,6,15,10,0
394276,1,0,0,0,5,1
189181,2,21,0,21,16,1
127587,2,0,9,-9,6,1
307344,3,14,19,-5,17,0
168441,3,0,17,-17,7,0
154850,1,3,0,3,1,1
399336,2,21,7,14,7,1
198856,4,19,36,-17,3,0
41233,4,10,13,-3,2,0
182589,1,0,3,-3,14,0
272054,2,10,3,7,2,0
268434,2,14,3,11,17,1
167329,2,16,16,0,7,1
41387,4,14,15,-1,2,1
36846,4,24,35,-11,17,1
392280,1,0,7,-7,4,0
350138,1,0,0,0,2,1
155515,2,20,0,20,2,0
383306,4,48,24,24,17,1
197086,2,7,14,-7,3,1
159535,2,14,6,8,3,0
247496,1,0,0,0,8,1
50624,4,10,6,4,6,1
189600,2,0,3,-3,17,1
187131,4,10,0,10,16,1
241049,1,7,0,7,5,0
373987,2,10,0,10,13,0
115044,4,20,22,-2,1,1
122186,4,27,28,-1,4,1
208018,2,21,0,21,8,0
162673,3,16,17,-1,5,0
358311,3,0,20,-20,6,0
391054,4,27,34,-7,4,1
198905,2,3,16,-13,3,1
314308,2,7,14,-7,3,1
218111,1,7,0,7,12,1
29330,4,21,7,14,14,0
54523,3,14,10,4,8,0
410318,4,7,23,-16,13,0
93391,1,3,0,3,9,0
5170,1,0,0,0,3,0
212819,4,17,21,-4,10,1
289904,2,6,3,3,10,0
223160,4,43,37,6,14,1
241786,1,0,0,0,5,0
390210,2,0,6,-6,3,1
279299,4,19,22,-3,5,0
140647,3,38,10,28,12,0
299682,2,14,0,14,14,0
50130,3,0,17,-17,6,0
280196,4,28,7,21,5,0
208549,4,50,23,27,8,0
180100,1,0,0,0,13,1
37456,1,0,7,-7,17,0
41520,3,15,7,8,2,0
278014,2,3,10,-7,4,1
5876,1,0,0,0,3,0
22622,3,23,3,20,11,0
299349,4,28,16,12,14,1
86384,2,7,0,7,5,0
91589,1,0,7,-7,8,0
216639,1,7,3,4,12,0
337259,4,16,23,-7,14,0
212959,3,14,7,7,10,1
6917,1,0,0,0,3,1
120724,2,17,0,17,3,0
88809,3,13,13,0,6,1
273032,3,6,3,3,2,0
98178,4,21,19,2,11,1
283630,4,20,20,0,7,0
91718,1,0,0,0,8,1
268548,1,7,3,4,17,1
333742,4,21,7,14,12,0
255937,2,6,3,3,12,0
272574,3,13,3,10,2,0
96664,4,3,17,-14,10,1
243666,1,0,0,0,6,0
242911,3,21,13,8,6,0
162424,4,20,30,-10,4,1
413232,2,7,0,7,14,0
403707,1,3,3,0,9,0
100891,1,7,3,4,12,0
332831,1,0,0,0,12,0
144036,4,21,22,-1,14,0
331535,1,0,14,-14,11,1
182306,2,14,7,7,14,1
21815,1,0,0,0,11,1
11402,3,26,0,26,6,0
281769,1,0,0,0,6,1
289613,2,10,13,-3,10,0
91140,2,3,7,-4,8,0
293725,4,13,13,0,12,0
310783,3,6,3,3,2,0
167298,1,3,10,-7,7,1
43014,1,0,0,0,3,1
163652,4,21,36,-15,5,1
151818,4,27,16,11,17,1
85415,4,38,17,21,5,0
287824,3,28,17,11,9,0
350661,4,20,3,17,2,0
280079,1,7,0,7,5,0
378542,2,7,6,1,15,1
227535,1,0,0,0,16,1
147472,4,36,10,26,15,0
51159,2,17,3,14,7,1
34333,4,23,9,14,16,0
229236,2,10,7,3,17,0
52985,3,27,17,10,7,0
49891,4,28,20,8,6,1
184073,2,6,6,0,14,0
144918,4,20,7,13,14,1
394868,2,0,14,-14,5,1
126919,1,0,0,0,6,1
43171,1,7,7,0,3,0
387407,2,21,10,11,2,0
111404,3,0,14,-14,16,0
34585,3,17,0,17,16,0
359932,4,23,30,-7,6,1
225203,2,3,7,-4,15,1
396312,4,6,13,-7,6,0
36208,3,10,17,-7,17,1
353009,4,23,10,13,3,1
105997,3,17,3,14,14,0
285393,2,10,0,10,8,1
289390,4,31,25,6,9,0
399211,3,13,13,0,7,0
232084,4,0,33,-33,1,0
182550,4,42,21,21,14,0
299324,4,26,16,10,14,0
404961,3,6,13,-7,10,0
111654,2,14,10,4,16,1
67446,2,10,7,3,14,1
95629,1,0,0,0,10,1
110608,2,17,10,7,16,0
312899,4,20,21,-1,3,1
330580,4,21,7,14,11,0
206383,2,3,0,3,7,1
234758,1,0,0,0,2,0
238109,5,13,13,0,4,0
116763,3,13,26,-13,2,1
246169,2,7,0,7,7,0
153084,2,0,10,-10,1,0
195922,2,0,17,-17,2,1
338978,2,13,3,10,15,0
254646,4,28,21,7,11,1
48983,1,3,7,-4,6,1
208736,2,0,6,-6,8,1
159045,1,7,0,7,3,1
72917,2,17,7,10,16,0
54966,3,6,3,3,8,0
170824,1,7,0,7,8,1
331057,4,52,17,35,11,0
324324,4,31,7,24,8,0
51156,2,17,3,14,7,0
158067,3,22,9,13,3,0
32549,3,20,6,14,15,0
290987,3,20,13,7,10,1
271031,3,18,21,-3,1,0
1167,1,0,0,0,1,0
332308,2,6,6,0,12,0
27820,4,14,14,0,13,1
225412,4,27,38,-11,15,0
107284,1,0,0,0,15,1
391488,1,0,0,0,4,0
294962,3,17,7,10,12,0
301519,4,20,18,2,15,1
386053,2,14,0,14,1,0
132173,4,29,6,23,9,0
251108,3,10,14,-4,10,0
164479,2,17,0,17,5,1
361662,3,7,22,-15,7,0
98338,4,35,35,0,11,1
316977,1,0,0,0,4,0
9132,1,0,13,-13,5,1
298370,2,7,14,-7,14,0
148320,3,14,3,11,16,0
395391,3,28,3,25,5,1
197536,1,3,0,3,3,0
333759,1,0,0,0,12,1
167016,2,0,14,-14,7,1
113743,2,3,10,-7,17,0
77473,1,0,7,-7,1,1
309403,2,0,0,0,1,1
237676,3,13,7,6,4,1
133379,4,21,9,12,9,0
368850,2,24,0,24,11,0
392484,2,3,17,-14,4,1
117273,1,0,0,0,2,0
329832,4,17,23,-6,11,0
133152,2,10,17,-7,9,1
164725,2,13,7,6,6,0
94862,4,6,13,-7,9,1
134004,1,0,0,0,9,0
247173,4,27,6,21,8,0
362476,2,7,6,1,8,0
403491,3,17,12,5,9,1
392769,2,14,3,11,4,1
300846,1,0,7,-7,15,1
150644,4,10,22,-12,17,1
361893,2,0,0,0,7,0
359453,2,0,14,-14,6,1
60308,1,0,0,0,11,1
222778,2,10,7,3,14,1
134376,4,29,21,8,10,0
362385,4,30,20,10,8,1
93693,1,0,0,0,9,1
89853,3,16,13,3,7,1
161701,1,10,0,10,4,0
49124,1,0,0,0,6,0
386637,2,7,13,-6,2,1
133990,1,0,0,0,9,0
157492,4,23,40,-17,2,1
34270,2,17,6,11,16,0
33501,2,14,0,14,16,0
280919,4,21,10,11,6,0
255141,1,0,0,0,12,1
366336,4,28,16,12,10,0
104339,2,45,21,24,13,0
378283,2,3,3,0,15,0
266996,4,19,17,2,17,0
46479,2,27,6,21,4,0
266001,1,0,0,0,16,1
70030,3,24,10,14,15,1
366259,2,7,10,-3,10,1
23998,4,26,6,20,12,1
25472,4,13,17,-4,12,1
248160,2,6,10,-4,8,1
11526,3,6,10,-4,6,1
310307,3,26,0,26,2,1
163187,4,30,28,2,5,1
117731,4,34,27,7,2,0
216674,2,21,6,15,12,0
186937,3,7,9,-2,15,0
399917,2,0,6,-6,8,1
264659,5,20,20,0,16,1
48556,2,11,14,-3,5,1
186929,2,7,6,1,15,0
187612,4,13,37,-24,16,1
147862,3,3,17,-14,15,1
131972,2,0,10,-10,8,1
189870,1,0,0,0,17,0
62728,2,7,0,7,12,1
122227,1,3,7,-4,4,0
403056,4,24,24,0,9,1
396972,2,7,3,4,6,1
182010,2,14,7,7,13,0
292990,1,0,6,-6,11,0
204875,2,3,10,-7,6,1
314135,1,0,6,-6,3,0
345357,1,0,7,-7,17,1
129584,3,13,20,-7,7,0
234437,2,10,3,7,2,1
61033,4,34,16,18,11,0
366214,1,0,0,0,10,0
170776,4,27,6,21,8,0
164822,4,26,21,5,6,1
106955,4,19,6,13,14,0
249645,1,0,7,-7,9,1
114153,1,0,0,0,1,0
54833,3,13,0,13,8,1
151719,1,7,0,7,17,0
331438,2,6,7,-1,11,1
117495,3,7,17,-10,2,1
159404,3,10,20,-10,3,1
384949,1,7,0,7,1,0
248487,4,17,6,11,8,0
198451,2,10,3,7,3,1
295714,3,3,9,-6,12,1
414783,4,17,17,0,14,1
54462,1,0,0,0,8,0
206915,4,10,20,-10,7,0
149794,1,3,7,-4,16,0
322669,4,6,9,-3,7,0
173036,3,21,6,15,9,1
23900,2,3,0,3,12,1
200882,2,14,0,14,4,1
411067,4,17,17,0,13,0
300252,1,0,0,0,14,1
392387,4,20,38,-18,4,1
318745,3,10,23,-13,5,0
47273,1,0,0,0,5,0
162473,2,7,3,4,4,0
356515,3,6,3,3,5,1
28272,4,17,14,3,13,0
218170,3,14,3,11,12,1
162696,3,23,24,-1,5,0
305846,2,0,14,-14,17,1
11067,2,10,7,3,5,0
127403,1,0,0,0,6,1
71408,2,14,0,14,16,1
43214,3,14,10,4,3,1
90356,4,14,32,-18,7,1
115692,2,10,3,7,1,1
192524,4,14,17,-3,1,1
364313,4,3,32,-29,9,1
1460,1,0,0,0,1,0
259380,4,35,34,1,13,0
403358,4,19,3,16,9,1
155949,1,0,0,0,2,0
134197,2,0,17,-17,10,1
56107,2,17,7,10,9,1
347976,4,0,24,-24,1,1
50033,4,28,17,11,6,1
230889,3,14,10,4,1,1
295511,2,14,7,7,12,0
366043,3,37,14,23,10,1
84914,4,41,17,24,4,1
286651,1,7,0,7,8,0
176968,3,10,6,4,11,0
3062,4,22,47,-25,2,1
72594,1,7,0,7,16,0
385995,1,0,0,0,1,1
167022,2,9,14,-5,7,1
349327,3,28,35,-7,2,0
325870,1,0,0,0,9,1
326664,3,16,6,10,9,0
389422,4,33,22,11,3,0
343667,3,15,10,5,17,0
272192,2,0,0,0,2,1
217120,2,0,9,-9,12,1
199984,2,17,10,7,4,1
265693,4,12,18,-6,16,1
406212,2,7,10,-3,11,1
405949,3,14,7,7,11,1
217503,4,19,3,16,12,1
384622,4,10,52,-42,1,0
159540,2,14,6,8,3,0
35714,1,3,0,3,17,1
376197,2,7,7,0,14,1
6565,4,13,6,7,3,1
64137,1,0,6,-6,13,1
158219,3,24,0,24,3,1
131494,2,0,3,-3,8,0
92140,3,3,30,-27,8,0
414658,1,0,0,0,14,0
34769,4,20,3,17,16,0
319462,2,0,10,-10,6,0
218917,3,41,24,17,13,0
25912,4,38,17,21,12,1
22508,4,31,37,-6,11,1
32547,3,20,6,14,15,0
46666,4,10,3,7,4,1
120060,1,3,0,3,3,0
318850,2,21,6,15,5,0
95142,3,16,17,-1,9,0
303669,4,38,19,19,16,0
97759,1,0,0,0,11,1
257381,3,20,0,20,13,0
387771,4,0,43,-43,2,1
369333,4,21,20,1,11,0
317841,3,9,10,-1,5,0
267422,4,16,17,-1,17,1
197629,4,26,0,26,3,1
366863,3,3,6,-3,10,1
205905,1,3,0,3,7,1
24501,2,0,7,-7,12,1
244196,2,13,7,6,6,1
249958,1,0,0,0,9,0
348936,1,6,0,6,2,1
351304,1,6,0,6,3,1
399176,2,7,6,1,7,1
255244,4,13,14,-1,12,0
318912,4,24,28,-4,5,1
162103,4,48,13,35,4,0
272445,4,31,17,14,2,0
227525,4,26,17,9,16,1
123597,1,0,0,0,4,0
260159,1,0,0,0,14,0
156963,3,7,10,-3,2,0
371107,4,13,27,-14,12,0
379357,4,10,16,-6,16,0
158869,4,23,3,20,3,1
297480,1,0,0,0,13,1
128135,4,13,6,7,7,0
277748,3,14,6,8,4,0
146249,3,3,30,-27,15,1
331240,1,0,0,0,11,0
361493,2,7,0,7,7,1
373497,2,0,10,-10,13,1
180491,3,14,20,-6,13,1
416563,1,0,0,0,15,0
105957,2,10,0,10,14,1
51395,1,0,0,0,7,1
110773,3,3,3,0,16,1
162187,2,7,7,0,4,1
383003,4,10,24,-14,17,1
47407,4,10,13,-3,5,1
112447,4,13,13,0,17,0
231046,3,24,0,24,1,0
56528,2,13,0,13,9,0
150563,2,3,3,0,17,0
86873,3,9,23,-14,5,1
27122,1,0,0,0,13,0
371058,3,10,13,-3,12,1
345907,3,17,23,-6,17,0
411774,3,0,20,-20,13,1
94686,3,24,29,-5,9,0
388299,2,10,3,7,2,0
66224,3,31,3,28,13,0
341397,3,0,13,-13,16,1
281291,2,14,6,8,6,0
241035,1,0,0,0,5,0
67166,2,0,0,0,14,1
47037,2,17,6,11,5,0
388173,3,3,6,-3,2,0
30818,1,0,7,-7,15,0
88762,2,6,3,3,6,1
61070,1,0,0,0,11,1
209554,3,34,20,14,8,1
284206,4,9,23,-14,7,0
384078,1,0,7,-7,1,0
380780,2,9,14,-5,16,0
396732,3,7,17,-10,6,1
202969,1,7,0,7,5,0
385437,3,21,10,11,1,0
102918,2,6,21,-15,13,1
395180,2,10,10,0,5,1
189114,4,31,37,-6,16,1
45063,4,23,19,4,4,0
7453,3,20,6,14,4,1
174428,4,17,10,7,10,1
159883,3,24,0,24,3,0
420684,4,21,16,5,17,0
70245,1,0,0,0,15,1
44527,1,0,7,-7,3,0
21591,3,7,24,-17,11,0
330413,3,13,20,-7,11,1
284948,3,10,14,-4,7,1
154981,4,35,30,5,1,0
385010,3,24,16,8,1,0
372743,2,0,0,0,13,0
159741,3,7,10,-3,3,0
316785,3,13,7,6,4,0
157106,3,10,14,-4,2,1
386663,3,14,13,1,2,0
30116,2,3,7,-4,14,1
419744,3,10,10,0,17,0
246641,2,24,3,21,8,1
246544,4,29,7,22,8,1
129178,1,7,0,7,7,0
114976,3,10,12,-2,1,1
15482,2,16,0,16,8,0
295921,4,13,17,-4,12,0
169023,2,19,14,5,7,0
178424,1,0,0,0,12,0
361991,4,20,12,8,7,1
233871,2,7,6,1,2,1
67378,4,30,6,24,14,1
366794,1,0,0,0,10,1
384277,2,6,0,6,1,0
104035,5,19,13,6,13,1
57476,2,14,10,4,10,0
383151,4,26,17,9,17,1
87023,4,14,22,-8,5,0
114447,1,0,7,-7,1,1
294004,1,0,0,0,12,0
50479,4,17,10,7,6,0
109238,2,6,0,6,15,0
414640,1,0,0,0,14,0
3151,3,10,9,1,2,1
189485,3,14,0,14,17,1
169246,4,17,6,11,7,1
257305,1,3,0,3,13,1
420653,3,21,16,5,17,0
220561,3,10,20,-10,13,0
263571,1,0,0,0,15,0
340537,4,7,40,-33,15,0
1654,2,0,0,0,1,0
270253,3,3,21,-18,1,0
265860,1,0,6,-6,16,0
318501,4,34,7,27,5,0
17372,3,17,0,17,9,0
389665,3,24,16,8,3,0
54681,4,27,29,-2,8,0
185780,4,25,3,22,15,0
330747,4,9,6,3,11,0
152863,1,0,0,0,1,0
46810,4,14,33,-19,4,1
15673,4,34,10,24,8,1
170437,3,21,3,18,8,0
403058,4,24,24,0,9,0
383059,2,17,7,10,17,0
80400,4,27,16,11,2,1
289203,3,20,10,10,9,0
368083,1,7,0,7,11,1
389362,3,23,13,10,3,1
177622,4,17,20,-3,11,1
124785,4,6,9,-3,5,0
263623,2,14,10,4,15,1
93062,4,20,12,8,8,0
218349,4,17,26,-9,12,1
163532,1,7,3,4,5,0
358103,2,14,0,14,6,0
372880,2,10,0,10,13,1
7954,4,9,27,-18,4,0
235398,2,21,13,8,3,0
303253,1,10,0,10,16,0
46029,2,14,14,0,4,1
49912,1,14,0,14,6,0
109313,4,13,3,10,15,0
62321,4,21,19,2,12,1
297980,3,30,7,23,13,1
406067,2,0,13,-13,11,0
218045,3,21,17,4,12,0
182012,2,14,14,0,13,1
357026,4,26,10,16,5,1
299319,4,26,16,10,14,1
176033,3,24,0,24,11,0
253263,3,3,13,-10,11,1
223440,4,20,26,-6,15,1
57738,1,9,0,9,10,0
193751,4,10,27,-17,1,0
168690,2,7,3,4,7,1
129694,2,7,3,4,7,1
73370,3,20,0,20,17,0
327234,2,6,3,3,9,1
127894,1,10,0,10,6,1
76563,4,7,41,-34,1,0
109341,4,20,3,17,15,0
280853,2,10,3,7,6,0
409881,4,30,8,22,12,0
283843,1,7,0,7,7,0
96634,3,3,10,-7,10,1
282935,1,7,0,7,6,1
356972,3,17,3,14,5,0
276349,2,14,28,-14,3,1
329549,4,44,14,30,10,1
246992,4,20,24,-4,8,0
316684,5,12,12,0,4,0
34664,1,0,0,0,16,0
218249,1,0,7,-7,12,1
294359,2,13,3,10,12,1
276507,3,16,7,9,4,1
396359,1,14,6,8,6,1
85878,1,0,0,0,5,0
72572,4,19,31,-12,16,1
222649,2,7,7,0,14,0
84625,3,20,13,7,4,1
295716,3,3,9,-6,12,1
255225,3,13,14,-1,12,1
252797,3,6,6,0,11,1
133788,3,13,10,3,9,1
74270,3,10,17,-7,17,1
183516,2,7,3,4,14,0
186601,2,17,0,17,15,0
127034,4,24,20,4,6,0
99816,4,8,24,-16,12,0
189411,1,0,0,0,17,1
366464,4,34,10,24,10,0
21674,2,3,7,-4,11,1
282157,4,23,8,15,6,0
327398,2,0,14,-14,9,1
408651,3,28,10,18,12,0
220922,1,0,0,0,14,1
271361,4,16,38,-22,1,0
242323,3,10,13,-3,6,1
230321,3,19,10,9,17,0
29602,3,14,13,1,14,1
407676,1,0,0,0,11,0
351900,1,0,0,0,3,0
206641,4,10,16,-6,7,1
169378,3,6,14,-8,8,0
357852,3,6,24,-18,6,0
59345,3,0,9,-9,11,1
314823,4,35,7,28,4,0
164221,3,27,38,-11,5,0
386020,1,7,0,7,1,0
137054,2,7,3,4,11,1
405225,2,7,7,0,10,1
15307,1,0,0,0,8,0
125680,4,31,24,7,5,0
394031,3,6,13,-7,5,1
76020,2,10,13,-3,1,0
50347,4,19,23,-4,6,0
97439,4,16,36,-20,10,1
23011,2,0,14,-14,11,0
1229,2,10,6,4,1,0
321308,3,12,19,-7,6,1
230667,1,0,7,-7,1,0
363483,1,0,0,0,8,0
250369,4,21,20,1,9,0
23642,3,7,13,-6,12,0
317686,4,16,9,7,5,1
410022,4,6,42,-36,12,0
341879,4,23,15,8,16,1
377641,1,6,7,-1,15,0
396284,3,3,6,-3,6,1
57901,2,10,10,0,10,1
241789,1,0,0,0,5,0
404258,1,0,0,0,10,0
143739,1,0,0,0,14,0
366973,2,0,17,-17,10,0
375652,3,17,20,-3,14,0
159680,1,0,7,-7,3,1
255267,4,13,17,-4,12,1
39714,2,3,0,3,1,1
232200,3,9,9,0,1,0
264320,4,17,36,-19,15,1
148528,4,24,10,14,16,0
146478,1,7,0,7,15,0
251962,1,0,7,-7,10,0
266314,1,0,0,0,16,1
328568,1,7,7,0,10,1
105572,4,29,21,8,14,1
101140,4,19,24,-5,12,0
342370,1,0,0,0,16,0
18239,1,0,14,-14,9,1
152653,3,7,6,1,17,1
165903,4,6,19,-13,6,0
358320,4,0,27,-27,6,1
43206,2,14,7,7,3,1
393651,1,0,0,0,5,1
221744,3,10,7,3,14,0
174730,4,9,10,-1,10,1
298534,2,13,0,13,14,0
275439,2,19,10,9,3,1
210782,4,24,10,14,9,1
91925,2,3,3,0,8,0
9116,4,30,22,8,4,1
5798,2,24,7,17,3,1
400944,2,13,7,6,8,1
178727,4,11,26,-15,12,1
364066,1,0,3,-3,9,0
18336,4,22,17,5,9,1
176991,3,13,6,7,11,1
399329,2,21,7,14,7,0
319583,1,3,0,3,6,0
68465,1,0,0,0,14,0
197448,3,13,6,7,3,0
333902,1,0,0,0,12,0
250184,3,17,12,5,9,0
109278,3,6,0,6,15,0
384538,1,0,21,-21,1,0
120219,1,7,0,7,3,0
287281,1,0,0,0,8,1
249928,4,18,23,-5,9,1
219299,2,10,7,3,13,1
401812,2,7,7,0,9,0
344952,2,10,14,-4,17,0
399321,2,14,7,7,7,1
259750,3,10,10,0,14,0
266093,3,17,10,7,16,0
189779,2,17,6,11,17,0
148192,3,13,21,-8,16,1
206110,3,20,6,14,7,1
41549,4,18,7,11,2,1
248656,4,24,10,14,9,0
353106,2,10,22,-12,3,0
233846,1,7,3,4,2,1
179663,5,31,30,1,12,0
29476,4,10,14,-4,14,1
367626,4,31,12,19,10,1
57276,1,0,0,0,10,0
230926,4,31,10,21,1,0
381913,1,0,0,0,17,0
100215,3,17,0,17,12,0
167333,2,16,16,0,7,1
381948,2,0,13,-13,17,0
96542,1,0,0,0,10,0
151854,1,3,0,3,17,0
418630,4,21,31,-10,16,1
351943,2,14,7,7,3,0
275623,3,24,3,21,3,0
139273,3,13,13,0,12,0
379244,4,25,16,9,16,0
244419,4,3,20,-17,7,0
63947,4,6,27,-21,12,0
178219,3,6,10,-4,12,0
377901,4,20,13,7,15,1
68075,3,3,10,-7,14,1
6186,1,7,0,7,3,0
85474,2,14,3,11,5,1
396244,2,0,3,-3,6,1
27788,3,14,14,0,13,1
419998,2,3,7,-4,17,1
263763,2,0,7,-7,15,0
269436,4,21,20,1,1,0
401493,1,0,0,0,8,0
328749,2,14,6,8,10,0
116633,4,23,3,20,2,0
176908,1,0,0,0,11,0
326113,4,30,3,27,9,0
341117,4,14,17,-3,15,0
414229,2,7,14,-7,14,1
364316,4,3,32,-29,9,1
121969,2,9,7,2,4,1
409060,2,3,7,-4,12,1
298275,3,20,13,7,14,0
104488,3,14,24,-10,13,0
244875,4,7,10,-3,7,1
419393,1,0,0,0,16,1
142473,3,13,10,3,13,1
213883,4,54,14,40,10,0
144712,2,3,0,3,14,1
240300,2,7,7,0,5,0
87245,2,10,14,-4,6,1
411735,2,0,10,-10,13,1
109880,3,20,0,20,16,0
141712,3,23,21,2,13,1
44262,2,17,13,4,3,0
327457,4,10,27,-17,9,0
223719,4,37,13,24,15,0
352242,2,3,3,0,3,1
377021,4,22,19,3,15,0
68937,1,7,7,0,15,0
215219,3,10,16,-6,11,0
86309,3,20,23,-3,5,1
259920,3,17,10,7,14,1
72627,2,13,0,13,16,1
221780,4,13,14,-1,14,0
21918,4,35,9,26,11,1
265410,4,14,23,-9,16,1
361073,3,16,9,7,7,0
330491,2,0,7,-7,11,1
51803,4,10,22,-12,7,1
293205,2,16,7,9,11,0
296296,2,3,10,-7,13,0
58318,4,27,13,14,10,0
267188,1,0,0,0,17,0
84084,4,30,32,-2,4,1
400536,3,7,17,-10,8,1
226880,2,0,10,-10,16,1
259650,4,9,6,3,13,1
85423,1,0,0,0,5,1
377172,4,13,17,-4,15,1
13128,2,10,7,3,6,0
233456,3,23,10,13,2,1
398468,2,7,6,1,7,1
282167,1,0,0,0,6,1
284632,3,14,17,-3,7,0
5090,3,13,7,6,3,0
307014,2,10,0,10,17,1
237402,4,12,14,-2,3,0
413206,1,0,0,0,14,1
119536,1,7,0,7,3,0
186140,2,3,3,0,15,1
11376,2,20,0,20,6,1
210462,3,9,14,-5,9,1
105441,4,23,24,-1,14,1
408287,2,0,0,0,12,1
14774,3,31,3,28,7,1
18148,3,13,17,-4,9,0
114159,1,0,0,0,1,1
87671,2,0,14,-14,6,1
114298,1,0,6,-6,1,1
86749,4,27,14,13,5,1
228638,2,13,14,-1,17,0
381374,2,13,0,13,16,1
361422,4,17,21,-4,7,1
396183,4,24,31,-7,6,0
373566,3,16,26,-10,13,0
347053,4,27,17,10,1,1
293006,1,3,6,-3,11,0
73678,3,13,6,7,17,0
223773,1,0,0,0,15,1
257515,3,19,10,9,13,1
87106,2,7,3,4,5,1
100848,4,12,19,-7,12,0
53676,2,0,0,0,8,1
304701,4,21,7,14,16,0
41762,2,7,7,0,2,1
126679,2,7,6,1,6,0
282612,1,3,7,-4,6,0
52349,2,3,10,-7,7,0
296003,2,3,0,3,13,1
396352,1,14,6,8,6,0
55652,1,10,14,-4,9,1
133303,2,7,0,7,9,0
421097,2,20,3,17,17,0
296852,1,0,0,0,13,1
1390,3,10,0,10,1,0
138321,2,20,0,20,11,0
401672,2,0,14,-14,8,0
368913,4,38,3,35,11,0
14344,4,2,7,-5,7,0
135358,2,14,17,-3,10,1
204698,1,7,7,0,6,0
294687,3,6,14,-8,12,1
399101,4,10,29,-19,7,1
128502,3,21,28,-7,7,1
268937,3,6,36,-30,17,1
114451,1,0,7,-7,1,1
319028,3,7,23,-16,5,0
62110,2,7,7,0,12,1
116507,4,6,22,-16,1,1
250176,3,17,6,11,9,1
163270,2,6,6,0,5,1
63473,3,28,13,15,12,1
330093,3,0,13,-13,11,1
362009,1,0,0,0,8,0
355235,2,3,14,-11,4,1
10922,2,6,7,-1,5,0
68118,4,3,10,-7,14,1
265017,1,6,0,6,16,1
239264,2,0,7,-7,4,1
170092,2,7,0,7,8,1
276501,3,16,7,9,4,0
20151,2,10,0,10,10,1
28895,4,23,10,13,14,1
186314,2,26,3,23,15,0
368099,2,7,0,7,11,0
317824,3,9,3,6,5,0
138875,4,12,47,-35,12,0
80297,1,7,3,4,2,0
237362,3,6,14,-8,3,0
316935,3,17,18,-1,4,0
176031,3,17,0,17,11,1
274422,3,10,17,-7,3,0
217591,2,3,9,-6,12,1
222513,3,9,14,-5,14,1
387331,1,6,0,6,2,1
189808,3,17,9,8,17,0
271582,2,7,20,-13,2,1
388,3,28,10,18,1,0
259202,4,14,32,-18,13,0
44457,3,17,9,8,3,0
384665,1,6,10,-4,1,1
351628,1,0,7,-7,3,1
330936,1,6,0,6,11,0
330302,4,31,21,10,11,1
307155,2,0,9,-9,17,0
139503,1,3,0,3,12,0
100494,2,7,10,-3,12,1
277367,2,17,6,11,4,0
11977,3,17,7,10,6,0
7401,1,3,3,0,4,1
89879,4,23,13,10,7,1
43733,4,24,17,7,3,1
218308,3,17,14,3,12,0
281083,4,38,16,22,6,1
272789,1,0,0,0,2,1
388424,1,0,6,-6,2,1
322301,1,7,0,7,7,1
119103,2,7,7,0,3,1
31131,1,3,10,-7,15,1
388265,1,3,0,3,2,0
46824,4,14,39,-25,4,0
245028,4,14,27,-13,7,1
113525,1,0,0,0,17,1
102673,4,22,20,2,13,1
375832,4,20,7,13,14,1
256318,4,14,17,-3,12,1
153559,2,5,14,-9,1,1
231969,4,14,41,-27,1,0
16845,4,26,37,-11,8,0
181862,2,21,14,7,13,1
84008,3,20,3,17,4,1
310292,2,23,0,23,2,0
106009,3,24,3,21,14,0
319371,4,23,28,-5,6,0
405512,1,0,0,0,10,1
350613,3,10,0,10,2,1
332013,2,0,3,-3,12,0
15084,3,10,26,-16,7,1
399830,4,11,27,-16,8,1
230426,3,14,3,11,1,1
360911,3,24,0,24,7,0
189663,3,16,6,10,17,1
119442,3,7,14,-7,3,0
230312,3,19,10,9,17,1
392086,4,18,33,-15,4,0
369908,4,13,16,-3,12,1
23764,2,10,0,10,12,0
361265,4,14,29,-15,7,1
418212,4,38,6,32,16,0
24882,4,13,6,7,12,1
170115,2,7,3,4,8,1
416499,3,27,17,10,15,1
285216,1,0,0,0,7,0
92696,2,3,10,-7,8,1
347721,1,0,0,0,1,1
314042,2,6,7,-1,3,1
107455,2,0,10,-10,15,0
81994,2,7,0,7,3,1
164343,3,20,0,20,5,1
8537,4,22,10,12,4,0
234644,2,20,17,3,2,0
77915,1,0,0,0,1,1
359266,1,0,3,-3,6,0
290965,2,17,10,7,10,1
305046,1,7,0,7,16,0
172879,3,24,17,7,9,1
92331,4,20,0,20,8,1
65115,1,0,0,0,13,1
148210,4,16,21,-5,16,0
194264,2,7,0,7,2,0
339902,3,26,0,26,15,1
269165,1,0,3,-3,17,0
164595,2,7,3,4,5,0
211524,3,29,14,15,9,0
317316,1,0,0,0,5,0
375167,3,17,10,7,14,0
332145,2,0,10,-10,12,0
218429,2,10,14,-4,13,1
132115,2,10,3,7,9,1
285392,2,10,0,10,8,1
267163,4,16,10,6,17,1
316403,2,13,0,13,4,0
43851,4,21,16,5,3,1
294079,3,7,21,-14,12,0
199254,3,17,24,-7,4,1
307987,3,14,12,2,1,1
67261,1,0,0,0,14,1
159738,3,7,10,-3,3,1
397633,3,6,27,-21,7,0
95079,1,0,7,-7,9,1
254759,3,10,3,7,11,1
172102,3,10,12,-2,9,1
378231,1,0,0,0,15,0
151190,2,3,20,-17,17,1
125723,1,7,7,0,5,0
15340,2,7,3,4,8,0
236927,2,26,7,19,3,1
2958,2,7,10,-3,2,1
399120,4,18,36,-18,7,1
316453,3,16,10,6,4,0
145498,4,23,17,6,14,0
228854,4,9,17,-8,17,0
304427,1,0,0,0,16,1
208384,4,17,43,-26,8,1
256420,2,9,21,-12,12,1
260346,2,6,0,6,14,0
398729,2,0,17,-17,7,1
388828,4,14,17,-3,3,1
214270,3,14,10,4,11,1
395212,2,10,10,0,5,0
125611,2,14,17,-3,5,1
369129,2,13,7,6,11,0
108997,3,16,27,-11,15,0
201231,4,23,24,-1,5,1
49545,3,14,3,11,6,0
218480,3,24,17,7,13,1
339594,3,17,14,3,15,1
383477,1,0,3,-3,17,1
98279,3,14,27,-13,11,0
252187,3,23,17,6,10,1
124625,4,13,17,-4,5,1
126166,2,7,3,4,6,0
340945,3,10,10,0,15,0
182988,4,10,44,-34,14,0
67334,3,20,6,14,14,0
138024,2,22,17,5,11,0
331573,2,17,20,-3,11,0
260469,1,7,0,7,14,1
330049,1,0,0,0,11,0
85042,3,25,16,9,4,1
285215,1,0,0,0,7,1
210223,4,10,28,-18,9,1
180166,3,10,0,10,13,1
344260,3,7,13,-6,17,1
112770,4,13,10,3,17,1
124691,2,0,3,-3,5,0
97183,2,3,3,0,10,0
394437,2,7,10,-3,5,0
223945,1,0,0,0,15,1
181271,3,0,13,-13,13,1
336560,2,0,0,0,14,1
117444,1,7,7,0,2,1
181784,4,10,17,-7,13,0
271165,3,7,17,-10,1,1
65333,3,3,21,-18,13,1
239132,2,13,10,3,4,0
285524,1,0,7,-7,8,1
112418,3,13,13,0,17,0
165908,1,0,0,0,6,0
86594,3,33,3,30,5,0
275077,4,34,26,8,3,0
261895,4,6,27,-21,14,0
418361,4,15,31,-16,16,0
354608,2,3,7,-4,4,1
80742,1,3,0,3,3,0
274060,2,10,0,10,3,1
257178,1,0,9,-9,12,1
118707,3,17,9,8,2,1
90374,4,20,32,-12,7,0
98299,3,21,27,-6,11,1
110802,4,6,10,-4,16,1
50546,2,0,6,-6,6,1
204231,1,0,7,-7,6,0
272134,4,24,9,15,2,0
177143,4,31,13,18,11,0
32299,4,30,36,-6,15,1
257816,2,7,3,4,13,1
70198,4,30,22,8,15,1
29853,2,6,16,-10,14,1
254136,2,3,9,-6,11,1
410212,1,7,0,7,13,0
130343,2,7,0,7,8,0
133672,4,24,35,-11,9,0
164077,3,3,6,-3,5,1
21903,4,28,3,25,11,1
244273,4,23,7,16,6,0
53307,4,17,10,7,8,1
340527,3,0,40,-40,15,1
63807,4,14,34,-20,12,1
264676,1,7,0,7,16,0
110173,4,20,23,-3,16,1
327867,3,16,17,-1,10,0
420691,4,21,16,5,17,0
34693,2,3,3,0,16,0
282978,2,14,3,11,6,0
370955,4,27,30,-3,12,0
31281,1,7,3,4,15,0
114921,1,0,0,0,1,1
405031,4,9,26,-17,10,1
263106,1,0,0,0,15,0
32533,2,17,3,14,15,1
374943,1,0,0,0,14,0
7208,1,0,0,0,4,0
196713,3,33,0,33,3,1
22295,2,0,3,-3,11,1
322622,3,3,6,-3,7,0
349622,4,13,28,-15,2,0
74295,4,10,30,-20,17,1
370763,3,12,10,2,12,1
318831,2,13,6,7,5,1
320587,3,31,0,31,6,0
151127,1,0,0,0,17,1
409624,1,0,0,0,12,0
329900,2,0,10,-10,11,0
111080,2,23,0,23,16,1
134294,1,7,7,0,10,0
209049,2,3,9,-6,8,0
253526,2,0,7,-7,11,1
193529,2,0,0,0,1,0
174410,4,17,9,8,10,0
26660,1,0,0,0,13,0
15068,3,10,26,-16,7,1
351800,2,17,14,3,3,0
80531,3,5,10,-5,3,1
94091,4,6,31,-25,9,1
283728,2,8,3,5,7,1
144503,1,0,6,-6,14,0
381387,3,16,0,16,16,1
42435,1,0,0,0,3,1
115242,2,0,9,-9,1,1
200406,2,10,6,4,4,1
82971,3,13,16,-3,4,0
278489,3,36,0,36,4,0
138784,2,0,7,-7,12,1
329574,1,7,0,7,11,0
333903,1,0,0,0,12,0
193690,2,3,20,-17,1,0
195485,1,0,0,0,2,0
125367,4,38,3,35,5,1
227313,3,13,27,-14,16,1
301144,1,10,3,7,15,0
372304,3,17,7,10,13,0
345102,2,9,3,6,17,1
184751,1,14,0,14,15,0
15635,3,21,10,11,8,0
134175,2,0,10,-10,10,0
251341,2,14,7,7,10,1
394017,3,6,13,-7,5,1
369376,1,3,0,3,11,1
129064,2,14,21,-7,7,1
195747,1,0,0,0,2,0
143130,4,31,27,4,13,0
148200,4,13,21,-8,16,1
34198,1,7,0,7,16,0
78616,4,23,13,10,2,1
13751,3,0,20,-20,7,1
98999,1,0,0,0,11,1
393493,1,0,0,0,5,0
18386,1,0,0,0,9,0
67840,1,3,3,0,14,1
293333,1,0,0,0,11,1
58653,5,20,20,0,10,0
358419,2,22,13,9,6,1
408415,1,0,0,0,12,0
902,1,0,0,0,1,0
66293,1,0,0,0,14,0
341372,3,0,10,-10,16,1
75782,3,35,26,9,1,1
119637,4,17,12,5,3,1
374361,1,0,0,0,14,1
193050,1,0,0,0,1,0
396060,1,10,0,10,6,0
45535,1,0,0,0,4,1
256630,4,27,7,20,12,1
90436,2,0,13,-13,7,0
282448,1,0,0,0,6,1
350633,3,13,3,10,2,1
417522,3,24,21,3,16,0
411623,3,14,28,-14,13,1
161132,3,3,26,-23,4,1
395827,3,3,14,-11,6,0
82860,1,0,0,0,4,0
183035,1,0,0,0,14,1
31970,4,16,13,3,15,1
146826,2,17,0,17,15,1
100069,3,6,3,3,12,0
249229,2,19,7,12,9,0
96965,4,22,10,12,10,0
59489,3,6,20,-14,11,0
220498,1,0,7,-7,13,0
269434,4,21,20,1,1,0
381636,2,7,0,7,17,1
72232,3,17,17,0,16,1
299581,3,10,3,7,14,1
355332,4,14,20,-6,4,0
266323,2,7,0,7,16,0
17517,2,13,0,13,9,0
150888,2,0,7,-7,17,0
39131,3,13,10,3,1,1
109006,3,16,27,-11,15,1
218222,4,37,3,34,12,0
364073,1,7,3,4,9,0
384865,3,6,15,-9,1,1
294819,2,28,21,7,12,1
167195,2,23,7,16,7,0
5117,4,13,7,6,3,0
181588,3,13,6,7,13,1
320633,4,38,18,20,6,0
41406,4,14,15,-1,2,0
31235,4,26,34,-8,15,1
369334,4,21,20,1,11,0
386718,4,17,19,-2,2,0
109076,1,0,0,0,15,1
240408,1,0,0,0,5,1
349697,2,14,7,7,2,0
334221,1,3,0,3,13,1
378857,2,7,6,1,15,1
415606,3,14,13,1,15,1
162434,4,23,30,-7,4,1
53454,4,10,28,-18,8,1
90120,2,0,0,0,7,1
256557,2,7,0,7,12,1
33892,1,0,3,-3,16,1
190388,2,7,0,7,17,0
35189,3,0,14,-14,16,1
21976,2,7,3,4,11,1
214503,4,7,20,-13,11,0
122645,4,36,14,22,4,1
24065,2,7,7,0,12,0
333505,2,13,0,13,12,0
250073,4,17,13,4,9,1
274280,4,29,13,16,3,0
387062,1,7,14,-7,2,1
333509,2,13,0,13,12,1
7509,4,29,6,23,4,1
58197,1,0,0,0,10,0
197433,2,13,6,7,3,0
104217,1,0,0,0,13,1
164190,2,17,21,-4,5,0
331398,1,3,7,-4,11,1
184094,2,9,14,-5,14,1
263000,2,7,0,7,15,0
293310,1,0,0,0,11,1
129540,2,3,14,-11,7,0
35438,1,7,0,7,17,0
190794,2,13,3,10,17,1
220338,1,0,0,0,13,1
389296,1,0,0,0,3,0
105436,4,23,24,-1,14,1
337572,1,0,0,0,14,1
402235,1,3,3,0,9,1
95875,4,13,20,-7,10,0
218180,3,17,3,14,12,1
353100,2,7,22,-15,3,1
182197,3,33,7,26,13,0
62797,4,17,0,17,12,1
382095,2,21,3,18,17,0
340487,2,0,20,-20,15,0
360694,1,0,7,-7,7,1
197623,4,26,0,26,3,0
33941,2,0,27,-27,16,1
98620,3,7,7,0,11,1
40884,2,13,10,3,2,0
335921,4,31,21,10,13,1
247268,2,28,14,14,8,0
410281,3,7,13,-6,13,0
263345,3,24,10,14,15,1
91177,3,10,14,-4,8,0
386219,3,9,10,-1,2,1
115794,1,0,0,0,1,1
52301,1,0,0,0,7,1
356821,2,0,13,-13,5,1
292100,1,0,0,0,11,1
283223,1,7,0,7,7,1
17257,4,7,34,-27,9,1
133639,3,10,21,-11,9,1
39962,1,0,0,0,1,0
315752,1,0,0,0,4,0
114104,3,21,7,14,17,0
303120,2,7,14,-7,16,0
170080,1,7,0,7,8,0
412967,3,16,12,4,14,1
407993,1,0,0,0,12,1
190830,3,16,3,13,17,1
404973,3,9,13,-4,10,0
151307,2,7,14,-7,17,0
401194,1,0,0,0,8,1
47747,4,6,20,-14,5,0
177952,1,7,3,4,12,1
260835,3,29,15,14,14,0
160309,2,3,7,-4,4,0
170956,4,38,20,18,8,0
129059,2,14,14,0,7,0
48314,4,22,13,9,5,0
113966,4,20,20,0,17,1
329619,2,10,7,3,11,1
360111,1,0,0,0,7,0
251653,1,6,3,3,10,0
372227,4,15,25,-10,13,0
318416,2,21,7,14,5,1
138217,3,10,12,-2,11,0
72653,3,13,3,10,16,1
267095,2,3,3,0,17,1
68705,3,24,0,24,15,1
342655,1,0,0,0,16,1
408041,3,10,10,0,12,1
280930,4,21,10,11,6,1
380727,4,7,16,-9,16,0
287481,2,14,20,-6,9,1
23402,4,20,24,-4,11,1
377690,2,19,7,12,15,0
2225,2,7,7,0,1,1
306595,2,0,20,-20,17,1
59982,4,3,24,-21,11,1
273407,1,0,0,0,2,0
321838,1,7,7,0,7,0
68006,1,0,3,-3,14,0
192848,4,7,15,-8,1,1
330084,2,0,3,-3,11,0
418303,3,6,14,-8,16,0
84447,2,6,10,-4,4,1
267985,2,7,6,1,17,0
68410,4,3,21,-18,14,0
183575,3,20,24,-4,14,1
63322,3,17,3,14,12,1
385244,2,0,3,-3,1,1
2680,2,6,7,-1,2,1
9852,1,0,0,0,5,0
150498,4,34,6,28,16,1
321384,1,7,3,4,7,0
284433,1,7,9,-2,7,0
354145,1,0,0,0,4,1
244166,1,6,7,-1,6,1
144943,4,20,7,13,14,0
299686,2,14,3,11,14,1
419935,4,19,18,1,17,0
382169,4,37,3,34,17,0
23660,3,7,20,-13,12,1
4529,3,17,19,-2,2,1
142840,4,12,20,-8,13,1
267521,2,13,14,-1,17,0
28867,3,23,7,16,14,0
116129,2,0,3,-3,1,1
287020,2,13,20,-7,8,0
418672,1,0,0,0,16,1
315079,3,37,14,23,4,1
385594,3,3,17,-14,1,0
250746,1,3,0,3,10,0
86524,2,13,3,10,5,0
323406,4,20,0,20,7,1
209928,4,37,22,15,8,0
198330,3,13,14,-1,3,0
387070,2,7,14,-7,2,1
91927,2,3,3,0,8,0
8734,1,0,0,0,4,0
2514,2,3,0,3,2,1
356288,1,7,0,7,5,0
116427,2,3,10,-7,1,1
276562,4,22,7,15,4,1
27286,1,7,3,4,13,0
316986,1,0,7,-7,4,1
259428,2,6,3,3,13,0
191238,2,7,17,-10,17,1
252402,1,0,0,0,10,0
243878,2,16,3,13,6,0
142202,5,11,13,-2,13,1
30547,1,7,0,7,14,1
18437,2,7,7,0,9,0
252994,4,18,13,5,11,0
2769,1,0,0,0,2,1
200560,2,14,7,7,4,1
142323,3,0,3,-3,13,1
12904,4,13,13,0,6,1
87985,1,3,0,3,6,0
293571,4,20,20,0,11,0
177830,2,13,10,3,12,1
79004,2,10,7,3,2,0
34757,3,20,3,17,16,0
244336,1,0,7,-7,7,1
395534,3,21,14,7,6,0
102183,2,17,7,10,13,0
185592,3,10,20,-10,15,1
372120,2,3,7,-4,13,0
266879,1,0,0,0,17,0
77646,2,0,7,-7,1,0
260767,2,3,6,-3,14,1
238338,2,3,16,-13,4,1
132293,3,24,13,11,9,0
127104,1,3,9,-6,6,1
3049,4,20,41,-21,2,0
60889,4,17,26,-9,11,0
40107,1,3,0,3,2,0
209335,2,7,7,0,8,1
343182,2,3,0,3,16,1
217395,1,0,0,0,12,0
223921,4,30,6,24,15,1
251058,1,7,7,0,10,0
254392,1,7,0,7,11,1
143906,1,0,0,0,14,0
45912,3,10,3,7,4,1
329070,2,10,7,3,10,0
407930,4,17,24,-7,11,0
240617,2,20,7,13,5,0
346972,2,7,3,4,1,1
410508,1,0,0,0,13,0
168454,3,0,24,-24,7,0
138843,3,12,33,-21,12,0
299771,4,17,14,3,14,1
378863,2,10,6,4,15,0
311977,4,35,17,18,2,1
161772,3,24,6,18,4,1
55299,4,20,10,10,9,0
389371,3,23,13,10,3,1
71055,3,20,0,20,16,1
102850,4,17,10,7,13,0
200559,2,14,7,7,4,0
376564,3,15,6,9,14,1
230669,1,0,13,-13,1,0
116405,2,3,3,0,1,1
89441,4,17,20,-3,7,0
132549,2,2,29,-27,9,1
62384,1,0,7,-7,12,0
257044,2,7,14,-7,12,0
331428,2,6,7,-1,11,0
412454,2,7,7,0,14,1
292629,3,22,16,6,11,1
377651,1,9,7,2,15,1
369804,1,0,0,0,12,1
82997,4,19,19,0,4,1
302147,4,41,48,-7,15,0
167891,3,21,16,5,7,0
237350,2,0,7,-7,3,1
206950,1,0,0,0,7,1
346866,3,23,6,17,1,0
339439,3,10,17,-7,15,0
298689,3,13,14,-1,14,1
343971,3,16,6,10,17,0
332443,2,13,3,10,12,1
303877,1,0,14,-14,16,1
30886,2,3,17,-14,15,1
346737,4,27,13,14,1,0
9608,2,6,7,-1,5,0
172231,3,7,13,-6,9,1
293523,3,10,10,0,11,0
163679,1,0,0,0,5,0
376458,5,23,23,0,14,1
139747,4,14,21,-7,12,1
297573,4,21,7,14,13,0
263772,2,0,21,-21,15,1
191927,1,0,3,-3,1,1
33526,2,17,0,17,16,1
191199,1,0,10,-10,17,0
264634,4,20,17,3,16,0
269369,3,7,17,-10,1,0
147325,4,7,31,-24,15,1
162884,4,13,6,7,5,0
377544,2,7,9,-2,15,0
42529,3,10,21,-11,3,0
4679,4,20,19,1,2,0
101654,1,3,0,3,12,0
293740,1,7,0,7,12,0
294153,1,0,0,0,12,0
103549,3,33,0,33,13,0
89206,2,3,0,3,7,1
3600,2,20,21,-1,2,1
374018,3,10,7,3,13,0
165335,1,0,0,0,6,0
322772,2,3,20,-17,7,1
312058,2,14,7,7,2,0
409323,4,19,16,3,12,0
369095,1,6,0,6,11,1
370581,2,14,14,0,12,1
278684,4,24,10,14,4,0
131279,4,20,17,3,8,1
126812,2,0,6,-6,6,0
149127,3,17,24,-7,16,1
335246,1,0,0,0,13,0
274375,2,3,10,-7,3,0
409954,2,3,14,-11,12,0
38757,1,0,3,-3,1,0
259148,2,14,7,7,13,1
302736,1,0,3,-3,15,1
87666,2,0,13,-13,6,0
142114,2,0,7,-7,13,1
253604,4,9,17,-8,11,1
84686,1,3,6,-3,4,0
257809,2,7,0,7,13,0
300525,4,23,17,6,14,0
247909,4,17,6,11,8,1
31177,3,23,27,-4,15,1
89543,2,0,20,-20,7,0
181173,4,24,21,3,13,1
223217,2,3,6,-3,15,0
421517,2,3,3,0,17,0
325918,2,10,7,3,9,1
387954,1,3,0,3,2,1
143093,3,17,17,0,13,0
341065,2,7,17,-10,15,0
385170,4,21,17,4,1,0
178233,4,6,10,-4,12,0
168671,1,0,0,0,7,1
355856,2,13,10,3,5,0
172824,1,7,0,7,9,0
313393,1,7,0,7,3,0
37357,3,17,0,17,17,0
197768,4,21,17,4,3,1
258654,1,0,0,0,13,1
90425,2,0,13,-13,7,0
271357,4,16,38,-22,1,1
298133,4,3,41,-38,13,1
409659,2,10,0,10,12,0
87607,4,17,10,7,6,0
306222,4,20,3,17,17,0
84482,4,20,10,10,4,0
297030,1,7,0,7,13,1
140817,1,7,0,7,13,0
22942,4,3,26,-23,11,1
368383,2,14,0,14,11,1
34042,1,0,0,0,16,0
318998,2,0,16,-16,5,1
47210,3,9,9,0,5,1
286347,1,0,0,0,8,0
151142,1,3,10,-7,17,1
69211,5,20,20,0,15,0
261295,4,38,0,38,14,1
316591,3,6,6,0,4,0
49702,4,21,24,-3,6,0
293544,3,10,17,-7,11,1
190105,3,27,3,24,17,1
103615,1,0,0,0,13,0
400246,3,10,6,4,8,1
136477,4,17,13,4,11,1
373048,2,0,0,0,13,0
130275,4,9,29,-20,8,0
301863,1,0,0,0,15,0
375995,4,23,15,8,14,0
407838,1,3,0,3,11,1
243991,1,7,0,7,6,0
333048,2,9,12,-3,12,1
50903,3,17,24,-7,6,0
95017,4,13,16,-3,9,1
342098,2,6,3,3,16,0
208382,4,17,37,-20,8,0
291112,2,15,13,2,10,0
419699,2,0,3,-3,17,1
95747,4,20,9,11,10,1
257321,1,16,0,16,13,1
320128,3,17,0,17,6,0
410751,3,17,6,11,13,0
247457,4,13,9,4,8,0
365826,1,0,0,0,9,0
371057,3,10,13,-3,12,1
195876,1,0,0,0,2,0
29018,4,14,7,7,14,0
388035,3,13,6,7,2,1
354716,1,0,0,0,4,0
408424,1,0,0,0,12,0
274391,2,3,10,-7,3,0
223407,3,10,19,-9,15,1
353555,2,17,0,17,4,1
133695,4,32,35,-3,9,0
55005,4,20,10,10,8,0
63210,4,14,23,-9,12,1
139798,2,7,3,4,12,0
56303,3,3,20,-17,9,1
178547,4,16,13,3,12,1
382320,4,20,3,17,17,1
188462,4,3,9,-6,16,1
219805,2,38,0,38,13,0
76872,1,0,0,0,1,0
135032,1,14,0,14,10,0
125351,4,31,3,28,5,0
406214,2,14,10,4,11,0
275511,4,20,30,-10,3,1
277550,2,3,14,-11,4,1
298217,2,14,3,11,14,0
54338,2,7,12,-5,8,1
409940,2,0,14,-14,12,1
1153,4,10,36,-26,1,1
364486,1,0,0,0,9,1
400969,3,19,7,12,8,0
259063,4,3,16,-13,13,1
267973,2,0,6,-6,17,1
231913,3,7,41,-34,1,1
44716,2,0,12,-12,3,0
237619,1,3,0,3,4,0
274904,3,14,16,-2,3,1
316773,3,10,7,3,4,0
383171,4,26,24,2,17,0
112982,2,7,3,4,17,1
372643,3,14,9,5,13,0
162232,3,20,20,0,4,1
109741,3,13,0,13,16,1
134344,3,16,21,-5,10,1
328365,4,3,37,-34,10,0
209730,3,9,6,3,8,1
19170,3,21,10,11,10,0
401274,3,10,14,-4,8,1
42243,3,30,7,23,2,0
297003,4,32,14,18,13,0
95619,4,12,13,-1,10,0
32505,2,14,3,11,15,0
340056,3,17,12,5,15,1
418872,2,10,10,0,16,1
136455,3,10,13,-3,11,1
9999,1,0,0,0,5,1
106460,3,16,0,16,14,0
270615,4,23,14,9,1,1
169710,4,20,17,3,8,1
160729,4,10,10,0,4,1
41347,3,14,9,5,2,0
334593,4,30,24,6,13,0
205616,1,7,3,4,7,0
392036,3,10,17,-7,4,1
173533,4,13,27,-14,10,0
83705,3,22,20,2,4,0
63865,2,3,14,-11,12,1
378937,4,16,30,-14,15,1
414206,1,6,0,6,14,1
16449,1,3,0,3,8,0
26084,1,0,10,-10,13,1
270897,4,19,13,6,1,0
77564,4,20,14,6,1,1
352234,2,3,3,0,3,1
381441,4,23,14,9,16,0
361183,1,0,7,-7,7,1
299108,2,3,3,0,14,0
29219,1,0,0,0,14,1
388956,4,17,27,-10,3,1
26925,3,13,6,7,13,0
332120,1,0,0,0,12,0
308920,1,0,0,0,1,1
73219,3,7,6,1,16,0
32075,3,14,13,1,15,0
32885,4,19,7,12,15,0
43434,5,24,24,0,3,0
290986,3,20,13,7,10,1
342188,4,15,19,-4,16,1
305582,3,20,7,13,17,0
153089,2,0,10,-10,1,1
123227,4,13,21,-8,4,1
171551,4,33,10,23,9,0
287334,2,13,0,13,8,0
383239,2,28,3,25,17,0
36676,3,20,3,17,17,1
228421,4,10,27,-17,17,1
48903,3,12,0,12,5,0
178013,3,7,20,-13,12,1
372355,4,24,17,7,13,1
19754,3,9,12,-3,10,1
20275,1,7,0,7,10,0
62663,4,24,20,4,12,0
295523,2,17,7,10,12,1
192613,2,3,7,-4,1,0
349250,1,0,14,-14,2,0
229568,3,27,6,21,17,0
65930,3,17,14,3,13,0
363477,1,0,0,0,8,0
197779,4,21,17,4,3,0
293926,2,7,21,-14,12,1
134279,1,0,0,0,10,0
359541,1,0,0,0,6,0
388979,4,24,27,-3,3,0
112768,4,13,10,3,17,0
322105,4,26,0,26,7,1
236840,4,3,9,-6,3,1
388696,1,0,0,0,3,1
63968,1,0,0,0,13,1
398614,2,0,0,0,7,1
94664,3,17,26,-9,9,0
36923,2,0,16,-16,17,0
219304,2,10,7,3,13,1
261599,4,12,15,-3,14,0
319616,2,16,3,13,6,0
180123,1,7,0,7,13,1
391855,2,10,10,0,4,1
307636,2,14,7,7,17,0
33866,4,9,41,-32,16,0
367733,3,12,13,-1,10,1
389664,3,24,16,8,3,0
232802,3,16,14,2,2,0
147130,3,17,37,-20,15,0
277719,2,7,3,4,4,0
285211,1,0,0,0,7,1
45439,2,14,7,7,4,1
132015,3,0,24,-24,8,1
306179,3,10,3,7,17,0
224260,2,6,6,0,15,1
284128,1,0,3,-3,7,0
32162,1,7,0,7,15,0
364857,3,6,14,-8,9,0
139892,4,23,24,-1,12,0
276982,4,17,20,-3,4,1
79908,3,3,16,-13,2,0
16514,3,20,13,7,8,0
195181,1,10,0,10,2,1
24779,1,6,0,6,12,0
288593,4,23,38,-15,9,1
388107,1,3,0,3,2,0
76852,4,33,7,26,1,1
244442,1,0,0,0,7,0
223917,4,30,6,24,15,0
40783,3,17,28,-11,2,1
315840,3,9,19,-10,4,0
33645,2,14,0,14,16,0
336815,4,10,30,-20,14,0
410287,3,7,16,-9,13,1
240958,3,21,9,12,5,0
217303,2,0,7,-7,12,0
389917,2,15,10,5,3,0
241020,5,30,30,0,5,1
100669,3,14,14,0,12,1
46898,3,13,20,-7,5,1
19916,4,16,21,-5,10,1
164741,2,19,14,5,6,1
293849,4,31,19,12,12,0
63901,3,6,21,-15,12,0
78109,2,7,3,4,2,1
131653,2,0,22,-22,8,1
27198,3,16,7,9,13,1
45074,4,23,20,3,4,0
223722,4,37,13,24,15,0
420240,1,0,0,0,17,1
181503,1,0,0,0,13,0
345588,3,14,23,-9,17,1
36570,4,23,37,-14,17,1
226238,2,6,0,6,16,1
129349,2,14,7,7,7,1
151759,2,13,6,7,17,1
411197,3,3,23,-20,13,0
80131,1,0,0,0,2,1
66460,2,7,7,0,14,0
31572,1,7,3,4,15,0
38568,4,38,6,32,1,0
351085,3,21,23,-2,3,1
138036,3,22,17,5,11,1
243111,3,7,9,-2,6,0
348977,2,14,0,14,2,1
128888,1,0,3,-3,7,0
20774,1,0,0,0,10,1
174278,1,0,0,0,10,0
282224,2,3,7,-4,6,1
221563,2,20,12,8,14,0
122129,3,17,14,3,4,0
109505,1,0,0,0,16,1
132847,2,3,14,-11,9,1
332534,1,0,0,0,12,0
139547,2,6,0,6,12,0
343010,1,0,0,0,16,1
74387,2,7,10,-3,17,1
283566,2,6,17,-11,7,0
363054,1,0,0,0,8,1
179033,1,3,0,3,12,1
95834,3,6,10,-4,10,0
102422,1,3,0,3,13,0
95322,4,17,24,-7,10,1
259400,1,0,3,-3,13,0
379957,4,24,6,18,16,0
366545,2,20,7,13,10,0
33976,3,10,27,-17,16,1
191825,2,10,10,0,1,1
249544,3,14,10,4,9,0
153149,3,20,17,3,1,1
233541,1,7,7,0,2,0
122717,2,7,17,-10,4,1
137109,3,24,6,18,11,0
203593,1,0,0,0,6,0
348655,1,3,3,0,2,1
195257,3,23,17,6,2,0
209673,2,6,0,6,8,1
285728,1,0,3,-3,8,0
95053,1,0,0,0,9,0
114666,3,3,10,-7,1,0
72381,4,10,23,-13,16,1
240056,4,17,26,-9,5,0
221145,3,0,9,-9,14,0
250430,1,0,0,0,9,1
417455,1,3,7,-4,16,0
136919,3,0,13,-13,11,0
290547,3,20,20,0,10,0
78430,3,17,0,17,2,0
356674,2,19,10,9,5,0
190358,2,7,0,7,17,1
282275,4,25,14,11,6,0
160135,1,10,0,10,3,0
36875,4,24,42,-18,17,1
262980,1,0,0,0,15,1
139264,2,13,6,7,12,0
251266,3,13,24,-11,10,0
402552,2,7,7,0,9,1
415829,1,0,13,-13,15,1
138823,3,3,33,-30,12,0
401871,3,14,28,-14,9,0
126578,4,16,12,4,6,0
166055,4,20,31,-11,6,1
4739,1,10,0,10,3,0
345935,4,20,23,-3,17,1
142751,2,9,10,-1,13,0
266017,1,7,0,7,16,0
209034,2,3,0,3,8,0
230169,3,3,26,-23,17,1
199910,1,0,0,0,4,1
53644,1,0,0,0,8,0
320276,3,14,14,0,6,0
232372,4,13,15,-2,1,1
173765,2,10,3,7,10,1
53111,3,19,24,-5,7,1
309762,4,29,12,17,1,1
162108,4,48,13,35,4,0
181549,2,6,0,6,13,1
55061,2,13,3,10,8,1
163021,4,19,3,16,5,0
274059,2,10,0,10,3,1
176431,1,0,0,0,11,1
382802,2,21,0,21,17,1
48569,3,14,17,-3,5,1
112373,2,10,13,-3,17,1
122740,3,7,17,-10,4,1
63663,4,20,36,-16,12,1
335679,1,7,0,7,13,0
56490,4,7,41,-34,9,0
193789,1,0,0,0,1,1
70454,2,14,17,-3,15,1
404607,2,13,10,3,10,0
290761,1,0,0,0,10,0
103799,2,6,0,6,13,1
176465,1,0,10,-10,11,0
241683,2,7,3,4,5,0
243651,4,23,20,3,6,0
226921,4,3,10,-7,16,0
272710,3,12,3,9,2,1
15793,3,0,12,-12,8,1
263690,4,30,13,17,15,0
39970,1,0,0,0,1,1
322441,1,6,0,6,7,1
303944,3,14,31,-17,16,1
362151,1,0,0,0,8,0
265811,4,20,12,8,16,0
134267,4,10,26,-16,10,1
101105,3,10,10,0,12,0
182463,2,7,0,7,14,0
105760,4,37,10,27,14,1
147845,2,3,14,-11,15,0
323321,1,0,0,0,7,0
60352,2,3,7,-4,11,1
64522,1,0,0,0,13,1
3845,1,7,0,7,2,0
14437,2,24,3,21,7,0
389802,3,17,6,11,3,0
210187,3,7,14,-7,9,0
152316,1,7,0,7,17,0
155588,4,23,10,13,2,0
49417,4,20,20,0,6,1
187522,2,6,10,-4,16,0
307930,2,7,0,7,1,0
45152,2,7,7,0,4,0
15935,2,6,7,-1,8,0
407934,4,17,24,-7,11,0
407419,3,14,7,7,11,0
412867,4,37,35,2,14,1
84880,3,27,17,10,4,1
90683,1,0,0,0,7,0
216430,1,7,0,7,12,0
249262,3,26,14,12,9,0
140044,4,28,10,18,12,0
199964,2,10,10,0,4,1
9052,3,21,13,8,4,1
149679,2,17,0,17,16,1
232668,3,7,0,7,1,1
164120,4,21,6,15,5,1
264467,4,20,35,-15,15,1
326934,2,2,0,2,9,1
410725,2,17,6,11,13,1
341036,2,7,14,-7,15,1
225520,3,0,21,-21,15,0
413927,1,0,0,0,14,1
338574,4,29,31,-2,14,0
133126,2,7,3,4,9,0
97518,2,16,0,16,10,0
256186,4,30,22,8,12,0
199018,1,0,0,0,4,0
411775,3,0,20,-20,13,1
201863,4,28,30,-2,5,1
210041,4,10,10,0,8,0
136817,4,20,13,7,11,1
5530,3,13,10,3,3,1
16095,3,33,7,26,8,0
366911,4,3,16,-13,10,1
31314,2,7,3,4,15,0
223914,4,30,6,24,15,1
320473,4,20,17,3,6,0
248486,4,17,6,11,8,1
50643,4,17,9,8,6,1
22427,2,17,24,-7,11,0
157685,1,7,3,4,2,0
103612,1,0,0,0,13,1
399541,4,0,33,-33,7,1
372863,1,3,0,3,13,0
217971,1,7,3,4,12,0
167248,4,30,17,13,7,0
169597,1,3,0,3,8,1
407782,4,10,7,3,11,0
86239,1,6,10,-4,5,0
89605,4,7,40,-33,7,1
366955,1,0,14,-14,10,1
175988,2,14,0,14,11,0
37348,2,17,0,17,17,1
306375,1,0,0,0,17,1
167568,4,3,17,-14,7,1
349158,3,20,7,13,2,1
138178,2,7,9,-2,11,0
344552,3,0,0,0,17,1
27514,3,23,9,14,13,0
213925,1,10,7,3,10,0
44436,3,17,7,10,3,1
12073,1,7,0,7,6,1
85300,2,7,3,4,5,1
134527,4,3,36,-33,10,1
335035,4,16,13,3,13,1
403832,1,0,0,0,10,0
170411,2,14,3,11,8,1
412563,4,31,21,10,14,0
22515,4,31,37,-6,11,0
202364,4,20,13,7,5,0
17677,2,14,6,8,9,0
229709,2,13,10,3,17,1
65323,3,3,21,-18,13,0
335672,1,7,0,7,13,0
169420,4,6,31,-25,8,1
179413,3,6,13,-7,12,0
388900,2,10,14,-4,3,1
57783,2,19,10,9,10,1
62264,2,21,7,14,12,0
260007,1,0,0,0,14,1
374828,2,7,0,7,14,0
120646,4,3,27,-24,3,1
406593,4,20,37,-17,11,1
242696,1,0,0,0,6,1
272067,2,10,3,7,2,0
173843,4,23,3,20,10,0
334240,2,3,7,-4,13,1
120637,4,3,27,-24,3,1
157206,1,7,0,7,2,0
342456,4,13,3,10,16,1
403875,2,10,0,10,10,0
277411,3,31,9,22,4,0
279091,2,21,7,14,5,0
59637,3,20,3,17,11,1
421169,4,44,16,28,17,1
274579,3,24,23,1,3,0
71706,1,10,0,10,16,0
81436,4,10,13,-3,3,0
56878,2,14,0,14,9,0
397416,2,0,13,-13,6,1
166402,2,10,7,3,6,1
324200,1,0,0,0,8,1
233297,3,7,17,-10,2,0
353060,1,7,6,1,3,1
4686,4,20,20,0,2,1
167203,3,23,10,13,7,0
292496,3,10,12,-2,11,0
188496,1,0,0,0,16,0
212285,2,7,3,4,10,0
352885,4,14,16,-2,3,1
94387,4,17,21,-4,9,1
303767,3,20,10,10,16,0
414122,2,10,10,0,14,0
96127,2,0,16,-16,10,1
81371,2,6,7,-1,3,1
282726,4,16,27,-11,6,0
368118,2,7,7,0,11,0
348874,3,6,14,-8,2,1
262984,1,0,0,0,15,1
270498,1,0,7,-7,1,1
235576,3,24,13,11,3,1
26955,4,16,6,10,13,0
283854,2,7,3,4,7,0
318683,1,0,13,-13,5,1
107003,1,7,0,7,15,0
152274,4,27,0,27,17,1
197986,2,0,17,-17,3,0
93379,1,0,0,0,9,1
279679,2,23,0,23,5,0
179633,4,31,30,1,12,1
204092,2,3,7,-4,6,1
5741,1,0,0,0,3,1
280274,2,13,13,0,5,0
126424,4,33,24,9,6,0
243646,4,23,20,3,6,1
228586,1,7,7,0,17,1
94220,3,24,17,7,9,1
3383,1,0,0,0,2,0
233370,1,0,0,0,2,1
271464,3,14,0,14,1,0
203634,2,7,10,-3,6,1
313696,1,7,3,4,3,0
23188,3,23,6,17,11,0
163274,2,6,6,0,5,1
251129,4,10,17,-7,10,1
226443,2,0,7,-7,16,1
4941,3,14,17,-3,3,1
285752,2,7,10,-3,8,0
401340,1,0,0,0,8,0
418968,1,7,7,0,16,0
385992,4,27,28,-1,1,1
205397,4,27,0,27,6,1
123558,4,16,17,-1,4,1
142773,3,12,10,2,13,0
347710,4,27,24,3,1,0
227284,2,10,20,-10,16,0
115993,2,10,0,10,1,1
291979,1,0,3,-3,11,1
79517,4,12,27,-15,2,1
182496,3,21,7,14,14,1
319533,4,13,23,-10,6,1
164868,2,0,3,-3,6,1
41213,3,7,13,-6,2,0
24319,1,0,0,0,12,1
410125,3,17,10,7,13,1
21585,3,7,24,-17,11,1
178866,4,27,21,6,12,1
157045,1,0,0,0,2,0
215103,4,19,7,12,11,1
101026,1,0,0,0,12,0
34278,3,17,9,8,16,1
40387,1,0,0,0,2,0
307919,2,0,0,0,1,1
327606,4,10,22,-12,10,1
213831,3,42,0,42,10,0
247,3,12,17,-5,1,0
106775,3,20,15,5,14,0
295514,2,14,7,7,12,0
161940,4,13,16,-3,4,0
56830,5,20,20,0,9,0
4632,2,10,10,0,2,1
99822,4,8,24,-16,12,1
150161,2,6,13,-7,16,0
410365,1,0,7,-7,13,1
366995,2,0,31,-31,10,1
27372,3,24,10,14,13,0
147015,3,24,0,24,15,1
175314,4,22,19,3,10,1
159086,3,17,0,17,3,1
207207,4,17,20,-3,7,0
370770,3,12,10,2,12,1
259123,2,7,0,7,13,1
375113,2,7,7,0,14,1
293323,1,0,0,0,11,1
19721,2,6,6,0,10,1
134671,4,34,30,4,10,0
326946,2,2,0,2,9,0
22588,2,13,3,10,11,1
46453,2,7,6,1,4,1
281712,4,31,30,1,6,1
86970,2,14,3,11,5,1
58879,2,3,15,-12,10,0
253288,4,10,13,-3,11,0
34527,1,0,0,0,16,1
274636,1,0,0,0,3,1
396088,2,17,9,8,6,1
388178,3,3,12,-9,2,0
48922,4,15,13,2,5,1
201310,2,28,3,25,5,0
216367,3,14,16,-2,12,1
10533,3,34,0,34,5,0
149688,2,20,0,20,16,1
390967,2,13,7,6,4,0
390151,4,20,35,-15,3,0
379849,1,7,0,7,16,1
191961,2,0,13,-13,1,1
278461,2,22,0,22,4,0
362146,4,42,23,19,8,0
34428,2,21,3,18,16,1
303652,4,38,13,25,16,0
97379,3,9,13,-4,10,0
12207,2,0,0,0,6,1
226290,3,16,0,16,16,0
191800,1,3,0,3,1,0
18161,3,13,20,-7,9,1
324308,3,25,7,18,8,0
170866,2,7,0,7,8,0
207881,3,14,7,7,8,0
276940,2,17,14,3,4,0
230004,2,0,6,-6,17,1
327806,1,3,10,-7,10,0
148447,2,7,3,4,16,0
210142,2,0,0,0,9,0
399263,4,13,30,-17,7,1
14006,2,3,7,-4,7,0
192128,2,0,6,-6,1,1
130450,1,3,0,3,8,0
224478,3,9,10,-1,15,1
399150,1,0,3,-3,7,0
241896,4,20,13,7,5,0
188230,1,0,7,-7,16,1
307540,4,38,19,19,17,0
313951,4,28,32,-4,3,1
402727,2,17,0,17,9,0
286175,5,24,24,0,8,0
141137,1,3,7,-4,13,1
390926,1,7,0,7,4,0
71165,2,19,10,9,16,0
278304,2,14,0,14,4,1
82848,4,15,16,-1,3,1
381693,3,20,14,6,17,0
386052,2,14,0,14,1,0
362978,3,27,16,11,8,0
212734,2,3,14,-11,10,1
90961,1,0,0,0,7,0
286094,3,10,10,0,8,1
353568,3,24,0,24,4,0
391424,2,10,17,-7,4,1
156016,2,17,17,0,2,0
347925,2,0,20,-20,1,0
260124,4,6,34,-28,14,0
414879,3,21,7,14,15,1
8101,4,24,20,4,4,1
199460,4,22,17,5,4,0
8007,1,3,6,-3,4,0
362763,1,7,0,7,8,0
226446,2,0,7,-7,16,1
332656,4,27,20,7,12,0
177424,3,17,10,7,11,1
380916,2,3,0,3,16,1
308948,1,0,3,-3,1,0
319067,4,20,38,-18,5,1
267941,1,0,0,0,17,1
307184,2,0,10,-10,17,1
11105,3,10,13,-3,5,1
405696,1,10,0,10,10,0
318349,4,9,22,-13,5,1
188771,4,0,20,-20,16,1
311436,1,0,3,-3,2,1
22947,4,3,26,-23,11,0
234637,2,20,17,3,2,0
249980,2,0,3,-3,9,1
29529,1,0,7,-7,14,0
319273,1,3,3,0,6,1
59344,3,0,9,-9,11,0
48378,2,3,10,-7,5,0
187353,2,14,7,7,16,0
346990,3,7,3,4,1,0
196194,1,7,0,7,2,1
292645,3,22,16,6,11,0
187737,4,16,20,-4,16,0
349592,3,13,28,-15,2,1
227310,3,13,20,-7,16,0
174728,4,9,10,-1,10,0
216662,2,14,6,8,12,1
326714,4,23,20,3,9,1
136413,2,3,7,-4,11,1
313629,4,25,30,-5,3,0
125377,4,45,3,42,5,0
181054,2,7,0,7,13,1
113281,2,13,21,-8,17,1
413198,1,0,0,0,14,1
245424,3,9,6,3,7,1
296075,4,9,7,2,13,0
389683,4,24,16,8,3,1
156040,3,20,17,3,2,0
68875,4,6,20,-14,15,1
223065,2,17,7,10,14,1
260069,2,3,7,-4,14,1
347333,4,7,21,-14,1,1
61914,4,27,30,-3,12,1
65475,3,23,14,9,13,0
264482,4,27,35,-8,15,0
196041,1,0,14,-14,2,1
386539,3,14,21,-7,2,0
230344,4,19,17,2,17,1
344966,3,10,14,-4,17,0
226737,2,7,13,-6,16,1
22600,2,20,3,17,11,1
305575,3,13,7,6,17,1
108871,4,7,17,-10,15,1
125871,1,6,10,-4,6,0
416879,1,0,0,0,15,0
65643,4,6,19,-13,13,1
154516,4,21,17,4,1,0
26579,2,10,6,4,13,1
53944,4,14,19,-5,8,1
369764,4,38,43,-5,11,1
52392,3,9,17,-8,7,1
186748,1,20,0,20,15,0
71858,2,9,0,9,16,1
76048,3,10,16,-6,1,1
333282,4,6,24,-18,12,1
248423,2,10,3,7,8,1
189896,1,0,7,-7,17,1
360090,4,10,40,-30,7,1
158233,3,31,0,31,3,1
334455,4,17,13,4,13,1
42421,4,14,22,-8,2,1
292960,4,10,0,10,11,0
292994,1,0,6,-6,11,1
254647,4,28,21,7,11,1
61120,3,0,7,-7,11,1
80666,3,17,19,-2,3,1
289507,3,21,7,14,10,0
201734,1,0,0,0,5,0
28014,1,0,0,0,13,0
119432,2,7,14,-7,3,0
118258,2,9,7,2,2,1
417057,2,17,0,17,15,1
208959,4,20,14,6,8,1
122030,4,16,13,3,4,1
7421,2,13,3,10,4,1
367382,2,10,14,-4,10,0
218672,4,10,33,-23,13,0
377804,1,7,0,7,15,0
340053,3,17,12,5,15,1
243886,2,16,6,10,6,0
291096,2,12,10,2,10,0
273592,1,3,3,0,2,0
250235,4,27,23,4,9,1
43066,3,3,10,-7,3,1
176680,3,29,12,17,11,0
233174,4,29,9,20,2,0
415889,3,10,20,-10,15,0
399189,2,10,13,-3,7,1
280867,3,13,3,10,6,0
355845,2,13,7,6,5,0
253543,2,6,7,-1,11,0
414838,2,21,7,14,15,0
40148,2,13,7,6,2,0
334623,1,0,0,0,13,1
402924,4,17,9,8,9,1
332601,2,17,6,11,12,1
254367,4,13,30,-17,11,1
212811,4,17,21,-4,10,0
119194,4,16,7,9,3,0
312108,3,30,10,20,2,1
295087,2,7,0,7,12,0
177806,1,0,3,-3,12,1
15478,2,9,0,9,8,1
202065,1,0,0,0,5,1
112000,3,20,21,-1,17,1
392000,2,0,7,-7,4,0
364951,1,7,0,7,9,0
113067,4,16,16,0,17,1
30951,4,17,24,-7,15,1
377696,2,25,7,18,15,1
343818,3,21,3,18,17,0
178136,1,0,7,-7,12,1
229148,4,19,7,12,17,1
326118,4,30,3,27,9,0
102818,3,10,10,0,13,1
110087,1,0,0,0,16,1
321554,1,3,3,0,7,0
372450,2,6,14,-8,13,0
58066,1,7,10,-3,10,1
193538,2,0,0,0,1,0
256604,3,21,0,21,12,0
310680,4,13,36,-23,2,1
290635,2,21,7,14,10,1
345633,4,24,26,-2,17,1
93414,2,3,7,-4,9,0
213796,2,28,0,28,10,0
175050,4,20,28,-8,10,0
293340,1,7,0,7,11,0
346690,3,21,6,15,1,1
309813,2,7,7,0,1,1
209404,3,14,10,4,8,1
349131,2,13,7,6,2,0
13451,2,3,21,-18,7,0
28590,4,33,7,26,14,1
165262,3,17,14,3,6,0
154453,3,14,7,7,1,1
140460,2,14,7,7,12,1
293516,2,10,10,0,11,1
354959,2,7,6,1,4,0
213249,4,10,16,-6,10,1
135457,1,0,0,0,10,0
86318,4,27,23,4,5,0
286890,3,9,7,2,8,1
302209,2,28,7,21,15,0
358490,4,41,27,14,6,0
227116,1,0,0,0,16,1
91933,2,3,10,-7,8,1
89066,2,6,6,0,6,1
194301,2,10,3,7,2,0
346508,2,17,30,-13,1,1
299842,2,10,0,10,14,0
380749,1,3,0,3,16,0
370335,4,14,35,-21,12,1
138216,3,10,12,-2,11,1
79050,3,10,14,-4,2,0
128016,1,0,0,0,7,1
180575,1,0,0,0,13,0
325404,1,0,0,0,8,0
277856,2,7,14,-7,4,0
382387,2,0,14,-14,17,0
228554,4,20,14,6,17,1
318621,3,10,13,-3,5,0
421545,3,10,3,7,17,1
59923,2,3,3,0,11,1
171636,3,19,10,9,9,0
278126,1,0,7,-7,4,1
78989,2,3,7,-4,2,0
165958,2,10,7,3,6,1
315769,2,0,3,-3,4,0
82541,4,17,27,-10,3,0
94843,4,6,13,-7,9,1
143380,3,7,23,-16,14,1
215210,3,10,16,-6,11,1
104439,1,0,7,-7,13,0
127326,3,10,17,-7,6,0
238435,4,23,36,-13,4,0
182079,4,17,24,-7,13,1
215433,1,7,3,4,11,1
109083,1,0,0,0,15,1
186512,4,17,20,-3,15,0
222910,2,13,3,10,14,0
33353,2,6,3,3,16,1
346161,1,7,0,7,1,1
65413,2,0,7,-7,13,1
6342,1,0,3,-3,3,1
352248,2,3,3,0,3,0
3623,3,20,21,-1,2,0
345938,4,20,23,-3,17,1
162738,4,35,24,11,5,0
121943,2,3,7,-4,4,0
89063,2,6,6,0,6,1
177067,1,3,3,0,11,1
262345,4,13,16,-3,15,1
75326,4,21,33,-12,17,0
1349,2,0,0,0,1,1
239472,4,15,24,-9,4,1
281329,3,14,13,1,6,0
352376,2,21,7,14,3,1
300897,2,10,10,0,15,1
157131,3,16,20,-4,2,0
108013,1,0,0,0,15,1
361671,3,7,25,-18,7,1
156949,2,7,10,-3,2,0
90516,4,0,26,-26,7,0
45796,4,13,14,-1,4,1
151808,3,21,16,5,17,0
76307,1,9,3,6,1,1
225837,4,24,21,3,16,0
309807,1,7,0,7,1,0
125225,4,31,14,17,5,0
139190,4,19,13,6,12,1
38861,4,3,13,-10,1,1
221013,4,21,17,4,14,0
191510,2,14,14,0,17,1
6479,1,0,0,0,3,0
52404,4,12,17,-5,7,0
44303,3,17,20,-3,3,1
336881,2,7,14,-7,14,1
189747,2,7,6,1,17,1
194215,4,12,17,-5,1,1
106690,1,0,0,0,14,1
281022,3,17,13,4,6,0
300930,4,10,27,-17,15,1
175365,2,14,0,14,11,0
143704,4,19,10,9,14,0
198208,4,13,9,4,3,0
376143,4,3,16,-13,14,1
90773,3,20,7,13,7,1
228581,1,7,7,0,17,1
236978,4,38,7,31,3,1
351117,4,37,30,7,3,0
213090,3,20,3,17,10,0
113566,2,0,0,0,17,0
346629,1,7,3,4,1,1
112623,4,38,34,4,17,0
129570,3,6,17,-11,7,0
183187,1,0,0,0,14,0
108658,2,20,0,20,15,1
314367,3,10,17,-7,3,0
324207,1,0,0,0,8,0
263790,3,0,24,-24,15,1
153173,4,20,17,3,1,0
16518,3,20,13,7,8,1
279280,3,19,13,6,5,0
23554,4,17,17,0,11,0
340348,3,17,10,7,15,0
285237,1,0,6,-6,7,0
94957,2,3,6,-3,9,1
192035,4,24,27,-3,1,1
364196,1,0,0,0,9,1
354848,4,33,28,5,4,0
247591,3,16,22,-6,8,0
84103,1,0,0,0,4,1
364547,2,9,21,-12,9,1
126910,4,17,14,3,6,0
76501,2,0,20,-20,1,1
392291,1,0,7,-7,4,1
355977,2,0,7,-7,5,0
266570,1,0,0,0,16,1
307326,2,14,19,-5,17,0
375996,4,23,15,8,14,0
242672,4,13,10,3,6,1
302689,4,20,20,0,15,0
354612,2,3,7,-4,4,0
301887,2,0,12,-12,15,0
119137,3,10,7,3,3,1
216394,4,14,23,-9,12,1
354498,3,27,28,-1,4,0
402423,2,21,7,14,9,0
121930,1,3,7,-4,4,0
208662,4,6,6,0,8,0
70063,4,31,17,14,15,1
104386,4,52,38,14,13,0
388612,2,14,0,14,3,0
271587,2,7,20,-13,2,1
49890,4,28,20,8,6,0
246983,3,20,24,-4,8,1
237807,2,0,10,-10,4,0
314511,3,21,6,15,3,0
4500,2,14,19,-5,2,1
5844,4,27,7,20,3,0
391325,4,24,3,21,4,0
104904,2,3,3,0,14,1
46601,2,3,0,3,4,0
239895,3,13,3,10,4,0
94428,1,0,0,0,9,1
45527,4,27,26,1,4,1
353547,2,17,0,17,4,1
11025,1,0,0,0,5,1
175774,1,0,0,0,11,0
43962,2,3,7,-4,3,0
253522,2,0,7,-7,11,1
92444,3,20,10,10,8,0
384195,4,29,20,9,1,1
142929,3,3,10,-7,13,0
112643,4,38,41,-3,17,1
80813,3,3,0,3,3,1
408897,1,14,6,8,12,1
337919,2,10,0,10,14,1
26975,1,0,0,0,13,1
323693,3,20,0,20,8,0
362879,1,0,0,0,8,1
333040,2,3,12,-9,12,0
160382,4,3,28,-25,4,1
129753,3,17,17,0,7,0
12753,4,59,0,59,6,1
408276,1,0,0,0,12,1
85145,2,0,3,-3,4,0
211946,1,0,3,-3,9,1
296004,2,3,0,3,13,0
158025,2,0,6,-6,3,0
114521,3,17,27,-10,1,1
28218,2,10,0,10,13,1
11642,2,14,0,14,6,0
296628,3,3,10,-7,13,1
288350,2,7,0,7,9,1
243798,4,24,20,4,6,0
342506,1,0,0,0,16,0
47347,3,3,10,-7,5,1
64601,3,20,14,6,13,0
26943,4,16,6,10,13,0
237855,3,7,27,-20,4,1
397665,4,6,30,-24,7,0
339110,2,10,0,10,15,0
309711,3,16,6,10,1,1
233913,3,14,13,1,2,1
307914,1,0,0,0,1,1
120100,2,3,0,3,3,1
397839,1,0,0,0,7,1
102889,1,0,14,-14,13,1
108001,4,6,20,-14,15,0
255024,2,3,9,-6,12,1
339074,1,0,0,0,15,1
61163,4,0,14,-14,11,0
337709,4,24,24,0,14,1
55905,1,0,0,0,9,0
400730,4,16,17,-1,8,1
289694,1,0,0,0,10,1
369811,1,0,0,0,12,1
208488,2,37,7,30,8,0
175951,1,0,0,0,11,1
10126,4,44,7,37,5,0
14378,4,9,20,-11,7,1
388348,3,17,12,5,2,1
139595,4,9,14,-5,12,1
28241,3,17,0,17,13,1
314620,2,7,0,7,3,0
204675,1,7,0,7,6,0
35105,4,15,27,-12,16,0
273087,4,9,3,6,2,1
383218,2,14,3,11,17,0
175369,2,14,0,14,11,0
334284,3,9,7,2,13,0
128770,2,7,3,4,7,0
341234,3,16,10,6,16,0
206673,1,0,7,-7,7,0
120910,4,21,31,-10,3,1
350473,3,7,12,-5,2,0
262226,1,3,0,3,15,0
27668,4,7,27,-20,13,1
341577,4,16,17,-1,16,1
420177,3,0,3,-3,17,1
49758,1,0,7,-7,6,1
123070,4,14,21,-7,4,1
370878,2,10,3,7,12,0
259377,4,35,34,1,13,0
210727,2,14,0,14,9,0
136541,1,0,10,-10,11,0
241736,3,7,9,-2,5,1
376093,3,0,3,-3,14,0
335037,4,16,13,3,13,0
47090,4,24,10,14,5,1
176582,5,19,20,-1,11,1
138409,1,7,0,7,12,0
3051,4,20,41,-21,2,0
233122,2,22,3,19,2,1
335801,1,0,0,0,13,1
407557,2,10,3,7,11,0
318370,1,0,0,0,5,1
106595,2,31,0,31,14,0
291969,1,0,0,0,11,0
223758,4,40,13,27,15,1
171666,4,19,17,2,9,1
389899,2,12,3,9,3,0
359298,2,3,13,-10,6,1
149038,1,0,7,-7,16,0
216888,3,13,17,-4,12,1
302260,4,38,13,25,15,1
234428,1,10,3,7,2,1
150850,1,0,0,0,17,0
96782,4,7,10,-3,10,0
637,2,0,3,-3,1,1
215017,2,10,0,10,11,1
323059,2,17,14,3,7,0
27128,1,0,0,0,13,0
38593,4,38,13,25,1,0
24404,3,13,7,6,12,1
189631,3,10,6,4,17,1
79616,3,14,13,1,2,0
256812,4,13,13,0,12,0
8067,3,17,7,10,4,1
330894,4,16,24,-8,11,0
134397,4,32,24,8,10,0
221179,4,0,23,-23,14,1
318744,3,10,23,-13,5,0
380140,5,38,44,-6,16,0
56460,3,0,38,-38,9,0
237798,1,0,10,-10,4,0
247101,2,13,3,10,8,0
235714,3,3,17,-14,3,0
52774,1,0,20,-20,7,0
112090,2,7,14,-7,17,0
350833,1,0,0,0,3,1
132142,3,10,3,7,9,0
19782,4,12,15,-3,10,1
214583,2,3,3,0,11,0
115058,1,0,0,0,1,1
301232,4,27,17,10,15,0
340721,1,0,0,0,15,1
196472,1,0,0,0,2,0
393812,1,7,10,-3,5,0
412552,4,31,14,17,14,0
339571,2,10,7,3,15,1
72097,4,10,17,-7,16,0
120845,2,7,14,-7,3,1
272720,3,12,3,9,2,0
283918,4,31,17,14,7,0
327159,3,21,17,4,9,1
53994,1,0,0,0,8,0
98704,2,21,3,18,11,0
305635,1,0,0,0,17,1
54408,4,33,25,8,8,1
236347,3,7,23,-16,3,0
286960,4,26,19,7,8,0
370686,1,0,0,0,12,0
344708,3,6,27,-21,17,1
97255,4,12,13,-1,10,1
325222,4,13,26,-13,8,1
323998,3,17,16,1,8,1
52663,2,3,10,-7,7,0
237955,1,3,0,3,4,0
397463,3,13,13,0,6,0
266157,1,7,0,7,16,0
364791,1,0,0,0,9,0
134124,4,27,13,14,9,0
354008,1,0,0,0,4,1
45860,1,7,0,7,4,0
379109,4,7,12,-5,15,1
211306,2,3,3,0,9,1
339219,1,0,0,0,15,1
133637,3,10,21,-11,9,1
309296,3,0,20,-20,1,0
113733,2,3,10,-7,17,0
239560,2,13,0,13,4,0
111852,4,6,10,-4,17,1
307056,3,24,0,24,17,0
420439,1,0,14,-14,17,1
350303,2,14,0,14,2,0
51237,4,39,25,14,7,0
118373,2,6,7,-1,2,0
85172,2,7,10,-3,4,1
127095,1,3,2,1,6,0
40807,4,17,34,-17,2,0
26671,1,0,0,0,13,0
78575,2,16,7,9,2,0
81494,1,0,14,-14,3,1
360729,2,17,14,3,7,1
284891,1,0,7,-7,7,1
141410,4,10,20,-10,13,1
187042,1,3,0,3,16,1
214329,4,21,13,8,11,1
101957,4,9,13,-4,12,0
321806,4,21,9,12,7,1
5784,2,21,7,14,3,1
314946,4,0,10,-10,4,0
112793,4,27,10,17,17,0
169003,2,12,14,-2,7,0
348092,3,0,19,-19,1,1
12963,1,0,0,0,6,0
70933,4,15,36,-21,15,0
404996,4,9,20,-11,10,0
313611,3,19,23,-4,3,1
207024,3,28,3,25,7,0
28213,2,10,0,10,13,0
129106,3,27,28,-1,7,0
396930,4,34,33,1,6,1
301024,2,10,3,7,15,1
385796,3,27,3,24,1,0
181393,2,17,14,3,13,1
280689,2,0,3,-3,5,0
338393,3,24,10,14,14,0
107244,4,14,31,-17,15,0
383150,4,23,17,6,17,1
44985,2,10,0,10,4,0
49478,1,0,0,0,6,0
387901,4,10,28,-18,2,1
91345,3,14,7,7,8,0
414631,1,0,0,0,14,1
18711,2,3,7,-4,9,0
117126,1,6,0,6,2,0
160590,1,0,0,0,4,0
340111,1,0,0,0,15,1
317794,2,9,3,6,5,1
218970,1,0,0,0,13,1
133362,4,20,9,11,9,1
284754,2,13,10,3,7,0
281676,3,24,17,7,6,1
134193,2,0,17,-17,10,0
306722,2,10,10,0,17,0
82509,3,10,20,-10,3,0
286029,1,0,0,0,8,1
312292,4,10,23,-13,2,0
384354,4,16,17,-1,1,1
15804,3,0,12,-12,8,0
191245,3,7,17,-10,17,1
294239,3,13,14,-1,12,1
226026,5,34,34,0,16,1
136224,1,6,0,6,11,1
108794,2,0,7,-7,15,0
214789,4,10,20,-10,11,0
198291,2,6,7,-1,3,0
404548,4,34,27,7,10,0
311138,4,13,13,0,2,0
161494,4,10,6,4,4,1
305006,4,24,20,4,16,0
322410,4,17,26,-9,7,0
48702,2,7,19,-12,5,1
323385,3,17,0,17,7,1
404448,2,14,7,7,10,1
271692,1,6,3,3,2,0
144902,3,14,7,7,14,0
222597,1,7,0,7,14,0
275530,4,26,36,-10,3,1
260594,1,0,7,-7,14,1
15937,2,6,13,-7,8,0
21451,3,12,14,-2,11,0
420451,2,0,14,-14,17,0
416365,4,16,6,10,15,1
151521,4,35,7,28,17,1
71260,1,0,0,0,16,1
100758,1,6,0,6,12,0
188165,4,16,10,6,16,1
370892,3,13,10,3,12,1
22691,1,3,0,3,11,0
406445,4,31,13,18,11,1
51276,1,6,0,6,7,0
371722,2,14,14,0,12,0
39629,4,27,6,21,1,0
283610,3,13,20,-7,7,1
291753,3,3,14,-11,11,0
80694,4,24,26,-2,3,1
207672,1,0,0,0,7,1
215581,1,14,0,14,11,0
395187,2,10,10,0,5,0
90443,2,0,13,-13,7,1
122824,2,10,3,7,4,0
153325,4,2,13,-11,1,0
8726,1,0,0,0,4,0
7798,4,30,9,21,4,1
419978,2,3,0,3,17,0
293114,4,10,27,-17,11,0
174301,1,10,0,10,10,0
389875,1,0,0,0,3,1
136426,2,10,7,3,11,1
175187,4,49,17,32,10,1
65220,4,10,10,0,13,1
249226,2,19,7,12,9,0
413075,2,20,14,6,14,1
300735,2,7,6,1,15,1
22532,4,37,37,0,11,1
26830,1,7,0,7,13,0
241988,2,7,0,7,5,0
386462,1,0,0,0,2,0
29388,1,0,0,0,14,0
126990,2,16,10,6,6,1
67787,4,24,0,24,14,0
312464,1,3,0,3,3,0
49790,2,7,7,0,6,1
149573,3,14,16,-2,16,0
361451,1,7,0,7,7,0
17471,1,0,0,0,9,1
213716,4,24,17,7,10,0
400586,4,13,31,-18,8,1
307364,3,16,22,-6,17,0
99484,3,3,10,-7,11,1
405707,2,10,0,10,10,0
178930,2,6,3,3,12,1
340669,3,16,13,3,15,0
114050,2,14,0,14,17,1
411731,2,0,10,-10,13,1
335517,1,0,0,0,13,1
170135,3,7,10,-3,8,1
179658,5,31,30,1,12,0
65728,2,7,16,-9,13,0
116516,1,0,0,0,2,1
319098,1,0,0,0,5,1
252848,4,9,13,-4,11,0
243961,4,25,20,5,6,1
240876,1,6,0,6,5,1
169609,1,6,0,6,8,0
419120,1,10,0,10,16,1
282573,4,17,24,-7,6,1
181838,2,21,7,14,13,0
395085,3,9,31,-22,5,1
257310,1,3,0,3,13,0
250801,3,3,9,-6,10,1
285506,1,0,0,0,8,0
195215,2,16,3,13,2,0
111727,4,37,16,21,16,0
55198,1,7,0,7,9,0
224723,1,3,0,3,15,0
256919,3,14,21,-7,12,0
303496,4,25,16,9,16,0
15212,3,13,0,13,8,0
125349,4,31,3,28,5,0
72625,2,13,0,13,16,1
245335,4,23,13,10,7,0
215286,1,0,0,0,11,1
254330,3,13,19,-6,11,0
271524,1,0,0,0,2,0
392969,3,9,9,0,4,0
29482,4,10,14,-4,14,1
99019,2,6,0,6,11,1
359631,3,24,7,17,6,1
72581,4,26,31,-5,16,0
318556,2,10,0,10,5,0
39934,4,9,10,-1,1,1
24849,3,13,3,10,12,1
11424,4,26,0,26,6,0
305914,4,21,21,0,17,0
123366,3,21,17,4,4,0
327320,4,16,27,-11,9,1
10526,3,27,0,27,5,1
170797,4,27,13,14,8,1
359182,3,10,21,-11,6,1
406514,2,7,16,-9,11,0
201413,1,6,0,6,5,1
302536,4,3,13,-10,15,1
15889,1,0,7,-7,8,1
258981,2,0,16,-16,13,1
297479,1,0,0,0,13,1
294241,3,13,14,-1,12,1
16610,2,7,14,-7,8,1
267655,2,0,21,-21,17,0
107621,2,13,7,6,15,0
178508,3,16,6,10,12,0
123168,2,3,21,-18,4,1
76259,4,12,27,-15,1,1
122666,1,0,0,0,4,0
378895,3,13,20,-7,15,0
347806,3,10,0,10,1,0
146912,4,41,0,41,15,0
333906,1,0,7,-7,12,1
216923,4,21,24,-3,12,0
19196,4,21,13,8,10,0
241506,1,0,3,-3,5,1
359732,2,17,9,8,6,1
153135,3,20,17,3,1,0
328103,1,0,0,0,10,1
156509,3,7,6,1,2,0
327649,1,0,0,0,10,0
211802,2,0,7,-7,9,1
216492,2,20,8,12,12,1
280365,1,0,0,0,5,1
386898,1,7,7,0,2,1
280727,3,7,6,1,5,1
272473,1,0,0,0,2,1
284418,1,0,6,-6,7,1
119796,3,17,6,11,3,1
321106,1,0,3,-3,6,0
20339,2,10,13,-3,10,0
358996,2,10,0,10,6,0
415524,1,0,0,0,15,1
182473,2,7,0,7,14,1
315726,4,17,22,-5,4,1
37057,2,13,0,13,17,0
416503,3,28,17,11,15,0
328209,4,14,17,-3,10,0
1638,1,0,0,0,1,1
291539,2,3,3,0,11,0
45372,4,20,16,4,4,1
251092,2,10,14,-4,10,0
31447,2,3,7,-4,15,0
385902,2,3,7,-4,1,0
248859,1,0,0,0,9,1
332509,4,23,9,14,12,0
328786,3,17,13,4,10,1
301182,2,13,14,-1,15,1
101187,1,0,7,-7,12,0
417117,4,34,0,34,15,0
174232,3,10,26,-16,10,0
345238,2,13,14,-1,17,0
99331,3,13,3,10,11,1
258467,4,21,21,0,13,1
340149,2,20,7,13,15,0
96112,1,0,12,-12,10,0
121581,4,22,13,9,4,1
366630,4,26,14,12,10,0
89735,4,16,23,-7,7,1
94685,3,24,29,-5,9,0
148598,2,0,6,-6,16,0
403604,2,17,10,7,9,0
368683,2,7,10,-3,11,1
382744,4,9,20,-11,17,0
381068,2,14,6,8,16,0
374610,4,20,20,0,14,1
294886,4,49,21,28,12,0
382906,1,0,7,-7,17,0
341740,4,29,13,16,16,0
322546,1,0,0,0,7,0
288194,1,3,7,-4,9,0
103504,2,13,0,13,13,1
325158,2,13,14,-1,8,0
386761,2,0,0,0,2,1
19954,1,0,3,-3,10,1
419030,3,7,20,-13,16,1
117101,4,7,24,-17,2,0
73603,1,0,0,0,17,0
411278,1,0,3,-3,13,0
86382,1,7,0,7,5,0
83636,1,0,0,0,4,0
234590,1,10,3,7,2,1
107005,1,7,0,7,15,0
281824,3,10,0,10,6,1
135485,1,7,6,1,10,1
91236,4,20,17,3,8,0
363694,3,8,10,-2,8,1
117917,1,0,3,-3,2,1
32799,2,0,0,0,15,1
210088,1,0,0,0,9,0
175936,4,37,27,10,11,0
35183,3,0,14,-14,16,0
349515,1,0,0,0,2,0
167340,3,23,16,7,7,0
50414,2,7,7,0,6,0
268598,2,7,6,1,17,0
73037,2,0,10,-10,16,1
392272,1,0,7,-7,4,1
145158,2,29,0,29,14,1
43389,4,21,17,4,3,0
397341,4,3,24,-21,6,0
262085,1,7,0,7,15,0
133104,1,0,0,0,9,0
141613,1,3,0,3,13,0
381544,3,21,13,8,17,1
314373,4,10,17,-7,3,1
23311,2,6,10,-4,11,0
100366,3,9,20,-11,12,1
364293,3,3,29,-26,9,0
77270,4,16,10,6,1,1
2047,1,0,0,0,1,1
14508,4,34,30,4,7,0
66718,1,0,3,-3,14,1
235486,1,0,0,0,3,1
400169,1,0,0,0,8,1
224744,2,5,0,5,15,0
98610,3,7,7,0,11,0
410201,1,0,0,0,13,1
169082,4,36,17,19,7,1
410024,4,6,42,-36,12,0
297356,2,3,10,-7,13,1
305725,3,9,7,2,17,0
287534,4,14,33,-19,9,0
47246,4,12,9,3,5,1
310830,4,27,13,14,2,0
186201,4,16,13,3,15,0
397664,4,6,30,-24,7,0
7259,3,7,13,-6,4,1
218493,4,31,17,14,13,1
12730,3,52,0,52,6,1
138834,3,3,33,-30,12,1
267043,1,0,0,0,17,1
174641,2,6,0,6,10,0
43140,1,0,0,0,3,1
334084,2,0,0,0,13,1
83999,2,17,3,14,4,0
158797,2,17,3,14,3,1
44642,4,23,24,-1,3,1
301634,3,10,6,4,15,1
308914,4,17,23,-6,1,1
286584,3,17,31,-14,8,0
230884,3,14,10,4,1,0
189510,4,17,0,17,17,1
391727,3,3,10,-7,4,0
146620,1,0,7,-7,15,1
152815,4,14,10,4,17,1
353829,2,7,14,-7,4,0
146266,3,3,30,-27,15,1
299667,1,14,0,14,14,1
419315,3,0,17,-17,16,0
373007,1,0,0,0,13,1
111473,1,7,0,7,16,0
55924,1,0,0,0,9,1
314732,1,14,0,14,4,1
380923,2,6,0,6,16,0
302201,2,21,7,14,15,1
110769,3,3,3,0,16,1
419026,3,7,17,-10,16,0
68733,4,34,7,27,15,0
272965,1,3,0,3,2,0
18727,2,3,7,-4,9,1
156052,4,20,24,-4,2,0
351960,2,21,14,7,3,1
78316,3,17,21,-4,2,1
326374,3,17,10,7,9,1
76435,1,0,0,0,1,0
94779,2,3,3,0,9,0
173785,3,10,3,7,10,0
92238,2,7,0,7,8,1
111009,4,14,22,-8,16,1
144853,2,14,0,14,14,1
146032,1,10,0,10,15,0
315208,3,16,10,6,4,1
262557,1,7,0,7,15,1
124320,4,34,20,14,5,0
313036,4,20,0,20,3,0
136068,1,0,0,0,10,0
77549,3,20,14,6,1,1
230134,2,3,16,-13,17,1
15201,2,6,0,6,8,0
108849,3,7,10,-3,15,0
36150,1,0,0,0,17,0
209918,4,37,16,21,8,0
237142,4,14,40,-26,3,1
289238,4,30,20,10,9,1
49196,2,17,0,17,6,0
111629,2,14,10,4,16,0
121377,3,7,3,4,3,0
256832,1,0,0,0,12,1
400708,4,16,10,6,8,1
415415,2,9,0,9,15,1
331480,3,9,23,-14,11,1
48371,1,0,10,-10,5,1
202636,4,27,20,7,5,0
188055,1,0,0,0,16,0
110496,3,20,6,14,16,1
372018,3,13,0,13,13,0
101895,3,6,13,-7,12,0
102960,3,12,31,-19,13,1
392710,4,16,6,10,4,1
87659,1,0,7,-7,6,0
378920,4,13,30,-17,15,1
339374,1,0,3,-3,15,1
400814,2,14,13,1,8,1
224710,1,0,0,0,15,1
87119,2,7,9,-2,5,0
396315,4,6,13,-7,6,1
407858,2,3,7,-4,11,1
187920,1,0,7,-7,16,1
122817,1,7,3,4,4,1
235655,1,0,3,-3,3,0
17234,3,7,34,-27,9,1
259802,4,20,20,0,14,1
70358,4,16,33,-17,15,1
65991,1,0,0,0,13,1
85062,3,31,16,15,4,1
15521,4,23,6,17,8,0
275057,4,34,20,14,3,1
48647,1,0,0,0,5,1
34885,3,20,7,13,16,0
158079,3,22,9,13,3,1
57269,1,0,0,0,10,1
283367,1,0,0,0,7,1
362666,3,3,7,-4,8,1
270205,1,3,7,-4,1,0
344603,1,0,0,0,17,0
128198,2,14,7,7,7,1
248439,2,10,6,4,8,1
17187,2,7,14,-7,9,0
206227,2,0,3,-3,7,0
14560,1,0,0,0,7,0
83430,4,10,23,-13,4,0
33256,3,10,0,10,16,1
140201,4,13,10,3,12,0
226660,4,17,13,4,16,1
255421,4,24,6,18,12,0
75429,2,10,7,3,17,1
233227,1,0,0,0,2,1
92849,2,21,0,21,8,1
358764,4,14,17,-3,6,0
314981,4,0,20,-20,4,0
303810,4,20,17,3,16,0
127137,2,10,9,1,6,1
1767,1,0,0,0,1,1
21347,4,14,24,-10,11,1
132091,1,7,0,7,9,1
7333,5,20,19,1,4,0
99132,1,0,0,0,11,0
117544,4,17,20,-3,2,1
333520,2,13,0,13,12,0
103307,1,0,3,-3,13,1
172168,1,0,0,0,9,1
53852,2,0,0,0,8,1
31968,4,16,13,3,15,0
8551,4,22,10,12,4,1
352983,3,13,10,3,3,1
363503,2,0,2,-2,8,1
218258,1,0,7,-7,12,1
175247,2,15,0,15,10,1
24710,3,20,14,6,12,0
116810,4,41,33,8,2,0
285147,4,3,0,3,7,0
101374,2,6,0,6,12,0
335131,2,10,0,10,13,1
57577,1,3,0,3,10,1
294522,3,17,13,4,12,1
318772,4,17,26,-9,5,1
4702,4,23,27,-4,2,1
105023,1,0,7,-7,14,0
303230,1,0,0,0,16,1
48919,4,15,13,2,5,1
240103,1,6,0,6,5,0
70266,2,7,7,0,15,1
122020,4,16,13,3,4,1
283529,1,6,7,-1,7,1
20064,4,19,16,3,10,1
176418,4,22,28,-6,11,1
355188,4,29,26,3,4,1
164057,2,3,3,0,5,0
366858,3,3,6,-3,10,0
245855,2,3,20,-17,7,0
417660,3,21,6,15,16,0
316754,2,10,0,10,4,0
138785,2,0,7,-7,12,1
330653,2,6,0,6,11,0
299329,4,26,16,10,14,1
345621,4,24,23,1,17,0
127474,3,3,10,-7,6,0
278148,2,13,14,-1,4,1
368175,4,21,21,0,11,1
299280,2,23,7,16,14,1
149884,4,6,16,-10,16,0
375658,3,17,20,-3,14,1
167769,5,26,26,0,7,0
187119,3,10,0,10,16,1
384976,2,14,6,8,1,1
242826,4,21,34,-13,6,1
59388,4,0,16,-16,11,1
291011,4,20,13,7,10,1
352615,1,0,0,0,3,0
324591,3,16,9,7,8,1
327077,1,0,0,0,9,1
46908,3,13,20,-7,5,1
421906,4,21,26,-5,17,1
411405,1,0,0,0,13,0
923,2,0,0,0,1,0
21738,3,24,14,10,11,0
406377,2,10,7,3,11,0
140513,4,21,29,-8,12,1
331462,3,9,7,2,11,0
259848,1,7,7,0,14,1
235290,4,25,6,19,3,0
183541,2,7,10,-3,14,0
308729,3,10,13,-3,1,0
184229,2,17,0,17,14,0
323103,4,26,14,12,7,0
310847,1,0,0,0,2,1
165636,2,0,0,0,6,1
130864,4,20,15,5,8,1
362331,2,10,7,3,8,0
190693,3,28,17,11,17,1
373764,4,19,21,-2,13,1
362258,4,15,24,-9,8,1
43795,2,14,13,1,3,1
197975,2,0,10,-10,3,0
341943,1,6,0,6,16,0
152901,2,7,7,0,1,0
77088,2,7,17,-10,1,1
379031,2,7,6,1,15,0
239136,2,13,10,3,4,0
262220,1,0,0,0,15,1
12144,4,14,21,-7,6,1
79056,4,10,14,-4,2,1
1294,4,24,23,1,1,1
188780,4,0,20,-20,16,1
25657,2,7,0,7,12,0
383566,3,21,13,8,17,1
246221,3,21,16,5,7,1
118518,2,17,0,17,2,1
93627,4,13,6,7,9,1
150991,1,0,0,0,17,1
191571,4,14,24,-10,17,1
285907,2,20,0,20,8,0
187965,2,6,14,-8,16,1
45128,2,7,7,0,4,1
17806,2,7,3,4,9,1
240994,4,27,22,5,5,1
267580,4,27,27,0,17,0
387659,1,0,7,-7,2,0
382523,2,0,3,-3,17,0
10162,2,6,0,6,5,0
198605,2,0,0,0,3,0
2387,2,14,10,4,2,0
6897,1,0,0,0,3,1
243330,4,14,30,-16,6,1
88407,1,0,0,0,6,0
290831,3,10,14,-4,10,1
146101,3,22,10,12,15,0
261404,3,10,17,-7,14,0
240717,1,0,0,0,5,0
132149,3,10,3,7,9,0
123500,2,7,0,7,4,0
217416,1,3,0,3,12,0
339278,2,24,0,24,15,1
271039,4,18,28,-10,1,1
335873,3,21,14,7,13,1
246618,2,14,3,11,8,1
107327,2,3,3,0,15,0
398156,1,7,3,4,7,1
301400,4,17,16,1,15,0
311439,1,0,3,-3,2,0
363011,4,33,26,7,8,0
365761,3,17,17,0,9,1
96486,3,17,17,0,10,0
70035,4,31,10,21,15,0
405419,2,14,10,4,10,1
136908,2,0,13,-13,11,1
140945,4,20,13,7,13,1
231365,4,9,16,-7,1,0
347742,1,0,0,0,1,1
111037,1,7,0,7,16,1
191095,2,7,10,-3,17,0
286476,4,20,13,7,8,1
304051,2,3,20,-17,16,1
191411,3,0,31,-31,17,1
114656,2,3,10,-7,1,1
28519,2,24,7,17,14,1
405061,1,0,3,-3,10,0
340231,4,29,31,-2,15,1
295637,1,0,0,0,12,0
221914,3,19,10,9,14,0
148098,4,14,10,4,15,1
311325,2,14,0,14,2,0
319790,2,14,7,7,6,0
151954,3,27,24,3,17,1
415286,2,0,7,-7,15,0
171152,2,3,0,3,8,0
390659,2,3,3,0,3,0
313498,4,17,17,0,3,1
200744,2,24,0,24,4,0
230616,4,16,24,-8,1,1
315366,2,13,16,-3,4,0
242929,3,21,16,5,6,1
236615,1,0,0,0,3,1
370215,4,31,10,21,12,0
263094,4,10,13,-3,15,0
134049,2,20,3,17,9,1
339706,2,7,6,1,15,1
21505,1,0,0,0,11,1
414666,2,0,7,-7,14,1
344913,1,3,7,-4,17,1
112304,4,38,17,21,17,1
16230,2,3,3,0,8,0
990,4,0,6,-6,1,0
53566,3,14,12,2,8,1
213552,3,10,14,-4,10,0
30665,1,0,0,0,15,1
199352,2,0,3,-3,4,0
348182,1,6,7,-1,1,0
118221,1,9,0,9,2,1
27313,2,14,3,11,13,0
50839,2,7,14,-7,6,0
118339,1,0,0,0,2,1
42816,3,6,28,-22,3,1
31068,4,13,13,0,15,1
91855,4,24,13,11,8,1
268104,1,3,7,-4,17,0
375736,1,3,0,3,14,1
152596,1,0,0,0,17,0
43016,1,0,0,0,3,1
208240,4,13,10,3,8,0
55203,1,7,0,7,9,1
211772,1,0,7,-7,9,0
83302,4,22,17,5,4,0
392924,2,3,3,0,4,1
342796,4,7,14,-7,16,1
271736,2,13,10,3,2,0
201622,2,7,10,-3,5,0
312014,1,0,0,0,2,1
368702,2,7,16,-9,11,0
97367,2,9,6,3,10,0
48217,1,0,3,-3,5,1
210188,3,7,14,-7,9,0
245493,1,0,0,0,7,1
238741,4,19,20,-1,4,1
351859,4,27,14,13,3,0
153618,4,12,14,-2,1,1
227193,4,13,16,-3,16,0
63689,1,0,0,0,12,1
86971,2,14,3,11,5,0
357925,1,0,6,-6,6,0
35969,4,3,7,-4,17,0
279069,2,14,0,14,5,0
95720,3,13,9,4,10,0
163695,1,0,6,-6,5,0
232452,1,3,0,3,1,0
75021,4,34,17,17,17,1
233754,3,13,24,-11,2,0
378056,4,0,14,-14,15,0
243910,3,16,6,10,6,1
11282,4,17,28,-11,6,0
414313,4,21,42,-21,14,1
344382,2,21,14,7,17,0
9649,3,12,21,-9,5,1
84719,2,10,14,-4,4,1
66180,2,17,3,14,13,1
301597,2,7,3,4,15,1
418713,2,0,7,-7,16,1
344992,4,10,23,-13,17,0
108152,4,20,42,-22,15,1
215594,2,14,3,11,11,0
129215,2,14,6,8,7,1
86596,3,33,3,30,5,1
298390,2,7,14,-7,14,1
82391,4,13,10,3,3,0
410957,4,21,29,-8,13,1
274173,1,0,0,0,3,0
5742,1,0,0,0,3,1
126343,2,7,14,-7,6,0
15618,2,14,10,4,8,1
46002,1,0,7,-7,4,1
309363,1,0,0,0,1,1
346456,1,0,0,0,1,1
161714,2,10,3,7,4,1
294008,1,0,0,0,12,1
316284,3,10,16,-6,4,1
131071,2,10,6,4,8,1
70825,1,7,0,7,15,0
278958,3,7,23,-16,5,0
409918,1,0,0,0,12,0
354596,1,0,7,-7,4,1
287623,2,3,3,0,9,0
417871,3,13,10,3,16,1
171548,4,30,10,20,9,1
202712,2,6,10,-4,5,0
141266,4,10,24,-14,13,1
155299,4,28,27,1,1,0
116180,3,14,13,1,1,0
210648,4,13,24,-11,9,1
66521,4,28,24,4,14,1
228738,4,26,33,-7,17,0
271593,3,10,20,-10,2,1
23146,1,12,0,12,11,1
242859,1,7,3,4,6,0
222628,2,7,7,0,14,0
90636,3,17,30,-13,7,0
219871,4,51,0,51,13,0
409501,2,0,0,0,12,0
99476,2,0,10,-10,11,1
195681,3,7,10,-3,2,1
8608,2,7,10,-3,4,0
318677,1,0,13,-13,5,1
98259,2,7,24,-17,11,1
192576,1,0,0,0,1,1
37830,4,14,9,5,1,1
5762,2,14,0,14,3,0
63151,2,14,10,4,12,0
378929,4,16,30,-14,15,1
239286,3,3,7,-4,4,1
104744,2,17,13,4,14,0
224749,2,5,0,5,15,0
233767,3,13,27,-14,2,0
383231,2,21,3,18,17,1
95578,3,9,10,-1,10,1
140259,1,0,0,0,12,1
399008,1,7,9,-2,7,1
346536,3,24,33,-9,1,0
331651,4,31,33,-2,11,0
329708,4,40,17,23,11,0
268301,2,17,3,14,17,0
270352,1,0,0,0,1,0
157879,2,6,15,-9,3,0
382730,4,9,19,-10,17,0
274967,1,7,0,7,3,0
282601,1,0,6,-6,6,0
311737,1,0,3,-3,2,0
88021,2,17,0,17,6,1
36199,2,10,17,-7,17,1
95068,1,0,7,-7,9,0
340262,4,29,34,-5,15,1
219033,3,24,0,24,13,0
220594,4,16,26,-10,13,0
30579,2,10,0,10,14,0
116311,3,17,13,4,1,1
341432,4,0,13,-13,16,0
297730,4,24,20,4,13,0
231863,2,6,20,-14,1,1
22845,1,0,7,-7,11,1
140755,3,15,14,1,12,0
931,2,0,0,0,1,1
294435,4,19,12,7,12,0
408030,2,10,7,3,12,0
228728,4,26,30,-4,17,0
365958,1,0,0,0,10,0
337048,3,19,0,19,14,0
144373,2,0,3,-3,14,0
316145,3,24,26,-2,4,1
123930,2,6,0,6,5,1
216307,2,7,7,0,12,1
369127,2,13,7,6,11,0
303964,4,14,34,-20,16,0
324791,4,33,14,19,8,1
304098,4,13,23,-10,16,0
106736,2,14,12,2,14,0
303173,4,24,28,-4,16,0
242595,2,9,0,9,6,1
189625,3,10,6,4,17,1
399335,2,21,7,14,7,1
113948,4,20,10,10,17,0
300882,2,3,7,-4,15,1
66304,2,0,7,-7,14,0
210180,3,7,14,-7,9,0
250874,4,10,18,-8,10,1
345997,1,0,3,-3,1,1
38480,1,7,3,4,1,0
181103,3,23,7,16,13,1
377246,2,7,3,4,15,1
248037,3,31,13,18,8,0
53410,3,3,21,-18,8,1
342893,3,16,14,2,16,0
327767,4,16,23,-7,10,0
227757,3,3,14,-11,16,0
171216,4,9,14,-5,8,0
329736,1,3,0,3,11,1
180713,1,0,0,0,13,0
288759,4,3,10,-7,9,0
27518,3,23,9,14,13,0
86980,2,14,6,8,5,1
214810,4,10,27,-17,11,0
287246,4,23,23,0,8,0
364576,3,15,28,-13,9,1
326348,2,13,10,3,9,1
309324,4,3,23,-20,1,1
176719,4,36,19,17,11,0
376947,2,3,13,-10,15,1
78509,1,0,0,0,2,0
165251,3,17,7,10,6,0
326625,2,10,6,4,9,0
11081,2,10,10,0,5,0
243767,3,17,17,0,6,0
339678,1,7,0,7,15,1
318374,1,0,0,0,5,1
148772,2,13,13,0,16,1
388811,4,14,7,7,3,0
211846,3,22,10,12,9,1
221750,3,10,7,3,14,0
373481,1,0,10,-10,13,1
303126,3,7,14,-7,16,0
287495,3,14,20,-6,9,0
149714,3,27,0,27,16,1
147880,3,3,31,-28,15,1
249371,2,10,12,-2,9,0
151919,3,20,10,10,17,0
396574,3,17,10,7,6,0
194406,1,3,0,3,2,0
78276,2,3,14,-11,2,0
345202,1,7,7,0,17,1
339408,2,7,3,4,15,0
29143,3,0,19,-19,14,1
285118,3,3,0,3,7,1
19738,3,9,9,0,10,0
377158,4,13,10,3,15,0
172695,2,14,3,11,9,0
398475,2,7,6,1,7,1
39733,3,9,0,9,1,1
89738,4,16,23,-7,7,0
54727,1,0,0,0,8,0
36497,2,10,6,4,17,0
5171,1,0,0,0,3,0
303053,1,0,0,0,16,0
352172,4,15,27,-12,3,1
248156,2,3,10,-7,8,1
162090,3,35,13,22,4,1
126901,4,17,14,3,6,1
230342,4,19,17,2,17,0
240465,2,3,7,-4,5,0
384427,2,21,0,21,1,0
150821,1,0,0,0,17,0
84730,2,10,14,-4,4,0
356279,1,7,0,7,5,0
188895,3,10,10,0,16,0
284484,3,14,15,-1,7,1
377325,4,24,14,10,15,1
218613,3,7,23,-16,13,1
154112,2,0,6,-6,1,0
77348,2,7,7,0,1,1
356753,4,29,31,-2,5,1
40565,2,10,6,4,2,0
167554,4,3,10,-7,7,0
290807,2,10,7,3,10,1
197610,3,19,0,19,3,1
114872,4,16,33,-17,1,0
130727,1,0,0,0,8,0
127107,1,3,9,-6,6,1
184564,4,42,21,21,14,1
291214,1,7,0,7,10,0
263056,3,10,3,7,15,0
103240,3,3,10,-7,13,0
123072,4,14,21,-7,4,1
16391,3,21,13,8,8,0
186967,3,10,12,-2,15,0
156498,3,0,6,-6,2,1
177073,2,10,3,7,11,0
152983,3,35,17,18,1,1
39630,4,27,6,21,1,0
10753,2,7,0,7,5,0
379182,3,9,10,-1,16,0
381645,2,10,0,10,17,0
187621,1,0,0,0,16,1
138329,3,20,0,20,11,1
187290,4,10,13,-3,16,1
231182,3,10,7,3,1,1
104972,4,17,22,-5,14,0
382522,2,0,3,-3,17,0
83245,3,9,7,2,4,0
294831,3,35,21,14,12,0
64052,3,20,17,3,13,1
190798,2,13,3,10,17,0
7652,4,34,3,31,4,0
222937,2,13,13,0,14,0
276829,3,20,20,0,4,1
399992,4,12,13,-1,8,0
29005,3,7,7,0,14,1
149749,4,48,0,48,16,1
99548,4,10,17,-7,11,0
28216,2,10,0,10,13,1
223051,2,14,7,7,14,0
87642,1,0,0,0,6,0
90122,2,0,0,0,7,1
24239,3,13,17,-4,12,1
334637,1,0,0,0,13,0
152643,2,7,6,1,17,1
357748,4,43,19,24,5,1
310250,1,3,0,3,2,0
407797,4,17,7,10,11,0
117807,2,6,6,0,2,1
42119,4,27,27,0,2,1
33455,4,23,20,3,16,0
10261,4,13,10,3,5,0
298183,1,0,3,-3,14,0
102224,4,24,14,10,13,0
350257,1,0,0,0,2,1
39405,2,3,3,0,1,0
345952,4,27,23,4,17,0
1092,3,10,29,-19,1,0
359444,2,0,14,-14,6,1
92091,2,3,10,-7,8,0
121792,1,0,0,0,4,1
264246,2,10,10,0,15,1
338544,3,20,31,-11,14,1
65212,4,10,10,0,13,1
365912,4,14,21,-7,9,0
7086,2,21,14,7,4,0
386285,4,14,20,-6,2,1
314564,1,0,0,0,3,1
236443,1,0,0,0,3,1
172686,2,14,3,11,9,0
12748,4,59,0,59,6,0
374257,2,7,9,-2,13,0
414657,1,0,0,0,14,1
125978,4,23,23,0,6,0
277634,4,27,28,-1,4,1
253418,3,14,28,-14,11,0
274742,4,24,12,12,3,0
324625,4,16,15,1,8,1
340575,1,0,0,0,15,1
118996,3,0,23,-23,3,1
359031,3,10,3,7,6,0
224200,4,0,23,-23,15,0
96914,3,22,7,15,10,0
86113,2,28,3,25,5,0
47462,1,3,0,3,5,1
415092,1,0,7,-7,15,1
9015,2,7,7,0,4,0
217226,4,12,22,-10,12,1
277279,3,0,16,-16,4,1
366612,4,26,14,12,10,0
116163,3,7,10,-3,1,0
135606,1,0,0,0,10,1
135005,4,14,34,-20,10,1
290998,3,20,13,7,10,0
162455,1,7,3,4,4,1
61414,3,13,3,10,11,1
390023,1,0,0,0,3,0
229262,2,16,14,2,17,1
337478,2,7,9,-2,14,0
214793,4,10,26,-16,11,0
270002,4,19,20,-1,1,0
390748,4,13,20,-7,3,1
365558,2,14,14,0,9,1
208332,2,14,24,-10,8,1
195307,1,0,0,0,2,1
244111,4,20,34,-14,6,0
362124,4,35,23,12,8,1
18020,4,16,21,-5,9,0
373877,3,27,10,17,13,1
139538,2,6,0,6,12,1
223151,4,43,30,13,14,0
184553,4,35,14,21,14,1
174574,4,13,14,-1,10,0
302425,1,0,0,0,15,0
206941,4,24,23,1,7,0
79872,2,3,13,-10,2,1
320408,2,14,0,14,6,0
182545,4,42,21,21,14,0
405398,2,7,10,-3,10,0
67514,4,39,14,25,14,0
406575,4,20,37,-17,11,0
291621,4,23,13,10,11,0
70145,2,20,7,13,15,0
411898,2,14,3,11,13,1
149493,1,7,6,1,16,0
65139,2,0,0,0,13,0
276743,1,7,0,7,4,1
176128,1,14,7,7,11,0
76143,1,9,3,6,1,0
241560,2,3,10,-7,5,0
13581,2,3,7,-4,7,1
348632,1,0,0,0,2,0
308334,1,0,3,-3,1,1
237351,2,0,7,-7,3,1
201487,3,19,7,12,5,1
372624,2,14,6,8,13,0
42385,3,14,16,-2,2,1
262005,3,24,17,7,14,0
71773,3,38,30,8,16,0
111134,4,31,10,21,16,0
303752,2,17,10,7,16,0
226642,4,10,12,-2,16,0
337525,3,7,19,-12,14,0
419074,4,13,20,-7,16,0
379289,2,0,3,-3,16,1
338564,4,23,31,-8,14,1
123054,4,7,13,-6,4,1
205327,2,20,0,20,6,1
7346,5,20,19,1,4,0
276605,2,7,3,4,4,0
157178,4,25,20,5,2,1
7914,3,3,20,-17,4,1
409664,2,10,3,7,12,1
26940,4,13,6,7,13,1
596,1,0,0,0,1,1
150265,1,7,0,7,16,1
44690,1,0,9,-9,3,0
179548,2,0,23,-23,12,1
108463,1,0,0,0,15,0
54562,4,21,18,3,8,1
322890,1,6,0,6,7,1
179017,4,19,3,16,12,1
59841,4,15,16,-1,11,1
177386,2,17,7,10,11,0
148432,2,7,0,7,16,0
179592,3,14,23,-9,12,1
79407,1,3,0,3,2,1
205258,4,23,20,3,6,1
158052,2,15,6,9,3,0
278293,2,13,0,13,4,1
181524,1,3,0,3,13,1
12523,2,0,17,-17,6,0
241984,2,7,0,7,5,1
25914,4,38,17,21,12,1
329271,4,31,13,18,10,0
94719,4,38,43,-5,9,1
25854,2,24,10,14,12,0
208083,4,21,19,2,8,1
355971,1,0,7,-7,5,0
227409,1,0,7,-7,16,1
254890,2,14,7,7,12,0
206605,3,10,13,-3,7,0
146024,1,10,0,10,15,0
119619,3,10,9,1,3,1
180727,1,0,0,0,13,0
81886,3,0,27,-27,3,0
270540,2,10,7,3,1,0
138880,4,12,47,-35,12,1
25442,4,13,17,-4,12,1
332920,3,24,3,21,12,1
148649,4,10,9,1,16,1
361023,2,9,2,7,7,1
378055,4,0,14,-14,15,1
106506,4,36,9,27,14,0
237813,2,0,13,-13,4,1
402488,4,26,15,11,9,1
303870,1,0,7,-7,16,1
169281,4,23,6,17,7,0
154486,4,14,10,4,1,0
354862,4,33,42,-9,4,1
69969,2,21,0,21,15,1
224443,2,9,10,-1,15,0
207645,4,42,10,32,7,0
98127,2,21,10,11,11,0
420081,4,31,21,10,17,0
155723,3,13,20,-7,2,1
49613,1,0,7,-7,6,1
325513,4,22,13,9,8,0
329873,1,0,0,0,11,0
105770,1,0,0,0,14,0
271901,2,7,13,-6,2,1
300079,4,7,40,-33,14,1
197710,2,7,10,-3,3,1
235431,3,28,25,3,3,1
214305,4,14,10,4,11,1
167542,3,0,10,-10,7,1
390822,2,0,14,-14,3,1
255856,4,20,7,13,12,1
221627,4,20,21,-1,14,1
363769,1,0,0,0,8,0
169630,2,13,0,13,8,1
205288,1,9,0,9,6,1
134679,4,34,31,3,10,1
169369,3,6,14,-8,8,1
220192,1,7,0,7,13,0
416592,2,7,0,7,15,0
25892,4,31,17,14,12,0
140143,3,10,3,7,12,0
142425,2,7,10,-3,13,1
191804,1,3,7,-4,1,1
205734,4,27,25,2,7,0
231472,3,10,12,-2,1,1
27891,1,0,0,0,13,0
263997,4,30,7,23,15,0
33985,3,10,27,-17,16,0
83567,3,0,17,-17,4,0
183884,4,51,28,23,14,0
270337,5,27,27,0,1,1
24605,4,10,26,-16,12,0
155183,1,7,7,0,1,1
210533,1,0,0,0,9,1
199185,1,7,0,7,4,0
25028,4,16,21,-5,12,0
213807,2,35,0,35,10,0
407811,1,0,0,0,11,1
17796,2,7,3,4,9,0
402104,2,6,0,6,9,1
347323,4,7,21,-14,1,0
347502,3,12,23,-11,1,1
172731,3,14,10,4,9,1
113385,1,0,0,0,17,1
387230,2,6,7,-1,2,1
404376,4,20,6,14,10,1
239852,2,7,3,4,4,1
252272,1,0,10,-10,10,1
155455,4,13,10,3,2,0
144957,1,0,0,0,14,1
268051,4,21,9,12,17,1
387952,1,3,0,3,2,1
218220,4,37,3,34,12,0
178979,3,12,3,9,12,0
205483,2,14,3,11,6,1
69536,1,0,0,0,15,1
279110,3,21,17,4,5,1
69605,3,7,17,-10,15,1
13339,3,7,27,-20,7,1
242984,5,34,34,0,6,1
220574,3,10,23,-13,13,0
204100,2,3,10,-7,6,0
208361,3,17,27,-10,8,1
296243,4,28,26,2,13,0
98860,2,7,6,1,11,0
386601,1,0,7,-7,2,0
364578,3,15,28,-13,9,1
11766,1,0,0,0,6,1
289886,2,6,3,3,10,1
308831,2,3,10,-7,1,1
88951,3,26,3,23,6,0
245091,1,14,3,11,7,0
183809,2,17,21,-4,14,0
56074,1,7,0,7,9,0
276415,4,32,44,-12,3,1
135316,1,0,7,-7,10,0
315578,4,7,14,-7,4,1
332885,2,17,0,17,12,1
210412,1,9,0,9,9,0
29842,2,6,10,-4,14,0
203350,3,14,27,-13,6,0
47556,3,37,6,31,5,0
295327,1,0,0,0,12,0
313996,1,0,0,0,3,1
248253,1,0,0,0,8,1
32089,3,14,13,1,15,0
226352,4,25,7,18,16,0
138334,3,27,0,27,11,0
245016,3,14,27,-13,7,0
244173,1,7,7,0,6,0
389924,2,15,10,5,3,1
240816,4,26,10,16,5,0
162444,1,7,0,7,4,0
184605,1,7,3,4,15,0
87279,3,17,17,0,6,1
278235,4,34,21,13,4,0
227269,2,3,13,-10,16,0
277399,3,24,9,15,4,0
195871,4,27,21,6,2,1
414525,2,14,3,11,14,0
209176,1,0,7,-7,8,1
390550,3,17,7,10,3,0
238962,2,14,9,5,4,0
254070,4,14,23,-9,11,0
96230,4,3,22,-19,10,0
160163,2,24,7,17,3,0
60139,4,27,19,8,11,1
354297,1,7,0,7,4,1
71837,1,7,0,7,16,1
283115,2,3,0,3,7,0
127782,3,10,21,-11,6,0
323936,2,10,7,3,8,0
52389,3,9,17,-8,7,0
410616,4,17,17,0,13,0
31361,3,7,3,4,15,0
68581,4,20,28,-8,14,0
318009,4,17,13,4,5,0
363978,3,3,9,-6,8,1
123283,1,7,0,7,4,0
311648,3,6,6,0,2,1
202507,1,0,0,0,5,0
37204,2,3,7,-4,17,0
192854,4,10,15,-5,1,0
250568,4,19,22,-3,9,0
394723,2,14,0,14,5,0
281257,1,6,0,6,6,1
290217,2,17,0,17,10,0
57891,1,10,3,7,10,0
339935,4,33,7,26,15,1
72505,3,13,17,-4,16,0
219954,2,6,14,-8,13,1
81428,4,10,13,-3,3,1
16876,1,6,7,-1,8,1
120116,3,10,3,7,3,0
290584,4,26,20,6,10,0
333663,2,7,0,7,12,1
124071,2,0,14,-14,5,1
152393,3,28,3,25,17,1
210539,1,0,0,0,9,0
325545,4,28,19,9,8,0
175919,4,23,27,-4,11,1
319329,3,13,18,-5,6,0
19065,4,10,6,4,10,1
351637,2,0,7,-7,3,1
168344,4,24,24,0,7,1
295617,4,34,32,2,12,0
46891,2,13,6,7,5,0
126470,1,0,6,-6,6,1
132298,3,24,14,10,9,0
379021,2,7,6,1,15,0
102305,2,10,10,0,13,1
338900,4,13,25,-12,15,0
108506,2,14,7,7,15,0
393139,4,24,3,21,4,1
38923,2,10,0,10,1,1
121045,3,11,24,-13,3,1
134587,2,17,3,14,10,0
192686,4,19,7,12,1,1
119091,2,7,7,0,3,1
155897,4,17,13,4,2,1
338396,3,24,10,14,14,0
144432,3,3,13,-10,14,0
195660,2,7,7,0,2,0
176555,4,19,17,2,11,1
63219,4,17,23,-6,12,0
240467,2,3,7,-4,5,0
400784,2,14,7,7,8,1
239858,2,10,3,7,4,0
101441,4,18,7,11,12,0
293107,4,10,27,-17,11,1
285154,4,3,3,0,7,1
79464,3,12,14,-2,2,0
126930,1,0,0,0,6,1
374751,4,0,39,-39,14,1
239499,1,0,0,0,4,0
73632,2,3,0,3,17,0
33059,1,3,0,3,16,0
182128,2,16,0,16,13,0
297279,4,24,6,18,13,0
78933,4,20,17,3,2,0
84534,1,0,0,0,4,1
366843,2,3,3,0,10,0
347236,1,0,0,0,1,0
87544,2,17,3,14,6,1
382656,2,0,0,0,17,1
306915,3,6,23,-17,17,0
236091,4,51,10,41,3,0
169055,3,26,14,12,7,0
369038,4,13,13,0,11,1
387687,2,0,7,-7,2,0
404101,4,13,49,-36,10,0
222681,3,14,24,-10,14,0
366291,3,28,10,18,10,1
263224,4,17,17,0,15,0
105006,1,0,0,0,14,0
262771,3,28,17,11,15,1
216101,4,24,26,-2,11,1
179580,3,7,23,-16,12,1
288739,4,0,7,-7,9,0
80804,3,3,0,3,3,0
311364,3,21,10,11,2,0
37248,3,13,14,-1,17,0
333419,4,23,13,10,12,0
230567,2,10,10,0,1,1
336337,4,20,13,7,13,1
93092,5,20,20,0,8,1
324732,3,16,7,9,8,1
306523,4,17,17,0,17,0
262736,2,21,0,21,15,0
402462,3,24,15,9,9,0
347858,4,16,8,8,1,1
399119,4,18,36,-18,7,1
207532,1,7,0,7,7,0
178808,3,24,14,10,12,0
190929,2,6,0,6,17,1
83571,3,0,17,-17,4,1
248636,3,14,10,4,9,1
178389,4,31,27,4,12,0
11383,3,23,0,23,6,0
148842,4,16,23,-7,16,1
3862,1,16,0,16,2,1
383113,3,20,14,6,17,1
360836,4,31,37,-6,7,0
323279,4,7,24,-17,7,1
129000,4,35,10,25,7,0
21703,2,10,7,3,11,0
38278,4,13,14,-1,1,1
3165,3,13,9,4,2,0
77865,4,17,28,-11,1,0
325641,3,17,7,10,9,1
3242,1,0,0,0,2,1
173992,1,0,6,-6,10,1
200941,4,40,14,26,4,0
401077,2,21,3,18,8,0
369029,4,13,7,6,11,0
369343,4,21,20,1,11,1
139900,1,0,0,0,12,0
200872,2,14,0,14,4,0
371805,4,24,17,7,12,1
58095,2,10,10,0,10,0
298941,2,3,9,-6,14,1
5845,4,27,7,20,3,0
350501,4,10,19,-9,2,1
128206,2,14,7,7,7,1
218382,1,0,0,0,13,0
249133,4,28,28,0,9,0
74528,3,0,3,-3,17,0
418814,1,0,0,0,16,0
336583,3,7,0,7,14,1
119588,2,10,3,7,3,1
90460,3,0,13,-13,7,0
59895,1,3,0,3,11,0
70091,1,3,0,3,15,0
139495,1,0,0,0,12,1
12223,2,0,0,0,6,0
27210,3,19,7,12,13,1
140421,1,7,7,0,12,0
158058,3,15,9,6,3,1
239337,4,3,17,-14,4,1
346503,2,17,17,0,1,0
365997,2,23,7,16,10,0
136665,4,22,19,3,11,1
34922,4,27,24,3,16,0
118797,2,10,0,10,2,1
413025,4,19,18,1,14,0
115606,4,30,9,21,1,0
168628,4,17,16,1,7,1
202602,3,21,13,8,5,1
89189,2,0,0,0,7,1
222743,1,3,0,3,14,1
247193,1,0,0,0,8,1
48730,3,10,19,-9,5,0
344732,4,6,34,-28,17,1
405508,4,24,16,8,10,0
409920,1,0,7,-7,12,1
146578,4,14,30,-16,15,0
340195,3,23,21,2,15,0
302629,2,17,3,14,15,0
318302,3,9,7,2,5,0
80158,2,7,7,0,2,1
47449,1,3,0,3,5,0
413040,1,0,0,0,14,1
353723,3,10,17,-7,4,0
227112,1,0,0,0,16,0
31878,1,6,0,6,15,1
176315,2,7,14,-7,11,0
58489,4,48,29,19,10,1
127448,2,3,7,-4,6,1
315402,3,16,23,-7,4,0
200618,3,27,21,6,4,1
53698,2,6,0,6,8,1
107367,4,19,6,13,15,0
358423,3,22,13,9,6,1
366241,2,7,3,4,10,1
48416,3,10,17,-7,5,1
340460,1,0,13,-13,15,1
326857,4,10,20,-10,9,0
270974,2,0,7,-7,1,0
143733,1,0,0,0,14,0
99407,1,0,0,0,11,0
279023,4,13,33,-20,5,1
79609,3,14,7,7,2,1
49973,3,21,7,14,6,1
172717,3,14,10,4,9,0
401423,3,17,7,10,8,0
390704,3,6,10,-4,3,1
420142,2,0,3,-3,17,0
117418,1,0,0,0,2,1
110690,4,23,17,6,16,1
4326,2,0,7,-7,2,1
250922,2,3,3,0,10,0
302107,3,27,27,0,15,0
6399,3,9,13,-4,3,0
339090,2,3,0,3,15,0
120883,3,14,24,-10,3,1
18903,4,9,13,-4,9,1
225163,1,3,0,3,15,0
187851,3,7,20,-13,16,0
35271,1,3,0,3,16,0
261588,4,12,15,-3,14,0
143954,3,0,10,-10,14,1
160311,2,3,14,-11,4,1
309833,2,14,7,7,1,0
348049,2,0,10,-10,1,1
211362,3,10,10,0,9,1
52638,1,3,7,-4,7,1
85075,4,31,16,15,4,1
265464,2,7,7,0,16,0
31676,4,24,16,8,15,0
147719,3,17,16,1,15,0
406565,4,20,30,-10,11,0
181342,1,7,0,7,13,1
27384,4,24,10,14,13,0
24947,2,10,13,-3,12,0
287026,2,13,21,-8,8,1
90424,2,0,13,-13,7,0
269772,2,7,0,7,1,1
135904,5,24,24,0,10,0
172549,2,7,21,-14,9,0
49640,2,0,7,-7,6,1
350161,2,8,0,8,2,1
67860,2,6,3,3,14,1
100197,2,17,0,17,12,0
357536,2,10,6,4,5,1
360075,4,10,40,-30,7,0
406416,4,24,7,17,11,1
399708,1,0,3,-3,8,1
391107,2,7,14,-7,4,1
204676,1,7,0,7,6,0
383949,2,0,10,-10,1,1
12729,3,52,0,52,6,1
278253,4,34,35,-1,4,1
59032,2,3,10,-7,10,0
388392,1,0,0,0,2,0
284708,1,0,0,0,7,0
297249,3,21,6,15,13,1
410130,3,17,10,7,13,0
392411,4,40,45,-5,4,0
197315,3,17,0,17,3,0
314177,2,7,20,-13,3,0
365329,4,17,19,-2,9,1
20461,1,0,0,0,10,1
163619,3,21,19,2,5,0
205134,1,6,0,6,6,1
361046,2,16,2,14,7,1
129496,1,0,0,0,7,1
161895,2,13,9,4,4,0
260886,1,0,0,0,14,1
111145,4,31,10,21,16,0
340451,1,0,6,-6,15,1
3573,2,14,7,7,2,0
55953,2,10,7,3,9,0
117287,1,0,0,0,2,1
309249,2,0,7,-7,1,1
43028,2,0,0,0,3,1
236528,3,10,9,1,3,0
93864,2,14,0,14,9,1
260232,3,10,3,7,14,1
170232,1,0,6,-6,8,1
166454,3,17,10,7,6,0
115428,3,32,7,25,1,1
139868,4,20,17,3,12,0
311686,4,6,9,-3,2,0
187331,1,7,7,0,16,1
342471,4,20,3,17,16,1
307485,3,35,13,22,17,1
390174,1,0,0,0,3,1
119290,3,14,10,4,3,0
223899,4,30,6,24,15,0
172307,5,24,23,1,9,1
414328,1,0,0,0,14,1
142824,4,12,10,2,13,0
358308,3,0,20,-20,6,1
243289,3,7,10,-3,6,0
152033,2,3,0,3,17,1
358842,2,3,7,-4,6,0
122657,1,0,0,0,4,0
149099,3,14,17,-3,16,1
364023,4,6,12,-6,8,0
6860,4,10,31,-21,3,0
237501,2,17,7,10,3,0
99546,4,10,17,-7,11,0
310652,3,13,30,-17,2,0
243184,5,23,22,1,6,0
315411,4,16,30,-14,4,1
183651,2,0,8,-8,14,1
166468,3,17,17,0,6,1
119916,1,6,14,-8,3,1
70320,3,10,23,-13,15,1
366163,3,7,38,-31,10,0
19727,2,6,6,0,10,1
165882,4,6,19,-13,6,1
159179,1,7,0,7,3,1
58728,2,10,17,-7,10,1
284332,3,6,10,-4,7,1
353016,4,23,10,13,3,1
165108,4,10,24,-14,6,1
260848,4,29,15,14,14,1
111619,1,7,10,-3,16,1
148129,1,0,7,-7,16,1
253482,4,17,44,-27,11,1
187197,1,0,0,0,16,1
412681,3,30,10,20,14,0
21994,2,7,10,-3,11,0
174351,2,17,0,17,10,1
115853,2,7,10,-3,1,0
332151,2,0,10,-10,12,0
399372,3,27,10,17,7,1
24464,1,0,0,0,12,0
363140,3,14,3,11,8,1
11771,1,6,0,6,6,1
182911,2,0,30,-30,14,1
221486,4,3,41,-38,14,1
137909,3,24,14,10,11,0
410258,2,7,7,0,13,0
404005,1,0,14,-14,10,1
333103,4,20,18,2,12,0
76699,4,16,7,9,1,0
174907,1,0,0,0,10,1
1533,3,6,13,-7,1,0
19714,2,3,6,-3,10,1
147876,3,3,31,-28,15,1
261397,3,10,17,-7,14,1
399587,1,0,0,0,8,1
979,4,0,6,-6,1,1
58170,4,29,17,12,10,0
344073,1,3,3,0,17,0
228448,1,0,0,0,17,1
287912,2,7,10,-3,9,1
277623,4,27,21,6,4,0
308430,3,7,25,-18,1,1
28236,3,17,0,17,13,0
373305,1,0,0,0,13,1
200497,4,26,18,8,4,0
360952,4,31,5,26,7,1
105934,1,7,0,7,14,0
346552,3,24,40,-16,1,0
45641,3,13,13,0,4,1
127861,1,0,0,0,6,1
250323,2,7,7,0,9,0
175265,3,15,7,8,10,0
167410,4,44,40,4,7,0
187329,1,7,7,0,16,1
228065,3,3,3,0,17,1
76485,2,0,14,-14,1,0
87343,1,0,0,0,6,1
313199,4,23,16,7,3,1
409544,3,28,3,25,12,0
374405,2,15,0,15,14,1
92802,1,0,0,0,8,1
201023,2,27,0,27,5,0
246981,3,20,24,-4,8,1
39332,4,20,27,-7,1,1
140094,2,0,0,0,12,1
383677,3,9,17,-8,17,0
22159,2,10,6,4,11,0
53119,3,19,31,-12,7,1
115460,4,39,14,25,1,0
374431,3,18,0,18,14,1
420020,3,10,7,3,17,1
88400,1,0,0,0,6,0
183512,2,7,3,4,14,1
300088,4,7,40,-33,14,1
416754,2,7,7,0,15,1
412327,2,7,14,-7,13,1
291591,3,23,3,20,11,0
187696,3,13,6,7,16,1
188776,4,0,20,-20,16,0
395543,4,21,14,7,6,1
395949,2,24,10,14,6,0
151560,1,0,0,0,17,0
106451,2,16,0,16,14,1
28075,2,21,10,11,13,0
236939,2,29,7,22,3,1
209521,2,27,10,17,8,0
292691,1,0,0,0,11,0
155992,2,10,14,-4,2,0
8261,4,16,13,3,4,1
196578,3,20,6,14,2,0
75004,4,27,17,10,17,1
54105,4,20,3,17,8,0
228864,4,9,17,-8,17,1
308443,4,7,25,-18,1,0
420534,4,10,42,-32,17,1
663,3,0,10,-10,1,0
415888,3,10,20,-10,15,0
44471,4,17,12,5,3,0
305589,3,20,10,10,17,0
372723,1,0,0,0,13,0
335766,4,17,7,10,13,0
117253,4,30,24,6,2,1
355210,1,0,14,-14,4,1
301165,2,13,11,2,15,0
258558,2,0,0,0,13,1
123315,2,14,7,7,4,1
277459,4,41,25,16,4,0
26881,2,10,6,4,13,0
151277,1,7,0,7,17,0
128007,4,23,33,-10,6,0
233368,1,0,0,0,2,1
168358,4,24,24,0,7,0
170022,4,28,17,11,8,1
363526,2,3,5,-2,8,1
277054,2,3,0,3,4,0
69636,4,14,17,-3,15,1
42774,2,6,7,-1,3,0
145716,1,0,10,-10,15,1
202250,2,3,0,3,5,0
391965,1,0,0,0,4,0
108136,4,13,42,-29,15,0
307448,2,21,10,11,17,1
71009,2,10,0,10,16,0
165421,4,6,36,-30,6,1
373272,4,13,23,-10,13,1
125092,1,0,0,0,5,0
301856,1,0,0,0,15,0
235644,1,0,3,-3,3,1
367301,3,3,17,-14,10,0
332569,2,3,3,0,12,0
286004,4,29,20,9,8,1
345086,2,6,3,3,17,0
90838,1,7,0,7,7,1
365622,4,35,27,8,9,1
282173,1,3,0,3,6,1
187476,1,0,3,-3,16,1
17721,4,17,6,11,9,1
257244,3,19,23,-4,12,0
219178,2,0,3,-3,13,1
26897,3,10,6,4,13,0
153916,4,7,12,-5,1,1
355735,3,7,6,1,5,1
330786,1,0,3,-3,11,1
159170,1,0,0,0,3,1
279863,3,17,13,4,5,0
346364,2,6,13,-7,1,1
90972,1,0,0,0,7,1
255733,1,0,0,0,12,0
85406,4,37,17,20,5,1
303768,3,20,10,10,16,0
342663,1,0,0,0,16,0
14528,4,34,39,-5,7,0
143199,2,7,3,4,13,0
352892,4,14,16,-2,3,1
299109,2,3,9,-6,14,0
225678,4,14,10,4,16,0
386627,2,7,13,-6,2,1
182237,1,0,0,0,14,1
2403,2,21,13,8,2,0
121842,3,0,10,-10,4,1
133748,2,0,7,-7,9,1
259725,2,10,7,3,14,1
41827,4,21,14,7,2,1
217757,3,10,7,3,12,1
384496,4,28,6,22,1,0
206920,4,10,23,-13,7,1
400117,3,17,23,-6,8,1
206768,4,14,24,-10,7,0
419552,1,7,7,0,17,1
292756,2,19,17,2,11,1
413258,2,10,0,10,14,0
402216,1,0,0,0,9,0
74482,1,0,0,0,17,1
14311,3,2,7,-5,7,0
276590,1,7,0,7,4,0
67295,2,14,0,14,14,0
71139,2,12,3,9,16,0
132302,3,24,14,10,9,0
179165,4,19,16,3,12,0
222620,2,7,7,0,14,1
108193,1,3,0,3,15,1
62955,1,0,7,-7,12,1
212292,2,7,3,4,10,1
395009,2,0,14,-14,5,1
119988,3,23,24,-1,3,0
331869,2,0,3,-3,12,1
392750,1,7,3,4,4,1
92312,4,20,0,20,8,1
278374,4,17,21,-4,4,0
396364,2,20,6,14,6,0
40778,3,17,28,-11,2,0
170909,3,14,20,-6,8,1
326103,4,30,3,27,9,0
166463,3,17,17,0,6,1
131288,4,21,17,4,8,0
99762,2,0,7,-7,12,1
344876,4,30,10,20,17,0
156180,3,14,10,4,2,0
37045,2,10,0,10,17,1
261553,3,12,7,5,14,0
284599,2,14,7,7,7,1
121777,1,0,0,0,4,1
224955,4,3,16,-13,15,1
357472,1,0,0,0,5,0
270851,3,9,13,-4,1,0
256816,4,13,19,-6,12,1
209227,3,17,7,10,8,1
7679,1,0,0,0,4,1
348257,3,16,39,-23,1,1
385310,3,14,20,-6,1,1
367725,3,6,13,-7,10,1
281901,1,0,0,0,6,1
388792,3,14,0,14,3,0
134660,4,34,24,10,10,0
298544,3,13,0,13,14,0
176984,3,13,6,7,11,0
139441,3,24,3,21,12,0
264773,3,10,16,-6,16,0
357445,4,31,30,1,5,1
55163,4,29,17,12,8,0
279623,1,0,0,0,5,1
124929,1,0,0,0,5,1
244561,4,25,16,9,7,0
55404,2,13,7,6,9,0
410824,1,7,0,7,13,1
220501,1,0,13,-13,13,0
345308,4,19,24,-5,17,1
401887,4,14,28,-14,9,1
196637,1,7,0,7,3,1
111861,4,13,10,3,17,0
59585,1,0,3,-3,11,1
220670,2,10,0,10,13,1
218389,1,0,7,-7,13,1
362223,3,6,16,-10,8,0
370025,3,10,7,3,12,0
298765,1,7,6,1,14,1
98146,3,21,10,11,11,0
386182,2,6,3,3,2,0
391513,1,7,14,-7,4,0
207048,3,35,3,32,7,0
183768,1,7,14,-7,14,1
122585,3,14,7,7,4,1
120316,4,24,13,11,3,0
91053,3,9,0,9,7,0
156790,2,14,13,1,2,0
117750,1,0,3,-3,2,0
314170,2,7,20,-13,3,1
211677,3,23,9,14,9,1
216809,1,0,0,0,12,0
139458,4,27,10,17,12,0
321557,1,3,6,-3,7,0
91471,2,12,0,12,8,1
358669,1,0,0,0,6,1
351942,2,14,7,7,3,0
409766,4,13,9,4,12,0
281727,4,38,38,0,6,1
341959,2,6,0,6,16,0
158635,2,7,7,0,3,1
15163,1,0,0,0,8,1
408463,2,7,3,4,12,0
388216,4,6,13,-7,2,1
230996,2,7,0,7,1,1
235355,1,14,0,14,3,0
60011,1,0,0,0,11,0
284538,4,24,15,9,7,0
317814,2,9,3,6,5,0
256029,4,25,12,13,12,1
36357,3,13,13,0,17,0
256417,2,9,14,-5,12,0
47419,5,13,13,0,5,0
315950,2,0,7,-7,4,0
53487,1,0,0,0,8,1
12398,2,10,6,4,6,0
91135,2,3,7,-4,8,0
43194,2,14,7,7,3,0
295994,2,3,0,3,13,0
185147,4,0,23,-23,15,0
209725,3,9,6,3,8,0
19094,1,0,0,0,10,0
28287,4,24,14,10,13,1
137685,2,0,13,-13,11,1
203961,2,3,7,-4,6,1
385526,1,0,0,0,1,1
164840,1,0,3,-3,6,0
51869,2,6,10,-4,7,1
134578,2,10,3,7,10,1
114386,3,34,13,21,1,1
164061,3,3,6,-3,5,0
20433,1,0,0,0,10,0
283702,1,0,0,0,7,1
166519,4,23,27,-4,6,1
311278,4,9,3,6,2,0
31300,2,7,3,4,15,1
42383,3,14,16,-2,2,1
310045,4,9,10,-1,2,0
66668,4,7,24,-17,14,0
328575,1,7,7,0,10,1
220569,3,10,23,-13,13,0
119116,2,10,7,3,3,0
190400,3,7,7,0,17,1
384816,2,6,3,3,1,0
212672,4,9,31,-22,10,0
409698,3,10,6,4,12,1
128547,4,21,35,-14,7,1
94199,3,17,14,3,9,1
238763,1,7,0,7,4,0
11310,1,0,0,0,6,1
295256,3,14,5,9,12,0
206885,3,10,17,-7,7,1
242051,4,10,9,1,5,0
140721,2,12,14,-2,12,1
206172,1,0,0,0,7,0
327050,4,14,17,-3,9,1
138766,1,0,0,0,12,0
376066,2,0,3,-3,14,1
1493,2,3,6,-3,1,0
40266,2,3,0,3,2,1
82718,1,0,0,0,3,0
206263,3,7,6,1,7,1
196192,1,7,0,7,2,0
87091,2,0,0,0,5,1
80950,2,13,0,13,3,1
179626,4,31,23,8,12,0
223040,1,7,7,0,14,1
61816,2,0,17,-17,12,1
102591,2,5,6,-1,13,1
393435,4,28,24,4,5,1
35515,3,27,7,20,17,1
48540,2,11,7,4,5,0
157133,3,16,20,-4,2,1
258178,4,13,13,0,13,0
247513,1,3,3,0,8,1
225389,4,24,35,-11,15,1
96377,4,9,37,-28,10,0
334722,3,18,3,15,13,0
82942,3,3,16,-13,4,1
324798,1,0,0,0,8,0
71933,4,15,13,2,16,1
135795,2,7,14,-7,10,1
319526,4,13,17,-4,6,1
237455,1,0,0,0,3,1
52863,3,14,51,-37,7,0
339449,3,10,17,-7,15,0
298753,1,0,0,0,14,1
346418,4,9,13,-4,1,1
396370,2,20,9,11,6,0
104393,4,52,38,14,13,1
318449,3,24,7,17,5,0
104665,4,7,3,4,14,0
106074,1,0,0,0,14,0
246760,2,3,3,0,8,0
368272,2,3,3,0,11,1
89784,1,3,0,3,7,0
203494,3,21,3,18,6,0
9454,2,10,0,10,5,0
67938,4,22,3,19,14,0
367408,2,17,14,3,10,0
107502,3,3,20,-17,15,0
181892,3,21,28,-7,13,0
133118,1,0,3,-3,9,1
188286,3,14,13,1,16,1
131698,3,10,22,-12,8,1
137561,3,17,27,-10,11,1
301751,2,0,17,-17,15,0
380974,4,9,14,-5,16,1
937,2,0,0,0,1,0
223465,1,0,0,0,15,0
376290,4,17,21,-4,14,1
135573,4,21,6,15,10,1
131469,1,0,0,0,8,0
33185,1,7,0,7,16,1
212058,4,17,40,-23,9,1
315256,4,20,16,4,4,1
235847,2,0,14,-14,3,1
366633,1,0,0,0,10,1
123928,2,0,0,0,5,1
390905,4,15,28,-13,3,0
56585,3,16,17,-1,9,1
202508,1,0,0,0,5,0
327468,4,10,30,-20,9,1
93297,2,21,3,18,9,1
290899,1,0,0,0,10,1
135634,2,7,7,0,10,1
170143,3,7,10,-3,8,1
163549,2,7,6,1,5,1
40511,4,7,20,-13,2,1
256542,2,7,0,7,12,1
106227,5,10,10,0,14,0
327828,2,10,10,0,10,0
27496,3,20,9,11,13,0
323532,3,24,10,14,7,1
365781,4,17,17,0,9,1
364342,1,0,0,0,9,0
211249,4,21,26,-5,9,1
86380,1,7,0,7,5,1
383813,2,3,7,-4,1,0
127541,4,3,26,-23,6,1
119606,3,10,9,1,3,1
193021,5,20,20,0,1,0
268283,2,10,3,7,17,1
242889,2,14,13,1,6,1
145525,4,26,17,9,14,1
378728,2,14,7,7,15,0
95241,2,3,10,-7,10,1
145648,3,28,7,21,14,0
316839,4,16,10,6,4,1
294750,1,0,0,0,12,0
62611,3,9,17,-8,12,0
304123,4,16,30,-14,16,1
346055,3,3,6,-3,1,1
120934,4,31,31,0,3,1
162888,4,13,6,7,5,1
317354,2,0,0,0,5,1
15993,4,18,14,4,8,1
370639,4,21,14,7,12,0
227467,3,13,10,3,16,1
389091,3,23,0,23,3,1
6033,1,0,7,-7,3,1
378040,3,0,7,-7,15,0
402558,2,7,7,0,9,1
236376,4,7,23,-16,3,1
123669,3,7,22,-15,4,1
317469,2,10,3,7,5,0
162333,2,3,7,-4,4,1
324616,4,16,15,1,8,0
285908,2,20,0,20,8,0
332727,2,21,6,15,12,0
143073,2,9,14,-5,13,1
3881,2,19,7,12,2,0
136014,3,3,10,-7,10,1
156877,1,0,0,0,2,0
101952,4,9,13,-4,12,1
174558,4,10,14,-4,10,1
7203,1,0,0,0,4,0
144630,4,23,22,1,14,1
151842,1,0,0,0,17,1
130381,3,7,3,4,8,0
101430,3,15,7,8,12,1
135915,5,24,24,0,10,0
143082,3,10,17,-7,13,1
300267,1,0,7,-7,14,1
154037,3,17,21,-4,1,1
243262,2,7,10,-3,6,1
418308,3,6,14,-8,16,0
113774,3,10,17,-7,17,0
305898,4,14,14,0,17,0
24032,1,0,0,0,12,1
179084,2,6,6,0,12,1
184747,1,7,0,7,15,1
214698,1,3,0,3,11,0
205664,2,14,12,2,7,1
86471,4,30,24,6,5,1
75811,4,42,26,16,1,0
161084,2,3,3,0,4,1
399301,1,14,7,7,7,1
158172,2,7,0,7,3,1
64981,1,0,7,-7,13,0
392753,1,7,3,4,4,0
175150,3,28,10,18,10,1
223883,3,30,6,24,15,0
69766,4,19,10,9,15,1
122766,4,10,27,-17,4,1
204196,4,24,20,4,6,0
354486,3,24,28,-4,4,0
339008,3,20,3,17,15,0
308502,1,0,6,-6,1,0
280169,3,28,0,28,5,1
321636,3,17,13,4,7,1
222571,1,0,0,0,14,0
198084,4,10,43,-33,3,1
239809,1,0,0,0,4,0
69365,1,0,0,0,15,1
401504,1,0,7,-7,8,1
149722,3,34,0,34,16,0
142694,1,0,0,0,13,0
337372,3,21,7,14,14,0
116718,2,6,17,-11,2,1
387561,3,6,3,3,2,1
292850,1,7,0,7,11,0
210707,1,7,0,7,9,1
22617,3,23,3,20,11,1
50783,4,24,21,3,6,1
204850,1,3,0,3,6,0
136242,1,9,7,2,11,1
306127,1,0,0,0,17,1
235574,3,24,13,11,3,1
44817,1,0,7,-7,4,1
327721,3,6,13,-7,10,1
16705,4,21,33,-12,8,1
408548,4,10,16,-6,12,0
370277,2,0,21,-21,12,0
331836,1,0,0,0,12,0
194856,1,0,7,-7,2,0
10705,4,17,17,0,5,1
283215,1,7,0,7,7,0
365886,3,14,14,0,9,1
395038,2,0,17,-17,5,1
399470,2,0,24,-24,7,1
210365,4,22,17,5,9,1
302518,3,3,10,-7,15,0
138048,3,29,17,12,11,0
49527,3,7,3,4,6,0
313482,4,17,14,3,3,0
215397,4,24,20,4,11,0
411237,4,11,23,-12,13,1
173340,3,21,27,-6,10,0
327660,1,0,3,-3,10,1
44213,1,7,7,0,3,0
374805,1,7,0,7,14,1
236671,3,10,7,3,3,0
35512,3,27,7,20,17,1
222367,3,24,3,21,14,1
309057,4,0,20,-20,1,1
203810,3,17,24,-7,6,1
222134,1,0,0,0,14,0
4724,1,7,0,7,3,0
84669,1,0,0,0,4,1
70523,4,39,23,16,15,0
65471,3,16,14,2,13,0
92456,4,20,10,10,8,1
127603,2,3,9,-6,6,1
163779,3,10,12,-2,5,1
293744,1,7,0,7,12,0
231040,3,24,0,24,1,0
144462,4,10,33,-23,14,1
384278,2,6,0,6,1,1
140187,4,13,9,4,12,0
39026,4,37,24,13,1,1
47573,4,40,6,34,5,0
197414,2,13,3,10,3,1
275169,3,14,16,-2,3,1
79665,5,24,24,0,2,1
33121,3,10,28,-18,16,1
258734,3,3,27,-24,13,1
395056,3,0,17,-17,5,0
28777,1,0,0,0,14,1
173928,3,13,16,-3,10,0
151980,4,34,27,7,17,0
267363,2,0,7,-7,17,0
168717,2,10,3,7,7,0
136381,1,0,0,0,11,0
984,4,0,6,-6,1,0
116413,2,3,3,0,1,0
9349,3,28,7,21,5,0
407020,4,11,34,-23,11,0
100422,4,12,20,-8,12,1
149036,1,0,7,-7,16,0
68133,4,6,10,-4,14,0
202131,3,13,3,10,5,1
180501,3,21,20,1,13,1
68849,3,6,17,-11,15,1
352614,1,0,0,0,3,0
338392,3,24,10,14,14,0
121425,4,7,12,-5,3,0
147674,2,10,0,10,15,0
20383,3,10,13,-3,10,1
132693,2,3,10,-7,9,1
320687,2,14,17,-3,6,1
246068,3,16,13,3,7,1
25260,2,14,7,7,12,1
195493,2,0,0,0,2,0
200541,1,7,0,7,4,0
180937,2,17,7,10,13,0
41078,4,3,16,-13,2,1
7877,2,3,14,-11,4,1
401719,3,10,14,-4,8,1
292929,3,7,0,7,11,1
15802,3,0,12,-12,8,0
300561,1,0,0,0,15,1
420971,3,7,21,-14,17,1
408018,2,3,0,3,12,0
20129,2,3,0,3,10,1
17270,4,21,34,-13,9,0
274930,4,17,16,1,3,0
77898,4,24,38,-14,1,0
31782,3,0,17,-17,15,1
6759,1,0,0,0,3,1
7285,4,17,13,4,4,0
375859,4,20,14,6,14,1
223627,1,6,0,6,15,0
226898,3,3,10,-7,16,0
53894,2,7,10,-3,8,0
363722,3,16,13,3,8,1
373116,4,10,21,-11,13,0
169084,4,36,17,19,7,0
44276,3,17,20,-3,3,0
380782,2,9,14,-5,16,0
154354,4,27,24,3,1,1
262159,3,28,6,22,15,0
151661,4,23,27,-4,17,0
163764,3,7,12,-5,5,1
261975,2,14,10,4,14,0
418856,2,0,10,-10,16,1
43204,2,14,7,7,3,1
147394,2,7,7,0,15,1
232407,4,20,25,-5,1,1
381647,2,10,0,10,17,0
17224,3,7,31,-24,9,0
291192,4,24,29,-5,10,1
208308,2,7,21,-14,8,1
221770,4,10,14,-4,14,1
4008,1,0,0,0,2,1
100141,1,0,0,0,12,1
98552,2,0,0,0,11,0
389131,4,30,14,16,3,1
207028,3,28,3,25,7,0
347321,3,7,21,-14,1,0
272865,3,20,10,10,2,0
3528,1,0,0,0,2,1
212065,4,23,40,-17,9,1
381211,2,7,10,-3,16,1
1182,1,3,0,3,1,1
342367,1,0,0,0,16,0
224504,3,15,10,5,15,0
220195,1,7,0,7,13,0
76729,1,0,0,0,1,0
128859,4,20,16,4,7,0
375858,4,20,14,6,14,1
217635,4,19,16,3,12,1
403998,1,0,13,-13,10,0
28321,1,0,0,0,14,1
208068,4,21,13,8,8,0
29526,1,0,7,-7,14,0
95178,4,23,27,-4,9,0
71803,4,38,33,5,16,0
391198,4,10,24,-14,4,1
265844,5,26,19,7,16,1
275442,2,20,10,10,3,0
390247,3,3,6,-3,3,0
281639,2,21,3,18,6,0
76404,4,29,12,17,1,1
388212,4,6,13,-7,2,0
290830,3,10,14,-4,10,1
332799,4,28,16,12,12,0
306116,1,0,0,0,17,0
73251,4,7,16,-9,16,1
84448,3,6,10,-4,4,1
202725,2,6,10,-4,5,1
281476,2,7,10,-3,6,1
116305,3,17,13,4,1,1
202293,3,6,3,3,5,1
110360,4,20,17,3,16,0
311120,4,13,10,3,2,0
192391,1,0,0,0,1,1
364101,2,14,3,11,9,1
3472,3,3,29,-26,2,0
240613,2,20,7,13,5,0
391214,4,10,24,-14,4,0
374722,3,0,33,-33,14,1
178337,2,14,10,4,12,1
56271,3,3,17,-14,9,1
142290,2,0,0,0,13,1
410902,3,14,15,-1,13,0
403607,2,17,13,4,9,0
249238,3,19,7,12,9,0
24349,2,3,0,3,12,0
114551,4,17,40,-23,1,0
326591,1,3,3,0,9,1
276364,3,17,35,-18,3,1
87567,3,17,3,14,6,1
140508,4,21,26,-5,12,0
130350,2,7,0,7,8,0
411120,1,0,7,-7,13,1
212927,2,7,7,0,10,0
350179,2,11,0,11,2,1
198316,3,6,14,-8,3,0
20914,1,0,0,0,10,1
414318,4,21,42,-21,14,0
231590,2,14,3,11,1,0
56013,4,10,23,-13,9,1
51252,1,0,0,0,7,1
228923,2,7,9,-2,17,1
191647,1,0,3,-3,17,1
277222,2,0,13,-13,4,1
252019,3,14,20,-6,10,0
393376,2,21,7,14,5,0
327745,4,6,16,-10,10,1
413551,2,3,10,-7,14,1
317107,4,20,17,3,4,0
244762,1,0,0,0,7,1
228384,3,7,17,-10,17,1
80265,1,0,0,0,2,1
256670,4,38,20,18,12,1
285650,4,27,24,3,8,0
301515,4,20,15,5,15,0
280958,1,0,0,0,6,1
84362,4,28,30,-2,4,1
322400,4,17,19,-2,7,0
151175,2,3,10,-7,17,0
276733,1,0,0,0,4,1
257732,4,3,24,-21,13,1
102489,3,24,3,21,13,0
85187,3,7,10,-3,4,1
145601,2,21,0,21,14,1
320163,4,17,14,3,6,0
218053,4,21,24,-3,12,1
167524,3,0,10,-10,7,1
412760,1,7,10,-3,14,0
192295,2,24,3,21,1,1
188159,3,10,10,0,16,1
306827,1,0,3,-3,17,1
55016,1,0,0,0,8,0
312160,4,33,23,10,2,0
335663,1,7,0,7,13,0
337038,2,16,0,16,14,1
89388,2,10,20,-10,7,1
173146,2,10,14,-4,9,1
238177,2,3,16,-13,4,0
19228,4,28,19,9,10,0
213435,4,10,41,-31,10,0
85578,4,20,22,-2,5,0
65040,3,3,17,-14,13,0
134574,2,10,0,10,10,0
312056,2,14,7,7,2,0
289484,3,6,7,-1,10,1
184775,2,17,7,10,15,1
419458,2,10,6,4,16,1
227306,3,13,20,-7,16,0
35965,4,3,7,-4,17,1
233438,3,17,10,7,2,1
237640,2,3,7,-4,4,0
137368,2,3,7,-4,11,0
329857,4,24,26,-2,11,1
12152,4,14,21,-7,6,0
12856,3,13,3,10,6,0
132168,4,29,6,23,9,0
270693,2,3,3,0,1,1
250280,1,7,0,7,9,0
57519,3,21,13,8,10,1
269484,2,10,3,7,1,0
75254,2,7,10,-3,17,0
398173,2,7,3,4,7,0
289218,4,23,13,10,9,0
199685,2,21,7,14,4,0
17590,4,20,17,3,9,0
249956,1,0,0,0,9,0
142199,5,11,13,-2,13,1
96509,4,17,24,-7,10,1
213275,4,17,27,-10,10,1
30920,4,3,24,-21,15,1
324582,3,16,9,7,8,0
17355,2,17,0,17,9,1
41565,4,18,14,4,2,1
318494,4,31,7,24,5,1
303602,3,28,13,15,16,0
73982,3,37,0,37,17,1
305,1,0,0,0,1,1
394798,4,24,6,18,5,1
392670,3,16,0,16,4,1
355793,4,10,12,-2,5,1
385546,2,0,10,-10,1,1
103719,4,3,17,-14,13,0
142047,4,23,14,9,13,0
390929,1,7,0,7,4,0
162422,4,20,30,-10,4,1
298525,2,10,0,10,14,1
374360,1,0,0,0,14,1
45521,4,27,26,1,4,1
198466,3,17,3,14,3,1
333777,1,6,7,-1,12,0
330545,3,7,7,0,11,1
323205,2,7,0,7,7,0
135414,4,28,23,5,10,0
371171,2,3,19,-16,12,1
345288,4,19,17,2,17,0
240096,1,0,0,0,5,1
372020,3,13,0,13,13,0
287506,3,14,26,-12,9,1
418081,1,0,0,0,16,1
245603,3,40,6,34,7,0
307183,2,0,10,-10,17,1
396025,4,38,20,18,6,1
394738,2,14,0,14,5,1
135254,3,16,3,13,10,0
95958,1,0,0,0,10,1
419990,2,3,7,-4,17,1
341037,2,7,14,-7,15,1
166637,3,22,20,2,6,1
187883,4,7,23,-16,16,0
115162,4,10,27,-17,1,1
45380,4,20,16,4,4,0
20651,2,7,14,-7,10,0
365549,2,14,7,7,9,0
263892,2,6,0,6,15,0
309924,1,0,0,0,2,1
104328,3,38,21,17,13,0
207749,3,24,13,11,7,0
410701,2,10,3,7,13,0
36077,3,31,0,31,17,1
122895,3,31,6,25,4,1
264675,1,7,0,7,16,0
278593,2,7,0,7,4,1
88319,3,14,7,7,6,1
399713,1,0,3,-3,8,0
220373,2,13,6,7,13,0
161726,2,10,3,7,4,1
93623,3,13,6,7,9,1
109384,2,3,10,-7,16,0
288485,1,3,0,3,9,0
92020,4,27,26,1,8,1
226520,4,14,20,-6,16,1
287770,2,14,10,4,9,1
355583,2,24,3,21,5,0
147798,1,0,7,-7,15,1
288159,4,19,14,5,9,0
18439,3,7,7,0,9,0
198663,3,15,21,-6,3,1
168602,3,14,13,1,7,1
299891,3,13,8,5,14,1
395767,1,0,0,0,6,1
232566,4,26,24,2,1,0
214288,3,14,10,4,11,0
40820,4,24,35,-11,2,1
247589,3,16,16,0,8,0
302180,1,14,0,14,15,1
401761,4,27,14,13,8,0
42572,4,10,31,-21,3,0
168841,2,14,0,14,7,0
10025,1,14,0,14,5,0
385708,1,0,0,0,1,0
301491,3,20,12,8,15,1
150345,3,27,7,20,16,0
155681,2,10,13,-3,2,0
71988,1,0,9,-9,16,0
369156,3,19,7,12,11,1
159551,2,14,6,8,3,1
111415,3,0,17,-17,16,0
266893,1,0,0,0,17,1
213875,4,54,14,40,10,1
282347,2,7,7,0,6,1
69846,2,14,9,5,15,1
96881,2,13,7,6,10,0
116641,4,23,3,20,2,0
390870,3,9,28,-19,3,1
237494,2,14,7,7,3,1
358431,3,29,19,10,6,0
247580,3,16,16,0,8,0
27378,3,24,10,14,13,1
412732,1,0,0,0,14,0
319129,2,2,0,2,5,1
253825,1,7,7,0,11,1
131322,1,0,0,0,8,1
48028,4,10,27,-17,5,0
381192,1,7,3,4,16,0
35937,3,3,0,3,17,0
410540,1,7,7,0,13,0
184631,2,10,10,0,15,1
43366,3,14,14,0,3,0
223990,2,7,6,1,15,1
80661,3,17,16,1,3,0
139721,3,7,7,0,12,0
61485,1,0,7,-7,11,0
299186,4,17,19,-2,14,0
161191,1,0,0,0,4,1
156097,1,7,0,7,2,0
188760,3,0,20,-20,16,1
101371,2,6,0,6,12,0
328231,4,14,17,-3,10,1
37336,2,13,0,13,17,1
348572,3,28,17,11,2,0
325015,3,20,21,-1,8,1
251257,3,10,24,-14,10,1
334688,2,15,3,12,13,1
380263,4,29,16,13,16,0
393017,4,12,10,2,4,0
352270,3,3,6,-3,3,1
247766,4,10,6,4,8,0
290438,4,35,10,25,10,0
391485,4,10,30,-20,4,0
209336,2,7,7,0,8,1
324636,4,19,15,4,8,0
282309,4,34,17,17,6,1
93135,2,0,0,0,9,0
186241,1,3,0,3,15,1
60794,2,7,3,4,11,1
169978,3,21,10,11,8,1
417741,4,35,19,16,16,0
398765,3,14,17,-3,7,1
409459,4,34,3,31,12,1
416988,4,10,17,-7,15,1
351646,2,7,7,0,3,0
182931,2,7,37,-30,14,1
374455,3,32,6,26,14,0
15454,2,6,0,6,8,0
231197,3,10,7,3,1,0
342926,4,23,17,6,16,1
117791,2,6,6,0,2,0
143825,3,12,7,5,14,0
82774,2,6,6,0,3,1
334033,4,20,16,4,12,1
47730,4,6,17,-11,5,0
121005,2,8,21,-13,3,0
161506,4,17,6,11,4,0
359828,1,0,7,-7,6,1
87422,3,17,7,10,6,1
300993,1,3,0,3,15,0
321795,4,21,9,12,7,0
113535,1,0,0,0,17,0
206786,1,0,0,0,7,1
208267,1,0,7,-7,8,0
87120,2,7,10,-3,5,1
231716,1,0,7,-7,1,1
261963,2,14,10,4,14,0
15941,2,9,14,-5,8,1
92060,1,3,0,3,8,0
17105,3,23,10,13,9,1
304291,1,0,0,0,16,0
228171,2,7,20,-13,17,0
255954,2,6,12,-6,12,1
360370,4,7,20,-13,7,0
390831,2,0,21,-21,3,0
129251,3,14,13,1,7,1
217560,2,3,3,0,12,1
185680,1,7,3,4,15,0
238671,3,16,14,2,4,0
339412,2,7,3,4,15,0
229728,3,13,17,-4,17,0
148734,2,10,3,7,16,1
48408,2,10,17,-7,5,0
373658,2,0,12,-12,13,1
94882,4,13,13,0,9,1
151523,4,35,7,28,17,1
410197,4,20,24,-4,13,1
379260,1,0,3,-3,16,0
54819,3,13,0,13,8,0
139405,2,21,0,21,12,1
254451,3,20,7,13,11,1
82574,1,0,3,-3,3,0
92609,4,17,3,14,8,0
340121,1,6,0,6,15,0
159810,1,0,0,0,3,0
344496,2,0,0,0,17,0
24019,1,0,0,0,12,0
396827,2,10,7,3,6,0
66102,4,10,6,4,13,1
41904,2,14,3,11,2,0
141448,1,0,0,0,13,1
209727,3,9,6,3,8,1
358049,4,31,29,2,6,1
80515,3,5,10,-5,3,0
151012,2,0,0,0,17,0
308409,3,0,18,-18,1,1
88403,1,0,0,0,6,0
25700,3,14,7,7,12,1
209137,4,9,30,-21,8,0
228074,3,3,3,0,17,0
223076,2,24,7,17,14,0
281621,2,21,0,21,6,1
290423,4,28,10,18,10,1
311781,2,10,20,-10,2,0
299466,4,10,20,-10,14,0
4337,2,0,7,-7,2,0
172938,4,48,31,17,9,0
416126,1,0,0,0,15,0
412402,4,34,30,4,13,0
213198,2,3,10,-7,10,0
164046,2,3,3,0,5,1
285538,2,7,7,0,8,1
62209,1,0,0,0,12,0
155250,3,28,14,14,1,1
114867,4,16,33,-17,1,1
220282,3,23,9,14,13,0
176916,1,0,0,0,11,1
306625,3,14,26,-12,17,0
192265,2,10,3,7,1,1
61559,3,28,7,21,11,0
308723,3,7,13,-6,1,1
60094,3,7,12,-5,11,0
79868,2,3,13,-10,2,1
265342,2,7,7,0,16,0
378703,2,7,7,0,15,1
337127,1,0,0,0,14,1
23273,1,0,3,-3,11,1
363374,2,7,10,-3,8,1
119381,1,0,7,-7,3,0
165507,2,0,14,-14,6,1
208158,2,0,0,0,8,0
359100,1,0,0,0,6,1
318220,1,0,0,0,5,1
303267,2,10,0,10,16,1
234198,3,13,10,3,2,1
90299,2,7,14,-7,7,0
173446,2,0,7,-7,10,1
349548,2,3,14,-11,2,0
67085,4,10,9,1,14,1
349769,4,23,21,2,2,1
274797,5,24,23,1,3,1
22338,3,0,6,-6,11,0
267385,2,0,7,-7,17,1
142503,4,27,13,14,13,1
233883,2,14,6,8,2,0
121710,3,21,14,7,4,0
354143,1,0,0,0,4,0
359060,4,10,13,-3,6,0
75746,2,28,16,12,1,0
131402,3,7,13,-6,8,0
165491,2,0,7,-7,6,1
272048,2,7,3,4,2,1
359952,4,30,30,0,6,0
100351,3,9,20,-11,12,1
235410,2,28,17,11,3,0
74862,4,20,20,0,17,1
212138,2,3,14,-11,10,0
146094,3,22,10,12,15,1
324556,2,13,9,4,8,0
224185,3,0,20,-20,15,0
114032,1,7,0,7,17,1
413226,2,7,0,7,14,1
278340,3,17,14,3,4,1
214670,4,17,19,-2,11,1
182107,1,9,0,9,13,0
11926,1,0,0,0,6,0
217733,2,10,7,3,12,1
307379,4,16,25,-9,17,0
96263,1,0,6,-6,10,0
19641,4,17,28,-11,10,1
412859,4,31,35,-4,14,0
293832,4,17,12,5,12,1
67819,1,0,3,-3,14,1
58470,4,48,23,25,10,1
118617,1,0,0,0,2,1
357772,1,0,7,-7,6,1
420824,3,10,10,0,17,0
131585,4,9,26,-17,8,0
350504,4,10,19,-9,2,1
406205,2,7,10,-3,11,0
178307,2,7,3,4,12,0
411920,2,17,10,7,13,1
272052,2,10,3,7,2,0
188133,3,10,10,0,16,0
60808,2,10,10,0,11,0
230478,4,28,14,14,1,1
210274,2,6,0,6,9,1
292365,4,12,16,-4,11,0
270297,4,10,27,-17,1,1
321525,1,0,0,0,7,0
147157,4,17,46,-29,15,0
288372,2,7,0,7,9,1
394366,4,31,17,14,5,1
152555,4,24,14,10,17,1
227775,3,3,14,-11,16,0
296449,2,14,0,14,13,1
201218,4,20,24,-4,5,1
110230,1,0,3,-3,16,1
210043,4,10,17,-7,8,1
344578,4,0,6,-6,17,0
60522,2,27,14,13,11,1
93427,2,3,14,-11,9,0
350927,3,6,14,-8,3,0
357361,1,7,7,0,5,1
367740,4,13,13,0,10,0
167370,3,30,23,7,7,0
316817,4,16,7,9,4,0
152213,2,14,0,14,17,1
267469,1,0,7,-7,17,0
54804,3,10,0,10,8,1
259733,2,10,7,3,14,0
34433,2,21,3,18,16,1
316802,4,16,7,9,4,1
268062,4,24,15,9,17,0
136159,3,10,10,0,10,0
104541,4,14,38,-24,13,0
354038,2,13,0,13,4,0
227788,3,6,14,-8,16,0
18602,3,17,10,7,9,1
391885,3,13,20,-7,4,1
133366,4,21,9,12,9,0
357036,1,0,0,0,5,1
293435,4,35,24,11,11,1
276738,1,7,0,7,4,0
276902,1,7,0,7,4,1
102483,3,23,3,20,13,1
194770,3,3,16,-13,2,1
177484,4,27,17,10,11,1
41049,3,3,13,-10,2,0
64611,3,20,14,6,13,1
304191,2,13,7,6,16,0
180381,4,15,14,1,13,1
71780,3,38,30,8,16,0
333392,3,20,10,10,12,0
170573,2,21,6,15,8,0
318084,2,9,7,2,5,1
318705,2,3,20,-17,5,1
59995,4,3,31,-28,11,1
353246,2,20,17,3,4,1
256992,1,0,7,-7,12,0
288693,2,0,7,-7,9,0
300916,3,10,13,-3,15,0
394810,4,24,6,18,5,0
42235,3,24,7,17,2,1
185621,4,20,20,0,15,0
149989,2,14,3,11,16,1
74463,1,0,0,0,17,1
178164,2,0,7,-7,12,0
405723,2,10,0,10,10,0
253806,1,0,0,0,11,0
51813,4,10,28,-18,7,1
180085,4,31,20,11,13,0
261305,1,0,0,0,14,1
83417,3,10,20,-10,4,0
290381,3,23,10,13,10,0
78915,4,17,10,7,2,1
347501,3,12,23,-11,1,1
197903,3,11,7,4,3,0
380731,4,7,16,-9,16,0
163127,2,16,19,-3,5,0
119118,2,10,7,3,3,0
385679,5,27,24,3,1,0
50830,2,7,13,-6,6,0
71922,3,15,13,2,16,1
390345,1,7,7,0,3,0
364399,2,28,7,21,9,1
317600,1,3,3,0,5,1
354868,4,33,42,-9,4,0
413081,2,26,14,12,14,1
120507,5,42,41,1,3,0
6500,2,3,0,3,3,0
44724,2,0,12,-12,3,0
155734,4,20,20,0,2,0
408282,1,0,0,0,12,0
387667,2,0,7,-7,2,0
291654,4,23,20,3,11,0
33488,1,7,0,7,16,1
42853,4,6,37,-31,3,1
124821,1,0,3,-3,5,1
391642,1,0,0,0,4,0
35125,1,0,7,-7,16,0
171642,3,19,17,2,9,1
413235,2,7,0,7,14,1
224769,3,5,3,2,15,0
347269,2,0,7,-7,1,1
112221,1,7,7,0,17,1
220197,1,7,0,7,13,1
186310,2,19,3,16,15,1
220973,2,14,7,7,14,0
209413,3,14,10,4,8,1
350822,1,0,0,0,3,1
109695,2,3,0,3,16,1
202623,3,24,13,11,5,1
349037,4,14,17,-3,2,1
401534,2,7,14,-7,8,0
370191,4,24,10,14,12,0
329428,1,0,0,0,10,0
139870,4,20,17,3,12,1
272937,4,20,23,-3,2,0
120437,3,19,16,3,3,1
113048,4,16,16,0,17,0
250802,3,3,9,-6,10,0
380335,2,7,7,0,16,0
142043,4,23,14,9,13,0
367312,4,6,17,-11,10,0
385152,3,14,17,-3,1,1
80041,3,10,3,7,2,1
136429,2,10,7,3,11,1
1510,2,3,6,-3,1,1
356696,3,19,16,3,5,1
306064,4,17,13,4,17,1
383036,1,3,0,3,17,0
259246,1,0,0,0,13,0
316770,2,10,7,3,4,0
113969,4,20,20,0,17,0
402912,4,17,9,8,9,0
109637,4,37,14,23,16,0
31455,2,3,7,-4,15,1
66813,4,10,6,4,14,1
29872,3,9,16,-7,14,0
19396,1,6,7,-1,10,1
367319,4,6,17,-11,10,0
416039,3,14,3,11,15,0
11809,2,20,10,10,6,1
49522,3,7,3,4,6,1
364589,3,15,34,-19,9,1
151907,2,19,7,12,17,1
44930,4,14,38,-24,4,1
228460,1,3,0,3,17,1
36051,2,17,0,17,17,0
391615,4,10,24,-14,4,1
136145,3,10,10,0,10,0
139611,4,9,14,-5,12,0
282894,5,23,23,0,6,1
17981,2,13,21,-8,9,1
239944,1,0,0,0,5,1
25406,3,6,3,3,12,1
88970,3,36,10,26,6,1
15817,3,0,12,-12,8,1
115128,3,9,20,-11,1,1
276557,4,22,7,15,4,0
313768,3,31,10,21,3,0
69150,3,14,17,-3,15,0
421559,3,13,3,10,17,1
201059,3,41,0,41,5,0
322947,3,13,0,13,7,1
229522,2,10,6,4,17,1
162697,3,23,24,-1,5,0
222573,1,0,0,0,14,0
404113,1,6,0,6,10,0
253157,4,21,23,-2,11,1
110529,4,20,13,7,16,1
27847,4,17,17,0,13,1
113205,4,41,22,19,17,0
220216,1,17,0,17,13,1
41216,4,7,13,-6,2,1
54278,4,0,6,-6,8,1
375085,1,0,0,0,14,1
192706,4,19,7,12,1,0
250467,2,13,0,13,9,0
52858,3,14,51,-37,7,1
99207,3,17,17,0,11,1
72769,2,14,7,7,16,1
242460,2,3,7,-4,6,0
420687,4,21,16,5,17,0
238129,1,0,3,-3,4,0
402438,3,21,12,9,9,1
249135,4,28,28,0,9,0
219682,4,13,14,-1,13,1
218791,4,3,19,-16,13,1
188587,3,12,13,-1,16,0
302982,3,20,16,4,16,1
319000,2,0,16,-16,5,1
337376,3,21,7,14,14,0
324926,4,23,23,0,8,0
74775,1,3,3,0,17,0
93030,3,13,6,7,8,0
136778,3,13,10,3,11,0
71552,1,3,0,3,16,1
376349,2,3,0,3,14,1
319286,2,10,3,7,6,0
368010,3,17,21,-4,11,0
161012,4,16,7,9,4,1
103152,1,0,0,0,13,1
203183,2,7,17,-10,5,0
326179,2,7,17,-10,9,1
353,2,14,10,4,1,1
39764,4,9,7,2,1,0
400353,2,16,10,6,8,1
197891,3,11,7,4,3,1
316519,1,0,0,0,4,0
408253,1,0,0,0,12,0
70905,3,15,26,-11,15,0
57168,2,7,0,7,10,1
404943,2,3,13,-10,10,1
217483,3,12,3,9,12,1
252109,2,7,7,0,10,0
113479,4,3,7,-4,17,1
300364,4,10,7,3,14,0
182295,2,14,0,14,14,0
68778,2,6,0,6,15,1
163855,1,0,7,-7,5,0
262864,2,7,20,-13,15,0
342145,3,15,16,-1,16,1
356960,2,17,3,14,5,0
384730,3,13,29,-16,1,0
234575,1,7,0,7,2,1
152029,2,0,0,0,17,1
353714,3,3,17,-14,4,1
109019,3,16,27,-11,15,0
81478,1,0,0,0,3,0
349908,3,3,12,-9,2,1
43894,1,0,0,0,3,1
361056,3,16,2,14,7,0
138298,2,17,0,17,11,1
411923,2,17,10,7,13,1
63511,4,31,16,15,12,0
241761,4,7,15,-8,5,1
397902,3,7,6,1,7,0
15923,2,6,7,-1,8,0
360731,2,17,14,3,7,1
356625,1,0,0,0,5,0
104579,1,7,3,4,14,1
232623,2,0,0,0,1,0
130672,3,7,38,-31,8,1
163471,4,10,23,-13,5,0
157560,2,2,0,2,2,1
187387,2,26,7,19,16,1
199770,1,0,0,0,4,1
215880,1,3,7,-4,11,1
232173,2,6,3,3,1,1
410535,1,7,7,0,13,0
402866,2,17,3,14,9,0
210745,2,21,7,14,9,0
214191,4,19,9,10,11,1
198929,2,13,16,-3,3,0
322073,3,26,0,26,7,0
401685,2,3,14,-11,8,0
410385,2,0,7,-7,13,0
317642,2,6,3,3,5,0
360347,4,7,20,-13,7,0
207171,3,14,10,4,7,0
207133,2,7,7,0,7,0
267566,3,27,27,0,17,1
403442,2,14,6,8,9,0
122228,1,3,7,-4,4,0
395287,4,13,19,-6,5,1
223891,4,30,6,24,15,0
176096,4,24,16,8,11,0
266956,3,16,10,6,17,0
372557,1,0,0,0,13,1
265952,3,0,30,-30,16,0
115236,2,0,3,-3,1,0
113988,5,20,20,0,17,0
290824,3,10,14,-4,10,1
129216,2,14,6,8,7,1
87981,1,3,0,3,6,1
173025,3,21,3,18,9,0
143382,3,7,23,-16,14,0
157959,4,16,25,-9,3,0
136143,3,10,10,0,10,0
233771,3,13,27,-14,2,0
244905,1,0,0,0,7,0
283459,3,23,14,9,7,0
292636,3,22,16,6,11,1
5983,4,17,29,-12,3,0
268567,2,7,3,4,17,0
347956,3,0,21,-21,1,1
113224,1,0,0,0,17,0
228124,4,20,10,10,17,0
353506,1,3,0,3,4,0
297809,2,14,7,7,13,0
183627,2,0,0,0,14,1
109882,3,20,0,20,16,1
207653,4,42,10,32,7,0
199518,2,17,0,17,4,1
29441,3,7,14,-7,14,0
81702,2,14,17,-3,3,1
322620,3,3,6,-3,7,1
284407,1,0,0,0,7,1
259266,1,13,0,13,13,0
392547,4,3,20,-17,4,1
329086,3,10,7,3,10,1
397404,2,0,10,-10,6,0
350896,2,3,14,-11,3,1
113855,1,7,0,7,17,0
400304,1,0,0,0,8,0
328344,3,3,30,-27,10,0
34740,3,6,3,3,16,1
236290,2,0,3,-3,3,1
159652,4,27,20,7,3,0
147490,1,0,0,0,15,1
387317,4,13,10,3,2,0
104256,2,10,0,10,13,0
163211,1,0,3,-3,5,1
324719,3,13,7,6,8,1
29593,3,14,13,1,14,0
12716,3,52,0,52,6,0
118103,2,3,13,-10,2,1
120832,1,7,14,-7,3,1
66044,2,7,0,7,13,0
336196,4,24,10,14,13,0
27931,2,14,10,4,13,0
81450,4,10,13,-3,3,0
349469,3,6,20,-14,2,0
117220,3,23,10,13,2,0
128505,3,21,28,-7,7,1
155430,4,13,10,3,2,0
350748,3,10,3,7,2,1
90668,4,27,33,-6,7,1
99212,3,24,17,7,11,1
270895,4,19,13,6,1,1
226667,1,7,0,7,16,0
399559,4,0,33,-33,7,0
297739,4,24,23,1,13,1
332526,4,30,16,14,12,0
385027,4,24,16,8,1,1
401404,2,17,7,10,8,1
393020,4,12,10,2,4,0
79631,3,21,14,7,2,0
8158,1,0,7,-7,4,0
132379,1,0,0,0,9,0
288089,2,10,0,10,9,0
330982,2,23,7,16,11,1
287531,4,14,33,-19,9,0
270370,1,0,0,0,1,1
189214,3,33,3,30,16,0
150518,4,41,12,29,16,0
85611,1,7,0,7,5,1
394431,2,7,10,-3,5,0
27818,4,14,14,0,13,1
125556,1,0,7,-7,5,1
406698,3,24,0,24,11,1
235674,2,0,3,-3,3,0
412705,4,33,10,23,14,0
91802,3,17,0,17,8,0
232229,4,15,12,3,1,0
311675,3,6,6,0,2,1
238230,3,3,16,-13,4,1
273601,2,10,3,7,2,0
284897,2,0,7,-7,7,0
344072,1,3,3,0,17,0
240438,2,0,6,-6,5,0
247209,1,0,7,-7,8,1
135446,4,31,27,4,10,1
209010,1,3,0,3,8,1
256437,3,12,21,-9,12,1
12604,4,3,24,-21,6,0
113909,3,10,3,7,17,1
148220,4,16,28,-12,16,0
262713,2,14,0,14,15,0
325844,4,13,20,-7,9,0
285775,2,7,10,-3,8,0
213062,3,17,3,14,10,0
276907,1,14,0,14,4,0
279434,4,16,24,-8,5,0
389823,3,24,6,18,3,1
138612,1,3,0,3,12,0
337043,3,16,0,16,14,1
341369,3,0,10,-10,16,0
250709,4,17,22,-5,10,0
384693,2,10,20,-10,1,1
421237,2,6,7,-1,17,1
393447,4,28,24,4,5,0
421033,1,0,0,0,17,0
45370,4,20,16,4,4,1
5084,3,13,7,6,3,1
227475,3,16,10,6,16,0
286286,3,13,16,-3,8,1
15769,2,0,5,-5,8,0
27241,4,22,7,15,13,1
346895,4,23,16,7,1,0
133154,2,10,17,-7,9,1
413028,4,19,21,-2,14,0
8879,2,14,0,14,4,1
375179,3,17,16,1,14,0
136538,1,0,10,-10,11,1
14739,2,21,0,21,7,1
28131,4,27,10,17,13,1
346410,4,9,13,-4,1,1
355489,4,23,26,-3,4,0
267847,3,26,14,12,17,0
160256,1,0,0,0,4,0
304919,2,7,3,4,16,1
316438,3,16,10,6,4,1
185576,3,10,20,-10,15,1
149384,2,6,6,0,16,0
166422,2,17,7,10,6,0
303688,1,0,0,0,16,0
49406,4,17,20,-3,6,1
94377,4,17,14,3,9,0
266595,1,0,0,0,16,0
290902,1,0,0,0,10,0
154994,1,6,0,6,1,0
417457,1,3,7,-4,16,0
205004,2,9,7,2,6,0
10396,4,10,38,-28,5,0
191090,2,7,10,-3,17,0
325640,3,17,7,10,9,1
132179,4,29,13,16,9,1
214764,3,3,13,-10,11,1
370833,1,0,0,0,12,1
94070,4,6,28,-22,9,0
325564,1,7,0,7,9,0
350532,4,17,19,-2,2,1
305713,3,9,7,2,17,0
356598,5,9,9,0,5,1
258411,2,14,13,1,13,1
333864,4,28,21,7,12,0
156427,1,0,3,-3,2,1
27943,3,14,10,4,13,0
83516,2,0,7,-7,4,0
306384,1,0,0,0,17,0
314302,2,7,14,-7,3,0
407207,1,0,3,-3,11,1
189251,4,53,11,42,16,0
40607,3,24,7,17,2,0
246690,4,38,3,35,8,0
379786,4,9,24,-15,16,1
61435,4,16,10,6,11,0
254548,1,0,0,0,11,0
11828,3,34,17,17,6,0
207280,2,0,7,-7,7,1
30219,4,13,31,-18,14,0
87759,4,6,20,-14,6,0
300856,1,0,7,-7,15,0
412070,3,24,0,24,13,0
316237,2,0,10,-10,4,0
256014,4,19,12,7,12,1
276453,1,9,7,2,4,1
251937,1,0,0,0,10,0
401528,2,0,14,-14,8,1
410631,4,17,17,0,13,1
336756,3,10,10,0,14,0
328102,1,0,0,0,10,1
199925,1,0,10,-10,4,1
209823,1,7,10,-3,8,1
398485,2,14,9,5,7,0
301840,1,0,0,0,15,1
34986,1,6,0,6,16,0
226109,2,7,14,-7,16,0
166427,2,17,7,10,6,0
158369,3,16,17,-1,3,0
130438,1,0,0,0,8,1
149286,3,13,26,-13,16,0
419780,4,17,17,0,17,0
196924,1,0,0,0,3,1
8638,3,7,10,-3,4,1
17047,1,13,0,13,9,0
418976,2,7,7,0,16,1
347344,4,7,21,-14,1,1
254328,3,13,19,-6,11,0
156224,4,16,23,-7,2,1
189668,4,17,6,11,17,0
88383,4,24,10,14,6,0
362031,1,0,7,-7,8,1
40644,4,34,7,27,2,1
26888,2,10,6,4,13,1
38852,4,3,10,-7,1,0
293882,1,0,7,-7,12,1
292196,3,21,14,7,11,0
58382,2,28,0,28,10,0
36628,2,3,3,0,17,1
291987,2,0,3,-3,11,1
19155,2,14,10,4,10,1
198198,3,10,9,1,3,1
197270,2,0,0,0,3,1
416717,1,0,0,0,15,0
166724,2,7,3,4,6,1
355776,4,10,9,1,5,1
42014,1,6,0,6,2,0
300059,4,6,40,-34,14,1
300327,3,0,7,-7,14,1
404059,3,10,35,-25,10,1
262580,2,20,3,17,15,0
80994,4,20,17,3,3,1
176364,3,16,27,-11,11,0
80925,2,6,0,6,3,0
397257,1,0,7,-7,6,1
227430,2,10,7,3,16,1
387591,4,6,3,3,2,1
414345,1,7,0,7,14,0
350774,3,10,3,7,2,1
260128,4,6,35,-29,14,1
241118,3,13,10,3,5,1
362321,2,3,7,-4,8,0
159545,2,14,6,8,3,1
66890,2,6,7,-1,14,0
247410,2,3,9,-6,8,1
153776,4,2,27,-25,1,1
320118,2,17,0,17,6,1
216885,3,13,14,-1,12,0
277039,1,3,0,3,4,0
103300,1,0,0,0,13,0
109065,4,23,41,-18,15,0
323065,2,17,14,3,7,1
297041,2,14,0,14,13,1
128558,4,21,35,-14,7,1
189621,2,10,3,7,17,0
184050,1,0,0,0,14,1
194955,4,14,22,-8,2,0
210123,2,0,0,0,9,0
336986,1,3,0,3,14,1
421521,2,3,3,0,17,1
165887,4,6,19,-13,6,0
296137,1,10,6,4,13,1
271263,2,6,0,6,1,0
96891,2,13,7,6,10,1
380228,3,13,16,-3,16,0
179790,4,6,24,-18,12,0
7933,3,3,20,-17,4,1
146177,1,0,3,-3,15,1
36087,3,34,0,34,17,1
138846,3,12,33,-21,12,0
88596,2,10,7,3,6,1
161503,4,16,6,10,4,1
399903,2,0,6,-6,8,1
369619,4,20,14,6,11,1
417106,4,34,0,34,15,1
153536,2,5,7,-2,1,0
134566,1,10,0,10,10,0
124394,2,6,0,6,5,0
85600,1,6,0,6,5,1
355955,1,0,6,-6,5,0
331954,1,0,0,0,12,0
111312,1,0,0,0,16,0
236459,2,7,0,7,3,1
22277,2,0,3,-3,11,1
147992,2,0,3,-3,15,0
365703,2,7,3,4,9,1
263544,4,20,29,-9,15,1
237720,4,20,17,3,4,0
103824,3,9,0,9,13,0
205662,2,14,12,2,7,1
49994,3,28,10,18,6,0
136170,4,10,10,0,10,1
373657,2,0,12,-12,13,1
877,1,0,0,0,1,0
404730,1,7,3,4,10,0
228709,4,19,23,-4,17,0
288996,2,19,7,12,9,1
364693,2,3,0,3,9,1
287796,2,21,10,11,9,0
56993,1,0,10,-10,9,0
141669,2,23,14,9,13,0
215387,4,24,20,4,11,0
323263,4,7,17,-10,7,1
301490,3,20,12,8,15,1
311730,1,0,0,0,2,0
6047,1,0,7,-7,3,1
383805,2,3,7,-4,1,1
328687,4,30,38,-8,10,1
357957,2,14,6,8,6,0
85715,4,24,28,-4,5,1
149342,1,0,0,0,16,1
348511,2,21,7,14,2,1
62306,3,21,19,2,12,0
415932,4,10,30,-20,15,1
144145,4,23,13,10,14,1
306100,4,27,13,14,17,0
300819,4,13,33,-20,15,1
412674,3,27,10,17,14,1
369369,1,3,0,3,11,0
1027,1,7,0,7,1,0
172004,1,0,0,0,9,0
23506,3,14,14,0,11,0
127688,4,37,26,11,6,0
6140,4,7,10,-3,3,0
185394,2,0,10,-10,15,1
25171,4,20,3,17,12,0
57966,4,13,17,-4,10,1
253582,3,6,10,-4,11,0
272028,2,7,3,4,2,0
193980,1,14,0,14,1,0
51300,2,6,10,-4,7,1
374006,3,10,7,3,13,1
253744,3,24,10,14,11,0
226075,2,0,7,-7,16,1
96931,3,22,7,15,10,0
204776,3,21,21,0,6,1
116978,1,0,0,0,2,0
141294,1,0,7,-7,13,1
228614,2,10,14,-4,17,1
130794,2,13,3,10,8,0
106774,3,20,15,5,14,0
158470,2,3,7,-4,3,0
368593,4,16,6,10,11,0
16043,1,13,0,13,8,1
82028,3,10,0,10,3,0
368631,4,16,20,-4,11,1
82525,4,10,27,-17,3,1
368971,2,7,7,0,11,0
295301,4,14,5,9,12,0
198265,1,3,7,-4,3,1
91575,1,0,7,-7,8,1
253400,2,14,28,-14,11,1
34685,2,3,3,0,16,0
224712,1,0,0,0,15,1
226814,1,0,0,0,16,0
239381,1,3,7,-4,4,1
385694,5,27,27,0,1,0
304058,2,3,20,-17,16,0
351968,3,21,14,7,3,1
255397,3,24,6,18,12,1
233504,4,26,10,16,2,0
85491,2,14,9,5,5,1
271579,2,7,20,-13,2,1
416732,1,0,0,0,15,1
96852,1,10,0,10,10,1
295012,4,31,21,10,12,0
188003,3,20,14,6,16,1
353266,3,28,20,8,4,1
147483,1,0,0,0,15,1
24228,3,10,10,0,12,1
135686,3,14,10,4,10,1
310796,4,13,10,3,2,0
251838,2,7,10,-3,10,1
281593,1,7,0,7,6,0
5351,2,10,7,3,3,1
345791,4,22,10,12,17,0
419781,4,17,17,0,17,0
241486,4,17,42,-25,5,0
309377,2,0,0,0,1,1
359561,1,3,0,3,6,1
184486,2,7,7,0,14,1
340298,1,3,0,3,15,1
193846,2,24,0,24,1,0
300609,2,10,0,10,15,1
68189,2,7,7,0,14,1
334556,3,21,17,4,13,1
310965,4,3,30,-27,2,1
390803,2,0,7,-7,3,1
153682,1,2,14,-12,1,1
360740,2,17,14,3,7,0
262102,2,14,3,11,15,0
112436,3,13,13,0,17,0
340592,1,3,0,3,15,1
415034,4,10,27,-17,15,0
348617,4,34,23,11,2,0
60601,1,0,0,0,11,1
260798,2,3,12,-9,14,1
132141,3,10,3,7,9,0
130317,2,7,0,7,8,1
118263,2,12,7,5,2,0
32680,2,7,0,7,15,0
155112,4,13,33,-20,1,1
306315,2,24,7,17,17,0
30760,4,31,28,3,15,1
79977,1,0,0,0,2,1
196405,3,17,7,10,2,1
418250,1,0,0,0,16,1
104940,3,3,6,-3,14,0
88702,4,26,20,6,6,1
76932,2,14,13,1,1,0
40935,3,16,20,-4,2,0
169522,3,3,28,-25,8,1
388119,2,3,3,0,2,1
345155,4,15,9,6,17,0
234384,4,17,10,7,2,1
199030,1,0,0,0,4,0
223179,1,3,0,3,15,0
35877,1,0,0,0,17,1
175662,2,9,3,6,11,1
189050,3,14,17,-3,16,1
162704,4,23,24,-1,5,1
54682,4,27,29,-2,8,0
164583,1,0,3,-3,5,1
160369,4,3,21,-18,4,1
89581,4,7,27,-20,7,0
345566,3,7,20,-13,17,1
366141,2,7,34,-27,10,0
240504,3,6,7,-1,5,1
353237,2,14,17,-3,4,1
192734,1,0,3,-3,1,0
375440,1,7,7,0,14,0
95303,4,17,24,-7,10,0
252259,1,0,10,-10,10,1
254022,3,7,13,-6,11,1
98204,4,35,26,9,11,1
65295,2,3,21,-18,13,0
387600,4,13,3,10,2,0
301076,4,24,13,11,15,1
374211,4,30,28,2,13,0
87626,4,17,13,4,6,0
198113,1,0,0,0,3,0
175038,4,20,28,-8,10,1
348513,2,21,7,14,2,1
410151,3,17,17,0,13,1
254703,1,3,0,3,11,0
405705,2,10,0,10,10,0
183491,1,0,0,0,14,1
98518,1,0,0,0,11,1
228293,1,0,0,0,17,0
354494,3,27,28,-1,4,0
28710,3,10,13,-3,14,0
398399,4,3,30,-27,7,0
367326,4,6,20,-14,10,1
94156,2,10,7,3,9,1
339528,1,7,0,7,15,0
362706,4,3,13,-10,8,0
274591,4,24,26,-2,3,1
223763,1,0,0,0,15,1
322450,2,6,0,6,7,0
151902,2,13,7,6,17,1
5970,3,17,23,-6,3,0
250840,4,3,12,-9,10,1
386256,4,14,17,-3,2,0
139135,3,12,6,6,12,1
20237,4,27,10,17,10,0
259554,1,0,0,0,13,1
99126,1,0,0,0,11,1
208,2,6,10,-4,1,1
274115,4,20,0,20,3,0
78652,4,30,13,17,2,0
401035,4,29,15,14,8,1
347413,1,0,6,-6,1,1
24791,1,6,0,6,12,0
388247,1,3,0,3,2,0
116211,4,22,19,3,1,1
332759,3,21,9,12,12,1
43831,3,21,16,5,3,0
203184,2,7,17,-10,5,0
27676,4,14,27,-13,13,0
295134,3,7,14,-7,12,1
56648,4,26,24,2,9,1
420671,3,21,16,5,17,0
283841,1,7,0,7,7,0
327873,3,16,17,-1,10,0
271957,4,23,20,3,2,0
128459,1,14,7,7,7,1
389645,3,17,10,7,3,1
70072,4,31,17,14,15,0
222959,3,13,13,0,14,1
106889,2,9,3,6,14,0
370585,2,14,14,0,12,1
320036,4,49,36,13,6,0
250610,2,3,0,3,10,1
118392,2,6,10,-4,2,1
325593,2,7,7,0,9,1
312542,3,23,0,23,3,0
377082,2,7,7,0,15,1
369937,4,16,22,-6,12,0
404878,1,0,0,0,10,0
105298,4,10,26,-16,14,0
327444,4,3,20,-17,9,1
44908,4,7,38,-31,4,1
290705,4,41,25,16,10,1
31698,5,27,24,3,15,1
245480,4,23,6,17,7,0
380343,2,7,7,0,16,1
312101,3,30,7,23,2,0
392743,1,7,0,7,4,0
135351,2,14,10,4,10,0
231199,4,10,7,3,1,0
316614,3,9,9,0,4,0
37052,2,13,0,13,17,0
143904,1,0,0,0,14,0
155847,2,7,10,-3,2,1
135779,1,0,14,-14,10,1
32226,2,14,14,0,15,1
368391,2,14,6,8,11,0
60464,1,0,0,0,11,1
35144,2,0,7,-7,16,0
160,1,0,0,0,1,1
419113,1,9,0,9,16,1
323571,4,34,24,10,7,1
382107,3,21,3,18,17,0
337388,4,21,14,7,14,1
313530,1,0,7,-7,3,1
2351,1,0,3,-3,2,1
146225,2,0,10,-10,15,1
217078,1,0,0,0,12,0
37126,4,16,17,-1,17,0
20539,4,10,0,10,10,0
287321,2,6,0,6,8,1
113257,2,7,7,0,17,0
10169,2,6,3,3,5,0
24607,4,10,26,-16,12,0
266058,2,10,3,7,16,1
348706,3,17,10,7,2,1
222972,3,13,13,0,14,0
319372,4,23,28,-5,6,0
323790,2,6,3,3,8,1
273323,3,21,0,21,2,0
343101,4,12,20,-8,16,1
197749,3,14,17,-3,3,1
323124,4,29,14,15,7,1
51985,1,0,7,-7,7,1
287147,2,10,3,7,8,0
73563,4,9,41,-32,17,0
119060,1,0,0,0,3,0
14549,1,0,0,0,7,0
396896,4,27,20,7,6,1
336702,2,3,3,0,14,1
341510,2,3,7,-4,16,1
276566,1,0,0,0,4,0
63175,3,14,20,-6,12,1
186444,2,10,10,0,15,1
384613,3,10,49,-39,1,0
373598,4,30,33,-3,13,0
377388,2,7,6,1,15,0
445,4,45,26,19,1,1
165663,2,0,7,-7,6,1
144537,2,7,10,-3,14,1
127483,3,3,17,-14,6,1
194428,2,9,0,9,2,0
149483,1,0,6,-6,16,1
129855,2,10,0,10,7,1
311961,3,35,10,25,2,1
411763,2,0,17,-17,13,0
420404,4,20,20,0,17,0
5134,4,13,7,6,3,1
297296,1,0,0,0,13,1
122612,4,27,7,20,4,1
47010,2,17,0,17,5,0
404260,1,0,0,0,10,0
296619,2,3,7,-4,13,1
309533,2,6,0,6,1,0
120373,2,9,6,3,3,0
50512,1,0,0,0,6,0
27672,4,14,27,-13,13,0
152202,2,14,0,14,17,1
414249,2,14,21,-7,14,1
107500,3,3,20,-17,15,0
18007,3,16,21,-5,9,0
240155,2,13,3,10,5,1
184476,1,0,7,-7,14,1
90730,2,14,7,7,7,1
177610,4,17,20,-3,11,0
279759,4,30,6,24,5,0
242663,4,13,9,4,6,0
327634,4,16,22,-6,10,0
207222,4,20,20,0,7,0
189654,3,10,6,4,17,0
185495,1,0,3,-3,15,1
155507,2,20,0,20,2,0
214753,3,3,13,-10,11,0
140048,4,28,10,18,12,1
269980,3,16,13,3,1,0
295480,1,0,0,0,12,1
416837,4,19,17,2,15,1
286396,2,14,0,14,8,1
339911,3,26,0,26,15,0
225703,4,21,13,8,16,0
91227,4,20,17,3,8,0
44934,4,14,38,-24,4,0
328249,5,17,17,0,10,1
283765,3,17,3,14,7,1
282839,3,9,13,-4,6,0
137597,4,27,34,-7,11,1
417751,5,35,35,0,16,1
54182,2,0,3,-3,8,0
222769,2,10,7,3,14,0
212018,3,10,23,-13,9,0
49128,1,0,0,0,6,0
391243,1,7,0,7,4,1
3053,4,22,41,-19,2,1
357158,4,6,14,-8,5,1
172569,3,13,24,-11,9,1
174372,3,17,3,14,10,0
302630,2,17,3,14,15,0
377340,1,0,0,0,15,1
300612,2,10,0,10,15,1
161075,1,3,0,3,4,0
168118,2,9,2,7,7,0
45593,2,7,13,-6,4,0
353630,1,3,0,3,4,0
377872,3,20,7,13,15,0
11840,3,34,17,17,6,0
79692,1,7,0,7,2,0
163069,1,0,3,-3,5,0
105459,4,23,31,-8,14,0
356024,3,21,10,11,5,1
152814,4,14,10,4,17,1
270127,3,24,10,14,1,0
280096,1,7,0,7,5,1
36060,2,17,0,17,17,1
335457,3,13,9,4,13,0
52973,3,14,17,-3,7,1
262755,3,27,3,24,15,1
100706,4,21,24,-3,12,1
388252,1,3,0,3,2,0
358062,1,0,0,0,6,0
219904,1,3,0,3,13,0
87701,2,0,20,-20,6,1
384926,1,0,0,0,1,1
283677,1,0,0,0,7,1
312932,1,0,0,0,3,0
46755,2,7,3,4,4,0
421092,2,13,3,10,17,1
358006,3,24,13,11,6,1
182593,2,0,3,-3,14,0
40882,2,13,10,3,2,0
312513,2,20,0,20,3,0
56480,4,7,41,-34,9,0
111948,2,13,21,-8,17,1
390647,1,0,3,-3,3,1
406551,3,14,30,-16,11,1
386599,1,0,7,-7,2,0
323723,4,39,0,39,8,0
140976,1,6,0,6,13,1
401066,1,14,3,11,8,0
83032,1,3,0,3,4,0
351090,3,21,23,-2,3,1
354723,1,0,0,0,4,1
201285,2,14,0,14,5,0
94832,3,6,13,-7,9,0
268596,2,7,6,1,17,0
233751,3,13,24,-11,2,0
276371,3,25,35,-10,3,0
412659,3,13,10,3,14,1
294932,2,7,7,0,12,0
280373,1,3,0,3,5,0
335548,2,3,0,3,13,0
213261,4,17,22,-5,10,0
56636,4,26,17,9,9,0
13082,4,21,14,7,6,0
73913,2,14,0,14,17,1
352243,2,3,3,0,3,1
232991,3,10,10,0,2,1
261444,4,17,24,-7,14,1
138717,4,28,35,-7,12,0
90823,1,0,0,0,7,1
265339,2,7,7,0,16,0
281081,4,38,16,22,6,1
200488,4,23,18,5,4,1
403018,3,13,21,-8,9,0
54649,3,14,22,-8,8,0
159541,2,14,6,8,3,1
248126,1,0,3,-3,8,1
149087,2,14,14,0,16,1
241295,4,10,7,3,5,1
253881,3,38,14,24,11,0
413000,4,16,15,1,14,1
26682,1,0,7,-7,13,1
316526,1,0,0,0,4,0
366790,1,0,0,0,10,0
354523,4,33,28,5,4,0
101293,4,17,14,3,12,0
206521,1,0,0,0,7,1
70388,1,6,0,6,15,1
22142,2,10,6,4,11,1
46370,4,6,17,-11,4,1
357406,2,17,17,0,5,0
148553,1,0,0,0,16,0
235092,2,0,7,-7,2,1
146943,1,7,0,7,15,1
312365,2,13,17,-4,3,0
419624,3,23,16,7,17,0
286451,4,17,10,7,8,1
279078,2,14,7,7,5,1
131899,4,31,7,24,8,1
3068,1,0,0,0,2,0
88792,3,13,10,3,6,0
113261,2,7,7,0,17,0
316189,4,30,35,-5,4,1
359847,1,16,7,9,6,1
246204,3,21,6,15,7,0
318249,2,3,0,3,5,0
47891,4,21,13,8,5,0
299570,3,10,3,7,14,0
251527,2,16,13,3,10,0
139874,4,23,17,6,12,0
330853,3,13,17,-4,11,1
309339,1,0,0,0,1,0
253518,2,0,7,-7,11,0
97286,4,27,20,7,10,0
8051,2,17,7,10,4,0
318550,2,7,0,7,5,0
48398,2,3,17,-14,5,0
29773,4,41,3,38,14,1
182132,2,16,7,9,13,1
30670,1,0,0,0,15,1
408076,4,20,17,3,12,0
361291,1,0,0,0,7,0
288196,1,3,7,-4,9,0
264309,3,10,30,-20,15,1
370004,2,10,7,3,12,0
14614,2,10,7,3,7,1
325361,4,15,20,-5,8,0
273822,3,17,7,10,2,0
321395,1,14,10,4,7,0
354882,4,41,42,-1,4,1
353285,3,31,20,11,4,1
189927,2,3,7,-4,17,0
103782,2,3,0,3,13,1
331306,3,0,24,-24,11,1
379163,2,6,10,-4,16,1
380783,2,9,14,-5,16,0
301536,4,20,24,-4,15,0
406035,1,0,3,-3,11,1
247186,4,27,6,21,8,0
223390,3,7,19,-12,15,1
118185,4,31,27,4,2,1
240976,4,21,16,5,5,0
312390,3,13,27,-14,3,1
297242,3,14,6,8,13,1
405485,4,24,16,8,10,1
347936,3,0,21,-21,1,1
417435,1,0,7,-7,16,1
341916,1,0,0,0,16,0
6275,3,13,17,-4,3,1
284809,3,26,20,6,7,1
171085,4,17,40,-23,8,1
267573,4,27,27,0,17,0
380231,3,13,16,-3,16,1
305024,4,30,27,3,16,1
327884,4,23,24,-1,10,0
274201,2,10,0,10,3,0
399989,4,12,13,-1,8,0
314112,4,33,20,13,3,0
21579,3,7,17,-10,11,0
236044,3,23,3,20,3,1
328658,4,27,35,-8,10,0
164958,4,9,16,-7,6,1
327356,1,0,0,0,9,0
99538,4,10,16,-6,11,0
227843,1,7,6,1,16,0
337364,3,14,7,7,14,1
396533,2,17,7,10,6,1
98307,3,28,27,1,11,0
179000,4,19,3,16,12,1
220486,1,0,0,0,13,0
1913,1,0,0,0,1,1
290363,2,13,3,10,10,1
98896,3,7,10,-3,11,1
385337,4,17,20,-3,1,0
65831,1,0,0,0,13,0
109270,3,6,0,6,15,1
180791,3,10,20,-10,13,1
23856,4,24,7,17,12,1
101718,3,10,7,3,12,1
92219,1,0,0,0,8,1
159207,2,13,14,-1,3,1
365525,1,0,0,0,9,1
280668,2,0,3,-3,5,0
62286,3,21,13,8,12,0
6905,1,0,0,0,3,0
353372,2,6,0,6,4,0
262228,1,3,0,3,15,1
36128,4,44,7,37,17,0
404602,2,7,10,-3,10,0
325929,3,13,7,6,9,0
253883,3,38,14,24,11,0
82215,4,16,10,6,3,1
190714,4,42,17,25,17,1
151760,2,14,6,8,17,0
214432,3,7,14,-7,11,0
369662,1,12,0,12,11,1
203885,5,37,34,3,6,0
286610,4,17,38,-21,8,0
229586,3,30,13,17,17,0
71034,2,20,0,20,16,1
144489,4,17,33,-16,14,1
400889,1,0,0,0,8,1
218870,2,21,3,18,13,0
244077,3,20,27,-7,6,0
395867,4,10,17,-7,6,0
42158,1,0,0,0,2,1
403373,4,26,11,15,9,1
232718,4,20,3,17,1,1
162721,4,26,24,2,5,0
36448,1,0,3,-3,17,1
66604,2,0,14,-14,14,0
266654,3,19,3,16,16,0
30436,2,10,22,-12,14,1
219964,3,6,14,-8,13,1
112022,4,35,21,14,17,1
315574,4,7,14,-7,4,1
20870,4,28,16,12,10,1
403980,1,0,0,0,10,0
87150,3,21,10,11,5,0
378131,2,21,0,21,15,1
291398,2,7,7,0,10,0
327533,2,7,9,-2,10,0
236267,1,0,3,-3,3,1
230675,1,0,14,-14,1,1
14132,2,0,14,-14,7,0
413910,4,20,9,11,14,1
292016,2,6,9,-3,11,1
209873,3,16,16,0,8,1
266564,4,10,22,-12,16,1
30177,3,13,17,-4,14,0
8267,4,16,13,3,4,1
371539,1,0,0,0,12,1
191369,2,0,17,-17,17,0
144694,2,3,0,3,14,1
75423,2,10,7,3,17,1
110374,4,27,17,10,16,0
136092,1,0,7,-7,10,1
42912,2,7,13,-6,3,1
406839,3,7,23,-16,11,1
421784,1,0,0,0,17,0
205788,2,7,0,7,7,0
302417,4,16,19,-3,15,0
147331,1,0,0,0,15,1
191798,1,3,0,3,1,0
128673,3,6,17,-11,7,0
370661,4,21,14,7,12,0
19576,2,14,14,0,10,0
282014,4,28,28,0,6,0
245685,2,3,3,0,7,0
238748,1,0,0,0,4,0
288103,3,10,7,3,9,1
321389,1,7,10,-3,7,1
114558,4,17,40,-23,1,1
353678,2,3,7,-4,4,1
353352,1,3,0,3,4,1
77910,1,0,0,0,1,1
68011,1,0,10,-10,14,1
304406,4,31,21,10,16,0
176814,2,10,7,3,11,0
214508,4,7,23,-16,11,0
121893,4,0,26,-26,4,1
320144,3,17,7,10,6,0
20564,4,17,0,17,10,1
52391,3,9,17,-8,7,0
231148,2,3,0,3,1,1
130301,1,7,0,7,8,0
343761,1,7,3,4,17,0
65370,4,13,28,-15,13,0
349782,4,26,21,5,2,1
33819,3,0,31,-31,16,1
217468,3,9,3,6,12,1
9408,1,0,0,0,5,1
269588,1,0,0,0,1,1
168907,4,17,6,11,7,0
285356,1,0,0,0,8,1
29690,2,3,0,3,14,0
291620,4,23,13,10,11,1
350816,4,23,10,13,2,0
371945,4,34,17,17,12,0
405476,4,24,16,8,10,0
40343,3,9,7,2,2,1
343909,1,7,0,7,17,1
127758,2,7,14,-7,6,0
292856,1,7,0,7,11,1
116669,1,3,0,3,2,0
171044,3,17,23,-6,8,0
239859,2,10,3,7,4,0
63032,3,16,21,-5,12,1
246331,2,7,10,-3,7,1
325546,4,28,19,9,8,0
62830,1,3,0,3,12,0
117639,2,6,13,-7,2,1
25436,4,13,10,3,12,0
122610,4,27,7,20,4,1
147505,1,0,0,0,15,1
179798,4,6,27,-21,12,0
90508,4,0,26,-26,7,0
185075,2,0,3,-3,15,0
141790,1,7,7,0,13,1
419898,3,6,18,-12,17,0
83691,2,22,17,5,4,0
197840,1,6,0,6,3,0
403352,3,19,3,16,9,0
90692,1,6,0,6,7,1
407479,4,17,10,7,11,1
353995,1,0,0,0,4,1
149977,2,14,3,11,16,0
129677,1,0,3,-3,7,1
199739,4,35,10,25,4,1
365101,1,0,7,-7,9,1
109220,1,3,0,3,15,0
264413,3,3,21,-18,15,0
194502,4,26,10,16,2,0
303301,3,27,0,27,16,1
197814,1,6,0,6,3,0
77624,2,0,7,-7,1,0
135243,3,13,3,10,10,0
289799,4,17,10,7,10,0
108164,1,0,0,0,15,1
159008,4,33,29,4,3,0
120835,2,7,14,-7,3,0
274072,2,10,0,10,3,1
276941,2,17,14,3,4,0
7945,4,3,27,-24,4,1
222726,1,0,0,0,14,1
68272,4,27,30,-3,14,0
4200,2,10,6,4,2,1
356816,2,0,7,-7,5,0
116396,1,3,0,3,1,0
310458,3,14,3,11,2,1
331668,1,0,0,0,12,1
363591,4,10,15,-5,8,1
399164,2,7,3,4,7,0
19988,2,6,3,3,10,1
370029,3,10,13,-3,12,1
392693,4,16,0,16,4,1
162059,3,21,13,8,4,1
384604,3,10,49,-39,1,1
115747,4,13,13,0,1,1
169902,1,0,0,0,8,0
58587,3,10,10,0,10,0
411144,2,0,20,-20,13,1
201293,2,14,3,11,5,1
383767,1,0,0,0,1,1
8178,2,0,7,-7,4,1
187473,1,0,3,-3,16,0
110111,2,0,10,-10,16,1
322927,2,13,0,13,7,0
345607,4,17,23,-6,17,0
245100,2,14,6,8,7,1
76544,4,7,34,-27,1,0
242128,2,13,7,6,6,1
236562,4,10,9,1,3,1
318296,3,6,7,-1,5,1
252866,4,19,13,6,11,0
269885,1,0,0,0,1,0
88146,2,7,3,4,6,0
163506,1,7,0,7,5,0
70133,2,13,7,6,15,1
340870,1,0,0,0,15,0
408080,4,20,17,3,12,1
327376,2,0,7,-7,9,1
325438,2,13,3,10,8,1
130663,3,7,35,-28,8,0
28202,2,3,0,3,13,1
307951,2,7,6,1,1,1
38751,1,0,3,-3,1,1
225820,3,23,14,9,16,1
137404,3,6,21,-15,11,0
48636,4,27,27,0,5,0
264197,1,0,0,0,15,0
418885,3,13,10,3,16,0
205086,4,22,20,2,6,0
56171,4,27,21,6,9,1
402046,4,3,25,-22,9,0
132161,4,23,6,17,9,0
156618,2,3,0,3,2,1
174679,3,9,7,2,10,0
19264,1,7,14,-7,10,1
18457,3,7,7,0,9,1
156810,3,23,20,3,2,1
107742,2,7,7,0,15,0
159501,1,7,0,7,3,0
64891,3,10,3,7,13,1
341060,2,7,17,-10,15,1
329727,1,0,0,0,11,1
27301,2,7,3,4,13,1
176667,2,26,12,14,11,0
136493,4,17,13,4,11,1
343896,1,0,0,0,17,1
19058,4,10,6,4,10,0
19918,4,16,21,-5,10,1
392777,2,14,3,11,4,1
401558,2,17,14,3,8,1
202369,1,0,0,0,5,0
398058,2,14,21,-7,7,1
415845,2,7,13,-6,15,0
370535,1,0,0,0,12,1
99033,2,6,0,6,11,1
233623,4,23,41,-18,2,1
303971,4,14,34,-20,16,1
173879,1,6,10,-4,10,1
54851,4,23,0,23,8,0
177980,2,7,6,1,12,1
322684,4,9,9,0,7,0
418582,2,14,3,11,16,1
105249,3,7,24,-17,14,1
54610,2,7,6,1,8,1
299243,2,10,0,10,14,0
134148,1,0,3,-3,10,0
215171,2,7,9,-2,11,1
357904,4,13,34,-21,6,0
199522,2,17,0,17,4,0
108778,1,0,7,-7,15,1
355996,2,14,7,7,5,0
259681,1,0,0,0,14,1
327435,3,3,17,-14,9,0
144734,3,3,7,-4,14,1
10896,1,3,7,-4,5,1
337700,4,24,21,3,14,1
197168,3,27,27,0,3,1
135708,4,17,17,0,10,1
146340,1,3,3,0,15,0
303161,4,21,28,-7,16,1
317504,3,10,17,-7,5,0
140047,4,28,10,18,12,1
377204,1,0,0,0,15,0
142882,1,0,0,0,13,0
230486,4,28,14,14,1,0
258719,3,3,20,-17,13,1
277319,4,0,16,-16,4,1
256628,4,21,7,14,12,1
128875,1,0,0,0,7,0
189542,1,0,0,0,17,0
157278,3,13,3,10,2,0
280639,4,23,16,7,5,1
114005,1,0,0,0,17,0
282201,2,3,0,3,6,0
284846,4,29,27,2,7,0
38354,2,7,6,1,1,1
41873,1,7,3,4,2,1
325818,3,6,17,-11,9,1
414111,2,3,10,-7,14,1
398176,2,7,9,-2,7,0
96730,2,0,10,-10,10,1
392508,3,3,20,-17,4,0
375676,4,23,20,3,14,0
152934,2,14,14,0,1,0
17082,2,20,3,17,9,1
136167,4,10,10,0,10,1
359960,4,30,30,0,6,1
337025,2,13,0,13,14,1
9567,1,0,0,0,5,0
387006,4,14,27,-13,2,0
261450,4,17,24,-7,14,0
405626,4,21,28,-7,10,1
334000,3,17,13,4,12,1
39435,3,10,10,0,1,1
119040,4,7,33,-26,3,0
407158,4,17,27,-10,11,1
355952,1,0,0,0,5,1
363841,3,13,17,-4,8,0
350155,2,8,0,8,2,0
213929,1,16,7,9,10,0
139316,4,20,13,7,12,0
302768,2,3,13,-10,15,1
391938,4,30,27,3,4,0
329470,2,3,0,3,10,1
281816,3,10,0,10,6,1
73284,4,14,23,-9,16,1
311458,2,3,3,0,2,1
370152,2,17,3,14,12,0
420330,3,17,3,14,17,1
411142,2,0,20,-20,13,1
372082,1,0,0,0,13,1
316590,3,6,6,0,4,0
368520,2,3,0,3,11,1
420256,1,6,0,6,17,1
33912,2,0,10,-10,16,0
314895,2,0,0,0,4,1
304876,4,12,10,2,16,0
94841,4,6,13,-7,9,1
8602,2,6,10,-4,4,1
284469,2,14,12,2,7,0
357754,4,43,19,24,5,1
366519,1,10,7,3,10,1
164761,3,23,14,9,6,1
181358,1,14,7,7,13,1
228564,4,20,21,-1,17,1
140059,1,0,0,0,12,1
261100,3,7,14,-7,14,0
304381,3,28,21,7,16,1
420620,2,7,13,-6,17,1
170887,3,7,20,-13,8,1
114772,1,7,10,-3,1,0
181463,4,31,24,7,13,0
170266,2,0,12,-12,8,0
301579,2,7,0,7,15,0
168479,4,3,24,-21,7,0
133609,2,10,7,3,9,0
158672,3,14,7,7,3,1
343901,1,7,0,7,17,0
413739,3,21,16,5,14,1
11228,2,14,14,0,6,0
42928,2,17,16,1,3,1
6963,2,0,7,-7,3,0
377210,1,0,0,0,15,1
102281,2,10,7,3,13,1
91865,4,30,13,17,8,0
383796,2,3,7,-4,1,0
407589,3,10,17,-7,11,0
339482,4,10,26,-16,15,1
98964,4,7,24,-17,11,0
396012,4,31,20,11,6,1
171166,2,3,7,-4,8,1
356937,2,3,3,0,5,0
62194,4,13,17,-4,12,1
50019,4,28,10,18,6,1
3966,4,29,14,15,2,0
334267,3,9,7,2,13,0
243592,3,16,7,9,6,1
71234,4,22,20,2,16,0
204318,4,0,10,-10,6,0
88368,4,24,10,14,6,1
149924,1,0,0,0,16,1
100236,4,17,14,3,12,1
347695,4,27,24,3,1,0
194530,4,29,10,19,2,0
58716,2,10,17,-7,10,1
66087,4,10,3,7,13,0
169094,4,36,23,13,7,0
53380,2,3,14,-11,8,1
11995,3,24,14,10,6,1
94165,2,10,7,3,9,0
204705,1,7,7,0,6,0
98677,1,0,3,-3,11,1
415799,4,27,24,3,15,0
205821,2,14,0,14,7,1
373735,4,13,21,-8,13,1
223477,1,0,3,-3,15,1
228831,3,6,17,-11,17,1
229037,4,23,16,7,17,0
129783,4,17,24,-7,7,1
226066,1,0,7,-7,16,1
23299,2,3,10,-7,11,0
191851,3,17,10,7,1,0
327858,3,16,10,6,10,0
194271,2,7,0,7,2,1
16865,1,0,0,0,8,0
277353,2,14,0,14,4,0
261457,1,0,0,0,14,1
395344,2,14,3,11,5,0
388541,4,3,23,-20,2,1
386132,1,0,0,0,2,1
362062,2,14,7,7,8,0
131927,1,0,0,0,8,0
336201,4,24,10,14,13,1
5061,2,10,0,10,3,1
127251,1,0,0,0,6,1
29525,1,0,7,-7,14,0
178655,3,3,13,-10,12,1
176724,4,36,19,17,11,1
387637,1,0,0,0,2,0
375352,3,7,17,-10,14,1
276297,1,7,7,0,3,0
115581,3,27,9,18,1,0
84908,3,41,17,24,4,0
362034,1,0,7,-7,8,1
404876,1,0,0,0,10,0
241026,5,30,30,0,5,0
229894,4,20,14,6,17,1
36513,3,10,20,-10,17,1
177177,1,0,0,0,11,0
33814,3,0,24,-24,16,0
117952,2,7,6,1,2,1
93192,3,0,12,-12,9,0
165998,3,17,21,-4,6,1
49045,3,10,10,0,6,0
214094,2,3,3,0,11,1
399058,3,10,18,-8,7,0
68571,4,13,28,-15,14,1
137590,4,27,34,-7,11,0
209341,2,7,7,0,8,1
179578,3,7,23,-16,12,1
153730,3,2,21,-19,1,1
308131,3,13,19,-6,1,1
165477,1,0,6,-6,6,0
361295,1,0,0,0,7,0
385253,2,0,3,-3,1,0
181090,2,17,7,10,13,0
147269,3,0,24,-24,15,1
302359,3,10,10,0,15,0
231614,2,14,10,4,1,1
59082,3,3,17,-14,10,0
23935,2,16,0,16,12,1
347785,2,10,0,10,1,1
156990,4,7,13,-6,2,0
412846,4,28,35,-7,14,1
395521,3,21,14,7,6,1
53090,2,19,14,5,7,1
105942,1,7,0,7,14,1
177106,3,24,13,11,11,1
199692,2,21,7,14,4,1
263135,1,0,7,-7,15,1
101254,3,7,7,0,12,0
278749,1,0,0,0,5,1
301214,3,20,14,6,15,0
280719,3,0,6,-6,5,1
36817,3,17,20,-3,17,0
291317,4,24,22,2,10,0
248270,1,7,0,7,8,1
76936,2,14,13,1,1,1
130016,2,7,13,-6,8,0
37631,2,10,0,10,17,1
236166,2,10,10,0,3,1
378262,2,0,3,-3,15,1
329956,3,7,10,-3,11,0
106252,1,0,0,0,14,0
11950,2,7,0,7,6,0
284659,3,14,27,-13,7,0
407060,1,0,3,-3,11,1
151937,3,20,17,3,17,1
60911,1,0,0,0,11,1
238522,3,13,6,7,4,0
420224,4,3,10,-7,17,0
93356,4,30,6,24,9,0
92756,4,6,17,-11,8,0
287224,4,16,23,-7,8,0
7205,1,0,0,0,4,0
344642,2,3,10,-7,17,1
19154,2,14,10,4,10,1
78411,2,14,0,14,2,1
264376,1,3,7,-4,15,0
18660,4,27,33,-6,9,0
263829,4,7,24,-17,15,1
375286,1,7,0,7,14,0
238035,3,10,13,-3,4,0
118610,4,38,10,28,2,0
116171,3,14,13,1,1,0
168472,4,0,24,-24,7,1
230451,3,21,11,10,1,0
292205,4,21,14,7,11,0
61327,4,31,28,3,11,0
361068,3,16,9,7,7,1
50228,1,7,7,0,6,1
177204,1,0,0,0,11,1
108161,4,20,42,-22,15,1
356123,1,7,0,7,5,1
380425,4,10,24,-14,16,1
791,2,7,3,4,1,0
263530,4,20,26,-6,15,0
70936,4,15,36,-21,15,0
403893,2,10,14,-4,10,1
189840,4,27,17,10,17,0
242311,2,10,10,0,6,1
274604,4,24,26,-2,3,1
13015,3,14,7,7,6,0
18701,1,0,7,-7,9,1
363599,4,10,15,-5,8,1
255204,2,10,7,3,12,0
387192,1,0,0,0,2,1
148662,4,10,9,1,16,1
212359,4,13,9,4,10,0
185839,2,3,3,0,15,0
47827,2,7,6,1,5,1
71332,3,10,20,-10,16,0
180512,3,21,20,1,13,0
188475,4,10,9,1,16,0
311496,3,10,10,0,2,1
253773,4,24,10,14,11,0
350420,1,0,3,-3,2,1
366020,3,30,14,16,10,1
65519,4,30,14,16,13,0
207694,1,0,7,-7,7,0
77938,1,3,0,3,1,0
136402,1,3,0,3,11,0
417709,4,35,12,23,16,0
339932,4,33,0,33,15,0
254779,3,10,10,0,11,1
102795,3,10,3,7,13,0
386962,3,7,21,-14,2,1
335276,2,0,6,-6,13,0
54204,2,0,3,-3,8,1
19177,3,21,13,8,10,1
95825,2,6,10,-4,10,1
120590,3,0,20,-20,3,1
45770,3,10,14,-4,4,1
127049,4,24,23,1,6,1
1601,4,16,20,-4,1,0
114593,1,3,0,3,1,1
30416,2,10,13,-3,14,0
161628,3,30,16,14,4,0
354818,3,20,28,-8,4,1
79538,1,0,0,0,2,0
283270,2,10,9,1,7,1
335697,2,7,7,0,13,1
53559,3,14,12,2,8,0
91881,1,0,0,0,8,0
379405,1,0,0,0,16,1
334989,2,16,7,9,13,0
354495,3,27,28,-1,4,0
13934,4,21,14,7,7,1
217443,2,9,0,9,12,1
245760,3,16,17,-1,7,0
235206,1,9,0,9,3,1
377489,1,0,0,0,15,0
210305,2,9,10,-1,9,1
69065,1,0,0,0,15,1
143365,3,7,13,-6,14,0
133055,4,12,14,-2,9,1
134031,2,13,3,10,9,0
376326,1,3,0,3,14,0
334970,2,3,7,-4,13,0
337429,1,0,0,0,14,1
358634,4,27,16,11,6,0
50789,1,0,0,0,6,0
333770,1,6,7,-1,12,1
263455,2,6,13,-7,15,0
224134,2,0,17,-17,15,1
289574,2,7,13,-6,10,1
212206,4,3,24,-21,10,1
382197,1,0,3,-3,17,1
192658,3,10,7,3,1,1
217073,1,0,0,0,12,0
181720,2,7,7,0,13,0
258991,2,3,16,-13,13,0
300053,3,0,40,-40,14,1
210010,3,7,3,4,8,0
134143,1,0,0,0,10,0
134041,2,19,3,16,9,1
36787,2,7,10,-3,17,1
291322,4,24,22,2,10,0
183854,4,34,28,6,14,1
20619,1,0,0,0,10,0
256605,3,21,0,21,12,0
376362,2,3,0,3,14,1
159617,4,20,12,8,3,0
75578,2,7,3,4,17,0
218067,4,21,24,-3,12,1
157797,4,20,10,10,2,1
238348,2,10,16,-6,4,0
88316,2,14,7,7,6,1
315011,1,14,0,14,4,0
283916,3,31,17,14,7,0
52027,2,3,10,-7,7,1
254892,2,14,7,7,12,0
309479,4,17,9,8,1,1
60964,2,21,6,15,11,0
396637,4,23,17,6,6,1
371922,4,27,17,10,12,1
51341,3,16,20,-4,7,1
410185,4,20,24,-4,13,1
99308,2,13,0,13,11,0
258152,3,13,13,0,13,1
267158,4,10,10,0,17,1
335273,2,0,3,-3,13,0
32093,3,14,13,1,15,1
322760,2,3,20,-17,7,1
261676,2,7,0,7,14,1
320721,2,14,23,-9,6,1
301390,4,17,10,7,15,0
71436,2,24,6,18,16,0
291805,1,0,0,0,11,1
417303,1,0,3,-3,16,1
86040,4,25,35,-10,5,1
86575,3,30,3,27,5,0
154168,3,7,12,-5,1,0
38091,3,6,6,0,1,0
391636,4,17,31,-14,4,1
127817,3,17,28,-11,6,0
52884,4,14,58,-44,7,0
51886,2,6,10,-4,7,1
384954,2,7,0,7,1,0
339819,1,6,0,6,15,1
368135,2,10,7,3,11,0
66980,1,0,0,0,14,1
175730,3,37,12,25,11,0
79202,3,20,10,10,2,0
334102,2,10,0,10,13,0
247677,2,7,6,1,8,0
19004,2,7,0,7,10,0
275192,4,17,16,1,3,0
359191,3,13,21,-8,6,0
418216,4,38,6,32,16,0
124383,2,0,0,0,5,1
58841,1,0,0,0,10,1
284774,2,26,17,9,7,1
41655,3,17,7,10,2,1
161072,1,3,0,3,4,1
195106,4,7,29,-22,2,0
94966,2,6,6,0,9,0
369247,2,14,7,7,11,1
399095,4,10,29,-19,7,1
266363,3,24,0,24,16,0
41750,2,0,7,-7,2,1
18118,2,3,17,-14,9,0
7658,4,34,3,31,4,0
121476,2,6,0,6,4,1
347581,1,6,7,-1,1,1
319524,4,13,17,-4,6,0
320267,2,14,7,7,6,0
225590,1,0,7,-7,16,1
63495,4,31,13,18,12,0
140699,1,3,7,-4,12,1
246215,3,21,16,5,7,0
380111,4,35,30,5,16,1
71422,2,17,0,17,16,1
318996,2,0,16,-16,5,1
391696,2,3,3,0,4,0
118883,4,27,14,13,2,1
169540,3,3,28,-25,8,0
93013,3,13,3,10,8,1
249151,4,28,28,0,9,1
228338,2,0,14,-14,17,1
89559,3,0,27,-27,7,1
278453,2,22,0,22,4,0
283234,1,10,0,10,7,1
46109,4,28,21,7,4,0
20389,4,10,13,-3,10,0
172457,4,13,49,-36,9,0
266613,2,3,0,3,16,1
50226,1,7,7,0,6,1
255732,1,0,0,0,12,0
411395,4,20,13,7,13,1
137370,2,3,14,-11,11,1
289969,4,6,9,-3,10,1
269594,1,0,0,0,1,1
193129,4,13,6,7,1,1
287910,1,7,10,-3,9,1
28806,2,3,0,3,14,1
390412,3,7,27,-20,3,0
109066,1,0,0,0,15,0
327572,3,10,15,-5,10,1
331156,2,7,13,-6,11,1
88783,3,13,10,3,6,1
331475,3,9,21,-12,11,0
401141,3,34,13,21,8,0
403057,4,24,24,0,9,1
153283,3,2,7,-5,1,0
240471,2,3,7,-4,5,1
391018,3,20,27,-7,4,1
66271,1,0,0,0,14,0
154984,1,0,0,0,1,0
237237,3,13,0,13,3,0
122680,2,0,3,-3,4,1
132538,2,2,26,-24,9,0
258754,4,3,34,-31,13,0
417065,2,20,0,20,15,1
209167,1,0,7,-7,8,1
170451,3,21,3,18,8,1
105356,2,16,7,9,14,0
412980,3,16,12,4,14,1
60628,1,0,3,-3,11,1
238685,3,16,17,-1,4,1
305534,2,6,0,6,17,0
153908,4,7,6,1,1,0
76452,1,0,7,-7,1,1
128083,3,3,6,-3,7,0
150347,3,27,7,20,16,0
219574,4,21,24,-3,13,1
321290,3,9,13,-4,6,0
297956,2,20,7,13,13,1
204212,1,0,7,-7,6,1
121951,2,3,7,-4,4,0
194761,2,0,16,-16,2,0
116520,1,0,0,0,2,0
205452,1,7,0,7,6,1
14762,2,31,3,28,7,0
47289,1,0,7,-7,5,0
396176,4,24,29,-5,6,0
153328,4,2,13,-11,1,1
405539,1,0,7,-7,10,0
86027,4,25,22,3,5,1
345572,3,14,20,-6,17,0
133500,4,27,20,7,9,1
278206,3,24,21,3,4,0
334028,4,20,16,4,12,0
35318,2,13,0,13,16,1
99980,4,17,19,-2,12,1
160042,3,13,26,-13,3,1
133470,3,20,17,3,9,1
364862,3,6,14,-8,9,0
134724,1,10,0,10,10,0
315064,3,30,14,16,4,1
279164,4,24,23,1,5,0
105015,1,0,7,-7,14,1
3678,4,23,31,-8,2,1
131030,4,17,30,-13,8,0
129923,4,13,0,13,7,0
386514,3,7,14,-7,2,0
164374,3,23,3,20,5,0
325249,1,0,3,-3,8,1
246461,2,9,0,9,8,1
328973,3,30,7,23,10,0
385380,1,7,7,0,1,0
316760,2,10,7,3,4,1
181061,2,7,0,7,13,0
242352,3,27,13,14,6,1
266146,1,0,0,0,16,1
83878,3,23,17,6,4,1
221698,2,10,0,10,14,1
191504,2,14,14,0,17,0
291173,4,18,23,-5,10,1
260542,4,27,8,19,14,1
382293,4,20,3,17,17,1
306141,2,0,0,0,17,1
406930,2,0,6,-6,11,0
279828,2,7,13,-6,5,1
283959,1,0,0,0,7,0
317379,3,7,3,4,5,0
282700,3,6,20,-14,6,0
191679,2,7,10,-3,17,0
15760,2,0,5,-5,8,0
186272,2,13,3,10,15,1
101785,5,13,13,0,12,0
138842,3,12,33,-21,12,0
267800,2,10,7,3,17,0
173430,2,0,7,-7,10,1
46741,2,7,3,4,4,1
49980,3,21,7,14,6,0
100533,4,17,20,-3,12,1
50675,1,0,0,0,6,0
35468,2,7,7,0,17,1
306681,1,0,0,0,17,1
382241,2,17,3,14,17,0
62433,3,0,13,-13,12,1
129632,4,23,23,0,7,0
294519,3,17,13,4,12,1
25219,1,0,0,0,12,0
280583,3,17,6,11,5,0
327797,1,0,9,-9,10,0
1759,1,0,0,0,1,1
104536,4,14,38,-24,13,1
367467,4,35,24,11,10,1
189445,2,7,0,7,17,1
279231,2,13,13,0,5,1
290092,4,13,9,4,10,1
256771,3,10,13,-3,12,0
258639,4,13,13,0,13,1
183289,4,22,20,2,14,1
361486,2,7,0,7,7,0
94991,3,6,16,-10,9,1
60565,4,30,34,-4,11,1
251491,2,16,3,13,10,0
381666,2,17,0,17,17,0
137086,3,17,3,14,11,1
292422,1,3,0,3,11,0
370436,2,10,6,4,12,1
303862,1,0,7,-7,16,1
124826,2,0,3,-3,5,0
295277,3,14,5,9,12,0
47336,2,0,10,-10,5,1
118072,1,3,6,-3,2,0
315551,4,7,14,-7,4,0
33826,3,0,31,-31,16,1
210675,4,20,31,-11,9,1
127386,4,17,23,-6,6,1
366856,3,3,6,-3,10,0
287654,3,3,10,-7,9,1
114076,3,21,0,21,17,1
338067,2,0,7,-7,14,0
392152,2,0,13,-13,4,0
385289,3,7,19,-12,1,1
310492,3,20,9,11,2,1
387385,2,21,7,14,2,1
10820,3,21,7,14,5,1
16164,1,0,0,0,8,1
135996,3,3,10,-7,10,1
13032,3,14,7,7,6,1
228619,2,10,14,-4,17,0
23789,2,17,0,17,12,0
119451,3,7,17,-10,3,1
83741,4,22,23,-1,4,1
378419,2,7,0,7,15,0
218629,3,10,30,-20,13,1
275712,1,0,0,0,3,0
4831,4,34,3,31,3,0
210531,1,0,0,0,9,1
303588,2,21,13,8,16,1
6900,1,0,0,0,3,1
183826,3,26,21,5,14,1
169366,3,6,14,-8,8,0
306730,2,10,17,-7,17,1
149730,3,34,0,34,16,1
224637,3,16,10,6,15,1
13460,3,3,21,-18,7,1
295260,3,14,5,9,12,1
99201,3,17,10,7,11,0
80459,1,2,0,2,3,1
143465,2,14,7,7,14,0
99661,4,26,3,23,11,0
367200,4,29,26,3,10,0
418570,2,14,3,11,16,1
5507,2,10,10,0,3,0
121347,2,7,0,7,3,0
419981,2,3,0,3,17,0
175627,1,0,0,0,11,0
236478,2,7,3,4,3,0
364464,4,42,28,14,9,0
204844,1,3,0,3,6,0
265696,4,12,18,-6,16,1
374682,2,0,6,-6,14,0
416992,4,10,17,-7,15,0
2598,4,10,27,-17,2,1
406472,1,0,6,-6,11,1
92259,2,10,0,10,8,1
271518,4,28,0,28,1,1
199323,1,0,0,0,4,0
395508,3,21,14,7,6,0
347768,2,7,0,7,1,0
123005,2,0,13,-13,4,0
338105,4,6,7,-1,14,1
45225,4,14,10,4,4,1
296154,2,13,6,7,13,0
126621,5,23,23,0,6,1
119201,4,16,7,9,3,0
292317,2,12,10,2,11,0
75812,4,42,32,10,1,0
102317,3,13,10,3,13,1
166797,4,23,16,7,6,0
308397,2,0,12,-12,1,1
353166,4,20,29,-9,3,1
268631,3,14,13,1,17,0
167074,3,13,31,-18,7,1
164893,2,0,3,-3,6,0
288085,2,10,0,10,9,0
136487,4,17,13,4,11,0
280520,1,7,0,7,5,1
133128,2,7,3,4,9,0
174188,2,3,16,-13,10,0
361231,3,7,20,-13,7,1
421832,2,0,13,-13,17,1
119338,4,14,16,-2,3,0
202510,1,0,0,0,5,0
402959,1,7,7,0,9,0
363531,2,3,5,-2,8,1
286149,4,24,17,7,8,0
18202,4,29,20,9,9,0
261771,4,28,7,21,14,1
75940,4,32,7,25,1,1
137148,4,31,6,25,11,1
88582,1,3,7,-4,6,1
83093,3,6,21,-15,4,0
419540,1,0,7,-7,17,1
28644,2,0,7,-7,14,1
16010,4,18,14,4,8,1
199336,1,0,0,0,4,0
181212,2,0,0,0,13,0
151414,1,0,0,0,17,1
39078,1,6,0,6,1,1
216555,4,37,11,26,12,0
327217,1,0,3,-3,9,0
345546,2,7,17,-10,17,1
137397,3,6,21,-15,11,0
158040,2,0,6,-6,3,1
192581,1,3,0,3,1,0
91937,2,3,10,-7,8,1
374215,1,0,0,0,13,1
278265,1,0,0,0,4,0
351308,1,7,0,7,3,0
19842,2,10,7,3,10,0
371358,4,42,10,32,12,0
200654,4,35,28,7,4,0
209264,4,27,7,20,8,1
152056,2,3,7,-4,17,1
384087,1,0,7,-7,1,0
233936,4,17,13,4,2,1
263989,4,23,7,16,15,0
83513,2,0,7,-7,4,0
34743,3,12,3,9,16,1
327434,3,3,17,-14,9,0
284938,2,7,14,-7,7,1
65518,4,30,14,16,13,0
306302,2,17,6,11,17,0
43551,3,17,3,14,3,1
257014,2,0,7,-7,12,0
339147,3,10,13,-3,15,1
160496,3,20,7,13,4,1
212860,1,0,0,0,10,0
254178,3,3,18,-15,11,1
405103,2,0,10,-10,10,0
30209,4,13,31,-18,14,1
353206,1,0,7,-7,4,1
247418,2,3,9,-6,8,0
52710,3,3,20,-17,7,1
139627,4,9,14,-5,12,0
262748,3,21,0,21,15,0
258212,1,0,0,0,13,0
178829,3,24,14,10,12,1
94707,4,31,43,-12,9,1
193126,3,13,6,7,1,1
189524,4,20,0,20,17,0
376224,3,10,14,-4,14,0
321178,3,3,19,-16,6,0
48564,2,14,14,0,5,0
414660,1,0,0,0,14,0
240424,1,0,0,0,5,1
72747,1,7,0,7,16,1
287152,2,10,3,7,8,0
49039,3,10,10,0,6,0
84666,1,0,0,0,4,1
303946,4,14,31,-17,16,1
406936,2,0,13,-13,11,1
178641,2,3,10,-7,12,1
138433,2,7,0,7,12,0
97527,3,16,0,16,10,1
95386,2,21,0,21,10,0
225055,2,0,14,-14,15,1
249404,3,18,15,3,9,0
63498,4,31,13,18,12,0
133288,2,7,0,7,9,0
247777,4,10,6,4,8,0
220771,1,0,0,0,14,0
167104,4,16,34,-18,7,1
49423,4,20,20,0,6,1
176108,1,7,0,7,11,0
404244,4,19,16,3,10,0
298353,2,0,7,-7,14,0
232830,4,16,17,-1,2,0
354586,1,0,7,-7,4,0
199702,3,21,7,14,4,1
399912,2,0,6,-6,8,0
249965,1,0,3,-3,9,0
33163,4,17,42,-25,16,0
330622,1,0,0,0,11,1
358366,1,9,7,2,6,0
321255,1,6,3,3,6,0
333621,1,0,0,0,12,0
185775,4,25,3,22,15,1
220295,4,23,9,14,13,1
208828,4,6,22,-16,8,0
150560,2,3,3,0,17,0
130600,1,7,7,0,8,1
370491,3,20,9,11,12,1
172487,1,0,0,0,9,1
68120,4,3,10,-7,14,1
83884,4,23,17,6,4,1
134398,1,0,0,0,10,1
152296,1,0,0,0,17,0
146311,1,0,0,0,15,0
336511,1,0,0,0,14,0
318477,4,31,7,24,5,0
358272,2,0,14,-14,6,1
184835,3,24,20,4,15,0
30373,4,17,20,-3,14,0
198710,4,15,27,-12,3,0
221705,2,10,0,10,14,0
287596,1,0,3,-3,9,1
195223,3,16,10,6,2,1
55039,1,7,0,7,8,0
263417,1,0,13,-13,15,1
191185,1,0,10,-10,17,1
275074,4,34,20,14,3,0
336699,2,3,3,0,14,0
31705,1,0,0,0,15,1
228208,3,10,27,-17,17,0
157532,1,0,0,0,2,1
252375,4,0,29,-29,10,1
152272,4,21,0,21,17,1
47140,1,3,0,3,5,1
384821,2,6,3,3,1,0
421782,1,0,0,0,17,0
262261,2,3,6,-3,15,0
2981,2,10,17,-7,2,1
246308,2,7,3,4,7,0
397351,4,3,24,-21,6,1
73587,1,0,0,0,17,1
127580,1,0,9,-9,6,1
46783,3,14,20,-6,4,0
388191,4,6,13,-7,2,0
161225,2,7,3,4,4,0
346123,4,18,12,6,1,0
227215,4,16,17,-1,16,0
226321,3,19,7,12,16,1
388741,2,11,0,11,3,1
241200,1,0,0,0,5,0
202679,1,0,6,-6,5,0
409263,3,13,13,0,12,0
386279,4,14,20,-6,2,1
194810,4,10,26,-16,2,0
175983,2,14,0,14,11,0
16951,3,27,20,7,8,0
120775,4,23,6,17,3,1
120401,2,16,9,7,3,1
283296,3,10,9,1,7,1
381564,4,28,16,12,17,0
134029,2,13,3,10,9,0
312765,1,0,0,0,3,1
398108,4,24,28,-4,7,0
149560,3,14,16,-2,16,0
274849,2,0,10,-10,3,1
331910,4,0,16,-16,12,1
374471,4,32,7,25,14,1
377292,4,14,14,0,15,1
126458,1,0,3,-3,6,0
60176,1,3,0,3,11,0
31890,2,6,7,-1,15,1
113035,3,13,16,-3,17,1
315145,1,7,7,0,4,0
279671,2,23,0,23,5,0
375842,4,20,7,13,14,1
253383,2,7,21,-14,11,1
33634,1,7,0,7,16,0
197403,1,13,0,13,3,0
351586,4,0,27,-27,3,1
191153,4,28,27,1,17,0
183504,1,7,0,7,14,0
317005,1,0,10,-10,4,1
312882,4,14,7,7,3,0
305740,3,9,10,-1,17,0
163280,3,13,6,7,5,0
85234,4,17,17,0,4,0
393609,4,7,26,-19,5,0
224274,2,6,9,-3,15,1
11283,4,17,28,-11,6,0
125059,4,3,32,-29,5,1
266871,5,17,17,0,16,1
234016,2,14,0,14,2,1
328631,3,20,35,-15,10,0
182465,2,7,0,7,14,0
245416,3,9,3,6,7,0
168168,3,19,12,7,7,1
342299,4,20,3,17,16,1
344094,2,3,3,0,17,1
226399,1,0,7,-7,16,1
5435,4,20,23,-3,3,1
173225,4,20,24,-4,9,0
399208,3,13,13,0,7,1
340787,3,17,10,7,15,0
126205,3,21,6,15,6,0
275406,1,6,7,-1,3,1
384119,2,7,17,-10,1,0
307362,3,16,22,-6,17,0
15300,1,0,0,0,8,0
13923,3,21,7,14,7,0
66058,3,7,3,4,13,0
360526,1,0,7,-7,7,1
329102,3,17,7,10,10,1
54309,1,7,2,5,8,0
226734,2,7,6,1,16,0
420524,3,3,42,-39,17,1
18015,3,16,21,-5,9,0
326700,4,23,13,10,9,0
345397,2,0,10,-10,17,1
95148,3,23,17,6,9,0
329260,4,31,13,18,10,0
292223,4,24,17,7,11,0
100414,4,12,20,-8,12,0
271332,4,16,24,-8,1,0
107127,4,40,12,28,15,0
225215,3,3,7,-4,15,0
204986,1,9,0,9,6,0
404175,2,9,7,2,10,1
399369,3,27,7,20,7,0
183388,2,17,3,14,14,0
404950,3,6,13,-7,10,1
191347,1,0,14,-14,17,0
108335,1,0,7,-7,15,1
109806,1,9,0,9,16,1
295992,1,3,0,3,13,0
101004,4,13,16,-3,12,1
28332,1,0,0,0,14,1
5013,1,0,0,0,3,0
270568,3,13,14,-1,1,1
142719,2,3,7,-4,13,1
207225,4,20,20,0,7,0
218987,1,14,0,14,13,0
217709,2,7,0,7,12,1
318609,3,10,13,-3,5,1
359161,3,7,7,0,6,1
193095,2,13,6,7,1,0
349395,1,0,0,0,2,1
38406,3,17,16,1,1,1
13657,4,19,17,2,7,1
373400,3,10,10,0,13,1
303305,3,27,0,27,16,1
418991,2,7,7,0,16,0
377708,3,25,7,18,15,1
72645,2,13,3,10,16,1
369551,2,14,0,14,11,0
48034,4,10,27,-17,5,1
340674,3,16,13,3,15,0
101443,4,18,10,8,12,1
211018,2,17,0,17,9,0
357316,4,14,19,-5,5,0
387155,4,10,41,-31,2,0
345763,4,16,10,6,17,1
88571,1,3,6,-3,6,0
297367,2,6,10,-4,13,1
174273,1,0,0,0,10,0
314842,4,35,14,21,4,0
135419,4,28,24,4,10,0
279799,1,7,3,4,5,1
326537,4,44,9,35,9,0
320455,3,17,10,7,6,1
118014,4,20,6,14,2,1
28908,1,0,0,0,14,0
119171,4,10,7,3,3,1
95019,4,13,16,-3,9,1
72548,4,19,24,-5,16,0
399021,2,10,9,1,7,0
298108,3,3,31,-28,13,1
136205,4,13,10,3,10,0
204917,3,13,19,-6,6,1
351248,4,28,17,11,3,0
374962,1,7,6,1,14,0
134261,4,10,23,-13,10,0
382236,2,10,3,7,17,1
193348,1,7,7,0,1,1
117735,1,0,0,0,2,0
389870,1,0,0,0,3,1
363820,2,13,10,3,8,1
332408,1,7,3,4,12,0
70170,3,27,13,14,15,0
44028,4,3,28,-25,3,1
358592,3,20,9,11,6,1
330122,4,0,13,-13,11,0
407103,2,0,20,-20,11,1
174055,3,0,26,-26,10,0
343875,4,26,6,20,17,1
304234,3,33,14,19,16,1
381939,2,0,13,-13,17,1
342335,4,23,12,11,16,0
214429,3,7,14,-7,11,1
376802,2,14,7,7,15,0
158042,2,3,6,-3,3,1
173507,3,10,20,-10,10,0
37065,2,13,7,6,17,0
270471,4,13,7,6,1,0
274585,3,24,23,1,3,0
285938,3,23,7,16,8,1
207642,4,42,10,32,7,0
56308,3,3,26,-23,9,1
161695,1,7,0,7,4,1
233282,2,7,10,-3,2,1
110753,2,3,3,0,16,0
305305,4,42,21,21,16,0
159490,1,7,0,7,3,0
65841,1,0,0,0,13,0
34047,1,0,0,0,16,1
252056,4,14,20,-6,10,0
308155,4,16,19,-3,1,0
4125,4,26,28,-2,2,0
71665,4,3,34,-31,16,1
18212,4,29,20,9,9,1
414866,3,21,7,14,15,0
40695,1,7,7,0,2,0
36139,4,44,7,37,17,1
13759,3,0,20,-20,7,1
403920,3,20,14,6,10,0
266659,3,19,3,16,16,1
69679,1,0,7,-7,15,1
257436,4,23,21,2,13,1
137635,5,37,34,3,11,0
403623,3,24,13,11,9,0
349824,1,0,0,0,2,0
123028,3,7,13,-6,4,0
409055,1,3,7,-4,12,1
208347,3,17,24,-7,8,0
186124,1,3,0,3,15,0
281001,2,14,13,1,6,1
158481,2,3,7,-4,3,1
83025,1,0,0,0,4,1
255432,4,24,6,18,12,1
379537,1,7,3,4,16,0
366865,3,3,6,-3,10,1
68346,2,3,7,-4,14,1
6672,3,3,13,-10,3,0
232910,1,0,3,-3,2,0
357306,4,14,19,-5,5,1
76495,2,0,20,-20,1,1
185607,3,13,20,-7,15,1
344608,1,0,0,0,17,0
194719,1,0,3,-3,2,1
134667,4,34,24,10,10,0
229813,1,6,0,6,17,0
117519,3,17,17,0,2,1
405646,4,24,28,-4,10,1
47477,1,3,3,0,5,0
111174,1,7,0,7,16,0
95364,1,7,0,7,10,1
335662,1,7,0,7,13,0
156778,2,14,7,7,2,1
295118,3,7,14,-7,12,0
300373,4,10,7,3,14,0
287701,4,9,13,-4,9,1
328891,2,3,0,3,10,1
51904,3,13,10,3,7,1
113446,3,0,7,-7,17,1
299995,2,0,14,-14,14,0
286085,3,10,3,7,8,0
256400,2,9,7,2,12,0
47909,1,0,0,0,5,1
150365,4,30,7,23,16,0
384291,2,6,0,6,1,1
283793,4,21,3,18,7,0
167841,2,7,13,-6,7,1
383157,4,26,17,9,17,0
379589,2,16,6,10,16,0
258344,4,41,39,2,13,1
206455,3,17,0,17,7,1
227113,1,0,0,0,16,0
83047,2,6,14,-8,4,1
277823,2,7,7,0,4,1
391074,1,0,6,-6,4,0
34666,1,0,0,0,16,0
374648,1,0,0,0,14,1
197634,4,32,0,32,3,1
402486,4,26,15,11,9,1
163964,4,26,19,7,5,0
148646,4,10,9,1,16,0
302422,1,0,0,0,15,0
106678,1,0,0,0,14,1
393213,2,7,6,1,5,1
104867,1,0,3,-3,14,0
396310,4,6,13,-7,6,1
360593,2,7,10,-3,7,1
55202,1,7,0,7,9,1
175529,2,3,0,3,11,1
383182,1,7,0,7,17,0
123325,2,21,7,14,4,0
175419,3,17,20,-3,11,1
48189,4,10,19,-9,5,1
202103,2,13,3,10,5,1
38488,1,10,3,7,1,0
315534,3,7,14,-7,4,1
381956,2,0,13,-13,17,0
267502,2,6,14,-8,17,0
324008,4,17,22,-5,8,1
213351,2,10,6,4,10,1
359411,1,0,0,0,6,1
117778,2,3,6,-3,2,1
187787,1,7,0,7,16,0
19021,3,7,3,4,10,0
325932,3,13,7,6,9,0
369628,4,23,14,9,11,0
68080,3,3,10,-7,14,1
18924,4,9,20,-11,9,0
417261,4,20,23,-3,16,1
245524,1,21,0,21,7,1
280018,3,3,20,-17,5,1
128121,4,13,6,7,7,1
257082,3,7,14,-7,12,1
353677,2,3,6,-3,4,0
143999,4,14,10,4,14,1
201979,3,3,7,-4,5,1
228352,2,7,17,-10,17,0
363760,4,29,27,2,8,1
396017,4,38,20,18,6,0
258646,1,0,0,0,13,0
35016,2,9,0,9,16,0
263765,2,0,7,-7,15,0
304390,4,31,21,10,16,0
6482,1,0,0,0,3,0
322001,1,3,0,3,7,0
314098,4,33,20,13,3,0
86868,3,9,23,-14,5,0
158842,4,20,3,17,3,1
413800,1,7,0,7,14,1
291780,4,9,17,-8,11,0
26501,4,30,29,1,13,1
368303,4,9,6,3,11,0
37970,4,17,14,3,1,0
34180,4,10,10,0,16,1
259283,2,13,7,6,13,0
138991,3,14,9,5,12,0
415304,2,0,14,-14,15,1
344440,4,28,24,4,17,1
206478,4,24,0,24,7,1
350310,2,14,3,11,2,1
175837,2,20,17,3,11,1
17467,1,0,0,0,9,1
185629,4,20,27,-7,15,1
34814,1,0,0,0,16,1
85282,1,0,3,-3,5,1
302615,2,10,3,7,15,0
286061,2,10,0,10,8,0
415062,4,13,34,-21,15,0
341781,1,0,3,-3,16,1
419833,1,0,3,-3,17,0
204884,2,3,10,-7,6,0
361766,2,14,0,14,7,0
63739,2,7,12,-5,12,0
358938,4,14,38,-24,6,1
63899,3,6,21,-15,12,0
333590,4,24,23,1,12,0
64781,4,31,7,24,13,1
379297,2,0,3,-3,16,0
154091,1,0,0,0,1,0
139620,4,9,14,-5,12,0
219485,2,0,21,-21,13,1
226591,2,10,3,7,16,1
78729,2,13,7,6,2,1
400398,3,24,10,14,8,1
320797,4,17,26,-9,6,1
246018,2,7,3,4,7,0
148135,2,3,7,-4,16,0
256531,1,0,0,0,12,1
381746,1,0,0,0,17,1
58495,1,0,0,0,10,0
225691,4,21,13,8,16,1
171452,2,7,3,4,9,1
126052,2,7,3,4,6,0
308638,4,34,22,12,1,1
2919,1,7,7,0,2,0
257027,2,0,14,-14,12,0
128809,3,13,13,0,7,0
61109,2,0,7,-7,11,1
351615,1,0,7,-7,3,0
356872,4,16,16,0,5,1
149551,3,14,9,5,16,0
198941,3,13,16,-3,3,0
161119,2,3,19,-16,4,1
218556,1,0,14,-14,13,1
395733,4,26,37,-11,6,1
353807,1,7,0,7,4,1
9908,2,0,3,-3,5,1
355425,3,13,10,3,4,0
110612,3,17,10,7,16,0
323212,3,7,3,4,7,1
153066,1,0,10,-10,1,1
7953,4,9,27,-18,4,0
250148,2,16,0,16,9,1
159726,2,7,10,-3,3,0
26981,1,7,0,7,13,0
223432,4,20,26,-6,15,0
171268,1,0,0,0,9,1
316632,4,9,12,-3,4,1
113220,4,44,22,22,17,1
367151,3,29,16,13,10,0
101132,4,13,23,-10,12,0
128904,1,2,3,-1,7,1
355379,1,3,3,0,4,1
375720,1,3,0,3,14,1
229158,4,19,7,12,17,0
397086,4,24,22,2,6,0
354088,3,19,0,19,4,1
401267,2,10,14,-4,8,1
280854,3,10,3,7,6,0
317021,2,0,10,-10,4,1
280950,1,0,0,0,6,0
405362,1,0,0,0,10,0
306642,4,14,27,-13,17,0
272752,4,15,10,5,2,1
125627,3,14,24,-10,5,1
222375,4,24,3,21,14,0
124827,2,0,3,-3,5,0
339308,3,38,7,31,15,1
207727,2,3,13,-10,7,1
394938,4,7,17,-10,5,0
30189,3,13,17,-4,14,1
245374,2,9,3,6,7,1
155098,3,6,33,-27,1,0
50481,4,17,17,0,6,1
147482,1,0,0,0,15,1
178734,4,11,26,-15,12,1
71107,1,6,0,6,16,0
232328,2,6,3,3,1,1
218973,1,0,0,0,13,1
386689,4,17,13,4,2,1
411463,2,10,17,-7,13,0
418038,4,28,35,-7,16,0
246214,3,21,13,8,7,0
181138,4,24,14,10,13,1
155051,2,6,12,-6,1,0
232368,3,13,15,-2,1,1
301590,2,7,3,4,15,1
117076,3,7,17,-10,2,0
81759,4,31,17,14,3,0
200921,4,27,7,20,4,1
174855,3,16,17,-1,10,1
419154,2,10,3,7,16,1
515,2,7,13,-6,1,1
28728,4,10,13,-3,14,0
250658,3,3,22,-19,10,1
401654,1,0,7,-7,8,0
407523,1,3,0,3,11,1
108572,4,17,14,3,15,1
300633,3,10,3,7,15,0
390494,1,7,0,7,3,1
15083,3,10,26,-16,7,1
206099,2,20,6,14,7,0
406789,2,0,17,-17,11,1
407801,4,17,7,10,11,0
55085,2,16,3,13,8,1
378592,3,17,13,4,15,0
13692,1,0,7,-7,7,1
185416,3,7,10,-3,15,1
120780,4,23,6,17,3,1
212111,1,3,7,-4,10,1
114207,2,3,0,3,1,0
112068,1,7,0,7,17,1
405686,1,3,0,3,10,1
38837,3,3,10,-7,1,0
394622,3,17,7,10,5,0
372166,3,9,10,-1,13,0
142379,4,7,6,1,13,1
401459,4,24,10,14,8,1
106388,1,0,0,0,14,1
87449,4,20,10,10,6,0
243505,4,10,37,-27,6,1
266236,3,31,19,12,16,1
394104,1,0,0,0,5,1
395079,3,3,30,-27,5,0
235589,4,27,13,14,3,1
263686,4,27,13,14,15,1
392128,1,0,13,-13,4,0
293254,3,23,7,16,11,0
310408,1,7,0,7,2,1
164535,4,23,16,7,5,0
303225,5,31,34,-3,16,0
206862,2,3,10,-7,7,0
156829,3,23,20,3,2,0
319685,3,33,3,30,6,0
266393,3,36,8,28,16,0
184930,2,0,10,-10,15,1
351181,2,14,0,14,3,0
114261,4,10,24,-14,1,1
249904,3,12,20,-8,9,1
344716,3,6,27,-21,17,0
230830,1,0,0,0,1,0
162910,1,0,0,0,5,1
383752,1,0,0,0,1,0
33228,2,10,0,10,16,1
96128,2,0,16,-16,10,1
204608,3,0,38,-38,6,1
320794,4,17,26,-9,6,1
387403,2,21,10,11,2,1
59829,4,15,16,-1,11,1
90390,1,0,6,-6,7,1
221640,4,23,21,2,14,0
275186,3,14,16,-2,3,1
413736,3,21,16,5,14,1
243918,3,19,6,13,6,0
380725,4,7,16,-9,16,0
133551,1,0,0,0,9,0
347446,2,6,13,-7,1,0
308280,4,13,16,-3,1,0
381756,1,0,0,0,17,0
238774,1,7,0,7,4,1
353900,3,17,28,-11,4,1
212412,1,0,0,0,10,1
225027,1,0,0,0,15,0
281620,2,21,0,21,6,1
162476,2,7,3,4,4,0
419282,2,0,10,-10,16,1
55338,5,20,20,0,9,0
329850,4,24,26,-2,11,0
252344,3,0,22,-22,10,0
294758,1,0,7,-7,12,1
26873,2,10,6,4,13,0
269914,1,7,0,7,1,0
339157,4,20,13,7,15,0
289128,2,13,0,13,9,0
310601,2,13,20,-7,2,0
304700,4,21,7,14,16,0
183569,3,20,17,3,14,0
67011,2,0,0,0,14,1
394678,4,24,21,3,5,1
297589,4,21,7,14,13,1
365814,1,0,0,0,9,1
60544,3,30,27,3,11,1
196209,1,7,3,4,2,1
59710,1,0,0,0,11,0
331561,2,7,20,-13,11,1
75731,2,21,16,5,1,1
397859,2,0,0,0,7,0
102596,2,5,6,-1,13,0
254580,2,7,7,0,11,0
79961,4,13,23,-10,2,1
348149,4,24,22,2,1,1
64426,2,0,6,-6,13,0
339261,2,21,0,21,15,1
197847,2,8,7,1,3,0
173249,1,0,0,0,10,1
217280,2,0,7,-7,12,1
38971,3,30,3,27,1,0
161682,1,7,0,7,4,0
246749,2,3,3,0,8,1
416274,1,7,3,4,15,1
22060,4,24,24,0,11,0
61698,3,17,10,7,12,0
56472,4,6,41,-35,9,1
371297,2,14,10,4,12,0
146525,2,7,10,-3,15,1
363152,4,17,3,14,8,0
23948,3,16,0,16,12,0
12349,1,0,0,0,6,1
93628,4,19,6,13,9,1
62293,3,21,19,2,12,1
200347,4,30,14,16,4,1
270043,1,0,3,-3,1,1
123696,4,10,31,-21,4,0
6663,2,3,13,-10,3,0
93343,4,27,6,21,9,1
9389,4,31,14,17,5,1
27986,4,30,17,13,13,0
319243,1,0,0,0,6,1
56502,1,10,0,10,9,1
252385,4,6,29,-23,10,0
319218,4,17,17,0,5,0
111770,1,3,7,-4,17,1
408481,3,7,3,4,12,0
61749,4,24,38,-14,12,0
175725,3,30,6,24,11,1
34635,4,24,10,14,16,1
9265,1,7,0,7,5,0
375953,3,17,12,5,14,1
30383,1,0,7,-7,14,1
24038,1,0,0,0,12,0
20105,1,3,0,3,10,1
119443,3,7,14,-7,3,0
277378,2,17,9,8,4,0
412173,2,14,3,11,13,0
43822,3,14,16,-2,3,1
411076,4,17,17,0,13,0
213123,4,20,6,14,10,1
266407,4,36,8,28,16,1
53345,1,3,6,-3,8,0
296374,4,13,28,-15,13,0
365350,4,17,19,-2,9,1
19927,4,16,21,-5,10,1
181233,2,0,0,0,13,0
307418,1,7,0,7,17,0
343698,4,18,10,8,17,1
262529,4,35,35,0,15,0
82742,2,3,6,-3,3,1
151803,3,21,16,5,17,1
379401,1,0,0,0,16,0
165331,1,0,0,0,6,1
87824,2,10,6,4,6,0
74294,4,10,30,-20,17,1
223420,4,13,26,-13,15,1
134016,2,6,0,6,9,0
387791,1,3,0,3,2,0
210829,1,0,0,0,9,1
30932,4,10,24,-14,15,1
143564,4,26,28,-2,14,1
351680,3,7,10,-3,3,0
398131,4,30,42,-12,7,0
336171,3,17,3,14,13,1
199458,4,22,17,5,4,0
220732,4,13,6,7,13,0
232079,4,0,33,-33,1,1
3478,3,3,30,-27,2,1
281119,1,0,0,0,6,0
364823,2,3,7,-4,9,0
233237,1,0,3,-3,2,0
98242,2,7,17,-10,11,1
272857,2,20,7,13,2,1
142499,3,27,10,17,13,0
8871,1,14,0,14,4,0
59349,3,0,9,-9,11,1
163002,3,9,3,6,5,1
242211,4,23,13,10,6,0
370463,3,13,6,7,12,0
330807,2,10,10,0,11,0
222672,3,14,24,-10,14,0
408667,4,28,17,11,12,1
379300,2,0,6,-6,16,0
309886,4,24,7,17,1,0
193019,5,20,20,0,1,0
380392,3,10,17,-7,16,1
294936,2,7,7,0,12,1
200840,1,0,0,0,4,1
209324,2,0,7,-7,8,1
258946,1,0,7,-7,13,1
8205,2,0,7,-7,4,0
358846,2,3,7,-4,6,1
311166,1,3,0,3,2,1
327781,1,0,0,0,10,1
219836,3,38,0,38,13,1
186435,2,10,10,0,15,0
169606,1,6,0,6,8,1
170112,2,7,3,4,8,1
256368,1,6,0,6,12,0
40348,4,9,7,2,2,0
39558,2,0,6,-6,1,1
283433,3,20,7,13,7,0
14393,1,0,0,0,7,1
179089,2,6,6,0,12,0
145445,2,9,14,-5,14,1
252479,3,7,22,-15,10,1
141787,1,7,7,0,13,1
255682,3,3,7,-4,12,0
180340,3,12,7,5,13,0
20241,4,27,10,17,10,1
167883,3,14,16,-2,7,1
33946,2,0,27,-27,16,1
399045,2,10,12,-2,7,0
147076,2,7,14,-7,15,0
350903,3,3,14,-11,3,0
413597,3,9,17,-8,14,0
277176,1,0,0,0,4,0
255729,1,0,0,0,12,0
386405,4,20,15,5,2,0
207852,2,7,0,7,8,1
340065,4,17,12,5,15,0
281516,3,17,13,4,6,0
275205,4,17,16,1,3,0
200140,3,7,24,-17,4,0
27242,4,22,7,15,13,1
229754,4,20,17,3,17,0
48859,2,6,0,6,5,1
289953,4,6,6,0,10,0
58919,3,20,32,-12,10,0
140748,3,15,14,1,12,0
283159,3,13,9,4,7,1
201587,1,0,0,0,5,1
302412,4,16,19,-3,15,0
388103,1,3,0,3,2,0
123527,3,10,10,0,4,1
193358,1,7,10,-3,1,1
281178,3,21,13,8,6,1
116336,4,40,13,27,1,0
237215,2,3,0,3,3,1
155489,1,7,0,7,2,0
57493,2,21,10,11,10,0
321034,3,10,7,3,6,1
268492,4,23,9,14,17,0
379106,4,7,12,-5,15,1
398298,1,3,3,0,7,1
95289,3,10,24,-14,10,1
293438,4,35,24,11,11,0
105510,2,26,7,19,14,0
250654,3,3,19,-16,10,0
29805,1,3,0,3,14,0
360268,2,0,6,-6,7,0
158210,3,23,0,23,3,1
179527,2,0,16,-16,12,1
43515,2,7,3,4,3,0
189450,2,7,0,7,17,1
320583,3,31,0,31,6,0
88643,3,20,10,10,6,1
370927,4,20,20,0,12,0
384018,3,10,23,-13,1,1
297117,3,24,0,24,13,1
253310,4,13,13,0,11,1
97481,1,13,0,13,10,1
160784,2,10,7,3,4,0
306601,2,0,20,-20,17,1
34533,1,0,0,0,16,0
152445,1,7,0,7,17,1
191499,2,14,14,0,17,0
286336,4,25,19,6,8,0
309875,4,24,7,17,1,0
317677,3,16,6,10,5,0
157070,2,3,0,3,2,0
407779,4,10,7,3,11,1
384456,3,21,0,21,1,0
93669,1,0,0,0,9,0
214711,1,3,7,-4,11,1
70630,4,17,17,0,15,0
272902,4,20,17,3,2,1
20367,3,10,13,-3,10,1
237368,3,6,14,-8,3,1
222711,4,14,24,-10,14,1
406158,1,0,0,0,11,1
101326,1,0,0,0,12,1
419422,1,3,3,0,16,1
167611,1,7,0,7,7,0
199906,4,17,24,-7,4,0
417096,4,34,0,34,15,0
90357,4,14,32,-18,7,1
215085,4,19,7,12,11,0
258920,1,0,0,0,13,0
420397,4,20,20,0,17,1
114178,2,0,0,0,1,1
22889,3,0,13,-13,11,0
159839,2,13,0,13,3,1
210652,4,13,24,-11,9,1
418648,4,28,31,-3,16,0
145572,2,14,0,14,14,1
186308,2,19,3,16,15,1
336532,2,0,0,0,14,0
359299,2,3,13,-10,6,0
101235,2,7,7,0,12,0
217215,4,12,19,-7,12,0
294330,2,10,3,7,12,1
331296,2,0,14,-14,11,1
292656,4,22,16,6,11,0
46961,4,26,36,-10,5,0
72074,3,10,10,0,16,0
348418,4,13,20,-7,1,0
315710,4,17,16,1,4,0
222105,4,34,17,17,14,1
230322,3,19,10,9,17,0
406929,2,0,6,-6,11,0
206871,3,3,17,-14,7,1
414751,4,10,17,-7,14,1
312343,2,7,17,-10,3,1
2848,3,31,24,7,2,0
218356,4,20,26,-6,12,0
17786,1,7,3,4,9,1
18574,2,10,10,0,9,0
363088,2,7,3,4,8,0
296228,4,22,26,-4,13,1
348325,1,7,7,0,1,1
103085,3,27,7,20,13,0
54488,2,7,7,0,8,0
410031,4,6,45,-39,12,1
270502,1,0,7,-7,1,1
115612,4,30,9,21,1,0
166600,2,22,14,8,6,0
277463,4,41,32,9,4,1
360668,4,17,34,-17,7,0
196942,1,7,0,7,3,1
45984,1,0,0,0,4,0
242140,2,13,7,6,6,0
278145,2,7,14,-7,4,1
323835,3,13,15,-2,8,1
71472,3,30,7,23,16,0
14619,2,10,7,3,7,1
282194,1,3,0,3,6,0
381196,2,7,3,4,16,0
31042,3,10,6,4,15,1
359770,3,27,16,11,6,0
180170,3,10,0,10,13,1
48433,3,17,17,0,5,1
90288,2,0,14,-14,7,1
179853,2,3,9,-6,13,1
189076,3,21,30,-9,16,0
47102,4,31,10,21,5,1
74405,3,10,10,0,17,0
123767,2,10,3,7,5,0
213509,2,7,7,0,10,1
188880,2,10,7,3,16,0
374643,1,0,0,0,14,0
3926,3,19,14,5,2,1
151914,2,20,7,13,17,0
77306,1,0,0,0,1,0
139206,1,0,6,-6,12,1
224050,3,14,6,8,15,0
356602,5,9,9,0,5,0
105081,3,26,14,12,14,1
410419,2,6,17,-11,13,1
12698,2,38,0,38,6,1
42225,3,24,0,24,2,0
338755,4,27,17,10,14,0
111826,3,6,10,-4,17,1
136220,1,6,0,6,11,0
168216,4,29,15,14,7,0
331553,2,7,20,-13,11,1
122779,4,10,27,-17,4,1
215240,4,10,16,-6,11,1
298066,2,0,14,-14,13,1
94323,2,10,7,3,9,1
402187,4,19,14,5,9,0
391208,4,10,24,-14,4,0
411688,4,37,31,6,13,0
61604,4,35,14,21,11,1
162991,3,6,3,3,5,0
67580,2,0,7,-7,14,0
124838,2,0,6,-6,5,0
201033,3,27,0,27,5,1
121234,3,21,27,-6,3,0
305270,3,28,21,7,16,0
120361,1,0,6,-6,3,1
32454,4,31,6,25,15,0
414534,2,14,3,11,14,0
142289,2,0,0,0,13,0
31456,2,3,7,-4,15,1
75243,2,7,7,0,17,0
399044,2,10,12,-2,7,0
46781,3,14,20,-6,4,0
299656,1,14,0,14,14,1
121848,3,0,10,-10,4,0
16914,2,14,13,1,8,0
4995,4,24,17,7,3,0
388283,2,3,3,0,2,1
290720,4,44,25,19,10,0
295343,1,3,0,3,12,0
387572,3,6,3,3,2,1
112897,3,13,6,7,17,1
329589,1,10,0,10,11,0
64997,2,0,7,-7,13,0
177629,4,24,20,4,11,0
98972,1,0,0,0,11,0
338984,3,13,3,10,15,1
127644,3,24,12,12,6,1
274826,1,0,0,0,3,0
392780,2,14,3,11,4,1
17053,2,13,0,13,9,1
129885,3,13,0,13,7,0
405083,2,0,3,-3,10,0
321185,3,3,19,-16,6,1
38089,3,6,6,0,1,0
34055,1,0,0,0,16,1
56508,1,10,0,10,9,0
141060,3,14,10,4,13,1
67425,1,7,0,7,14,0
404321,2,0,6,-6,10,1
385733,2,7,0,7,1,1
96218,4,3,22,-19,10,1
200973,1,14,0,14,5,0
32207,2,14,7,7,15,0
371151,2,0,9,-9,12,0
191481,1,7,7,0,17,1
81659,1,7,7,0,3,0
86496,1,0,0,0,5,0
42358,3,7,9,-2,2,0
119168,4,10,7,3,3,1
97014,1,10,0,10,10,0
252383,4,0,29,-29,10,1
55383,2,10,7,3,9,1
406336,2,7,7,0,11,0
53847,1,0,0,0,8,0
239018,4,29,15,14,4,0
361522,3,10,7,3,7,0
409802,1,10,0,10,12,1
269766,1,7,0,7,1,0
118551,2,17,3,14,2,1
297760,1,0,0,0,13,1
186320,3,26,9,17,15,0
398974,1,0,0,0,7,1
294518,2,17,13,4,12,0
196740,4,54,0,54,3,0
345515,1,7,10,-3,17,1
185859,2,9,3,6,15,0
129804,1,7,0,7,7,0
120659,1,0,0,0,3,1
32028,1,7,3,4,15,1
88202,3,14,17,-3,6,1
86109,2,28,3,25,5,0
62248,2,14,7,7,12,1
48581,3,14,17,-3,5,1
63573,2,13,7,6,12,0
262233,1,3,0,3,15,0
397788,4,24,14,10,7,1
78066,4,19,23,-4,1,0
338925,1,3,0,3,15,0
120688,2,10,0,10,3,0
35959,3,3,7,-4,17,0
68454,1,0,0,0,14,0
305275,3,28,21,7,16,1
352927,1,3,0,3,3,1
294410,4,19,9,10,12,1
15667,3,34,10,24,8,0
231314,2,3,10,-7,1,1
257768,1,0,0,0,13,1
344151,4,27,3,24,17,0
345941,4,27,23,4,17,0
312338,2,7,17,-10,3,1
132604,4,12,35,-23,9,0
65753,3,14,16,-2,13,0
354884,5,41,42,-1,4,1
363354,1,0,7,-7,8,0
7641,4,28,3,25,4,1
373909,4,43,16,27,13,0
327289,3,16,20,-4,9,0
301047,3,17,3,14,15,0
127735,1,0,7,-7,6,1
144485,4,17,33,-16,14,1
263078,4,10,13,-3,15,1
56244,2,3,7,-4,9,1
182795,2,19,3,16,14,0
114819,3,13,27,-14,1,1
178824,3,24,14,10,12,1
401215,1,0,7,-7,8,1
239990,2,0,13,-13,5,1
153807,1,0,0,0,1,1
31426,1,3,0,3,15,1
362040,2,7,7,0,8,1
239763,4,20,13,7,4,0
185594,3,10,20,-10,15,1
214278,3,14,10,4,11,1
330162,1,0,0,0,11,0
368425,3,20,7,13,11,1
18367,4,25,20,5,9,0
129715,2,14,6,8,7,1
204980,1,9,0,9,6,0
87869,3,10,12,-2,6,0
6922,1,0,0,0,3,0
92633,4,20,10,10,8,1
195444,4,24,10,14,2,1
50050,1,0,0,0,6,1
259940,3,20,13,7,14,1
370973,1,0,0,0,12,1
239444,3,9,16,-7,4,0
205856,4,20,0,20,7,1
258602,3,13,10,3,13,1
386112,4,21,9,12,1,1
59284,1,0,0,0,11,1
184913,2,0,7,-7,15,0
72808,3,24,17,7,16,0
365188,4,14,28,-14,9,0
362851,4,14,28,-14,8,1
209077,3,3,13,-10,8,0
412711,4,33,13,20,14,1
19454,3,17,14,3,10,0
224224,1,0,0,0,15,0
87500,1,0,0,0,6,1
21652,1,0,0,0,11,1
324946,1,0,7,-7,8,1
370019,3,10,7,3,12,1
389085,3,23,0,23,3,1
74608,1,0,0,0,17,1
4262,4,13,6,7,2,1
357674,2,13,3,10,5,0
224927,3,3,9,-6,15,1
313761,3,28,10,18,3,1
313093,1,0,0,0,3,0
409028,1,0,0,0,12,1
253284,4,3,13,-10,11,1
68138,4,6,10,-4,14,1
134881,1,7,0,7,10,0
381413,3,16,7,9,16,1
140570,1,14,7,7,12,0
387392,2,21,7,14,2,1
70718,2,7,10,-3,15,1
105767,4,37,10,27,14,0
199326,1,0,0,0,4,1
368797,1,0,0,0,11,1
106160,3,0,0,0,14,0
399508,3,0,26,-26,7,0
267831,2,13,14,-1,17,1
342569,3,12,13,-1,16,1
176005,2,17,0,17,11,0
204401,2,7,3,4,6,0
216650,2,14,6,8,12,0
362850,4,14,28,-14,8,1
272886,3,20,17,3,2,1
220475,4,26,21,5,13,1
251049,1,0,7,-7,10,1
172707,2,14,3,11,9,0
262112,2,14,3,11,15,0
252027,3,14,20,-6,10,1
369599,4,14,6,8,11,1
118280,3,12,7,5,2,0
305183,4,33,10,23,16,0
25504,1,0,0,0,12,1
285860,1,0,0,0,8,0
365088,1,0,7,-7,9,1
88491,3,13,14,-1,6,1
372479,3,23,14,9,13,0
351315,1,7,0,7,3,1
392440,1,0,0,0,4,1
4912,2,14,7,7,3,0
414510,1,7,3,4,14,1
184349,2,7,6,1,14,0
301356,3,17,7,10,15,1
392813,3,17,6,11,4,0
101552,2,13,21,-8,12,0
410788,4,22,6,16,13,0
368830,2,10,0,10,11,0
188181,4,17,13,4,16,1
57669,4,17,17,0,10,1
38652,2,0,0,0,1,1
315045,2,24,7,17,4,0
172696,2,14,3,11,9,0
387054,1,7,7,0,2,0
411948,3,17,10,7,13,0
34437,3,24,3,21,16,0
201503,3,25,7,18,5,1
274071,2,10,0,10,3,0
114705,4,15,10,5,1,0
238474,2,6,0,6,4,1
195736,4,17,19,-2,2,0
346139,1,0,0,0,1,1
179545,2,0,23,-23,12,1
271274,2,6,7,-1,1,0
121378,3,7,3,4,3,0
100566,4,20,20,0,12,1
354901,5,41,42,-1,4,1
173281,2,7,10,-3,10,1
231320,2,9,10,-1,1,1
238117,1,0,0,0,4,1
260376,3,6,0,6,14,0
16332,1,7,0,7,8,1
361242,3,14,20,-6,7,0
262932,4,14,26,-12,15,1
64799,4,31,7,24,13,0
290341,2,6,3,3,10,1
243285,3,7,10,-3,6,0
173227,4,20,24,-4,9,0
179282,3,33,3,30,12,1
153015,4,42,24,18,1,0
48915,4,15,7,8,5,0
177028,4,26,13,13,11,1
130204,3,3,19,-16,8,0
31129,1,3,10,-7,15,1
352738,4,24,13,11,3,1
147704,3,10,10,0,15,0
388109,2,3,0,3,2,0
285771,2,7,10,-3,8,1
167006,2,0,14,-14,7,0
244580,4,25,22,3,7,0
253854,2,21,14,7,11,1
59570,1,0,3,-3,11,0
397213,4,13,0,13,6,0
374412,2,15,0,15,14,1
142763,2,9,10,-1,13,1
372403,1,6,0,6,13,0
63550,1,7,0,7,12,1
221339,4,6,35,-29,14,1
112549,2,17,16,1,17,0
213165,1,3,0,3,10,0
127133,2,10,9,1,6,0
229660,1,7,7,0,17,0
348194,2,6,10,-4,1,1
278249,4,34,28,6,4,0
116293,3,17,10,7,1,0
184252,3,24,7,17,14,1
289043,3,32,21,11,9,1
228613,1,10,14,-4,17,0
25836,2,17,7,10,12,0
20037,3,19,6,13,10,0
245761,4,16,17,-1,7,0
225770,2,10,7,3,16,0
204197,4,24,20,4,6,0
394416,1,0,3,-3,5,0
316992,1,0,7,-7,4,0
218165,2,14,3,11,12,0
178617,2,3,3,0,12,1
131388,2,7,13,-6,8,1
17146,4,30,17,13,9,0
219167,2,0,3,-3,13,1
373477,1,0,10,-10,13,0
369451,3,38,7,31,11,0
169085,4,36,23,13,7,0
278416,1,0,0,0,4,1
101965,1,0,0,0,12,1
404445,2,14,0,14,10,0
308312,4,16,23,-7,1,0
65177,3,3,3,0,13,0
145636,3,28,0,28,14,0
318122,2,9,7,2,5,0
18372,4,31,20,11,9,0
143826,4,12,7,5,14,0
23077,4,10,17,-7,11,1
378898,3,13,20,-7,15,0
372504,4,23,17,6,13,1
320551,2,21,0,21,6,1
177429,3,17,10,7,11,0
248561,1,0,0,0,9,0
375683,4,26,20,6,14,0
288142,4,19,7,12,9,1
256343,1,0,0,0,12,1
28570,4,33,7,26,14,1
105465,1,6,0,6,14,0
182643,3,0,6,-6,14,1
384045,4,20,30,-10,1,1
417893,4,13,10,3,16,0
237825,2,7,13,-6,4,0
193940,4,31,24,7,1,0
309126,2,23,3,20,1,0
415150,2,3,21,-18,15,0
364243,2,0,13,-13,9,1
191327,1,0,0,0,17,0
312776,1,0,0,0,3,0
16554,4,30,13,17,8,1
209833,2,10,10,0,8,0
173699,1,0,0,0,10,1
320488,4,26,17,9,6,1
196138,3,31,24,7,2,0
283887,3,21,10,11,7,0
310217,4,24,10,14,2,0
97305,1,0,0,0,10,0
2097,2,7,13,-6,1,1
10830,4,21,7,14,5,0
292258,1,0,7,-7,11,1
207909,3,28,7,21,8,0
317111,4,20,20,0,4,0
335157,3,20,0,20,13,0
393743,3,7,7,0,5,1
351661,2,7,10,-3,3,1
288181,1,3,0,3,9,0
98690,1,7,3,4,11,1
104769,2,20,16,4,14,0
266612,2,3,0,3,16,0
42201,2,14,0,14,2,1
236328,2,0,23,-23,3,1
292241,1,0,0,0,11,1
17670,2,7,6,1,9,1
66029,2,7,0,7,13,1
177689,2,10,14,-4,12,1
400691,3,16,7,9,8,0
373197,2,3,3,0,13,0
140891,3,17,7,10,13,0
49884,4,28,20,8,6,0
49706,4,21,24,-3,6,0
396384,2,20,12,8,6,1
370205,4,31,10,21,12,0
315240,4,20,10,10,4,1
92438,3,20,10,10,8,0
220763,4,13,16,-3,13,0
292190,3,21,14,7,11,1
374333,4,25,13,12,13,1
175713,3,30,6,24,11,0
125294,2,10,3,7,5,0
196636,1,7,0,7,3,1
355992,2,14,7,7,5,1
118154,3,23,27,-4,2,1
288257,3,10,28,-18,9,0
239938,1,0,0,0,5,1
20519,3,3,0,3,10,0
198615,2,0,7,-7,3,0
279542,3,10,6,4,5,0
242471,3,3,10,-7,6,1
293012,2,3,13,-10,11,1
375798,3,20,0,20,14,1
65152,2,0,0,0,13,0
390288,4,17,13,4,3,0
272464,4,31,24,7,2,0
294942,2,7,7,0,12,1
89460,4,24,20,4,7,1
160207,3,30,7,23,3,0
129280,4,17,13,4,7,1
117610,1,6,7,-1,2,0
133817,4,19,17,2,9,1
14356,4,2,17,-15,7,1
24706,3,20,14,6,12,1
52967,2,14,17,-3,7,0
62682,1,0,0,0,12,1
156193,3,14,10,4,2,1
290875,4,17,21,-4,10,1
94297,2,3,0,3,9,0
349576,2,6,28,-22,2,1
293797,2,17,6,11,12,0
144714,2,3,0,3,14,0
356005,2,14,7,7,5,0
375901,2,14,3,11,14,0
316171,4,30,32,-2,4,0
72649,3,13,3,10,16,1
354839,4,30,28,2,4,0
15958,3,12,14,-2,8,0
309891,4,24,21,3,1,1
421286,4,19,10,9,17,0
15871,1,0,6,-6,8,0
114074,3,21,0,21,17,1
129284,4,17,13,4,7,1
129294,4,17,13,4,7,1
349764,4,20,14,6,2,1
308193,1,7,7,0,1,0
253533,2,3,7,-4,11,0
139950,2,10,3,7,12,1
87321,4,24,24,0,6,1
205354,3,20,0,20,6,1
284799,3,26,17,9,7,0
153754,3,2,21,-19,1,0
319204,4,9,17,-8,5,1
110054,4,48,16,32,16,1
133393,4,21,9,12,9,0
219630,2,10,0,10,13,1
344618,1,0,3,-3,17,0
27911,2,0,3,-3,13,0
99278,1,7,0,7,11,1
304719,4,21,14,7,16,0
346974,2,7,3,4,1,0
420141,2,0,3,-3,17,1
185837,2,3,0,3,15,0
410165,4,20,17,3,13,0
380634,2,7,7,0,16,1
342776,4,7,14,-7,16,0
58773,4,10,26,-16,10,0
418498,4,24,12,12,16,0
200216,4,14,37,-23,4,0
21694,2,10,7,3,11,0
418414,2,14,3,11,16,1
398521,4,28,16,12,7,0
166775,3,20,16,4,6,0
13672,4,25,17,8,7,0
51934,4,13,16,-3,7,1
187521,2,6,10,-4,16,0
299352,4,28,16,12,14,1
331128,2,7,13,-6,11,0
269936,2,13,10,3,1,0
255262,4,13,17,-4,12,0
90402,1,0,6,-6,7,0
169245,4,17,6,11,7,1
268102,1,3,7,-4,17,1
394699,1,6,0,6,5,1
370522,4,27,9,18,12,0
261144,4,21,24,-3,14,0
303430,2,16,7,9,16,0
33818,3,0,31,-31,16,1
185996,2,10,20,-10,15,1
165551,3,3,28,-25,6,0
313137,2,7,10,-3,3,0
141938,1,10,0,10,13,0
112271,3,24,17,7,17,0
139479,4,34,10,24,12,0
319070,4,20,38,-18,5,0
372256,1,10,7,3,13,1
145921,2,7,7,0,15,0
2713,3,9,7,2,2,0
387538,2,3,0,3,2,0
327944,1,0,0,0,10,0
251728,3,24,3,21,10,0
160944,2,7,7,0,4,0
408165,2,6,0,6,12,1
205848,3,20,0,20,7,0
381301,4,31,28,3,16,1
284607,2,14,7,7,7,0
352181,1,0,0,0,3,1
164456,2,14,0,14,5,0
87566,3,17,3,14,6,1
342975,4,44,31,13,16,0
352464,4,38,27,11,3,1
149232,2,7,3,4,16,0
312910,4,21,24,-3,3,1
225968,3,33,20,13,16,1
175659,2,3,3,0,11,1
229675,2,7,7,0,17,1
312123,4,33,10,23,2,0
156861,4,23,26,-3,2,0
70906,3,15,26,-11,15,0
5352,2,10,7,3,3,1
114752,1,0,0,0,1,0
231970,4,14,41,-27,1,1
333783,2,6,14,-8,12,1
393599,3,7,26,-19,5,1
106842,1,0,0,0,14,1
248939,3,20,3,17,9,0
200088,1,7,3,4,4,1
69357,1,0,0,0,15,1
155239,3,28,7,21,1,0
164588,1,0,3,-3,5,1
22118,1,3,3,0,11,0
382403,2,0,21,-21,17,1
113431,2,0,7,-7,17,1
285817,4,14,24,-10,8,1
365872,2,7,14,-7,9,1
172823,1,7,0,7,9,0
98020,4,17,17,0,11,0
279873,3,17,13,4,5,1
415590,3,7,10,-3,15,1
348886,4,9,14,-5,2,0
74142,4,30,6,24,17,1
1286,4,24,16,8,1,0
193295,4,9,23,-14,1,1
367136,2,29,13,16,10,0
100065,3,6,3,3,12,0
172776,4,21,18,3,9,1
306525,4,17,20,-3,17,0
46336,3,6,17,-11,4,0
194844,1,0,0,0,2,0
209087,3,3,20,-17,8,0
285490,4,36,15,21,8,1
115796,1,0,0,0,1,1
421650,2,3,7,-4,17,1
125380,1,0,0,0,5,0
319421,1,0,0,0,6,0
96029,3,13,7,6,10,0
173940,3,13,19,-6,10,0
174905,1,0,0,0,10,1
36371,3,13,19,-6,17,1
165157,5,24,24,0,6,0
3236,1,0,0,0,2,1
250671,3,10,22,-12,10,1
348394,3,13,13,0,1,0
289095,1,0,0,0,9,1
358644,4,27,16,11,6,1
113912,3,10,3,7,17,1
77832,3,14,14,0,1,0
398933,4,10,10,0,7,1
128795,2,10,13,-3,7,1
285788,3,7,17,-10,8,0
311874,1,7,0,7,2,1
389488,2,13,3,10,3,0
119269,2,7,3,4,3,1
338299,1,0,0,0,14,1
154602,3,14,14,0,1,1
293667,3,10,7,3,12,0
387816,1,10,0,10,2,0
3633,3,20,28,-8,2,1
119354,4,14,16,-2,3,1
175179,4,42,17,25,10,1
325341,3,12,13,-1,8,1
350677,1,0,0,0,2,0
165616,1,0,0,0,6,1
94363,3,17,14,3,9,1
190471,1,7,0,7,17,1
310229,4,24,10,14,2,0
200802,4,31,17,14,4,1
297314,1,0,3,-3,13,1
269139,5,16,16,0,17,0
321429,2,14,17,-3,7,0
309185,4,37,9,28,1,1
222320,2,7,3,4,14,1
87055,1,0,0,0,5,1
45792,4,13,14,-1,4,0
156074,4,20,24,-4,2,0
14255,1,0,6,-6,7,0
305785,1,0,0,0,17,0
135668,2,7,10,-3,10,1
414791,5,17,17,0,14,1
288957,1,9,0,9,9,1
219727,4,13,14,-1,13,1
354928,1,7,0,7,4,0
46229,4,14,31,-17,4,1
406986,3,3,20,-17,11,0
356195,3,19,0,19,5,1
225348,3,10,21,-11,15,0
63319,2,16,3,13,12,1
330917,4,31,31,0,11,0
385667,5,24,24,0,1,1
263735,2,0,0,0,15,0
4549,4,24,26,-2,2,0
159210,2,14,14,0,3,0
160095,4,23,39,-16,3,0
199678,2,14,7,7,4,1
102429,2,3,0,3,13,0
269767,1,7,0,7,1,0
68708,4,24,0,24,15,1
233448,3,17,10,7,2,1
131520,2,6,6,0,8,0
69169,4,14,17,-3,15,1
154592,2,14,7,7,1,0
61205,1,7,0,7,11,0
145894,2,0,0,0,15,0
138753,1,0,0,0,12,1
64605,3,20,14,6,13,0
216960,1,3,3,0,12,1
307735,1,7,0,7,1,0
188795,4,7,20,-13,16,1
185358,1,0,3,-3,15,0
100012,1,3,0,3,12,1
160700,4,10,0,10,4,1
138299,2,17,0,17,11,1
74355,2,7,3,4,17,1
272179,1,0,0,0,2,1
14260,1,0,7,-7,7,1
211280,1,3,0,3,9,1
368368,1,7,0,7,11,1
36775,2,7,7,0,17,0
197793,4,21,20,1,3,0
209459,4,24,20,4,8,0
328228,4,14,17,-3,10,1
201090,4,41,10,31,5,0
130149,2,0,9,-9,8,0
232325,2,6,3,3,1,0
119781,3,10,6,4,3,1
181063,2,7,0,7,13,0
98958,4,7,24,-17,11,1
390451,4,21,33,-12,3,0
151610,2,13,10,3,17,0
313310,3,6,24,-18,3,1
120189,1,0,0,0,3,1
237319,1,0,0,0,3,0
112096,2,7,17,-10,17,1
291767,4,3,17,-14,11,1
58696,1,7,7,0,10,0
407480,4,17,10,7,11,1
351972,3,21,14,7,3,1
269950,2,16,10,6,1,0
232031,2,0,16,-16,1,0
182156,2,19,7,12,13,1
201929,2,0,0,0,5,1
65998,1,0,0,0,13,0
100915,2,7,3,4,12,1
127841,4,17,42,-25,6,0
144810,1,7,0,7,14,0
208420,1,6,0,6,8,1
162240,4,20,20,0,4,1
163488,4,16,26,-10,5,1
274387,2,3,10,-7,3,0
198344,3,20,14,6,3,0
415655,4,36,13,23,15,0
181828,2,14,7,7,13,1
303270,2,13,0,13,16,0
207338,3,13,21,-8,7,1
44703,2,0,9,-9,3,0
403976,4,26,24,2,10,1
237163,1,0,0,0,3,0
173101,1,0,0,0,9,1
34050,1,0,0,0,16,1
27530,4,23,12,11,13,1
124925,4,11,16,-5,5,0
372439,2,6,7,-1,13,0
323349,2,7,0,7,7,1
322035,2,6,0,6,7,1
221602,3,20,18,2,14,0
64141,1,7,6,1,13,1
172232,3,7,13,-6,9,1
285218,1,0,0,0,7,0
156847,4,23,23,0,2,0
357291,3,6,19,-13,5,1
118665,2,14,6,8,2,0
20955,2,7,17,-10,10,0
398325,2,3,10,-7,7,0
75271,2,7,13,-6,17,0
163101,2,13,12,1,5,0
388270,1,3,0,3,2,1
255918,1,3,3,0,12,1
252649,3,6,3,3,10,0
355978,2,6,7,-1,5,1
401808,2,7,7,0,9,1
62251,2,14,7,7,12,0
151868,1,10,0,10,17,1
48716,3,10,19,-9,5,0
20583,1,0,0,0,10,0
414439,3,13,23,-10,14,0
76218,3,12,27,-15,1,1
201485,3,19,7,12,5,1
270160,4,27,27,0,1,1
222692,4,14,24,-10,14,0
51946,4,13,16,-3,7,0
136581,2,9,13,-4,11,1
147955,1,0,0,0,15,1
376196,2,7,7,0,14,1
385391,2,7,7,0,1,1
91970,3,13,23,-10,8,0
211605,1,0,3,-3,9,1
106808,4,27,22,5,14,1
108185,1,3,0,3,15,0
327625,4,10,22,-12,10,1
384940,1,0,0,0,1,1
22702,1,3,0,3,11,0
56442,3,0,35,-35,9,1
234072,4,20,7,13,2,0
46669,4,10,3,7,4,1
124633,4,13,17,-4,5,0
30823,1,0,7,-7,15,0
245264,2,6,3,3,7,1
91624,2,14,7,7,8,1
138743,1,0,0,0,12,1
44875,3,7,17,-10,4,0
164483,2,17,0,17,5,1
92163,3,3,37,-34,8,1
396443,3,20,25,-5,6,0
187923,1,0,7,-7,16,0
59285,1,0,0,0,11,0
237266,4,23,0,23,3,1
172758,4,21,18,3,9,1
15450,1,3,0,3,8,1
82023,3,10,0,10,3,1
255553,4,30,7,23,12,1
99768,2,0,7,-7,12,1
278351,3,17,14,3,4,1
69528,1,0,0,0,15,0
48086,1,0,0,0,5,0
403965,4,20,24,-4,10,1
321828,1,0,0,0,7,0
177857,3,14,16,-2,12,1
253100,3,21,7,14,11,1
175368,2,14,0,14,11,0
272747,4,15,9,6,2,0
210658,4,20,24,-4,9,0
3655,4,20,28,-8,2,0
326578,1,3,0,3,9,1
240949,3,14,9,5,5,1
4043,2,10,14,-4,2,1
202929,4,31,0,31,5,0
212349,3,13,3,10,10,1
224915,2,0,9,-9,15,0
143371,3,7,16,-9,14,0
158780,2,7,3,4,3,1
9878,2,0,0,0,5,0
40453,3,7,14,-7,2,1
75788,4,41,26,15,1,1
251813,2,0,7,-7,10,1
86672,2,7,0,7,5,1
93014,3,13,3,10,8,1
311798,3,17,20,-3,2,0
66607,2,0,14,-14,14,0
176535,3,12,17,-5,11,0
286105,3,10,17,-7,8,1
204730,2,14,14,0,6,0
294668,2,3,14,-11,12,1
146144,4,28,17,11,15,0
28046,2,7,7,0,13,1
59438,1,0,10,-10,11,1
67989,1,0,0,0,14,0
389226,3,21,7,14,3,1
214959,4,7,26,-19,11,1
375035,3,28,27,1,14,0
280694,2,0,3,-3,5,0
72571,4,19,31,-12,16,1
311015,1,7,0,7,2,1
214581,2,3,3,0,11,1
194400,1,3,0,3,2,1
223824,2,9,0,9,15,0
172930,4,41,24,17,9,0
221823,1,0,0,0,14,1
376671,2,3,0,3,14,1
320612,4,31,18,13,6,1
279009,4,13,30,-17,5,0
216142,1,7,0,7,12,0
136655,4,22,19,3,11,1
109186,4,34,14,20,15,1
276709,4,30,26,4,4,0
333779,1,6,14,-8,12,1
261898,4,6,27,-21,14,0
195286,4,23,24,-1,2,1
110830,4,6,13,-7,16,1
292476,3,10,9,1,11,0
187006,4,16,15,1,15,0
320385,2,7,0,7,6,1
289299,2,14,17,-3,9,0
279943,1,0,10,-10,5,1
236430,1,0,0,0,3,0
168165,3,19,11,8,7,0
58672,1,7,0,7,10,0
383170,4,26,24,2,17,0
320542,2,14,0,14,6,1
14706,1,7,0,7,7,0
285772,2,7,10,-3,8,1
77224,2,9,0,9,1,1
127830,4,17,42,-25,6,1
193893,3,24,10,14,1,1
313216,4,23,16,7,3,1
226683,1,7,3,4,16,1
315263,4,20,16,4,4,0
128145,1,0,0,0,7,1
407998,1,0,0,0,12,1
160658,2,10,0,10,4,0
23707,4,12,33,-21,12,1
235270,3,15,6,9,3,1
75597,3,7,3,4,17,0
348808,2,0,7,-7,2,1
286052,2,10,0,10,8,1
294987,4,24,14,10,12,0
297022,1,7,0,7,13,0
336185,4,17,10,7,13,1
60512,2,27,7,20,11,1
414683,2,3,7,-4,14,0
421051,1,6,0,6,17,1
230847,2,0,7,-7,1,1
306402,1,0,10,-10,17,0
87281,3,17,17,0,6,1
396262,2,3,3,0,6,1
164255,4,48,41,7,5,0
3259,2,3,0,3,2,1
56612,4,26,17,9,9,0
235673,2,0,3,-3,3,1
135435,4,31,27,4,10,0
68984,2,21,13,8,15,0
87517,2,14,0,14,6,0
254381,1,0,0,0,11,1
374362,1,6,0,6,14,1
18154,3,13,17,-4,9,0
59148,1,0,14,-14,10,0
390413,3,7,27,-20,3,0
47194,3,9,3,6,5,0
311966,3,35,10,25,2,0
267618,1,0,0,0,17,1
15537,4,23,6,17,8,1
374742,3,0,39,-39,14,1
201914,1,0,0,0,5,1
304587,1,0,0,0,16,1
392445,1,0,0,0,4,1
418641,4,21,31,-10,16,1
142798,3,12,10,2,13,1
395874,4,10,17,-7,6,0
240263,1,7,7,0,5,0
396785,4,7,20,-13,6,0
274753,4,24,20,4,3,0
7467,3,29,6,23,4,0
4471,2,7,12,-5,2,1
55527,2,10,0,10,9,0
225560,4,8,31,-23,15,1
178024,3,7,20,-13,12,0
384673,1,7,17,-10,1,1
207978,1,7,0,7,8,1
94922,1,0,3,-3,9,0
354754,2,6,9,-3,4,1
96516,4,17,24,-7,10,0
342037,4,20,3,17,16,0
242014,3,7,3,4,5,1
194270,2,7,0,7,2,1
17560,3,13,10,3,9,0
279844,3,14,13,1,5,1
197236,1,0,0,0,3,0
330574,4,14,7,7,11,1
378827,1,0,3,-3,15,1
301872,2,0,3,-3,15,0
329489,2,10,7,3,10,1
394900,3,0,17,-17,5,0
24031,1,0,0,0,12,1
298172,1,0,0,0,14,0
65525,4,30,14,16,13,0
106277,2,0,3,-3,14,0
27774,2,14,14,0,13,1
3929,3,19,14,5,2,0
52055,3,10,10,0,7,1
146127,4,25,17,8,15,0
300505,3,23,17,6,14,1
194710,1,0,0,0,2,0
399774,3,0,24,-24,8,1
392687,4,16,0,16,4,0
344444,4,28,24,4,17,0
239974,2,0,10,-10,5,0
2822,2,21,24,-3,2,1
358679,1,7,0,7,6,0
59695,4,31,6,25,11,0
198546,5,20,20,0,3,1
155819,2,7,10,-3,2,0
399067,3,10,19,-9,7,1
150963,4,22,14,8,17,0
24570,3,10,16,-6,12,1
37756,2,7,0,7,1,0
25411,3,6,3,3,12,1
78289,2,3,21,-18,2,1
381705,3,20,17,3,17,0
199408,3,16,10,6,4,0
85379,4,31,10,21,5,0
321237,1,3,0,3,6,0
150873,2,0,7,-7,17,0
215698,1,0,0,0,11,1
392080,4,18,33,-15,4,0
316861,1,3,0,3,4,0
86820,2,9,6,3,5,0
224041,3,14,6,8,15,1
363649,2,0,7,-7,8,0
179770,3,6,17,-11,12,1
362054,2,14,7,7,8,1
109203,1,0,0,0,15,1
375229,4,24,24,0,14,1
311719,1,0,0,0,2,0
363108,2,7,3,4,8,0
373337,2,0,0,0,13,1
242459,2,3,7,-4,6,0
206411,2,10,0,10,7,1
22336,3,0,3,-3,11,0
413754,4,24,16,8,14,0
208702,1,0,0,0,8,0
317706,4,23,16,7,5,0
53520,2,7,3,4,8,0
83870,3,23,10,13,4,1
236788,2,3,9,-6,3,1
228298,1,0,0,0,17,0
307477,3,35,13,22,17,0
6901,1,0,0,0,3,1
230208,4,3,32,-29,17,1
333198,2,0,7,-7,12,0
157184,1,0,0,0,2,1
359603,2,23,0,23,6,1
187842,3,7,13,-6,16,1
193138,4,13,6,7,1,0
90272,2,0,7,-7,7,1
257194,2,3,16,-13,12,1
168394,1,0,3,-3,7,1
155172,1,7,0,7,1,0
298641,1,3,0,3,14,1
80754,1,3,0,3,3,0
226360,4,25,13,12,16,0
307438,2,14,10,4,17,1
224774,3,5,3,2,15,1
20306,2,10,3,7,10,0
381958,2,0,13,-13,17,0
382548,3,0,10,-10,17,0
171336,3,10,3,7,9,0
354656,3,10,7,3,4,0
105613,4,32,28,4,14,0
323597,1,0,0,0,8,0
394731,2,14,0,14,5,0
391620,4,16,24,-8,4,1
59889,1,0,0,0,11,1
297395,3,9,24,-15,13,1
353513,1,3,0,3,4,0
231111,1,3,0,3,1,1
214137,3,3,6,-3,11,0
160474,2,20,7,13,4,0
124110,3,3,21,-18,5,0
163738,2,0,9,-9,5,1
409508,2,0,0,0,12,1
132715,3,3,17,-14,9,1
416596,2,7,7,0,15,1
95286,3,10,24,-14,10,1
61049,4,34,19,15,11,1
75751,3,28,16,12,1,0
387323,4,13,10,3,2,0
239390,2,3,7,-4,4,1
220225,2,17,6,11,13,1
169139,1,0,0,0,7,1
397631,3,6,27,-21,7,0
8771,2,6,0,6,4,1
281982,3,21,21,0,6,1
219384,4,23,20,3,13,1
59591,2,7,3,4,11,0
177384,2,17,7,10,11,0
360056,3,9,33,-24,7,1
152003,1,0,0,0,17,1
33351,1,6,3,3,16,0
394019,3,6,13,-7,5,1
421774,1,0,0,0,17,1
354812,3,20,28,-8,4,0
244113,4,20,34,-14,6,1
125699,1,0,0,0,5,0
152155,1,0,0,0,17,1
118613,1,0,0,0,2,0
305030,1,0,0,0,16,0
409369,2,10,3,7,12,0
204709,2,7,7,0,6,0
252971,3,9,10,-1,11,0
166788,4,20,16,4,6,1
120081,2,3,0,3,3,1
180584,1,0,3,-3,13,1
228870,4,9,17,-8,17,1
83453,4,10,23,-13,4,0
125708,1,0,7,-7,5,0
81737,3,17,17,0,3,0
206519,1,0,0,0,7,1
284834,4,29,27,2,7,1
105676,2,20,3,17,14,1
70587,2,7,10,-3,15,1
331388,1,3,0,3,11,0
262135,3,21,3,18,15,0
243062,2,0,9,-9,6,1
38300,4,19,14,5,1,0
247952,1,0,0,0,8,0
388802,3,14,7,7,3,0
3272,2,3,0,3,2,0
183085,2,7,3,4,14,0
15880,1,0,7,-7,8,1
92070,1,3,7,-4,8,0
72923,2,17,7,10,16,1
98053,5,24,24,0,11,1
298156,4,10,41,-31,13,0
134068,3,20,10,10,9,0
324796,1,0,0,0,8,0
334686,2,15,3,12,13,1
12212,2,0,0,0,6,0
380035,2,21,14,7,16,1
228696,3,19,23,-4,17,0
10721,1,0,0,0,5,0
181204,1,0,0,0,13,0
107109,4,40,6,34,15,1
268982,1,0,0,0,17,0
57953,3,13,17,-4,10,0
7302,4,20,13,7,4,1
51207,3,24,25,-1,7,1
601,1,0,0,0,1,0
363754,4,26,27,-1,8,1
246495,2,19,0,19,8,0
79308,2,12,3,9,2,1
183052,2,7,0,7,14,0
69316,3,19,3,16,15,0
73076,3,7,10,-3,16,0
267245,2,10,14,-4,17,1
296273,2,0,3,-3,13,0
362325,2,3,7,-4,8,0
141027,2,7,7,0,13,0
209538,2,34,17,17,8,1
25060,4,27,24,3,12,1
367266,2,3,3,0,10,1
381043,2,7,6,1,16,1
308418,3,7,18,-11,1,0
50543,2,0,6,-6,6,0
259489,3,28,10,18,13,0
230802,4,17,27,-10,1,1
84146,2,10,0,10,4,0
307454,2,27,10,17,17,1
144578,3,7,19,-12,14,1
273952,3,7,9,-2,2,1
88906,2,16,3,13,6,1
344453,4,28,24,4,17,1
417600,1,14,0,14,16,1
354224,3,13,10,3,4,0
54619,2,7,6,1,8,1
336359,4,20,20,0,13,0
185426,3,10,10,0,15,1
410873,2,14,12,2,13,1
371378,1,0,0,0,12,0
301090,4,33,13,20,15,0
103818,2,9,0,9,13,1
269838,3,22,10,12,1,0
186399,1,0,0,0,15,1
173495,3,3,20,-17,10,1
57265,1,0,0,0,10,1
223507,2,7,10,-3,15,0
51917,3,13,10,3,7,0
373081,3,3,14,-11,13,1
137476,1,7,0,7,11,0
89457,4,24,20,4,7,1
26742,3,6,14,-8,13,0
200213,4,14,37,-23,4,1
176580,5,19,20,-1,11,0
294627,2,0,0,0,12,0
253656,1,0,0,0,11,1
242268,1,0,7,-7,6,1
341958,2,6,0,6,16,0
294973,3,17,14,3,12,1
192222,4,6,33,-27,1,0
9500,3,13,10,3,5,1
56318,4,3,26,-23,9,1
351722,4,21,17,4,3,0
334260,3,6,7,-1,13,1
103444,1,0,0,0,13,1
34116,2,3,0,3,16,0
404236,4,12,16,-4,10,1
21713,3,17,7,10,11,0
261512,2,9,0,9,14,0
202230,1,3,0,3,5,1
392950,2,6,3,3,4,1
328651,4,27,35,-8,10,0
244162,1,0,7,-7,6,1
393892,4,20,17,3,5,0
119353,4,14,16,-2,3,1
378023,3,0,7,-7,15,1
146318,1,0,0,0,15,0
178217,3,6,10,-4,12,0
259872,2,7,7,0,14,1
196188,1,7,0,7,2,0
382772,1,7,0,7,17,0
156689,3,14,14,0,2,0
410771,4,22,6,16,13,0
166732,2,7,3,4,6,0
209425,4,14,17,-3,8,1
419596,2,20,10,10,17,1
22420,2,10,24,-14,11,1
215328,2,14,10,4,11,0
278930,2,7,23,-16,5,0
86010,4,22,19,3,5,1
143318,2,0,13,-13,14,0
235623,4,27,34,-7,3,1
141398,3,10,17,-7,13,0
114736,4,15,10,5,1,0
201995,4,10,7,3,5,1
268648,4,17,20,-3,17,1
63119,1,7,10,-3,12,0
244609,1,0,6,-6,7,0
328936,3,9,7,2,10,1
393029,1,0,0,0,4,0
167654,2,10,13,-3,7,0
319944,2,23,10,13,6,1
27951,3,14,10,4,13,0
336490,4,20,17,3,14,0
320119,2,17,0,17,6,1
53987,1,0,0,0,8,0
77442,4,27,21,6,1,0
129346,1,14,7,7,7,1
126947,1,3,7,-4,6,0
9253,1,0,0,0,5,0
362796,2,7,21,-14,8,1
341721,4,23,13,10,16,1
324580,3,13,9,4,8,1
152152,1,0,0,0,17,0
372317,3,24,10,14,13,0
229921,4,29,14,15,17,0
101364,2,6,0,6,12,1
188248,2,14,7,7,16,1
162732,4,29,24,5,5,1
52486,2,3,0,3,7,0
85314,2,20,3,17,5,1
144442,3,3,26,-23,14,1
346808,2,10,3,7,1,0
397449,2,10,13,-3,6,0
414037,4,10,45,-35,14,0
74798,2,6,3,3,17,0
148391,1,0,0,0,16,1
68374,3,3,14,-11,14,1
408375,4,19,7,12,12,0
96226,4,3,22,-19,10,0
19937,4,22,21,1,10,0
252668,3,6,3,3,10,1
985,4,0,6,-6,1,0
13466,3,3,21,-18,7,1
221810,1,0,0,0,14,0
311005,1,7,0,7,2,0
52086,4,13,19,-6,7,1
120402,2,16,9,7,3,1
365503,4,16,25,-9,9,1
215499,3,13,3,10,11,0
421127,3,27,13,14,17,0
209676,2,6,0,6,8,1
243923,3,19,12,7,6,0
144868,2,14,7,7,14,1
360310,3,0,13,-13,7,1
44422,2,3,0,3,3,0
377375,2,0,6,-6,15,1
65852,1,0,7,-7,13,1
319292,2,10,3,7,6,1
338546,3,20,31,-11,14,1
382562,3,0,17,-17,17,1
275763,3,16,3,13,3,1
157157,4,19,20,-1,2,1
263217,4,17,17,0,15,1
330754,5,9,9,0,11,0
333083,3,17,12,5,12,0
123647,3,7,9,-2,4,0
202910,3,28,0,28,5,0
330891,4,13,24,-11,11,1
315511,2,7,3,4,4,0
327586,3,10,15,-5,10,1
385012,3,24,16,8,1,0
405667,1,0,0,0,10,1
360459,3,10,0,10,7,1
31123,1,0,3,-3,15,1
41969,4,38,6,32,2,0
203466,2,14,3,11,6,1
270317,4,17,27,-10,1,1
62252,2,14,7,7,12,0
906,2,0,0,0,1,1
101203,2,0,7,-7,12,1
68200,2,7,14,-7,14,1
371142,2,0,9,-9,12,0
94345,3,17,7,10,9,1
211764,1,0,0,0,9,1
267943,1,0,0,0,17,1
279521,2,10,6,4,5,0
212103,1,0,7,-7,10,1
238384,3,10,30,-20,4,1
417013,1,3,0,3,15,0
352931,2,10,0,10,3,0
241115,2,13,10,3,5,1
101117,3,10,17,-7,12,1
307238,4,10,10,0,17,1
162921,1,0,0,0,5,1
277158,4,17,27,-10,4,0
89893,4,30,20,10,7,1
45609,3,10,13,-3,4,0
29555,2,0,13,-13,14,0
192127,2,0,6,-6,1,1
81395,3,7,10,-3,3,1
105844,3,16,3,13,14,1
342225,1,3,0,3,16,1
365303,3,10,16,-6,9,1
398259,4,42,17,25,7,0
379436,2,13,0,13,16,0
377133,3,10,10,0,15,0
374574,3,20,13,7,14,0
227398,1,0,7,-7,16,1
342505,1,0,0,0,16,0
44790,4,16,19,-3,3,1
198952,3,13,23,-10,3,0
303772,3,20,10,10,16,0
269425,4,21,20,1,1,1
124884,3,9,6,3,5,0
68674,2,17,0,17,15,0
70661,4,17,22,-5,15,1
63134,2,7,10,-3,12,1
301479,3,20,9,11,15,0
108586,4,26,14,12,15,0
304428,1,0,0,0,16,1
373652,2,0,9,-9,13,0
25107,2,9,0,9,12,1
380095,4,35,23,12,16,0
252874,1,0,0,0,11,1
238073,4,13,13,0,4,0
65404,1,0,7,-7,13,0
287933,2,14,13,1,9,1
230287,2,19,10,9,17,0
243960,4,25,20,5,6,1
154115,2,0,6,-6,1,0
6325,1,0,0,0,3,1
71582,2,3,14,-11,16,1
285584,3,7,10,-3,8,1
343155,1,3,0,3,16,0
174956,2,6,14,-8,10,1
217674,1,0,0,0,12,1
222590,1,0,0,0,14,1
177348,1,3,0,3,11,1
106089,1,0,0,0,14,1
322924,2,13,0,13,7,1
222608,2,7,7,0,14,1
392782,2,14,3,11,4,1
33457,4,23,20,3,16,0
157268,3,13,3,10,2,0
210694,1,0,0,0,9,1
8204,2,0,7,-7,4,0
347208,4,23,27,-4,1,1
156465,2,0,3,-3,2,1
347345,4,7,21,-14,1,1
417719,4,35,19,16,16,1
406663,2,14,0,14,11,0
259340,3,21,27,-6,13,0
61530,2,14,7,7,11,1
9048,3,21,13,8,4,1
158784,2,7,3,4,3,1
15734,1,0,3,-3,8,1
140967,1,0,0,0,13,0
246467,2,9,0,9,8,1
189332,3,3,10,-7,16,1
195608,4,24,7,17,2,0
261573,4,12,9,3,14,0
315519,3,7,3,4,4,0
261532,3,12,0,12,14,0
54230,3,0,3,-3,8,1
401040,1,0,0,0,8,1
325308,2,9,10,-1,8,0
15523,4,23,6,17,8,0
9682,4,12,28,-16,5,0
188307,4,20,13,7,16,0
105413,3,23,17,6,14,1
333086,3,17,12,5,12,0
346332,2,3,3,0,1,0
93023,3,13,3,10,8,0
170591,3,34,6,28,8,0
257387,3,20,6,14,13,0
373069,2,3,7,-4,13,0
362912,2,7,0,7,8,1
135564,3,14,6,8,10,1
133447,2,14,14,0,9,0
141184,2,3,21,-18,13,1
113386,1,0,0,0,17,1
64287,2,6,10,-4,13,1
121299,1,0,0,0,3,1
364167,4,31,3,28,9,1
237630,1,3,0,3,4,0
234687,4,30,20,10,2,0
14531,4,34,39,-5,7,1
377546,2,7,9,-2,15,1
263452,2,6,13,-7,15,0
161766,3,24,6,18,4,0
354858,4,33,41,-8,4,0
307226,4,3,10,-7,17,1
166614,3,22,14,8,6,0
354749,2,6,3,3,4,1
128036,1,0,3,-3,7,1
156136,2,7,7,0,2,1
277149,4,10,24,-14,4,0
330504,2,7,7,0,11,1
159151,4,31,7,24,3,0
223285,4,3,9,-6,15,0
360161,2,10,6,4,7,0
216733,4,27,6,21,12,0
64250,1,0,0,0,13,0
234409,1,0,0,0,2,1
384353,4,16,16,0,1,0
203690,4,14,23,-9,6,0
79963,4,13,23,-10,2,0
348683,2,10,10,0,2,0
190069,2,17,3,14,17,0
98762,3,34,6,28,11,1
398180,2,7,10,-3,7,1
299124,2,3,10,-7,14,0
168790,4,16,16,0,7,1
416746,2,7,0,7,15,0
85021,2,25,13,12,4,0
98114,2,14,7,7,11,0
221220,1,0,10,-10,14,0
213371,2,10,13,-3,10,1
235345,1,7,0,7,3,0
123620,2,0,0,0,4,0
318094,2,9,7,2,5,0
287142,2,10,3,7,8,1
61284,3,27,14,13,11,1
95713,3,13,9,4,10,0
352065,1,3,7,-4,3,0
148963,3,13,12,1,16,1
31563,1,7,3,4,15,0
239894,3,13,3,10,4,0
325847,4,13,20,-7,9,0
912,2,0,0,0,1,0
100841,4,12,19,-7,12,0
71657,4,3,34,-31,16,0
10417,4,10,45,-35,5,0
244140,1,0,0,0,6,0
202324,3,13,3,10,5,0
117635,2,6,13,-7,2,1
196460,4,20,28,-8,2,1
151948,3,27,23,4,17,0
243967,4,25,20,5,6,0
104218,1,0,0,0,13,1
320786,4,17,23,-6,6,0
126860,3,16,6,10,6,1
6606,1,0,0,0,3,1
17716,4,17,6,11,9,0
299894,3,13,8,5,14,0
376021,1,0,0,0,14,1
46641,3,10,0,10,4,0
416403,4,16,20,-4,15,1
294532,3,17,13,4,12,1
52583,4,22,10,12,7,0
220228,2,17,6,11,13,1
153717,2,2,21,-19,1,1
5437,4,20,23,-3,3,0
148104,1,0,0,0,16,1
339561,2,10,7,3,15,0
9482,3,10,3,7,5,1
314910,2,0,0,0,4,0
263340,3,24,7,17,15,0
151062,3,10,10,0,17,1
289165,2,20,7,13,9,0
157611,3,12,3,9,2,1
262311,3,10,9,1,15,1
242921,3,21,13,8,6,0
132169,4,29,6,23,9,0
46637,3,3,0,3,4,1
209348,2,7,7,0,8,1
97907,1,0,0,0,11,0
156632,2,3,0,3,2,1
279949,1,0,10,-10,5,0
204895,3,3,13,-10,6,1
188155,3,10,10,0,16,1
244168,1,7,7,0,6,0
102544,4,31,17,14,13,0
66503,3,14,24,-10,14,1
126940,1,3,0,3,6,0
263667,4,27,10,17,15,0
398011,1,7,7,0,7,1
324503,1,0,0,0,8,1
107239,4,14,31,-17,15,1
249538,2,14,3,11,9,1
173758,2,10,3,7,10,0
401776,1,0,0,0,9,1
399179,2,7,6,1,7,1
206065,2,7,3,4,7,1
219017,2,14,0,14,13,1
291479,4,21,20,1,10,1
86639,1,0,0,0,5,0
109781,4,26,0,26,16,1
409902,4,37,8,29,12,0
17785,1,7,3,4,9,1
270375,1,3,0,3,1,1
311880,1,7,0,7,2,0
324952,1,0,7,-7,8,0
109829,2,10,0,10,16,1
273242,4,40,7,33,2,1
196809,2,0,10,-10,3,0
360384,1,0,0,0,7,1
150694,1,6,3,3,17,0
289757,2,0,10,-10,10,0
236437,1,0,0,0,3,1
308741,3,10,20,-10,1,1
181470,4,31,24,7,13,1
180255,1,0,0,0,13,1
414676,2,3,7,-4,14,0
15938,2,6,14,-8,8,1
290597,1,7,0,7,10,0
274323,1,0,0,0,3,1
382551,3,0,10,-10,17,0
121849,3,0,10,-10,4,1
409930,1,0,7,-7,12,0
29668,1,0,0,0,14,0
227305,3,13,20,-7,16,0
6848,3,10,28,-18,3,1
195064,3,7,23,-16,2,0
244343,2,0,7,-7,7,0
181440,3,24,24,0,13,1
27608,2,7,10,-3,13,1
370985,1,7,0,7,12,0
40118,1,6,0,6,2,0
365834,1,7,0,7,9,0
296059,3,6,7,-1,13,0
151329,2,13,14,-1,17,0
360643,4,10,27,-17,7,1
37597,1,7,0,7,17,1
172816,1,6,0,6,9,1
141722,4,30,21,9,13,1
393653,1,0,0,0,5,1
316714,1,7,0,7,4,0
82899,2,3,0,3,4,0
130379,3,7,3,4,8,0
302862,4,12,23,-11,15,0
377367,2,0,0,0,15,0
13726,2,0,17,-17,7,1
100863,4,19,22,-3,12,1
113368,1,0,0,0,17,0
308200,1,7,7,0,1,0
382683,3,3,6,-3,17,1
183661,3,0,8,-8,14,1
314905,2,0,0,0,4,1
290342,2,6,3,3,10,1
162149,1,0,0,0,4,1
67509,4,39,14,25,14,0
325907,2,9,0,9,9,1
258750,4,3,34,-31,13,1
279906,4,24,13,11,5,1
239712,3,7,10,-3,4,0
329781,2,17,13,4,11,0
243036,1,0,3,-3,6,1
124649,1,0,0,0,5,0
185514,1,3,3,0,15,0
274677,2,7,9,-2,3,1
85201,3,10,10,0,4,0
397732,2,9,14,-5,7,1
51413,1,3,7,-4,7,0
325762,2,0,7,-7,9,0
155778,4,30,30,0,2,0
297839,3,14,10,4,13,1
421724,3,17,17,0,17,1
289695,1,0,0,0,10,1
239526,1,3,0,3,4,1
383728,4,16,24,-8,17,0
220043,1,0,0,0,13,0
255790,2,10,0,10,12,1
126669,2,7,3,4,6,0
178528,3,16,13,3,12,1
319399,1,0,0,0,6,1
217461,2,9,0,9,12,0
315680,3,10,13,-3,4,0
91616,2,14,7,7,8,0
157595,3,12,0,12,2,0
275210,4,17,22,-5,3,1
374508,1,7,0,7,14,0
65379,1,0,0,0,13,0
19413,2,14,7,7,10,1
344793,2,7,7,0,17,1
30060,4,46,7,39,14,0
109856,2,17,0,17,16,1
398024,2,14,7,7,7,0
19316,3,14,17,-3,10,0
145464,3,16,14,2,14,0
264790,3,17,29,-12,16,1
224098,1,0,0,0,15,0
242070,4,17,16,1,5,1
136933,3,3,13,-10,11,1
392841,4,17,20,-3,4,0
187831,2,7,13,-6,16,1
49977,3,21,7,14,6,0
63135,2,7,10,-3,12,1
31772,3,0,17,-17,15,0
305004,4,24,20,4,16,0
393535,2,7,9,-2,5,1
214954,4,7,26,-19,11,1
164103,4,12,6,6,5,1
151262,4,24,26,-2,17,0
315903,1,0,0,0,4,1
127609,2,9,9,0,6,1
374772,4,16,39,-23,14,1
27317,2,14,3,11,13,0
330352,2,7,13,-6,11,0
28268,3,17,14,3,13,1
34370,1,0,0,0,16,1
221177,4,0,23,-23,14,1
320102,2,10,0,10,6,1
10482,2,3,0,3,5,1
252561,4,32,39,-7,10,1
251605,4,19,20,-1,10,1
87732,3,6,20,-14,6,1
150437,2,20,3,17,16,0
115556,2,9,3,6,1,1
170963,4,44,20,24,8,0
42750,1,3,0,3,3,1
40562,2,7,0,7,2,1
104643,3,7,3,4,14,0
372642,3,14,9,5,13,0
192287,2,24,3,21,1,0
44842,2,0,7,-7,4,0
386694,4,17,13,4,2,0
373042,2,0,0,0,13,1
230035,4,6,6,0,17,1
368274,2,6,3,3,11,0
239918,4,13,9,4,4,0
257585,4,19,13,6,13,0
355637,4,31,17,14,5,0
314680,4,14,21,-7,3,1
59716,1,6,0,6,11,0
57652,3,17,10,7,10,0
237009,1,0,6,-6,3,0
149852,3,3,16,-13,16,1
199313,1,0,0,0,4,0
316767,2,10,7,3,4,1
246476,2,9,0,9,8,1
30237,1,0,0,0,14,1
100018,1,3,0,3,12,0
335543,2,0,0,0,13,1
220235,2,17,6,11,13,1
212062,4,17,40,-23,9,1
16271,4,19,23,-4,8,0
273355,3,35,0,35,2,0
6574,4,13,6,7,3,1
309616,4,16,3,13,1,1
166556,1,6,6,0,6,0
179661,5,31,30,1,12,0
55245,2,7,3,4,9,0
63446,2,14,13,1,12,0
412444,2,0,7,-7,14,1
1012,1,0,0,0,1,1
352332,1,0,0,0,3,1
407470,4,17,10,7,11,0
367400,2,10,14,-4,10,1
385311,3,14,20,-6,1,1
166588,2,15,14,1,6,0
60321,1,3,0,3,11,1
355684,1,7,0,7,5,1
47092,4,30,10,20,5,1
294059,2,7,20,-13,12,0
288211,2,3,7,-4,9,0
371445,2,14,14,0,12,1
106206,4,0,10,-10,14,1
72387,4,16,23,-7,16,1
275781,3,16,3,13,3,0
109200,1,0,0,0,15,1
305130,3,21,10,11,16,1
352623,1,0,0,0,3,1
388995,4,24,27,-3,3,1
410174,4,20,17,3,13,0
368777,4,21,22,-1,11,1
145743,2,6,10,-4,15,1
377306,4,21,14,7,15,0
94146,2,3,7,-4,9,1
121647,2,0,7,-7,4,1
277689,2,7,0,7,4,1
371580,2,10,3,7,12,0
40698,1,7,7,0,2,0
195103,4,7,29,-22,2,1
332156,2,0,10,-10,12,0
225012,1,0,0,0,15,0
96765,3,7,10,-3,10,0
34516,1,0,0,0,16,1
342705,2,0,0,0,16,0
295068,1,0,0,0,12,0
150270,1,14,0,14,16,0
302972,3,20,13,7,16,0
120526,1,0,6,-6,3,1
128901,1,2,3,-1,7,1
360925,3,24,3,21,7,1
85731,1,0,0,0,5,1
240337,3,7,23,-16,5,1
163760,3,7,12,-5,5,0
357028,4,26,10,16,5,1
281082,4,38,16,22,6,1
170454,3,21,3,18,8,0
152424,4,38,3,35,17,1
57743,1,9,0,9,10,1
323805,2,6,9,-3,8,1
155527,2,20,3,17,2,0
232634,2,0,0,0,1,0
4657,3,13,13,0,2,0
107059,2,24,0,24,15,0
151930,3,20,17,3,17,0
172126,4,13,18,-5,9,1
151248,4,23,26,-3,17,1
205911,1,3,0,3,7,0
417650,2,21,3,18,16,0
226630,3,10,6,4,16,1
17211,2,7,28,-21,9,1
107881,1,0,3,-3,15,0
336921,3,7,21,-14,14,1
338602,4,39,38,1,14,0
341297,1,0,0,0,16,1
212920,2,7,7,0,10,0
311062,2,10,3,7,2,1
237897,4,14,27,-13,4,0
409347,1,3,3,0,12,0
188205,1,0,0,0,16,0
416172,2,10,12,-2,15,0
376424,4,16,9,7,14,0
102864,4,17,10,7,13,0
392431,4,40,54,-14,4,1
121175,2,7,13,-6,3,1
180430,1,7,7,0,13,0
97221,3,9,6,3,10,1
328995,4,33,7,26,10,0
116023,3,13,7,6,1,1
402058,4,3,26,-23,9,1
274150,4,27,0,27,3,1
311073,3,10,3,7,2,1
320928,4,13,21,-8,6,0
5898,2,0,9,-9,3,1
121023,2,8,21,-13,3,1
231085,4,27,14,13,1,0
207274,2,0,7,-7,7,0
87470,4,20,17,3,6,0
289323,2,28,17,11,9,0
306107,1,0,0,0,17,0
73695,4,20,9,11,17,0
257481,2,6,3,3,13,1
265830,4,20,19,1,16,1
319710,4,33,9,24,6,0
219373,4,23,13,10,13,0
107946,3,6,6,0,15,0
10457,1,3,0,3,5,1
51302,2,6,10,-4,7,1
103657,2,0,7,-7,13,1
133822,4,19,17,2,9,0
309811,2,7,6,1,1,0
312180,1,0,6,-6,2,0
381008,1,0,0,0,16,1
236846,4,6,9,-3,3,0
58813,4,18,36,-18,10,1
2968,2,7,10,-3,2,1
132942,1,0,0,0,9,0
238048,4,13,13,0,4,0
270171,4,34,27,7,1,0
93292,2,21,3,18,9,0
373752,4,19,21,-2,13,0
170941,4,31,20,11,8,1
53179,4,27,41,-14,7,1
263885,1,6,0,6,15,1
194950,4,14,13,1,2,1
352902,1,0,0,0,3,0
123686,4,10,25,-15,4,1
228837,3,6,17,-11,17,1
254067,4,14,23,-9,11,0
83232,2,6,7,-1,4,1
212994,4,21,7,14,10,1
203036,3,20,3,17,5,0
180346,3,12,14,-2,13,1
340215,3,23,31,-8,15,1
108542,3,17,14,3,15,0
1194,1,9,0,9,1,1
331603,3,20,23,-3,11,0
334573,3,24,24,0,13,1
218872,2,21,3,18,13,0
141259,4,10,24,-14,13,1
178300,2,7,3,4,12,0
241670,2,0,3,-3,5,1
307353,3,14,22,-8,17,0
259364,4,28,34,-6,13,1
218950,4,48,27,21,13,1
26021,4,10,19,-9,13,0
231554,1,0,0,0,1,1
352488,1,0,0,0,3,1
377251,2,7,3,4,15,0
253980,2,0,6,-6,11,1
245239,1,3,3,0,7,1
318871,3,21,12,9,5,0
99925,3,10,6,4,12,0
282240,3,10,7,3,6,0
95044,4,20,16,4,9,0
168555,2,7,10,-3,7,0
178305,2,7,3,4,12,0
363780,1,0,7,-7,8,1
346322,1,0,3,-3,1,1
319611,2,10,3,7,6,0
3645,4,20,28,-8,2,0
134822,4,48,17,31,10,0
302095,3,20,27,-7,15,0
262601,2,23,3,20,15,1
106475,3,16,9,7,14,1
253205,2,0,7,-7,11,0
299321,4,26,16,10,14,1
374201,4,29,28,1,13,1
77859,4,17,28,-11,1,0
260483,2,10,0,10,14,1
266498,3,3,15,-12,16,1
42921,2,14,13,1,3,0
332047,3,10,3,7,12,1
417308,1,7,3,4,16,0
147952,4,34,41,-7,15,0
217569,2,3,9,-6,12,0
121839,2,0,10,-10,4,0
20157,2,10,0,10,10,0
131091,2,20,6,14,8,1
386620,2,7,7,0,2,0
337356,3,14,7,7,14,0
298055,1,0,14,-14,13,0
283792,4,21,3,18,7,1
306567,1,0,14,-14,17,0
8841,4,32,0,32,4,0
216133,1,0,0,0,12,1
260347,2,6,0,6,14,0
247136,3,20,6,14,8,1
66834,4,13,6,7,14,1
295396,2,10,10,0,12,0
6320,4,19,25,-6,3,1
98005,3,17,10,7,11,0
32633,1,0,0,0,15,1
236391,4,14,23,-9,3,1
334740,4,25,9,16,13,0
361296,1,0,0,0,7,0
391554,2,10,21,-11,4,1
13119,1,3,7,-4,6,1
97030,2,19,0,19,10,0
256914,3,14,18,-4,12,0
251268,3,13,24,-11,10,0
180841,4,20,20,0,13,0
341802,2,3,9,-6,16,1
235728,3,3,20,-17,3,1
6349,1,0,3,-3,3,0
52465,1,3,0,3,7,1
183039,1,7,0,7,14,0
338098,3,6,7,-1,14,1
413407,2,3,24,-21,14,0
76949,3,14,13,1,1,1
10635,3,7,17,-10,5,0
344248,2,7,13,-6,17,0
201862,4,28,30,-2,5,1
381673,3,17,7,10,17,0
336944,4,21,21,0,14,0
4074,3,16,21,-5,2,0
249017,1,7,0,7,9,0
35384,4,30,23,7,16,0
197041,4,29,33,-4,3,1
46711,1,7,0,7,4,0
384850,2,6,12,-6,1,0
317203,3,7,13,-6,5,1
295933,4,13,24,-11,12,0
375645,3,17,17,0,14,0
414319,4,21,42,-21,14,0
74697,3,7,17,-10,17,1
106216,4,7,10,-3,14,0
362274,4,18,24,-6,8,1
331336,3,0,30,-30,11,1
220107,2,19,6,13,13,1
259924,3,17,10,7,14,1
265424,4,14,26,-12,16,1
119465,3,7,17,-10,3,1
94047,3,6,21,-15,9,1
81273,3,10,7,3,3,0
358949,1,0,0,0,6,0
406045,2,0,10,-10,11,1
253224,2,0,7,-7,11,1
191272,3,7,17,-10,17,1
308007,4,21,12,9,1,0
273028,3,6,3,3,2,1
304405,4,31,21,10,16,0
331281,2,0,7,-7,11,0
146754,4,22,35,-13,15,1
210618,3,13,17,-4,9,0
400259,3,17,6,11,8,0
291803,4,9,23,-14,11,1
236036,3,23,3,20,3,1
412712,4,39,13,26,14,1
414961,1,10,7,3,15,0
70110,1,10,0,10,15,0
217818,1,0,7,-7,12,1
310287,2,23,0,23,2,0
49525,3,7,3,4,6,1
270281,3,10,24,-14,1,0
369613,4,20,6,14,11,0
54052,3,10,3,7,8,0
402681,1,0,0,0,9,0
3453,3,3,23,-20,2,0
228125,4,20,10,10,17,0
302437,1,0,3,-3,15,1
64646,4,20,24,-4,13,0
58082,2,10,10,0,10,0
162733,4,29,24,5,5,0
105484,1,20,0,20,14,0
87554,2,17,3,14,6,1
308079,2,6,13,-7,1,0
405562,2,7,14,-7,10,0
54639,2,14,19,-5,8,0
332281,2,0,6,-6,12,1
104632,3,7,3,4,14,1
276623,2,13,6,7,4,1
254943,3,38,7,31,12,1
20462,1,0,0,0,10,0
230852,2,7,7,0,1,0
363598,4,10,15,-5,8,1
355087,2,6,13,-7,4,0
307259,1,0,0,0,17,1
405597,3,14,17,-3,10,0
270581,3,13,14,-1,1,0
198258,1,3,0,3,3,0
328921,2,6,7,-1,10,1
288345,2,7,0,7,9,0
62542,1,0,0,0,12,1
275622,3,24,3,21,3,0
20567,4,17,0,17,10,1
233961,4,24,19,5,2,1
170249,2,0,9,-9,8,1
293413,3,22,10,12,11,0
337102,4,26,15,11,14,1
8384,4,30,10,20,4,1
10451,1,3,0,3,5,0
269384,3,7,17,-10,1,1
397736,3,9,14,-5,7,0
88761,2,6,3,3,6,1
319828,3,17,10,7,6,1
397911,3,7,6,1,7,0
59011,2,0,10,-10,10,1
171613,2,6,3,3,9,0
337471,2,7,9,-2,14,0
279224,2,13,6,7,5,0
230069,4,19,6,13,17,1
297649,2,7,0,7,13,0
137009,5,20,20,0,11,1
382049,1,0,0,0,17,0
132578,3,12,29,-17,9,0
69728,3,13,7,6,15,1
416373,4,16,6,10,15,0
159520,2,7,3,4,3,0
270455,4,10,7,3,1,1
118142,3,23,20,3,2,0
99761,2,0,7,-7,12,1
9098,4,30,13,17,4,0
81019,4,20,23,-3,3,1
403922,3,20,14,6,10,1
322678,4,6,9,-3,7,1
40794,4,17,28,-11,2,0
35898,2,0,0,0,17,1
210748,2,21,10,11,9,0
32291,4,30,28,2,15,0
366904,4,3,16,-13,10,1
243627,4,23,14,9,6,0
231214,4,10,16,-6,1,1
236345,3,7,23,-16,3,0
331610,3,20,30,-10,11,1
188866,2,3,7,-4,16,0
398373,3,3,27,-24,7,0
110726,2,3,3,0,16,0
233769,3,13,27,-14,2,0
312326,1,7,14,-7,3,0
1558,3,13,13,0,1,1
240248,1,7,0,7,5,0
303987,1,0,0,0,16,0
159019,1,0,0,0,3,0
117911,1,0,0,0,2,0
251636,1,3,0,3,10,0
201494,3,25,7,18,5,0
386791,2,7,7,0,2,1
344829,3,20,10,10,17,1
253135,4,21,20,1,11,1
124414,2,6,0,6,5,0
420423,1,0,7,-7,17,1
98652,4,14,10,4,11,0
103945,2,3,3,0,13,0
147364,2,0,0,0,15,0
2004,4,10,12,-2,1,1
372980,4,28,13,15,13,1
144807,1,6,0,6,14,1
262596,2,23,3,20,15,0
294309,1,10,0,10,12,0
127715,1,0,7,-7,6,1
124452,3,9,7,2,5,1
354490,3,24,28,-4,4,1
9485,3,10,3,7,5,1
191310,4,17,20,-3,17,1
112195,4,27,34,-7,17,0
296866,1,3,0,3,13,0
283949,4,31,17,14,7,0
214446,3,7,14,-7,11,1
123725,1,7,0,7,5,0
121059,3,11,24,-13,3,0
356853,4,9,16,-7,5,1
188598,4,20,13,7,16,0
329870,1,0,0,0,11,0
219435,1,0,0,0,13,0
80771,2,3,0,3,3,1
181438,3,24,24,0,13,1
308461,4,7,25,-18,1,1
219219,3,13,3,10,13,0
308778,4,18,20,-2,1,0
173348,3,28,27,1,10,0
5656,2,0,14,-14,3,0
208207,4,3,10,-7,8,1
84900,3,34,17,17,4,1
40817,4,24,35,-11,2,0
150313,2,24,7,17,16,0
261650,1,0,0,0,14,0
189340,3,10,10,0,16,1
27715,1,0,0,0,13,0
274983,1,14,3,11,3,0
94739,1,0,0,0,9,0
408996,4,31,31,0,12,0
74090,2,9,0,9,17,1
222160,2,7,9,-2,14,0
258058,1,0,0,0,13,1
198296,2,6,13,-7,3,0
397005,2,14,3,11,6,1
183836,3,27,21,6,14,1
383146,4,23,17,6,17,1
254060,4,14,23,-9,11,1
327534,2,7,9,-2,10,0
4513,3,17,19,-2,2,1
29353,4,21,16,5,14,1
73611,2,0,0,0,17,1
186108,1,0,0,0,15,1
302558,4,3,16,-13,15,1
44927,4,14,38,-24,4,0
175614,4,36,14,22,11,0
331316,3,0,24,-24,11,0
48830,2,3,0,3,5,1
325238,4,19,32,-13,8,1
360210,4,20,13,7,7,1
321589,2,10,6,4,7,0
203056,3,20,10,10,5,1
211259,4,29,26,3,9,0
411737,2,0,10,-10,13,0
414395,2,7,17,-10,14,1
203272,1,0,10,-10,6,1
61507,2,7,7,0,11,0
214909,3,7,12,-5,11,1
23220,3,23,13,10,11,1
278442,2,22,0,22,4,1
193103,3,13,6,7,1,0
247503,1,3,0,3,8,1
350208,3,25,0,25,2,1
199932,1,3,10,-7,4,1
134258,4,10,23,-13,10,0
50362,1,0,0,0,6,1
99624,2,7,3,4,11,1
278822,3,7,21,-14,5,1
137858,2,10,6,4,11,0
233706,2,7,21,-14,2,1
74271,4,10,17,-7,17,1
402432,3,21,12,9,9,1
187750,4,16,20,-4,16,0
145535,4,26,20,6,14,0
409381,2,10,3,7,12,1
226748,3,7,13,-6,16,1
361016,2,9,2,7,7,0
164231,3,33,38,-5,5,1
165926,1,3,7,-4,6,0
260200,2,10,0,10,14,1
319918,1,13,7,6,6,1
240249,1,7,0,7,5,0
356193,3,19,0,19,5,1
207820,1,0,0,0,8,0
206982,2,21,0,21,7,1
164582,1,0,3,-3,5,1
416245,4,10,39,-29,15,1
246725,1,0,0,0,8,1
348882,4,9,14,-5,2,1
232266,4,18,12,6,1,0
389873,1,0,0,0,3,1
236424,1,0,0,0,3,1
402854,2,10,3,7,9,1
89079,3,13,6,7,6,0
230878,2,13,10,3,1,1
304672,3,14,7,7,16,0
208854,1,7,0,7,8,0
164912,2,0,3,-3,6,0
419326,3,0,17,-17,16,1
173639,3,10,20,-10,10,0
352031,4,31,21,10,3,0
337495,2,7,12,-5,14,0
98473,3,24,14,10,11,0
148450,2,7,3,4,16,1
236689,3,17,7,10,3,1
119327,4,14,16,-2,3,1
322650,4,6,9,-3,7,1
309388,2,0,0,0,1,1
348750,4,31,17,14,2,1
171935,3,7,7,0,9,1
217691,1,7,0,7,12,1
356378,4,24,14,10,5,1
151967,4,27,27,0,17,1
105212,2,7,17,-10,14,0
396913,4,27,27,0,6,0
153939,1,0,0,0,1,0
13403,1,3,7,-4,7,0
128616,2,3,10,-7,7,1
414899,4,35,7,28,15,1
17112,3,23,10,13,9,0
184763,2,14,7,7,15,1
198719,1,0,0,0,3,0
276539,4,22,7,15,4,1
219388,4,23,20,3,13,1
244623,1,0,7,-7,7,0
179263,3,26,3,23,12,0
253799,4,24,17,7,11,1
2567,3,10,17,-7,2,0
131568,3,9,23,-14,8,0
269734,1,0,0,0,1,1
404822,3,20,20,0,10,1
101829,1,3,0,3,12,0
301952,4,17,20,-3,15,1
295036,4,31,24,7,12,0
228612,1,10,14,-4,17,0
328838,4,17,20,-3,10,1
54486,2,7,7,0,8,1
117132,1,6,0,6,2,0
413714,3,14,13,1,14,1
279186,1,0,3,-3,5,1
306656,4,14,27,-13,17,0
63583,2,13,7,6,12,0
259422,1,6,3,3,13,0
386157,1,3,3,0,2,0
39551,2,0,3,-3,1,0
216950,1,3,0,3,12,0
313068,4,20,0,20,3,0
53867,2,7,7,0,8,1
44101,2,0,13,-13,3,0
140516,4,21,29,-8,12,1
5708,4,0,24,-24,3,1
54177,2,0,3,-3,8,1
44419,2,3,0,3,3,0
214225,1,0,3,-3,11,0
330929,1,0,0,0,11,0
130291,1,0,0,0,8,1
377702,3,25,7,18,15,0
136325,4,18,7,11,11,1
127391,4,17,23,-6,6,0
8344,2,16,3,13,4,0
25716,3,14,10,4,12,0
101366,2,6,0,6,12,1
252345,3,0,22,-22,10,1
51270,1,6,0,6,7,1
336047,4,16,25,-9,13,0
353073,2,7,9,-2,3,0
328710,1,7,0,7,10,0
413867,3,17,6,11,14,1
250329,3,7,7,0,9,1
179436,3,13,20,-7,12,0
61711,3,24,17,7,12,0
165802,2,3,3,0,6,0
219145,1,0,3,-3,13,1
189689,4,20,6,14,17,0
277727,3,7,3,4,4,0
378946,4,16,30,-14,15,1
116476,4,6,16,-10,1,0
312491,2,13,0,13,3,0
390902,4,15,28,-13,3,0
363309,4,33,14,19,8,1
259846,1,7,7,0,14,1
149225,2,7,0,7,16,0
288974,2,16,7,9,9,1
187059,2,10,0,10,16,0
1395,3,10,0,10,1,1
122868,3,10,6,4,4,1
119745,2,10,3,7,3,1
333385,3,17,10,7,12,1
319234,4,17,17,0,5,0
344252,3,7,13,-6,17,0
220984,3,14,10,4,14,1
344434,4,28,24,4,17,0
293912,2,7,21,-14,12,1
55767,1,0,0,0,9,1
366654,1,7,3,4,10,1
363262,3,24,7,17,8,1
412550,4,31,14,17,14,0
67143,1,0,0,0,14,1
150534,1,0,0,0,17,0
111973,3,14,21,-7,17,1
293596,1,0,0,0,12,1
346964,2,7,3,4,1,1
238634,2,6,6,0,4,0
415417,2,9,0,9,15,1
269525,3,13,24,-11,1,1
343688,4,15,10,5,17,1
352227,2,0,3,-3,3,1
6065,2,7,7,0,3,1
299922,4,16,11,5,14,0
307145,2,0,3,-3,17,0
72914,2,16,7,9,16,1
282034,1,0,0,0,6,1
397485,3,13,19,-6,6,0
340564,4,7,42,-35,15,1
116355,4,40,13,27,1,1
17026,1,0,0,0,9,1
92647,1,0,0,0,8,0
246986,3,20,24,-4,8,0
200534,1,7,0,7,4,0
104422,1,0,0,0,13,0
164066,3,3,6,-3,5,0
326906,1,0,0,0,9,1
48935,4,15,13,2,5,1
159301,4,27,24,3,3,0
336125,2,10,3,7,13,1
112381,2,10,13,-3,17,1
204149,3,10,10,0,6,0
403979,1,0,0,0,10,0
162433,4,23,30,-7,4,1
17938,1,7,14,-7,9,1
116500,4,6,22,-16,1,1
11547,3,6,10,-4,6,1
341914,1,0,0,0,16,0
20431,1,0,0,0,10,0
348359,2,10,7,3,1,0
374105,2,13,7,6,13,1
316945,3,30,18,12,4,0
91960,3,6,23,-17,8,1
321420,2,14,17,-3,7,1
247368,1,3,0,3,8,0
250528,3,16,7,9,9,0
318676,1,0,13,-13,5,1
19039,3,7,6,1,10,0
67614,3,0,32,-32,14,0
327604,4,10,22,-12,10,0
306367,4,37,10,27,17,0
331567,2,10,20,-10,11,1
146972,2,17,0,17,15,1
19331,3,14,17,-3,10,0
418093,1,14,0,14,16,0
193306,4,10,23,-13,1,0
44494,4,27,20,7,3,0
283395,2,13,7,6,7,0
191124,3,21,20,1,17,1
246956,3,20,10,10,8,0
414279,3,21,21,0,14,0
70003,3,24,3,21,15,0
193490,4,33,20,13,1,0
315758,1,0,0,0,4,0
421676,2,17,7,10,17,1
100591,1,0,0,0,12,1
324000,4,17,16,1,8,1
52167,2,0,0,0,7,0
278480,3,29,0,29,4,1
115683,2,10,3,7,1,0
202058,1,0,0,0,5,1
231467,3,10,9,1,1,0
87758,4,6,20,-14,6,0
67438,2,10,7,3,14,0
377127,3,10,10,0,15,0
138539,4,31,37,-6,12,1
113379,1,0,0,0,17,0
328060,4,17,17,0,10,1
407401,2,7,7,0,11,1
44594,3,10,14,-4,3,1
118348,1,3,0,3,2,1
235377,2,14,7,7,3,1
209429,4,14,17,-3,8,0
135482,1,7,0,7,10,0
27328,2,14,3,11,13,1
125138,2,14,7,7,5,0
312514,2,20,0,20,3,0
133815,4,19,17,2,9,0
364331,4,9,39,-30,9,1
23303,2,3,10,-7,11,1
402012,3,3,12,-9,9,0
386327,2,10,3,7,2,0
95542,2,6,7,-1,10,0
176203,3,14,24,-10,11,0
412036,2,7,0,7,13,1
216140,1,7,0,7,12,0
260739,1,3,3,0,14,1
128747,1,0,0,0,7,0
354740,1,6,0,6,4,0
388940,3,10,20,-10,3,1
176401,4,22,28,-6,11,0
80471,2,5,0,5,3,0
309568,3,16,0,16,1,0
370561,2,14,0,14,12,0
284385,4,28,17,11,7,0
109578,3,16,7,9,16,0
65791,4,27,25,2,13,0
40724,2,10,7,3,2,0
104213,1,0,0,0,13,1
264817,4,17,37,-20,16,1
395871,4,10,17,-7,6,1
9079,4,28,13,15,4,1
1755,4,28,0,28,1,0
96454,2,10,14,-4,10,0
55337,5,20,20,0,9,0
105668,2,14,3,11,14,1
211775,1,0,7,-7,9,1
391302,3,17,3,14,4,1
308990,2,0,17,-17,1,0
395702,4,18,34,-16,6,0
101450,4,18,10,8,12,0
216335,2,7,13,-6,12,0
346304,1,0,0,0,1,0
223475,1,0,3,-3,15,1
214464,3,7,17,-10,11,0
350413,1,0,3,-3,2,1
420448,2,0,14,-14,17,1
372300,3,17,7,10,13,0
285528,1,7,7,0,8,0
313983,1,0,0,0,3,0
33702,3,28,0,28,16,1
241779,4,10,15,-5,5,0
181029,1,7,0,7,13,1
190922,1,6,0,6,17,1
316334,4,24,26,-2,4,0
218267,1,7,7,0,12,0
24009,1,0,0,0,12,1
190492,2,7,0,7,17,1
350873,2,0,7,-7,3,0
99739,2,0,0,0,12,1
331063,4,52,17,35,11,0
163897,2,16,10,6,5,1
140856,2,14,0,14,13,1
364781,1,0,0,0,9,1
85780,2,13,7,6,5,1
90582,2,14,7,7,7,0
262185,4,31,13,18,15,0
408187,3,13,0,13,12,0
270558,3,10,14,-4,1,1
333649,2,0,0,0,12,1
44053,1,0,0,0,3,0
57453,1,7,3,4,10,0
48151,3,10,13,-3,5,1
131526,2,6,12,-6,8,0
289211,4,20,13,7,9,1
62223,1,0,7,-7,12,1
158386,4,16,17,-1,3,1
333405,4,23,10,13,12,0
268854,1,0,7,-7,17,0
337348,3,14,7,7,14,0
158078,3,22,9,13,3,1
26918,3,13,6,7,13,1
375080,1,0,0,0,14,1
363963,2,0,9,-9,8,1
132483,4,8,31,-23,9,1
350839,1,0,0,0,3,0
313746,3,21,3,18,3,1
5390,3,13,13,0,3,1
303554,1,7,3,4,16,1
320653,1,7,7,0,6,0
355963,1,0,7,-7,5,1
284281,1,3,0,3,7,0
22813,4,13,21,-8,11,1
90630,3,17,30,-13,7,0
175353,1,7,0,7,11,1
132725,3,10,17,-7,9,0
130434,1,0,0,0,8,1
138801,2,0,33,-33,12,1
158415,4,16,27,-11,3,1
389803,3,17,6,11,3,0
374504,1,6,0,6,14,1
225777,2,10,14,-4,16,0
69255,2,6,0,6,15,1
304570,4,31,31,0,16,1
68464,1,0,0,0,14,0
22113,1,3,3,0,11,0
222691,4,14,24,-10,14,1
299688,2,17,3,14,14,1
149608,4,17,26,-9,16,0
336920,3,7,21,-14,14,1
374140,2,16,7,9,13,1
226583,2,3,3,0,16,1
165209,2,7,7,0,6,1
286425,3,14,3,11,8,0
400105,3,17,23,-6,8,0
172133,4,13,18,-5,9,0
183706,4,22,20,2,14,1
171370,4,16,17,-1,9,0
388176,3,3,6,-3,2,0
42970,4,31,23,8,3,1
343637,2,15,7,8,17,0
150583,2,3,13,-10,17,1
77901,4,24,38,-14,1,1
117744,1,0,0,0,2,0
226658,4,17,13,4,16,1
177326,1,0,0,0,11,1
375500,3,26,7,19,14,1
352365,2,14,7,7,3,1
161527,1,0,0,0,4,1
406924,1,0,6,-6,11,0
126366,3,7,14,-7,6,0
101737,3,13,7,6,12,0
68215,2,10,14,-4,14,0
267540,3,20,21,-1,17,1
403598,2,17,10,7,9,1
169665,3,20,17,3,8,1
39373,1,0,0,0,1,0
1297,4,24,23,1,1,1
226082,2,0,14,-14,16,1
204936,4,13,27,-14,6,1
290501,2,14,7,7,10,1
198383,4,23,14,9,3,0
352072,2,3,7,-4,3,0
49249,4,17,10,7,6,0
41799,3,10,14,-4,2,1
247246,2,21,14,7,8,1
254527,1,0,0,0,11,1
378727,2,14,7,7,15,0
131337,1,7,0,7,8,0
108222,2,6,0,6,15,1
146367,2,3,3,0,15,1
310789,3,12,10,2,2,1
243010,1,0,0,0,6,0
180756,2,7,3,4,13,0
52511,2,10,0,10,7,0
350531,4,17,19,-2,2,1
166967,1,0,0,0,7,1
206633,4,10,16,-6,7,1
122039,4,19,13,6,4,1
220429,3,23,14,9,13,1
223757,4,40,13,27,15,1
360326,3,0,20,-20,7,1
252167,3,20,10,10,10,0
407691,1,0,0,0,11,0
70147,2,20,7,13,15,0
47403,4,10,13,-3,5,0
288310,1,0,0,0,9,1
117050,2,0,17,-17,2,0
294104,4,7,27,-20,12,1
87063,1,0,0,0,5,0
22485,3,31,29,2,11,0
78103,1,7,3,4,2,0
124851,2,0,6,-6,5,1
54573,4,28,18,10,8,0
302544,4,3,13,-10,15,1
403535,1,0,0,0,9,1
417003,1,0,0,0,15,1
216539,3,34,11,23,12,0
328106,2,6,0,6,10,0
374747,4,0,39,-39,14,0
329458,1,3,0,3,10,0
108505,2,14,7,7,15,0
193164,4,16,6,10,1,1
217542,1,3,0,3,12,0
178747,1,14,0,14,12,0
74101,3,16,6,10,17,1
288950,1,9,0,9,9,1
350133,1,0,0,0,2,0
196084,2,6,21,-15,2,1
369650,1,6,0,6,11,1
391643,1,0,0,0,4,0
98962,4,7,24,-17,11,0
193483,4,33,20,13,1,1
35668,4,23,10,13,17,1
121052,3,11,24,-13,3,0
5763,2,14,0,14,3,1
408135,2,3,0,3,12,0
97597,1,0,0,0,11,1
121467,1,0,0,0,4,0
87514,2,7,0,7,6,1
382793,2,14,0,14,17,1
111620,1,7,10,-3,16,1
304002,1,0,10,-10,16,0
100703,4,21,24,-3,12,1
361387,3,17,7,10,7,0
154687,1,0,0,0,1,0
189551,1,0,0,0,17,0
217000,2,3,3,0,12,1
377522,2,0,6,-6,15,1
300581,1,0,0,0,15,1
251101,3,10,14,-4,10,1
374689,2,0,9,-9,14,1
355723,2,7,3,4,5,0
96732,2,0,10,-10,10,1
343456,2,7,7,0,16,0
136663,4,22,19,3,11,1
97786,2,7,3,4,11,0
361998,4,23,12,11,7,0
173904,2,13,10,3,10,0
154291,2,6,14,-8,1,0
94353,3,17,7,10,9,0
315194,2,10,10,0,4,1
319245,1,0,0,0,6,1
260019,1,0,0,0,14,0
214287,3,14,10,4,11,0
30516,1,0,0,0,14,1
79220,4,23,10,13,2,0
133939,3,6,6,0,9,1
137724,3,7,27,-20,11,1
363606,4,10,15,-5,8,1
57839,4,22,10,12,10,1
172904,3,27,24,3,9,0
330932,1,0,0,0,11,0
228096,4,3,10,-7,17,1
243800,4,24,20,4,6,0
165083,3,10,24,-14,6,0
194212,4,12,17,-5,1,0
44763,4,13,12,1,3,0
282084,2,9,8,1,6,0
283375,1,0,0,0,7,0
81551,2,7,21,-14,3,1
275697,1,0,0,0,3,0
290895,1,0,0,0,10,0
59280,1,0,0,0,11,1
245671,1,3,3,0,7,1
7655,4,34,3,31,4,0
288197,1,3,7,-4,9,1
362950,2,27,6,21,8,0
20744,4,31,20,11,10,0
178142,1,0,7,-7,12,0
297502,2,5,0,5,13,0
153967,1,7,7,0,1,1
339075,1,0,0,0,15,1
308039,1,0,0,0,1,0
273160,2,10,0,10,2,1
314714,1,0,0,0,4,1
65799,4,27,33,-6,13,1
78952,1,0,0,0,2,1
384561,2,3,35,-32,1,1
395516,3,21,14,7,6,1
151712,1,7,0,7,17,0
235538,2,3,13,-10,3,1
184685,3,10,24,-14,15,1
309306,3,0,23,-23,1,1
260146,1,0,0,0,14,1
84797,4,13,31,-18,4,1
390715,3,13,10,3,3,0
146269,3,3,30,-27,15,0
222902,2,6,3,3,14,1
359420,1,0,0,0,6,0
267005,4,19,17,2,17,1
392623,2,7,0,7,4,0
88857,4,13,16,-3,6,1
38386,3,14,16,-2,1,1
71323,3,10,20,-10,16,1
227919,3,27,20,7,16,1
54368,3,14,19,-5,8,1
338312,1,0,0,0,14,1
190077,2,17,3,14,17,1
26301,3,13,21,-8,13,1
242409,1,0,0,0,6,0
410948,4,14,29,-15,13,1
132397,2,0,7,-7,9,0
121986,3,16,7,9,4,1
110872,1,7,0,7,16,0
277266,3,0,13,-13,4,1
15698,4,37,17,20,8,0
227372,4,27,37,-10,16,0
283794,4,21,3,18,7,0
6798,2,3,7,-4,3,0
360224,4,20,13,7,7,0
332602,2,17,6,11,12,1
401932,1,0,3,-3,9,1
1308,4,31,23,8,1,1
321177,3,3,19,-16,6,1
327923,4,37,24,13,10,0
66282,1,0,0,0,14,0
396102,2,17,9,8,6,0
81429,4,10,13,-3,3,0
153990,2,7,7,0,1,0
21296,3,3,14,-11,11,0
101035,1,0,0,0,12,1
63537,1,0,0,0,12,1
267865,3,26,17,9,17,0
280334,4,19,22,-3,5,1
357942,1,7,6,1,6,1
319072,4,20,38,-18,5,0
297837,3,14,10,4,13,1
6429,4,9,20,-11,3,1
210964,4,33,23,10,9,1
322981,4,20,0,20,7,0
55333,4,20,17,3,9,0
128920,2,15,3,12,7,0
207491,4,21,14,7,7,1
48787,4,24,28,-4,5,1
403415,1,7,0,7,9,0
352566,3,27,20,7,3,1
239008,3,29,15,14,4,0
261623,1,0,0,0,14,1
383008,4,10,24,-14,17,0
305741,3,9,10,-1,17,1
407832,1,3,0,3,11,0
324153,3,3,10,-7,8,0
166910,3,10,6,4,6,1
17478,1,7,0,7,9,1
31454,2,3,7,-4,15,1
87229,1,7,7,0,6,0
147983,1,0,3,-3,15,1
95921,5,23,23,0,10,0
276423,4,32,44,-12,3,0
54327,2,7,5,2,8,1
356571,4,9,6,3,5,0
322858,1,0,0,0,7,1
150679,1,0,0,0,17,0
239739,3,10,13,-3,4,1
359576,2,10,0,10,6,1
113756,3,3,17,-14,17,1
4269,4,20,6,14,2,0
50300,3,13,16,-3,6,0
297601,4,24,13,11,13,0
76661,3,10,0,10,1,1
126368,3,7,14,-7,6,1
416302,2,10,3,7,15,1
366804,1,0,0,0,10,0
820,3,14,6,8,1,0
141963,2,10,7,3,13,0
3706,1,9,0,9,2,1
176071,4,24,8,16,11,1
173870,1,6,7,-1,10,1
22293,2,0,3,-3,11,1
60513,2,27,7,20,11,1
237283,4,26,0,26,3,1
260481,2,10,0,10,14,1
30682,1,3,0,3,15,0
142941,3,3,13,-10,13,1
342941,4,37,17,20,16,1
276958,3,17,20,-3,4,1
292462,2,10,6,4,11,0
59547,4,13,35,-22,11,0
353457,4,25,12,13,4,0
321144,2,3,10,-7,6,1
376483,1,0,3,-3,14,1
51972,1,0,0,0,7,1
389388,4,30,13,17,3,0
296885,2,10,0,10,13,0
413902,4,17,9,8,14,1
383374,2,0,9,-9,17,1
32103,3,21,13,8,15,0
254766,3,10,9,1,11,0
97531,3,22,0,22,10,1
363420,3,21,21,0,8,1
236710,4,30,7,23,3,0
36961,3,0,25,-25,17,0
316791,3,13,7,6,4,1
354027,2,6,0,6,4,1
348097,3,3,19,-16,1,1
184241,3,24,0,24,14,0
196452,4,20,28,-8,2,1
116501,4,6,22,-16,1,1
257994,3,0,21,-21,13,0
336962,4,21,21,0,14,0
212902,2,0,7,-7,10,1
48154,3,10,13,-3,5,0
400709,4,16,10,6,8,0
364853,2,6,14,-8,9,0
235450,4,28,31,-3,3,0
192047,4,24,27,-3,1,1
167569,4,3,17,-14,7,1
271721,2,13,10,3,2,0
272577,3,13,3,10,2,1
329660,3,16,14,2,11,1
134435,2,0,14,-14,10,1
337978,4,23,0,23,14,0
395482,2,7,0,7,6,1
252538,4,29,31,-2,10,0
310797,4,13,10,3,2,0
665,3,0,10,-10,1,0
130811,3,13,12,1,8,1
79931,3,10,16,-6,2,1
209249,4,20,7,13,8,1
197390,1,7,0,7,3,1
142208,5,11,13,-2,13,0
90845,1,14,0,14,7,1
289328,3,28,17,11,9,0
255648,2,3,7,-4,12,0
63686,4,33,36,-3,12,1
159555,2,14,6,8,3,1
116148,2,7,10,-3,1,1
58897,3,6,18,-12,10,0
164922,3,0,6,-6,6,0
281079,4,38,16,22,6,1
335053,4,16,20,-4,13,1
351907,1,0,0,0,3,0
231288,2,3,3,0,1,1
404692,4,27,32,-5,10,0
340456,1,0,13,-13,15,1
310975,4,9,37,-28,2,1
55606,4,27,7,20,9,0
292989,1,0,0,0,11,0
331320,3,0,27,-27,11,0
126257,4,28,9,19,6,0
143662,3,16,10,6,14,1
270400,2,10,0,10,1,0
190331,1,0,0,0,17,1
352906,1,0,0,0,3,1
47522,2,23,6,17,5,1
37254,4,13,14,-1,17,0
128831,4,13,13,0,7,1
138135,1,7,9,-2,11,1
328603,2,17,14,3,10,0
254294,3,6,16,-10,11,0
409433,4,34,3,31,12,1
319407,1,0,0,0,6,0
380952,3,9,7,2,16,0
11994,3,24,14,10,6,1
243277,2,7,10,-3,6,1
390798,1,0,7,-7,3,1
320792,4,17,26,-9,6,0
141106,5,17,17,0,13,0
359605,2,24,0,24,6,0
351575,4,0,27,-27,3,1
246049,2,10,13,-3,7,1
374443,3,25,0,25,14,0
87521,2,14,0,14,6,1
367291,3,3,17,-14,10,1
396758,4,7,20,-13,6,1
274420,3,10,17,-7,3,0
14058,3,3,24,-21,7,1
137405,3,6,21,-15,11,1
212186,3,3,17,-14,10,0
407994,1,0,0,0,12,1
208571,1,0,0,0,8,1
60744,4,28,3,25,11,0
371933,4,34,17,17,12,1
264276,3,10,17,-7,15,0
388752,2,11,0,11,3,1
291645,4,23,20,3,11,1
219341,3,16,10,6,13,0
45736,2,7,7,0,4,1
202914,3,28,0,28,5,1
225397,4,27,35,-8,15,1
279462,1,0,0,0,5,1
57027,2,7,17,-10,9,1
252050,4,14,20,-6,10,0
357031,1,0,0,0,5,1
222487,2,6,14,-8,14,1
396453,4,20,25,-5,6,1
69913,4,27,16,11,15,0
66896,2,6,7,-1,14,1
159668,1,0,0,0,3,0
324231,2,3,0,3,8,0
143159,1,0,0,0,13,0
186966,3,10,12,-2,15,0
294265,4,28,21,7,12,1
7166,4,41,24,17,4,0
368101,2,7,0,7,11,0
392144,2,0,13,-13,4,1
253841,2,14,14,0,11,1
273186,3,24,7,17,2,1
283110,2,3,0,3,7,0
4996,4,24,17,7,3,0
237935,1,0,0,0,4,0
362368,3,23,14,9,8,0
401075,2,21,3,18,8,0
111915,1,0,14,-14,17,1
55859,3,13,14,-1,9,0
79165,2,9,7,2,2,1
393462,4,34,27,7,5,0
343042,2,6,7,-1,16,1
193419,3,13,20,-7,1,0
360811,4,24,30,-6,7,0
253525,2,0,7,-7,11,1
253348,1,7,0,7,11,0
363811,2,13,10,3,8,1
372417,2,6,7,-1,13,0
127439,2,3,0,3,6,0
208737,2,0,6,-6,8,1
303198,5,31,31,0,16,1
271829,1,0,0,0,2,0
212675,4,9,31,-22,10,0
316879,2,3,2,1,4,0
401779,1,7,0,7,9,0
421332,1,0,3,-3,17,1
64285,2,3,10,-7,13,1
217320,3,0,10,-10,12,1
61318,4,31,28,3,11,1
303520,4,37,17,20,16,0
258704,2,0,17,-17,13,0
399318,2,14,7,7,7,1
261402,3,10,17,-7,14,0
252768,2,3,6,-3,11,1
41129,1,0,0,0,2,1
201142,2,6,21,-15,5,1
127827,4,17,42,-25,6,1
188796,4,7,20,-13,16,1
188710,2,0,17,-17,16,1
392921,2,3,3,0,4,1
300445,2,9,0,9,14,1
13857,1,7,0,7,7,0
128321,2,0,3,-3,7,1
243199,1,0,0,0,6,0
317336,2,0,0,0,5,0
62668,4,24,20,4,12,0
395484,2,7,0,7,6,1
172862,2,17,10,7,9,1
194409,1,3,0,3,2,1
21769,4,31,24,7,11,1
48135,3,7,6,1,5,1
388133,2,3,6,-3,2,1
132394,2,0,7,-7,9,0
119208,1,0,0,0,3,0
75879,2,14,7,7,1,1
236318,2,0,16,-16,3,0
20139,2,3,0,3,10,1
290574,4,23,20,3,10,1
252107,1,7,7,0,10,0
3102,1,0,3,-3,2,1
336427,2,10,10,0,14,1
207542,1,13,0,13,7,1
216835,2,7,7,0,12,1
98753,3,34,6,28,11,0
322173,2,0,17,-17,7,0
152495,2,17,7,10,17,1
198072,4,10,37,-27,3,0
98314,4,28,27,1,11,1
218476,3,24,17,7,13,1
388889,2,10,14,-4,3,0
417483,2,10,21,-11,16,1
95123,2,9,17,-8,9,1
150777,4,13,9,4,17,1
49592,4,28,10,18,6,0
376981,3,15,16,-1,15,0
288636,1,0,0,0,9,0
336340,4,20,13,7,13,1
271763,3,23,10,13,2,0
115575,3,24,9,15,1,1
94275,1,0,0,0,9,1
117612,1,6,10,-4,2,1
38725,4,24,17,7,1,1
18404,2,0,7,-7,9,1
295590,4,23,32,-9,12,1
4962,4,21,17,4,3,0
254726,2,3,3,0,11,0
87104,2,7,3,4,5,1
100618,2,6,7,-1,12,1
173271,1,7,3,4,10,0
385206,4,21,20,1,1,1
210985,1,0,0,0,9,1
73273,4,14,23,-9,16,1
156931,2,7,10,-3,2,0
60398,3,13,7,6,11,1
32434,4,31,6,25,15,1
253468,4,14,38,-24,11,1
378713,2,14,7,7,15,1
32249,3,21,14,7,15,1
224791,3,8,10,-2,15,1
337315,2,7,7,0,14,1
300670,4,24,3,21,15,0
316196,1,0,0,0,4,1
116712,2,6,10,-4,2,1
5810,3,24,7,17,3,1
269052,2,10,16,-6,17,0
402546,2,7,7,0,9,0
95134,3,9,17,-8,9,1
348892,4,9,14,-5,2,0
148513,4,24,3,21,16,0
379958,4,24,6,18,16,0
197104,2,7,17,-10,3,1
330433,4,13,20,-7,11,1
276673,3,23,6,17,4,0
288619,4,23,41,-18,9,0
225327,2,7,21,-14,15,0
288846,2,10,17,-7,9,0
219847,3,38,0,38,13,1
281070,4,30,16,14,6,1
398867,1,3,0,3,7,0
255697,4,3,10,-7,12,0
131379,2,7,13,-6,8,0
328485,3,6,3,3,10,1
356793,2,0,0,0,5,0
47614,1,0,7,-7,5,1
385763,2,17,0,17,1,0
337327,2,14,7,7,14,0
344438,4,28,24,4,17,1
375413,1,0,0,0,14,0
285547,2,7,7,0,8,0
166398,2,10,7,3,6,0
136101,2,0,10,-10,10,1
284518,4,24,15,9,7,0
298523,2,10,0,10,14,1
75655,4,13,6,7,17,1
30151,2,10,16,-6,14,0
155669,2,3,10,-7,2,0
126502,2,0,6,-6,6,0
91062,4,9,0,9,7,1
293678,3,10,10,0,12,1
161453,3,7,3,4,4,1
174476,1,7,7,0,10,1
386573,4,14,31,-17,2,1
381795,2,0,6,-6,17,0
205226,4,20,13,7,6,1
14662,4,24,14,10,7,1
105388,3,23,7,16,14,0
295102,2,7,14,-7,12,1
49484,1,0,3,-3,6,1
163277,2,13,6,7,5,0
244849,3,7,10,-3,7,0
30728,3,17,21,-4,15,1
171279,2,0,0,0,9,0
340367,3,17,13,4,15,1
376008,4,26,21,5,14,0
231903,3,7,34,-27,1,0
151229,3,17,23,-6,17,0
419902,3,6,18,-12,17,0
410595,3,17,7,10,13,0
90545,1,7,0,7,7,0
220723,3,13,6,7,13,0
163818,4,17,22,-5,5,1
93557,2,3,3,0,9,1
191438,4,0,31,-31,17,1
78778,4,13,23,-10,2,1
408803,3,10,25,-15,12,1
225300,1,0,14,-14,15,0
108390,3,3,21,-18,15,0
43534,3,10,3,7,3,1
152428,4,38,3,35,17,1
89987,2,5,14,-9,7,1
89571,3,7,27,-20,7,0
152488,2,10,7,3,17,1
65775,4,21,25,-4,13,0
330860,3,13,17,-4,11,1
396956,1,0,0,0,6,1
394265,1,0,0,0,5,1
180508,3,21,20,1,13,1
146105,3,22,17,5,15,1
345451,4,3,19,-16,17,0
49736,4,35,31,4,6,0
183455,4,27,6,21,14,1
164304,2,13,0,13,5,0
308630,4,34,16,18,1,0
390085,2,10,7,3,3,1
65255,1,0,7,-7,13,0
76749,1,10,0,10,1,1
210836,1,0,0,0,9,0
44002,4,3,28,-25,3,1
262953,4,14,32,-18,15,0
368917,4,38,3,35,11,0
254275,2,6,9,-3,11,0
305442,4,20,3,17,17,1
64542,1,0,0,0,13,1
129888,3,13,0,13,7,0
331472,3,9,15,-6,11,0
357575,3,13,13,0,5,1
315419,4,23,30,-7,4,0
128573,4,28,35,-7,7,1
254896,2,14,7,7,12,1
366084,1,0,0,0,10,0
178748,1,14,0,14,12,0
100513,3,10,17,-7,12,0
180433,1,7,7,0,13,1
204749,3,14,14,0,6,0
356075,4,27,10,17,5,1
91774,2,3,0,3,8,1
311560,1,0,0,0,2,1
348625,4,34,23,11,2,0
291995,2,6,3,3,11,0
369238,1,7,7,0,11,1
214864,2,0,9,-9,11,1
29026,4,14,10,4,14,1
87970,1,0,0,0,6,1
77607,1,0,7,-7,1,0
226677,1,7,3,4,16,1
306077,4,17,13,4,17,1
201409,1,6,0,6,5,0
347039,4,24,17,7,1,0
353858,2,7,14,-7,4,0
16346,2,7,7,0,8,1
186819,3,29,7,22,15,0
401659,1,0,14,-14,8,1
420046,3,24,14,10,17,0
357140,4,6,14,-8,5,1
328795,3,17,13,4,10,1
127564,1,0,3,-3,6,0
304001,1,0,7,-7,16,0
140684,1,0,0,0,12,1
273152,2,10,0,10,2,0
195057,2,7,17,-10,2,1
396233,2,0,3,-3,6,1
30757,4,31,28,3,15,1
7029,4,19,7,12,3,0
136969,4,17,13,4,11,0
375186,4,17,17,0,14,1
328805,4,17,13,4,10,1
46977,1,0,0,0,5,0
92561,2,17,0,17,8,0
45186,3,7,10,-3,4,1
105940,1,7,0,7,14,1
84672,1,0,0,0,4,1
197151,3,27,20,7,3,1
269877,4,22,10,12,1,1
190663,2,28,14,14,17,0
57819,4,19,10,9,10,0
248557,1,0,0,0,9,0
389469,2,10,0,10,3,1
38101,3,6,6,0,1,1
15859,4,8,19,-11,8,0
380112,4,35,30,5,16,0
5157,4,19,14,5,3,0
14516,4,34,36,-2,7,1
254228,1,0,0,0,11,0
243231,1,0,7,-7,6,1
312751,4,31,21,10,3,0
345778,4,19,10,9,17,1
216258,4,17,20,-3,12,1
18184,4,20,20,0,9,1
365365,4,17,19,-2,9,1
44895,3,7,37,-30,4,0
48338,4,28,20,8,5,0
119759,2,10,3,7,3,0
396154,3,24,23,1,6,0
163866,1,6,7,-1,5,0
166569,2,6,7,-1,6,0
116016,3,13,0,13,1,0
367410,2,17,14,3,10,0
419762,3,17,17,0,17,0
302121,4,34,34,0,15,0
333336,2,10,7,3,12,0
227168,3,10,7,3,16,1
309683,2,3,3,0,1,0
342377,1,0,3,-3,16,1
419317,3,0,17,-17,16,0
3435,2,3,16,-13,2,1
125383,1,0,0,0,5,0
415815,1,0,6,-6,15,0
186305,2,19,3,16,15,0
208477,2,17,7,10,8,1
252146,2,10,10,0,10,1
342114,2,12,6,6,16,0
123340,3,21,14,7,4,0
86967,2,14,3,11,5,1
337147,1,3,0,3,14,1
146196,2,0,9,-9,15,0
260224,3,10,3,7,14,0
182334,3,17,10,7,14,1
92678,2,3,10,-7,8,1
251597,4,19,20,-1,10,0
54401,4,27,25,2,8,1
220566,3,10,23,-13,13,1
270990,2,3,14,-11,1,0
351325,2,7,7,0,3,1
17209,2,7,28,-21,9,1
13764,3,7,20,-13,7,0
298091,2,3,24,-21,13,1
313857,2,14,10,4,3,0
221413,2,3,23,-20,14,0
241181,4,20,10,10,5,1
231388,4,9,19,-10,1,1
415080,1,0,0,0,15,1
357089,2,6,14,-8,5,0
232979,3,10,3,7,2,0
165615,1,0,0,0,6,1
209625,4,50,34,16,8,1
80336,2,13,6,7,2,1
243385,1,3,7,-4,6,0
130080,4,17,30,-13,8,0
209596,4,43,34,9,8,1
7982,4,16,27,-11,4,0
11924,1,0,0,0,6,0
389528,4,20,10,10,3,0
62590,2,6,10,-4,12,0
177151,4,40,13,27,11,1
6120,3,7,10,-3,3,1
404416,1,0,0,0,10,1
35216,4,0,14,-14,16,0
222303,1,7,0,7,14,0
20778,1,7,0,7,10,0
259311,3,13,13,0,13,0
294489,2,10,10,0,12,0
380526,2,7,17,-10,16,1
75132,3,7,6,1,17,1
48837,2,3,0,3,5,0
340123,1,6,0,6,15,0
390675,2,3,3,0,3,1
381409,3,16,0,16,16,0
105329,1,0,7,-7,14,1
421101,2,20,3,17,17,0
338134,4,12,7,5,14,1
125796,3,14,20,-6,5,0
361234,3,7,20,-13,7,1
394849,1,0,14,-14,5,1
227440,2,10,7,3,16,0
317691,4,22,9,13,5,1
17315,1,7,0,7,9,0
196002,4,7,30,-23,2,0
64791,4,31,7,24,13,1
173821,4,17,3,14,10,1
401925,1,0,0,0,9,0
226697,1,7,3,4,16,1
103788,2,3,0,3,13,1
298630,1,3,0,3,14,1
385351,4,17,31,-14,1,1
352594,4,34,23,11,3,1
112150,3,10,20,-10,17,0
4164,1,0,3,-3,2,0
247211,1,0,7,-7,8,1
408680,4,31,17,14,12,1
28611,1,0,0,0,14,0
322225,3,0,27,-27,7,1
187234,2,7,6,1,16,0
112170,4,13,27,-14,17,0
59769,2,9,10,-1,11,0
382615,1,0,0,0,17,0
348239,3,16,24,-8,1,1
247460,4,13,9,4,8,0
230264,2,9,10,-1,17,0
113981,4,20,20,0,17,0
140095,2,0,0,0,12,1
259396,1,0,0,0,13,1
406508,2,0,16,-16,11,1
37723,1,7,0,7,1,0
358649,1,0,0,0,6,0
369723,3,22,23,-1,11,1
273427,1,0,0,0,2,1
18767,3,13,10,3,9,0
217951,1,0,0,0,12,1
17827,2,13,10,3,9,1
271075,4,35,34,1,1,0
233228,1,0,0,0,2,1
238871,4,41,7,34,4,0
229046,1,0,0,0,17,1
372102,1,3,0,3,13,0
21869,3,21,0,21,11,1
155583,4,23,10,13,2,0
104646,3,7,3,4,14,0
255686,3,3,10,-7,12,0
337434,1,0,6,-6,14,0
169419,4,6,31,-25,8,1
48663,1,7,0,7,5,0
248855,1,0,0,0,9,1
273635,3,13,6,7,2,0
109143,3,24,7,17,15,0
339142,3,10,13,-3,15,1
123112,1,0,0,0,4,1
221147,3,0,9,-9,14,0
210508,4,9,21,-12,9,0
351676,3,7,10,-3,3,0
34629,4,24,10,14,16,1
343824,3,21,3,18,17,0
251338,2,14,7,7,10,1
5262,4,24,31,-7,3,1
188087,2,0,3,-3,16,0
325713,1,0,0,0,9,1
5454,1,0,0,0,3,0
75977,1,7,0,7,1,0
72570,4,19,31,-12,16,1
104550,4,14,38,-24,13,0
420734,1,0,0,0,17,0
349465,3,6,20,-14,2,1
191577,4,21,24,-3,17,0
170165,4,10,20,-10,8,1
417071,3,20,0,20,15,1
63035,3,16,21,-5,12,1
12955,1,0,0,0,6,0
39035,4,37,24,13,1,0
21265,2,3,7,-4,11,1
258450,4,21,13,8,13,0
121006,2,8,21,-13,3,0
138158,2,7,9,-2,11,0
303666,4,38,19,19,16,1
238195,2,3,16,-13,4,1
132270,3,21,7,14,9,1
322061,3,23,0,23,7,1
87545,2,17,3,14,6,1
316192,4,30,35,-5,4,1
253358,1,7,7,0,11,0
356802,2,0,0,0,5,0
251669,2,6,3,3,10,0
64591,2,16,14,2,13,1
109067,1,0,0,0,15,0
381511,2,14,0,14,17,0
316262,2,7,16,-9,4,0
18909,4,9,13,-4,9,0
371021,2,7,10,-3,12,1
234416,1,7,0,7,2,0
188451,4,3,6,-3,16,0
378057,4,0,14,-14,15,0
264442,4,10,28,-18,15,1
62395,2,0,10,-10,12,0
9066,3,28,13,15,4,0
195559,3,6,7,-1,2,1
77737,4,26,24,2,1,0
68219,3,10,14,-4,14,1
195791,2,13,7,6,2,1
289015,3,19,21,-2,9,1
314028,2,6,0,6,3,0
396421,3,20,18,2,6,1
218362,4,20,33,-13,12,1
183910,1,7,3,4,14,1
338533,3,20,17,3,14,0
64297,2,6,10,-4,13,1
230641,4,22,31,-9,1,1
402842,1,10,0,10,9,1
114444,1,0,0,0,1,0
307358,3,16,22,-6,17,1
351412,4,13,16,-3,3,1
98998,1,0,0,0,11,1
162971,2,6,0,6,5,0
198672,4,15,21,-6,3,0
378936,4,16,30,-14,15,0
367523,1,7,3,4,10,0
373671,2,0,12,-12,13,1
210816,4,24,10,14,9,0
399688,4,19,9,10,8,1
136624,3,15,16,-1,11,0
70394,1,7,0,7,15,1
34282,3,20,9,11,16,0
72116,4,17,17,0,16,0
151987,4,34,34,0,17,1
371008,2,7,7,0,12,1
296930,3,19,0,19,13,1
16190,1,0,0,0,8,1
324920,4,17,23,-6,8,0
11821,2,27,17,10,6,1
133105,1,0,0,0,9,0
268027,3,21,9,12,17,1
420261,1,7,0,7,17,0
206710,3,0,14,-14,7,1
167764,4,26,23,3,7,0
153108,2,6,10,-4,1,1
181270,3,0,13,-13,13,1
343870,4,26,6,20,17,1
287827,3,28,17,11,9,1
113631,3,9,13,-4,17,0
260350,2,6,0,6,14,0
34450,3,31,3,28,16,1
30362,4,10,20,-10,14,0
325754,2,0,7,-7,9,0
105135,4,33,14,19,14,0
342871,2,16,7,9,16,1
119282,3,14,10,4,3,1
248299,2,17,6,11,8,0
168952,1,0,0,0,7,1
294056,2,7,14,-7,12,0
193474,4,23,20,3,1,1
247378,1,3,6,-3,8,1
377411,3,7,13,-6,15,1
286351,1,0,0,0,8,1
75212,1,0,0,0,17,1
273926,2,7,6,1,2,1
146070,2,19,3,16,15,0
300604,2,10,0,10,15,0
351376,3,10,10,0,3,1
40805,4,17,28,-11,2,0
344884,4,30,10,20,17,1
45578,2,7,13,-6,4,1
37903,2,3,14,-11,1,1
420465,2,0,21,-21,17,0
344452,4,28,24,4,17,1
9287,2,7,0,7,5,0
216730,3,27,6,21,12,0
83914,4,23,24,-1,4,1
4849,1,0,0,0,3,1
110381,4,27,24,3,16,1
139167,4,19,13,6,12,1
3611,3,20,21,-1,2,1
341045,2,7,14,-7,15,1
303662,4,38,19,19,16,0
236300,2,0,9,-9,3,0
260220,2,10,3,7,14,0
263873,1,0,0,0,15,1
122711,2,7,10,-3,4,0
67553,1,0,0,0,14,0
370250,1,0,13,-13,12,0
404357,3,20,6,14,10,0
299565,2,3,3,0,14,1
77433,4,27,21,6,1,1
219787,2,35,0,35,13,0
61155,4,0,14,-14,11,1
341115,4,14,17,-3,15,0
235666,2,0,3,-3,3,0
245687,2,3,3,0,7,0
264053,1,7,14,-7,15,0
207507,4,28,21,7,7,1
233872,2,7,6,1,2,1
327826,2,9,10,-1,10,1
348916,4,9,21,-12,2,1
411059,3,17,17,0,13,0
391925,4,23,27,-4,4,0
252845,4,9,13,-4,11,0
275668,4,37,3,34,3,0
253763,4,24,10,14,11,0
339879,2,23,0,23,15,0
186206,4,22,13,9,15,1
13044,3,14,7,7,6,0
178020,3,7,20,-13,12,0
140802,4,22,30,-8,12,0
222535,4,17,14,3,14,1
222495,3,6,14,-8,14,0
133133,2,7,10,-3,9,1
87587,3,17,3,14,6,0
283549,2,6,13,-7,7,0
180438,2,7,7,0,13,1
278775,2,0,0,0,5,1
59965,3,3,24,-21,11,0
259087,1,0,0,0,13,0
71668,4,3,34,-31,16,1
368346,1,0,0,0,11,1
342737,3,0,7,-7,16,1
106257,1,0,0,0,14,0
156547,4,14,6,8,2,1
200512,4,26,18,8,4,1
400063,2,14,6,8,8,1
263993,4,23,7,16,15,1
122676,1,0,3,-3,4,1
353314,4,38,28,10,4,0
91430,1,3,0,3,8,1
289856,1,0,3,-3,10,0
68046,2,3,10,-7,14,1
206753,4,7,24,-17,7,1
205121,1,0,0,0,6,1
154148,3,7,6,1,1,1
204723,2,7,14,-7,6,1
219593,1,3,0,3,13,1
348387,3,13,13,0,1,1
191427,4,0,31,-31,17,1
117296,1,6,0,6,2,1
258107,2,13,13,0,13,0
173195,3,20,17,3,9,1
263453,2,6,13,-7,15,0
64113,1,0,0,0,13,1
160688,3,10,0,10,4,1
213477,1,0,0,0,10,0
347983,4,0,24,-24,1,1
239421,2,9,10,-1,4,1
124185,4,22,27,-5,5,1
309059,4,0,20,-20,1,0
133140,2,10,10,0,9,0
170807,1,0,0,0,8,1
90879,2,31,0,31,7,0
118228,1,9,0,9,2,0
289117,1,6,0,6,9,0
410444,3,9,17,-8,13,0
198384,1,0,0,0,3,1
278691,4,24,10,14,4,1
233485,4,23,10,13,2,1
72734,1,0,0,0,16,0
407796,4,17,7,10,11,0
131335,1,7,0,7,8,0
137496,1,7,7,0,11,1
182813,3,26,10,16,14,0
258515,1,0,0,0,13,1
65266,2,0,14,-14,13,1
79630,3,21,14,7,2,0
263399,1,0,0,0,15,1
55027,1,0,0,0,8,1
341014,1,0,0,0,15,0
971,3,0,3,-3,1,1
114941,2,0,3,-3,1,1
242198,3,16,7,9,6,1
397600,3,6,20,-14,7,0
295501,1,7,7,0,12,1
278188,3,24,20,4,4,0
209388,3,14,7,7,8,0
401845,3,7,21,-14,9,0
109583,3,16,14,2,16,1
369368,1,3,0,3,11,1
172543,2,0,21,-21,9,1
259948,3,20,13,7,14,0
148165,2,3,21,-18,16,1
90238,1,0,6,-6,7,0
273263,1,7,0,7,2,0
63941,4,6,27,-21,12,1
83170,1,0,0,0,4,1
354989,3,7,12,-5,4,0
19661,1,0,0,0,10,0
248385,1,3,0,3,8,1
162927,1,3,0,3,5,0
119662,4,17,12,5,3,0
21564,2,7,10,-3,11,1
396042,1,0,0,0,6,1
151742,2,7,6,1,17,1
142361,4,7,6,1,13,1
32611,1,0,0,0,15,0
137174,1,0,0,0,11,0
180285,2,6,7,-1,13,1
185441,4,17,10,7,15,0
106863,1,6,0,6,14,1
303605,3,28,13,15,16,1
75321,4,14,26,-12,17,0
156677,3,6,14,-8,2,1
155962,1,3,7,-4,2,1
266905,1,7,0,7,17,0
211654,2,16,3,13,9,1
63465,3,21,13,8,12,1
140650,4,38,10,28,12,0
353157,4,19,29,-10,3,1
69468,4,24,10,14,15,1
389037,2,20,0,20,3,0
204201,4,24,20,4,6,0
133970,4,16,13,3,9,1
285452,3,33,8,25,8,1
388679,4,20,7,13,3,1
119134,3,10,7,3,3,1
211130,1,0,3,-3,9,1
368852,2,24,0,24,11,0
34060,1,0,0,0,16,1
96817,4,7,17,-10,10,1
167941,1,0,0,0,7,0
236338,3,7,23,-16,3,1
231145,2,3,0,3,1,1
286686,2,10,7,3,8,1
337804,3,23,6,17,14,0
287023,2,13,21,-8,8,1
107749,2,7,10,-3,15,0
175223,1,10,0,10,10,1
174,1,3,0,3,1,0
357187,4,12,27,-15,5,1
2852,3,31,24,7,2,1
138908,1,0,3,-3,12,1
280023,3,3,20,-17,5,0
175018,4,13,28,-15,10,1
148878,1,3,6,-3,16,0
390852,3,3,28,-25,3,0
136684,1,0,7,-7,11,1
303187,4,31,28,3,16,0
420984,4,14,21,-7,17,0
56782,4,14,13,1,9,1
157431,3,9,10,-1,2,0
99649,3,23,3,20,11,0
153367,1,0,7,-7,1,0
200878,2,14,0,14,4,1
201349,3,28,13,15,5,0
144939,4,20,7,13,14,1
392140,2,0,13,-13,4,1
68485,2,0,7,-7,14,0
207354,4,13,21,-8,7,1
414673,2,0,7,-7,14,1
332405,1,0,3,-3,12,1
379068,3,7,6,1,15,0
78902,3,17,7,10,2,0
181034,1,7,0,7,13,0
27366,3,24,10,14,13,0
92945,1,0,0,0,8,1
105800,1,6,3,3,14,1
173713,1,0,3,-3,10,1
307795,3,17,14,3,1,0
246417,1,0,0,0,8,1
158611,2,7,7,0,3,0
175107,2,14,10,4,10,1
395262,4,10,13,-3,5,0
235605,4,27,20,7,3,1
376724,4,6,0,6,14,0
397849,2,0,0,0,7,1
291311,3,21,22,-1,10,1
317958,2,10,10,0,5,0
129031,1,0,0,0,7,0
22521,4,31,37,-6,11,0
13702,1,0,7,-7,7,0
149359,2,3,0,3,16,1
326995,3,2,10,-8,9,0
32290,4,30,28,2,15,0
264599,4,12,17,-5,16,0
148498,3,24,3,21,16,1
311275,4,9,3,6,2,1
30315,3,3,10,-7,14,0
187934,1,3,7,-4,16,0
145531,4,26,17,9,14,0
4357,2,7,7,0,2,0
175870,3,20,27,-7,11,0
288564,3,20,31,-11,9,1
344245,2,7,13,-6,17,1
368523,2,3,0,3,11,1
352084,2,3,10,-7,3,0
184016,4,22,10,12,14,1
49580,4,21,10,11,6,1
118467,4,27,10,17,2,1
189440,2,7,0,7,17,1
342619,4,22,27,-5,16,1
142803,3,12,10,2,13,0
133852,1,0,3,-3,9,1
277570,3,6,14,-8,4,0
175273,3,15,7,8,10,0
131424,4,7,19,-12,8,1
18908,4,9,13,-4,9,0
323722,4,33,0,33,8,0
290685,3,35,22,13,10,1
363459,4,28,42,-14,8,1
293481,2,7,3,4,11,1
264565,3,10,17,-7,16,0
167242,4,30,17,13,7,0
140449,2,14,7,7,12,0
156947,2,7,10,-3,2,0
235236,2,15,3,12,3,0
152006,1,0,0,0,17,1
249500,2,14,3,11,9,0
43042,2,3,0,3,3,0
67251,4,7,3,4,14,0
388650,4,17,0,17,3,1
358498,1,0,0,0,6,0
111811,2,3,10,-7,17,0
149754,4,55,0,55,16,0
145512,4,26,17,9,14,1
2354,1,0,3,-3,2,1
314510,3,21,0,21,3,0
238553,4,16,20,-4,4,1
235059,1,0,7,-7,2,1
182554,4,42,27,15,14,0
317522,3,10,27,-17,5,1
101584,3,13,31,-18,12,0
397747,3,9,14,-5,7,0
26124,2,0,13,-13,13,0
185135,4,0,16,-16,15,0
322529,4,15,3,12,7,1
114682,3,6,10,-4,1,0
413351,1,0,0,0,14,1
72238,4,24,17,7,16,1
413671,2,7,6,1,14,0
215228,4,10,16,-6,11,0
225501,3,0,14,-14,15,0
148111,1,0,0,0,16,0
64229,4,38,6,32,13,0
129738,3,17,17,0,7,1
74022,4,37,7,30,17,1
357243,2,3,3,0,5,1
393920,4,23,20,3,5,0
246583,1,0,3,-3,8,1
181302,4,3,20,-17,13,0
204651,4,17,48,-31,6,1
54599,1,7,6,1,8,1
301247,4,27,17,10,15,0
294432,4,19,12,7,12,0
83594,4,3,17,-14,4,1
382201,1,3,3,0,17,0
207771,4,24,13,11,7,0
174890,4,26,24,2,10,1
37919,3,10,14,-4,1,0
398781,3,14,17,-3,7,1
312535,3,23,0,23,3,1
94917,1,0,3,-3,9,0
311856,1,0,0,0,2,1
379071,3,7,6,1,15,0
152037,2,3,0,3,17,0
264270,3,10,17,-7,15,1
375554,4,33,14,19,14,0
106741,2,14,12,2,14,0
183998,4,22,10,12,14,1
181452,4,31,24,7,13,0
416492,3,21,17,4,15,0
387426,3,21,16,5,2,1
230726,3,9,27,-18,1,0
417491,2,17,21,-4,16,0
127445,2,3,7,-4,6,1
254023,3,7,13,-6,11,1
398747,2,14,17,-3,7,1
252499,3,10,22,-12,10,0
55288,4,13,10,3,9,1
297079,2,24,0,24,13,1
7842,1,0,7,-7,4,1
230081,1,0,0,0,17,0
28494,2,24,0,24,14,0
14716,1,7,0,7,7,1
296923,2,19,0,19,13,0
262034,4,24,24,0,14,1
364211,1,0,0,0,9,1
381102,3,24,21,3,16,1
342283,3,13,3,10,16,0
100042,2,3,3,0,12,0
105565,3,29,21,8,14,1
198486,3,17,3,14,3,1
363448,4,28,34,-6,8,0
106028,4,24,3,21,14,1
298757,1,7,0,7,14,0
337724,1,0,0,0,14,1
188788,4,0,20,-20,16,1
64984,2,0,7,-7,13,0
248057,4,34,13,21,8,0
203004,2,14,0,14,5,1
220869,4,13,35,-22,14,0
171367,4,16,17,-1,9,0
172261,4,21,13,8,9,1
70368,4,18,33,-15,15,1
57865,1,0,0,0,10,1
384028,4,13,23,-10,1,1
280507,1,7,0,7,5,0
166757,3,20,9,11,6,0
204789,4,21,21,0,6,1
265679,4,12,18,-6,16,1
397079,4,24,16,8,6,0
145251,1,7,6,1,14,0
267861,3,26,17,9,17,0
351356,2,10,7,3,3,0
70026,3,24,10,14,15,1
35654,3,23,3,20,17,0
214112,2,3,6,-3,11,0
12637,1,0,0,0,6,0
221212,1,0,3,-3,14,0
230277,2,16,10,6,17,1
343594,1,15,7,8,17,0
190879,4,27,17,10,17,0
193726,3,3,27,-24,1,0
373588,4,23,33,-10,13,1
318077,1,9,0,9,5,0
102354,3,13,13,0,13,1
290503,2,14,7,7,10,1
205573,4,17,24,-7,6,0
388887,2,10,14,-4,3,1
213721,4,24,17,7,10,1
103015,1,0,0,0,13,1
252275,2,0,10,-10,10,0
126380,3,13,14,-1,6,0
159318,4,27,24,3,3,0
216094,4,24,19,5,11,0
95361,1,7,0,7,10,1
368075,1,6,0,6,11,1
273563,1,0,0,0,2,0
67108,4,16,17,-1,14,0
64572,2,10,7,3,13,0
346537,3,24,33,-9,1,1
113847,1,0,0,0,17,1
162876,4,13,6,7,5,1
333494,2,3,0,3,12,1
119300,3,14,10,4,3,0
365767,3,17,17,0,9,1
192823,3,0,15,-15,1,1
370572,2,14,7,7,12,0
172099,3,10,9,1,9,0
150010,3,14,6,8,16,1
292815,4,29,24,5,11,1
262978,1,0,0,0,15,0
375958,3,20,12,8,14,1
178351,3,14,17,-3,12,1
43874,4,27,16,11,3,0
72218,3,17,10,7,16,0
170486,4,21,10,11,8,1
7526,1,0,0,0,4,0
321162,3,3,16,-13,6,1
171580,1,3,0,3,9,0
338597,4,39,38,1,14,1
71636,3,3,31,-28,16,1
228144,1,6,3,3,17,1
39160,4,20,10,10,1,0
116234,1,3,0,3,1,1
325410,1,6,0,6,8,1
193666,1,3,19,-16,1,0
152959,3,28,17,11,1,1
45928,3,17,3,14,4,1
199388,3,13,10,3,4,1
261105,3,7,21,-14,14,1
121054,3,11,24,-13,3,1
299092,2,3,3,0,14,1
410273,2,7,13,-6,13,1
271841,1,0,3,-3,2,0
43047,2,3,0,3,3,0
170491,4,21,10,11,8,0
210447,2,9,14,-5,9,1
194375,4,26,6,20,2,1
295108,3,7,14,-7,12,1
92361,1,7,0,7,8,1
300319,3,0,7,-7,14,1
268025,3,21,9,12,17,1
99179,2,10,3,7,11,0
44694,1,0,9,-9,3,1
284546,4,24,15,9,7,1
165440,4,12,36,-24,6,1
166932,4,13,6,7,6,1
289483,3,6,7,-1,10,1
336497,4,20,17,3,14,1
56801,4,17,19,-2,9,0
60660,2,7,3,4,11,1
298577,4,13,0,13,14,0
295818,1,0,0,0,12,0
385047,4,24,24,0,1,1
5827,3,27,7,20,3,1
236643,2,3,0,3,3,1
114144,4,31,14,17,17,1
242073,4,17,16,1,5,1
145446,2,9,14,-5,14,0
56870,2,7,0,7,9,1
165387,3,6,17,-11,6,1
318746,3,10,23,-13,5,1
231949,4,14,41,-27,1,1
36828,3,17,26,-9,17,0
326690,4,16,13,3,9,1
171810,3,23,14,9,9,0
378332,4,9,6,3,15,1
25804,1,3,0,3,12,0
284329,3,6,10,-4,7,1
342604,3,19,20,-1,16,1
111787,2,3,7,-4,17,1
56353,4,3,33,-30,9,1
97514,2,16,0,16,10,1
31107,1,0,0,0,15,0
345355,1,0,7,-7,17,1
209485,1,6,3,3,8,1
276550,4,22,7,15,4,0
85690,4,24,21,3,5,1
16171,1,0,0,0,8,0
76579,1,0,0,0,1,0
285284,3,14,6,8,7,0
292623,3,16,16,0,11,1
214033,4,43,7,36,10,0
394825,4,31,6,25,5,1
164884,2,0,3,-3,6,1
9578,1,0,0,0,5,1
230722,3,9,27,-18,1,1
352414,3,35,10,25,3,0
101373,2,6,0,6,12,0
90763,3,17,7,10,7,1
79687,1,0,0,0,2,1
288469,1,0,0,0,9,0
290971,3,20,10,10,10,0
106488,3,29,9,20,14,1
356967,2,17,3,14,5,1
182315,2,17,7,10,14,1
263864,1,0,0,0,15,0
128559,4,21,35,-14,7,1
409942,2,0,14,-14,12,1
388917,3,10,20,-10,3,0
206337,1,0,0,0,7,1
341368,3,0,10,-10,16,0
9762,2,2,7,-5,5,0
136165,3,10,10,0,10,1
283410,2,20,7,13,7,0
229799,1,0,0,0,17,1
205716,4,20,19,1,7,1
14007,2,3,7,-4,7,0
195006,1,7,0,7,2,0
357165,4,12,14,-2,5,0
1082,2,10,29,-19,1,0
359649,4,37,7,30,6,0
415896,3,10,20,-10,15,1
93754,3,3,13,-10,9,0
384307,3,8,0,8,1,1
290243,3,17,3,14,10,1
45096,1,0,0,0,4,0
220290,3,23,9,14,13,1
299269,2,20,0,20,14,1
305943,5,21,24,-3,17,1
90606,3,17,19,-2,7,0
14,1,0,0,0,1,0
351759,1,7,14,-7,3,1
421579,4,16,6,10,17,0
167659,2,10,20,-10,7,1
17967,2,13,21,-8,9,1
367579,3,14,12,2,10,1
155265,4,28,21,7,1,1
226061,1,0,7,-7,16,1
171893,2,0,7,-7,9,1
240531,4,12,13,-1,5,0
280392,2,3,7,-4,5,1
229083,2,10,7,3,17,1
397195,3,13,0,13,6,0
287537,4,14,40,-26,9,1
302372,3,16,13,3,15,1
170322,4,0,15,-15,8,1
22866,2,0,10,-10,11,1
279139,4,21,20,1,5,0
28785,1,0,0,0,14,0
399009,1,7,9,-2,7,1
373792,1,0,0,0,13,1
167098,4,16,34,-18,7,1
186782,2,23,7,16,15,1
265384,3,14,13,1,16,0
25721,3,14,10,4,12,1
411870,1,6,0,6,13,1
245937,4,13,37,-24,7,1
282485,2,7,0,7,6,0
377547,2,7,9,-2,15,1
260770,2,3,6,-3,14,0
341357,2,0,10,-10,16,1
296117,1,0,0,0,13,1
156296,1,10,0,10,2,0
320598,3,31,6,25,6,1
51617,3,14,13,1,7,1
321897,3,14,21,-7,7,1
169052,3,26,14,12,7,1
268952,4,6,36,-30,17,0
141313,1,0,7,-7,13,1
196610,4,27,20,7,2,1
225129,4,16,14,2,15,0
65125,2,0,0,0,13,0
194017,2,14,7,7,1,0
92604,4,17,3,14,8,0
239219,1,0,0,0,4,0
48806,1,0,0,0,5,0
150486,3,34,6,28,16,0
250215,4,24,16,8,9,0
327940,1,0,0,0,10,1
102193,3,17,7,10,13,1
392532,3,3,20,-17,4,1
384445,3,21,0,21,1,1
202378,1,0,0,0,5,1
263240,4,17,20,-3,15,0
145834,4,13,33,-20,15,0
380456,1,0,0,0,16,1
53499,1,7,0,7,8,0
347418,1,0,6,-6,1,1
266129,4,17,13,4,16,0
118217,1,9,0,9,2,0
53446,4,10,28,-18,8,0
293159,1,6,0,6,11,1
397700,1,6,0,6,7,0
15210,3,13,0,13,8,0
333537,3,16,3,13,12,0
136181,4,13,10,3,10,1
404523,4,31,27,4,10,0
90859,2,21,0,21,7,1
234063,3,20,0,20,2,0
131340,1,7,3,4,8,1
273953,3,7,9,-2,2,1
11169,1,0,0,0,6,0
237967,2,3,3,0,4,0
410672,1,0,3,-3,13,0
297852,3,21,16,5,13,0
405318,4,14,10,4,10,0
79802,4,28,14,14,2,0
132737,3,13,17,-4,9,1
141795,1,10,7,3,13,0
300186,3,21,3,18,14,1
271299,3,6,17,-11,1,1
349773,4,23,21,2,2,1
153847,2,0,0,0,1,0
40756,3,17,21,-4,2,0
332588,2,17,3,14,12,0
129172,1,7,0,7,7,0
114108,4,21,7,14,17,0
11158,1,0,0,0,6,1
223585,4,24,13,11,15,0
194326,3,10,6,4,2,1
50506,4,20,24,-4,6,1
227913,3,27,13,14,16,0
210112,1,0,0,0,9,1
84780,4,13,31,-18,4,0
251877,3,14,13,1,10,0
252420,1,0,0,0,10,0
310295,2,23,0,23,2,1
252478,2,7,22,-15,10,0
295862,2,7,14,-7,12,0
18080,1,0,14,-14,9,1
324678,1,0,7,-7,8,1
174352,2,17,0,17,10,1
296893,2,10,0,10,13,1
6799,2,3,7,-4,3,0
259322,3,13,20,-7,13,1
378208,4,40,16,24,15,1
387358,2,14,0,14,2,1
98709,2,21,3,18,11,1
359082,4,19,13,6,6,0
106910,2,9,3,6,14,1
66942,4,18,7,11,14,0
218922,3,41,24,17,13,0
373822,2,13,0,13,13,0
373982,2,10,0,10,13,1
106516,4,36,9,27,14,0
233350,4,19,23,-4,2,0
27307,2,14,3,11,13,0
367396,2,10,14,-4,10,1
268438,2,14,3,11,17,0
187280,4,10,6,4,16,0
357726,3,40,13,27,5,0
318266,2,3,7,-4,5,0
92694,2,3,10,-7,8,1
315016,1,14,0,14,4,1
361581,4,19,17,2,7,0
242622,3,10,0,10,6,1
112847,2,7,3,4,17,0
336970,1,0,0,0,14,1
417906,4,16,10,6,16,1
137327,1,0,0,0,11,1
351820,3,20,14,6,3,0
150505,4,40,6,34,16,1
232339,2,6,12,-6,1,1
3835,1,0,0,0,2,0
122920,4,34,6,28,4,1
170463,4,21,3,18,8,1
392369,3,20,28,-8,4,0
255003,1,0,9,-9,12,1
381329,1,6,0,6,16,1
405865,1,7,0,7,11,1
7120,3,28,21,7,4,1
2112,3,10,13,-3,1,1
9167,2,3,13,-10,5,0
310700,1,0,0,0,2,1
391431,3,10,17,-7,4,1
288166,4,19,14,5,9,1
365919,4,14,21,-7,9,0
421550,3,13,3,10,17,0
244164,1,0,7,-7,6,1
101427,3,15,7,8,12,1
269516,2,13,17,-4,1,1
297693,3,10,13,-3,13,1
356919,1,3,0,3,5,0
187506,2,3,10,-7,16,0
148087,4,14,10,4,15,1
260964,3,10,0,10,14,0
35799,3,3,10,-7,17,0
353290,3,31,26,5,4,0
416700,4,44,21,23,15,1
345221,2,7,14,-7,17,0
289073,4,41,28,13,9,0
86651,1,7,0,7,5,0
100431,1,0,0,0,12,0
381629,2,7,0,7,17,1
6857,4,10,28,-18,3,0
97659,2,3,3,0,11,0
285355,1,0,0,0,8,1
17475,1,7,0,7,9,1
362611,2,0,7,-7,8,1
179128,3,9,13,-4,12,0
293749,1,7,0,7,12,1
274454,4,10,17,-7,3,0
330344,2,7,6,1,11,0
347990,4,6,24,-18,1,0
59150,1,0,14,-14,10,0
73069,3,7,10,-3,16,1
43563,4,24,3,21,3,0
57045,3,7,20,-13,9,1
386376,3,17,6,11,2,0
245609,4,40,13,27,7,1
333871,4,28,21,7,12,0
327178,4,28,17,11,9,0
36666,3,13,3,10,17,1
132309,3,24,17,7,9,1
316927,3,17,15,2,4,1
380458,1,0,0,0,16,0
241174,4,20,10,10,5,0
41586,1,0,0,0,2,1
411540,1,0,6,-6,13,0
71465,3,30,7,23,16,1
336363,4,20,23,-3,13,0
84791,4,13,31,-18,4,0
48490,1,0,0,0,5,0
70623,3,17,17,0,15,1
128607,1,3,7,-4,7,0
243673,1,0,0,0,6,1
203115,1,0,7,-7,5,1
203381,4,27,33,-6,6,0
32003,4,19,20,-1,15,1
283847,2,7,0,7,7,0
401424,3,17,10,7,8,0
288573,3,23,31,-8,9,0
170919,3,14,20,-6,8,1
274841,2,0,7,-7,3,0
346168,1,14,0,14,1,0
275399,1,6,7,-1,3,0
334214,1,3,0,3,13,0
380964,3,9,14,-5,16,1
182307,2,14,7,7,14,0
70518,4,32,23,9,15,1
328996,4,33,7,26,10,0
311322,2,13,0,13,2,1
167949,1,0,0,0,7,0
10865,4,27,21,6,5,0
340025,3,14,12,2,15,0
267643,1,0,14,-14,17,0
29847,2,6,10,-4,14,0
227522,4,26,17,9,16,0
155682,2,10,13,-3,2,0
413945,1,3,7,-4,14,0
344910,1,3,7,-4,17,0
162826,3,3,3,0,5,1
25915,4,38,17,21,12,1
121819,2,0,7,-7,4,1
19621,4,17,28,-11,10,0
22745,2,3,21,-18,11,1
254477,3,23,10,13,11,0
164751,2,20,14,6,6,1
336118,2,10,3,7,13,0
158837,4,20,3,17,3,1
293975,4,7,21,-14,12,0
339350,4,45,7,38,15,1
199714,3,28,7,21,4,0
103536,3,20,0,20,13,1
182400,4,24,20,4,14,1
124300,3,34,20,14,5,1
24366,2,3,0,3,12,1
295247,2,14,5,9,12,0
350056,3,20,13,7,2,1
269351,2,7,7,0,1,0
405593,3,14,17,-3,10,0
337153,2,3,0,3,14,1
294342,2,10,3,7,12,0
330808,2,10,10,0,11,0
314808,3,28,7,21,4,0
383417,3,10,9,1,17,1
299285,3,23,7,16,14,1
103747,1,0,0,0,13,1
267745,4,16,34,-18,17,1
159759,3,7,13,-6,3,0
334064,1,0,0,0,13,0
363603,4,10,15,-5,8,1
48065,1,0,0,0,5,1
294686,3,6,14,-8,12,0
11911,1,0,0,0,6,1
278141,2,7,7,0,4,0
359705,1,10,3,7,6,0
50417,2,7,7,0,6,0
263762,2,0,7,-7,15,1
367841,2,10,10,0,10,1
208733,2,0,6,-6,8,1
5106,3,13,7,6,3,1
92095,2,3,10,-7,8,0
137698,2,0,13,-13,11,0
25591,3,27,10,17,12,1
1804,2,10,0,10,1,1
223851,3,9,3,6,15,0
85266,1,0,0,0,5,0
370105,1,7,0,7,12,1
131814,2,7,7,0,8,0
304380,3,28,21,7,16,1
410518,1,7,0,7,13,0
156820,3,23,20,3,2,1
16128,4,40,17,23,8,1
63856,1,3,13,-10,12,0
104332,2,45,21,24,13,0
334652,1,2,0,2,13,1
170293,3,0,12,-12,8,1
405412,2,14,10,4,10,0
329883,1,0,7,-7,11,1
294253,4,20,21,-1,12,1
381449,4,26,14,12,16,0
294251,4,20,21,-1,12,1
227510,4,19,17,2,16,1
232835,4,16,17,-1,2,1
342559,2,9,13,-4,16,1
159935,4,38,16,22,3,0
119870,5,24,24,0,3,1
340550,4,7,42,-35,15,0
1239,3,10,6,4,1,1
24844,3,13,3,10,12,1
103681,3,0,10,-10,13,0
94848,4,6,13,-7,9,0
90319,3,14,17,-3,7,0
59510,3,6,20,-14,11,0
296297,2,3,10,-7,13,0
381146,4,31,28,3,16,0
11119,4,17,13,4,5,0
51817,4,10,28,-18,7,1
51272,1,6,0,6,7,0
84631,3,23,13,10,4,0
76711,4,16,14,2,1,1
279469,1,7,0,7,5,0
354905,1,0,0,0,4,0
58539,2,10,3,7,10,0
64813,1,0,0,0,13,1
165378,2,3,17,-14,6,1
78502,1,0,0,0,2,0
274210,2,16,0,16,3,1
361719,4,10,39,-29,7,0
420737,1,0,0,0,17,0
183558,3,7,10,-3,14,0
221467,4,3,41,-38,14,1
325287,2,6,3,3,8,1
209420,3,14,17,-3,8,0
89989,3,5,14,-9,7,1
278005,2,3,10,-7,4,0
397335,4,0,24,-24,6,1
400477,1,0,0,0,8,0
15453,1,6,0,6,8,0
15821,4,8,12,-4,8,0
171913,2,7,7,0,9,1
235490,1,0,0,0,3,0
111758,1,3,0,3,17,1
278817,3,7,21,-14,5,1
217260,1,0,0,0,12,1
136854,1,0,0,0,11,0
13574,2,3,0,3,7,0
232606,1,0,0,0,1,0
397959,4,10,24,-14,7,1
15152,1,0,0,0,8,1
268522,4,23,16,7,17,0
390685,2,3,3,0,3,0
56563,2,16,14,2,9,0
305106,2,21,10,11,16,0
81257,3,10,7,3,3,1
272650,1,2,0,2,2,1
229595,3,30,13,17,17,1
16414,4,21,16,5,8,1
17635,1,7,3,4,9,0
70413,1,13,14,-1,15,1
140658,4,38,10,28,12,1
421881,4,14,26,-12,17,1
376192,2,7,7,0,14,1
158775,2,7,3,4,3,0
256594,3,14,0,14,12,0
179784,4,6,24,-18,12,0
417080,3,27,0,27,15,0
399496,3,0,24,-24,7,1
272231,2,6,0,6,2,0
281859,4,13,7,6,6,1
320926,4,13,21,-8,6,0
257803,2,7,0,7,13,0
90598,2,17,10,7,7,0
262054,4,24,31,-7,14,1
390489,1,7,0,7,3,0
313096,1,0,0,0,3,1
61088,2,0,0,0,11,0
283052,1,0,0,0,7,0
193712,3,3,27,-24,1,1
383950,2,0,10,-10,1,1
417278,4,20,23,-3,16,0
128718,4,13,30,-17,7,1
190728,4,42,17,25,17,0
372977,4,28,13,15,13,1
169748,1,0,7,-7,8,1
222005,2,7,0,7,14,0
63815,4,14,34,-20,12,1
223583,4,23,13,10,15,1
309164,3,35,3,32,1,1
80020,2,7,3,4,2,1
175956,1,0,0,0,11,1
42326,2,0,9,-9,2,1
24608,4,10,26,-16,12,0
248279,2,14,0,14,8,1
35444,1,7,7,0,17,0
154487,4,14,10,4,1,0
2101,2,7,13,-6,1,1
383092,2,20,7,13,17,1
270686,2,3,3,0,1,0
389680,4,24,16,8,3,1
245935,4,13,37,-24,7,1
341825,2,13,9,4,16,0
285202,1,0,0,0,7,0
286575,3,10,31,-21,8,1
288874,3,10,24,-14,9,1
9409,1,0,0,0,5,0
414323,4,21,42,-21,14,0
256438,3,12,21,-9,12,1
196511,2,10,3,7,2,0
395050,2,0,17,-17,5,1
227656,4,42,0,42,16,0
413547,2,3,10,-7,14,1
420543,4,10,42,-32,17,0
142648,3,20,13,7,13,0
51079,4,3,23,-20,6,1
177444,3,17,10,7,11,1
173876,1,6,10,-4,10,1
41267,1,0,0,0,2,0
213563,4,10,14,-4,10,1
25088,1,3,0,3,12,1
152899,2,7,7,0,1,0
343435,1,7,0,7,16,0
25629,1,0,0,0,12,0
117524,3,17,17,0,2,0
187205,2,0,0,0,16,0
256946,4,26,27,-1,12,0
259612,3,3,3,0,13,1
149051,1,0,7,-7,16,0
127046,4,24,23,1,6,1
336177,4,17,3,14,13,0
390879,4,9,28,-19,3,1
101556,2,13,24,-11,12,1
55818,2,0,7,-7,9,1
371309,2,21,10,11,12,0
9229,4,3,23,-20,5,0
131097,2,20,6,14,8,1
39446,3,13,10,3,1,0
228194,2,10,27,-17,17,0
231764,2,10,20,-10,1,1
13179,3,22,16,6,6,0
130859,4,20,12,8,8,0
136653,4,22,19,3,11,0
108088,3,13,21,-8,15,0
282234,2,10,7,3,6,0
326676,3,16,6,10,9,0
204656,4,17,48,-31,6,1
390989,2,20,21,-1,4,0
167497,2,0,3,-3,7,0
12823,2,12,3,9,6,1
81018,4,20,23,-3,3,1
311708,4,12,9,3,2,1
190720,4,42,17,25,17,1
229074,2,3,0,3,17,1
195798,2,19,7,12,2,1
354832,4,23,28,-5,4,0
310247,1,3,0,3,2,0
207506,4,28,21,7,7,1
85018,2,25,13,12,4,0
124750,3,3,6,-3,5,0
379257,1,0,3,-3,16,0
7343,5,20,19,1,4,1
135225,2,13,3,10,10,0
74850,3,20,20,0,17,1
241613,4,6,27,-21,5,0
141724,4,30,21,9,13,0
337096,4,26,7,19,14,0
10919,2,6,7,-1,5,0
404660,4,20,22,-2,10,1
184155,4,16,17,-1,14,0
138776,2,0,6,-6,12,0
401587,3,17,14,3,8,0
344692,3,6,20,-14,17,0
168380,1,0,0,0,7,0
116805,4,34,33,1,2,1
33735,1,0,0,0,16,1
298445,4,13,24,-11,14,0
332816,4,35,16,19,12,0
11115,3,10,13,-3,5,1
284032,3,3,3,0,7,1
293686,3,10,10,0,12,0
290993,3,20,13,7,10,0
268926,3,6,33,-27,17,1
46095,4,21,21,0,4,1
148345,3,14,3,11,16,0
153454,4,20,17,3,1,0
355272,3,14,14,0,4,0
225712,1,0,0,0,16,0
143346,2,7,13,-6,14,0
323194,2,7,0,7,7,1
140864,2,17,0,17,13,0
196519,2,10,3,7,2,1
414271,3,21,21,0,14,1
415784,4,21,24,-3,15,1
61554,3,21,7,14,11,1
237332,2,0,0,0,3,0
17317,1,7,0,7,9,1
4639,2,13,10,3,2,0
2634,1,0,0,0,2,1
278218,4,24,21,3,4,1
66806,4,10,6,4,14,0
131823,2,7,7,0,8,1
36782,2,7,7,0,17,0
314311,2,7,14,-7,3,0
378910,3,13,29,-16,15,0
265389,4,14,20,-6,16,1
145146,2,29,0,29,14,0
145494,4,16,17,-1,14,1
357415,3,23,17,6,5,1
181427,3,23,24,-1,13,1
288506,1,3,14,-11,9,1
257655,2,0,7,-7,13,0
66994,1,0,0,0,14,1
102765,2,10,3,7,13,1
211774,1,0,7,-7,9,1
390996,3,20,21,-1,4,0
190753,1,3,0,3,17,0
133728,1,0,0,0,9,1
14996,1,0,7,-7,7,0
234470,2,17,13,4,2,0
232403,4,20,22,-2,1,0
337951,3,20,0,20,14,1
213450,4,10,41,-31,10,1
112101,2,7,17,-10,17,0
26835,1,7,0,7,13,1
26611,3,10,6,4,13,1
156089,1,0,0,0,2,1
213899,1,0,0,0,10,1
70528,4,39,23,16,15,1
51947,4,13,16,-3,7,0
364372,1,14,0,14,9,0
104071,2,10,13,-3,13,1
119787,3,17,6,11,3,0
153668,1,2,7,-5,1,0
234283,1,7,0,7,2,0
339840,1,13,0,13,15,1
386490,2,7,0,7,2,0
218162,2,13,3,10,12,1
314954,4,0,13,-13,4,1
79336,3,22,3,19,2,0
166460,3,17,16,1,6,0
264748,2,10,16,-6,16,1
175670,2,16,3,13,11,0
84431,2,6,7,-1,4,1
316143,3,24,26,-2,4,1
41005,2,3,7,-4,2,0
259440,2,6,10,-4,13,1
97218,3,9,6,3,10,1
358203,4,23,17,6,6,0
109891,3,23,0,23,16,0
67467,2,27,7,20,14,0
105293,4,10,26,-16,14,1
93676,1,0,0,0,9,1
311566,1,0,0,0,2,1
347193,4,23,24,-1,1,0
152010,1,0,0,0,17,1
286509,1,3,7,-4,8,1
351131,5,37,37,0,3,0
363984,3,3,9,-6,8,0
52648,2,3,7,-4,7,1
110539,1,0,0,0,16,1
395259,4,10,13,-3,5,0
116321,3,24,13,11,1,1
265777,3,17,3,14,16,0
103299,1,0,0,0,13,1
321960,4,28,28,0,7,1
26616,3,10,6,4,13,1
181417,3,17,17,0,13,0
331280,2,0,7,-7,11,0
70353,4,10,33,-23,15,1
354543,4,33,31,2,4,1
186517,4,17,20,-3,15,0
355042,4,18,33,-15,4,1
69156,3,14,17,-3,15,0
352198,1,0,0,0,3,0
267981,2,7,6,1,17,0
411496,3,13,17,-4,13,0
95500,1,3,0,3,10,0
43460,1,0,0,0,3,0
101726,3,13,7,6,12,1
414822,1,13,0,13,15,0
390946,2,7,0,7,4,1
302728,1,0,0,0,15,0
364792,1,0,0,0,9,0
271103,1,0,7,-7,1,0
74885,4,20,20,0,17,1
71188,3,19,10,9,16,0
164637,3,14,17,-3,5,0
56267,2,3,14,-11,9,0
78730,2,13,7,6,2,1
301494,3,20,12,8,15,1
399862,1,0,0,0,8,1
288667,2,0,7,-7,9,0
391359,1,0,0,0,4,0
381748,1,0,0,0,17,1
236990,4,45,7,38,3,0
358127,2,17,6,11,6,1
386382,3,17,9,8,2,1
2138,4,10,16,-6,1,1
373057,2,0,7,-7,13,1
7987,1,0,0,0,4,1
10458,1,3,0,3,5,1
24995,3,16,14,2,12,0
38839,3,3,10,-7,1,0
151134,1,3,0,3,17,0
366385,2,19,0,19,10,1
193449,4,23,20,3,1,1
378939,4,16,30,-14,15,1
398635,3,0,0,0,7,0
97946,2,0,7,-7,11,0
252958,3,9,7,2,11,0
295261,3,14,5,9,12,1
389101,3,29,0,29,3,1
346589,4,40,47,-7,1,0
347635,3,17,10,7,1,0
233339,4,19,23,-4,2,0
112535,2,10,9,1,17,0
15170,2,3,0,3,8,0
409108,3,3,10,-7,12,1
267216,1,3,7,-4,17,1
30589,2,16,0,16,14,1
230409,2,13,0,13,1,1
118220,1,9,0,9,2,1
321851,1,7,7,0,7,0
188638,5,20,19,1,16,1
213703,3,17,17,0,10,0
288576,3,23,31,-8,9,0
175274,3,15,7,8,10,0
29846,2,6,10,-4,14,0
141980,2,10,14,-4,13,1
176026,3,17,0,17,11,1
108819,2,0,10,-10,15,1
243414,2,3,16,-13,6,0
350327,3,21,3,18,2,1
347012,3,10,3,7,1,0
31871,1,3,0,3,15,1
397228,4,16,0,16,6,0
110461,3,17,0,17,16,1
96136,2,0,16,-16,10,1
310225,4,24,10,14,2,0
382651,2,0,0,0,17,0
294716,4,6,14,-8,12,1
172729,3,14,10,4,9,1
193431,3,20,20,0,1,1
185926,4,22,23,-1,15,1
394411,1,0,3,-3,5,1
360011,2,3,26,-23,7,1
312949,1,0,0,0,3,1
61566,3,28,7,21,11,1
256564,2,7,0,7,12,1
226783,4,7,20,-13,16,1
107232,4,14,31,-17,15,1
13021,3,14,7,7,6,0
28059,2,14,7,7,13,0
268960,4,6,36,-30,17,1
305927,5,21,21,0,17,0
185386,2,0,3,-3,15,0
403714,2,3,3,0,9,1
91277,1,7,0,7,8,1
319731,1,0,0,0,6,1
229390,2,3,0,3,17,0
354977,3,7,12,-5,4,1
115417,2,26,7,19,1,0
364554,2,9,21,-12,9,1
367742,4,13,19,-6,10,0
410210,1,7,0,7,13,0
263334,3,24,7,17,15,0
271300,3,6,17,-11,1,1
387817,2,10,6,4,2,0
280634,4,23,16,7,5,1
142115,2,0,7,-7,13,0
16316,1,7,0,7,8,0
136097,1,0,7,-7,10,0
249020,1,7,3,4,9,1
404211,4,12,9,3,10,1
383366,2,0,6,-6,17,0
120595,3,0,20,-20,3,1
305779,4,16,10,6,17,0
376350,2,3,0,3,14,1
75442,3,17,7,10,17,1
112334,1,0,0,0,17,1
15146,1,0,0,0,8,0
158113,4,25,9,16,3,0
200999,2,14,0,14,5,0
140295,2,14,6,8,12,1
188339,1,0,0,0,16,0
31991,4,19,13,6,15,0
384265,2,6,0,6,1,1
351276,4,28,17,11,3,1
217580,2,3,9,-6,12,1
170673,1,0,3,-3,8,1
246035,2,7,13,-6,7,1
274448,4,10,17,-7,3,1
149274,3,13,20,-7,16,0
370092,1,0,0,0,12,1
353269,3,28,20,8,4,1
121450,1,0,0,0,4,0
348425,4,13,23,-10,1,1
116324,3,24,13,11,1,1
105995,3,17,3,14,14,0
400391,3,24,10,14,8,0
337862,1,0,0,0,14,1
87720,3,6,20,-14,6,0
25035,4,16,24,-8,12,1
114236,3,10,14,-4,1,0
98201,4,35,26,9,11,0
327138,3,14,16,-2,9,0
336754,3,10,10,0,14,0
330657,2,6,0,6,11,0
209829,2,10,10,0,8,0
204029,4,16,7,9,6,0
141429,4,13,20,-7,13,0
348994,2,14,7,7,2,1
65192,3,3,3,0,13,0
401134,3,34,13,21,8,0
17041,1,7,0,7,9,0
177309,4,20,20,0,11,0
347893,2,0,7,-7,1,1
353089,2,7,16,-9,3,0
224049,3,14,6,8,15,0
345329,4,22,24,-2,17,1
274259,3,23,7,16,3,0
148601,2,0,9,-9,16,0
417809,2,10,0,10,16,1
49199,2,17,0,17,6,0
120516,1,0,0,0,3,0
284882,1,0,0,0,7,0
255993,3,16,12,4,12,1
421018,4,14,35,-21,17,1
254274,2,6,9,-3,11,0
89897,4,30,20,10,7,0
278174,3,24,14,10,4,1
202988,1,14,0,14,5,1
22203,4,10,15,-5,11,1
141987,3,10,14,-4,13,1
89402,3,10,20,-10,7,1
114057,2,14,0,14,17,0
285155,4,3,3,0,7,1
401003,4,22,15,7,8,1
194836,1,0,0,0,2,0
91857,4,24,13,11,8,1
148393,1,0,0,0,16,1
202937,4,31,0,31,5,0
232214,3,9,12,-3,1,0
311403,4,42,20,22,2,1
351378,3,10,10,0,3,0
102096,4,42,17,25,12,0
56723,2,0,10,-10,9,0
176204,3,14,24,-10,11,0
117181,2,13,10,3,2,1
101618,4,13,38,-25,12,0
57012,2,7,10,-3,9,0
195572,4,13,7,6,2,1
120249,2,14,3,11,3,0
307467,2,28,13,15,17,1
89615,1,0,0,0,7,1
411698,1,0,0,0,13,0
306675,4,14,35,-21,17,1
48241,2,3,10,-7,5,0
261042,1,0,7,-7,14,0
410280,3,7,13,-6,13,0
160767,1,10,0,10,4,0
219016,2,14,0,14,13,1
18745,3,12,10,2,9,1
259602,2,0,3,-3,13,1
304612,1,14,7,7,16,0
55182,1,6,0,6,9,1
47621,1,3,14,-11,5,0
394113,1,0,7,-7,5,1
50966,1,0,7,-7,6,0
312173,1,0,0,0,2,0
231549,1,0,0,0,1,1
74912,1,7,0,7,17,0
225954,3,27,7,20,16,0
114328,2,13,6,7,1,1
61011,3,34,16,18,11,0
172688,2,14,3,11,9,0
95767,1,0,0,0,10,1
69510,1,0,0,0,15,1
352162,4,15,20,-5,3,0
130563,4,13,13,0,8,1
227446,2,10,7,3,16,1
296649,3,3,16,-13,13,0
71333,3,10,20,-10,16,0
139034,4,21,19,2,12,1
8318,2,9,0,9,4,0
162839,3,3,3,0,5,1
91630,2,14,7,7,8,1
187678,2,7,3,4,16,0
50353,1,0,0,0,6,0
390492,1,7,0,7,3,1
215810,3,38,13,25,11,1
26890,2,10,6,4,13,0
218624,3,10,30,-20,13,1
225852,4,24,24,0,16,0
78207,4,48,3,45,2,0
48130,3,7,6,1,5,0
36491,2,10,6,4,17,0
140986,1,7,0,7,13,1
359594,2,17,0,17,6,1
361829,3,37,10,27,7,1
370568,2,14,7,7,12,1
345695,2,7,0,7,17,0
38555,3,24,6,18,1,1
172689,2,14,3,11,9,0
249126,4,28,28,0,9,1
151843,1,0,0,0,17,1
316795,3,16,7,9,4,0
114485,2,10,17,-7,1,1
127832,4,17,42,-25,6,1
290424,4,28,10,18,10,1
306935,4,6,30,-24,17,0
50539,2,0,3,-3,6,0
293161,1,6,0,6,11,1
161943,4,13,16,-3,4,0
338158,1,7,7,0,14,1
211380,4,10,10,0,9,1
12262,3,3,3,0,6,0
376762,1,0,0,0,15,1
36788,2,7,10,-3,17,1
61340,1,0,0,0,11,1
71306,2,7,13,-6,16,1
302,1,0,0,0,1,1
222851,4,24,13,11,14,1
212274,1,7,3,4,10,0
198085,4,10,43,-33,3,1
208028,3,21,0,21,8,0
303287,2,19,0,19,16,1
14405,1,6,0,6,7,1
105399,3,23,17,6,14,1
89264,4,12,0,12,7,0
172192,2,0,0,0,9,1
222310,2,7,3,4,14,0
104654,3,7,3,4,14,1
316567,2,3,6,-3,4,1
183887,4,51,28,23,14,0
352650,2,0,0,0,3,0
90549,1,7,7,0,7,1
130240,4,3,26,-23,8,1
130558,4,13,13,0,8,1
216622,1,0,3,-3,12,1
354611,2,3,7,-4,4,1
223971,1,0,6,-6,15,1
113215,4,44,22,22,17,0
290332,2,6,3,3,10,0
85974,3,14,14,0,5,0
107267,1,0,0,0,15,1
393087,2,7,3,4,4,1
191393,3,0,31,-31,17,0
13664,4,19,17,2,7,0
25228,1,6,0,6,12,1
327317,4,16,20,-4,9,0
193177,1,0,0,0,1,0
28920,1,0,0,0,14,1
405890,2,7,0,7,11,1
9792,3,9,17,-8,5,0
197180,4,27,27,0,3,1
50180,4,6,24,-18,6,0
404543,4,34,27,7,10,1
196201,1,7,0,7,2,0
322443,1,6,0,6,7,1
246617,2,14,3,11,8,1
343687,3,15,10,5,17,1
238379,3,10,23,-13,4,0
316114,3,24,16,8,4,0
171753,2,3,7,-4,9,1
231859,1,0,20,-20,1,1
127850,4,23,42,-19,6,1
285079,2,3,0,3,7,0
222188,2,10,10,0,14,1
319830,3,17,10,7,6,1
96067,4,13,14,-1,10,1
50206,1,7,7,0,6,1
38053,2,3,0,3,1,0
371261,1,0,7,-7,12,1
169800,2,3,17,-14,8,0
5881,1,0,0,0,3,0
115807,1,0,0,0,1,0
88104,4,24,3,21,6,1
407339,4,29,26,3,11,1
355260,2,14,14,0,4,0
292446,2,3,3,0,11,0
180298,2,9,7,2,13,1
156006,2,10,14,-4,2,1
249103,3,21,20,1,9,1
170638,4,47,9,38,8,1
205492,3,14,10,4,6,0
370413,2,7,0,7,12,1
267617,1,0,0,0,17,1
370994,2,7,7,0,12,0
125544,1,0,0,0,5,1
179375,2,3,6,-3,12,0
411370,4,20,10,10,13,0
390440,4,14,27,-13,3,0
2861,3,31,24,7,2,0
238549,4,16,20,-4,4,1
3338,4,3,6,-3,2,1
299048,4,16,25,-9,14,1
153228,1,2,0,2,1,0
265008,1,0,0,0,16,1
10240,4,6,10,-4,5,1
230831,1,0,0,0,1,0
265697,4,12,18,-6,16,1
403889,2,10,14,-4,10,1
378846,2,7,6,1,15,1
271976,4,23,27,-4,2,1
100026,1,3,3,0,12,1
79124,1,0,0,0,2,0
170203,1,0,0,0,8,0
335017,3,16,10,6,13,1
22235,1,0,0,0,11,0
143689,4,19,10,9,14,0
219938,2,6,6,0,13,0
294572,4,31,13,18,12,0
72012,2,0,10,-10,16,1
196264,3,21,10,11,2,0
9105,4,30,19,11,4,1
292048,3,15,12,3,11,0
204473,3,7,24,-17,6,1
289118,1,6,0,6,9,1
339784,4,24,13,11,15,1
239413,2,6,10,-4,4,1
40894,2,13,17,-4,2,0
104168,4,27,27,0,13,0
363809,2,13,10,3,8,1
262103,2,14,3,11,15,0
244538,3,25,13,12,7,0
334657,2,2,0,2,13,0
141371,3,10,17,-7,13,0
61161,4,0,14,-14,11,1
4388,3,7,14,-7,2,1
295951,4,13,24,-11,12,0
245331,4,23,13,10,7,0
237012,1,0,7,-7,3,1
10329,2,10,14,-4,5,0
240819,4,26,10,16,5,0
216729,3,27,6,21,12,0
114246,4,10,17,-7,1,0
147533,2,6,0,6,15,1
86872,3,9,23,-14,5,1
289893,2,6,3,3,10,0
326900,1,0,0,0,9,0
239824,2,0,0,0,4,0
324993,2,13,21,-8,8,1
62309,3,21,19,2,12,1
73249,4,7,16,-9,16,1
72971,4,38,15,23,16,0
274559,3,21,16,5,3,0
258545,2,0,0,0,13,0
56867,2,7,0,7,9,0
389065,2,20,0,20,3,1
63831,1,0,0,0,12,0
388335,3,17,6,11,2,1
253203,2,0,7,-7,11,0
243662,4,23,27,-4,6,1
53635,1,0,0,0,8,1
262053,4,24,31,-7,14,1
143696,4,19,10,9,14,1
300233,4,38,10,28,14,0
190675,3,28,14,14,17,0
53713,3,7,0,7,8,0
287544,4,14,40,-26,9,1
278547,4,43,7,36,4,0
356541,4,9,6,3,5,0
111431,4,0,20,-20,16,1
289150,2,13,7,6,9,1
285698,5,27,27,0,8,0
320368,1,7,0,7,6,0
58196,1,0,0,0,10,0
170222,1,0,3,-3,8,0
233900,3,14,13,1,2,1
95246,2,3,10,-7,10,0
324099,2,0,7,-7,8,1
24302,4,13,17,-4,12,1
207499,4,28,14,14,7,0
368329,4,12,19,-7,11,1
5112,4,13,7,6,3,0
280331,4,19,22,-3,5,0
202460,3,6,10,-4,5,0
21047,4,21,34,-13,10,1
267592,4,27,34,-7,17,1
13509,4,6,33,-27,7,0
352312,4,6,9,-3,3,0
140640,3,38,10,28,12,0
144467,4,10,33,-23,14,1
389863,4,31,6,25,3,0
257922,1,0,0,0,13,1
212364,4,13,10,3,10,1
389353,3,23,6,17,3,0
221012,4,21,17,4,14,0
340885,1,0,3,-3,15,0
16139,4,40,17,23,8,0
139925,1,7,3,4,12,1
343122,4,12,20,-8,16,1
212246,1,0,0,0,10,0
389483,2,13,0,13,3,0
142404,1,7,0,7,13,0
33019,4,12,44,-32,15,0
299392,2,0,13,-13,14,1
268524,4,23,16,7,17,0
306587,2,0,17,-17,17,0
220497,1,0,7,-7,13,0
289903,2,6,3,3,10,0
228249,4,10,27,-17,17,0
32735,4,7,24,-17,15,1
287789,2,21,10,11,9,1
317328,2,0,0,0,5,1
337969,4,23,0,23,14,0
73709,4,20,9,11,17,0
6422,3,9,20,-11,3,1
45975,4,20,3,17,4,1
195285,4,23,24,-1,2,1
93267,1,14,0,14,9,0
381698,3,20,14,6,17,0
392079,4,18,33,-15,4,0
190787,2,13,3,10,17,0
214592,2,3,6,-3,11,0
141821,2,10,14,-4,13,1
172012,1,0,0,0,9,1
137760,4,10,37,-27,11,1
377163,4,13,17,-4,15,1
321109,2,0,3,-3,6,0
330384,3,7,20,-13,11,1
103684,3,0,10,-10,13,0
54061,3,10,3,7,8,1
334759,4,32,11,21,13,1
276283,1,0,0,0,3,1
269399,3,7,17,-10,1,1
36872,4,24,42,-18,17,0
182037,3,14,14,0,13,1
203575,1,0,0,0,6,1
378698,1,7,7,0,15,1
219795,2,38,0,38,13,0
301442,2,10,3,7,15,1
325022,3,20,21,-1,8,0
271091,1,0,0,0,1,0
325166,3,13,14,-1,8,1
386332,2,10,3,7,2,0
193832,2,10,0,10,1,1
201190,3,20,21,-1,5,0
276625,2,14,6,8,4,0
405026,4,9,26,-17,10,1
231683,4,24,19,5,1,1
318678,1,0,13,-13,5,1
110832,4,13,13,0,16,0
223835,2,9,0,9,15,1
108213,2,6,0,6,15,1
143249,4,10,16,-6,13,1
120494,5,39,41,-2,3,1
169815,3,3,17,-14,8,1
4556,4,24,29,-5,2,1
94556,4,10,10,0,9,1
163126,2,16,19,-3,5,0
67633,3,7,35,-28,14,0
382051,1,0,0,0,17,0
325965,4,22,7,15,9,0
124350,1,0,0,0,5,0
85057,3,31,16,15,4,1
378194,4,27,16,11,15,1
228267,4,17,27,-10,17,0
8450,2,9,0,9,4,1
187512,2,3,10,-7,16,1
158966,3,14,22,-8,3,0
137534,2,17,17,0,11,1
169029,2,19,14,5,7,1
59525,4,13,20,-7,11,1
196338,1,7,0,7,2,1
400682,3,9,7,2,8,1
83122,4,6,30,-24,4,1
351279,4,28,17,11,3,1
146536,3,14,10,4,15,1
287725,1,0,0,0,9,1
318069,1,2,0,2,5,1
418258,2,6,0,6,16,1
96768,3,7,10,-3,10,0
62670,4,24,20,4,12,0
353516,2,3,0,3,4,0
394816,4,31,6,25,5,1
405111,3,0,10,-10,10,1
268099,1,0,7,-7,17,1
298865,4,21,9,12,14,0
318788,4,17,26,-9,5,0
18623,4,17,17,0,9,1
318640,4,10,13,-3,5,1
319897,1,6,0,6,6,0
100401,4,9,20,-11,12,0
59963,3,3,24,-21,11,0
179729,2,3,10,-7,12,1
360453,3,10,0,10,7,0
33767,2,0,3,-3,16,1
131201,2,7,9,-2,8,0
78572,2,16,7,9,2,0
252959,3,9,7,2,11,0
160806,2,17,10,7,4,1
144575,3,7,19,-12,14,1
156346,3,24,0,24,2,1
290107,4,13,15,-2,10,1
164914,2,0,3,-3,6,0
231783,3,13,20,-7,1,1
275507,4,20,30,-10,3,1
344528,2,0,0,0,17,0
6207,2,10,0,10,3,0
128994,4,35,10,25,7,0
71095,4,27,3,24,16,1
333283,4,6,24,-18,12,1
363919,1,0,0,0,8,0
20991,3,14,24,-10,10,0
265321,2,7,0,7,16,1
107747,2,7,10,-3,15,1
243237,2,0,7,-7,6,1
82233,4,16,10,6,3,0
85367,4,28,10,18,5,1
16915,2,14,13,1,8,0
10333,2,10,21,-11,5,0
405808,4,21,24,-3,10,1
314676,4,14,21,-7,3,1
6288,4,16,17,-1,3,1
217650,4,26,16,10,12,0
148211,4,16,21,-5,16,0
188966,1,0,0,0,16,1
287651,3,3,10,-7,9,1
14995,1,0,7,-7,7,0
101116,3,10,17,-7,12,0
421026,4,14,35,-21,17,0
36410,4,27,26,1,17,0
29160,3,3,19,-16,14,1
359957,4,30,30,0,6,1
275482,3,20,17,3,3,1
301147,2,10,3,7,15,1
203403,4,27,33,-6,6,0
272393,2,24,0,24,2,0
188916,3,17,10,7,16,1
420927,2,7,14,-7,17,1
370854,2,3,0,3,12,0
280466,4,34,24,10,5,0
284476,3,14,15,-1,7,1
33568,4,17,10,7,16,1
4206,2,10,6,4,2,0
102144,1,7,0,7,13,1
185532,2,10,3,7,15,0
221927,4,19,16,3,14,0
81335,1,0,0,0,3,0
392492,2,3,17,-14,4,1
59754,2,6,10,-4,11,1
216444,1,14,0,14,12,0
137254,3,7,13,-6,11,1
208078,4,21,19,2,8,1
94262,1,0,0,0,9,1
29386,1,0,0,0,14,0
71671,4,3,34,-31,16,1
267085,2,3,3,0,17,0
407052,1,0,0,0,11,0
160419,1,0,0,0,4,1
327013,4,2,10,-8,9,1
227230,1,0,0,0,16,0
372564,1,7,0,7,13,0
31605,2,16,6,10,15,1
141816,2,10,14,-4,13,0
378279,2,0,3,-3,15,1
302108,4,27,27,0,15,0
101651,1,3,0,3,12,0
357214,1,0,3,-3,5,0
161757,3,24,6,18,4,0
345453,4,3,22,-19,17,1
364625,4,21,37,-16,9,0
394398,1,0,0,0,5,0
373835,2,13,0,13,13,1
199876,4,10,24,-14,4,0
189770,2,10,6,4,17,1
353239,2,14,17,-3,4,0
97209,2,9,6,3,10,1
335874,3,21,14,7,13,1
326856,4,10,17,-7,9,0
143440,1,7,6,1,14,0
368572,3,9,0,9,11,0
46247,4,21,31,-10,4,1
85395,4,31,10,21,5,0
163323,4,13,23,-10,5,1
246890,1,0,7,-7,8,0
261392,3,10,17,-7,14,1
124853,2,0,6,-6,5,1
127912,2,10,0,10,6,0
150339,3,24,7,17,16,1
312860,3,14,0,14,3,0
75618,3,7,6,1,17,1
202095,2,13,0,13,5,0
99517,4,3,10,-7,11,1
5900,2,0,9,-9,3,1
19512,4,39,17,22,10,0
313792,4,34,17,17,3,0
244426,4,3,20,-17,7,0
156660,3,6,7,-1,2,1
358652,1,0,0,0,6,0
235007,3,16,17,-1,2,1
219733,1,0,0,0,13,1
398919,3,10,10,0,7,0
303188,4,31,28,3,16,0
273797,3,10,7,3,2,1
361202,2,0,10,-10,7,1
181478,4,31,24,7,13,0
144760,4,3,10,-7,14,0
76158,2,9,6,3,1,0
349392,1,0,0,0,2,1
299251,2,16,0,16,14,1
90098,1,0,0,0,7,0
102293,2,10,7,3,13,0
239146,3,13,13,0,4,1
416930,3,10,7,3,15,1
343968,3,16,6,10,17,1
150497,4,34,6,28,16,1
36819,3,17,26,-9,17,1
333058,3,10,12,-2,12,0
181166,4,24,21,3,13,0
241402,2,7,28,-21,5,0
282788,2,0,10,-10,6,0
111994,3,20,21,-1,17,1
162690,3,23,24,-1,5,1
109784,4,27,0,27,16,0
74692,3,7,17,-10,17,0
210186,3,7,14,-7,9,0
159842,2,14,0,14,3,0
331920,4,6,22,-16,12,0
131278,4,14,17,-3,8,1
12171,4,20,28,-8,6,1
308037,1,0,0,0,1,1
313588,3,12,20,-8,3,0
144039,1,0,0,0,14,1
5655,2,0,14,-14,3,0
164107,4,12,6,6,5,1
413347,1,0,0,0,14,1
384253,2,6,0,6,1,0
227933,3,27,20,7,16,0
118820,2,20,0,20,2,0
42672,3,6,10,-4,3,1
308733,3,10,19,-9,1,0
84059,4,30,22,8,4,1
257689,3,0,10,-10,13,1
230305,3,19,10,9,17,0
68843,3,6,17,-11,15,1
227553,1,7,0,7,16,0
394719,1,14,0,14,5,0
369414,2,17,7,10,11,0
244109,4,20,34,-14,6,0
261569,3,12,9,3,14,0
106999,1,0,0,0,15,1
81189,1,0,0,0,3,1
338558,4,23,31,-8,14,1
409630,1,0,0,0,12,0
226716,2,7,6,1,16,1
284571,1,7,0,7,7,0
4694,4,23,26,-3,2,0
283181,4,20,9,11,7,1
194684,4,41,10,31,2,0
316461,3,16,17,-1,4,0
317822,3,9,3,6,5,1
115101,2,3,13,-10,1,0
183882,4,51,28,23,14,0
365189,4,14,28,-14,9,0
36794,2,7,10,-3,17,1
358451,3,32,20,12,6,0
146270,3,3,30,-27,15,0
330329,1,6,3,3,11,1
310126,2,14,0,14,2,0
369610,4,20,6,14,11,0
355314,4,14,20,-6,4,0
132830,2,3,7,-4,9,1
334273,3,9,7,2,13,1
73269,4,14,23,-9,16,1
119996,4,23,24,-1,3,0
174533,3,7,14,-7,10,1
245086,1,7,3,4,7,1
416698,4,44,15,29,15,0
63817,4,14,34,-20,12,1
193874,3,24,7,17,1,1
143882,1,0,0,0,14,1
38496,2,10,3,7,1,1
29154,3,0,19,-19,14,1
400194,2,3,3,0,8,0
261891,4,6,27,-21,14,1
184834,3,24,20,4,15,0
370751,2,12,10,2,12,1
237739,4,20,17,3,4,0
282708,4,9,20,-11,6,0
238170,2,3,9,-6,4,0
195304,1,0,0,0,2,0
92279,3,13,0,13,8,1
382009,4,0,30,-30,17,1
331008,3,36,7,29,11,1
96973,4,22,17,5,10,1
400516,2,7,3,4,8,0
186641,3,24,3,21,15,0
137162,4,31,6,25,11,0
353804,1,7,0,7,4,0
250477,2,13,7,6,9,1
268669,4,27,20,7,17,0
297702,3,10,13,-3,13,0
154567,2,14,7,7,1,0
287959,3,14,13,1,9,1
252540,4,29,32,-3,10,1
221169,4,0,23,-23,14,1
140386,4,17,29,-12,12,1
216452,1,14,0,14,12,0
45389,4,20,26,-6,4,1
221330,4,6,35,-29,14,1
397113,1,3,0,3,6,0
386607,1,0,7,-7,2,1
232587,1,0,0,0,1,1
219651,3,10,7,3,13,1
78030,4,12,16,-4,1,1
90929,4,61,7,54,7,0
261446,4,17,24,-7,14,0
178193,2,0,10,-10,12,1
252976,4,9,13,-4,11,1
243141,4,20,22,-2,6,1
35190,3,0,14,-14,16,1
299648,1,13,0,13,14,1
355442,3,13,13,0,4,1
164010,1,0,3,-3,5,0
293495,2,10,9,1,11,0
258810,2,7,7,0,13,1
272782,4,15,16,-1,2,1
318491,4,31,7,24,5,1
296196,3,16,26,-10,13,0
108486,1,7,7,0,15,1
202339,4,19,6,13,5,1
342247,2,3,0,3,16,1
88690,4,26,20,6,6,0
92177,4,3,43,-40,8,1
361745,1,7,0,7,7,1
294753,1,0,7,-7,12,1
102182,2,17,7,10,13,0
243270,2,7,10,-3,6,1
72332,2,0,14,-14,16,0
61588,4,35,7,28,11,0
105642,1,7,3,4,14,1
376227,3,10,14,-4,14,0
8255,4,16,10,6,4,0
1277,4,17,16,1,1,1
198125,1,0,3,-3,3,0
261291,4,38,0,38,14,0
238223,3,3,16,-13,4,1
184556,4,42,14,28,14,0
182727,4,27,26,1,14,0
201615,2,7,10,-3,5,0
281073,4,38,16,22,6,0
385440,3,27,10,17,1,1
276305,1,7,7,0,3,0
73717,4,20,12,8,17,0
353165,4,20,29,-9,3,1
289372,4,31,25,6,9,0
113283,2,13,21,-8,17,0
176141,2,14,7,7,11,1
84130,2,7,0,7,4,0
244302,4,26,7,19,6,1
386520,3,7,14,-7,2,0
254916,3,24,7,17,12,1
4170,1,7,3,4,2,0
350891,2,0,14,-14,3,1
406796,2,0,17,-17,11,0
400946,2,16,7,9,8,1
259786,4,20,13,7,14,1
47938,1,0,14,-14,5,1
244210,2,13,7,6,6,1
159837,1,7,0,7,3,1
339750,3,21,6,15,15,1
222520,3,17,14,3,14,0
305025,4,31,27,4,16,0
242621,3,10,0,10,6,0
326229,3,10,34,-24,9,1
206050,1,6,3,3,7,1
95387,2,21,0,21,10,0
193746,4,10,27,-17,1,0
399828,4,11,27,-16,8,1
201805,3,13,10,3,5,0
37435,1,0,0,0,17,0
113793,4,13,17,-4,17,1
189483,3,14,0,14,17,1
286512,1,3,7,-4,8,0
93730,2,0,13,-13,9,1
266848,4,17,17,0,16,0
70267,2,7,7,0,15,0
258427,3,21,13,8,13,1
78144,2,17,3,14,2,1
26595,3,10,6,4,13,0
249208,2,9,7,2,9,1
159367,2,0,10,-10,3,1
404776,2,10,13,-3,10,1
223346,1,0,3,-3,15,0
304095,3,6,23,-17,16,1
347574,1,0,6,-6,1,0
318868,3,21,12,9,5,0
374804,1,7,0,7,14,1
183978,3,22,3,19,14,1
241203,1,0,0,0,5,0
371934,4,34,17,17,12,1
173206,3,20,24,-4,9,1
245075,1,7,0,7,7,0
412938,2,9,6,3,14,1
417524,3,24,21,3,16,0
114955,2,7,3,4,1,0
230836,1,0,0,0,1,1
273406,1,0,0,0,2,0
23733,1,0,0,0,12,0
361803,3,24,7,17,7,1
208932,3,14,6,8,8,1
67453,2,19,7,12,14,1
283829,1,7,0,7,7,1
216677,2,21,6,15,12,0
351200,2,14,3,11,3,1
11855,3,41,17,24,6,0
3237,1,0,0,0,2,1
380818,3,9,24,-15,16,0
259204,4,14,32,-18,13,0
13975,1,0,0,0,7,0
174770,1,6,7,-1,10,1
142741,2,9,10,-1,13,1
44468,4,17,12,5,3,1
198776,2,3,6,-3,3,1
108079,2,13,21,-8,15,1
374157,3,23,7,16,13,0
251082,2,10,14,-4,10,0
409959,2,3,21,-18,12,1
410754,3,19,6,13,13,1
267804,2,10,13,-3,17,0
68723,4,34,0,34,15,0
94564,4,13,10,3,9,0
329078,2,10,7,3,10,1
112995,2,7,3,4,17,1
391581,3,10,21,-11,4,0
125745,2,7,14,-7,5,1
81001,4,20,17,3,3,0
151583,2,0,3,-3,17,0
399016,2,10,9,1,7,1
164296,1,6,0,6,5,1
211619,1,7,3,4,9,1
3640,4,20,28,-8,2,1
310724,1,3,3,0,2,1
355929,4,34,17,17,5,1
42265,4,30,7,23,2,1
355585,3,24,3,21,5,0
320527,1,7,0,7,6,1
46998,2,7,0,7,5,1
290233,3,17,3,14,10,1
49233,3,17,10,7,6,1
49348,2,7,10,-3,6,1
411985,4,20,20,0,13,1
394328,3,24,10,14,5,0
391379,1,7,3,4,4,0
352299,4,6,6,0,3,0
301357,3,17,7,10,15,1
135583,4,28,6,22,10,0
100383,4,9,20,-11,12,1
151116,1,0,0,0,17,1
237824,2,7,13,-6,4,0
382954,3,3,13,-10,17,0
44862,2,0,17,-17,4,1
299488,4,10,23,-13,14,0
245169,4,17,28,-11,7,1
89183,1,0,0,0,7,1
259216,4,21,32,-11,13,1
221336,4,6,35,-29,14,0
188934,4,23,13,10,16,1
6525,3,3,3,0,3,0
116954,4,28,13,15,2,1
185366,2,0,3,-3,15,1
255290,1,0,0,0,12,0
393207,2,7,6,1,5,0
190018,1,6,0,6,17,1
419808,4,24,26,-2,17,0
318681,1,0,13,-13,5,1
149843,3,3,13,-10,16,0
336919,3,7,21,-14,14,1
328153,3,6,14,-8,10,1
322304,1,7,0,7,7,0
229404,2,3,0,3,17,0
133352,3,14,9,5,9,1
420713,4,21,19,2,17,0
394510,4,10,25,-15,5,0
47200,3,9,6,3,5,0
99069,3,23,0,23,11,0
251236,3,10,24,-14,10,0
136560,2,0,13,-13,11,1
413935,1,3,0,3,14,0
138206,3,7,12,-5,11,1
298517,2,10,0,10,14,1
27566,1,0,0,0,13,1
58935,4,20,32,-12,10,1
239140,3,13,13,0,4,1
349864,2,3,3,0,2,0
210352,4,16,17,-1,9,0
236696,3,23,7,16,3,1
103408,4,10,20,-10,13,0
82839,4,15,16,-1,3,0
296986,4,29,14,15,13,0
33172,1,6,0,6,16,1
378806,4,17,10,7,15,0
45418,1,7,0,7,4,0
108470,1,0,0,0,15,1
253654,1,0,0,0,11,1
289826,4,17,20,-3,10,1
138914,1,0,3,-3,12,1
227878,2,17,6,11,16,0
411390,4,20,13,7,13,1
683,3,0,17,-17,1,0
304069,3,3,20,-17,16,1
12236,2,0,3,-3,6,0
26395,2,10,0,10,13,0
5529,3,13,10,3,3,1
358274,2,0,14,-14,6,1
366334,4,28,16,12,10,0
300510,3,23,17,6,14,1
265780,3,17,3,14,16,0
377389,2,7,12,-5,15,0
290732,4,47,25,22,10,0
348667,2,3,3,0,2,0
127705,1,0,0,0,6,1
275793,4,16,3,13,3,1
86313,4,20,23,-3,5,1
236344,3,7,23,-16,3,1
51299,2,6,10,-4,7,1
235075,1,0,7,-7,2,0
325553,1,0,0,0,9,0
284373,4,14,17,-3,7,1
157485,4,23,37,-14,2,0
96832,1,0,0,0,10,1
200508,4,26,18,8,4,0
386634,2,7,13,-6,2,0
319701,4,33,9,24,6,1
121438,1,0,0,0,4,0
355306,3,14,17,-3,4,0
315881,4,9,19,-10,4,0
97006,1,7,0,7,10,1
402627,4,20,23,-3,9,1
267222,2,10,7,3,17,0
203139,1,0,7,-7,5,0
199265,3,17,31,-14,4,1
45120,2,7,0,7,4,0
31631,3,24,6,18,15,0
300697,1,0,0,0,15,1
154541,1,0,0,0,1,1
238187,2,3,16,-13,4,1
203477,2,21,3,18,6,0
30669,1,0,0,0,15,1
237464,1,7,0,7,3,1
159092,3,24,0,24,3,1
396121,2,17,22,-5,6,0
19663,1,0,0,0,10,0
136343,4,18,14,4,11,1
136578,2,9,13,-4,11,1
138974,3,14,6,8,12,0
420268,1,7,0,7,17,0
214269,2,14,10,4,11,0
240371,4,21,23,-2,5,1
188959,4,26,13,13,16,0
317262,4,7,16,-9,5,0
48008,3,10,24,-14,5,0
4046,2,10,14,-4,2,0
179668,5,31,30,1,12,0
110552,1,3,0,3,16,0
287284,1,0,0,0,8,1
206981,1,21,0,21,7,1
48042,4,10,27,-17,5,0
52738,4,13,23,-10,7,1
355931,4,34,17,17,5,0
254204,4,3,18,-15,11,0
144218,2,9,7,2,14,0
44959,1,0,0,0,4,0
17320,1,7,0,7,9,1
103723,4,3,17,-14,13,1
176442,1,0,7,-7,11,1
305105,2,21,10,11,16,0
201007,2,20,0,20,5,0
116135,2,7,3,4,1,0
211572,4,42,21,21,9,0
212432,2,10,0,10,10,0
278030,3,10,10,0,4,1
200905,3,24,0,24,4,1
281754,1,0,0,0,6,0
113278,2,10,21,-11,17,1
119906,1,6,7,-1,3,1
242357,4,33,13,20,6,1
234697,4,30,23,7,2,0
106331,3,14,19,-5,14,1
240183,3,16,6,10,5,1
301910,2,11,13,-2,15,1
370280,2,0,27,-27,12,0
38333,2,7,3,4,1,0
392562,4,10,20,-10,4,0
219263,4,25,10,15,13,1
29803,1,3,0,3,14,1
330311,1,0,0,0,11,1
410776,4,22,6,16,13,1
231685,4,24,19,5,1,0
386432,4,23,17,6,2,0
305231,2,14,14,0,16,0
323214,3,7,3,4,7,1
392804,2,17,3,14,4,0
116653,4,23,10,13,2,0
340965,4,10,17,-7,15,1
95719,3,13,9,4,10,0
417614,2,14,0,14,16,0
386870,4,26,28,-2,2,0
109306,3,13,3,10,15,1
203039,3,20,3,17,5,0
356724,4,26,16,10,5,0
211554,4,42,21,21,9,0
272856,2,20,7,13,2,1
115694,2,10,3,7,1,1
270244,2,3,21,-18,1,0
160434,1,6,0,6,4,0
407827,1,3,0,3,11,1
38851,4,3,10,-7,1,0
329577,1,7,0,7,11,1
17843,3,16,10,6,9,0
22536,1,0,0,0,11,1
6756,1,0,0,0,3,1
56614,4,26,17,9,9,0
153433,3,19,17,2,1,1
241528,2,3,3,0,5,0
252111,2,7,10,-3,10,0
257127,4,17,21,-4,12,1
190917,1,6,0,6,17,0
407162,4,17,27,-10,11,0
238176,2,3,16,-13,4,0
138597,1,3,0,3,12,0
313493,4,17,17,0,3,0
342948,4,37,17,20,16,0
19429,2,17,14,3,10,0
206767,4,14,24,-10,7,0
306818,1,0,0,0,17,0
304425,1,0,0,0,16,0
74290,4,10,30,-20,17,1
255963,3,6,12,-6,12,0
52654,2,3,7,-4,7,1
285035,1,0,0,0,7,1
355693,1,7,0,7,5,0
65170,3,3,3,0,13,1
196025,1,0,6,-6,2,0
110688,4,23,17,6,16,1
38497,2,10,3,7,1,1
392364,3,20,28,-8,4,1
104030,5,13,13,0,13,1
227415,2,7,7,0,16,1
70237,1,0,0,0,15,1
213717,4,24,17,7,10,0
96288,2,0,9,-9,10,1
309841,2,14,7,7,1,1
358557,2,10,9,1,6,1
108634,1,6,0,6,15,1
371846,2,14,10,4,12,0
408340,3,10,7,3,12,1
763,2,0,0,0,1,1
63826,1,0,0,0,12,0
263148,2,3,7,-4,15,1
368077,1,7,0,7,11,0
291748,3,3,14,-11,11,0
397810,1,0,0,0,7,0
139615,4,9,14,-5,12,1
83189,1,3,0,3,4,0
59834,4,15,16,-1,11,1
270944,1,0,0,0,1,0
54694,4,34,36,-2,8,1
348702,3,17,10,7,2,1
149356,2,3,0,3,16,0
361471,1,7,0,7,7,1
386187,2,6,3,3,2,1
395971,3,24,10,14,6,0
148551,1,0,0,0,16,0
160415,1,0,0,0,4,1
225405,4,27,35,-8,15,0
417892,4,13,10,3,16,0
345196,1,7,7,0,17,1
79649,4,24,21,3,2,1
46201,3,14,21,-7,4,1
243661,4,23,27,-4,6,1
104201,1,0,0,0,13,0
157005,4,13,13,0,2,0
337469,2,7,9,-2,14,1
96668,4,3,17,-14,10,1
256906,3,14,18,-4,12,1
33749,1,0,0,0,16,0
105683,2,21,3,18,14,1
275450,2,20,10,10,3,0
238460,1,3,0,3,4,1
198754,2,3,3,0,3,0
132174,4,29,6,23,9,0
128195,2,14,7,7,7,0
146639,2,0,7,-7,15,1
187504,2,3,10,-7,16,0
133322,2,7,6,1,9,0
78801,4,16,30,-14,2,1
412624,2,3,3,0,14,1
291906,3,17,10,7,11,1
199203,2,10,7,3,4,0
373475,1,0,7,-7,13,0
98710,2,21,3,18,11,0
151783,3,14,6,8,17,0
333463,1,3,0,3,12,0
149521,2,14,6,8,16,0
284456,2,7,12,-5,7,0
198805,3,3,16,-13,3,1
191923,1,0,3,-3,1,0
64020,2,17,10,7,13,1
187852,3,7,20,-13,16,0
399705,1,0,3,-3,8,0
36882,1,0,0,0,17,0
373075,3,3,7,-4,13,0
290105,4,13,15,-2,10,0
166906,3,10,6,4,6,1
176919,1,7,0,7,11,0
342206,1,0,0,0,16,1
41369,3,14,12,2,2,1
27607,2,7,10,-3,13,1
81681,2,7,14,-7,3,0
229483,4,13,9,4,17,1
186653,3,24,3,21,15,0
144183,1,0,7,-7,14,1
56496,1,6,0,6,9,1
152305,1,7,0,7,17,0
320860,2,3,14,-11,6,1
411141,2,0,20,-20,13,1
264933,3,20,17,3,16,1
283393,1,13,7,6,7,0
145172,3,43,0,43,14,0
207351,4,13,21,-8,7,0
133498,3,27,20,7,9,1
260752,1,3,3,0,14,1
365569,2,21,14,7,9,0
92845,2,21,0,21,8,1
364189,1,0,0,0,9,0
150599,3,3,13,-10,17,0
5878,1,0,0,0,3,0
38220,2,13,14,-1,1,1
259379,4,35,34,1,13,0
124804,1,0,3,-3,5,1
128931,2,22,3,19,7,0
171818,4,23,17,6,9,1
113796,4,13,17,-4,17,1
363456,4,28,42,-14,8,1
197983,2,0,17,-17,3,1
62113,2,7,7,0,12,0
384197,4,32,20,12,1,1
10740,1,7,0,7,5,1
158022,2,0,6,-6,3,1
310294,2,23,0,23,2,1
82694,4,12,19,-7,3,1
287784,2,21,10,11,9,0
370034,3,17,13,4,12,0
167038,3,10,17,-7,7,0
78667,1,0,0,0,2,1
328665,4,27,38,-11,10,1
249915,4,12,20,-8,9,1
332582,2,10,3,7,12,1
269483,2,10,3,7,1,0
324430,3,14,3,11,8,0
6677,3,3,20,-17,3,1
153302,3,2,10,-8,1,0
340985,4,17,17,0,15,0
238584,4,16,20,-4,4,1
119273,2,14,3,11,3,0
120350,1,0,3,-3,3,1
196724,3,47,0,47,3,0
19643,4,23,28,-5,10,0
49918,1,14,0,14,6,1
180664,3,24,6,18,13,1
5940,3,14,23,-9,3,1
158591,1,0,7,-7,3,1
359864,2,17,14,3,6,1
384454,3,21,0,21,1,0
53850,1,0,0,0,8,0
3635,4,20,28,-8,2,1
310136,2,14,7,7,2,0
395086,3,10,31,-21,5,0
361260,4,14,29,-15,7,1
206699,2,0,14,-14,7,0
274700,2,10,12,-2,3,1
57019,2,7,10,-3,9,0
25375,2,6,0,6,12,0
5105,3,13,7,6,3,1
58910,3,13,25,-12,10,0
116485,4,6,19,-13,1,1
53687,2,0,0,0,8,1
111788,2,3,7,-4,17,0
202965,1,7,0,7,5,0
367021,3,10,31,-21,10,0
29025,4,14,10,4,14,1
10251,4,13,10,3,5,1
135158,1,0,0,0,10,0
334484,1,0,13,-13,13,0
62523,5,16,16,0,12,0
385187,4,21,20,1,1,1
291675,1,0,0,0,11,0
70648,4,17,20,-3,15,0
101598,4,13,31,-18,12,0
278173,2,24,14,10,4,0
331259,1,0,7,-7,11,1
247983,2,7,3,4,8,1
369386,1,10,0,10,11,1
315907,1,0,0,0,4,1
60378,3,13,7,6,11,1
359742,2,24,9,15,6,0
104989,4,17,22,-5,14,0
239251,2,0,7,-7,4,0
170187,4,24,27,-3,8,1
61464,4,24,17,7,11,0
176369,3,16,28,-12,11,1
121324,2,0,0,0,3,1
337313,2,7,7,0,14,1
123474,2,0,0,0,4,0
216690,3,24,6,18,12,1
316976,4,44,18,26,4,0
230093,1,0,3,-3,17,1
212876,1,0,0,0,10,1
37535,3,10,10,0,17,1
327677,2,3,10,-7,10,1
206594,3,10,13,-3,7,0
328066,4,17,17,0,10,0
408064,3,13,17,-4,12,0
417710,4,35,12,23,16,0
35136,1,0,7,-7,16,1
19437,2,17,14,3,10,0
248544,5,23,26,-3,8,1
101997,2,7,0,7,12,0
411524,4,13,31,-18,13,0
362315,1,3,7,-4,8,0
404581,1,0,10,-10,10,1
52154,1,0,0,0,7,1
219905,1,3,0,3,13,0
53812,5,10,10,0,8,1
322779,2,3,20,-17,7,0
205868,4,20,0,20,7,0
342805,4,7,14,-7,16,0
169644,2,13,7,6,8,1
269749,1,7,0,7,1,1
313879,2,21,19,2,3,0
254671,4,31,31,0,11,1
88242,4,31,17,14,6,0
242194,3,16,7,9,6,1
34107,2,0,0,0,16,1
173786,3,10,3,7,10,0
205225,4,20,13,7,6,1
200305,3,24,14,10,4,1
219611,1,3,0,3,13,1
11426,4,26,0,26,6,0
402914,4,17,9,8,9,1
97581,4,44,7,37,10,0
300414,1,2,0,2,14,1
217378,4,21,13,8,12,1
23822,4,24,7,17,12,0
216356,3,14,13,1,12,0
9833,4,20,17,3,5,1
204438,2,7,17,-10,6,1
37953,4,10,14,-4,1,0
399869,1,0,0,0,8,0
403097,5,34,34,0,9,1
413003,4,16,15,1,14,1
185240,2,17,6,11,15,0
324815,1,3,0,3,8,0
352756,4,24,13,11,3,1
141490,2,7,0,7,13,0
304483,2,0,14,-14,16,1
381776,1,0,0,0,17,1
69110,2,7,7,0,15,1
108416,3,6,21,-15,15,1
20272,1,7,0,7,10,1
16714,4,21,33,-12,8,0
82645,3,12,10,2,3,0
122571,2,14,7,7,4,1
341546,3,13,10,3,16,0
269322,1,0,7,-7,1,1
323467,1,0,3,-3,7,1
248,3,12,23,-11,1,0
329741,1,3,0,3,11,0
184746,1,7,0,7,15,0
210525,1,0,0,0,9,0
371672,1,0,0,0,12,1
189259,1,0,0,0,16,0
123194,3,6,21,-15,4,1
245289,3,9,3,6,7,1
286397,2,14,0,14,8,1
381181,1,7,3,4,16,1
10430,1,0,0,0,5,0
370314,3,7,35,-28,12,1
271171,3,7,17,-10,1,1
202826,1,7,0,7,5,0
12329,1,0,0,0,6,0
200526,1,0,0,0,4,1
97188,2,3,3,0,10,0
381084,3,17,14,3,16,1
161869,2,13,3,10,4,1
95819,2,6,10,-4,10,0
147180,4,17,49,-32,15,1
291708,2,0,6,-6,11,1
345772,4,19,10,9,17,0
284688,4,17,27,-10,7,0
133400,1,0,7,-7,9,1
391661,1,0,0,0,4,0
241762,4,7,15,-8,5,1
206293,3,10,6,4,7,0
313056,4,20,0,20,3,1
23020,2,0,14,-14,11,1
199104,3,14,24,-10,4,1
148626,3,7,9,-2,16,1
387651,1,0,7,-7,2,1
315845,3,9,19,-10,4,1
59113,4,18,29,-11,10,0
219364,3,23,13,10,13,0
824,3,14,6,8,1,1
27907,2,0,3,-3,13,1
409213,2,10,3,7,12,0
219960,3,6,14,-8,13,0
132250,2,14,7,7,9,0
138109,1,7,0,7,11,0
138767,1,0,0,0,12,0
291321,4,24,22,2,10,0
384765,4,19,40,-21,1,1
201915,1,0,0,0,5,1
189935,2,3,7,-4,17,1
394919,3,0,17,-17,5,1
104673,4,7,3,4,14,0
4360,3,7,7,0,2,0
283150,3,13,9,4,7,0
142825,4,12,10,2,13,0
270218,2,3,14,-11,1,1
293886,1,0,7,-7,12,1
96918,3,22,7,15,10,0
69189,4,17,17,0,15,1
213928,1,16,7,9,10,0
360881,2,6,0,6,7,0
190958,2,9,0,9,17,1
144447,3,10,26,-16,14,0
234867,4,3,12,-9,2,0
76646,2,10,0,10,1,0
408793,3,10,25,-15,12,0
345806,1,0,7,-7,17,1
259515,4,35,10,25,13,1
109793,1,0,0,0,16,1
279688,2,23,3,20,5,0
137706,2,7,13,-6,11,0
47779,1,0,0,0,5,1
394517,4,10,25,-15,5,1
169078,4,33,17,16,7,1
52645,2,3,7,-4,7,0
54184,2,0,3,-3,8,1
392001,2,0,7,-7,4,0
321687,1,0,0,0,7,0
165144,5,24,24,0,6,0
134303,1,7,14,-7,10,0
281511,3,10,10,0,6,0
107182,2,0,21,-21,15,1
54638,2,14,19,-5,8,0
325680,4,34,7,27,9,1
302654,3,17,6,11,15,0
235619,4,27,34,-7,3,1
309674,2,3,3,0,1,0
361689,4,10,32,-22,7,0
104616,2,7,3,4,14,0
211257,4,29,26,3,9,0
217761,3,10,7,3,12,0
319125,2,2,0,2,5,1
367783,1,0,0,0,10,1
250957,2,3,6,-3,10,1
292559,1,0,6,-6,11,1
6809,2,3,21,-18,3,1
57224,4,20,7,13,10,0
180311,2,9,7,2,13,0
380801,3,9,21,-12,16,1
391042,4,27,34,-7,4,0
224672,4,19,10,9,15,1
335304,3,3,9,-6,13,0
233208,1,0,0,0,2,1
273112,1,0,0,0,2,0
99773,2,0,7,-7,12,0
104415,1,0,0,0,13,1
386594,1,0,7,-7,2,1
279444,4,16,30,-14,5,0
108116,3,13,35,-22,15,0
104196,1,0,0,0,13,1
44888,3,7,24,-17,4,0
23163,2,20,0,20,11,1
238034,3,10,13,-3,4,0
411306,2,0,10,-10,13,1
325132,2,10,7,3,8,1
48011,3,10,24,-14,5,0
277181,1,0,0,0,4,0
320005,4,43,24,19,6,1
195406,3,24,3,21,2,0
226600,3,10,3,7,16,0
221198,1,0,0,0,14,0
117743,1,0,0,0,2,0
405129,3,3,10,-7,10,0
255755,1,0,0,0,12,1
36486,2,3,6,-3,17,1
366719,3,24,10,14,10,1
226774,4,7,20,-13,16,0
220079,2,13,3,10,13,0
267008,4,19,17,2,17,1
271079,1,0,0,0,1,1
18861,2,3,6,-3,9,1
391235,1,7,0,7,4,0
57,2,0,0,0,1,0
326170,2,7,10,-3,9,1
68773,1,6,0,6,15,1
299833,1,3,0,3,14,1
258819,2,7,7,0,13,0
182220,4,33,7,26,13,1
242845,1,7,0,7,6,0
293440,4,35,24,11,11,1
224754,2,5,0,5,15,0
320173,4,17,17,0,6,0
74739,4,14,17,-3,17,0
416810,4,13,10,3,15,0
389276,4,34,14,20,3,1
28062,2,14,7,7,13,0
164157,1,14,7,7,5,1
41253,4,10,13,-3,2,1
174432,4,17,10,7,10,0
414378,2,7,16,-9,14,0
406662,2,14,0,14,11,0
97625,1,3,0,3,11,1
192126,2,0,6,-6,1,1
389866,4,31,6,25,3,1
126466,1,0,3,-3,6,0
260206,2,10,3,7,14,1
173201,3,20,17,3,9,0
405903,2,14,0,14,11,1
102842,4,17,10,7,13,0
391366,1,0,0,0,4,0
49143,1,3,0,3,6,0
355518,1,7,0,7,5,1
82401,4,13,10,3,3,1
273147,2,10,0,10,2,1
222361,3,21,3,18,14,1
343151,1,3,0,3,16,1
115727,3,13,13,0,1,0
98676,1,0,3,-3,11,1
58565,3,10,10,0,10,1
106456,3,16,0,16,14,0
116849,2,7,7,0,2,1
41137,1,0,0,0,2,0
81800,1,0,7,-7,3,0
291383,2,7,7,0,10,0
65360,4,13,21,-8,13,0
394402,1,0,0,0,5,0
246978,3,20,24,-4,8,0
305063,1,21,7,14,16,0
24061,2,7,7,0,12,0
7822,4,37,17,20,4,1
104669,4,7,3,4,14,1
127468,2,3,10,-7,6,0
162214,3,13,20,-7,4,1
249039,2,14,10,4,9,1
402709,2,10,0,10,9,0
341668,2,17,13,4,16,1
291966,1,0,0,0,11,1
417606,1,14,0,14,16,0
38807,3,3,10,-7,1,0
284074,4,13,10,3,7,0
138493,3,24,30,-6,12,1
202612,3,24,13,11,5,1
239076,1,0,0,0,4,0
3020,3,19,34,-15,2,1
370679,1,0,0,0,12,0
144469,4,10,33,-23,14,1
344047,1,0,0,0,17,0
46290,1,0,7,-7,4,0
277779,4,17,6,11,4,1
123868,4,17,3,14,5,0
285031,1,0,0,0,7,0
343390,4,6,33,-27,16,0
418551,2,14,0,14,16,0
64753,3,28,7,21,13,1
194592,2,21,0,21,2,1
41955,4,31,6,25,2,0
37945,3,10,14,-4,1,1
312440,4,39,41,-2,3,1
229916,4,27,14,13,17,1
101241,3,7,7,0,12,1
212240,4,3,24,-21,10,0
330964,2,9,7,2,11,1
124467,4,16,14,2,5,0
137269,4,7,19,-12,11,0
276232,4,24,10,14,3,1
60373,2,13,7,6,11,0
284629,2,14,17,-3,7,0
24303,4,13,17,-4,12,1
87805,1,3,0,3,6,0
410566,2,10,7,3,13,1
56604,3,19,17,2,9,1
115329,4,20,15,5,1,0
364382,2,20,7,13,9,1
395680,3,10,27,-17,6,0
99006,1,3,0,3,11,1
34326,4,23,9,14,16,0
397716,2,9,7,2,7,0
64131,1,0,0,0,13,0
50883,3,7,17,-10,6,1
326843,4,10,17,-7,9,1
94503,3,0,0,0,9,1
322023,2,6,0,6,7,0
286056,2,10,0,10,8,1
77251,3,16,7,9,1,1
383432,4,13,9,4,17,0
281346,3,21,13,8,6,1
227800,4,6,21,-15,16,1
33668,2,21,0,21,16,1
18605,3,17,10,7,9,0
249433,4,18,15,3,9,1
383037,1,3,0,3,17,0
376157,1,0,0,0,14,1
185764,3,23,3,20,15,1
81511,2,0,14,-14,3,1
329378,3,16,34,-18,10,1
248981,4,27,3,24,9,1
415050,4,10,27,-17,15,1
223827,2,9,0,9,15,0
325396,1,0,0,0,8,1
90024,3,5,21,-16,7,0
397691,1,3,0,3,7,1
79496,4,12,17,-5,2,0
181577,3,13,3,10,13,0
267766,1,0,0,0,17,1
128542,4,21,35,-14,7,0
10507,2,20,0,20,5,1
159249,3,17,24,-7,3,0
135901,5,24,24,0,10,0
268835,1,0,0,0,17,1
80635,2,7,16,-9,3,0
122864,3,10,6,4,4,1
36916,2,0,14,-14,17,1
205069,4,19,20,-1,6,1
287312,2,3,0,3,8,1
91105,1,0,0,0,8,1
225340,2,10,21,-11,15,0
375677,4,23,20,3,14,1
205562,4,14,24,-10,6,1
144058,1,7,0,7,14,1
260067,2,3,7,-4,14,1
266752,2,0,7,-7,16,0
343367,3,0,20,-20,16,1
48980,1,3,6,-3,6,0
298866,4,21,9,12,14,0
163529,1,7,3,4,5,0
179361,1,0,6,-6,12,1
141748,4,33,21,12,13,0
420266,1,7,0,7,17,0
11172,1,0,0,0,6,1
24199,2,3,0,3,12,1
19883,3,13,21,-8,10,0
100901,1,7,3,4,12,1
257868,3,13,12,1,13,1
182083,4,17,24,-7,13,1
259770,3,17,10,7,14,1
101906,3,6,13,-7,12,0
305991,2,3,3,0,17,0
145059,4,20,6,14,14,0
128674,3,6,17,-11,7,0
24049,2,0,7,-7,12,0
381348,2,6,0,6,16,0
123770,2,10,3,7,5,1
190593,4,20,20,0,17,1
160375,4,3,28,-25,4,1
221981,1,0,0,0,14,1
16678,4,14,27,-13,8,0
206726,3,7,14,-7,7,0
245504,1,7,0,7,7,1
266985,3,19,17,2,17,1
261642,1,0,0,0,14,1
169954,2,7,7,0,8,0
51027,2,0,17,-17,6,1
55430,3,20,10,10,9,1
183325,1,6,0,6,14,1
324049,1,0,0,0,8,0
281050,3,17,13,4,6,0
360543,1,0,7,-7,7,0
116648,4,23,10,13,2,1
337428,1,0,0,0,14,1
327985,2,10,0,10,10,0
32447,4,31,6,25,15,1
160619,2,7,0,7,4,1
194075,4,33,14,19,1,1
357954,2,13,6,7,6,1
32813,2,6,0,6,15,0
411074,4,17,17,0,13,1
128541,4,21,35,-14,7,0
391719,3,3,10,-7,4,1
415575,2,7,7,0,15,1
225928,2,20,7,13,16,1
196875,4,10,20,-10,3,0
38630,1,0,0,0,1,1
24151,4,31,14,17,12,0
352691,3,17,3,14,3,1
137021,1,7,0,7,11,0
295231,2,14,5,9,12,1
110049,4,48,10,38,16,0
13760,3,0,20,-20,7,1
52013,2,3,7,-4,7,0
244572,4,25,16,9,7,0
129068,2,14,21,-7,7,1
15318,2,7,3,4,8,0
76674,3,13,7,6,1,1
45219,4,14,10,4,4,0
116591,3,13,0,13,2,0
78354,4,31,35,-4,2,1
183033,1,0,0,0,14,0
415503,4,23,3,20,15,0
243870,2,13,3,10,6,0
13388,1,0,0,0,7,0
243438,3,3,17,-14,6,1
331239,1,0,0,0,11,0
53126,3,19,31,-12,7,0
203218,4,10,17,-7,5,1
221506,4,10,41,-31,14,1
107556,1,0,0,0,15,0
221337,4,6,35,-29,14,1
355192,1,0,0,0,4,0
317364,2,0,0,0,5,0
1823,3,16,7,9,1,0
93127,1,0,0,0,9,1
21120,2,0,0,0,10,0
379630,4,26,13,13,16,0
278686,4,24,10,14,4,0
266311,1,0,0,0,16,1
292237,4,24,17,7,11,1
289602,2,10,13,-3,10,0
400008,1,0,0,0,8,0
98348,4,49,35,14,11,0
125287,2,3,0,3,5,0
187924,1,0,7,-7,16,0
111028,1,7,0,7,16,0
310274,2,10,0,10,2,1
33563,3,17,3,14,16,0
329027,1,0,7,-7,10,1
272732,3,12,3,9,2,1
97576,4,37,7,30,10,1
2413,3,21,13,8,2,1
353622,1,0,0,0,4,1
181707,2,7,7,0,13,0
412560,4,31,21,10,14,1
373649,2,0,9,-9,13,0
253623,4,9,17,-8,11,1
335557,2,6,0,6,13,0
78010,3,9,16,-7,1,0
218300,2,10,14,-4,12,1
364388,2,21,7,14,9,1
314811,3,28,7,21,4,1
175052,1,0,0,0,10,1
63992,1,7,3,4,13,1
132728,3,10,17,-7,9,0
6459,4,23,20,3,3,0
235078,2,0,7,-7,2,0
70099,1,3,0,3,15,1
21773,4,31,24,7,11,0
176066,4,24,8,16,11,1
403771,3,12,13,-1,9,0
6805,2,3,14,-11,3,0
210791,4,24,10,14,9,0
338332,2,3,0,3,14,0
279659,2,14,0,14,5,1
398471,2,7,6,1,7,1
81022,4,20,23,-3,3,1
410399,2,6,7,-1,13,0
396132,3,17,23,-6,6,0
73174,2,7,0,7,16,1
266245,4,31,19,12,16,1
44715,2,0,9,-9,3,0
406118,4,0,26,-26,11,1
314549,4,27,10,17,3,0
21226,1,3,0,3,11,1
95366,1,7,0,7,10,1
321103,1,0,3,-3,6,1
326161,1,7,7,0,9,0
17589,4,20,17,3,9,0
231178,3,10,7,3,1,0
402204,4,19,14,5,9,1
150326,3,24,7,17,16,1
192532,4,14,17,-3,1,1
52041,2,10,10,0,7,1
368352,1,7,0,7,11,0
133407,1,0,7,-7,9,0
164309,2,13,0,13,5,1
353891,3,10,28,-18,4,1
72465,2,7,10,-3,16,1
263955,3,23,0,23,15,1
120123,3,10,3,7,3,1
231961,4,14,41,-27,1,1
87867,2,10,12,-2,6,0
241359,1,7,0,7,5,0
199339,2,0,0,0,4,0
215303,2,7,0,7,11,0
303606,3,28,13,15,16,1
322706,5,9,9,0,7,0
4628,2,10,10,0,2,1
361964,3,10,6,4,7,1
100550,4,20,20,0,12,0
227263,2,3,13,-10,16,1
275795,4,16,3,13,3,1
24773,1,0,0,0,12,0
89850,3,16,6,10,7,0
413301,3,17,0,17,14,1
157406,2,9,7,2,2,0
336412,2,3,3,0,14,1
411905,2,17,3,14,13,0
192739,1,0,3,-3,1,0
202922,4,31,0,31,5,1
355860,2,13,10,3,5,1
348437,4,13,23,-10,1,0
414047,4,10,45,-35,14,1
120419,3,19,9,10,3,1
273935,3,7,9,-2,2,0
32912,1,0,0,0,15,0
82009,2,7,0,7,3,1
197329,3,17,10,7,3,1
251667,2,6,3,3,10,1
195593,4,24,7,17,2,0
57398,4,14,6,8,10,1
184881,1,0,0,0,15,1
52263,4,17,19,-2,7,1
58720,2,10,17,-7,10,0
348776,1,0,0,0,2,0
55244,2,7,3,4,9,0
184021,4,29,10,19,14,0
371071,4,13,20,-7,12,1
105926,1,0,0,0,14,0
117113,4,7,27,-20,2,1
246475,2,9,0,9,8,1
103671,3,0,10,-10,13,0
102460,2,3,3,0,13,1
285010,4,16,27,-11,7,1
299618,4,13,16,-3,14,1
133912,3,6,6,0,9,0
108351,2,0,14,-14,15,1
287093,4,33,32,1,8,0
372044,3,13,3,10,13,0
393006,4,12,10,2,4,1
40236,1,0,0,0,2,0
243898,2,16,6,10,6,1
181422,3,17,24,-7,13,1
117572,4,24,23,1,2,0
233890,2,14,6,8,2,1
242353,3,27,13,14,6,1
281552,4,20,23,-3,6,1
351062,3,14,16,-2,3,1
23214,3,23,13,10,11,0
127924,2,16,0,16,6,1
303616,3,28,13,15,16,0
412557,4,31,21,10,14,1
320960,1,7,0,7,6,0
52901,1,0,0,0,7,0
129909,4,13,0,13,7,1
251815,2,0,7,-7,10,1
319880,4,23,10,13,6,0
348455,1,0,0,0,2,1
371376,4,45,10,35,12,1
298882,4,21,23,-2,14,1
244016,2,7,10,-3,6,1
346028,2,3,3,0,1,0
399609,2,3,3,0,8,1
275402,1,6,7,-1,3,0
270339,5,27,27,0,1,1
83269,3,12,10,2,4,1
106310,2,7,9,-2,14,0
339813,1,0,0,0,15,1
20777,1,7,0,7,10,0
14089,4,3,31,-28,7,0
393309,4,30,29,1,5,0
278495,3,36,0,36,4,1
113516,4,3,7,-4,17,1
305162,4,27,10,17,16,0
410821,1,7,0,7,13,1
19299,2,14,14,0,10,0
387255,2,6,7,-1,2,0
37019,1,3,0,3,17,1
159405,3,10,20,-10,3,1
350004,2,10,7,3,2,0
107169,2,0,14,-14,15,1
92053,1,0,0,0,8,1
130186,2,0,19,-19,8,1
388240,1,0,0,0,2,1
356103,1,0,0,0,5,1
336926,4,14,21,-7,14,0
409223,2,13,3,10,12,0
62970,1,0,7,-7,12,1
48406,2,3,17,-14,5,1
23288,1,0,10,-10,11,1
122087,1,7,7,0,4,0
334610,4,30,31,-1,13,1
79658,4,24,21,3,2,0
182373,4,24,20,4,14,1
75689,1,7,0,7,1,1
76794,3,33,0,33,1,0
271113,1,0,10,-10,1,1
178766,1,21,7,14,12,0
248785,3,27,14,13,9,1
107110,4,40,6,34,15,1
131555,3,9,23,-14,8,1
358184,4,20,17,3,6,1
378751,3,14,7,7,15,0
246985,3,20,24,-4,8,0
405915,2,14,0,14,11,0
262846,2,7,20,-13,15,1
272776,4,15,10,5,2,0
407040,4,11,34,-23,11,1
26285,3,10,21,-11,13,1
126437,1,0,0,0,6,0
200707,2,7,0,7,4,1
365078,1,0,0,0,9,0
206204,1,0,3,-3,7,1
45920,3,17,3,14,4,0
4689,4,20,20,0,2,1
21477,4,15,14,1,11,0
20605,1,0,0,0,10,1
283015,3,21,3,18,6,0
283176,4,20,9,11,7,1
273102,1,0,0,0,2,1
305239,2,14,21,-7,16,1
286204,1,0,0,0,8,0
297309,1,0,0,0,13,0
187257,3,10,6,4,16,0
345087,2,6,3,3,17,0
33667,2,21,0,21,16,0
372031,3,13,3,10,13,1
288221,2,3,14,-11,9,1
190157,4,30,3,27,17,0
358790,4,21,28,-7,6,1
271182,3,14,17,-3,1,0
228996,3,14,16,-2,17,1
5860,4,34,7,27,3,0
85210,3,10,17,-7,4,1
201180,3,13,21,-8,5,1
159746,3,7,10,-3,3,0
297028,1,7,0,7,13,1
383183,1,7,0,7,17,0
334409,3,10,10,0,13,0
10921,2,6,7,-1,5,0
132089,1,7,0,7,9,1
355054,1,0,6,-6,4,1
48750,4,10,19,-9,5,0
415697,2,7,3,4,15,0
165619,1,0,0,0,6,1
4910,2,14,7,7,3,1
179080,2,3,6,-3,12,1
408457,2,7,3,4,12,0
70709,2,7,9,-2,15,0
77271,4,16,10,6,1,1
69205,4,20,20,0,15,0
75417,2,10,7,3,17,0
94216,3,24,17,7,9,1
309773,4,29,19,10,1,1
379466,3,16,0,16,16,1
39457,3,13,10,3,1,1
186921,2,7,3,4,15,0
234174,2,10,10,0,2,0
3074,1,0,0,0,2,1
137141,4,31,6,25,11,1
284344,3,6,17,-11,7,1
412115,4,38,3,35,13,0
80373,3,26,9,17,2,1
363427,3,28,21,7,8,0
41634,2,14,0,14,2,1
361319,1,0,0,0,7,0
55566,3,17,7,10,9,1
101826,1,3,0,3,12,0
154512,4,21,17,4,1,0
135272,4,24,17,7,10,1
327665,1,3,3,0,10,0
224983,4,10,22,-12,15,1
56740,3,7,10,-3,9,1
23378,4,20,17,3,11,1
346452,1,0,0,0,1,1
195547,3,6,7,-1,2,1
293513,2,10,10,0,11,0
277771,4,17,6,11,4,0
277665,1,7,0,7,4,1
335355,4,3,23,-20,13,0
235234,2,15,3,12,3,0
102455,2,3,3,0,13,1
344350,2,7,0,7,17,0
371418,2,7,7,0,12,1
145513,4,26,17,9,14,0
332434,2,10,3,7,12,1
242599,2,10,0,10,6,0
377199,1,0,0,0,15,1
403151,2,10,14,-4,9,1
269654,2,10,0,10,1,0
148977,3,13,12,1,16,1
321695,1,0,3,-3,7,1
272987,2,3,3,0,2,1
176714,4,29,19,10,11,1
405657,4,24,28,-4,10,0
163318,4,13,16,-3,5,0
182319,3,17,7,10,14,0
45867,2,7,3,4,4,1
31215,4,23,34,-11,15,1
278074,4,13,10,3,4,1
190523,2,10,6,4,17,0
40735,2,17,7,10,2,0
212304,2,10,3,7,10,0
295544,2,23,7,16,12,0
23569,1,0,0,0,12,1
378065,4,0,14,-14,15,0
104115,2,17,20,-3,13,1
218571,2,7,17,-10,13,1
399728,1,0,3,-3,8,1
359951,4,30,30,0,6,0
414458,4,16,23,-7,14,1
303421,2,10,7,3,16,1
285025,1,0,0,0,7,0
160342,3,3,21,-18,4,1
75267,2,7,13,-6,17,0
240386,5,24,23,1,5,1
113393,1,0,0,0,17,0
354009,1,6,0,6,4,1
392550,4,10,20,-10,4,0
137545,3,17,17,0,11,0
93961,1,0,7,-7,9,1
68372,3,3,14,-11,14,1
223555,3,16,13,3,15,1
3627,3,20,21,-1,2,0
97626,1,3,0,3,11,1
142893,2,0,10,-10,13,1
206611,4,10,13,-3,7,0
275746,2,16,0,16,3,0
68183,2,7,7,0,14,0
289310,2,21,17,4,9,0
35935,3,3,0,3,17,0
147451,4,23,10,13,15,1
54836,3,13,0,13,8,1
340325,2,17,7,10,15,0
408432,2,0,0,0,12,1
199230,2,17,21,-4,4,1
243406,2,3,10,-7,6,1
32800,2,0,0,0,15,1
55367,1,7,7,0,9,1
182636,2,0,6,-6,14,0
22194,4,10,15,-5,11,0
70695,1,7,3,4,15,0
360974,4,37,5,32,7,1
273285,2,14,0,14,2,0
279247,3,16,13,3,5,1
5695,4,0,24,-24,3,1
197509,4,20,9,11,3,1
202655,4,40,20,20,5,1
30342,4,10,16,-6,14,0
126375,3,10,14,-4,6,1
202566,2,13,6,7,5,1
289485,3,6,7,-1,10,1
162624,2,3,10,-7,5,1
290624,1,20,0,20,10,1
110505,4,20,6,14,16,0
129087,2,17,21,-4,7,1
238678,3,16,17,-1,4,1
18585,2,10,10,0,9,1
304992,4,17,20,-3,16,0
222613,2,7,7,0,14,0
165422,4,6,36,-30,6,1
103613,1,0,0,0,13,1
95206,1,0,0,0,10,1
21214,1,0,0,0,11,1
290120,4,21,15,6,10,0
125827,4,17,23,-6,5,1
402403,2,7,7,0,9,1
58998,1,0,7,-7,10,0
402114,2,12,0,12,9,0
302692,4,20,20,0,15,1
367571,3,14,9,5,10,1
122913,4,34,6,28,4,1
218404,1,3,14,-11,13,1
87019,4,14,22,-8,5,1
271834,1,0,0,0,2,0
47302,2,0,7,-7,5,0
263645,3,20,10,10,15,0
327181,4,28,17,11,9,1
297065,2,14,0,14,13,1
47041,3,17,7,10,5,0
259623,3,6,3,3,13,0
67222,4,0,3,-3,14,0
243521,1,0,0,0,6,1
415412,2,9,0,9,15,0
42440,1,0,0,0,3,0
382184,1,0,0,0,17,0
82468,2,7,14,-7,3,0
9645,3,12,21,-9,5,1
204418,2,7,9,-2,6,0
342413,2,10,3,7,16,0
113198,4,41,22,19,17,1
87097,2,7,0,7,5,0
372480,3,23,14,9,13,0
258227,1,0,0,0,13,1
18603,3,17,10,7,9,0
382896,1,0,7,-7,17,0
14768,3,31,3,28,7,0
392713,4,16,6,10,4,0
137184,1,0,0,0,11,1
172913,4,34,24,10,9,0
265134,4,20,17,3,16,1
304034,2,3,13,-10,16,0
392343,2,14,28,-14,4,1
147910,4,24,31,-7,15,0
371096,4,13,27,-14,12,1
226186,4,35,35,0,16,0
226717,2,7,6,1,16,1
130814,3,13,12,1,8,0
378222,4,41,16,25,15,1
318345,4,9,22,-13,5,0
77363,2,7,7,0,1,1
74048,1,3,0,3,17,0
168837,2,14,0,14,7,1
362875,1,0,0,0,8,1
235428,3,28,17,11,3,0
226728,2,7,6,1,16,0
83100,3,6,21,-15,4,0
321859,1,7,14,-7,7,1
121730,4,21,28,-7,4,1
196307,4,24,17,7,2,0
222084,4,27,17,10,14,1
206644,4,10,16,-6,7,1
209383,3,14,7,7,8,0
37375,3,17,0,17,17,1
140893,3,17,7,10,13,0
379620,3,19,13,6,16,0
313506,4,17,17,0,3,0
59675,4,21,6,15,11,1
323525,3,24,10,14,7,0
1065,2,7,22,-15,1,0
253280,4,3,13,-10,11,0
79353,4,32,3,29,2,0
116371,1,0,0,0,1,1
125852,1,3,0,3,6,0
238357,2,10,16,-6,4,1
62310,3,21,19,2,12,1
122553,2,14,0,14,4,0
325276,2,3,3,0,8,0
382708,3,3,13,-10,17,1
276794,2,17,17,0,4,1
383210,1,14,3,11,17,1
194851,1,0,7,-7,2,1
61425,3,16,3,13,11,0
238245,4,3,16,-13,4,1
289177,3,20,10,10,9,1
183063,2,7,0,7,14,1
244211,2,13,7,6,6,0
230046,4,19,6,13,17,0
52914,1,0,0,0,7,0
170285,3,0,12,-12,8,1
343855,4,24,3,21,17,0
347588,1,7,7,0,1,1
308476,4,7,28,-21,1,1
232386,4,13,21,-8,1,0
304888,1,0,0,0,16,1
256062,1,0,3,-3,12,0
320578,3,24,0,24,6,0
372985,4,28,13,15,13,0
32818,2,6,7,-1,15,1
73488,2,3,21,-18,17,1
335098,1,0,0,0,13,1
11696,3,17,3,14,6,0
319486,3,3,10,-7,6,1
307429,1,14,3,11,17,0
390447,4,14,33,-19,3,1
315302,1,0,0,0,4,1
73225,3,7,9,-2,16,0
22023,3,14,17,-3,11,0
281061,4,24,13,11,6,0
204143,3,10,10,0,6,0
160919,1,0,0,0,4,1
86392,2,7,7,0,5,1
60320,1,3,0,3,11,1
336953,4,21,21,0,14,1
76284,1,0,0,0,1,1
98788,4,34,8,26,11,0
337132,1,3,0,3,14,0
198481,3,17,3,14,3,0
93179,3,0,3,-3,9,0
273971,4,7,22,-15,2,1
51978,1,0,0,0,7,0
150848,1,0,0,0,17,0
296022,2,3,7,-4,13,0
263620,2,14,10,4,15,1
69222,1,0,0,0,15,1
108619,1,0,0,0,15,1
81628,1,0,0,0,3,1
130528,3,10,6,4,8,0
243949,4,25,13,12,6,0
61687,2,14,10,4,12,1
87004,3,14,9,5,5,1
132616,4,20,49,-29,9,0
263961,3,23,0,23,15,1
44072,1,0,6,-6,3,0
291499,1,0,0,0,11,0
94280,1,3,0,3,9,1
367510,1,0,0,0,10,1
151150,2,3,10,-7,17,0
29197,4,3,26,-23,14,0
106297,2,7,6,1,14,0
415249,1,0,0,0,15,0
290851,4,17,21,-4,10,1
70869,2,7,17,-10,15,1
191083,2,7,3,4,17,0
275547,4,32,36,-4,3,1
269062,3,10,16,-6,17,1
1389,3,10,0,10,1,0
90547,1,7,7,0,7,1
139720,3,7,7,0,12,0
303822,4,20,17,3,16,0
413509,1,0,0,0,14,0
166252,2,0,3,-3,6,0
10486,2,6,0,6,5,0
207352,4,13,21,-8,7,0
208139,2,0,0,0,8,0
208249,4,13,13,0,8,0
315379,3,16,17,-1,4,1
416646,3,31,7,24,15,0
180518,3,21,20,1,13,1
405786,4,18,21,-3,10,1
29107,2,0,6,-6,14,1
352076,2,3,10,-7,3,1
25877,3,31,17,14,12,0
138636,2,3,14,-11,12,0
293402,3,16,10,6,11,1
140210,5,13,13,0,12,1
258338,4,41,39,2,13,1
25127,2,10,0,10,12,1
335955,1,0,15,-15,13,1
205732,4,27,19,8,7,0
150853,1,0,0,0,17,0
375893,1,7,3,4,14,1
61918,4,27,30,-3,12,0
191946,1,0,6,-6,1,1
52930,1,7,7,0,7,1
323629,2,10,0,10,8,1
323708,4,26,0,26,8,0
76666,3,10,0,10,1,1
373817,2,13,0,13,13,1
50449,3,10,10,0,6,1
301942,3,14,20,-6,15,1
45743,2,10,7,3,4,1
260765,2,3,6,-3,14,1
198903,2,3,16,-13,3,1
212027,3,10,36,-26,9,0
352656,2,0,0,0,3,1
199677,2,14,7,7,4,1
69849,2,14,9,5,15,0
292937,3,10,0,10,11,0
111706,4,31,13,18,16,0
28960,2,0,7,-7,14,1
395533,3,21,14,7,6,0
38312,1,0,0,0,1,0
118874,4,27,7,20,2,0
137861,2,10,6,4,11,0
10465,2,3,0,3,5,1
28431,4,13,6,7,14,1
141874,4,24,21,3,13,1
77841,3,14,21,-7,1,1
191226,2,6,17,-11,17,1
407669,1,0,0,0,11,1
6082,2,7,10,-3,3,0
243225,1,0,0,0,6,0
203273,1,0,10,-10,6,1
407560,2,10,6,4,11,1
274510,2,14,6,8,3,1
316690,5,12,15,-3,4,1
204522,1,0,7,-7,6,1
188770,4,0,20,-20,16,1
16602,2,7,14,-7,8,0
89740,4,16,23,-7,7,0
395939,2,24,3,21,6,0
172187,2,0,0,0,9,0
23785,2,16,0,16,12,1
81995,2,7,0,7,3,1
38941,2,17,0,17,1,0
46445,1,7,0,7,4,0
188667,1,0,0,0,16,0
109963,1,10,0,10,16,0
73963,3,30,0,30,17,0
39061,1,3,0,3,1,1
399121,4,18,36,-18,7,1
317703,4,23,16,7,5,0
215942,3,13,21,-8,11,0
55,2,0,0,0,1,0
98507,4,31,24,7,11,0
184624,2,10,3,7,15,0
69855,3,14,9,5,15,1
135853,4,7,17,-10,10,1
160162,2,24,7,17,3,0
43565,4,24,3,21,3,0
258476,4,21,21,0,13,1
69695,2,7,7,0,15,1
326619,2,10,6,4,9,1
172287,4,24,20,4,9,0
375199,4,17,17,0,14,0
158202,2,10,0,10,3,1
185224,2,10,6,4,15,1
310853,1,3,0,3,2,1
77337,1,7,7,0,1,0
36748,1,0,7,-7,17,0
166005,3,17,21,-4,6,0
66364,3,14,24,-10,14,0
168461,3,0,24,-24,7,0
252903,2,6,0,6,11,0
154270,2,6,7,-1,1,0
96597,2,3,3,0,10,1
151283,1,7,6,1,17,0
188345,1,0,0,0,16,1
27353,3,24,10,14,13,1
280062,4,13,23,-10,5,0
320706,2,14,17,-3,6,0
316434,3,16,10,6,4,1
151609,2,13,10,3,17,0
219362,3,23,13,10,13,0
169584,1,0,0,0,8,1
16375,3,21,10,11,8,0
4259,3,13,6,7,2,1
184258,3,24,7,17,14,1
228729,4,26,30,-4,17,0
105769,1,0,0,0,14,0
23021,2,0,14,-14,11,1
396396,2,20,12,8,6,1
262770,3,28,17,11,15,1
371844,2,14,10,4,12,0
202490,4,9,16,-7,5,0
278834,4,14,21,-7,5,0
96304,2,0,16,-16,10,1
304931,2,7,3,4,16,0
383084,2,20,7,13,17,1
229102,2,13,7,6,17,1
112316,4,45,17,28,17,1
81339,1,0,7,-7,3,1
256709,2,0,3,-3,12,0
72640,2,13,0,13,16,0
125179,3,17,7,10,5,1
284362,4,14,17,-3,7,1
79357,4,32,3,29,2,1
349980,1,3,0,3,2,0
157832,1,0,9,-9,3,1
314530,4,24,7,17,3,0
218730,2,0,10,-10,13,0
71062,3,27,0,27,16,1
124469,4,16,14,2,5,0
119411,2,0,14,-14,3,0
174009,1,0,6,-6,10,0
283485,4,23,14,9,7,0
122412,2,0,20,-20,4,0
240282,2,7,7,0,5,0
272625,4,19,9,10,2,0
202429,2,3,9,-6,5,0
262004,3,23,17,6,14,1
266651,2,16,3,13,16,1
408586,2,14,0,14,12,0
274601,4,24,26,-2,3,1
403206,3,17,17,0,9,1
118916,1,0,0,0,3,0
116244,1,10,0,10,1,0
109610,4,25,14,11,16,1
305095,2,21,10,11,16,0
157589,3,5,0,5,2,1
175344,1,7,0,7,11,0
227205,4,16,17,-1,16,1
290170,1,3,0,3,10,1
354062,2,13,0,13,4,1
264788,3,17,23,-6,16,1
239354,1,0,7,-7,4,1
259302,2,13,13,0,13,0
282422,4,10,26,-16,6,1
187487,1,0,3,-3,16,1
17549,3,13,3,10,9,0
122735,3,7,17,-10,4,1
43314,1,7,7,0,3,1
5620,1,0,7,-7,3,0
19743,3,9,9,0,10,0
315857,4,9,19,-10,4,1
263082,4,10,13,-3,15,1
402999,2,7,21,-14,9,0
208920,3,7,6,1,8,1
202631,3,24,20,4,5,1
132128,3,10,3,7,9,0
138175,2,7,9,-2,11,0
243756,3,17,17,0,6,1
240960,3,21,9,12,5,0
210055,4,17,17,0,8,0
205342,2,20,0,20,6,0
339768,4,24,6,18,15,0
141908,1,0,0,0,13,1
421883,4,14,26,-12,17,1
329055,2,3,7,-4,10,0
208961,4,20,14,6,8,1
4316,1,0,7,-7,2,0
148529,4,24,10,14,16,0
376659,2,3,0,3,14,1
111608,1,0,3,-3,16,1
109299,3,13,3,10,15,0
150657,4,17,22,-5,17,1
80037,3,10,3,7,2,0
181692,2,0,7,-7,13,1
28685,3,3,10,-7,14,0
415132,2,0,21,-21,15,1
129013,4,42,13,29,7,0
2899,4,31,34,-3,2,1
33876,4,9,41,-32,16,1
46557,1,0,0,0,4,0
135888,5,24,24,0,10,0
369886,3,7,9,-2,12,1
104062,1,7,7,0,13,1
201664,3,10,13,-3,5,0
174095,4,8,36,-28,10,1
163891,2,16,10,6,5,1
126100,4,20,9,11,6,1
303033,4,23,19,4,16,1
94880,4,13,13,0,9,1
81470,4,17,16,1,3,0
336596,4,7,0,7,14,0
107775,2,7,13,-6,15,1
270296,4,10,27,-17,1,1
247056,1,0,3,-3,8,0
39635,4,27,6,21,1,1
39852,2,6,0,6,1,0
406239,3,14,24,-10,11,1
404835,4,23,20,3,10,1
217517,4,19,3,16,12,1
247634,4,26,26,0,8,1
51973,1,0,0,0,7,1
404700,4,35,32,3,10,0
349714,2,14,7,7,2,0
66339,2,7,21,-14,14,0
110401,1,7,0,7,16,0
104496,3,14,31,-17,13,1
253371,2,7,14,-7,11,1
271434,2,14,0,14,1,1
332915,3,24,3,21,12,1
251903,4,14,19,-5,10,1
355266,2,14,14,0,4,1
132850,3,3,14,-11,9,1
142852,1,0,0,0,13,1
414731,3,3,17,-14,14,1
411075,4,17,17,0,13,0
375803,3,20,0,20,14,0
64096,4,34,24,10,13,0
404418,1,0,0,0,10,1
10656,3,10,17,-7,5,1
326267,4,17,48,-31,9,0
219418,4,33,34,-1,13,1
341202,2,13,7,6,16,1
366739,3,24,10,14,10,1
209136,4,9,30,-21,8,0
317930,2,7,3,4,5,1
411497,3,13,17,-4,13,0
417059,2,17,0,17,15,1
29552,2,0,13,-13,14,1
281432,1,0,10,-10,6,0
302586,1,0,0,0,15,1
254052,4,14,20,-6,11,0
153650,1,0,0,0,1,0
415617,3,23,13,10,15,0
236189,3,17,16,1,3,0
192796,3,0,15,-15,1,1
320949,1,0,0,0,6,1
101750,4,13,10,3,12,1
304362,3,20,14,6,16,1
360422,2,7,0,7,7,0
5075,2,10,0,10,3,1
286091,3,10,10,0,8,1
201452,2,12,0,12,5,0
144331,1,0,0,0,14,1
219292,1,10,0,10,13,0
250792,2,3,0,3,10,0
189183,2,24,0,24,16,1
326877,4,10,20,-10,9,0
56816,4,17,20,-3,9,1
296086,4,9,14,-5,13,0
314348,3,10,17,-7,3,1
255341,2,14,0,14,12,0
98646,4,14,10,4,11,1
346778,1,0,0,0,1,1
223148,4,43,30,13,14,0
31085,4,13,13,0,15,0
192504,3,14,17,-3,1,0
387349,1,7,0,7,2,1
48660,1,7,0,7,5,0
131199,1,0,3,-3,8,1
317120,1,0,0,0,5,0
190474,1,7,0,7,17,0
359681,1,0,0,0,6,1
74210,2,3,7,-4,17,1
274105,3,20,0,20,3,1
145719,1,0,10,-10,15,0
131350,2,7,10,-3,8,0
5374,2,13,7,6,3,1
377589,4,20,12,8,15,1
421460,1,0,0,0,17,0
70479,3,20,17,3,15,0
138269,1,3,0,3,11,0
144049,1,7,0,7,14,0
42875,1,0,3,-3,3,1
340516,3,0,34,-34,15,0
259728,2,10,7,3,14,1
48725,3,10,19,-9,5,1
395418,4,28,3,25,5,1
384158,3,21,20,1,1,0
197954,1,0,3,-3,3,0
171974,4,14,21,-7,9,1
243559,2,10,7,3,6,0
36561,4,23,27,-4,17,0
332585,2,17,3,14,12,0
420113,1,0,0,0,17,1
340103,4,20,15,5,15,0
264459,4,20,28,-8,15,0
216426,4,24,23,1,12,0
305502,1,6,0,6,17,0
79985,1,7,0,7,2,0
137581,4,20,34,-14,11,1
377680,2,19,7,12,15,0
311972,4,35,17,18,2,0
71364,4,10,20,-10,16,0
180639,3,17,6,11,13,0
352578,3,34,20,14,3,0
238914,1,7,0,7,4,0
327968,2,7,0,7,10,1
393888,3,20,17,3,5,0
117338,2,21,0,21,2,0
122243,2,3,10,-7,4,0
252001,2,14,20,-6,10,1
4146,1,0,0,0,2,0
210794,4,24,10,14,9,0
215925,3,10,14,-4,11,0
88576,1,3,7,-4,6,1
324152,3,3,10,-7,8,1
200485,4,23,18,5,4,1
255880,4,20,14,6,12,0
354382,3,45,3,42,4,0
66861,1,0,7,-7,14,0
406358,2,10,7,3,11,0
257748,4,3,24,-21,13,0
77824,3,14,14,0,1,0
148266,1,0,0,0,16,1
326543,4,44,15,29,9,0
203239,4,10,24,-14,5,1
355073,1,0,6,-6,4,0
368341,4,19,19,0,11,0
115774,4,20,16,4,1,0
287416,1,0,0,0,9,1
154389,1,0,0,0,1,0
177119,3,24,13,11,11,1
188855,2,3,6,-3,16,0
415243,1,0,0,0,15,1
140907,3,17,10,7,13,0
270360,1,0,0,0,1,1
314467,2,7,0,7,3,1
379367,4,10,16,-6,16,1
354316,2,20,3,17,4,1
318354,4,9,22,-13,5,0
272486,1,7,0,7,2,0
98839,1,7,0,7,11,1
61450,4,16,17,-1,11,0
374705,2,0,23,-23,14,0
353200,1,0,0,0,4,0
161667,4,39,24,15,4,0
197553,2,10,0,10,3,0
370077,4,31,20,11,12,0
87059,1,0,0,0,5,1
187325,1,7,0,7,16,0
420236,4,6,13,-7,17,0
275271,2,10,2,8,3,1
239714,3,7,10,-3,4,0
134619,3,24,17,7,10,1
195986,4,7,27,-20,2,0
301402,4,17,16,1,15,0
308085,2,6,13,-7,1,0
337596,2,7,7,0,14,1
353539,2,17,0,17,4,0
329365,3,9,27,-18,10,1
343273,4,22,0,22,16,0
372141,2,9,7,2,13,1
323584,1,0,0,0,8,0
269892,1,0,0,0,1,1
355699,2,7,3,4,5,1
353048,1,0,0,0,3,1
362886,1,0,0,0,8,0
116972,1,0,0,0,2,0
291306,3,21,22,-1,10,1
276952,3,17,17,0,4,0
165077,3,10,24,-14,6,0
415556,2,0,6,-6,15,0
57542,4,24,16,8,10,0
35840,4,10,17,-7,17,0
196820,2,0,10,-10,3,0
290032,2,7,3,4,10,1
12033,4,27,14,13,6,0
385373,1,0,7,-7,1,1
363302,4,27,14,13,8,1
370325,3,14,35,-21,12,0
402140,2,12,0,12,9,1
181789,4,10,17,-7,13,0
82847,4,15,16,-1,3,1
63773,3,14,24,-10,12,1
215704,1,3,0,3,11,0
381708,3,20,24,-4,17,1
190506,2,10,6,4,17,1
295090,2,7,7,0,12,1
375161,3,17,10,7,14,1
316363,1,6,0,6,4,1
120597,3,0,20,-20,3,1
409889,4,30,8,22,12,1
5047,2,7,0,7,3,1
236576,4,16,9,7,3,1
69985,2,21,3,18,15,1
181227,2,0,0,0,13,1
165972,2,10,14,-4,6,1
161058,1,0,0,0,4,1
301539,4,20,24,-4,15,0
417153,1,0,10,-10,16,0
339943,4,33,7,26,15,0
272349,2,14,0,14,2,1
413780,4,27,19,8,14,0
416250,4,10,39,-29,15,1
3386,1,0,0,0,2,0
292477,3,10,9,1,11,0
78150,3,20,3,17,2,0
283705,2,0,0,0,7,1
189848,4,27,17,10,17,1
337054,3,19,0,19,14,1
49909,1,7,0,7,6,1
133584,2,3,7,-4,9,1
279640,1,14,0,14,5,0
388754,2,11,0,11,3,1
175838,2,20,17,3,11,1
312844,3,7,0,7,3,1
275226,4,17,29,-12,3,1
335522,1,0,0,0,13,1
218874,2,21,3,18,13,0
402288,3,13,16,-3,9,1
240942,3,14,9,5,5,0
259812,4,20,20,0,14,1
182804,3,19,10,9,14,1
226721,2,7,6,1,16,1
348740,4,24,17,7,2,1
119705,5,20,19,1,3,0
137366,2,3,7,-4,11,0
363558,3,3,12,-9,8,1
405880,1,7,0,7,11,1
315708,4,10,16,-6,4,1
413615,4,9,24,-15,14,1
400997,4,22,7,15,8,0
351654,2,7,7,0,3,0
381578,4,41,16,25,17,1
308803,1,0,3,-3,1,1
140015,4,28,10,18,12,1
314513,3,21,7,14,3,1
32881,4,12,7,5,15,1
179998,2,7,13,-6,13,1
369852,2,7,0,7,12,0
342465,4,20,3,17,16,0
415437,2,12,3,9,15,1
291047,4,20,20,0,10,1
184015,4,22,10,12,14,1
369749,3,38,30,8,11,1
224052,3,14,6,8,15,0
90696,1,7,0,7,7,0
299252,2,17,0,17,14,0
2939,1,7,7,0,2,0
284865,5,29,33,-4,7,0
405811,4,21,24,-3,10,1
305551,2,6,0,6,17,1
252900,2,6,0,6,11,0
280320,4,16,22,-6,5,1
369842,2,0,0,0,12,1
178893,1,0,0,0,12,0
195822,3,20,14,6,2,1
172866,2,24,10,14,9,0
10570,1,0,0,0,5,1
346877,4,23,13,10,1,1
308560,2,6,9,-3,1,1
53552,2,14,9,5,8,0
124984,2,3,3,0,5,1
363797,2,13,7,6,8,1
366471,4,34,22,12,10,1
319775,2,7,7,0,6,1
165941,1,3,7,-4,6,1
171039,3,17,23,-6,8,0
297129,4,31,6,25,13,0
279796,1,7,3,4,5,1
345105,3,12,3,9,17,1
376548,3,8,6,2,14,1
185841,2,3,3,0,15,1
217686,1,7,0,7,12,1
107481,3,3,17,-14,15,0
383953,2,0,10,-10,1,1
255198,2,10,7,3,12,1
209283,4,34,7,27,8,1
379247,1,0,0,0,16,0
52396,3,9,17,-8,7,1
2208,2,7,0,7,1,1
30949,4,17,24,-7,15,1
271176,3,14,17,-3,1,0
66883,2,0,7,-7,14,1
62747,3,14,0,14,12,0
232719,4,20,3,17,1,1
240546,4,19,16,3,5,0
226713,2,7,6,1,16,1
161779,3,24,6,18,4,0
93293,2,21,3,18,9,0
243095,3,7,9,-2,6,0
202747,3,13,17,-4,5,1
316141,3,24,25,-1,4,0
116464,3,6,13,-7,1,0
138929,2,7,3,4,12,0
94068,3,6,28,-22,9,0
381997,3,0,23,-23,17,0
340938,3,7,10,-3,15,0
45801,4,13,14,-1,4,1
89534,2,0,17,-17,7,1
253255,3,3,7,-4,11,0
10850,4,21,21,0,5,1
127729,1,0,7,-7,6,1
285922,2,23,0,23,8,0
218055,4,21,24,-3,12,1
35955,3,3,7,-4,17,0
145038,3,13,6,7,14,1
235258,3,15,6,9,3,1
151835,4,28,16,12,17,1
71832,1,7,0,7,16,0
374673,1,0,6,-6,14,1
351851,3,27,14,13,3,1
269475,1,3,3,0,1,1
366831,2,0,3,-3,10,1
260041,2,3,7,-4,14,0
30247,1,3,0,3,14,0
117798,2,6,6,0,2,0
178536,4,16,13,3,12,0
206662,1,0,0,0,7,0
10841,4,21,14,7,5,0
393567,2,7,12,-5,5,1
117782,2,3,6,-3,2,1
152364,2,14,3,11,17,1
122844,2,10,3,7,4,1
286917,3,16,13,3,8,1
406613,1,0,0,0,11,0
281834,3,10,0,10,6,1
201102,1,0,0,0,5,1
302775,2,3,13,-10,15,0
107615,2,13,7,6,15,0
410295,3,7,16,-9,13,0
144242,2,9,7,2,14,1
209344,2,7,7,0,8,0
298693,3,13,14,-1,14,1
200605,3,24,14,10,4,1
210208,4,10,21,-11,9,0
345298,4,19,17,2,17,0
216884,3,13,14,-1,12,0
293269,4,26,7,19,11,0
43048,2,3,0,3,3,0
132893,4,6,21,-15,9,1
281242,4,27,19,8,6,0
337294,1,6,7,-1,14,1
379036,2,7,6,1,15,1
231059,4,24,8,16,1,1
318466,3,31,7,24,5,0
328310,2,3,14,-11,10,0
130883,4,23,15,8,8,1
27254,4,22,7,15,13,0
240435,2,0,0,0,5,0
310878,2,3,3,0,2,0
207738,3,24,13,11,7,0
354493,3,27,28,-1,4,0
109397,2,3,10,-7,16,0
171116,1,0,0,0,8,0
303062,1,0,0,0,16,0
406709,4,27,0,27,11,0
298966,2,6,9,-3,14,1
189867,1,0,0,0,17,0
304151,1,0,0,0,16,0
284885,1,0,0,0,7,0
341519,2,3,7,-4,16,1
166907,3,10,6,4,6,1
199278,4,17,38,-21,4,1
150775,4,13,9,4,17,0
147850,2,3,14,-11,15,0
88269,1,7,0,7,6,0
26095,1,0,10,-10,13,0
3834,1,0,0,0,2,0
316320,4,17,19,-2,4,0
228430,1,0,0,0,17,1
133139,2,10,10,0,9,0
173625,3,7,20,-13,10,1
155330,1,10,0,10,2,0
221127,3,0,6,-6,14,0
25319,4,39,14,25,12,1
406918,1,0,6,-6,11,1
193088,2,13,6,7,1,0
18365,4,25,20,5,9,0
53330,4,24,16,8,8,1
204745,2,14,14,0,6,1
88295,2,14,7,7,6,0
355920,4,34,17,17,5,0
315213,3,17,10,7,4,0
103094,3,27,7,20,13,1
99878,1,0,3,-3,12,1
129057,2,14,14,0,7,0
199942,1,3,10,-7,4,1
400345,2,10,3,7,8,0
198225,4,16,9,7,3,0
292315,2,12,10,2,11,1
7426,2,20,3,17,4,0
246445,2,7,0,7,8,1
64268,1,0,3,-3,13,1
409787,1,7,0,7,12,1
382690,3,3,6,-3,17,0
123479,2,0,0,0,4,1
358479,4,38,27,11,6,1
182927,2,0,30,-30,14,1
174597,4,13,21,-8,10,1
208369,3,17,30,-13,8,1
6394,3,3,13,-10,3,0
65428,2,0,14,-14,13,1
318874,3,21,15,6,5,1
65986,1,0,0,0,13,0
158770,2,6,3,3,3,1
86138,3,28,3,25,5,0
22703,1,3,0,3,11,0
24760,4,20,34,-14,12,1
208509,3,44,7,37,8,1
19380,1,0,0,0,10,0
77359,2,7,7,0,1,0
163303,3,13,16,-3,5,0
66716,1,0,3,-3,14,1
250725,1,0,0,0,10,1
248496,4,23,6,17,8,0
297892,1,3,0,3,13,0
333575,4,16,16,0,12,1
417445,1,3,7,-4,16,1
77418,4,20,21,-1,1,1
106439,2,16,0,16,14,1
410838,1,14,3,11,13,1
213104,4,20,3,17,10,0
314977,4,0,20,-20,4,1
246283,1,0,0,0,7,0
128929,2,21,3,18,7,1
157943,4,9,22,-13,3,1
28239,3,17,0,17,13,1
177777,4,13,17,-4,12,0
292568,1,6,6,0,11,0
4106,3,23,28,-5,2,0
397730,2,9,14,-5,7,0
205351,3,20,0,20,6,0
358676,1,7,0,7,6,0
134957,3,7,22,-15,10,0
409751,4,13,9,4,12,1
193300,4,10,23,-13,1,0
84680,1,3,0,3,4,0
68484,2,0,7,-7,14,0
191822,2,10,10,0,1,0
264908,2,17,14,3,16,1
49842,3,21,10,11,6,1
298326,1,0,0,0,14,0
24621,1,0,0,0,12,1
378381,1,7,0,7,15,0
308362,2,0,6,-6,1,1
325221,4,13,26,-13,8,1
193085,2,7,6,1,1,0
55190,1,7,0,7,9,1
29686,1,0,0,0,14,1
218938,4,41,27,14,13,1
123424,1,0,0,0,4,0
181885,3,21,28,-7,13,1
499,2,7,6,1,1,0
287047,3,19,24,-5,8,1
162100,4,42,13,29,4,0
419054,3,7,20,-13,16,1
405722,2,10,0,10,10,0
40969,4,16,27,-11,2,1
112361,1,3,0,3,17,1
8811,3,19,0,19,4,0
55929,1,0,0,0,9,0
164251,4,41,41,0,5,1
301546,4,20,24,-4,15,0
323462,1,0,3,-3,7,0
285697,5,27,27,0,8,0
4099,3,16,28,-12,2,1
401176,4,51,13,38,8,0
136514,4,20,23,-3,11,1
415977,1,0,0,0,15,1
249351,2,10,9,1,9,0
30229,4,13,34,-21,14,1
383736,4,16,27,-11,17,1
23604,2,7,7,0,12,1
24686,3,20,7,13,12,0
69045,4,27,24,3,15,1
50467,4,17,10,7,6,1
409861,3,23,0,23,12,0
156057,4,20,24,-4,2,0
391876,3,13,13,0,4,0
5301,1,0,0,0,3,1
229539,2,17,6,11,17,0
155370,2,10,3,7,2,1
51681,4,41,20,21,7,0
376521,2,6,3,3,14,0
119736,2,10,3,7,3,1
196537,2,10,6,4,2,1
374900,4,14,18,-4,14,1
337864,1,0,0,0,14,1
59788,3,12,10,2,11,0
22310,3,0,3,-3,11,0
92713,2,3,17,-14,8,1
34394,2,14,0,14,16,0
300157,2,21,3,18,14,1
78906,4,17,10,7,2,1
182147,2,19,7,12,13,0
288795,1,3,7,-4,9,0
236982,4,38,7,31,3,1
200922,4,27,7,20,4,1
224987,4,10,22,-12,15,1
43971,3,3,14,-11,3,0
52158,1,0,0,0,7,0
356349,3,24,0,24,5,0
55107,3,23,9,14,8,0
11121,4,17,13,4,5,0
161741,2,17,6,11,4,1
266875,5,20,17,3,16,0
177916,4,21,23,-2,12,1
329084,3,10,7,3,10,1
250617,2,3,0,3,10,1
401358,1,10,0,10,8,0
380778,2,9,14,-5,16,0
158074,3,22,9,13,3,1
57703,4,24,24,0,10,0
129196,2,7,6,1,7,1
211731,4,29,16,13,9,1
223489,2,7,3,4,15,1
97212,2,9,6,3,10,0
134446,2,0,20,-20,10,1
353362,2,3,0,3,4,1
14883,2,7,0,7,7,1
206629,4,10,16,-6,7,0
116056,4,16,7,9,1,0
38319,1,0,0,0,1,0
199302,1,0,0,0,4,0
400911,1,6,7,-1,8,1
33920,2,0,24,-24,16,1
297754,1,0,0,0,13,1
110721,1,3,3,0,16,0
213568,4,10,14,-4,10,0
263849,4,14,24,-10,15,0
44118,3,3,13,-10,3,1
639,2,0,3,-3,1,1
411798,3,0,34,-34,13,0
183279,3,13,20,-7,14,1
112420,3,13,13,0,17,1
78149,3,20,3,17,2,0
62852,2,3,3,0,12,0
245707,2,3,10,-7,7,1
58228,2,0,3,-3,10,1
317320,2,0,0,0,5,0
388919,3,10,20,-10,3,0
395077,3,3,24,-21,5,0
365732,2,10,10,0,9,1
226266,2,9,0,9,16,1
202280,2,6,0,6,5,0
277978,1,0,7,-7,4,1
131660,2,0,22,-22,8,0
288035,1,0,0,0,9,0
306719,2,10,10,0,17,0
98225,1,0,0,0,11,0
215140,1,7,0,7,11,0
255549,4,30,7,23,12,0
414022,3,10,38,-28,14,1
81247,2,10,7,3,3,0
331655,4,31,33,-2,11,1
130488,2,3,3,0,8,1
87811,1,3,0,3,6,1
290660,2,35,10,25,10,0
72527,3,16,17,-1,16,0
225106,4,13,14,-1,15,1
158999,4,27,29,-2,3,0
217567,2,3,9,-6,12,1
174741,4,9,10,-1,10,0
168152,3,16,5,11,7,1
252314,2,0,16,-16,10,0
102309,2,13,10,3,13,1
51171,2,24,3,21,7,0
198242,4,16,9,7,3,1
245617,4,40,13,27,7,0
23255,4,30,13,17,11,1
213732,4,31,17,14,10,1
411803,3,0,34,-34,13,0
312823,2,7,0,7,3,1
307355,3,14,22,-8,17,0
336310,3,17,10,7,13,1
351432,4,20,16,4,3,0
133453,2,14,17,-3,9,1
416273,1,7,3,4,15,1
216962,2,3,3,0,12,1
273927,2,7,6,1,2,0
221264,2,0,19,-19,14,0
191705,3,10,17,-7,17,1
333092,3,17,18,-1,12,1
2224,2,7,7,0,1,1
214259,2,14,10,4,11,0
149946,1,7,3,4,16,1
80411,4,27,16,11,2,1
218864,2,14,3,11,13,1
331701,2,0,13,-13,12,1
350035,2,13,7,6,2,0
294464,1,0,7,-7,12,1
363057,1,0,0,0,8,0
209061,2,3,10,-7,8,1
392124,1,0,13,-13,4,1
287805,3,21,10,11,9,0
106378,4,21,19,2,14,0
93509,4,3,31,-28,9,1
55511,1,10,0,10,9,1
421193,1,3,0,3,17,0
262310,3,10,9,1,15,0
49869,4,21,17,4,6,0
370044,3,24,13,11,12,0
398387,4,3,27,-24,7,0
410960,4,21,29,-8,13,1
339905,3,26,0,26,15,0
340507,3,0,34,-34,15,1
182677,3,3,18,-15,14,0
42167,1,7,0,7,2,0
173064,4,24,12,12,9,1
357030,1,0,0,0,5,1
149120,3,17,17,0,16,0
387264,3,6,10,-4,2,1
45260,1,0,0,0,4,1
332261,1,0,0,0,12,0
122225,1,3,7,-4,4,0
270658,1,3,0,3,1,0
110079,1,0,0,0,16,0
305971,1,0,0,0,17,1
271082,1,0,0,0,1,1
313818,1,0,0,0,3,1
213858,3,48,7,41,10,0
5771,2,14,0,14,3,0
127766,2,7,21,-14,6,1
70692,1,6,3,3,15,1
179991,2,7,6,1,13,0
199241,3,17,21,-4,4,0
357117,3,6,14,-8,5,1
359111,1,7,0,7,6,0
331980,1,0,0,0,12,0
207278,2,0,7,-7,7,0
161663,4,39,24,15,4,0
312032,1,7,0,7,2,0
5065,2,10,0,10,3,1
296100,4,9,17,-8,13,1
295840,1,7,7,0,12,0
113866,2,7,0,7,17,0
284496,3,17,15,2,7,0
16532,3,23,13,10,8,1
163311,3,13,16,-3,5,0
235519,2,0,13,-13,3,1
335799,1,0,0,0,13,1
315976,3,0,21,-21,4,0
125152,2,14,7,7,5,1
332625,3,27,6,21,12,0
407055,1,0,0,0,11,0
98991,1,0,0,0,11,0
15336,2,7,3,4,8,0
126817,2,0,6,-6,6,0
140168,4,10,3,7,12,1
2978,2,10,10,0,2,1
315679,3,10,13,-3,4,0
158095,4,22,9,13,3,1
281266,1,7,3,4,6,1
7126,3,31,21,10,4,1
360467,3,10,0,10,7,1
398512,3,21,16,5,7,1
263245,4,17,23,-6,15,1
187944,2,3,7,-4,16,1
193713,3,3,27,-24,1,1
403743,2,12,9,3,9,0
77744,1,0,0,0,1,1
366553,2,20,7,13,10,1
83244,3,9,7,2,4,0
145045,3,13,6,7,14,1
95168,4,23,27,-4,9,1
356944,2,3,3,0,5,0
251460,1,9,3,6,10,1
178018,3,7,20,-13,12,0
168104,1,6,2,4,7,0
350018,2,13,7,6,2,0
16426,4,24,16,8,8,0
58283,3,20,13,7,10,1
246270,4,27,16,11,7,1
334995,2,16,7,9,13,0
8777,2,6,0,6,4,0
284274,1,3,0,3,7,0
360162,2,10,6,4,7,0
156669,3,6,7,-1,2,0
337915,2,10,0,10,14,1
27493,3,20,7,13,13,0
4987,4,24,17,7,3,0
256203,1,0,0,0,12,1
38342,2,7,6,1,1,1
233440,3,17,10,7,2,0
390275,3,10,13,-3,3,1
404652,3,20,19,1,10,0
370069,4,31,20,11,12,0
387346,1,7,0,7,2,1
284914,2,7,14,-7,7,0
19235,1,0,0,0,10,0
104678,4,7,3,4,14,0
388549,1,7,0,7,3,0
321808,4,21,9,12,7,1
358268,2,0,14,-14,6,1
338589,4,36,38,-2,14,1
419439,2,10,3,7,16,0
66987,1,0,0,0,14,0
380962,3,9,14,-5,16,1
393899,4,20,20,0,5,1
114490,2,17,17,0,1,0
291725,3,0,14,-14,11,0
414547,2,21,3,18,14,0
309383,2,0,0,0,1,0
75067,1,0,0,0,17,0
71785,4,38,33,5,16,1
292916,3,7,0,7,11,1
120825,1,7,14,-7,3,0
346293,4,47,3,44,1,0
310171,3,21,10,11,2,0
414094,2,0,10,-10,14,1
276801,2,17,17,0,4,1
296040,3,3,7,-4,13,1
288301,1,0,0,0,9,0
212681,4,9,31,-22,10,1
323158,1,0,0,0,7,0
199373,2,0,10,-10,4,1
193237,2,3,7,-4,1,0
52005,2,3,7,-4,7,1
223406,3,10,19,-9,15,1
312620,1,0,0,0,3,1
232984,3,10,3,7,2,0
70419,1,14,14,0,15,0
213557,3,10,14,-4,10,1
334877,3,24,10,14,13,1
408297,2,0,0,0,12,0
392790,2,17,3,14,4,0
271435,2,14,0,14,1,1
190151,4,30,3,27,17,1
322438,1,6,0,6,7,0
181907,4,21,35,-14,13,1
270340,5,27,27,0,1,1
207747,3,24,13,11,7,1
393032,1,0,0,0,4,1
40412,1,0,7,-7,2,0
15285,1,0,0,0,8,0
19272,2,7,14,-7,10,0
57913,2,13,10,3,10,0
267749,4,16,34,-18,17,1
228857,4,9,17,-8,17,0
332342,3,16,6,10,12,1
159226,2,14,24,-10,3,1
263704,1,0,0,0,15,0
65700,2,0,16,-16,13,1
130928,2,0,14,-14,8,1
191960,2,0,13,-13,1,1
91019,2,6,0,6,7,1
18034,4,22,28,-6,9,1
172246,3,14,13,1,9,1
121675,2,7,7,0,4,1
369044,4,20,13,7,11,0
313566,2,3,17,-14,3,1
97847,3,7,24,-17,11,0
99110,4,23,7,16,11,0
343012,2,0,0,0,16,1
78874,2,17,0,17,2,0
336102,1,10,0,10,13,0
173700,1,0,0,0,10,1
84815,1,0,0,0,4,0
420270,1,7,0,7,17,1
387765,4,0,37,-37,2,0
4283,4,27,6,21,2,1
202287,3,6,3,3,5,0
131579,4,9,23,-14,8,0
259054,4,3,16,-13,13,1
410909,3,14,15,-1,13,1
275726,2,7,0,7,3,0
162210,3,13,20,-7,4,1
409130,4,3,10,-7,12,0
150296,2,17,7,10,16,1
6025,1,0,6,-6,3,0
312684,3,28,14,14,3,1
132631,1,0,0,0,9,1
68919,1,0,0,0,15,1
99912,2,3,3,0,12,0
98466,3,17,14,3,11,1
282754,1,0,0,0,6,0
284943,3,10,14,-4,7,0
150302,2,17,7,10,16,0
73754,2,3,0,3,17,0
216705,3,24,6,18,12,0
213057,2,17,0,17,10,0
242565,1,3,0,3,6,0
203533,4,31,3,28,6,0
182535,4,35,21,14,14,0
263907,2,9,0,9,15,0
106067,1,0,0,0,14,1
35485,2,21,7,14,17,1
263233,4,17,20,-3,15,0
157826,1,0,9,-9,3,0
65398,1,0,7,-7,13,0
50049,1,0,0,0,6,1
33796,2,0,24,-24,16,1
140861,2,14,0,14,13,1
390086,2,10,7,3,3,0
113702,1,0,10,-10,17,1
266019,1,7,0,7,16,1
143571,5,28,28,0,14,1
254165,3,3,12,-9,11,0
68077,3,3,10,-7,14,0
309527,2,6,0,6,1,1
141103,5,17,17,0,13,0
109603,3,22,14,8,16,0
161232,2,7,3,4,4,1
259482,3,28,10,18,13,1
348829,2,3,14,-11,2,1
347335,4,7,21,-14,1,0
294175,1,0,7,-7,12,0
8072,3,17,7,10,4,0
65879,2,7,7,0,13,0
302267,4,38,13,25,15,0
50913,4,17,24,-7,6,1
364612,4,21,37,-16,9,1
38945,2,23,0,23,1,0
340860,1,0,0,0,15,0
320049,4,49,36,13,6,1
331961,1,0,0,0,12,1
384530,1,0,21,-21,1,1
192919,2,7,7,0,1,0
137541,3,17,17,0,11,0
383622,1,0,7,-7,17,1
122993,2,0,3,-3,4,0
60293,4,23,19,4,11,1
314160,2,7,7,0,3,0
257896,4,16,19,-3,13,0
256891,2,14,10,4,12,0
364299,4,3,29,-26,9,0
100793,2,6,3,3,12,1
259328,3,13,20,-7,13,0
272079,3,10,6,4,2,1
75938,4,32,7,25,1,1
26335,4,19,21,-2,13,1
324651,1,0,0,0,8,0
225418,4,27,38,-11,15,1
152884,2,0,7,-7,1,0
20477,2,0,0,0,10,1
25046,4,24,24,0,12,1
274062,2,10,0,10,3,1
150796,4,20,9,11,17,1
243133,4,7,15,-8,6,1
296598,2,3,0,3,13,0
397386,1,0,3,-3,6,0
9069,3,28,13,15,4,1
317974,3,10,10,0,5,0
257637,1,0,7,-7,13,0
388534,4,3,23,-20,2,0
62466,4,7,13,-6,12,1
311386,4,34,13,21,2,1
80421,4,27,16,11,2,0
103813,2,9,0,9,13,1
75337,4,21,33,-12,17,0
192557,4,27,17,10,1,0
204127,2,3,10,-7,6,1
268313,3,20,3,17,17,1
128355,3,7,3,4,7,1
176988,3,13,6,7,11,1
271831,1,0,0,0,2,0
50784,4,24,21,3,6,1
96046,4,13,7,6,10,1
385830,4,33,3,30,1,0
412580,1,0,0,0,14,1
79953,4,13,23,-10,2,0
69826,2,14,3,11,15,0
335155,3,20,0,20,13,0
81795,1,0,7,-7,3,1
318718,2,10,23,-13,5,1
143740,1,0,0,0,14,0
114027,1,7,0,7,17,0
54139,1,0,0,0,8,1
197870,2,11,7,4,3,0
322883,1,6,0,6,7,0
227534,4,26,24,2,16,1
99506,3,3,10,-7,11,1
334835,2,10,3,7,13,1
5917,2,0,16,-16,3,1
306978,1,7,0,7,17,0
255625,2,0,7,-7,12,1
7974,4,16,27,-11,4,1
354770,2,12,17,-5,4,1
115813,1,0,0,0,1,0
382563,3,0,17,-17,17,1
315265,4,20,16,4,4,0
229338,4,24,34,-10,17,0
188210,1,0,0,0,16,0
354804,3,13,28,-15,4,1
309442,3,7,6,1,1,1
192750,2,0,6,-6,1,0
28497,2,24,0,24,14,0
90911,3,41,7,34,7,1
45855,1,7,0,7,4,0
113032,3,13,13,0,17,0
317100,4,17,17,0,4,1
312061,2,14,7,7,2,1
80524,3,5,10,-5,3,0
107714,1,0,0,0,15,1
400742,4,16,17,-1,8,1
42174,1,7,0,7,2,0
133461,2,14,17,-3,9,1
1842,3,16,7,9,1,1
409214,2,10,3,7,12,1
206360,1,0,0,0,7,1
266079,3,17,3,14,16,0
226724,2,7,6,1,16,0
285145,4,3,0,3,7,1
172285,4,24,20,4,9,1
59270,1,0,0,0,11,1
149047,1,0,7,-7,16,0
150913,3,7,7,0,17,0
18538,1,3,3,0,9,0
407006,4,3,20,-17,11,0
172241,3,14,13,1,9,1
409914,1,0,0,0,12,0
180887,1,0,0,0,13,1
114327,2,7,6,1,1,1
78033,4,12,22,-10,1,0
408637,3,28,3,25,12,0
159511,1,7,0,7,3,0
308268,3,10,16,-6,1,1
21054,4,28,34,-6,10,1
350935,3,6,14,-8,3,1
161041,4,30,7,23,4,1
116553,2,0,0,0,2,1
415790,4,24,24,0,15,1
191597,4,24,24,0,17,0
343726,1,0,0,0,17,1
301229,4,27,17,10,15,0
109323,4,20,3,17,15,0
138516,4,31,30,1,12,1
29513,1,0,0,0,14,1
4771,2,13,0,13,3,1
6978,3,3,7,-4,3,0
395175,2,10,7,3,5,0
204156,3,10,17,-7,6,1
25947,1,3,3,0,13,1
301781,3,0,27,-27,15,1
335489,4,13,12,1,13,0
77389,3,14,14,0,1,0
77108,3,14,17,-3,1,1
197009,3,20,20,0,3,1
138285,1,10,0,10,11,1
353867,2,7,21,-14,4,1
181305,4,3,20,-17,13,0
24312,1,0,0,0,12,0
322043,2,13,0,13,7,0
371429,2,7,7,0,12,0
277612,4,12,21,-9,4,0
393509,1,7,6,1,5,0
168584,3,14,10,4,7,0
285517,1,0,0,0,8,0
148726,1,10,3,7,16,1
150058,4,31,12,19,16,0
104152,4,24,27,-3,13,1
5101,3,13,7,6,3,0
29854,2,6,16,-10,14,1
356605,5,9,9,0,5,1
121966,2,3,7,-4,4,1
295618,4,34,32,2,12,0
225901,2,7,0,7,16,1
98997,1,0,0,0,11,1
31166,2,23,20,3,15,1
100445,1,0,7,-7,12,1
344961,3,10,14,-4,17,0
110580,2,17,7,10,16,1
411084,4,17,17,0,13,1
72756,2,14,0,14,16,1
229953,1,0,3,-3,17,0
390859,3,3,28,-25,3,1
408210,3,13,3,10,12,0
103885,4,26,0,26,13,0
129381,2,16,7,9,7,0
345556,2,7,20,-13,17,0
395802,2,0,7,-7,6,1
57201,3,13,7,6,10,0
408569,1,7,0,7,12,1
106828,4,34,29,5,14,0
120787,4,26,6,20,3,0
370600,3,14,14,0,12,0
416416,1,7,0,7,15,0
52256,4,17,19,-2,7,0
114372,3,34,13,21,1,1
359743,2,24,9,15,6,0
89151,1,0,0,0,7,1
344773,1,0,0,0,17,0
140360,4,17,26,-9,12,0
364958,1,7,0,7,9,0
241989,2,7,0,7,5,0
341307,1,0,3,-3,16,0
158612,2,7,7,0,3,0
52076,3,13,10,3,7,0
316092,2,17,6,11,4,0
399761,2,0,17,-17,8,0
223313,4,6,12,-6,15,0
400529,3,7,11,-4,8,0
228031,2,0,0,0,17,1
411053,3,17,17,0,13,1
293550,3,13,17,-4,11,0
58279,3,17,13,4,10,1
121436,1,0,0,0,4,0
229689,2,10,7,3,17,1
384863,3,6,15,-9,1,1
372677,4,21,17,4,13,0
259618,3,6,3,3,13,0
388563,1,14,0,14,3,0
283305,3,10,9,1,7,0
334245,2,6,7,-1,13,0
373631,1,0,9,-9,13,1
204421,2,7,10,-3,6,1
334178,4,30,14,16,13,0
238659,2,16,14,2,4,0
198432,2,3,3,0,3,0
149242,2,7,6,1,16,0
161472,3,10,3,7,4,0
294982,3,17,14,3,12,1
127201,4,13,16,-3,6,1
94990,3,6,15,-9,9,0
334994,2,16,7,9,13,0
345884,2,3,14,-11,17,0
241970,1,7,0,7,5,0
314455,2,7,0,7,3,0
371493,4,14,24,-10,12,1
59970,3,3,24,-21,11,0
190989,3,12,3,9,17,1
7765,3,30,3,27,4,0
105202,2,7,14,-7,14,0
91283,2,7,0,7,8,1
148507,4,24,3,21,16,0
395013,2,0,14,-14,5,0
385022,4,24,16,8,1,1
68996,3,21,14,7,15,1
234914,1,7,0,7,2,1
154957,4,29,24,5,1,1
308464,4,7,25,-18,1,1
189065,3,21,17,4,16,0
125288,2,3,3,0,5,0
178911,1,3,3,0,12,1
152798,3,7,7,0,17,1
252269,1,0,10,-10,10,1
325275,2,3,3,0,8,0
313707,2,7,3,4,3,1
77591,1,0,0,0,1,0
219174,2,0,3,-3,13,0
102480,3,17,3,14,13,1
64238,4,38,13,25,13,1
411487,3,13,17,-4,13,0
173040,3,21,6,15,9,1
407863,2,6,7,-1,11,1
127812,3,10,28,-18,6,1
109585,3,16,14,2,16,1
54247,4,0,3,-3,8,1
123041,3,7,13,-6,4,1
371571,2,3,0,3,12,0
304683,3,14,7,7,16,0
348294,4,16,46,-30,1,0
348964,2,14,0,14,2,1
222992,4,13,16,-3,14,1
133007,2,9,14,-5,9,0
390679,2,3,3,0,3,0
324359,1,7,0,7,8,0
250303,2,7,7,0,9,1
289320,2,28,17,11,9,0
341311,1,0,3,-3,16,1
200479,4,23,18,5,4,1
142215,5,11,13,-2,13,1
320377,1,7,0,7,6,0
215285,1,0,0,0,11,1
419775,4,17,17,0,17,1
82677,4,12,13,-1,3,1
25043,4,24,24,0,12,0
211374,4,10,10,0,9,0
262146,3,21,6,15,15,0
336770,4,10,10,0,14,0
65721,2,7,16,-9,13,1
368947,1,7,7,0,11,0
226055,1,0,0,0,16,0
161957,4,13,16,-3,4,1
33603,5,17,16,1,16,0
300202,4,28,3,25,14,0
101367,2,6,0,6,12,1
177630,4,24,20,4,11,0
181214,2,0,0,0,13,0
4427,4,14,14,0,2,1
214427,3,7,14,-7,11,1
260018,1,0,0,0,14,0
280661,1,0,3,-3,5,0
170340,4,0,15,-15,8,1
102794,3,10,3,7,13,0
418368,1,0,0,0,16,1
106887,2,9,3,6,14,0
369234,1,7,7,0,11,0
125211,4,31,14,17,5,1
155607,4,30,17,13,2,0
207069,4,38,10,28,7,1
270174,4,34,27,7,1,0
188167,4,17,10,7,16,0
339769,4,24,6,18,15,0
233794,4,13,37,-24,2,1
354995,3,7,19,-12,4,1
253183,1,0,0,0,11,1
26350,4,19,21,-2,13,1
32285,4,27,28,-1,15,1
377274,3,14,6,8,15,1
322293,1,7,0,7,7,1
168411,2,0,3,-3,7,0
30538,1,0,0,0,14,1
17492,1,10,0,10,9,1
135523,2,14,6,8,10,0
251828,2,7,7,0,10,0
33472,1,0,0,0,16,0
246122,1,6,0,6,7,1
353847,2,7,14,-7,4,1
66311,2,0,13,-13,14,0
270230,2,3,21,-18,1,1
244990,3,0,27,-27,7,1
121075,4,11,31,-20,3,0
263165,2,3,14,-11,15,1
214842,1,0,3,-3,11,0
198939,3,13,16,-3,3,0
100312,2,9,7,2,12,0
272828,2,20,0,20,2,1
336006,3,13,18,-5,13,0
101404,3,12,7,5,12,1
333482,2,3,0,3,12,0
162224,3,20,20,0,4,0
178614,2,3,3,0,12,0
121584,4,22,13,9,4,1
66259,4,45,3,42,13,1
269183,1,3,3,0,17,0
84232,1,0,0,0,4,0
299930,4,16,11,5,14,0
278989,3,7,30,-23,5,0
3171,3,13,9,4,2,0
293836,4,24,12,12,12,0
419819,1,0,0,0,17,0
70009,3,24,3,21,15,0
307049,3,17,0,17,17,1
36110,4,44,0,44,17,0
9243,4,10,30,-20,5,0
225862,4,24,24,0,16,1
354230,3,13,10,3,4,1
116564,2,3,0,3,2,0
319453,2,0,3,-3,6,1
248398,1,10,0,10,8,0
124521,1,3,0,3,5,1
96448,2,10,14,-4,10,0
379835,1,0,0,0,16,1
96379,4,9,37,-28,10,0
29195,4,3,26,-23,14,1
340842,4,24,19,5,15,1
381446,4,26,14,12,16,1
162380,3,10,13,-3,4,1
78451,3,17,0,17,2,1
377177,4,16,17,-1,15,0
60807,2,10,10,0,11,0
302335,2,7,3,4,15,1
57041,3,7,20,-13,9,0
213181,2,3,7,-4,10,0
158558,4,13,17,-4,3,0
350436,2,0,6,-6,2,1
157863,2,6,9,-3,3,0
335031,4,16,10,6,13,0
204391,1,7,3,4,6,1
43236,3,24,10,14,3,0
98702,2,21,3,18,11,0
227162,3,10,7,3,16,1
115476,4,39,28,11,1,1
338159,1,7,7,0,14,1
230150,3,3,23,-20,17,0
182172,3,26,7,19,13,1
169618,2,6,0,6,8,1
348419,4,13,20,-7,1,0
119449,3,7,17,-10,3,1
59651,3,21,6,15,11,1
208598,2,6,3,3,8,1
264160,4,27,27,0,15,0
262449,3,7,21,-14,15,0
217613,3,19,9,10,12,0
165640,2,0,0,0,6,0
196668,2,27,0,27,3,1
120931,4,31,31,0,3,0
57771,2,16,3,13,10,0
416956,4,10,10,0,15,1
274423,3,10,17,-7,3,0
20012,2,16,6,10,10,1
167093,4,16,34,-18,7,0
219276,1,7,0,7,13,1
382100,2,21,3,18,17,1
22884,2,0,13,-13,11,1
334585,4,27,24,3,13,1
410282,3,7,13,-6,13,0
28325,1,0,0,0,14,1
403259,1,0,0,0,9,1
318545,2,7,0,7,5,0
373392,3,10,7,3,13,0
81575,3,17,24,-7,3,1
226248,2,6,0,6,16,1
57822,4,19,10,9,10,0
205972,3,6,10,-4,7,1
16063,2,16,0,16,8,1
303930,3,14,24,-10,16,0
176042,3,24,0,24,11,1
153344,4,9,16,-7,1,0
285269,2,14,6,8,7,1
223262,3,3,9,-6,15,0
321295,3,9,19,-10,6,1
36057,2,17,0,17,17,1
254238,1,0,0,0,11,0
109510,1,0,0,0,16,0
324990,2,13,21,-8,8,1
327928,1,0,0,0,10,0
12448,4,13,6,7,6,1
416515,4,28,17,11,15,1
351168,1,7,0,7,3,1
355852,2,13,7,6,5,0
208431,1,7,0,7,8,1
146742,4,22,35,-13,15,1
224853,1,0,0,0,15,0
113125,2,21,0,21,17,1
335445,3,13,9,4,13,1
223939,1,0,0,0,15,0
354273,4,26,24,2,4,1
392240,4,10,16,-6,4,1
67183,2,0,0,0,14,0
106854,1,6,0,6,14,0
199178,1,0,0,0,4,1
387339,1,7,0,7,2,0
50490,4,20,17,3,6,1
67919,3,19,3,16,14,0
66815,4,13,6,7,14,0
36808,3,10,17,-7,17,1
324129,3,0,10,-10,8,1
165328,1,0,0,0,6,1
140803,4,22,30,-8,12,0
183515,2,7,3,4,14,0
74727,4,7,17,-10,17,0
379025,2,7,6,1,15,0
270892,4,19,13,6,1,1
266039,2,10,0,10,16,0
13434,2,3,14,-11,7,1
275258,1,10,0,10,3,0
73961,3,30,0,30,17,0
107989,4,6,20,-14,15,1
381403,3,16,0,16,16,0
208453,2,10,0,10,8,1
354462,2,14,21,-7,4,1
298831,3,21,9,12,14,0
36851,4,24,35,-11,17,1
314429,1,0,0,0,3,1
30969,1,0,0,0,15,1
410674,1,0,3,-3,13,0
281122,1,0,0,0,6,1
123793,2,10,3,7,5,0
157856,2,6,9,-3,3,1
417615,2,14,3,11,16,0
242882,2,14,10,4,6,0
29750,3,34,3,31,14,0
209954,1,0,3,-3,8,1
125939,3,16,13,3,6,0
211458,2,6,7,-1,9,1
331339,4,0,30,-30,11,1
205908,1,3,0,3,7,0
235903,3,7,14,-7,3,1
75641,4,13,6,7,17,1
199350,2,0,3,-3,4,1
389911,2,12,10,2,3,1
302466,2,3,3,0,15,0
23392,4,20,17,3,11,0
13469,3,3,21,-18,7,1
155745,4,20,23,-3,2,1
139036,4,21,19,2,12,1
205060,3,19,17,2,6,0
167603,1,0,0,0,7,1
328323,3,3,17,-14,10,0
127615,2,17,9,8,6,0
416164,2,10,9,1,15,0
361804,3,24,7,17,7,1
73082,3,7,10,-3,16,1
57378,4,14,3,11,10,0
142429,2,7,10,-3,13,1
242730,2,7,7,0,6,0
31510,4,3,17,-14,15,1
421271,3,16,10,6,17,1
332365,4,16,13,3,12,0
315777,2,0,3,-3,4,1
175508,2,0,0,0,11,1
362158,1,0,0,0,8,1
50320,4,13,23,-10,6,1
233805,4,19,37,-18,2,1
64847,2,7,0,7,13,1
215388,4,24,20,4,11,0
83839,2,10,3,7,4,1
173085,4,24,27,-3,9,1
165145,5,24,24,0,6,0
37754,2,7,0,7,1,0
158057,3,15,9,6,3,1
227852,1,7,6,1,16,1
126261,4,28,9,19,6,1
364336,4,9,39,-30,9,1
24006,4,26,6,20,12,0
276032,2,10,3,7,3,1
121125,1,0,0,0,3,0
366828,2,0,3,-3,10,0
212545,1,0,0,0,10,0
62584,2,6,10,-4,12,0
368871,3,24,3,21,11,0
389464,2,10,0,10,3,1
160490,3,20,7,13,4,1
187496,2,3,10,-7,16,1
292281,2,6,7,-1,11,1
68762,1,3,0,3,15,1
23980,4,23,6,17,12,1
411723,1,0,3,-3,13,0
333175,2,0,0,0,12,0
388458,2,3,13,-10,2,0
144816,1,14,0,14,14,0
304628,2,14,7,7,16,1
169849,4,20,17,3,8,0
227766,3,3,14,-11,16,0
37449,1,0,7,-7,17,0
96793,4,7,17,-10,10,1
67287,1,7,0,7,14,1
213658,2,7,14,-7,10,1
187639,1,0,3,-3,16,1
396834,2,17,7,10,6,0
162221,3,20,20,0,4,0
209959,1,0,3,-3,8,1
146964,2,17,0,17,15,0
166506,4,23,24,-1,6,0
398393,4,3,27,-24,7,0
225254,4,17,7,10,15,0
201576,1,0,0,0,5,0
37798,3,7,9,-2,1,1
237465,1,7,0,7,3,1
90037,4,11,21,-10,7,0
54453,1,0,0,0,8,1
140290,2,14,6,8,12,0
5579,4,19,10,9,3,1
240708,1,0,0,0,5,1
92240,2,7,0,7,8,0
280184,4,28,6,22,5,0
189729,1,0,3,-3,17,0
368767,4,21,22,-1,11,0
149640,1,7,0,7,16,0
363008,4,33,26,7,8,1
87882,3,13,12,1,6,0
185808,4,25,3,22,15,0
123811,3,10,3,7,5,1
366077,1,0,0,0,10,0
157359,1,3,0,3,2,0
119947,2,6,17,-11,3,1
242411,1,0,7,-7,6,1
189242,4,46,11,35,16,0
36638,2,10,3,7,17,1
207265,2,0,7,-7,7,1
409040,1,3,6,-3,12,0
241081,2,13,0,13,5,1
135557,3,14,6,8,10,0
194479,3,16,3,13,2,0
147346,1,0,0,0,15,1
297953,2,20,7,13,13,0
336971,1,0,0,0,14,1
341084,3,7,17,-10,15,1
275518,4,26,30,-4,3,0
76775,2,24,0,24,1,1
123501,2,7,0,7,4,0
314080,3,30,14,16,3,0
306597,2,0,20,-20,17,1
382487,1,0,0,0,17,0
418292,2,6,7,-1,16,0
396114,2,17,16,1,6,0
148791,3,13,16,-3,16,0
84207,4,17,10,7,4,0
284678,4,14,27,-13,7,1
141373,3,10,17,-7,13,0
16228,2,3,3,0,8,1
52868,3,14,58,-44,7,1
419413,1,3,0,3,16,0
230944,4,31,10,21,1,1
330530,3,7,7,0,11,1
47473,1,3,0,3,5,0
19558,2,7,7,0,10,0
216015,1,7,9,-2,11,0
47432,5,13,13,0,5,1
321865,2,7,14,-7,7,0
23889,1,3,0,3,12,0
225385,4,24,28,-4,15,0
342608,4,22,20,2,16,0
183908,1,7,3,4,14,1
385306,3,14,20,-6,1,0
56706,2,0,10,-10,9,1
223113,3,34,17,17,14,1
2390,2,14,10,4,2,0
171151,2,3,0,3,8,0
197193,4,27,27,0,3,1
183905,1,7,0,7,14,0
36479,2,3,6,-3,17,0
353899,3,17,28,-11,4,0
138499,4,30,30,0,12,1
283896,3,28,17,11,7,0
124031,1,0,0,0,5,1
397422,2,0,13,-13,6,1
106026,4,24,3,21,14,1
39582,3,20,6,14,1,0
228582,1,7,7,0,17,1
333433,4,23,13,10,12,1
335574,3,9,7,2,13,1
359950,4,30,30,0,6,0
289731,2,0,10,-10,10,1
59430,1,0,7,-7,11,0
250392,4,24,26,-2,9,1
307559,1,0,0,0,17,1
404127,1,6,0,6,10,1
146349,2,3,3,0,15,0
299689,2,17,3,14,14,0
188982,1,0,0,0,16,1
17751,4,24,13,11,9,0
123098,5,21,21,0,4,1
334433,4,17,10,7,13,1
127706,1,0,0,0,6,0
178724,4,11,26,-15,12,0
97108,3,34,6,28,10,1
51625,3,21,19,2,7,0
164539,4,23,17,6,5,1
270926,4,19,20,-1,1,1
300836,1,0,0,0,15,0
129153,4,34,34,0,7,0
202762,3,16,17,-1,5,0
151289,1,7,7,0,17,0
69298,3,16,3,13,15,1
159563,3,17,6,11,3,0
122823,2,10,3,7,4,0
77396,3,14,21,-7,1,1
318567,2,10,0,10,5,0
413735,3,21,16,5,14,0
228726,4,26,30,-4,17,0
275877,2,10,6,4,3,0
173808,4,17,3,14,10,0
206707,2,0,14,-14,7,0
25112,2,10,0,10,12,1
122268,2,6,13,-7,4,0
89369,2,3,13,-10,7,1
352055,1,3,0,3,3,0
154051,4,17,21,-4,1,1
87979,1,3,0,3,6,1
28184,2,3,0,3,13,0
258953,1,0,7,-7,13,1
17564,3,13,10,3,9,0
264359,1,0,0,0,15,0
321531,1,0,0,0,7,0
280037,4,6,20,-14,5,0
357797,1,3,14,-11,6,1
96633,3,3,10,-7,10,1
50620,4,10,6,4,6,0
227787,3,6,14,-8,16,1
198884,1,0,13,-13,3,1
73723,4,20,12,8,17,0
335023,3,16,10,6,13,0
382624,1,0,0,0,17,0
393612,4,7,26,-19,5,0
269235,3,3,6,-3,17,0
165195,1,0,7,-7,6,1
333353,2,17,7,10,12,0
375000,2,21,27,-6,14,1
81237,2,7,7,0,3,1
30364,4,10,20,-10,14,1
367457,4,26,24,2,10,1
111804,2,3,7,-4,17,0
363175,4,24,10,14,8,1
81854,2,0,21,-21,3,1
218436,2,17,14,3,13,0
210130,2,0,0,0,9,1
411556,1,0,10,-10,13,1
258232,1,0,0,0,13,1
155939,1,0,0,0,2,1
361778,2,14,7,7,7,1
154900,2,13,10,3,1,1
412105,4,31,3,28,13,1
374468,4,32,7,25,14,0
407615,4,10,17,-7,11,1
43613,1,0,0,0,3,0
73268,4,14,22,-8,16,0
87292,3,24,17,7,6,1
82932,2,3,9,-6,4,1
88726,1,3,0,3,6,0
54465,1,0,0,0,8,0
123935,2,7,0,7,5,0
169735,1,0,0,0,8,0
103247,3,3,10,-7,13,1
76626,2,10,0,10,1,0
391329,4,24,3,21,4,1
79192,3,17,10,7,2,1
28779,1,0,0,0,14,1
288374,2,7,0,7,9,1
400356,2,17,10,7,8,0
384837,2,6,10,-4,1,1
31432,2,3,0,3,15,0
302512,3,3,10,-7,15,0
211634,2,16,3,13,9,1
396354,1,14,6,8,6,0
298726,4,22,21,1,14,1
186949,3,7,9,-2,15,0
302650,2,17,6,11,15,1
60612,1,0,0,0,11,0
136357,4,18,14,4,11,1
58737,3,10,17,-7,10,1
341407,4,0,13,-13,16,1
160708,4,10,3,7,4,1
343561,4,13,10,3,16,0
244993,3,0,27,-27,7,1
70689,1,0,3,-3,15,1
108866,4,7,17,-10,15,1
270632,1,0,0,0,1,1
340377,3,17,13,4,15,0
66272,1,0,0,0,14,0
398446,1,7,0,7,7,1
383509,2,14,3,11,17,1
301272,1,6,0,6,15,1
129304,4,17,13,4,7,1
359231,5,28,28,0,6,1
147211,1,0,14,-14,15,1
87266,2,17,17,0,6,1
23812,3,17,7,10,12,1
306869,2,0,6,-6,17,0
271959,4,23,26,-3,2,0
260796,2,3,6,-3,14,1
137038,1,7,0,7,11,0
170858,2,7,0,7,8,1
410388,2,0,7,-7,13,1
401701,3,10,14,-4,8,1
91526,4,19,10,9,8,1
22178,3,10,15,-5,11,1
234364,3,17,10,7,2,0
15540,4,23,6,17,8,1
46526,4,40,6,34,4,0
219359,3,23,13,10,13,0
291801,4,9,23,-14,11,1
137103,3,17,6,11,11,1
243175,5,23,22,1,6,0
379262,1,0,3,-3,16,0
307400,4,23,25,-2,17,0
10445,1,3,0,3,5,1
128299,1,0,0,0,7,0
412788,2,14,17,-3,14,1
296529,4,26,3,23,13,0
202455,3,6,10,-4,5,0
263988,4,23,7,16,15,0
148552,1,0,0,0,16,0
67148,2,0,0,0,14,0
132677,2,3,9,-6,9,0
153342,4,8,16,-8,1,1
401353,1,0,0,0,8,1
161024,4,16,7,9,4,1
161926,3,13,9,4,4,0
239532,2,3,0,3,4,0
234563,4,23,20,3,2,0
212950,3,7,7,0,10,1
55177,1,0,0,0,9,1
319301,2,10,9,1,6,0
222267,4,13,27,-14,14,1
220913,1,0,0,0,14,1
304960,3,7,14,-7,16,1
374017,3,10,7,3,13,0
102059,3,21,10,11,12,1
276497,3,16,7,9,4,0
341233,3,16,7,9,16,0
178577,4,16,20,-4,12,1
350274,1,7,0,7,2,1
24343,2,3,0,3,12,0
221786,4,13,21,-8,14,0
230458,4,21,11,10,1,0
112728,2,10,0,10,17,0
250418,1,0,0,0,9,0
401678,2,0,14,-14,8,1
413006,4,16,15,1,14,0
360275,2,0,6,-6,7,0
381289,4,31,20,11,16,0
295772,4,24,16,8,12,0
175724,3,30,6,24,11,1
289890,2,6,3,3,10,1
208956,4,20,14,6,8,0
263733,2,0,0,0,15,0
220407,3,23,14,9,13,0
375674,4,23,20,3,14,0
394154,2,13,10,3,5,1
303059,1,0,0,0,16,0
34536,1,0,0,0,16,0
366007,2,30,14,16,10,0
232340,3,6,12,-6,1,0
198005,2,0,20,-20,3,0
1829,3,16,7,9,1,0
184852,4,24,20,4,15,1
129283,4,17,13,4,7,1
49225,3,17,3,14,6,0
341144,1,0,0,0,16,0
248292,2,17,0,17,8,0
276115,4,34,3,31,3,0
294531,3,17,13,4,12,1
344276,3,14,13,1,17,0
25556,2,17,7,10,12,1
112928,4,19,6,13,17,0
413821,2,14,0,14,14,1
257713,3,3,17,-14,13,0
125869,1,6,10,-4,6,0
359842,1,10,7,3,6,0
184880,1,0,0,0,15,1
241751,4,7,9,-2,5,1
201788,2,13,0,13,5,0
69671,1,0,7,-7,15,0
265161,1,0,0,0,16,0
167097,4,16,34,-18,7,0
377103,2,10,10,0,15,0
178794,2,21,14,7,12,1
85413,4,38,17,21,5,0
9262,1,7,0,7,5,0
167441,1,0,0,0,7,0
130313,2,7,0,7,8,0
297426,4,30,24,6,13,1
367067,4,10,41,-31,10,0
157581,2,5,0,5,2,1
314670,4,14,21,-7,3,1
187815,2,7,10,-3,16,1
267998,3,13,9,4,17,1
690,3,0,17,-17,1,0
358751,4,14,17,-3,6,1
54388,3,24,19,5,8,0
194900,2,7,10,-3,2,0
287693,4,9,13,-4,9,1
198136,2,0,3,-3,3,1
412591,1,0,0,0,14,1
73399,3,30,3,27,17,0
267252,2,10,14,-4,17,1
174647,2,6,0,6,10,1
325714,1,0,0,0,9,0
153933,4,7,12,-5,1,0
281871,4,16,7,9,6,0
316188,4,30,35,-5,4,1
82543,4,17,27,-10,3,0
3346,4,3,6,-3,2,0
371892,3,27,10,17,12,1
40083,4,20,14,6,1,1
304676,3,14,7,7,16,1
237689,3,20,14,6,4,0
9622,2,12,14,-2,5,0
24163,1,0,0,0,12,0
172495,1,0,0,0,9,1
193792,1,0,0,0,1,1
67413,1,7,0,7,14,0
393128,4,24,3,21,4,0
5032,1,0,0,0,3,1
326659,3,16,6,10,9,0
208224,4,3,10,-7,8,1
315115,4,56,14,42,4,0
404519,4,31,27,4,10,0
166619,3,22,20,2,6,1
103661,2,0,7,-7,13,0
115458,4,39,14,25,1,0
419524,4,10,23,-13,16,1
86141,3,28,9,19,5,0
82369,4,13,10,3,3,1
64366,4,27,27,0,13,0
171295,2,0,3,-3,9,1
308813,2,3,3,0,1,0
72136,1,0,0,0,16,0
347922,2,0,14,-14,1,0
177883,3,21,16,5,12,0
180861,5,20,20,0,13,0
186640,3,24,3,21,15,0
403782,3,15,16,-1,9,0
371584,2,10,3,7,12,0
4185,2,7,6,1,2,1
372143,2,9,7,2,13,0
233853,1,7,3,4,2,1
67037,2,7,3,4,14,1
103764,1,0,0,0,13,1
421541,3,10,3,7,17,1
373708,3,13,18,-5,13,0
192612,2,3,7,-4,1,0
313231,4,26,16,10,3,1
160429,1,3,0,3,4,1
56769,3,14,13,1,9,0
347949,3,0,21,-21,1,0
120593,3,0,20,-20,3,1
418854,2,0,10,-10,16,1
351954,2,21,14,7,3,0
319172,3,2,3,-1,5,0
228783,1,3,7,-4,17,0
263182,3,3,17,-14,15,1
358990,2,7,0,7,6,1
304452,1,0,7,-7,16,1
22743,2,3,21,-18,11,1
151736,2,7,3,4,17,0
213119,4,20,6,14,10,1
206059,1,7,3,4,7,1
18057,4,36,28,8,9,0
129550,2,3,17,-14,7,0
291277,2,14,12,2,10,0
148849,4,16,23,-7,16,0
73151,1,0,0,0,16,1
202303,3,13,3,10,5,1
311699,4,12,9,3,2,0
268415,2,14,0,14,17,0
117092,4,7,24,-17,2,0
61274,3,21,14,7,11,0
275911,3,13,12,1,3,0
199276,4,17,38,-21,4,1
60982,2,27,13,14,11,0
389673,3,24,16,8,3,1
399810,4,11,24,-13,8,0
211585,4,42,21,21,9,1
354620,2,3,7,-4,4,1
268848,1,0,0,0,17,0
26288,3,13,21,-8,13,1
300285,2,0,7,-7,14,0
415511,4,23,3,20,15,1
256689,1,0,0,0,12,0
401260,2,7,14,-7,8,1
252248,1,0,7,-7,10,1
160041,3,10,26,-16,3,1
224373,4,19,12,7,15,0
16586,1,0,7,-7,8,1
122082,1,0,7,-7,4,0
70239,1,0,0,0,15,1
8755,2,0,0,0,4,1
363741,4,26,26,0,8,0
102420,1,3,0,3,13,0
256126,3,14,16,-2,12,1
367512,1,7,0,7,10,0
157534,1,0,0,0,2,1
415430,2,12,0,12,15,0
225197,2,3,7,-4,15,1
276869,4,26,20,6,4,0
185370,2,0,3,-3,15,1
376792,2,14,0,14,15,0
303890,2,0,17,-17,16,1
406714,4,27,0,27,11,1
197408,2,13,0,13,3,0
264916,2,17,14,3,16,0
147556,3,9,0,9,15,0
421770,4,31,24,7,17,0
45402,1,7,0,7,4,0
157104,3,10,14,-4,2,0
34330,4,23,9,14,16,0
12332,1,0,0,0,6,1
341346,2,0,10,-10,16,0
56943,4,43,7,36,9,0
130822,3,13,12,1,8,1
252493,3,10,22,-12,10,1
413327,4,20,0,20,14,0
230851,2,6,7,-1,1,1
416858,1,0,0,0,15,1
303879,2,0,14,-14,16,0
275421,2,6,10,-4,3,1
259185,3,14,25,-11,13,0
323644,2,13,0,13,8,0
141719,4,30,21,9,13,0
380252,4,23,16,7,16,0
264904,2,17,14,3,16,1
43507,2,7,3,4,3,1
340999,4,17,20,-3,15,0
152960,3,28,17,11,1,1
209292,1,0,0,0,8,1
207810,4,30,23,7,7,1
367193,4,29,23,6,10,0
149012,4,13,19,-6,16,0
123783,2,10,3,7,5,1
300145,2,14,3,11,14,1
49333,2,7,10,-3,6,0
420811,3,10,10,0,17,0
328579,2,10,7,3,10,0
269376,3,7,17,-10,1,1
251389,3,27,14,13,10,1
244307,1,0,0,0,7,1
88742,1,3,3,0,6,1
202613,3,24,13,11,5,1
80647,3,10,16,-6,3,1
118250,2,9,7,2,2,1
7656,4,34,3,31,4,0
395523,3,21,14,7,6,1
11363,2,17,0,17,6,0
222241,4,13,24,-11,14,0
329799,3,17,20,-3,11,0
54120,4,20,10,10,8,0
69517,1,0,0,0,15,0
163725,2,0,9,-9,5,0
414430,3,7,23,-16,14,0
132170,4,29,6,23,9,0
197770,4,21,17,4,3,1
44386,1,0,0,0,3,1
317843,3,9,10,-1,5,0
256451,3,12,21,-9,12,0
200053,4,24,20,4,4,0
294065,2,7,21,-14,12,0
346604,1,7,0,7,1,1
78950,1,0,0,0,2,1
177877,3,21,16,5,12,0
361795,2,21,7,14,7,1
370589,2,14,14,0,12,0
384689,2,10,20,-10,1,1
190613,1,7,7,0,17,1
312139,4,33,16,17,2,0
154326,3,20,14,6,1,0
198965,3,13,23,-10,3,0
73414,4,30,3,27,17,1
150988,1,0,0,0,17,1
364777,1,0,0,0,9,1
300105,1,7,0,7,14,0
61847,3,13,20,-7,12,0
340993,4,17,20,-3,15,1
395447,1,0,0,0,6,0
14127,1,0,14,-14,7,1
194622,3,21,7,14,2,1
79219,4,23,10,13,2,0
119475,3,14,17,-3,3,0
230869,2,7,10,-3,1,0
313599,3,12,23,-11,3,1
225874,1,7,0,7,16,0
408138,2,3,0,3,12,1
338967,2,13,0,13,15,0
193705,2,3,26,-23,1,0
248501,4,23,13,10,8,1
40853,1,0,3,-3,2,1
1149,4,10,36,-26,1,0
326839,4,10,14,-4,9,0
389553,4,27,17,10,3,0
175202,1,6,0,6,10,1
215606,2,14,3,11,11,1
61288,4,28,14,14,11,1
78140,2,17,3,14,2,0
148281,2,7,0,7,16,1
210765,3,21,10,11,9,1
98557,2,0,7,-7,11,1
25076,1,3,0,3,12,0
248609,2,14,3,11,9,0
402393,2,7,7,0,9,0
30807,1,0,0,0,15,1
112821,1,0,0,0,17,0
163616,3,14,19,-5,5,1
226917,3,3,10,-7,16,0
298803,2,14,6,8,14,0
313274,2,6,7,-1,3,0
404994,4,9,20,-11,10,0
30977,1,0,0,0,15,0
296751,2,0,0,0,13,1
63486,3,28,13,15,12,1
191002,4,19,3,16,17,0
273866,1,0,0,0,2,1
80047,3,17,3,14,2,0
110115,2,0,10,-10,16,1
270645,1,0,0,0,1,1
138364,4,32,7,25,11,0
185451,4,17,13,4,15,1
179632,4,31,30,1,12,1
191346,1,0,14,-14,17,0
342224,1,3,0,3,16,1
335872,3,21,14,7,13,1
338191,2,7,21,-14,14,1
210343,4,16,17,-1,9,1
197924,4,18,7,11,3,0
120293,4,23,13,10,3,1
95446,3,31,7,24,10,1
371205,3,14,19,-5,12,0
165141,4,24,24,0,6,1
387592,4,6,3,3,2,0
323800,2,6,9,-3,8,1
231825,4,33,20,13,1,0
10320,2,7,14,-7,5,1
53561,3,14,12,2,8,1
134664,4,34,24,10,10,1
210784,4,24,10,14,9,1
155804,1,7,3,4,2,1
351139,5,37,37,0,3,0
129373,2,16,7,9,7,1
321760,3,12,6,6,7,0
95696,3,10,9,1,10,0
276753,1,14,0,14,4,0
30066,4,46,7,39,14,0
117966,2,10,6,4,2,1
67046,3,10,6,4,14,1
200414,2,10,18,-8,4,1
283446,3,20,13,7,7,0
112801,4,34,10,24,17,0
171186,3,3,7,-4,8,1
255803,2,17,0,17,12,0
55077,2,13,3,10,8,1
100004,1,0,0,0,12,1
166254,2,0,3,-3,6,0
285093,3,3,0,3,7,0
286249,2,6,13,-7,8,1
280434,3,16,24,-8,5,1
199782,1,3,3,0,4,1
353458,4,25,12,13,4,1
355240,2,3,14,-11,4,1
243392,1,3,10,-7,6,1
345041,1,0,0,0,17,0
362789,2,7,14,-7,8,0
377335,4,24,14,10,15,0
114477,2,10,10,0,1,0
370918,4,20,17,3,12,0
370627,3,14,14,0,12,0
380900,1,0,0,0,16,1
322280,1,7,0,7,7,0
48707,2,7,19,-12,5,1
373360,2,7,7,0,13,1
151764,2,14,6,8,17,1
347064,1,0,0,0,1,1
109733,3,13,0,13,16,0
17408,4,17,0,17,9,0
118461,4,26,10,16,2,1
115729,3,13,13,0,1,1
179555,2,0,23,-23,12,1
147210,1,0,14,-14,15,1
287697,4,9,13,-4,9,1
322780,2,3,20,-17,7,0
168534,1,0,3,-3,7,1
339171,4,23,13,10,15,0
280410,2,6,10,-4,5,1
171977,4,20,21,-1,9,1
363642,1,0,7,-7,8,1
384373,1,0,0,0,1,1
263194,3,10,17,-7,15,0
236299,2,0,9,-9,3,0
119548,1,7,0,7,3,0
102431,2,3,0,3,13,0
270727,3,6,3,3,1,1
384657,1,0,10,-10,1,0
279040,1,0,0,0,5,1
382183,1,0,0,0,17,0
124845,2,0,6,-6,5,0
393183,1,0,3,-3,5,0
201389,4,28,22,6,5,0
346566,4,24,47,-23,1,1
215289,1,7,0,7,11,0
33294,4,23,3,20,16,0
297540,3,14,0,14,13,0
119024,4,7,26,-19,3,0
6253,3,13,14,-1,3,1
137652,1,0,0,0,11,1
1688,3,14,0,14,1,1
87619,4,17,13,4,6,1
35304,2,12,0,12,16,1
362733,4,6,20,-14,8,1
226947,4,3,20,-17,16,1
367544,2,14,6,8,10,1
150784,4,20,9,11,17,0
366590,4,20,14,6,10,0
329464,2,3,0,3,10,0
220703,3,10,6,4,13,1
296346,3,6,19,-13,13,1
367554,2,14,9,5,10,1
170184,4,24,27,-3,8,0
213221,3,10,13,-3,10,0
231326,3,9,10,-1,1,0
224598,2,6,7,-1,15,1
139300,3,20,13,7,12,1
249532,2,14,3,11,9,0
267500,2,6,14,-8,17,0
226867,2,0,7,-7,16,0
409312,4,16,16,0,12,0
241632,4,6,30,-24,5,1
17557,3,13,10,3,9,0
289276,1,7,14,-7,9,1
241524,2,3,3,0,5,1
10628,2,7,10,-3,5,0
403302,2,6,0,6,9,0
147386,2,7,7,0,15,1
165871,4,6,19,-13,6,1
163578,2,7,16,-9,5,0
221500,4,10,41,-31,14,1
282264,3,19,14,5,6,1
280544,2,13,3,10,5,1
206308,4,10,6,4,7,0
158524,3,10,10,0,3,0
265440,1,0,7,-7,16,1
316821,4,16,7,9,4,0
200990,2,14,0,14,5,1
26994,1,10,0,10,13,0
13415,1,3,14,-11,7,0
412206,3,14,3,11,13,0
384114,2,0,17,-17,1,1
24433,4,16,7,9,12,1
340351,3,17,10,7,15,1
115517,1,0,3,-3,1,0
365699,1,7,3,4,9,1
158640,2,14,7,7,3,0
344752,1,0,0,0,17,0
328367,4,3,37,-34,10,0
292384,4,12,16,-4,11,0
143479,2,14,21,-7,14,1
170354,4,6,15,-9,8,0
387386,2,21,7,14,2,0
269683,3,10,6,4,1,1
310807,4,13,13,0,2,0
155416,3,13,10,3,2,1
97620,1,3,0,3,11,0
351391,3,10,13,-3,3,1
156302,2,10,0,10,2,1
278795,2,7,7,0,5,1
397211,4,13,0,13,6,1
46076,4,21,14,7,4,0
245147,3,17,22,-5,7,1
251090,2,10,14,-4,10,0
6427,4,9,20,-11,3,0
233250,2,0,3,-3,2,0
257949,2,0,7,-7,13,0
97263,4,27,13,14,10,0
66866,1,0,7,-7,14,0
406391,3,17,7,10,11,0
222132,1,0,0,0,14,0
80906,1,6,0,6,3,1
315499,2,0,3,-3,4,1
133807,4,19,16,3,9,0
322785,3,3,20,-17,7,1
125267,1,3,0,3,5,0
112827,1,6,0,6,17,1
128025,1,0,0,0,7,0
353411,3,18,0,18,4,1
223289,4,3,12,-9,15,1
413691,2,14,13,1,14,0
388791,3,14,0,14,3,0
228629,2,10,14,-4,17,1
36251,4,10,27,-17,17,1
343576,1,12,0,12,17,1
34884,3,20,7,13,16,0
57935,3,13,17,-4,10,0
184417,4,24,6,18,14,0
127972,4,23,20,3,6,1
294977,3,17,14,3,12,0
401209,1,0,0,0,8,0
127559,1,0,3,-3,6,1
27529,4,23,12,11,13,1
244277,4,23,7,16,6,1
426,4,38,26,12,1,1
32238,3,21,14,7,15,1
178146,1,0,7,-7,12,0
175386,2,14,3,11,11,1
90340,4,14,26,-12,7,0
65717,2,7,16,-9,13,0
394755,2,14,0,14,5,1
88890,1,9,0,9,6,1
361272,4,21,29,-8,7,0
241430,3,7,35,-28,5,1
277019,4,31,20,11,4,0
37889,2,3,7,-4,1,0
370456,3,13,6,7,12,0
420225,4,3,10,-7,17,0
319872,4,23,10,13,6,0
363036,4,33,34,-1,8,1
19526,1,0,0,0,10,0
226086,2,0,14,-14,16,1
178849,4,27,14,13,12,0
195884,1,0,0,0,2,0
221018,4,21,20,1,14,1
331893,3,0,9,-9,12,1
336230,1,3,0,3,13,0
137046,2,7,0,7,11,0
322125,1,0,0,0,7,0
89061,2,6,6,0,6,0
249896,3,12,20,-8,9,0
165618,1,0,0,0,6,1
109820,2,10,0,10,16,1
283954,1,0,0,0,7,1
345441,3,0,19,-19,17,1
168675,1,7,0,7,7,0
52233,3,7,16,-9,7,0
213474,1,0,0,0,10,0
394971,4,13,20,-7,5,1
128249,4,20,7,13,7,1
15129,4,17,26,-9,7,0
408943,3,17,15,2,12,1
283306,3,10,9,1,7,0
230266,2,15,10,5,17,1
176473,2,0,10,-10,11,1
419168,3,10,6,4,16,0
56071,1,7,0,7,9,0
407351,1,0,0,0,11,1
91256,1,7,0,7,8,0
270077,2,10,10,0,1,1
305436,3,20,3,17,17,0
396465,4,28,25,3,6,0
267505,2,6,14,-8,17,1
398477,2,13,6,7,7,1
254317,3,6,19,-13,11,0
161887,2,13,9,4,4,0
121203,3,21,20,1,3,0
41950,4,24,6,18,2,1
277301,4,0,16,-16,4,1
417072,3,20,0,20,15,1
144633,4,26,22,4,14,1
43975,3,3,14,-11,3,1
232436,1,3,0,3,1,1
66270,1,0,0,0,14,0
344610,1,0,3,-3,17,0
310424,2,14,3,11,2,1
205617,1,7,3,4,7,0
152363,2,14,3,11,17,0
330345,2,7,12,-5,11,0
405422,2,14,10,4,10,1
210279,2,6,0,6,9,0
157650,1,0,0,0,2,0
47231,4,12,9,3,5,1
268254,1,3,0,3,17,0
287857,4,28,20,8,9,1
165667,2,7,7,0,6,0
272367,2,21,0,21,2,1
57993,4,20,20,0,10,0
137907,3,24,8,16,11,0
305847,2,0,14,-14,17,1
390551,3,17,7,10,3,0
378687,1,7,7,0,15,1
9005,1,7,0,7,4,0
88898,1,16,0,16,6,0
152359,2,14,3,11,17,1
407924,4,17,24,-7,11,1
29984,2,14,0,14,14,1
354031,2,13,0,13,4,0
54080,3,10,3,7,8,1
367211,4,29,26,3,10,1
224920,2,0,9,-9,15,1
41997,1,0,0,0,2,1
20553,4,17,0,17,10,0
99027,2,6,0,6,11,0
27950,3,14,10,4,13,0
138971,3,13,6,7,12,1
136004,3,3,10,-7,10,0
396373,2,20,9,11,6,1
108171,1,0,0,0,15,1
111481,1,7,0,7,16,1
301710,1,0,3,-3,15,0
265088,3,13,10,3,16,1
383783,2,3,0,3,1,1
92038,4,27,26,1,8,0
88378,4,24,10,14,6,1
312679,2,28,7,21,3,0
110118,2,7,10,-3,16,0
413963,2,3,7,-4,14,0
334298,4,9,14,-5,13,0
352343,1,7,0,7,3,1
390488,1,7,0,7,3,0
14573,1,0,7,-7,7,1
185734,3,20,3,17,15,0
420705,4,21,19,2,17,0
220361,1,6,0,6,13,0
111682,3,28,10,18,16,0
84435,2,6,7,-1,4,0
285995,4,29,14,15,8,0
100925,2,7,3,4,12,0
255411,4,24,6,18,12,1
69579,3,7,10,-3,15,0
391337,4,24,3,21,4,1
205505,3,14,17,-3,6,1
127992,4,23,27,-4,6,1
208877,2,7,0,7,8,0
360920,3,24,3,21,7,0
175402,2,17,3,14,11,0
77124,4,14,17,-3,1,0
356448,1,0,3,-3,5,0
28553,3,27,7,20,14,0
105698,3,28,3,25,14,0
12352,1,0,0,0,6,0
241941,1,0,0,0,5,0
199585,4,34,17,17,4,1
21724,3,17,14,3,11,1
241512,1,0,3,-3,5,1
187061,2,10,0,10,16,0
341868,3,16,15,1,16,1
34567,2,14,0,14,16,1
28833,2,10,7,3,14,1
311679,4,6,6,0,2,0
57440,1,7,0,7,10,0
390385,3,7,20,-13,3,0
186954,3,7,12,-5,15,1
222469,2,6,7,-1,14,0
179320,4,36,11,25,12,1
240304,2,7,10,-3,5,0
293588,4,27,20,7,11,1
12107,2,7,7,0,6,0
80454,1,2,0,2,3,0
224437,2,6,10,-4,15,1
252144,2,10,10,0,10,1
254500,4,29,13,16,11,1
67682,1,0,0,0,14,0
294073,3,7,21,-14,12,1
242408,1,0,0,0,6,0
244412,4,3,17,-14,7,0
7830,1,0,0,0,4,0
312763,4,31,28,3,3,0
393410,3,28,17,11,5,0
123555,4,16,17,-1,4,1
370027,3,10,13,-3,12,0
13865,2,7,0,7,7,1
65539,1,3,0,3,13,0
140573,1,14,7,7,12,1
384992,3,17,6,11,1,0
30805,1,0,0,0,15,1
284156,2,3,13,-10,7,1
267841,3,26,14,12,17,0
412781,2,14,16,-2,14,0
399779,3,8,24,-16,8,0
31957,4,16,13,3,15,0
9398,1,0,0,0,5,0
268688,1,0,0,0,17,1
258155,3,13,13,0,13,1
125044,4,3,19,-16,5,1
72843,4,38,17,21,16,1
168775,4,16,9,7,7,0
154720,2,3,7,-4,1,0
14834,1,0,0,0,7,1
177947,1,7,0,7,12,0
235716,3,3,17,-14,3,0
65149,2,0,0,0,13,0
113785,4,10,17,-7,17,1
221471,4,3,41,-38,14,1
373157,1,0,0,0,13,0
66398,4,21,30,-9,14,0
208879,2,7,0,7,8,0
266159,1,7,0,7,16,1
38728,4,24,17,7,1,1
333816,3,14,14,0,12,0
138646,2,3,21,-18,12,0
245952,4,21,37,-16,7,0
173643,3,10,20,-10,10,1
262678,1,0,0,0,15,1
57452,1,7,0,7,10,0
127955,3,23,13,10,6,1
12427,3,10,6,4,6,0
270042,1,0,3,-3,1,1
107976,4,6,13,-7,15,0
385643,4,16,24,-8,1,0
383747,4,16,33,-17,17,0
293206,2,16,7,9,11,0
401850,3,7,21,-14,9,1
119596,3,10,9,1,3,0
118188,4,31,27,4,2,1
157021,4,13,13,0,2,1
41567,1,0,0,0,2,0
56402,2,0,21,-21,9,0
358463,4,32,27,5,6,1
100225,3,17,7,10,12,1
327127,2,14,3,11,9,0
62203,4,13,17,-4,12,0
22088,5,24,24,0,11,1
135112,3,31,6,25,10,0
116912,3,14,10,4,2,0
237592,4,38,22,16,3,0
111730,4,37,16,21,16,0
294066,3,7,21,-14,12,1
218228,4,37,3,34,12,1
232495,2,13,3,10,1,1
698,4,0,17,-17,1,1
224603,2,6,7,-1,15,1
59124,4,26,39,-13,10,0
124979,2,3,3,0,5,0
401863,3,14,21,-7,9,0
29742,3,27,3,24,14,0
407439,3,14,10,4,11,1
214268,2,14,10,4,11,1
222359,3,21,3,18,14,0
98633,4,14,7,7,11,0
339376,1,0,3,-3,15,0
380924,2,6,0,6,16,0
127197,4,13,16,-3,6,0
4278,4,27,6,21,2,1
409758,4,13,9,4,12,0
316236,2,0,10,-10,4,0
323972,3,17,13,4,8,0
79570,2,7,0,7,2,0
273178,3,24,0,24,2,0
289968,4,6,9,-3,10,1
313648,4,25,30,-5,3,0
319150,2,2,0,2,5,0
219306,2,13,7,6,13,0
11837,3,34,17,17,6,0
166383,1,3,0,3,6,0
271641,4,23,30,-7,2,1
188289,3,14,13,1,16,1
84483,4,20,10,10,4,0
49903,1,7,0,7,6,0
67257,4,7,3,4,14,1
110567,2,10,7,3,16,1
192334,3,27,17,10,1,0
293551,3,13,17,-4,11,0
124986,2,3,3,0,5,1
138722,4,28,38,-10,12,0
241356,1,0,0,0,5,1
143725,4,19,20,-1,14,0
212800,4,17,21,-4,10,1
84702,2,3,7,-4,4,0
379701,2,3,0,3,16,1
198447,2,10,3,7,3,1
10306,1,7,14,-7,5,0
110624,3,17,10,7,16,1
270718,3,6,3,3,1,1
56340,4,3,33,-30,9,1
127309,2,10,17,-7,6,0
384692,2,10,20,-10,1,1
108436,4,13,28,-15,15,0
342801,4,7,14,-7,16,0
285587,3,13,10,3,8,0
96318,2,0,16,-16,10,0
220061,1,13,0,13,13,0
257604,5,19,23,-4,13,1
248704,1,3,0,3,9,0
368806,1,0,0,0,11,0
3443,2,3,23,-20,2,1
10142,1,0,0,0,5,1
229468,4,13,9,4,17,1
54178,2,0,3,-3,8,1
410083,1,14,7,7,13,1
189557,1,0,0,0,17,1
419419,1,3,3,0,16,0
307848,4,27,28,-1,1,0
233279,2,7,3,4,2,0
336933,4,14,21,-7,14,1
322628,3,3,6,-3,7,0
369045,4,20,13,7,11,0
296081,4,9,14,-5,13,1
240589,2,3,7,-4,5,1
329008,1,0,0,0,10,0
26737,3,6,14,-8,13,1
214224,1,0,3,-3,11,0
212955,3,14,7,7,10,0
231033,3,24,0,24,1,0
40806,4,17,28,-11,2,0
309089,1,9,3,6,1,1
272267,3,9,3,6,2,0
22933,4,3,26,-23,11,1
47112,4,31,17,14,5,1
125062,4,3,32,-29,5,0
231034,3,24,0,24,1,0
376255,3,10,14,-4,14,0
156491,3,0,6,-6,2,0
399234,3,13,19,-6,7,0
375565,1,0,0,0,14,0
294844,3,35,21,14,12,1
250708,4,17,22,-5,10,0
166535,1,0,0,0,6,1
234188,2,10,10,0,2,1
105929,1,0,0,0,14,1
217250,1,0,0,0,12,0
398602,2,0,0,0,7,0
358781,4,20,20,0,6,1
210855,1,0,3,-3,9,0
65787,4,27,25,2,13,0
418380,1,14,0,14,16,0
313158,2,10,13,-3,3,1
73821,3,13,0,13,17,0
17997,3,16,21,-5,9,0
245098,2,14,3,11,7,0
69456,3,24,10,14,15,1
94031,2,6,21,-15,9,1
15014,2,0,13,-13,7,1
188369,2,0,0,0,16,1
129788,4,17,24,-7,7,0
221011,3,20,17,3,14,1
214747,2,3,10,-7,11,1
138668,3,6,28,-22,12,1
242824,4,21,34,-13,6,1
154827,4,27,23,4,1,1
113258,2,7,7,0,17,0
157544,2,0,0,0,2,1
131449,4,20,19,1,8,0
47846,3,10,6,4,5,1
60518,2,27,7,20,11,0
365836,1,7,0,7,9,0
87767,4,6,20,-14,6,1
150351,3,27,7,20,16,1
209895,3,23,16,7,8,1
365603,3,35,24,11,9,1
245632,4,43,20,23,7,0
962,3,0,3,-3,1,0
38660,2,0,0,0,1,1
128911,2,15,3,12,7,0
54473,2,0,7,-7,8,1
283193,4,26,9,17,7,1
304052,2,3,20,-17,16,1
138231,4,10,12,-2,11,0
302944,2,19,6,13,16,1
3438,2,3,16,-13,2,0
11049,2,10,7,3,5,0
102535,4,31,10,21,13,0
207951,4,35,21,14,8,1
3562,2,14,7,7,2,0
353852,2,7,14,-7,4,0
101836,1,3,0,3,12,1
78914,4,17,10,7,2,1
270143,4,24,13,11,1,1
356333,2,17,0,17,5,0
194538,1,0,0,0,2,1
135696,3,17,10,7,10,1
351495,2,0,24,-24,3,0
390159,4,20,35,-15,3,0
97200,2,6,6,0,10,1
345269,3,13,14,-1,17,1
11706,3,20,10,10,6,0
118369,2,6,7,-1,2,0
36973,4,0,32,-32,17,1
247724,3,7,6,1,8,0
121379,3,7,3,4,3,0
209902,3,30,16,14,8,0
124155,4,19,21,-2,5,0
67598,2,0,23,-23,14,0
160257,1,0,0,0,4,1
107250,4,14,31,-17,15,0
419591,2,20,10,10,17,1
1776,1,3,0,3,1,1
130810,3,13,12,1,8,1
332224,4,10,16,-6,12,0
263406,1,0,0,0,15,1
169384,3,6,21,-15,8,1
178170,2,0,7,-7,12,0
227851,1,7,6,1,16,1
268111,2,3,7,-4,17,0
51848,1,6,0,6,7,0
147450,4,23,10,13,15,1
199055,2,0,14,-14,4,1
179295,4,33,3,30,12,0
198747,1,3,0,3,3,0
21525,1,7,7,0,11,1
329240,3,17,13,4,10,1
305763,4,9,10,-1,17,0
290315,1,0,0,0,10,1
415597,3,14,10,4,15,1
217172,3,9,16,-7,12,1
152461,1,10,0,10,17,0
227235,1,0,3,-3,16,0
413880,3,17,6,11,14,0
200014,3,24,17,7,4,1
401890,4,17,28,-11,9,1
345680,2,7,0,7,17,1
144006,4,14,10,4,14,1
118791,1,10,0,10,2,0
254863,1,0,0,0,12,1
97150,4,34,13,21,10,1
310704,1,0,0,0,2,1
413503,1,0,0,0,14,1
365162,3,7,28,-21,9,1
206713,3,0,14,-14,7,1
218396,1,3,7,-4,13,0
228938,2,7,9,-2,17,1
210020,3,7,10,-3,8,1
134866,1,0,0,0,10,1
142748,2,9,10,-1,13,0
402521,1,0,0,0,9,1
398832,4,21,27,-6,7,1
293669,3,10,7,3,12,1
111658,2,14,10,4,16,1
118780,1,10,0,10,2,1
419463,2,10,6,4,16,0
270429,3,10,7,3,1,0
257184,2,0,9,-9,12,1
192479,3,0,17,-17,1,1
84205,4,17,10,7,4,1
71204,3,19,20,-1,16,1
304790,2,0,0,0,16,1
14237,1,0,0,0,7,0
19640,4,17,28,-11,10,1
49302,1,0,3,-3,6,0
290064,3,7,6,1,10,1
234929,1,10,3,7,2,1
300391,4,10,7,3,14,1
303747,2,17,10,7,16,1
193376,2,7,17,-10,1,1
182072,4,17,21,-4,13,0
97226,3,12,6,6,10,0
175841,2,20,17,3,11,0
248095,4,34,20,14,8,0
124710,2,3,3,0,5,0
301890,2,0,13,-13,15,1
281400,1,0,0,0,6,0
64930,4,10,6,4,13,0
299322,4,26,16,10,14,0
134542,1,0,0,0,10,0
410655,1,0,0,0,13,0
95935,1,0,0,0,10,1
328551,1,6,0,6,10,1
55672,2,17,14,3,9,1
339249,2,21,0,21,15,0
392531,3,3,20,-17,4,1
168049,4,6,24,-18,7,0
200824,1,0,0,0,4,1
166195,4,35,19,16,6,0
233076,1,0,0,0,2,1
166813,4,30,16,14,6,0
71580,2,3,14,-11,16,1
255917,1,3,3,0,12,1
263909,2,9,0,9,15,1
290390,3,23,10,13,10,1
77610,1,0,7,-7,1,0
292942,4,10,0,10,11,1
420374,4,20,13,7,17,1
220577,4,10,23,-13,13,0
268988,1,0,0,0,17,0
156658,3,3,7,-4,2,1
153853,2,0,3,-3,1,1
162353,3,10,10,0,4,0
278468,2,22,0,22,4,1
402987,2,7,14,-7,9,0
301642,3,10,6,4,15,1
116045,4,13,7,6,1,0
296530,4,26,3,23,13,1
75446,3,17,7,10,17,1
3537,1,0,0,0,2,0
199713,3,28,7,21,4,0
310674,4,13,36,-23,2,1
74882,4,20,20,0,17,1
376417,4,16,9,7,14,0
241629,4,6,30,-24,5,1
129150,4,34,28,6,7,0
97145,4,34,13,21,10,1
272312,4,12,13,-1,2,1
275196,4,17,16,1,3,0
78574,2,16,7,9,2,0
229147,4,19,7,12,17,1
391118,2,7,17,-10,4,1
172646,1,6,0,6,9,1
312505,2,13,0,13,3,1
390509,2,10,0,10,3,0
252453,2,0,5,-5,10,0
182397,4,24,20,4,14,1
107894,2,0,3,-3,15,0
37360,3,17,0,17,17,0
218555,1,0,14,-14,13,1
102458,2,3,3,0,13,1
166596,2,22,14,8,6,1
80568,4,16,10,6,3,1
407518,1,3,0,3,11,1
16098,3,33,7,26,8,1
287000,2,10,13,-3,8,0
216240,4,17,17,0,12,0
212637,3,7,31,-24,10,1
72608,1,7,0,7,16,0
75748,2,28,16,12,1,1
313381,1,7,0,7,3,0
47531,3,30,6,24,5,1
384965,2,7,6,1,1,1
382934,2,0,13,-13,17,1
371325,3,28,10,18,12,1
123771,2,10,3,7,5,1
104639,3,7,3,4,14,0
254497,4,29,13,16,11,1
204140,3,10,10,0,6,0
115908,4,7,23,-16,1,0
26553,2,10,3,7,13,0
405927,3,14,0,14,11,1
330458,1,0,0,0,11,0
150908,3,7,7,0,17,0
400262,3,17,6,11,8,0
146611,1,0,0,0,15,0
35973,4,6,7,-1,17,1
158366,3,16,17,-1,3,0
158118,4,25,9,16,3,1
383102,3,20,7,13,17,1
263725,1,0,0,0,15,0
396189,4,24,31,-7,6,0
405586,3,14,17,-3,10,0
150277,1,14,7,7,16,1
109668,1,0,0,0,16,1
271362,1,0,0,0,1,0
298746,1,0,0,0,14,0
298982,3,9,9,0,14,0
189894,1,0,7,-7,17,0
47176,2,6,0,6,5,0
358705,2,7,7,0,6,0
222477,2,6,14,-8,14,1
341272,4,23,13,10,16,0
295067,1,0,0,0,12,0
45938,3,17,3,14,4,1
119954,2,6,24,-18,3,1
264527,2,7,13,-6,16,0
51149,2,17,3,14,7,0
361080,3,16,9,7,7,1
210950,4,33,23,10,9,0
241375,2,7,14,-7,5,1
70083,1,0,0,0,15,1
92889,3,27,0,27,8,1
152140,4,20,13,7,17,0
358509,1,0,0,0,6,0
158732,1,0,0,0,3,0
410330,4,7,26,-19,13,1
197400,1,13,0,13,3,0
2739,4,9,7,2,2,1
196556,3,17,6,11,2,0
287877,4,28,23,5,9,1
246590,1,0,3,-3,8,1
60425,4,23,10,13,11,1
41791,3,10,14,-4,2,0
344768,1,0,0,0,17,0
314115,4,33,20,13,3,0
309022,3,0,20,-20,1,1
234399,4,24,10,14,2,0
408362,4,19,7,12,12,0
414575,3,21,9,12,14,0
162111,4,48,13,35,4,1
226944,4,3,20,-17,16,1
291477,4,21,20,1,10,0
186004,2,10,27,-17,15,1
385989,4,27,28,-1,1,1
293264,4,26,7,19,11,0
237922,4,14,27,-13,4,1
81139,3,13,14,-1,3,1
55235,2,7,3,4,9,0
352780,1,7,0,7,3,1
368965,2,7,7,0,11,0
27284,1,7,3,4,13,0
77920,1,3,0,3,1,1
33428,4,20,20,0,16,0
270025,4,22,23,-1,1,1
170120,2,7,10,-3,8,1
133027,3,9,14,-5,9,0
73745,1,3,0,3,17,0
141096,4,14,10,4,13,0
302819,3,9,20,-11,15,1
341796,2,3,3,0,16,0
12510,2,0,14,-14,6,0
415312,3,0,14,-14,15,1
415021,3,10,27,-17,15,1
48800,1,0,0,0,5,1
21386,1,6,7,-1,11,0
240861,1,0,0,0,5,1
50596,3,3,6,-3,6,1
357352,1,0,0,0,5,1
318044,1,0,0,0,5,0
421578,4,16,6,10,17,1
339322,4,38,7,31,15,1
333031,2,3,9,-6,12,0
389235,3,28,7,21,3,0
327057,1,0,0,0,9,1
115870,3,7,16,-9,1,1
389186,2,14,0,14,3,1
133358,4,14,9,5,9,1
153702,2,2,14,-12,1,0
353412,3,18,0,18,4,0
204547,1,0,21,-21,6,1
322574,2,0,3,-3,7,1
408785,3,10,19,-9,12,0
348533,2,28,7,21,2,0
271575,2,7,13,-6,2,0
20881,4,28,16,12,10,0
291688,2,0,3,-3,11,0
215487,3,10,3,7,11,0
233187,4,42,18,24,2,1
86616,4,40,3,37,5,1
277545,2,3,14,-11,4,0
156741,1,7,7,0,2,0
206592,3,10,13,-3,7,0
164540,4,23,17,6,5,1
388985,4,24,27,-3,3,1
419872,2,3,11,-8,17,0
99895,2,0,3,-3,12,1
293201,2,13,7,6,11,1
248193,3,9,10,-1,8,0
247841,2,0,3,-3,8,1
383993,3,3,16,-13,1,1
421572,4,16,6,10,17,0
226282,3,16,0,16,16,0
35867,1,0,0,0,17,1
97208,2,9,6,3,10,1
85861,4,20,16,4,5,0
148692,1,0,0,0,16,1
67288,1,7,0,7,14,1
353085,2,7,16,-9,3,0
307940,2,7,3,4,1,0
3325,3,3,6,-3,2,1
249709,3,21,14,7,9,1
168582,2,14,10,4,7,0
55057,2,13,3,10,8,1
212133,2,3,14,-11,10,1
307770,2,17,7,10,1,0
96910,3,19,7,12,10,1
152922,2,14,14,0,1,1
313620,4,22,30,-8,3,1
110724,1,3,3,0,16,0
125816,4,17,23,-6,5,1
353225,2,7,7,0,4,0
311668,3,6,6,0,2,0
105205,2,7,17,-10,14,0
138592,1,3,0,3,12,1
42798,2,6,21,-15,3,0
89006,4,39,10,29,6,1
185423,3,10,10,0,15,0
76672,3,13,0,13,1,1
230425,3,14,3,11,1,1
310232,1,0,0,0,2,1
352716,3,17,6,11,3,1
16299,4,25,29,-4,8,1
171564,1,0,0,0,9,0
14637,3,17,7,10,7,0
177767,4,13,17,-4,12,1
265168,1,0,3,-3,16,1
336178,4,17,3,14,13,0
196226,2,7,10,-3,2,1
312328,1,7,14,-7,3,0
383114,3,20,14,6,17,1
220161,4,29,13,16,13,1
195590,4,24,7,17,2,0
225252,4,17,7,10,15,0
256037,4,25,12,13,12,1
379034,2,7,6,1,15,1
365731,2,10,10,0,9,1
15247,4,23,7,16,8,0
35464,2,7,7,0,17,0
204239,2,0,7,-7,6,0
292171,3,21,7,14,11,0
197844,2,6,7,-1,3,1
10429,1,0,0,0,5,1
137210,2,7,3,4,11,0
282262,3,19,14,5,6,0
355591,3,24,3,21,5,1
61936,1,0,0,0,12,1
155352,2,10,3,7,2,0
157277,3,13,3,10,2,0
129499,1,0,0,0,7,0
126833,2,10,6,4,6,0
301153,2,10,11,-1,15,1
142263,1,0,0,0,13,1
57712,1,0,0,0,10,1
94500,2,0,0,0,9,1
201177,3,13,21,-8,5,1
148959,3,10,12,-2,16,1
101172,1,0,0,0,12,0
108757,4,44,19,25,15,1
271552,2,7,6,1,2,1
347725,1,0,0,0,1,1
52527,3,10,0,10,7,1
284581,1,7,0,7,7,0
185256,3,24,9,15,15,0
404508,3,21,27,-6,10,1
26232,1,0,7,-7,13,0
153769,4,2,27,-25,1,1
131003,4,10,30,-20,8,1
97844,3,7,24,-17,11,0
306545,1,0,0,0,17,0
352082,2,3,10,-7,3,0
39145,3,20,10,10,1,0
126660,2,0,3,-3,6,1
346967,2,7,3,4,1,1
200161,3,7,31,-24,4,1
201344,3,28,13,15,5,1
171589,1,3,3,0,9,1
102504,3,31,3,28,13,0
88215,4,17,17,0,6,1
405489,4,24,16,8,10,0
44979,2,3,0,3,4,1
318576,2,10,7,3,5,0
25523,2,7,6,1,12,0
400559,3,13,24,-11,8,0
14666,4,27,14,13,7,0
387847,2,10,14,-4,2,0
73512,3,3,31,-28,17,0
402685,1,0,0,0,9,1
100013,1,3,0,3,12,1
387634,1,0,0,0,2,1
71134,1,12,0,12,16,0
421165,4,44,16,28,17,1
63796,4,14,31,-17,12,1
399079,3,10,26,-16,7,1
129027,1,0,0,0,7,0
133063,4,15,14,1,9,1
258723,3,3,20,-17,13,0
93666,1,0,0,0,9,1
415882,3,7,20,-13,15,1
154700,1,0,0,0,1,1
393910,4,20,20,0,5,0
182885,1,0,3,-3,14,0
17588,4,20,17,3,9,0
116037,4,13,7,6,1,1
98100,2,13,0,13,11,1
162041,2,21,13,8,4,0
94519,3,0,10,-10,9,1
216522,3,27,11,16,12,1
131313,1,0,0,0,8,0
268997,1,0,3,-3,17,1
360728,2,16,7,9,7,1
149591,4,17,26,-9,16,0
285460,4,33,8,25,8,1
63810,4,14,34,-20,12,0
184196,1,7,0,7,14,1
132095,2,7,0,7,9,1
237253,3,20,0,20,3,1
330884,4,13,24,-11,11,0
320652,1,6,7,-1,6,1
367407,2,17,14,3,10,0
225184,2,3,7,-4,15,0
379651,4,26,13,13,16,1
178787,2,21,7,14,12,0
375987,4,20,15,5,14,1
138101,4,56,24,32,11,1
23684,4,7,27,-20,12,1
114221,3,3,14,-11,1,1
232554,4,23,24,-1,1,1
302283,4,38,13,25,15,1
232181,2,6,3,3,1,0
364126,3,23,3,20,9,1
96609,3,3,3,0,10,0
140846,2,7,0,7,13,1
378990,1,7,0,7,15,0
101563,3,13,24,-11,12,0
53636,1,0,0,0,8,1
393008,4,12,10,2,4,1
345727,3,7,7,0,17,1
140732,2,12,14,-2,12,1
113421,2,0,7,-7,17,1
18495,4,17,14,3,9,1
296203,3,16,26,-10,13,0
367395,2,10,14,-4,10,0
313614,3,22,23,-1,3,1
313919,4,28,26,2,3,0
364228,2,0,7,-7,9,0
366563,3,20,7,13,10,0
82989,4,13,19,-6,4,1
278827,3,14,21,-7,5,0
9620,2,12,14,-2,5,0
297348,2,3,10,-7,13,1
5082,3,13,7,6,3,1
386241,4,12,17,-5,2,1
167427,1,0,0,0,7,1
35452,2,7,7,0,17,1
20006,2,15,6,9,10,1
351172,1,13,0,13,3,1
146902,4,34,0,34,15,0
105363,2,23,7,16,14,0
278183,3,24,14,10,4,0
264488,1,0,0,0,16,1
389708,4,27,16,11,3,0
150492,4,34,6,28,16,0
238311,1,3,9,-6,4,0
279838,2,7,13,-6,5,1
180552,4,28,25,3,13,0
143931,2,0,3,-3,14,1
172194,2,0,6,-6,9,1
30156,2,10,17,-7,14,1
136939,3,3,13,-10,11,1
128917,2,15,3,12,7,1
91599,1,0,7,-7,8,1
58948,4,20,32,-12,10,1
352850,3,14,10,4,3,1
227836,1,0,0,0,16,0
402691,2,0,0,0,9,1
76583,1,0,0,0,1,1
257021,2,0,13,-13,12,0
92026,4,27,26,1,8,1
170770,4,27,6,21,8,0
83871,3,23,10,13,4,1
8221,3,3,10,-7,4,0
274592,4,24,26,-2,3,0
272799,1,7,0,7,2,0
249380,3,10,15,-5,9,0
268873,2,6,10,-4,17,0
399877,2,0,0,0,8,0
150511,4,41,6,35,16,0
198053,4,3,30,-27,3,1
10540,3,34,0,34,5,0
166896,2,10,3,7,6,0
51662,4,27,20,7,7,1
160621,2,7,0,7,4,1
166243,1,0,3,-3,6,1
379421,2,0,0,0,16,1
202202,4,13,14,-1,5,1
119905,1,6,7,-1,3,1
329562,4,45,21,24,10,1
238459,1,3,0,3,4,1
93797,4,3,19,-16,9,1
329953,3,7,10,-3,11,0
190422,4,7,10,-3,17,0
27501,3,20,9,11,13,1
63779,3,14,24,-10,12,1
401594,4,17,23,-6,8,0
148060,3,7,10,-3,15,1
195109,4,7,29,-22,2,1
305361,2,14,3,11,17,0
229751,4,20,17,3,17,0
55137,4,26,17,9,8,1
378431,2,7,0,7,15,1
128217,3,20,7,13,7,0
389375,3,23,13,10,3,1
122986,2,0,3,-3,4,1
170394,2,14,3,11,8,0
165558,4,3,28,-25,6,1
107525,4,3,23,-20,15,1
200892,3,17,0,17,4,1
91929,2,3,3,0,8,1
5335,2,7,0,7,3,1
262474,3,7,35,-28,15,1
84915,4,41,17,24,4,1
289669,4,13,23,-10,10,1
117592,1,0,7,-7,2,1
170663,1,0,0,0,8,1
275650,3,27,3,24,3,1
28964,2,0,7,-7,14,0
350635,3,13,3,10,2,0
342217,1,3,0,3,16,0
96060,4,13,14,-1,10,1
354699,4,17,17,0,4,1
176482,2,0,10,-10,11,1
68487,2,0,7,-7,14,1
40501,4,7,20,-13,2,1
36290,1,7,0,7,17,0
43999,3,3,28,-25,3,1
1131,4,10,36,-26,1,0
113023,3,13,13,0,17,0
347849,4,16,8,8,1,0
93971,1,0,7,-7,9,0
103024,1,0,0,0,13,0
284104,1,0,0,0,7,0
256817,4,13,19,-6,12,1
230684,2,6,14,-8,1,0
229857,2,13,6,7,17,0
257142,5,24,24,0,12,1
307958,3,7,6,1,1,0
79066,4,13,21,-8,2,1
67221,4,0,3,-3,14,0
341897,4,30,15,15,16,1
305032,1,0,0,0,16,0
343184,2,3,0,3,16,1
271387,1,0,0,0,1,1
356373,3,24,14,10,5,1
14396,1,0,0,0,7,1
55778,1,0,0,0,9,0
147789,1,0,7,-7,15,0
204716,2,7,14,-7,6,1
336382,1,0,3,-3,14,1
20867,4,28,9,19,10,0
364093,2,14,3,11,9,0
223853,3,9,3,6,15,1
255338,2,14,0,14,12,1
47430,5,13,13,0,5,0
48156,3,10,13,-3,5,0
197165,3,27,20,7,3,1
89974,2,2,14,-12,7,0
3339,4,3,6,-3,2,1
293606,1,7,0,7,12,0
32437,4,31,6,25,15,0
359823,1,0,0,0,6,0
273470,2,7,10,-3,2,0
35716,1,3,0,3,17,0
346654,2,14,6,8,1,0
130650,3,7,28,-21,8,0
191133,4,28,20,8,17,0
127700,4,37,26,11,6,0
148856,4,16,23,-7,16,1
412190,2,14,3,11,13,0
55909,1,0,0,0,9,1
418495,4,24,12,12,16,0
280579,3,17,6,11,5,1
341116,4,14,17,-3,15,0
187450,4,41,14,27,16,1
174576,4,13,14,-1,10,0
384549,2,0,28,-28,1,1
359769,3,27,16,11,6,0
225679,4,14,10,4,16,0
43037,2,3,0,3,3,0
187766,1,0,0,0,16,1
213604,1,0,0,0,10,0
124406,2,6,0,6,5,1
384196,4,29,20,9,1,1
237796,1,0,10,-10,4,0
17903,4,24,17,7,9,1
4676,4,20,13,7,2,0
147722,3,17,17,0,15,1
41145,1,0,7,-7,2,1
356416,4,31,20,11,5,0
6764,1,0,0,0,3,1
158821,3,17,3,14,3,1
80424,4,27,16,11,2,0
41194,3,0,7,-7,2,0
167678,2,10,20,-10,7,0
96078,4,16,14,2,10,0
323436,4,23,7,16,7,1
350394,1,0,0,0,2,0
172533,2,0,7,-7,9,0
215576,1,7,0,7,11,1
135895,5,24,24,0,10,1
302268,4,38,13,25,15,0
6066,2,7,7,0,3,1
145425,2,0,14,-14,14,1
413032,4,19,21,-2,14,1
144177,4,30,13,17,14,0
115119,3,3,20,-17,1,0
168036,3,6,17,-11,7,0
345268,3,13,14,-1,17,1
361290,1,0,0,0,7,0
261013,4,10,3,7,14,0
389612,2,10,7,3,3,0
358501,1,0,0,0,6,0
364045,4,6,24,-18,8,0
383184,1,7,0,7,17,0
236560,4,10,9,1,3,0
364906,4,13,23,-10,9,1
408101,4,20,17,3,12,1
182031,3,14,14,0,13,1
350761,3,10,3,7,2,1
194044,3,20,7,13,1,1
291203,1,0,0,0,10,1
343413,1,0,0,0,16,1
35777,3,3,10,-7,17,1
193765,4,10,27,-17,1,1
254575,2,7,7,0,11,0
65804,4,27,33,-6,13,1
176229,4,14,24,-10,11,0
179448,4,13,20,-7,12,1
187143,4,13,0,13,16,1
321294,3,9,19,-10,6,1
183115,3,7,6,1,14,1
228418,4,10,20,-10,17,0
69658,1,0,7,-7,15,1
280927,4,21,10,11,6,1
115772,4,20,16,4,1,0
189536,4,20,7,13,17,0
341308,1,0,3,-3,16,1
261830,2,6,10,-4,14,1
166211,4,35,19,16,6,0
166867,2,6,3,3,6,1
187145,4,16,0,16,16,0
359238,5,28,28,0,6,0
202186,4,13,14,-1,5,0
155425,3,13,10,3,2,1
310632,3,13,30,-17,2,0
371443,2,14,7,7,12,0
4424,4,14,14,0,2,1
176468,2,0,10,-10,11,0
205135,1,7,0,7,6,0
420520,3,3,42,-39,17,1
191412,3,0,31,-31,17,1
72534,3,16,24,-8,16,1
341852,3,13,15,-2,16,1
224644,3,16,10,6,15,0
363715,3,16,13,3,8,1
37331,2,7,0,7,17,1
322332,2,14,7,7,7,1
195677,3,7,10,-3,2,0
327003,3,2,10,-8,9,1
282884,4,23,23,0,6,0
9370,4,31,7,24,5,0
138905,1,0,3,-3,12,0
7458,3,20,6,14,4,1
170981,1,7,0,7,8,0
167635,2,7,13,-6,7,1
224206,4,0,23,-23,15,1
286643,1,0,0,0,8,1
177894,4,21,23,-2,12,1
368296,3,9,6,3,11,0
239542,2,10,0,10,4,1
93537,1,0,0,0,9,1
72177,2,3,10,-7,16,1
297386,3,9,17,-8,13,0
421802,1,0,3,-3,17,0
235127,3,0,10,-10,2,1
397647,4,6,27,-21,7,0
11735,4,30,23,7,6,0
196087,2,6,21,-15,2,1
409182,1,0,0,0,12,1
252203,4,23,24,-1,10,0
182209,4,33,7,26,13,0
361677,3,7,32,-25,7,1
253740,3,17,10,7,11,1
158584,1,0,0,0,3,0
194229,4,18,17,1,1,0
362046,2,14,7,7,8,1
168433,2,0,17,-17,7,1
261227,2,21,0,21,14,1
91050,3,9,0,9,7,0
52067,3,13,10,3,7,1
190446,4,14,13,1,17,1
32841,3,6,7,-1,15,0
56487,4,7,41,-34,9,0
144911,3,20,7,13,14,1
188394,2,3,0,3,16,0
157926,3,9,15,-6,3,1
378510,1,0,0,0,15,1
407868,2,6,7,-1,11,0
165353,2,0,7,-7,6,0
115866,2,7,13,-6,1,0
410455,3,9,20,-11,13,0
130485,2,3,3,0,8,1
83899,4,23,17,6,4,1
399771,3,0,24,-24,8,1
61644,1,0,3,-3,12,1
177805,1,0,3,-3,12,0
153333,4,2,16,-14,1,0
201128,1,6,14,-8,5,1
211673,3,23,3,20,9,1
370887,2,13,10,3,12,1
407919,4,17,24,-7,11,0
15409,4,10,31,-21,8,1
410932,4,14,21,-7,13,0
399199,2,10,13,-3,7,1
333665,2,7,0,7,12,1
295975,1,0,0,0,13,1
79854,1,3,6,-3,2,0
151696,4,37,44,-7,17,0
68760,1,3,0,3,15,0
385713,1,0,0,0,1,1
389961,3,28,25,3,3,1
233452,3,23,10,13,2,0
196808,2,0,7,-7,3,0
95957,1,0,0,0,10,0
311107,4,13,3,10,2,0
292025,3,9,9,0,11,0
126040,2,7,3,4,6,1
391273,2,14,0,14,4,0
186846,4,29,20,9,15,1
338425,4,30,24,6,14,1
103595,1,0,0,0,13,1
303738,2,17,10,7,16,0
267154,4,10,10,0,17,0
321901,3,14,21,-7,7,1
15504,3,16,6,10,8,0
107041,2,17,0,17,15,1
22881,2,0,13,-13,11,0
297858,4,21,16,5,13,0
256156,3,24,22,2,12,1
306992,1,7,0,7,17,0
101233,2,7,7,0,12,0
332825,1,0,0,0,12,1
81945,4,7,36,-29,3,0
126362,3,7,14,-7,6,0
13209,4,22,26,-4,6,0
89027,1,0,0,0,6,0
140840,1,7,0,7,13,0
216997,2,3,3,0,12,1
291582,3,20,3,17,11,1
169024,2,19,14,5,7,0
162212,3,13,20,-7,4,1
288416,3,13,0,13,9,1
55180,1,0,0,0,9,1
326826,3,10,14,-4,9,1
187789,1,7,0,7,16,0
279286,4,19,16,3,5,0
64620,3,20,17,3,13,1
34156,4,10,10,0,16,1
240156,2,13,3,10,5,1
370810,4,26,17,9,12,0
416916,3,3,7,-4,15,1
354364,3,38,3,35,4,1
6710,4,3,23,-20,3,1
265238,3,9,6,3,16,0
100999,4,13,16,-3,12,1
288890,4,13,24,-11,9,1
258645,1,0,0,0,13,0
133712,1,0,0,0,9,0
16806,3,13,24,-11,8,0
109296,3,6,3,3,15,1
56386,1,0,7,-7,9,0
323276,4,7,17,-10,7,0
46955,4,20,36,-16,5,1
10456,1,3,0,3,5,1
334224,1,3,0,3,13,0
93583,2,6,3,3,9,0
263037,3,10,3,7,15,1
89587,4,7,34,-27,7,1
140188,4,13,10,3,12,1
295234,2,14,5,9,12,0
231012,2,10,0,10,1,1
224322,3,16,12,4,15,0
279321,4,29,23,6,5,0
182023,3,14,14,0,13,1
112629,4,38,34,4,17,1
286587,3,17,31,-14,8,0
188879,2,10,7,3,16,0
231092,4,27,14,13,1,1
214280,3,14,10,4,11,1
168261,2,7,7,0,7,1
40692,1,6,7,-1,2,1
258553,2,0,0,0,13,0
96276,1,0,9,-9,10,1
404295,2,0,3,-3,10,0
144199,1,0,7,-7,14,1
28781,1,0,0,0,14,1
189188,2,24,0,24,16,0
337298,1,7,7,0,14,0
49190,2,10,0,10,6,1
111703,4,31,13,18,16,0
185631,4,20,27,-7,15,1
332184,3,3,13,-10,12,1
356164,2,19,0,19,5,0
162405,4,13,27,-14,4,0
229049,1,0,0,0,17,1
84912,4,41,17,24,4,1
301823,4,6,34,-28,15,0
186594,2,17,0,17,15,0
410136,3,17,10,7,13,1
123607,1,0,0,0,4,0
185265,3,24,9,15,15,0
398407,4,9,30,-21,7,1
224428,2,6,10,-4,15,1
193158,4,16,6,10,1,0
140161,3,10,3,7,12,0
50547,2,0,6,-6,6,1
395016,2,0,14,-14,5,1
152804,3,14,7,7,17,0
327455,4,10,27,-17,9,1
358099,2,14,0,14,6,1
33171,1,0,0,0,16,0
89166,1,0,0,0,7,0
258321,4,28,32,-4,13,1
5592,4,26,10,16,3,1
17695,3,14,6,8,9,0
139109,2,9,6,3,12,1
149403,3,6,27,-21,16,1
126126,4,37,9,28,6,0
54705,4,34,36,-2,8,0
55167,4,29,17,12,8,0
33517,2,17,0,17,16,0
240290,2,7,7,0,5,1
210834,1,0,0,0,9,1
110927,3,7,10,-3,16,1
181343,1,7,0,7,13,1
375197,4,17,17,0,14,0
32714,3,7,21,-14,15,1
51169,2,24,3,21,7,0
218746,2,0,13,-13,13,0
91822,3,24,0,24,8,0
300628,3,10,3,7,15,1
207271,2,0,7,-7,7,0
266486,2,0,15,-15,16,1
341926,1,0,0,0,16,0
343307,1,0,10,-10,16,1
114824,3,13,27,-14,1,0
143248,4,10,16,-6,13,1
178869,4,27,21,6,12,1
14669,4,33,14,19,7,0
409887,4,30,8,22,12,1
377812,2,7,0,7,15,1
159518,2,7,3,4,3,1
300422,1,2,0,2,14,0
279731,3,23,6,17,5,1
113717,2,3,10,-7,17,1
336029,4,16,25,-9,13,1
254424,2,19,0,19,11,1
81936,4,7,30,-23,3,0
124401,2,6,0,6,5,1
176444,1,0,7,-7,11,1
187755,4,16,20,-4,16,0
78850,2,7,0,7,2,1
273967,3,7,22,-15,2,1
43687,3,14,10,4,3,0
234505,3,20,20,0,2,1
85031,2,25,16,9,4,0
57799,3,19,10,9,10,1
100588,1,0,0,0,12,1
1579,4,16,13,3,1,0
83724,3,22,20,2,4,0
371254,1,0,0,0,12,0
160290,2,3,0,3,4,1
350510,4,10,19,-9,2,1
190736,4,42,17,25,17,0
60427,4,23,17,6,11,1
389309,2,0,6,-6,3,1
256770,3,10,13,-3,12,0
235877,3,0,14,-14,3,0
24630,1,6,0,6,12,1
340632,2,13,3,10,15,1
145944,3,7,21,-14,15,1
161902,2,13,9,4,4,1
282293,4,28,17,11,6,1
320599,3,31,6,25,6,1
263616,2,14,10,4,15,1
185525,1,3,3,0,15,1
151748,2,7,6,1,17,1
50420,2,7,7,0,6,0
66917,3,12,7,5,14,0
162973,2,6,3,3,5,0
42155,1,0,0,0,2,1
202257,2,3,0,3,5,1
271938,4,23,20,3,2,0
238166,2,3,9,-6,4,0
232992,3,10,10,0,2,1
53896,3,7,13,-6,8,1
251936,1,0,0,0,10,0
286147,4,24,17,7,8,0
403230,4,24,17,7,9,0
328607,2,17,21,-4,10,1
80306,1,7,6,1,2,0
356329,2,17,0,17,5,1
283330,4,10,9,1,7,0
285219,1,0,0,0,7,0
27595,2,7,10,-3,13,1
339841,1,13,0,13,15,1
125006,3,3,3,0,5,0
234646,2,20,17,3,2,0
122726,3,7,17,-10,4,0
70640,4,17,20,-3,15,1
321284,2,9,10,-1,6,0
94176,2,17,7,10,9,0
273721,1,0,0,0,2,1
196642,1,7,0,7,3,1
323755,1,6,3,3,8,0
308619,4,21,16,5,1,1
378555,2,14,6,8,15,0
225255,4,17,7,10,15,1
179961,1,0,6,-6,13,1
14722,2,14,0,14,7,1
354683,4,10,17,-7,4,0
257667,2,0,7,-7,13,0
366686,2,17,10,7,10,1
243694,1,7,3,4,6,1
394691,1,0,0,0,5,1
196752,4,54,13,41,3,1
404455,2,14,7,7,10,0
50633,4,10,9,1,6,1
168852,2,14,3,11,7,1
306029,3,10,10,0,17,1
357326,4,14,22,-8,5,1
125934,3,16,13,3,6,1
239966,2,0,10,-10,5,1
394200,3,26,17,9,5,1
7567,2,7,0,7,4,1
98506,4,31,24,7,11,0
5144,4,19,7,12,3,0
280187,4,28,7,21,5,1
382069,1,7,0,7,17,0
271076,4,35,34,1,1,0
208448,2,10,0,10,8,0
323281,4,7,24,-17,7,1
33076,2,3,7,-4,16,0
8391,4,30,10,20,4,1
311184,2,3,0,3,2,1
300663,4,24,3,21,15,0
16464,1,3,0,3,8,0
338129,4,12,7,5,14,0
41526,4,15,7,8,2,1
120400,2,16,9,7,3,0
66844,1,0,0,0,14,0
53007,4,27,24,3,7,0
327865,3,16,17,-1,10,1
403618,3,24,13,11,9,0
79379,1,0,0,0,2,1
329567,1,0,0,0,11,1
46525,4,40,6,34,4,0
133839,4,19,24,-5,9,0
44707,2,0,9,-9,3,0
108475,1,7,0,7,15,0
192936,2,7,17,-10,1,1
368818,1,7,0,7,11,0
145256,1,7,6,1,14,1
62148,3,7,14,-7,12,1
327456,4,10,27,-17,9,1
303454,3,19,10,9,16,1
296225,4,22,26,-4,13,0
53979,4,37,25,12,8,0
291265,2,7,12,-5,10,1
189951,3,6,7,-1,17,1
35629,2,17,3,14,17,1
288709,3,0,7,-7,9,0
166918,3,13,6,7,6,0
381105,3,24,21,3,16,0
87743,4,6,20,-14,6,1
132486,4,14,31,-17,9,1
242620,3,10,0,10,6,0
106454,2,16,0,16,14,1
227063,4,17,9,8,16,1
238917,1,7,0,7,4,0
288422,4,19,0,19,9,0
184549,3,35,14,21,14,0
237039,1,0,14,-14,3,0
290151,1,3,0,3,10,0
263575,1,0,7,-7,15,1
138490,3,24,27,-3,12,0
24830,2,13,3,10,12,0
405182,4,12,16,-4,10,1
310784,3,6,9,-3,2,0
226924,4,3,10,-7,16,0
412042,2,13,0,13,13,1
327637,1,0,0,0,10,1
282125,3,23,8,15,6,0
375101,1,0,0,0,14,1
234229,4,20,17,3,2,1
20512,3,3,0,3,10,1
17859,3,24,17,7,9,0
7254,2,7,13,-6,4,1
288807,1,3,14,-11,9,0
150984,1,0,0,0,17,0
86236,1,6,10,-4,5,0
18886,3,9,13,-4,9,0
39408,2,3,10,-7,1,1
249960,1,0,3,-3,9,1
97863,4,14,27,-13,11,1
262610,3,23,3,20,15,0
161853,1,13,0,13,4,0
73138,1,0,0,0,16,1
261972,2,14,10,4,14,0
201034,3,27,0,27,5,1
410887,3,14,12,2,13,0
163275,2,6,6,0,5,1
19771,4,9,12,-3,10,1
202123,2,13,3,10,5,0
109231,2,6,0,6,15,1
207790,4,24,16,8,7,1
67195,3,0,3,-3,14,1
341374,3,0,10,-10,16,1
260099,3,6,21,-15,14,1
263167,2,3,14,-11,15,1
282727,4,16,27,-11,6,0
289213,4,20,13,7,9,1
139787,1,0,3,-3,12,1
325734,1,0,7,-7,9,1
418809,1,0,0,0,16,0
364869,3,6,14,-8,9,0
219967,3,6,21,-15,13,1
412995,4,16,12,4,14,0
30088,1,0,0,0,14,1
281549,4,20,16,4,6,0
379148,2,6,3,3,16,0
340217,3,23,31,-8,15,1
259081,1,0,0,0,13,1
266635,2,10,3,7,16,0
249930,4,18,23,-5,9,1
304848,4,6,3,3,16,1
165188,1,0,7,-7,6,1
388376,4,17,20,-3,2,1
18427,2,7,7,0,9,0
156466,2,0,3,-3,2,1
316289,3,10,16,-6,4,1
233644,4,23,41,-18,2,0
7263,3,7,13,-6,4,1
91978,3,13,23,-10,8,1
158469,2,3,7,-4,3,0
125516,4,30,7,23,5,0
314583,1,7,0,7,3,1
55786,2,0,0,0,9,0
107934,3,6,3,3,15,0
401975,2,3,9,-6,9,0
84117,1,7,0,7,4,0
144978,1,0,0,0,14,0
27212,3,19,7,12,13,1
27231,4,19,7,12,13,1
375841,4,20,7,13,14,1
20109,1,3,0,3,10,0
302760,1,3,10,-7,15,1
198365,4,20,14,6,3,0
61100,2,0,7,-7,11,1
315895,4,9,26,-17,4,1
206432,3,10,0,10,7,1
330731,4,6,6,0,11,1
234666,3,23,20,3,2,0
11603,5,20,19,1,6,1
3044,4,20,41,-21,2,1
317265,4,7,16,-9,5,1
207089,4,38,16,22,7,0
190591,4,20,20,0,17,1
24638,1,7,0,7,12,1
402113,2,12,0,12,9,0
113340,4,25,31,-6,17,1
251137,4,10,20,-10,10,0
369290,3,14,14,0,11,0
62493,4,13,16,-3,12,0
306696,1,3,3,0,17,1
355311,4,14,17,-3,4,0
51765,3,3,19,-16,7,1
403958,4,20,24,-4,10,1
92515,1,7,0,7,8,1
150612,3,3,16,-13,17,0
320901,4,3,14,-11,6,0
88564,1,0,0,0,6,1
257647,2,0,7,-7,13,1
167219,3,23,17,6,7,0
360700,1,0,7,-7,7,0
155408,3,13,3,10,2,0
226070,1,0,7,-7,16,0
205903,1,0,0,0,7,1
280094,1,7,0,7,5,1
264941,3,23,17,6,16,0
359516,4,0,21,-21,6,1
158915,2,14,3,11,3,1
378796,4,17,10,7,15,0
374035,4,17,10,7,13,1
13570,2,3,0,3,7,0
307979,3,14,6,8,1,0
168698,2,10,3,7,7,0
62492,4,13,16,-3,12,0
318032,4,17,16,1,5,1
242974,4,27,31,-4,6,1
194911,3,7,10,-3,2,1
279994,2,3,13,-10,5,1
100598,1,0,0,0,12,0
98064,5,24,24,0,11,0
332290,2,0,6,-6,12,1
403370,4,26,3,23,9,0
329338,2,6,20,-14,10,1
324862,2,10,10,0,8,1
96378,4,9,37,-28,10,0
402032,4,3,19,-16,9,0
398360,3,3,20,-17,7,1
35748,2,3,0,3,17,0
419906,3,6,18,-12,17,1
413381,2,0,14,-14,14,0
1454,1,0,0,0,1,1
195491,2,0,0,0,2,0
2624,1,0,0,0,2,0
198535,4,20,12,8,3,1
221715,2,10,0,10,14,1
111226,2,10,3,7,16,1
11860,3,41,17,24,6,1
418405,2,14,0,14,16,0
236825,4,3,9,-6,3,0
353586,3,31,0,31,4,1
357100,2,6,14,-8,5,1
361544,4,13,7,6,7,0
381335,1,6,0,6,16,0
241704,3,7,3,4,5,0
100027,2,3,3,0,12,1
38738,1,0,0,0,1,1
40543,1,7,0,7,2,0
251572,4,16,20,-4,10,1
372826,4,6,0,6,13,1
295672,2,0,0,0,12,1
298863,4,21,9,12,14,0
175422,3,17,20,-3,11,1
246170,2,7,3,4,7,0
71112,1,6,0,6,16,0
193829,2,10,0,10,1,1
235950,4,23,28,-5,3,0
273029,3,6,3,3,2,1
315104,4,47,14,33,4,1
406618,1,0,0,0,11,0
18677,1,0,0,0,9,0
241667,2,0,0,0,5,0
30944,4,17,24,-7,15,0
34619,4,24,7,17,16,0
348605,4,31,23,8,2,1
11154,4,24,27,-3,5,1
75008,4,27,17,10,17,0
10953,3,9,21,-12,5,0
260485,2,10,0,10,14,1
129185,1,7,0,7,7,0
153819,1,0,0,0,1,0
383337,1,0,0,0,17,0
152472,2,10,6,4,17,0
374388,2,9,0,9,14,0
235977,1,7,0,7,3,1
411673,4,34,28,6,13,1
332546,1,0,3,-3,12,1
190453,4,14,13,1,17,1
180421,1,7,7,0,13,1
206772,4,14,27,-13,7,1
364114,2,14,3,11,9,1
35942,3,3,6,-3,17,0
136858,1,0,0,0,11,0
198430,2,3,3,0,3,0
376854,4,21,14,7,15,1
410071,1,14,7,7,13,1
74789,2,6,3,3,17,0
171869,1,0,7,-7,9,1
77638,2,0,7,-7,1,1
25237,1,7,0,7,12,1
101038,1,0,0,0,12,0
267027,1,0,0,0,17,1
239474,4,15,24,-9,4,1
228416,4,10,20,-10,17,0
315345,2,10,9,1,4,0
69821,2,13,3,10,15,1
329546,4,38,14,24,10,1
322213,3,0,20,-20,7,1
405820,5,24,24,0,10,0
205265,1,0,0,0,6,1
262805,4,35,17,18,15,0
275664,4,37,3,34,3,0
33202,1,7,0,7,16,1
216615,1,0,3,-3,12,0
78535,1,3,7,-4,2,0
409395,2,13,3,10,12,0
126085,3,20,3,17,6,0
207931,4,35,21,14,8,1
144889,3,14,7,7,14,1
306701,1,3,3,0,17,1
37982,4,17,14,3,1,0
269031,2,10,3,7,17,0
186027,2,17,34,-17,15,0
105796,1,3,3,0,14,0
201900,1,0,0,0,5,1
345246,2,13,14,-1,17,0
170116,2,7,3,4,8,0
71635,3,3,31,-28,16,1
5203,2,7,10,-3,3,1
290721,4,44,25,19,10,0
387937,1,0,0,0,2,1
377864,3,20,7,13,15,1
359275,1,0,6,-6,6,1
129034,1,0,7,-7,7,1
253956,1,0,0,0,11,0
421641,1,3,7,-4,17,1
401790,1,7,0,7,9,0
393511,1,7,6,1,5,0
155221,2,14,7,7,1,1
92172,4,3,43,-40,8,1
261289,4,38,0,38,14,0
353980,5,34,34,0,4,1
354833,4,23,28,-5,4,0
273531,4,21,28,-7,2,1
264793,3,17,29,-12,16,1
48910,3,12,7,5,5,1
421159,4,44,16,28,17,1
8026,2,10,7,3,4,0
353624,1,0,0,0,4,1
384143,3,7,20,-13,1,1
71049,3,20,0,20,16,0
44314,4,24,20,4,3,0
110416,1,7,0,7,16,1
136533,1,0,10,-10,11,0
11594,5,20,19,1,6,1
371279,1,0,10,-10,12,1
25361,1,3,0,3,12,1
333513,2,13,0,13,12,1
198833,4,13,29,-16,3,1
226797,4,14,20,-6,16,0
309386,2,0,0,0,1,0
229739,3,13,17,-4,17,1
346100,4,10,12,-2,1,1
270914,4,19,20,-1,1,1
134676,4,34,31,3,10,1
180494,3,14,20,-6,13,1
399068,3,10,19,-9,7,0
295605,4,31,32,-1,12,1
296610,2,3,7,-4,13,0
8599,2,0,10,-10,4,0
284019,2,3,3,0,7,0
406433,4,31,7,24,11,1
403825,4,18,30,-12,9,1
420116,1,0,0,0,17,0
189098,4,31,30,1,16,0
241656,1,0,0,0,5,1
85245,4,17,17,0,4,0
227110,1,0,0,0,16,0
231940,4,13,41,-28,1,1
402989,2,7,14,-7,9,0
141593,4,34,18,16,13,0
400236,3,10,6,4,8,0
263830,4,7,24,-17,15,1
399224,3,13,13,0,7,0
132656,1,0,3,-3,9,0
142357,4,7,3,4,13,0
28349,2,3,0,3,14,1
267370,2,0,7,-7,17,1
27191,2,16,7,9,13,1
42839,4,6,37,-31,3,0
73433,4,30,3,27,17,0
56593,3,19,17,2,9,0
388831,4,14,17,-3,3,1
27406,4,27,10,17,13,0
72329,2,0,14,-14,16,1
104013,4,13,13,0,13,1
161190,4,3,36,-33,4,1
72776,2,14,13,1,16,0
394207,3,33,17,16,5,0
401600,4,17,24,-7,8,1
156924,2,7,10,-3,2,0
161515,4,17,6,11,4,0
285362,1,0,0,0,8,0
247265,2,28,14,14,8,0
373402,3,10,10,0,13,0
55088,2,16,3,13,8,0
322303,1,7,0,7,7,1
219391,4,29,20,9,13,1
31093,4,13,16,-3,15,0
136272,2,15,7,8,11,1
147728,4,17,17,0,15,0
324621,4,16,15,1,8,0
52837,3,13,37,-24,7,1
263640,3,20,10,10,15,1
287085,4,26,32,-6,8,1
91879,1,0,0,0,8,0
7744,2,26,3,23,4,1
117359,3,21,3,18,2,0
314478,2,14,0,14,3,0
318644,4,10,13,-3,5,1
362439,1,0,0,0,8,0
196432,3,20,7,13,2,0
42447,1,0,3,-3,3,1
8364,3,23,3,20,4,1
332731,2,21,6,15,12,0
280348,4,19,29,-10,5,0
288651,1,0,7,-7,9,1
201663,3,10,13,-3,5,1
190023,1,7,0,7,17,1
210330,3,16,10,6,9,0
86062,1,6,0,6,5,1
299020,4,16,18,-2,14,0
65298,2,3,21,-18,13,1
68799,2,6,7,-1,15,1
367320,4,6,17,-11,10,0
385839,4,33,3,30,1,1
350295,2,14,0,14,2,0
372703,1,0,0,0,13,1
42068,3,20,10,10,2,1
117250,4,30,24,6,2,1
198950,3,13,23,-10,3,0
232062,3,0,24,-24,1,0
214266,2,14,10,4,11,1
116323,3,24,13,11,1,1
379923,3,21,6,15,16,0
249972,1,0,3,-3,9,1
120547,1,0,6,-6,3,0
404998,4,9,20,-11,10,0
214341,1,0,0,0,11,0
228098,4,3,10,-7,17,1
8035,2,10,7,3,4,1
228028,2,0,0,0,17,1
57441,1,7,0,7,10,1
320400,2,14,0,14,6,1
328672,4,27,38,-11,10,0
400798,2,14,7,7,8,0
16438,1,0,0,0,8,1
400853,4,24,19,5,8,1
46257,4,24,31,-7,4,0
33144,4,10,42,-32,16,1
353221,2,7,7,0,4,0
93972,1,0,7,-7,9,0
127897,2,10,0,10,6,0
42316,1,0,9,-9,2,1
182776,2,10,3,7,14,1
313973,1,0,0,0,3,0
383453,4,16,12,4,17,0
123231,4,19,21,-2,4,0
3952,4,19,14,5,2,1
27142,1,0,7,-7,13,1
200367,1,0,0,0,4,1
239979,2,0,10,-10,5,0
95166,4,23,27,-4,9,1
211363,3,10,10,0,9,1
144854,2,14,0,14,14,1
355817,1,6,0,6,5,0
360332,3,0,20,-20,7,1
201591,1,0,0,0,5,1
397232,4,16,0,16,6,0
43849,4,21,16,5,3,1
129575,3,6,20,-14,7,1
61640,1,0,0,0,12,0
405560,2,0,14,-14,10,1
124118,3,10,21,-11,5,0
209361,2,7,7,0,8,1
300526,4,23,17,6,14,0
260926,2,0,0,0,14,0
96674,1,0,0,0,10,1
414088,1,0,10,-10,14,1
47985,3,3,24,-21,5,0
145778,2,13,10,3,15,1
375960,3,20,12,8,14,0
218710,2,0,7,-7,13,1
325753,2,0,7,-7,9,0
298129,4,3,41,-38,13,1
401885,4,14,28,-14,9,1
161169,4,3,33,-30,4,0
286093,3,10,10,0,8,1
125992,1,0,0,0,6,0
33755,1,0,0,0,16,0
250647,3,3,12,-9,10,0
73175,2,7,0,7,16,0
109630,4,37,14,23,16,0
12996,2,7,7,0,6,0
258029,4,7,35,-28,13,0
296347,4,6,19,-13,13,1
133656,4,10,28,-18,9,1
297081,3,24,0,24,13,0
349084,1,7,0,7,2,0
365978,1,20,7,13,10,0
309492,1,0,0,0,1,1
93241,4,9,27,-18,9,1
104119,2,17,20,-3,13,0
36114,4,44,0,44,17,0
21206,1,0,0,0,11,1
188858,2,3,7,-4,16,1
48639,4,33,27,6,5,0
307488,3,35,13,22,17,1
326799,2,3,14,-11,9,1
124811,1,0,3,-3,5,0
309452,4,14,6,8,1,0
344887,1,0,0,0,17,0
203455,2,13,3,10,6,1
204400,2,7,3,4,6,0
71944,4,22,13,9,16,0
277700,2,7,0,7,4,0
219095,4,45,13,32,13,1
331915,4,6,16,-10,12,0
77869,4,17,31,-14,1,1
373852,3,27,3,24,13,0
66245,4,45,3,42,13,0
13493,4,6,27,-21,7,1
249789,4,35,35,0,9,1
416777,3,10,10,0,15,1
235418,3,28,17,11,3,0
12066,1,7,0,7,6,1
152386,3,28,3,25,17,0
87052,4,14,25,-11,5,1
30671,1,0,0,0,15,1
45468,3,27,14,13,4,0
228965,2,14,9,5,17,1
129257,3,17,13,4,7,0
144061,1,7,0,7,14,1
130042,3,10,27,-17,8,1
327642,1,0,0,0,10,0
12167,4,20,21,-1,6,0
271667,1,0,0,0,2,0
283490,4,23,14,9,7,0
408486,3,7,10,-3,12,1
259608,3,3,3,0,13,0
327368,2,0,7,-7,9,0
309549,2,6,0,6,1,1
111078,2,17,0,17,16,1
240505,3,6,7,-1,5,0
57979,4,13,17,-4,10,0
62061,4,26,10,16,12,1
191641,1,0,3,-3,17,0
179098,2,6,6,0,12,1
348040,2,0,10,-10,1,1
26138,2,0,13,-13,13,1
245705,2,3,10,-7,7,1
118517,2,17,0,17,2,0
231181,3,10,7,3,1,0
413289,3,17,0,17,14,1
187640,1,0,3,-3,16,1
390900,4,15,28,-13,3,0
113512,4,3,7,-4,17,0
335726,3,10,7,3,13,0
40749,2,17,14,3,2,0
149008,4,13,19,-6,16,1
72233,3,23,17,6,16,1
157609,3,12,3,9,2,1
417401,4,16,17,-1,16,1
184175,1,0,0,0,14,1
199672,2,14,7,7,4,0
376688,3,3,0,3,14,1
356530,3,9,3,6,5,0
335947,1,0,9,-9,13,0
55451,4,20,10,10,9,1
322059,2,20,0,20,7,1
393472,4,34,27,7,5,0
43405,4,21,24,-3,3,0
30955,4,17,24,-7,15,1
352411,3,35,10,25,3,1
32716,3,7,21,-14,15,1
332347,3,16,13,3,12,1
148968,3,13,12,1,16,0
245205,4,19,28,-9,7,1
323316,1,0,0,0,7,0
230516,1,3,0,3,1,1
93751,3,3,13,-10,9,0
127350,3,10,20,-10,6,0
170260,2,0,9,-9,8,0
229427,3,10,6,4,17,0
280403,2,6,7,-1,5,0
307473,3,35,13,22,17,1
1485,1,0,6,-6,1,1
225275,1,0,7,-7,15,1
202435,2,3,10,-7,5,1
379760,3,9,17,-8,16,1
221976,1,0,0,0,14,1
61768,1,0,0,0,12,0
252081,1,0,0,0,10,0
143829,4,12,7,5,14,1
85438,1,7,0,7,5,0
35473,2,14,7,7,17,0
168686,2,7,3,4,7,1
179698,1,0,0,0,12,1
321112,2,0,9,-9,6,0
134253,4,3,23,-20,10,1
191257,3,7,17,-10,17,1
59566,1,0,3,-3,11,1
21748,3,24,17,7,11,1
413709,2,14,13,1,14,0
98451,3,17,7,10,11,0
48195,4,10,19,-9,5,0
130913,1,0,7,-7,8,0
84332,4,21,27,-6,4,0
294463,1,0,7,-7,12,1
135122,4,31,6,25,10,1
130981,3,10,27,-17,8,1
391916,4,23,27,-4,4,1
318087,2,9,7,2,5,1
188735,3,0,17,-17,16,1
154936,3,26,10,16,1,0
67688,1,0,0,0,14,1
349449,3,0,20,-20,2,1
131750,4,24,28,-4,8,1
17555,3,13,10,3,9,0
140505,4,21,26,-5,12,0
359798,4,30,33,-3,6,1
192173,3,3,13,-10,1,1
330391,3,10,20,-10,11,0
246038,2,7,13,-6,7,1
137535,2,17,17,0,11,1
144566,2,7,19,-12,14,1
351456,1,0,0,0,3,0
408290,2,0,0,0,12,1
130181,2,0,19,-19,8,0
297599,4,24,7,17,13,0
180514,3,21,20,1,13,0
85942,2,7,14,-7,5,0
261989,2,17,17,0,14,1
156098,1,7,0,7,2,0
359313,2,3,13,-10,6,1
220888,4,28,38,-10,14,0
248918,2,17,0,17,9,0
212234,4,3,24,-21,10,1
212987,4,21,7,14,10,1
374858,3,14,3,11,14,0
410204,1,0,0,0,13,1
172972,1,7,0,7,9,1
48421,3,17,17,0,5,0
20353,3,10,13,-3,10,0
155896,4,17,13,4,2,1
260987,4,10,3,7,14,0
214402,2,7,7,0,11,0
331291,2,0,14,-14,11,1
235031,4,27,17,10,2,1
288165,4,19,14,5,9,1
256315,4,14,17,-3,12,1
322165,2,0,14,-14,7,0
126402,4,20,17,3,6,1
267115,3,10,10,0,17,1
220954,2,7,7,0,14,0
128581,1,0,0,0,7,1
322886,1,6,0,6,7,0
27124,1,0,0,0,13,0
417075,3,20,0,20,15,1
232793,3,13,14,-1,2,1
234495,3,20,20,0,2,1
148380,4,14,6,8,16,1
180864,5,20,20,0,13,0
186445,2,10,10,0,15,1
228743,4,26,33,-7,17,1
404661,4,20,22,-2,10,0
373522,2,0,13,-13,13,1
215614,2,14,3,11,11,0
324347,1,0,0,0,8,1
409616,1,0,0,0,12,1
267822,2,13,14,-1,17,1
321432,2,14,17,-3,7,0
160118,1,7,0,7,3,1
54807,3,10,0,10,8,1
135152,4,31,13,18,10,1
92549,2,10,0,10,8,1
311305,1,0,0,0,2,1
39227,2,3,3,0,1,1
95891,4,20,23,-3,10,0
125995,1,0,0,0,6,1
83662,1,9,3,6,4,0
317092,4,17,17,0,4,1
25055,4,27,24,3,12,1
78963,1,0,0,0,2,1
314343,3,10,17,-7,3,0
372776,3,3,0,3,13,0
210213,4,10,21,-11,9,0
121183,2,14,13,1,3,0
396941,1,0,0,0,6,0
55670,2,17,14,3,9,0
206081,2,20,3,17,7,0
364176,4,34,3,31,9,0
2481,1,0,0,0,2,0
316758,2,10,6,4,4,0
202299,3,13,3,10,5,0
247128,3,20,6,14,8,0
83781,1,0,0,0,4,0
421439,4,31,20,11,17,1
117445,1,7,7,0,2,1
335606,4,19,7,12,13,0
189641,3,10,6,4,17,0
342888,3,16,14,2,16,0
32010,1,0,0,0,15,1
385812,4,30,3,27,1,0
336791,4,10,17,-7,14,1
332899,3,24,0,24,12,0
352378,2,21,7,14,3,1
50251,2,10,14,-4,6,1
190268,3,7,14,-7,17,1
313575,2,12,17,-5,3,0
376691,3,3,0,3,14,0
398358,3,3,13,-10,7,0
124200,1,0,7,-7,5,1
352123,3,9,20,-11,3,0
390515,2,10,7,3,3,1
43988,3,3,20,-17,3,0
234302,2,10,0,10,2,1
358410,2,19,13,6,6,0
169319,1,0,7,-7,8,1
307652,3,14,17,-3,17,1
203342,3,14,27,-13,6,0
343145,1,0,0,0,16,1
373841,2,20,0,20,13,0
50684,1,0,7,-7,6,0
199091,3,7,24,-17,4,1
225658,3,14,10,4,16,1
334123,3,16,7,9,13,0
177523,1,0,0,0,11,1
97605,1,0,0,0,11,0
393723,3,0,7,-7,5,1
257844,3,7,9,-2,13,0
129145,4,34,28,6,7,1
265053,2,10,3,7,16,0
15472,2,9,0,9,8,1
205565,4,14,24,-10,6,1
83160,4,13,30,-17,4,1
400111,3,17,23,-6,8,1
163844,1,0,0,0,5,0
36440,1,0,3,-3,17,0
396820,1,3,7,-4,6,1
370944,4,27,27,0,12,1
368301,3,9,6,3,11,0
400441,4,24,10,14,8,1
69157,3,14,17,-3,15,0
18083,1,0,14,-14,9,1
154090,1,0,0,0,1,0
68566,4,13,28,-15,14,1
281486,3,7,10,-3,6,1
355103,2,6,13,-7,4,0
358896,3,6,28,-22,6,0
173352,4,28,27,1,10,0
200118,2,7,17,-10,4,1
327491,1,0,0,0,10,1
280964,1,0,0,0,6,0
197937,4,18,7,11,3,1
112218,1,7,7,0,17,1
180513,3,21,20,1,13,0
202368,1,0,0,0,5,0
184431,4,31,6,25,14,0
128835,4,20,13,7,7,0
178610,2,3,3,0,12,1
97877,4,14,27,-13,11,0
116555,2,0,0,0,2,1
236510,3,7,9,-2,3,1
362129,4,42,23,19,8,0
294189,2,0,7,-7,12,0
130708,4,7,45,-38,8,0
201334,3,28,13,15,5,0
155379,2,13,3,10,2,1
215070,3,13,7,6,11,1
146055,2,10,0,10,15,0
369119,2,6,7,-1,11,1
349247,1,0,14,-14,2,0
149868,3,3,16,-13,16,0
16130,4,40,17,23,8,1
316650,4,12,12,0,4,0
275156,2,14,10,4,3,0
19733,3,9,6,3,10,1
88243,4,31,17,14,6,0
294636,2,0,0,0,12,0
89496,1,0,0,0,7,0
362347,2,16,7,9,8,0
369914,4,13,16,-3,12,1
157906,3,6,15,-9,3,1
44242,2,10,13,-3,3,1
83602,4,3,17,-14,4,1
413172,4,40,45,-5,14,1
329673,3,23,17,6,11,1
390193,1,0,3,-3,3,1
245312,4,16,10,6,7,1
259226,4,28,32,-4,13,0
221615,4,20,21,-1,14,1
389618,2,10,7,3,3,0
124417,2,6,7,-1,5,1
219948,2,6,7,-1,13,0
47839,3,10,6,4,5,0
243100,3,7,9,-2,6,1
22119,1,3,3,0,11,0
97546,3,30,7,23,10,0
34033,4,17,27,-10,16,1
226204,1,3,0,3,16,0
332658,4,27,20,7,12,1
77295,4,32,17,15,1,0
25299,3,37,14,23,12,0
63894,2,6,21,-15,12,0
154992,1,6,0,6,1,0
306119,1,0,0,0,17,0
219298,2,10,7,3,13,1
318821,1,7,6,1,5,1
138064,3,36,17,19,11,0
265994,4,0,33,-33,16,1
80721,4,40,33,7,3,0
361284,4,21,32,-11,7,1
252459,2,0,12,-12,10,1
92399,2,10,7,3,8,1
127932,2,22,0,22,6,1
146273,3,3,30,-27,15,1
243717,2,14,3,11,6,1
232889,1,0,0,0,2,0
34919,4,27,24,3,16,0
348985,2,14,0,14,2,0
168258,2,7,7,0,7,1
281186,3,21,13,8,6,1
141033,3,7,10,-3,13,1
364436,3,35,20,15,9,0
4236,3,13,6,7,2,1
139519,1,6,0,6,12,1
22781,3,6,21,-15,11,1
250371,4,21,20,1,9,0
131748,4,24,28,-4,8,1
168897,3,17,6,11,7,1
222035,2,17,3,14,14,0
277481,1,0,0,0,4,0
373209,2,3,13,-10,13,1
344930,2,3,7,-4,17,1
84478,3,20,10,10,4,0
370220,4,31,16,15,12,0
7694,1,10,0,10,4,0
405590,3,14,17,-3,10,0
140900,3,17,7,10,13,0
195129,4,7,29,-22,2,0
327972,2,7,0,7,10,1
158627,2,7,7,0,3,0
340976,4,17,17,0,15,1
184403,3,24,6,18,14,0
71840,1,7,0,7,16,1
254900,2,17,7,10,12,0
420942,2,7,14,-7,17,0
248877,1,14,0,14,9,0
160989,3,10,7,3,4,0
194287,2,10,0,10,2,0
4562,4,31,29,2,2,0
127279,1,10,7,3,6,0
308974,2,0,3,-3,1,0
93713,2,0,3,-3,9,0
195037,2,7,17,-10,2,1
295478,1,0,0,0,12,1
275451,2,20,10,10,3,0
132672,2,3,3,0,9,0
168047,4,6,24,-18,7,0
361222,3,7,17,-10,7,0
5493,2,10,3,7,3,0
276721,4,30,27,3,4,1
235327,4,32,21,11,3,1
288245,3,10,21,-11,9,0
132066,1,0,0,0,9,1
332667,4,33,20,13,12,1
230916,4,24,10,14,1,0
280486,4,34,31,3,5,1
408291,2,0,0,0,12,1
319656,3,24,3,21,6,1
243265,2,7,10,-3,6,0
276093,4,34,3,31,3,1
166333,4,20,9,11,6,0
241930,4,23,27,-4,5,1
299869,2,13,5,8,14,0
19500,4,33,17,16,10,0
80784,2,3,0,3,3,1
30633,4,17,9,8,14,1
267053,1,3,0,3,17,1
322098,4,26,0,26,7,1
407634,4,10,17,-7,11,0
107835,4,13,30,-17,15,1
182054,4,17,21,-4,13,1
198825,3,6,23,-17,3,1
358561,2,10,9,1,6,1
417469,2,10,14,-4,16,0
147776,1,0,0,0,15,1
295655,1,0,0,0,12,0
158264,4,38,0,38,3,0
244543,3,25,13,12,7,0
365423,2,7,12,-5,9,1
175684,2,23,3,20,11,0
383537,3,14,13,1,17,0
78433,3,17,0,17,2,1
336492,4,20,17,3,14,0
275916,3,13,12,1,3,0
50141,3,0,17,-17,6,1
249078,3,21,17,4,9,0
145482,3,16,17,-1,14,1
235518,2,0,13,-13,3,1
61674,2,14,3,11,12,0
62094,1,7,7,0,12,1
185086,2,0,10,-10,15,0
271063,4,28,28,0,1,0
151288,1,7,7,0,17,0
30222,4,13,31,-18,14,0
127311,2,10,17,-7,6,1
43599,4,31,9,22,3,0
20153,2,10,0,10,10,1
271349,4,16,31,-15,1,0
17530,2,13,0,13,9,1
290487,2,14,0,14,10,0
366190,4,7,51,-44,10,1
212471,3,10,3,7,10,1
77441,4,27,21,6,1,0
246658,3,31,3,28,8,1
175180,4,42,17,25,10,1
260461,1,7,0,7,14,0
368970,2,7,7,0,11,0
252343,3,0,22,-22,10,0
339479,4,10,26,-16,15,1
413638,4,17,24,-7,14,1
197302,3,14,0,14,3,0
309518,1,3,0,3,1,1
117230,3,23,16,7,2,0
116399,1,3,3,0,1,1
9804,3,9,17,-8,5,1
242061,4,10,9,1,5,1
308866,3,10,10,0,1,0
230723,3,9,27,-18,1,1
336300,3,17,9,8,13,0
166825,1,0,0,0,6,0
362485,2,7,6,1,8,1
409894,4,37,8,29,12,0
72278,4,27,33,-6,16,1
137780,4,16,37,-21,11,1
390138,4,20,35,-15,3,1
270822,2,6,0,6,1,0
193830,2,10,0,10,1,1
310691,4,20,36,-16,2,0
388804,3,14,7,7,3,0
118074,1,3,6,-3,2,0
84022,3,27,9,18,4,1
86703,2,10,7,3,5,1
298864,4,21,9,12,14,0
180911,2,10,7,3,13,1
32263,3,24,14,10,15,0
228830,3,6,17,-11,17,1
400212,2,10,6,4,8,0
143161,1,0,0,0,13,0
39500,4,13,19,-6,1,1
118656,2,14,6,8,2,1
77864,4,17,28,-11,1,0
8107,4,24,20,4,4,1
188479,4,10,17,-7,16,1
317588,1,3,0,3,5,0
371497,4,17,24,-7,12,0
293985,4,7,28,-21,12,1
333459,1,3,0,3,12,1
239478,4,15,24,-9,4,1
210889,2,12,3,9,9,1
351100,4,29,23,6,3,0
22779,3,3,21,-18,11,1
364127,3,24,3,21,9,0
135622,1,7,6,1,10,0
357082,2,6,14,-8,5,1
243020,1,0,0,0,6,1
125571,2,7,7,0,5,1
368232,1,0,0,0,11,0
318222,1,0,0,0,5,1
420592,1,0,10,-10,17,0
220320,4,26,9,17,13,1
417327,2,7,3,4,16,1
284644,3,14,20,-6,7,1
206489,4,27,0,27,7,0
199562,3,26,10,16,4,1
419208,4,17,6,11,16,1
206195,1,0,3,-3,7,1
227247,1,3,10,-7,16,0
19451,3,17,14,3,10,0
327467,4,10,30,-20,9,1
69722,3,13,7,6,15,0
262563,1,7,0,7,15,0
391025,3,27,27,0,4,0
314979,4,0,20,-20,4,0
23395,4,20,17,3,11,0
47952,2,0,21,-21,5,1
383936,1,0,0,0,1,1
92791,4,12,26,-14,8,1
149340,1,0,0,0,16,1
157648,1,0,0,0,2,0
240132,2,13,3,10,5,0
212112,1,3,7,-4,10,1
73838,4,13,7,6,17,1
406474,1,0,6,-6,11,1
189653,3,10,6,4,17,0
240520,4,12,7,5,5,1
331223,4,17,20,-3,11,0
297674,2,7,6,1,13,1
46516,4,37,6,31,4,1
274256,3,23,7,16,3,0
9376,4,31,14,17,5,0
37556,4,13,10,3,17,0
326454,1,16,3,13,9,1
120047,1,0,0,0,3,1
200127,2,7,17,-10,4,0
156759,1,7,7,0,2,0
121164,2,6,13,-7,3,1
368332,4,12,19,-7,11,1
291443,3,14,20,-6,10,0
412057,2,21,0,21,13,1
372829,4,6,0,6,13,0
31212,4,23,33,-10,15,0
378002,2,0,7,-7,15,0
17313,1,7,0,7,9,0
42706,4,7,13,-6,3,1
301859,1,0,0,0,15,1
317296,1,0,0,0,5,0
316983,1,0,6,-6,4,0
305362,2,14,3,11,17,0
315664,3,10,7,3,4,0
198070,4,3,37,-34,3,1
378233,1,0,0,0,15,1
126462,1,0,3,-3,6,0
257385,3,20,0,20,13,0
293733,1,0,0,0,12,1
110295,2,0,17,-17,16,0
329298,1,3,14,-11,10,1
295939,4,13,24,-11,12,0
158973,3,20,29,-9,3,1
293009,2,3,12,-9,11,0
316387,2,13,0,13,4,0
410209,1,7,0,7,13,0
325700,4,34,20,14,9,0
56802,4,17,20,-3,9,1
339378,1,0,3,-3,15,0
246922,2,14,7,7,8,1
98151,3,21,10,11,11,0
421459,1,0,0,0,17,0
123992,4,13,7,6,5,0
202881,3,21,0,21,5,1
86533,2,13,3,10,5,1
106695,1,0,2,-2,14,0
335239,1,0,0,0,13,0
284311,2,6,10,-4,7,0
92478,4,23,10,13,8,0
402918,4,17,9,8,9,0
139506,1,3,0,3,12,1
112507,1,0,9,-9,17,1
98401,2,7,7,0,11,0
33844,4,3,34,-31,16,1
224587,2,6,7,-1,15,0
161692,1,7,0,7,4,1
333192,2,0,7,-7,12,1
75659,4,13,6,7,17,1
138058,3,29,17,12,11,0
194483,3,16,10,6,2,1
366942,1,0,7,-7,10,0
291327,4,24,25,-1,10,0
366041,3,37,14,23,10,1
403526,4,24,19,5,9,1
68666,2,10,0,10,15,0
218932,4,41,24,17,13,0
367486,4,36,31,5,10,0
176718,4,35,19,16,11,1
226227,2,6,0,6,16,1
38387,3,14,16,-2,1,1
124879,3,9,6,3,5,0
108419,3,6,21,-15,15,1
364678,2,3,0,3,9,0
23335,2,9,10,-1,11,0
184816,3,17,20,-3,15,1
203611,2,0,7,-7,6,0
30093,1,0,0,0,14,1
87038,4,14,22,-8,5,0
84252,2,0,7,-7,4,0
405048,1,0,0,0,10,0
107463,2,0,17,-17,15,1
256229,2,6,7,-1,12,0
255874,4,20,14,6,12,1
243732,2,17,3,14,6,0
317786,2,9,0,9,5,0
54452,1,0,0,0,8,1
22481,3,31,27,4,11,1
198438,2,3,3,0,3,1
362636,2,0,7,-7,8,0
369692,2,16,10,6,11,1
62285,3,21,13,8,12,0
210861,2,0,3,-3,9,1
290515,2,14,14,0,10,0
25738,4,14,10,4,12,0
207563,2,14,0,14,7,0
10637,3,7,17,-10,5,1
144263,3,9,7,2,14,1
130594,1,7,7,0,8,1
1300,4,24,23,1,1,1
74548,3,0,3,-3,17,1
404516,3,24,27,-3,10,1
272136,4,24,9,15,2,0
122070,1,0,7,-7,4,1
370773,3,19,10,9,12,0
50302,3,13,16,-3,6,0
159272,3,17,24,-7,3,1
265969,4,0,33,-33,16,0
251172,1,7,7,0,10,1
406088,3,0,20,-20,11,1
217579,2,3,9,-6,12,1
308274,3,10,16,-6,1,1
127161,3,10,9,1,6,0
78660,1,0,0,0,2,1
64093,4,34,24,10,13,0
264688,1,7,0,7,16,0
143686,3,19,10,9,14,0
57918,2,13,10,3,10,0
294537,3,17,13,4,12,1
363350,1,0,7,-7,8,0
5195,2,7,3,4,3,0
156620,2,3,0,3,2,0
381554,3,28,13,15,17,0
401555,2,14,14,0,8,1
280643,1,0,0,0,5,0
357636,1,0,0,0,5,1
62258,2,14,7,7,12,1
394984,1,0,0,0,5,0
295041,1,0,0,0,12,0
256865,2,0,3,-3,12,1
236375,4,7,23,-16,3,1
19769,4,9,12,-3,10,1
371746,3,14,14,0,12,0
289479,3,6,7,-1,10,1
221494,4,10,41,-31,14,0
298645,2,3,0,3,14,1
218603,3,7,23,-16,13,1
116229,1,3,0,3,1,0
193782,1,0,0,0,1,0
187620,1,0,0,0,16,1
197132,3,21,20,1,3,1
257307,1,3,0,3,13,0
294013,1,0,0,0,12,1
26217,1,0,7,-7,13,1
52762,1,0,13,-13,7,1
88621,2,20,7,13,6,1
91191,3,10,17,-7,8,0
152581,1,0,0,0,17,0
200328,4,30,14,16,4,0
375661,3,17,20,-3,14,0
67734,2,14,0,14,14,1
381170,1,6,0,6,16,1
113534,1,0,0,0,17,0
344312,4,19,13,6,17,1
56286,3,3,20,-17,9,0
177037,1,0,0,0,11,0
102603,2,5,6,-1,13,1
270797,1,3,0,3,1,1
112566,2,24,19,5,17,1
376496,2,3,3,0,14,1
416470,2,21,10,11,15,0
123068,4,14,19,-5,4,0
314520,4,24,7,17,3,0
284288,2,3,3,0,7,1
159379,2,7,10,-3,3,0
83040,1,3,7,-4,4,1
33981,3,10,27,-17,16,0
133648,3,10,28,-18,9,1
298236,2,20,3,17,14,0
253725,3,10,3,7,11,0
187148,4,16,0,16,16,0
354472,2,21,21,0,4,0
322990,4,20,0,20,7,1
211516,3,26,14,12,9,1
86559,2,23,3,20,5,0
371855,2,21,10,11,12,0
293449,1,0,0,0,11,0
387936,1,0,0,0,2,1
82854,4,18,16,2,3,0
136152,3,10,10,0,10,1
47568,4,37,6,31,5,1
259300,2,13,7,6,13,0
39178,4,27,17,10,1,1
310093,1,0,0,0,2,1
366655,1,7,3,4,10,1
70920,3,15,36,-21,15,1
262176,4,31,13,18,15,0
29506,4,10,14,-4,14,1
78227,1,0,0,0,2,0
264579,3,10,17,-7,16,1
325602,2,10,7,3,9,1
69051,4,27,24,3,15,0
60541,3,30,27,3,11,1
226293,3,16,7,9,16,1
223859,3,9,6,3,15,1
158580,1,0,0,0,3,0
245729,3,13,10,3,7,1
232660,3,7,0,7,1,0
208654,3,6,6,0,8,1
112383,2,10,13,-3,17,1
110062,4,48,16,32,16,0
358482,4,38,27,11,6,1
378501,4,23,0,23,15,0
57238,4,20,14,6,10,0
417207,2,16,17,-1,16,1
276212,3,24,10,14,3,0
150989,1,0,0,0,17,1
175809,2,14,3,11,11,0
249582,4,21,13,8,9,0
329512,3,24,7,17,10,0
36040,2,10,0,10,17,0
84476,3,20,10,10,4,0
140142,3,10,3,7,12,1
283985,2,0,0,0,7,1
370775,3,19,10,9,12,0
202292,3,6,3,3,5,1
356294,1,14,0,14,5,0
25579,3,24,10,14,12,1
127314,2,10,17,-7,6,1
310258,1,3,0,3,2,1
309570,3,16,0,16,1,0
82753,2,6,6,0,3,0
328002,3,10,3,7,10,1
192890,1,7,0,7,1,0
353204,1,0,7,-7,4,1
72336,2,0,14,-14,16,1
379361,4,10,16,-6,16,1
294181,2,0,7,-7,12,1
325514,4,22,13,9,8,0
137323,1,0,0,0,11,0
299274,2,23,0,23,14,0
24150,4,31,14,17,12,0
376549,3,8,6,2,14,1
9836,4,20,17,3,5,1
230271,2,16,10,6,17,0
291099,2,12,13,-1,10,1
359941,4,23,30,-7,6,1
211396,4,10,13,-3,9,0
100619,2,7,7,0,12,0
172233,3,13,13,0,9,1
188392,2,3,0,3,16,0
228242,4,10,27,-17,17,0
82438,1,0,7,-7,3,1
330234,3,10,14,-4,11,1
275893,2,13,6,7,3,0
7237,2,0,13,-13,4,1
43508,2,7,3,4,3,1
384281,2,6,0,6,1,1
411231,4,11,23,-12,13,0
408544,4,10,16,-6,12,0
389260,4,31,7,24,3,1
123122,1,0,0,0,4,1
266900,1,0,0,0,17,1
400657,2,3,0,3,8,1
72630,2,13,0,13,16,0
302357,3,10,10,0,15,0
414519,2,13,3,10,14,1
220326,4,29,9,20,13,0
88757,2,6,3,3,6,0
47472,1,3,0,3,5,0
181763,4,7,14,-7,13,0
263698,1,0,0,0,15,1
214580,2,3,3,0,11,1
16468,2,3,0,3,8,1
88636,3,20,10,10,6,0
23934,2,16,0,16,12,1
140023,4,28,10,18,12,1
37900,2,3,7,-4,1,0
50551,2,0,6,-6,6,1
45031,3,20,10,10,4,0
27061,3,10,6,4,13,1
411327,3,10,10,0,13,1
313989,1,0,0,0,3,1
59991,4,3,31,-28,11,1
236561,4,10,9,1,3,1
17783,1,7,3,4,9,1
78748,3,13,17,-4,2,1
399240,4,13,20,-7,7,1
361918,2,7,0,7,7,0
259965,4,20,20,0,14,0
262711,2,13,0,13,15,1
24385,3,13,0,13,12,1
2111,3,10,13,-3,1,1
305132,3,21,10,11,16,1
253088,3,14,7,7,11,1
219102,4,45,13,32,13,0
398209,3,27,10,17,7,1
9529,4,13,13,0,5,1
194913,3,7,10,-3,2,1
72397,4,17,23,-6,16,1
253265,3,3,13,-10,11,1
390707,3,6,10,-4,3,1
35816,4,3,10,-7,17,1
245017,4,14,27,-13,7,0
285896,2,13,0,13,8,0
144929,4,20,7,13,14,0
222279,1,0,0,0,14,1
363787,1,7,7,0,8,0
224399,1,0,0,0,15,0
111328,1,0,7,-7,16,1
28089,3,21,10,11,13,1
257009,1,0,7,-7,12,0
63672,4,26,36,-10,12,1
239207,4,27,27,0,4,1
362716,4,3,13,-10,8,1
223238,3,3,6,-3,15,1
378235,1,0,0,0,15,1
189710,1,0,0,0,17,0
338646,2,6,0,6,14,0
319807,2,14,10,4,6,1
259170,3,14,19,-5,13,1
161787,3,24,6,18,4,0
248185,3,9,10,-1,8,1
156421,1,0,0,0,2,0
283039,4,28,3,25,6,0
64335,3,6,20,-14,13,1
410324,4,7,23,-16,13,0
287936,2,14,13,1,9,1
209380,3,14,7,7,8,0
56771,3,14,13,1,9,0
215121,1,0,0,0,11,0
7918,3,3,20,-17,4,0
168785,4,16,16,0,7,1
294211,2,0,7,-7,12,1
154596,2,14,7,7,1,0
292773,3,26,17,9,11,1
7371,1,0,0,0,4,1
110733,2,3,3,0,16,0
154843,1,3,0,3,1,1
173857,1,0,7,-7,10,0
330443,4,13,20,-7,11,1
145254,1,7,6,1,14,1
368908,4,38,3,35,11,0
407609,3,10,17,-7,11,0
389282,1,0,0,0,3,1
31993,4,19,13,6,15,0
257927,1,0,0,0,13,0
212024,3,10,30,-20,9,1
129456,4,23,20,3,7,0
183820,3,20,21,-1,14,1
158306,2,6,7,-1,3,0
40245,1,0,0,0,2,0
340155,2,20,7,13,15,1
94338,3,17,7,10,9,0
170474,4,21,10,11,8,1
39760,4,9,7,2,1,0
420728,1,0,0,0,17,1
322690,5,9,9,0,7,1
272917,4,20,20,0,2,1
269966,3,16,13,3,1,0
305730,3,9,10,-1,17,0
235106,2,0,10,-10,2,0
139126,3,12,6,6,12,0
197145,3,24,20,4,3,1
91983,3,13,23,-10,8,0
56611,4,26,17,9,9,0
150932,3,13,7,6,17,0
19984,2,6,3,3,10,1
160638,2,7,0,7,4,0
161490,4,10,6,4,4,0
174391,3,17,3,14,10,0
65908,3,14,14,0,13,1
413903,4,17,9,8,14,1
172850,2,17,3,14,9,1
48988,1,3,7,-4,6,0
61074,1,0,0,0,11,0
239206,4,27,27,0,4,1
130352,3,7,3,4,8,1
6007,4,17,36,-19,3,1
99671,4,26,3,23,11,1
211717,4,26,16,10,9,0
263947,3,23,0,23,15,1
75664,4,13,6,7,17,1
151747,2,7,6,1,17,1
177633,4,24,20,4,11,0
217339,3,7,10,-3,12,0
130515,3,10,6,4,8,0
148178,3,6,21,-15,16,1
367504,1,0,0,0,10,1
278970,3,7,30,-23,5,1
143101,3,17,24,-7,13,1
283750,3,11,3,8,7,0
177561,2,10,0,10,11,0
93444,3,3,14,-11,9,1
224351,4,16,12,4,15,0
270664,2,3,0,3,1,0
211064,3,27,0,27,9,1
381999,3,0,23,-23,17,0
207892,3,21,7,14,8,0
60984,2,27,13,14,11,0
383794,2,3,7,-4,1,0
379543,1,7,3,4,16,0
2812,2,21,21,0,2,0
46940,4,20,30,-10,5,0
185724,2,20,3,17,15,0
354204,2,13,10,3,4,0
79521,4,12,27,-15,2,1
198249,1,0,0,0,3,1
314374,4,10,17,-7,3,1
229155,4,19,7,12,17,0
153765,4,2,27,-25,1,1
237954,1,3,0,3,4,0
240957,3,21,9,12,5,0
413255,2,10,0,10,14,0
404042,2,10,28,-18,10,0
389135,4,30,14,16,3,0
172293,4,24,20,4,9,0
105849,3,16,10,6,14,1
307471,2,35,13,22,17,0
187607,4,13,30,-17,16,0
23730,1,0,0,0,12,0
377009,4,15,19,-4,15,1
6092,2,7,10,-3,3,1
350528,4,17,19,-2,2,1
76952,3,17,13,4,1,0
274755,4,24,20,4,3,1
293618,1,7,6,1,12,0
72972,4,38,15,23,16,0
155267,4,28,21,7,1,1
334711,3,18,3,15,13,0
287642,3,3,10,-7,9,0
359785,4,27,26,1,6,1
150439,2,20,3,17,16,1
397027,3,21,9,12,6,0
157837,1,6,9,-3,3,0
88386,4,24,10,14,6,0
211031,2,20,0,20,9,1
270635,1,0,0,0,1,0
206762,4,14,24,-10,7,0
349600,3,13,28,-15,2,0
174367,3,17,3,14,10,1
129899,3,13,0,13,7,1
68714,4,31,0,31,15,0
120904,4,21,31,-10,3,1
67845,1,3,3,0,14,0
373592,4,30,33,-3,13,0
359924,4,23,30,-7,6,1
239058,1,0,0,0,4,0
200310,3,27,14,13,4,0
87348,1,0,0,0,6,1
402995,2,7,21,-14,9,1
53166,4,19,38,-19,7,1
299344,4,28,16,12,14,0
204792,4,28,21,7,6,0
281606,2,14,0,14,6,1
192031,4,24,20,4,1,0
298835,3,21,9,12,14,1
319512,3,10,17,-7,6,1
79867,2,3,13,-10,2,1
161747,2,23,6,17,4,1
245985,1,0,0,0,7,0
250480,2,13,7,6,9,0
125730,2,7,7,0,5,1
44691,1,0,9,-9,3,0
229078,2,10,0,10,17,0
58015,5,20,20,0,10,1
326584,1,3,0,3,9,0
380076,4,35,20,15,16,1
8343,2,16,3,13,4,1
11875,4,41,20,21,6,0
34374,1,7,0,7,16,0
190685,3,28,14,14,17,0
203719,4,22,37,-15,6,0
315668,3,10,7,3,4,1
54799,3,10,0,10,8,0
265979,4,0,33,-33,16,0
274761,4,24,20,4,3,0
416268,1,7,3,4,15,0
384150,3,14,20,-6,1,0
61924,1,0,0,0,12,0
412305,2,7,7,0,13,1
170176,4,17,27,-10,8,1
256884,2,7,10,-3,12,1
224458,2,9,10,-1,15,1
378594,3,17,13,4,15,1
218376,1,0,0,0,13,1
64815,1,0,0,0,13,0
127076,4,31,29,2,6,0
362359,3,16,14,2,8,1
145469,3,16,17,-1,14,1
344005,4,23,6,17,17,0
295593,4,23,32,-9,12,1
190686,3,28,14,14,17,0
339855,2,16,0,16,15,0
348817,2,3,7,-4,2,0
343819,3,21,3,18,17,1
133781,3,13,10,3,9,1
286873,2,9,7,2,8,0
70167,3,27,7,20,15,0
272325,1,7,0,7,2,0
91660,3,21,14,7,8,0
247977,1,7,3,4,8,0
296869,1,3,0,3,13,0
385787,3,20,3,17,1,1
150524,1,0,0,0,17,1
361415,4,17,21,-4,7,1
88716,1,0,0,0,6,1
359540,4,0,21,-21,6,0
407010,4,3,27,-24,11,0
364379,2,14,7,7,9,1
223691,3,20,13,7,15,0
412023,2,7,0,7,13,1
342439,3,10,3,7,16,1
205270,1,0,0,0,6,1
182782,2,10,3,7,14,0
53145,4,19,38,-19,7,0
368981,2,7,7,0,11,1
157393,2,6,7,-1,2,1
89242,3,6,0,6,7,1
82312,2,3,10,-7,3,1
171635,3,19,10,9,9,0
260174,1,7,0,7,14,1
98000,3,17,10,7,11,0
262395,1,6,7,-1,15,1
211336,2,10,10,0,9,1
119078,1,0,7,-7,3,0
1902,1,0,0,0,1,1
320528,1,7,0,7,6,1
131940,1,0,0,0,8,0
408619,2,28,0,28,12,0
383786,2,3,0,3,1,0
92757,4,6,17,-11,8,0
315286,5,20,19,1,4,1
311761,2,7,13,-6,2,0
127511,3,3,23,-20,6,1
215507,3,13,3,10,11,1
39305,4,10,27,-17,1,1
3812,4,23,10,13,2,0
91707,4,21,24,-3,8,1
345287,4,19,17,2,17,1
165476,1,0,0,0,6,0
51238,4,39,25,14,7,0
229715,2,13,17,-4,17,1
44712,2,0,9,-9,3,0
235459,4,28,32,-4,3,0
336545,2,0,0,0,14,0
241663,1,0,0,0,5,0
185449,4,17,10,7,15,0
327323,4,16,27,-11,9,1
158715,4,31,7,24,3,1
225549,4,8,24,-16,15,0
194225,4,18,17,1,1,1
313618,4,22,29,-7,3,0
411874,1,7,0,7,13,1
111036,1,7,0,7,16,1
252190,3,23,17,6,10,0
19191,3,21,13,8,10,0
46018,2,14,7,7,4,0
200447,3,13,18,-5,4,1
142329,3,0,3,-3,13,1
342913,3,23,17,6,16,0
267417,3,10,17,-7,17,1
216630,1,0,3,-3,12,1
100476,2,7,10,-3,12,0
39185,4,34,17,17,1,0
412261,4,28,15,13,13,1
63515,4,31,19,12,12,1
371879,2,24,10,14,12,1
324494,1,0,0,0,8,0
322711,1,0,0,0,7,0
258192,4,20,13,7,13,0
398355,3,3,13,-10,7,0
418254,2,0,0,0,16,1
65745,3,14,16,-2,13,0
386677,3,17,13,4,2,0
143404,4,7,26,-19,14,0
109357,1,0,7,-7,16,1
387825,2,10,7,3,2,0
139861,3,13,17,-4,12,1
53139,3,19,38,-19,7,1
151780,3,14,6,8,17,0
198669,4,15,21,-6,3,0
387830,2,10,7,3,2,0
380939,3,9,7,2,16,1
384099,2,0,10,-10,1,1
154225,4,10,23,-13,1,1
27031,2,10,0,10,13,0
106113,2,0,0,0,14,1
321480,4,21,30,-9,7,1
383430,4,13,9,4,17,1
133909,2,3,6,-3,9,1
81847,2,0,21,-21,3,1
108973,2,16,17,-1,15,0
398568,1,0,0,0,7,1
418241,1,0,0,0,16,0
203125,1,0,7,-7,5,1
152518,3,17,7,10,17,0
66621,2,0,17,-17,14,0
170103,2,7,0,7,8,0
339849,2,16,0,16,15,1
50606,3,3,6,-3,6,1
271294,3,6,14,-8,1,0
31112,1,0,3,-3,15,1
294998,4,31,14,17,12,0
177373,2,10,7,3,11,1
289174,3,20,10,10,9,1
180914,2,10,7,3,13,1
102908,2,6,14,-8,13,0
386862,4,26,28,-2,2,0
236297,2,0,9,-9,3,1
320741,3,14,23,-9,6,1
342364,1,0,0,0,16,0
170326,4,0,15,-15,8,1
151261,4,24,26,-2,17,0
126850,3,10,6,4,6,1
142243,1,0,0,0,13,0
23519,4,17,17,0,11,0
419118,1,10,0,10,16,1
56425,2,0,28,-28,9,0
322466,2,12,0,12,7,0
247933,4,20,6,14,8,0
347172,4,23,17,6,1,0
390307,4,17,20,-3,3,1
189216,3,33,3,30,16,0
222652,3,7,10,-3,14,1
116914,3,14,10,4,2,0
347713,1,0,0,0,1,0
193436,3,20,20,0,1,1
40199,4,34,7,27,2,0
419769,3,17,17,0,17,0
264934,3,20,17,3,16,1
296976,4,29,7,22,13,0
233367,1,0,0,0,2,1
363236,2,21,7,14,8,0
80573,4,16,10,6,3,0
93035,3,13,9,4,8,1
324210,1,0,0,0,8,1
295458,4,17,16,1,12,0
377198,1,0,0,0,15,1
263128,1,0,7,-7,15,0
329420,4,16,41,-25,10,0
183449,4,27,6,21,14,0
375511,3,33,7,26,14,1
245082,1,7,0,7,7,0
16071,2,16,0,16,8,0
129794,1,0,0,0,7,0
344964,3,10,14,-4,17,0
38401,3,17,16,1,1,0
223771,1,0,0,0,15,0
192784,2,0,15,-15,1,1
223700,3,20,13,7,15,1
219236,4,16,3,13,13,1
57555,4,31,16,15,10,0
73943,2,17,0,17,17,1
104892,2,0,3,-3,14,1
263035,3,10,3,7,15,1
368395,2,14,7,7,11,1
13675,1,0,0,0,7,0
418478,4,17,6,11,16,1
116674,1,3,3,0,2,0
397191,3,13,0,13,6,0
188648,5,20,19,1,16,0
182236,1,0,0,0,14,1
304328,2,7,7,0,16,1
379763,3,9,17,-8,16,0
259688,1,0,0,0,14,1
314960,4,0,13,-13,4,0
390198,1,0,3,-3,3,0
414400,2,7,17,-10,14,0
292005,2,6,3,3,11,1
379136,1,6,3,3,16,1
325254,1,0,3,-3,8,1
76805,3,33,0,33,1,1
209026,2,3,0,3,8,1
371490,4,14,24,-10,12,1
275669,4,37,3,34,3,0
90168,3,3,0,3,7,1
278307,2,14,0,14,4,1
76706,4,16,7,9,1,0
115662,1,3,3,0,1,0
357753,4,43,19,24,5,1
307702,4,17,31,-14,17,1
368255,2,3,3,0,11,1
328139,2,6,7,-1,10,1
172661,1,7,3,4,9,1
135445,4,31,27,4,10,0
290799,2,10,0,10,10,0
324067,1,0,0,0,8,0
46493,3,27,6,21,4,1
391977,1,0,7,-7,4,1
4832,4,34,3,31,3,1
71874,2,9,6,3,16,1
383323,1,0,0,0,17,1
304812,3,0,3,-3,16,1
334896,4,27,10,17,13,0
302685,4,17,20,-3,15,1
240759,2,7,7,0,5,0
272512,2,7,3,4,2,0
4463,1,7,9,-2,2,0
51796,4,10,19,-9,7,0
348260,3,16,45,-29,1,0
60384,3,13,7,6,11,1
133531,4,30,20,10,9,1
25958,2,3,3,0,13,0
164619,2,7,17,-10,5,1
107272,1,0,0,0,15,0
207731,2,16,13,3,7,1
358201,4,23,17,6,6,0
306272,2,10,0,10,17,0
244504,2,25,3,22,7,0
75829,1,7,0,7,1,0
198579,1,0,0,0,3,1
124077,2,0,14,-14,5,1
96584,2,3,3,0,10,0
114494,2,17,17,0,1,0
159299,4,27,24,3,3,0
227929,3,27,20,7,16,0
412418,1,0,0,0,14,0
179745,3,6,10,-4,12,0
251330,1,7,7,0,10,1
40434,2,7,13,-6,2,0
247045,1,0,3,-3,8,0
164454,2,14,0,14,5,0
7942,4,3,27,-24,4,1
35585,1,7,0,7,17,1
311887,2,7,0,7,2,0
289601,2,10,13,-3,10,0
75085,2,7,6,1,17,1
362049,2,14,7,7,8,1
76537,3,7,27,-20,1,0
181338,1,7,0,7,13,0
273883,1,0,3,-3,2,1
166242,1,0,3,-3,6,0
203964,2,10,7,3,6,0
239919,4,13,9,4,4,0
325204,4,13,23,-10,8,0
278208,3,24,21,3,4,0
311355,3,21,10,11,2,0
120520,1,0,0,0,3,0
277099,3,10,14,-4,4,1
323759,1,6,3,3,8,1
342192,4,15,19,-4,16,1
215907,2,3,7,-4,11,0
169227,3,16,6,10,7,1
139158,3,19,6,13,12,0
96857,2,10,0,10,10,1
416770,2,7,10,-3,15,1
324758,4,26,7,19,8,0
258195,4,20,20,0,13,1
302831,3,9,23,-14,15,1
52343,2,3,9,-6,7,0
88001,2,10,0,10,6,0
9817,4,12,17,-5,5,1
127789,3,10,21,-11,6,0
251543,3,16,13,3,10,0
405242,2,7,7,0,10,0
174235,4,10,26,-16,10,0
182299,2,14,0,14,14,0
345818,1,0,7,-7,17,1
295737,4,10,16,-6,12,0
264664,5,23,20,3,16,0
285309,4,21,9,12,7,1
160882,4,34,27,7,4,0
409276,3,13,13,0,12,0
323350,2,7,0,7,7,1
394880,2,0,17,-17,5,1
32329,1,7,0,7,15,0
140768,3,15,21,-6,12,0
392253,4,10,16,-6,4,1
367533,2,14,3,11,10,0
13838,1,0,0,0,7,1
50533,1,0,3,-3,6,0
105651,2,7,3,4,14,0
41298,1,0,3,-3,2,1
176195,3,14,24,-10,11,1
381556,3,28,16,12,17,0
235624,4,27,34,-7,3,1
159266,3,17,24,-7,3,0
228690,3,16,23,-7,17,1
291561,2,10,3,7,11,1
227646,4,35,0,35,16,1
213136,4,20,13,7,10,1
397280,2,0,14,-14,6,0
83175,1,0,0,0,4,1
236377,4,7,23,-16,3,1
100465,2,7,7,0,12,0
418643,4,21,31,-10,16,1
101998,2,7,0,7,12,0
27507,3,20,9,11,13,1
218886,2,21,10,11,13,0
180272,1,6,0,6,13,0
347794,3,10,0,10,1,0
323381,3,17,0,17,7,0
73959,3,30,0,30,17,0
281048,3,17,13,4,6,0
400365,2,17,10,7,8,1
192703,4,19,7,12,1,0
418188,4,24,6,18,16,1
240112,1,6,0,6,5,0
393125,3,24,3,21,4,0
200270,2,10,14,-4,4,1
266405,4,36,8,28,16,1
329287,1,0,0,0,10,0
122601,3,26,7,19,4,1
54866,4,26,3,23,8,0
392271,1,0,7,-7,4,1
391626,4,17,24,-7,4,0
5304,1,0,0,0,3,0
351023,2,7,7,0,3,0
223670,2,13,6,7,15,0
391663,1,0,0,0,4,0
145253,1,7,6,1,14,1
148572,2,0,6,-6,16,1
233612,3,20,41,-21,2,1
185380,2,0,3,-3,15,1
233946,4,24,13,11,2,0
336138,3,10,3,7,13,0
327609,4,10,22,-12,10,1
219277,1,7,0,7,13,1
85716,4,24,28,-4,5,1
219983,3,13,21,-8,13,0
398865,1,3,0,3,7,0
45807,4,13,14,-1,4,1
157767,4,17,10,7,2,1
235389,2,21,7,14,3,0
313785,4,31,17,14,3,1
355887,3,13,10,3,5,1
132653,1,0,3,-3,9,1
144297,4,26,7,19,14,0
159762,3,7,13,-6,3,0
120851,2,7,14,-7,3,0
126150,1,0,3,-3,6,1
160491,3,20,7,13,4,0
253156,4,21,23,-2,11,1
317598,1,3,3,0,5,1
145224,4,56,0,56,14,0
29085,1,0,6,-6,14,1
269745,1,7,0,7,1,0
246267,4,24,16,8,7,1
149680,2,20,0,20,16,1
103590,4,33,14,19,13,1
396256,2,3,3,0,6,0
336539,2,0,0,0,14,1
159485,1,0,0,0,3,1
192319,3,27,17,10,1,1
54152,1,0,0,0,8,0
53862,2,0,0,0,8,1
18885,3,9,13,-4,9,0
8770,2,6,0,6,4,1
286621,4,17,41,-24,8,1
229752,4,20,17,3,17,0
413234,2,7,0,7,14,1
322836,4,3,40,-37,7,1
303538,1,0,0,0,16,0
126801,1,0,6,-6,6,0
396024,4,38,20,18,6,0
138631,2,3,14,-11,12,1
407758,3,10,7,3,11,1
2736,4,9,7,2,2,1
327175,4,28,17,11,9,0
382445,4,0,24,-24,17,1
39201,1,0,0,0,1,0
369295,3,14,17,-3,11,1
92734,3,3,17,-14,8,1
290738,4,47,25,22,10,1
87958,1,0,0,0,6,0
49192,2,10,0,10,6,1
31018,2,3,6,-3,15,1
200607,3,24,14,10,4,1
417223,3,17,20,-3,16,0
147552,2,6,0,6,15,1
125042,4,3,19,-16,5,1
130782,2,13,3,10,8,1
209334,2,7,7,0,8,0
34113,2,3,0,3,16,0
25518,2,7,0,7,12,0
139355,1,7,0,7,12,0
43691,3,14,10,4,3,1
223547,3,10,10,0,15,0
291736,3,0,14,-14,11,1
92864,3,24,0,24,8,0
82644,3,12,10,2,3,0
64468,3,21,13,8,13,0
409852,3,23,0,23,12,0
125428,2,10,0,10,5,0
326057,2,9,3,6,9,1
334541,2,14,17,-3,13,1
32327,1,7,0,7,15,0
103259,4,3,10,-7,13,1
280601,3,17,9,8,5,1
122190,4,27,28,-1,4,0
45815,4,16,14,2,4,0
135765,1,0,7,-7,10,1
344749,4,13,34,-21,17,0
267774,1,3,0,3,17,0
191737,3,16,17,-1,17,0
22304,2,0,3,-3,11,0
270204,1,3,7,-4,1,1
165367,2,3,10,-7,6,0
56941,4,43,7,36,9,0
304240,4,33,14,19,16,1
356368,3,24,8,16,5,0
310366,4,29,0,29,2,0
171272,1,0,0,0,9,0
31199,3,23,27,-4,15,0
155120,4,19,33,-14,1,0
404496,3,21,19,2,10,0
260359,2,6,0,6,14,1
21685,2,10,7,3,11,0
348545,3,28,14,14,2,1
316816,4,16,7,9,4,1
414558,3,21,9,12,14,1
79520,4,12,27,-15,2,1
350260,1,0,0,0,2,1
244804,2,7,0,7,7,0
412722,4,40,13,27,14,0
10889,1,0,7,-7,5,1
330787,1,0,3,-3,11,1
327180,4,28,17,11,9,0
57302,2,7,0,7,10,0
249199,2,9,0,9,9,0
184251,3,24,7,17,14,1
59828,4,15,16,-1,11,0
53036,1,0,0,0,7,0
109543,2,0,7,-7,16,1
209893,3,23,16,7,8,0
63743,2,7,15,-8,12,1
365649,4,45,35,10,9,0
408179,3,6,0,6,12,1
98256,2,7,24,-17,11,1
383062,2,17,7,10,17,0
243503,4,10,37,-27,6,1
197167,3,27,26,1,3,0
33039,1,0,0,0,16,0
140773,3,22,21,1,12,0
330155,4,0,22,-22,11,0
281826,3,10,0,10,6,1
251203,2,10,10,0,10,0
204591,2,0,38,-38,6,1
80053,3,17,6,11,2,0
204186,4,24,20,4,6,1
107960,3,6,6,0,15,0
306421,2,0,10,-10,17,1
162271,4,30,20,10,4,1
410477,4,9,23,-14,13,0
391169,3,10,24,-14,4,1
334249,2,6,7,-1,13,1
57388,4,14,3,11,10,1
17285,4,21,41,-20,9,1
309613,4,16,3,13,1,1
381793,2,0,0,0,17,0
134011,1,6,0,6,9,0
214306,4,14,10,4,11,1
66159,1,10,0,10,13,0
237201,2,3,0,3,3,1
148706,1,7,0,7,16,1
136180,4,13,10,3,10,1
327563,3,7,15,-8,10,1
174155,1,0,3,-3,10,0
112767,4,13,7,6,17,0
85643,2,17,0,17,5,0
26964,4,16,6,10,13,0
283429,2,20,7,13,7,0
251069,2,7,14,-7,10,1
351919,1,6,7,-1,3,1
78916,4,17,10,7,2,1
286601,3,17,38,-21,8,1
54505,3,7,7,0,8,0
245090,1,13,3,10,7,1
194562,1,7,0,7,2,0
28657,2,3,7,-4,14,1
307888,1,0,0,0,1,1
107151,1,0,7,-7,15,0
102423,1,3,0,3,13,0
5254,3,24,24,0,3,0
44277,3,17,20,-3,3,0
393762,4,7,14,-7,5,1
300519,4,23,17,6,14,0
246113,1,0,0,0,7,0
80800,3,3,0,3,3,0
72214,3,17,10,7,16,0
381572,4,35,16,19,17,0
51458,2,13,24,-11,7,1
207569,2,14,3,11,7,1
352947,2,10,0,10,3,1
150820,1,0,0,0,17,0
388045,4,20,6,14,2,0
265528,4,14,10,4,16,0
237358,2,6,7,-1,3,0
331685,1,0,6,-6,12,0
668,3,0,10,-10,1,0
220476,1,0,0,0,13,1
284761,2,20,10,10,7,0
65392,1,0,7,-7,13,0
299793,5,17,17,0,14,1
313031,3,20,0,20,3,1
237053,2,0,17,-17,3,1
281370,4,21,13,8,6,1
232334,2,6,9,-3,1,0
132231,2,7,0,7,9,0
6650,2,0,10,-10,3,1
10078,3,31,7,24,5,1
342355,1,0,0,0,16,0
367604,4,28,12,16,10,1
418801,4,14,24,-10,16,1
264611,4,12,17,-5,16,0
386928,2,7,21,-14,2,1
185371,2,0,3,-3,15,0
341973,2,6,0,6,16,1
314893,2,0,0,0,4,1
251222,2,10,24,-14,10,1
106156,3,0,0,0,14,1
347004,3,7,3,4,1,1
370,2,27,10,17,1,1
113146,2,41,0,41,17,0
315656,2,3,7,-4,4,1
144028,4,21,16,5,14,0
188571,3,9,13,-4,16,1
269935,2,13,10,3,1,0
260877,4,50,15,35,14,0
330659,2,6,3,3,11,1
321621,3,17,13,4,7,1
382846,3,28,3,25,17,0
84560,2,7,7,0,4,0
111133,4,31,10,21,16,0
20661,2,7,17,-10,10,1
403033,3,21,21,0,9,0
198320,3,6,14,-8,3,0
40945,4,16,20,-4,2,0
25568,3,24,10,14,12,0
202376,1,0,0,0,5,1
258824,2,7,7,0,13,1
265081,3,13,3,10,16,0
345725,3,7,7,0,17,1
151041,2,3,3,0,17,0
341800,2,3,3,0,16,1
167279,1,3,0,3,7,0
210908,3,19,10,9,9,1
329417,4,16,41,-25,10,0
271021,3,18,21,-3,1,0
57737,1,9,0,9,10,0
86922,1,0,0,0,5,1
144430,3,3,13,-10,14,0
362619,2,0,7,-7,8,0
110618,3,17,10,7,16,1
57719,1,0,0,0,10,0
247922,4,20,6,14,8,0
129968,1,0,0,0,8,0
225368,3,17,21,-4,15,0
8997,1,0,0,0,4,1
279746,4,30,6,24,5,1
418744,3,7,14,-7,16,0
377379,2,0,6,-6,15,1
187403,3,34,7,27,16,0
199783,1,3,3,0,4,0
322321,2,14,7,7,7,0
298742,4,22,27,-5,14,1
172052,2,7,0,7,9,0
180526,4,21,20,1,13,1
49300,1,0,3,-3,6,0
343009,1,0,0,0,16,1
102875,1,0,7,-7,13,1
249752,4,35,21,14,9,0
272031,2,7,3,4,2,1
126184,2,14,3,11,6,0
266403,4,36,8,28,16,1
381707,3,20,24,-4,17,1
48616,4,21,27,-6,5,1
343309,1,0,10,-10,16,1
264111,3,13,27,-14,15,0
103121,4,34,7,27,13,1
282231,2,3,7,-4,6,1
317226,3,7,16,-9,5,0
231490,3,23,12,11,1,0
280263,2,6,13,-7,5,1
214903,3,7,12,-5,11,1
183044,1,7,0,7,14,0
79465,3,12,14,-2,2,0
338363,2,3,0,3,14,0
396632,4,23,10,13,6,0
282709,4,9,20,-11,6,0
257206,2,10,16,-6,12,1
382123,3,27,3,24,17,0
417079,3,27,0,27,15,0
378128,2,21,0,21,15,1
255431,4,24,6,18,12,1
411694,1,0,0,0,13,0
409542,3,27,3,24,12,1
320837,2,3,11,-8,6,1
312212,2,7,14,-7,2,1
218209,4,30,3,27,12,0
124761,4,3,9,-6,5,1
189778,2,17,6,11,17,0
53049,1,10,0,10,7,0
188333,4,23,13,10,16,0
366825,2,0,3,-3,10,1
99218,3,31,17,14,11,0
181273,3,0,13,-13,13,1
81971,1,0,0,0,3,1
194573,2,14,0,14,2,0
134927,3,7,16,-9,10,0
129117,3,27,28,-1,7,1
195476,1,0,0,0,2,0
193422,3,13,20,-7,1,1
227526,4,26,17,9,16,1
133305,2,7,0,7,9,0
278259,1,0,0,0,4,0
414741,3,10,17,-7,14,0
270356,1,0,0,0,1,1
350237,4,27,0,27,2,1
406790,2,0,17,-17,11,1
31664,4,24,9,15,15,0
309686,2,3,3,0,1,0
111190,1,7,0,7,16,0
274364,2,3,7,-4,3,0
370484,3,20,9,11,12,0
127921,2,16,0,16,6,0
117995,3,20,6,14,2,1
92574,3,17,3,14,8,0
178516,3,16,13,3,12,1
99216,3,31,17,14,11,0
366430,3,26,10,16,10,0
46743,2,7,3,4,4,1
136273,2,15,7,8,11,1
287589,1,0,3,-3,9,1
212409,1,0,0,0,10,1
401624,4,24,31,-7,8,0
198586,1,0,0,0,3,1
237063,2,0,17,-17,3,0
198828,4,12,23,-11,3,1
118904,4,27,14,13,2,0
395015,2,0,14,-14,5,0
217373,4,21,10,11,12,0
412334,2,10,14,-4,13,0
108423,4,13,21,-8,15,0
94537,3,3,10,-7,9,0
411880,1,14,0,14,13,0
295592,4,23,32,-9,12,1
112058,1,0,0,0,17,1
355315,4,14,20,-6,4,1
207394,1,6,0,6,7,1
286761,4,20,21,-1,8,0
259975,4,20,20,0,14,0
255269,4,13,17,-4,12,1
29659,1,0,0,0,14,1
204180,4,24,17,7,6,0
413641,1,0,0,0,14,0
199664,2,7,7,0,4,1
245637,4,43,20,23,7,0
251319,1,7,0,7,10,0
320841,2,3,11,-8,6,0
339676,1,7,0,7,15,1
91341,3,14,7,7,8,0
328395,1,0,0,0,10,1
374165,3,23,7,16,13,0
295142,4,10,14,-4,12,0
121233,3,21,27,-6,3,0
232090,4,0,33,-33,1,1
214138,3,3,6,-3,11,0
322044,2,13,0,13,7,0
420163,3,0,3,-3,17,1
56735,2,0,10,-10,9,0
225123,4,16,14,2,15,1
307121,1,0,0,0,17,1
198044,3,3,30,-27,3,0
53419,3,3,28,-25,8,1
39043,1,0,0,0,1,1
160801,2,17,10,7,4,0
6180,1,0,0,0,3,1
146559,3,14,24,-10,15,0
292881,2,7,0,7,11,0
181272,3,0,13,-13,13,1
377289,3,14,14,0,15,1
340229,4,29,31,-2,15,1
297545,3,14,0,14,13,0
383608,1,0,0,0,17,0
16233,2,3,3,0,8,0
367149,3,29,16,13,10,0
369578,3,14,0,14,11,0
48927,4,15,13,2,5,0
224647,3,16,10,6,15,1
366839,2,3,3,0,10,1
112934,4,19,6,13,17,0
402613,3,17,16,1,9,1
306814,4,26,36,-10,17,0
151893,2,13,0,13,17,0
292061,4,15,19,-4,11,1
16608,2,7,14,-7,8,1
296627,3,3,10,-7,13,1
163782,3,10,12,-2,5,1
408201,3,13,3,10,12,0
301274,1,7,0,7,15,0
222309,2,7,0,7,14,0
348383,3,13,10,3,1,0
36116,4,44,0,44,17,0
117667,3,20,13,7,2,1
338309,1,0,0,0,14,1
29611,3,14,13,1,14,1
302883,4,15,26,-11,15,1
99745,2,0,0,0,12,0
36104,3,41,0,41,17,1
12118,3,7,7,0,6,0
594,1,0,0,0,1,1
393560,2,7,9,-2,5,0
146284,4,10,30,-20,15,0
147921,4,30,31,-1,15,1
205339,2,20,0,20,6,0
378244,1,0,0,0,15,0
84287,2,7,21,-14,4,0
416010,2,7,0,7,15,1
268183,3,9,17,-8,17,1
356722,4,19,16,3,5,1
287802,2,21,10,11,9,0
247203,1,0,0,0,8,0
129933,4,13,0,13,7,0
336270,2,10,0,10,13,1
263350,3,24,10,14,15,0
88817,4,13,13,0,6,0
368648,1,0,3,-3,11,1
157376,2,3,7,-4,2,1
326833,3,10,14,-4,9,0
378831,1,0,3,-3,15,1
405618,3,21,20,1,10,0
319934,2,23,7,16,6,0
314899,2,0,0,0,4,0
76429,4,29,12,17,1,1
95144,3,16,17,-1,9,1
344020,4,23,9,14,17,1
109565,2,9,7,2,16,1
247049,1,0,3,-3,8,1
108123,4,13,35,-22,15,0
195204,2,10,3,7,2,1
127043,4,24,23,1,6,1
90540,1,7,0,7,7,0
159442,4,20,20,0,3,0
359422,1,0,0,0,6,0
341078,3,7,17,-10,15,0
391076,1,0,7,-7,4,1
143611,2,10,3,7,14,1
235265,3,15,6,9,3,1
14565,1,0,7,-7,7,1
214230,1,0,10,-10,11,1
50103,2,0,17,-17,6,1
12109,2,7,7,0,6,0
344428,4,28,24,4,17,1
288543,2,20,28,-8,9,0
282863,4,9,23,-14,6,1
6686,3,3,20,-17,3,0
70024,3,24,10,14,15,0
19458,3,17,17,0,10,1
106191,4,0,10,-10,14,1
177838,2,14,10,4,12,1
323857,4,16,23,-7,8,0
159023,1,0,0,0,3,0
44432,3,17,0,17,3,0
379535,1,6,3,3,16,1
265759,2,3,3,0,16,1
182725,4,27,26,1,14,0
48911,3,15,7,8,5,1
27956,3,20,17,3,13,1
360696,1,0,7,-7,7,1
8469,2,15,0,15,4,0
69265,2,13,0,13,15,0
139120,2,9,6,3,12,1
357229,2,0,3,-3,5,1
264834,4,24,37,-13,16,1
198371,4,20,14,6,3,0
307401,1,0,0,0,17,0
406815,3,0,20,-20,11,1
26898,3,10,6,4,13,0
379699,1,3,0,3,16,0
291968,1,0,0,0,11,1
313545,2,0,10,-10,3,0
402822,1,0,0,0,9,1
116320,3,24,13,11,1,1
279142,4,21,20,1,5,0
300403,1,0,0,0,14,1
343607,2,15,7,8,17,0
359498,3,0,21,-21,6,0
363328,4,36,21,15,8,1
260063,2,3,7,-4,14,0
335124,2,10,0,10,13,0
164599,2,7,10,-3,5,1
149365,2,3,6,-3,16,1
303924,3,14,24,-10,16,0
259994,4,23,20,3,14,1
45379,4,20,16,4,4,0
343888,4,26,6,20,17,0
224213,4,0,23,-23,15,0
246787,3,3,13,-10,8,1
321667,4,27,27,0,7,1
44082,2,0,6,-6,3,0
339756,3,24,6,18,15,0
413907,4,17,9,8,14,1
118265,2,12,7,5,2,0
35676,4,23,10,13,17,1
202996,2,14,0,14,5,0
194374,4,26,6,20,2,0
144961,1,0,0,0,14,0
113264,2,7,14,-7,17,1
100942,2,10,3,7,12,1
259138,2,14,7,7,13,1
169782,2,0,14,-14,8,1
269558,4,21,31,-10,1,0
13107,1,0,0,0,6,1
90877,2,31,0,31,7,1
369933,4,16,22,-6,12,1
296452,2,14,0,14,13,1
61568,3,28,7,21,11,0
126172,2,13,3,10,6,1
74717,4,7,17,-10,17,1
166934,4,13,6,7,6,1
167873,3,14,16,-2,7,0
417150,1,0,10,-10,16,0
280216,1,0,0,0,5,1
317389,3,7,10,-3,5,1
262214,1,0,0,0,15,1
139669,1,0,0,0,12,0
395267,4,10,16,-6,5,0
341774,1,0,0,0,16,0
72739,1,7,0,7,16,1
139243,2,10,6,4,12,1
39509,4,13,19,-6,1,1
124442,3,9,7,2,5,0
138479,3,24,27,-3,12,1
307062,3,24,0,24,17,1
264529,2,7,14,-7,16,1
277907,4,7,20,-13,4,1
299684,2,14,3,11,14,1
116484,4,6,19,-13,1,1
315462,1,0,0,0,4,1
204684,1,7,7,0,6,1
9438,2,10,0,10,5,0
271069,4,28,34,-6,1,1
157554,2,2,0,2,2,1
43659,2,14,9,5,3,0
241569,3,3,13,-10,5,0
316727,1,7,0,7,4,1
227797,4,6,21,-15,16,1
56893,2,27,0,27,9,0
230230,1,6,0,6,17,1
268629,3,13,13,0,17,1
368409,2,14,7,7,11,0
164794,4,26,21,5,6,1
182794,2,19,3,16,14,0
173001,2,14,0,14,9,0
393537,2,7,9,-2,5,1
303384,1,7,0,7,16,1
944,3,0,3,-3,1,1
366450,3,34,10,24,10,0
228915,1,7,9,-2,17,1
208228,4,6,10,-4,8,0
368592,4,16,6,10,11,0
197821,1,6,0,6,3,0
11740,4,30,30,0,6,0
371448,2,14,14,0,12,0
55995,3,10,20,-10,9,0
156351,3,24,0,24,2,0
261798,1,0,7,-7,14,1
2250,3,10,10,0,1,0
251005,4,3,6,-3,10,1
319404,1,0,0,0,6,0
91353,3,14,7,7,8,0
397372,4,17,24,-7,6,0
112863,2,7,3,4,17,1
55162,4,29,17,12,8,0
59752,2,6,10,-4,11,1
293805,3,17,6,11,12,1
226771,4,7,20,-13,16,0
329584,1,10,0,10,11,0
214092,2,3,3,0,11,1
180466,2,14,7,7,13,0
314684,4,17,21,-4,3,0
38778,2,0,9,-9,1,0
266124,4,17,13,4,16,0
197818,1,6,0,6,3,1
171335,3,10,3,7,9,0
229214,1,3,0,3,17,0
90754,3,17,7,10,7,1
191426,4,0,31,-31,17,1
95577,3,9,10,-1,10,1
330656,2,6,0,6,11,0
281269,1,7,3,4,6,0
40598,2,24,7,17,2,0
300966,4,24,27,-3,15,1
123498,2,7,0,7,4,0
49334,2,7,10,-3,6,0
238181,2,3,16,-13,4,0
318129,2,9,7,2,5,0
31674,4,24,16,8,15,1
10260,4,13,10,3,5,0
353898,3,17,28,-11,4,0
9296,2,7,0,7,5,0
349682,2,7,7,0,2,1
28549,3,27,7,20,14,0
177006,4,26,13,13,11,0
72976,4,38,15,23,16,1
89163,1,0,0,0,7,1
240581,1,3,0,3,5,0
334110,2,16,0,16,13,0
274348,1,3,7,-4,3,0
311020,2,10,0,10,2,0
248465,3,10,6,4,8,1
85026,2,25,16,9,4,1
156258,5,24,23,1,2,1
68204,2,7,14,-7,14,0
364421,3,35,14,21,9,0
209494,1,7,3,4,8,1
214663,4,17,16,1,11,0
2807,2,21,21,0,2,1
380353,2,10,7,3,16,0
88121,1,0,0,0,6,0
5406,3,20,16,4,3,1
221297,3,6,29,-23,14,0
287503,3,14,26,-12,9,0
19047,4,7,6,1,10,0
69138,3,14,10,4,15,0
383009,4,10,24,-14,17,0
17660,2,7,3,4,9,1
279388,2,13,21,-8,5,1
28181,1,3,0,3,13,1
48855,2,6,0,6,5,0
11199,2,7,7,0,6,0
333720,4,21,6,15,12,0
98331,4,35,27,8,11,0
133178,3,13,17,-4,9,0
268172,3,9,17,-8,17,1
277704,2,7,0,7,4,0
132121,2,10,3,7,9,1
220128,3,26,13,13,13,1
222797,3,10,10,0,14,1
190988,3,12,3,9,17,1
186530,4,24,33,-9,15,0
110839,5,13,13,0,16,0
108596,4,26,21,5,15,1
259550,1,0,0,0,13,1
35234,4,0,17,-17,16,0
164219,3,27,35,-8,5,0
78625,4,30,13,17,2,0
157762,3,17,10,7,2,0
167598,1,0,0,0,7,1
390658,2,3,3,0,3,0
388052,4,20,9,11,2,1
47617,1,3,14,-11,5,1
283533,1,6,7,-1,7,0
403039,3,21,24,-3,9,0
337068,3,19,0,19,14,1
211084,4,37,0,37,9,1
150239,4,12,26,-14,16,0
335937,1,0,3,-3,13,0
107081,3,40,0,40,15,0
301686,4,17,6,11,15,1
407183,4,17,34,-17,11,1
53872,2,7,7,0,8,0
228321,2,0,7,-7,17,1
307918,2,0,0,0,1,1
143464,2,14,7,7,14,0
101341,1,3,0,3,12,1
184504,2,14,14,0,14,1
121235,4,21,27,-6,3,0
68205,2,7,14,-7,14,0
162873,4,13,3,10,5,0
305416,3,20,3,17,17,0
203415,1,0,0,0,6,1
328040,4,17,9,8,10,0
9283,1,7,0,7,5,0
18384,1,0,0,0,9,1
212286,2,7,3,4,10,0
250716,1,0,0,0,10,1
53765,4,10,10,0,8,1
115066,1,3,0,3,1,0
250064,4,17,13,4,9,1
148536,4,24,10,14,16,0
140843,1,7,0,7,13,1
268331,3,20,3,17,17,1
101627,4,13,38,-25,12,1
388857,1,3,7,-4,3,1
310488,3,20,9,11,2,0
100076,3,6,6,0,12,0
99574,1,0,0,0,11,0
365446,3,10,19,-9,9,1
399141,1,0,3,-3,7,1
196129,3,24,21,3,2,0
1666,2,0,0,0,1,1
37037,1,10,0,10,17,1
180944,3,17,7,10,13,0
153897,3,7,6,1,1,0
148822,4,13,23,-10,16,1
185472,4,24,20,4,15,0
2998,3,13,31,-18,2,1
183604,1,0,0,0,14,0
360222,4,20,13,7,7,0
227806,4,6,28,-22,16,1
324760,4,26,7,19,8,0
210709,1,14,0,14,9,0
326798,2,3,14,-11,9,1
271429,2,14,0,14,1,1
361244,3,14,26,-12,7,1
238877,4,41,14,27,4,1
183320,4,22,20,2,14,0
321280,2,9,10,-1,6,0
385715,1,0,0,0,1,1
341145,1,0,0,0,16,0
191294,4,10,17,-7,17,1
111127,4,31,10,21,16,0
133314,2,7,3,4,9,1
105150,4,39,14,25,14,1
202534,1,7,3,4,5,0
357017,4,26,9,17,5,0
202349,4,20,13,7,5,1
203249,4,17,24,-7,5,0
56125,2,17,14,3,9,1
51423,2,3,10,-7,7,0
210624,3,13,17,-4,9,1
340002,2,14,6,8,15,1
317257,4,7,16,-9,5,1
102917,2,6,21,-15,13,1
359341,3,3,13,-10,6,0
65511,4,23,14,9,13,1
177312,4,20,20,0,11,0
245302,3,16,3,13,7,0
112523,2,10,9,1,17,0
252370,4,0,22,-22,10,0
266459,2,0,9,-9,16,0
230964,1,0,0,0,1,0
344826,3,20,10,10,17,1
385138,3,14,17,-3,1,0
176182,3,14,14,0,11,0
353450,4,25,12,13,4,1
202363,4,20,13,7,5,0
286726,3,20,7,13,8,0
359395,4,13,23,-10,6,1
51035,3,0,17,-17,6,0
50720,2,7,14,-7,6,1
330830,2,10,17,-7,11,0
214967,1,0,0,0,11,1
127347,3,10,20,-10,6,1
319047,4,13,26,-13,5,0
83973,2,14,0,14,4,1
377806,1,7,0,7,15,0
332425,2,7,3,4,12,1
58842,1,0,0,0,10,1
132390,2,0,7,-7,9,1
256193,1,0,0,0,12,1
156957,3,7,10,-3,2,1
235191,1,2,0,2,3,1
323450,1,0,3,-3,7,1
368726,3,7,16,-9,11,0
90082,1,0,0,0,7,1
127576,1,0,6,-6,6,0
396649,1,0,0,0,6,1
384234,1,6,0,6,1,0
177489,4,27,17,10,11,0
88157,2,7,10,-3,6,1
3095,1,0,3,-3,2,0
52000,1,3,7,-4,7,0
11457,1,0,7,-7,6,1
45482,3,27,17,10,4,0
405698,1,10,0,10,10,1
56381,1,0,7,-7,9,1
35325,3,16,0,16,16,0
182916,2,0,30,-30,14,0
308099,2,13,13,0,1,0
16224,2,3,3,0,8,0
317500,3,10,17,-7,5,0
29685,1,0,0,0,14,1
183638,2,0,8,-8,14,1
73687,4,13,9,4,17,1
14216,4,0,38,-38,7,1
395836,3,3,17,-14,6,1
33125,3,10,28,-18,16,0
19486,4,24,17,7,10,1
359314,2,3,13,-10,6,1
21943,1,7,0,7,11,1
222026,2,14,3,11,14,0
106977,4,22,6,16,14,0
356342,3,24,0,24,5,0
109294,3,6,3,3,15,1
17675,2,14,6,8,9,0
184309,4,37,14,23,14,1
79661,4,24,21,3,2,0
342492,4,27,3,24,16,0
154680,1,0,0,0,1,1
84134,2,7,0,7,4,1
106921,3,12,3,9,14,1
340360,3,17,10,7,15,0
10536,3,34,0,34,5,0
64854,2,7,0,7,13,0
33569,4,17,10,7,16,1
81066,1,0,7,-7,3,1
350347,3,24,3,21,2,0
375325,2,7,14,-7,14,1
263120,1,0,7,-7,15,1
342088,2,3,3,0,16,1
393319,4,30,29,1,5,1
302378,3,16,13,3,15,1
35382,4,23,23,0,16,1
369875,3,7,9,-2,12,0
213377,2,10,20,-10,10,1
410490,4,9,26,-17,13,1
319002,2,6,16,-10,5,1
50786,4,24,21,3,6,0
116251,1,10,0,10,1,0
271282,2,6,7,-1,1,0
146263,3,3,30,-27,15,1
208765,2,3,9,-6,8,1
73718,4,20,12,8,17,1
367484,4,36,31,5,10,1
8429,1,3,0,3,4,0
85782,2,13,7,6,5,1
403478,3,17,12,5,9,0
133625,3,10,14,-4,9,1
63154,2,14,10,4,12,0
314925,3,0,9,-9,4,0
111838,3,6,10,-4,17,1
185267,3,24,9,15,15,0
316715,1,7,0,7,4,0
148983,3,13,12,1,16,1
117699,4,27,20,7,2,1
126984,2,10,10,0,6,1
216261,4,24,20,4,12,0
357788,1,3,7,-4,6,0
356632,1,0,3,-3,5,1
284830,4,29,27,2,7,1
348277,4,16,46,-30,1,0
271691,1,6,3,3,2,0
226864,2,0,7,-7,16,1
334399,3,10,10,0,13,1
305353,1,7,3,4,17,1
107273,1,0,0,0,15,0
127549,1,0,0,0,6,0
352235,2,3,3,0,3,1
302096,3,20,27,-7,15,1
417217,3,17,17,0,16,0
307954,2,7,6,1,1,0
45333,3,20,16,4,4,0
343326,2,0,10,-10,16,0
202870,2,14,0,14,5,1
99338,3,20,3,17,11,0
258143,3,13,13,0,13,0
17547,3,13,3,10,9,0
191776,1,0,0,0,1,0
241265,3,3,0,3,5,0
41101,4,3,19,-16,2,1
71459,3,30,7,23,16,1
374223,1,0,0,0,13,1
254519,4,29,13,16,11,0
249157,5,28,28,0,9,0
231886,2,7,27,-20,1,1
111575,4,35,18,17,16,0
122435,2,6,26,-20,4,1
23632,2,7,13,-6,12,1
410659,1,0,0,0,13,0
37856,1,0,0,0,1,1
290727,4,44,25,19,10,1
8660,4,7,10,-3,4,0
89085,3,13,6,7,6,1
4177,1,7,3,4,2,0
363093,2,7,3,4,8,1
183207,1,0,0,0,14,1
260371,3,6,0,6,14,1
384241,1,6,0,6,1,1
363534,3,3,5,-2,8,1
308804,1,0,3,-3,1,1
112605,3,31,34,-3,17,1
149726,3,34,0,34,16,0
214958,4,7,26,-19,11,1
385144,3,14,17,-3,1,0
266038,2,10,0,10,16,0
158343,2,13,17,-4,3,1
415913,3,10,23,-13,15,0
411526,4,13,31,-18,13,1
90628,3,17,27,-10,7,0
128255,4,20,7,13,7,1
354181,2,3,7,-4,4,1
365064,4,23,9,14,9,1
382194,1,0,3,-3,17,1
269518,3,13,17,-4,1,0
283655,4,23,33,-10,7,1
350921,3,3,14,-11,3,0
48456,4,17,20,-3,5,1
8759,2,6,0,6,4,0
309531,2,6,0,6,1,0
185393,2,0,10,-10,15,1
197039,4,23,33,-10,3,1
269004,1,0,3,-3,17,1
111288,4,17,16,1,16,0
218334,3,17,23,-6,12,0
191225,2,0,17,-17,17,1
32330,1,7,0,7,15,0
299216,1,3,0,3,14,1
381336,1,6,0,6,16,0
353931,4,23,28,-5,4,0
161929,3,13,9,4,4,0
376553,3,15,6,9,14,0
147114,2,17,31,-14,15,1
382537,3,0,10,-10,17,0
63833,1,0,0,0,12,0
187618,4,13,37,-24,16,1
391913,4,23,27,-4,4,1
389669,3,24,16,8,3,1
144888,3,14,7,7,14,1
262798,4,35,17,18,15,1
228314,1,0,7,-7,17,1
281965,3,14,14,0,6,0
67354,3,20,6,14,14,1
369082,1,3,0,3,11,0
238691,3,16,17,-1,4,0
279795,1,7,3,4,5,1
14053,3,3,24,-21,7,1
28125,4,27,10,17,13,0
131031,4,17,30,-13,8,0
346513,2,17,30,-13,1,1
330429,4,13,20,-7,11,0
132741,3,13,17,-4,9,1
150080,4,34,12,22,16,0
226421,2,0,7,-7,16,0
1220,2,10,6,4,1,1
248527,4,23,20,3,8,0
76999,4,17,20,-3,1,1
319356,4,16,28,-12,6,1
400721,4,16,17,-1,8,1
135276,4,24,17,7,10,0
126950,1,3,7,-4,6,0
278648,3,14,3,11,4,1
148590,2,0,6,-6,16,1
205989,3,13,10,3,7,1
411814,4,0,34,-34,13,1
140780,4,22,21,1,12,0
274796,5,24,23,1,3,0
85004,2,25,7,18,4,0
304717,4,21,14,7,16,0
68953,2,14,7,7,15,0
85030,2,25,16,9,4,0
288660,2,0,7,-7,9,0
414736,3,3,17,-14,14,1
19579,3,14,21,-7,10,1
170702,2,14,6,8,8,1
393130,4,24,3,21,4,0
296020,2,3,7,-4,13,0
135539,3,14,6,8,10,0
31204,3,23,27,-4,15,0
66011,1,6,0,6,13,1
54767,2,10,0,10,8,0
12505,1,0,14,-14,6,0
242076,4,17,16,1,5,1
256476,4,19,24,-5,12,0
227718,2,0,0,0,16,1
127218,4,13,16,-3,6,1
400037,1,7,3,4,8,1
107638,3,13,20,-7,15,0
256852,1,0,3,-3,12,1
398328,2,3,10,-7,7,0
7008,4,13,7,6,3,0
59400,4,0,16,-16,11,1
217388,4,21,13,8,12,1
197106,2,7,17,-10,3,1
15193,2,6,0,6,8,1
165017,1,7,10,-3,6,1
396924,4,34,27,7,6,0
418589,2,14,10,4,16,1
288393,3,10,0,10,9,1
299766,4,17,14,3,14,1
32465,1,7,0,7,15,0
284030,3,3,3,0,7,1
237858,3,7,27,-20,4,1
81370,2,0,7,-7,3,1
67307,2,14,3,11,14,0
91876,4,30,13,17,8,0
287941,2,14,13,1,9,1
305874,3,7,14,-7,17,1
356504,3,6,3,3,5,0
22429,2,17,24,-7,11,0
282522,3,17,3,14,6,0
303499,4,25,17,8,16,1
229547,2,17,6,11,17,0
393742,3,7,7,0,5,1
135776,1,0,7,-7,10,0
354566,1,0,0,0,4,0
410965,1,0,0,0,13,0
170336,4,0,15,-15,8,1
265520,4,14,10,4,16,1
372676,4,21,17,4,13,0
80110,4,24,22,2,2,0
338525,3,20,17,3,14,1
25537,2,17,7,10,12,0
393113,3,24,3,21,4,0
41991,1,0,0,0,2,1
219303,2,10,7,3,13,1
32676,2,7,0,7,15,1
88670,4,23,13,10,6,0
240964,3,21,9,12,5,0
345424,3,0,13,-13,17,1
287322,2,6,0,6,8,1
275143,2,7,10,-3,3,1
91460,2,9,0,9,8,0
278705,4,24,10,14,4,0
108693,3,27,13,14,15,0
211590,4,42,21,21,9,0
156202,4,14,10,4,2,0
9300,2,7,0,7,5,0
367591,3,28,12,16,10,0
388393,1,0,0,0,2,0
221457,3,3,38,-35,14,0
67640,3,7,35,-28,14,1
52603,1,0,0,0,7,1
10344,2,10,28,-18,5,0
296608,2,3,7,-4,13,0
318028,4,17,16,1,5,1
88139,1,0,3,-3,6,1
314801,3,21,7,14,4,1
187908,1,0,0,0,16,1
215178,2,7,9,-2,11,0
333446,1,0,0,0,12,0
397503,4,20,22,-2,6,0
312217,2,7,14,-7,2,0
106850,1,0,0,0,14,0
272801,1,7,0,7,2,0
74459,1,0,0,0,17,1
2908,1,0,0,0,2,0
163548,2,7,6,1,5,1
401010,4,22,15,7,8,1
358179,4,20,9,11,6,0
365526,1,0,0,0,9,1
161049,1,0,0,0,4,0
26057,4,13,19,-6,13,0
100905,1,7,3,4,12,0
38376,2,14,9,5,1,0
252941,3,9,0,9,11,0
268289,2,17,3,14,17,0
89575,3,7,27,-20,7,1
346394,3,9,13,-4,1,1
410,3,38,20,18,1,0
181680,1,0,0,0,13,0
275498,3,20,24,-4,3,1
68471,1,0,7,-7,14,1
313921,4,28,26,2,3,0
200718,2,7,0,7,4,0
363471,1,0,0,0,8,1
178857,4,27,14,13,12,0
183317,4,22,20,2,14,1
279062,1,13,0,13,5,1
107012,1,7,0,7,15,1
238262,4,10,24,-14,4,0
215182,2,7,9,-2,11,0
294732,4,13,27,-14,12,1
360179,3,17,13,4,7,1
195312,1,0,0,0,2,1
351623,1,0,7,-7,3,1
323093,3,26,14,12,7,0
234237,4,20,17,3,2,0
347358,4,14,21,-7,1,0
259144,2,14,7,7,13,1
101506,1,10,0,10,12,0
47436,5,13,13,0,5,1
67132,1,0,0,0,14,0
144463,4,10,33,-23,14,1
44657,4,23,31,-8,3,1
165655,2,0,7,-7,6,0
81097,2,3,14,-11,3,1
139494,1,0,0,0,12,1
86709,3,17,7,10,5,0
211931,1,0,3,-3,9,1
310327,3,26,0,26,2,1
124615,4,13,17,-4,5,0
392122,1,0,13,-13,4,1
404069,3,10,49,-39,10,1
213191,2,3,10,-7,10,1
41976,4,38,6,32,2,1
358289,3,0,20,-20,6,1
176550,4,19,17,2,11,0
168652,4,17,16,1,7,1
378922,4,13,30,-17,15,1
394931,4,7,17,-10,5,0
362245,4,12,17,-5,8,1
9660,3,12,28,-16,5,1
130976,3,10,24,-14,8,0
71601,2,3,17,-14,16,0
262170,4,28,6,22,15,0
404912,2,3,10,-7,10,1
230646,1,0,0,0,1,0
105424,4,23,24,-1,14,1
340876,1,0,3,-3,15,1
153713,2,2,21,-19,1,0
106755,3,17,15,2,14,0
88594,2,10,7,3,6,0
331233,1,0,0,0,11,1
137856,2,10,6,4,11,1
311168,1,3,0,3,2,1
272034,2,7,3,4,2,1
122000,3,16,7,9,4,0
46378,4,6,17,-11,4,1
114880,4,24,33,-9,1,0
2607,4,10,27,-17,2,1
21426,2,9,14,-5,11,1
333684,3,14,0,14,12,0
366436,3,26,10,16,10,1
263837,4,7,24,-17,15,1
52952,2,14,14,0,7,0
96243,4,3,29,-26,10,1
257035,2,0,14,-14,12,1
23219,3,23,13,10,11,1
323645,2,13,0,13,8,1
301172,2,13,11,2,15,0
363859,3,13,26,-13,8,0
154442,2,14,7,7,1,0
271099,1,0,7,-7,1,0
157276,3,13,3,10,2,1
61068,1,0,0,0,11,0
114433,4,41,20,21,1,1
24748,4,20,27,-7,12,0
57554,4,31,16,15,10,0
224312,3,9,12,-3,15,1
315356,2,10,10,0,4,1
666,3,0,10,-10,1,0
85709,4,24,21,3,5,0
134750,2,17,3,14,10,0
120742,3,23,0,23,3,0
75190,4,13,6,7,17,0
275230,4,17,29,-12,3,1
361826,3,37,10,27,7,1
373119,4,10,21,-11,13,1
8627,2,7,10,-3,4,0
10216,3,6,3,3,5,0
50658,1,0,0,0,6,0
331923,4,6,22,-16,12,1
19423,2,17,7,10,10,0
97520,2,16,0,16,10,0
108085,3,13,21,-8,15,1
33199,1,7,0,7,16,1
209812,1,7,7,0,8,0
198339,3,20,14,6,3,0
205252,4,23,13,10,6,1
265057,2,10,3,7,16,1
334202,1,0,0,0,13,1
64610,3,20,14,6,13,1
269155,5,19,16,3,17,1
244526,3,25,13,12,7,1
6623,1,0,0,0,3,0
366128,2,7,21,-14,10,0
214165,4,12,9,3,11,1
167751,4,26,23,3,7,1
286049,2,10,0,10,8,0
163788,4,16,12,4,5,1
246599,1,7,3,4,8,1
22204,4,10,15,-5,11,1
315655,2,3,7,-4,4,1
199606,4,41,17,24,4,1
190381,2,7,0,7,17,0
169382,3,6,21,-15,8,1
354529,4,33,28,5,4,0
386997,4,14,21,-7,2,0
330960,1,9,7,2,11,0
21624,4,7,38,-31,11,0
7194,1,0,0,0,4,0
118960,2,0,17,-17,3,0
413427,3,3,37,-34,14,0
52357,2,3,16,-13,7,0
23342,3,9,10,-1,11,0
252625,2,6,3,3,10,0
138535,4,31,37,-6,12,1
74931,1,10,0,10,17,0
417051,2,17,0,17,15,0
373080,3,3,13,-10,13,0
119026,4,7,33,-26,3,1
257016,2,0,7,-7,12,1
96296,2,0,16,-16,10,1
260989,4,10,3,7,14,0
133692,4,32,35,-3,9,1
408612,2,21,0,21,12,1
21876,3,21,0,21,11,0
360615,3,7,10,-3,7,0
285699,5,27,27,0,8,0
164575,1,0,0,0,5,0
405767,3,10,14,-4,10,0
134759,2,17,3,14,10,1
131147,4,27,12,15,8,0
28480,1,10,0,10,14,1
64689,2,14,0,14,13,0
117018,2,0,10,-10,2,0
56610,4,26,17,9,9,0
295069,1,0,0,0,12,0
386956,3,7,21,-14,2,1
397952,4,10,17,-7,7,0
252512,3,17,25,-8,10,1
404656,3,20,22,-2,10,1
385060,1,0,0,0,1,0
268387,1,0,0,0,17,1
241457,4,10,42,-32,5,0
229025,4,23,16,7,17,1
113714,2,3,10,-7,17,1
205946,2,6,3,3,7,0
215730,1,16,0,16,11,0
317070,3,14,17,-3,4,1
224281,2,6,9,-3,15,1
192819,3,0,15,-15,1,0
42695,4,7,13,-6,3,1
353999,1,0,0,0,4,1
387517,2,3,0,3,2,0
32737,4,7,24,-17,15,0
309163,3,35,3,32,1,1
22811,4,13,21,-8,11,1
111138,4,31,10,21,16,1
125658,4,21,24,-3,5,1
255072,3,6,21,-15,12,0
335024,3,16,10,6,13,0
260688,4,10,25,-15,14,1
289386,4,31,25,6,9,0
342572,3,12,13,-1,16,1
204118,2,3,10,-7,6,0
148238,4,18,31,-13,16,1
162386,3,10,13,-3,4,0
162089,3,35,13,22,4,1
398047,2,14,21,-7,7,1
247950,1,0,0,0,8,0
35801,3,3,10,-7,17,0
318293,3,6,7,-1,5,1
206147,4,20,19,1,7,1
2805,2,21,21,0,2,1
78178,3,27,3,24,2,1
96646,4,3,10,-7,10,0
134014,2,6,0,6,9,0
407871,2,6,7,-1,11,0
40779,3,17,28,-11,2,0
293789,2,17,3,14,12,0
323844,3,16,15,1,8,0
138865,4,12,47,-35,12,1
278707,4,24,10,14,4,1
211553,4,42,21,21,9,0
407133,3,10,20,-10,11,0
112887,3,10,6,4,17,1
318480,4,31,7,24,5,1
59992,4,3,31,-28,11,1
181749,3,7,13,-6,13,0
336701,2,3,3,0,14,1
254062,4,14,23,-9,11,1
10928,2,6,14,-8,5,1
213850,3,45,7,38,10,1
344894,1,0,7,-7,17,0
382871,4,35,3,32,17,1
309233,2,0,7,-7,1,0
326427,1,0,0,0,9,0
366200,4,14,51,-37,10,0
319588,1,3,0,3,6,0
55577,3,24,7,17,9,0
115140,3,10,20,-10,1,1
304835,3,3,3,0,16,1
244496,2,25,3,22,7,0
298734,4,22,27,-5,14,0
69901,4,27,16,11,15,0
410620,4,17,17,0,13,0
9386,4,31,14,17,5,1
201751,1,3,0,3,5,1
291285,3,14,19,-5,10,1
258673,1,0,7,-7,13,1
244999,3,0,27,-27,7,0
152315,1,7,0,7,17,0
389520,3,20,10,10,3,0
341223,3,13,7,6,16,1
184827,3,24,20,4,15,1
221250,2,0,16,-16,14,0
363426,3,28,21,7,8,0
223361,2,0,12,-12,15,0
398183,2,7,10,-3,7,1
360503,4,17,14,3,7,1
11781,1,7,0,7,6,1
231250,1,0,0,0,1,0
158991,4,21,29,-8,3,1
348870,3,6,14,-8,2,0
247886,3,10,3,7,8,1
160272,1,3,0,3,4,1
217969,1,7,0,7,12,0
304014,1,0,13,-13,16,0
175315,4,22,19,3,10,1
136612,3,15,16,-1,11,1
204220,1,0,7,-7,6,0
146951,2,14,0,14,15,1
38559,3,31,6,25,1,0
135761,1,0,7,-7,10,1
6893,1,0,0,0,3,1
421390,2,13,20,-7,17,1
224992,4,10,22,-12,15,1
19436,2,17,14,3,10,0
89981,2,2,14,-12,7,1
51484,3,27,24,3,7,1
39034,4,37,24,13,1,0
419378,4,3,26,-23,16,1
201373,4,28,15,13,5,0
63121,1,7,10,-3,12,0
349578,2,6,28,-22,2,0
187509,2,3,10,-7,16,1
372552,5,29,27,2,13,0
173172,3,10,17,-7,9,0
169270,4,23,6,17,7,1
149125,3,17,24,-7,16,1
170942,4,31,20,11,8,1
8296,1,0,0,0,4,0
221460,3,3,38,-35,14,0
182608,2,0,6,-6,14,0
91022,2,6,0,6,7,0
149681,2,20,0,20,16,0
7932,3,3,20,-17,4,1
313517,1,0,0,0,3,0
337347,3,14,7,7,14,0
209753,4,16,6,10,8,0
258215,1,0,0,0,13,1
243339,4,14,30,-16,6,1
106444,2,16,0,16,14,0
129177,1,7,0,7,7,0
95688,3,10,6,4,10,1
110059,4,48,16,32,16,0
147369,2,0,6,-6,15,0
102695,4,32,28,4,13,0
113171,3,41,7,34,17,0
40265,2,3,0,3,2,1
124801,1,0,3,-3,5,0
348456,1,0,0,0,2,1
135543,3,14,6,8,10,1
62766,3,17,0,17,12,0
228531,3,20,7,13,17,1
97074,2,19,6,13,10,0
402213,1,0,0,0,9,1
286801,1,0,0,0,8,1
281438,2,0,10,-10,6,0
47400,4,10,13,-3,5,0
242590,2,3,0,3,6,1
300064,4,7,40,-33,14,0
411490,3,13,17,-4,13,0
250503,3,16,7,9,9,0
257747,4,3,24,-21,13,0
418989,2,7,7,0,16,0
157179,1,0,0,0,2,0
241404,3,7,28,-21,5,0
77875,4,17,31,-14,1,0
322026,2,6,0,6,7,0
54043,2,10,0,10,8,0
181954,1,0,0,0,13,1
411974,4,20,17,3,13,1
147942,4,31,41,-10,15,1
157463,4,16,31,-15,2,1
207795,4,27,16,11,7,1
223674,2,13,6,7,15,0
16839,4,26,31,-5,8,1
48583,3,14,17,-3,5,1
103986,4,6,13,-7,13,1
47565,4,37,6,31,5,1
375636,3,17,17,0,14,1
104663,4,7,3,4,14,1
215194,2,7,9,-2,11,0
246017,2,7,3,4,7,0
356044,3,24,10,14,5,0
179865,2,3,9,-6,13,1
9949,3,3,3,0,5,1
246238,4,21,16,5,7,1
324311,4,25,7,18,8,0
188777,4,0,20,-20,16,0
191140,4,28,27,1,17,1
137493,1,7,0,7,11,0
226617,3,10,3,7,16,0
114107,3,21,7,14,17,0
355029,4,10,26,-16,4,1
249566,3,14,13,1,9,1
313112,1,0,3,-3,3,1
950,3,0,3,-3,1,0
185005,4,14,20,-6,15,0
373087,3,3,14,-11,13,0
408473,3,7,3,4,12,0
380839,4,9,24,-15,16,1
2331,1,0,0,0,2,0
118485,1,0,0,0,2,1
384405,2,14,0,14,1,1
64881,3,10,3,7,13,1
276417,4,32,44,-12,3,1
122115,2,10,14,-4,4,1
40251,1,0,0,0,2,1
213586,4,23,14,9,10,0
279789,1,7,3,4,5,0
252906,2,6,0,6,11,1
241363,2,7,7,0,5,1
273281,2,14,0,14,2,0
80570,4,16,10,6,3,1
256338,1,0,0,0,12,1
333556,3,16,10,6,12,0
35375,4,23,16,7,16,0
91564,4,26,10,16,8,0
346080,3,10,6,4,1,1
371954,1,0,0,0,13,1
224071,4,14,9,5,15,0
6883,4,10,31,-21,3,0
381075,2,14,14,0,16,1
285513,1,0,0,0,8,0
319412,1,0,0,0,6,0
313213,4,23,16,7,3,1
24792,1,6,0,6,12,0
31528,4,3,17,-14,15,1
274200,2,10,0,10,3,0
387475,4,21,16,5,2,1
339344,4,45,7,38,15,1
298345,1,0,7,-7,14,1
190494,2,7,0,7,17,1
256505,1,0,0,0,12,1
230291,3,19,10,9,17,0
336711,2,3,3,0,14,1
361699,4,10,39,-29,7,1
2684,2,6,7,-1,2,1
235585,3,27,13,14,3,1
337012,2,13,0,13,14,0
407646,4,10,17,-7,11,1
50221,1,7,7,0,6,0
363115,3,7,3,4,8,1
288815,2,10,14,-4,9,0
28175,1,3,0,3,13,0
186343,3,29,10,19,15,0
214632,4,3,16,-13,11,0
37862,1,0,0,0,1,0
402097,2,6,0,6,9,0
289724,2,0,7,-7,10,1
294016,1,0,0,0,12,1
228243,4,10,27,-17,17,1
80722,4,40,33,7,3,1
299418,2,0,20,-20,14,0
86532,2,13,3,10,5,1
145732,1,0,10,-10,15,1
39122,3,13,10,3,1,1
67154,2,0,0,0,14,1
390468,4,27,33,-6,3,1
146973,2,17,0,17,15,1
73127,4,13,17,-4,16,1
73147,1,0,0,0,16,1
116145,2,7,3,4,1,0
248543,5,23,26,-3,8,1
417889,4,13,10,3,16,1
22366,4,6,6,0,11,1
367393,2,10,14,-4,10,0
28599,4,33,7,26,14,0
52615,1,0,0,0,7,1
29876,3,9,23,-14,14,1
58618,4,13,17,-4,10,0
145612,2,21,0,21,14,0
30114,2,3,7,-4,14,1
336796,4,10,17,-7,14,1
5936,3,14,23,-9,3,0
310489,3,20,9,11,2,0
85657,2,24,7,17,5,0
90268,2,0,7,-7,7,0
396745,4,7,17,-10,6,0
191695,2,7,17,-10,17,1
339972,1,7,3,4,15,1
198124,1,0,3,-3,3,0
354849,4,33,28,5,4,0
227542,1,0,0,0,16,1
196576,3,20,6,14,2,0
398983,1,0,2,-2,7,1
303582,2,21,13,8,16,1
389846,4,24,6,18,3,0
158184,2,10,0,10,3,0
213153,1,0,0,0,10,1
394415,1,0,3,-3,5,0
26891,2,10,6,4,13,0
100477,2,7,10,-3,12,0
25443,4,13,17,-4,12,1
205672,3,17,12,5,7,0
5386,3,13,13,0,3,0
24469,1,0,0,0,12,1
152833,4,21,18,3,17,1
153906,4,7,6,1,1,1
181867,3,21,14,7,13,0
413354,1,0,0,0,14,1
311094,3,10,3,7,2,1
326612,2,10,3,7,9,0
65515,4,30,14,16,13,0
396172,4,24,23,1,6,0
153887,3,7,3,4,1,1
35932,3,3,0,3,17,1
369705,2,22,17,5,11,0
109895,3,23,0,23,16,0
140560,1,7,7,0,12,1
155015,1,6,12,-6,1,1
130074,4,17,30,-13,8,0
312496,2,13,0,13,3,1
151918,3,20,10,10,17,0
361892,2,0,0,0,7,0
235455,4,28,32,-4,3,0
305928,5,21,21,0,17,0
19290,2,14,14,0,10,0
218178,3,14,3,11,12,1
63974,1,0,0,0,13,1
290616,1,14,0,14,10,1
390249,3,3,6,-3,3,1
345369,2,0,7,-7,17,0
285466,4,36,8,28,8,0
135999,3,3,10,-7,10,1
42164,1,7,0,7,2,0
210581,2,6,14,-8,9,0
373880,4,34,16,18,13,0
369600,4,14,6,8,11,1
103106,3,34,7,27,13,1
24320,1,0,0,0,12,1
19695,2,3,6,-3,10,0
224422,1,6,3,3,15,0
47874,4,21,13,8,5,0
286906,3,16,7,9,8,0
321814,4,24,9,15,7,0
138438,2,7,7,0,12,1
262849,2,7,20,-13,15,1
52721,4,6,23,-17,7,1
266695,4,39,10,29,16,1
342917,3,23,17,6,16,0
51055,3,3,20,-17,6,0
277521,2,3,7,-4,4,1
282925,1,7,0,7,6,1
43622,1,0,3,-3,3,1
121787,1,0,0,0,4,0
164848,1,0,3,-3,6,1
69685,2,7,7,0,15,0
331594,3,17,23,-6,11,1
105403,3,23,17,6,14,1
29938,1,0,0,0,14,0
45133,2,7,7,0,4,0
99368,4,23,10,13,11,0
411991,1,0,0,0,13,0
238492,2,12,0,12,4,1
299634,4,20,16,4,14,0
288535,2,13,28,-15,9,0
245099,2,14,6,8,7,0
144206,1,0,7,-7,14,1
140707,1,3,14,-11,12,1
102410,1,0,0,0,13,1
153263,2,2,0,2,1,0
133201,3,13,17,-4,9,1
109738,3,13,0,13,16,1
109400,2,3,10,-7,16,1
338549,3,20,31,-11,14,1
181293,4,3,20,-17,13,0
102502,3,31,3,28,13,0
15998,4,18,14,4,8,0
181183,1,0,0,0,13,0
85532,3,17,12,5,5,1
60547,3,30,27,3,11,1
261678,2,7,0,7,14,1
200271,2,10,14,-4,4,1
137855,2,10,6,4,11,1
404182,3,9,7,2,10,0
86718,3,17,14,3,5,0
28396,3,13,3,10,14,1
75943,4,32,7,25,1,0
217794,4,17,13,4,12,0
416944,3,10,7,3,15,1
212972,4,14,7,7,10,1
303211,5,31,31,0,16,1
136075,1,0,0,0,10,0
81860,2,0,21,-21,3,0
272083,3,10,6,4,2,0
171203,3,6,14,-8,8,1
337531,4,7,26,-19,14,1
394753,2,14,0,14,5,0
185109,3,0,13,-13,15,0
224880,1,0,3,-3,15,0
96090,4,16,21,-5,10,0
225287,1,0,7,-7,15,0
371031,2,10,10,0,12,1
334442,4,17,10,7,13,0
374042,4,24,10,14,13,0
254364,4,13,30,-17,11,1
13393,1,0,6,-6,7,0
38064,2,3,0,3,1,0
9156,2,0,13,-13,5,0
367929,1,0,7,-7,11,1
298164,1,0,0,0,14,0
343995,3,22,6,16,17,1
94794,2,3,6,-3,9,0
382286,4,17,3,14,17,1
380999,4,9,14,-5,16,1
93017,3,13,3,10,8,0
243087,3,0,9,-9,6,1
339622,4,24,17,7,15,1
200912,3,27,7,20,4,1
170455,3,21,3,18,8,0
98492,4,31,21,10,11,0
355730,2,7,3,4,5,0
124956,1,0,3,-3,5,1
328176,3,14,14,0,10,0
278906,1,7,7,0,5,0
10116,4,44,7,37,5,1
370228,1,0,0,0,12,0
2544,3,10,7,3,2,1
199406,3,16,10,6,4,0
218819,1,0,0,0,13,0
3681,1,0,0,0,2,0
375036,3,28,27,1,14,0
204333,4,0,17,-17,6,1
309399,2,0,0,0,1,1
372426,2,6,7,-1,13,0
274014,1,0,0,0,3,1
128557,4,21,35,-14,7,1
43891,1,0,0,0,3,0
270912,4,19,20,-1,1,1
77279,4,16,10,6,1,1
24190,2,0,0,0,12,1
250901,1,0,0,0,10,0
106424,2,13,0,13,14,0
349914,3,3,12,-9,2,0
174624,1,3,0,3,10,0
236404,4,14,23,-9,3,0
80637,2,7,16,-9,3,1
156501,3,0,6,-6,2,1
96006,2,6,7,-1,10,1
132651,1,0,3,-3,9,1
39516,1,0,0,0,1,0
219664,3,10,7,3,13,1
105373,2,23,7,16,14,1
186984,4,10,12,-2,15,1
301296,2,14,0,14,15,0
61656,2,7,3,4,12,0
338156,1,7,0,7,14,0
56976,1,0,7,-7,9,1
30976,1,0,0,0,15,1
159065,2,17,0,17,3,0
330441,4,13,20,-7,11,0
421692,2,17,7,10,17,0
38439,4,31,16,15,1,1
362521,3,16,6,10,8,0
30624,3,17,3,14,14,0
136172,4,13,10,3,10,1
33056,1,3,0,3,16,0
413778,4,27,16,11,14,0
117374,3,34,3,31,2,0
71336,3,10,20,-10,16,1
159942,4,45,17,28,3,0
161959,4,13,22,-9,4,0
152597,1,0,0,0,17,0
331599,3,20,23,-3,11,0
301360,3,17,7,10,15,1
220737,4,13,12,1,13,0
173117,1,3,7,-4,9,1
121678,2,14,7,7,4,0
83889,4,23,17,6,4,0
90283,2,0,14,-14,7,1
235180,4,7,20,-13,2,0
363349,1,0,7,-7,8,0
357617,5,16,16,0,5,0
354555,4,36,31,5,4,0
386680,3,17,13,4,2,0
54038,2,3,0,3,8,1
318622,4,10,13,-3,5,0
82187,3,16,3,13,3,0
5298,1,0,0,0,3,0
334862,3,24,3,21,13,0
159822,1,7,0,7,3,0
86582,3,30,3,27,5,1
43120,4,6,27,-21,3,1
193597,4,0,17,-17,1,1
394164,2,16,10,6,5,0
421869,4,7,19,-12,17,1
14072,4,3,24,-21,7,0
72365,3,10,20,-10,16,1
86914,4,23,29,-6,5,0
119885,1,0,6,-6,3,0
366775,4,34,10,24,10,1
195409,3,24,3,21,2,1
418685,1,0,7,-7,16,0
368720,3,7,16,-9,11,1
272701,2,9,3,6,2,1
309495,1,0,0,0,1,1
141539,3,24,10,14,13,1
369713,3,22,23,-1,11,0
227326,3,20,34,-14,16,1
234858,4,3,12,-9,2,0
95946,1,0,0,0,10,0
405105,2,0,10,-10,10,0
18195,4,23,20,3,9,0
233579,2,14,27,-13,2,1
369202,4,22,20,2,11,0
192014,3,17,20,-3,1,0
396338,1,7,0,7,6,0
108271,4,9,7,2,15,0
274285,4,29,16,13,3,1
215520,4,13,3,10,11,1
377857,2,20,7,13,15,0
168147,3,16,5,11,7,1
163383,1,0,6,-6,5,1
94231,4,24,24,0,9,0
271569,2,7,13,-6,2,1
325451,2,13,3,10,8,1
304313,2,7,0,7,16,1
268847,1,0,0,0,17,0
324215,1,0,0,0,8,1
59193,2,14,42,-28,10,1
254405,1,13,0,13,11,0
300995,1,3,0,3,15,0
90747,3,17,7,10,7,1
245891,3,6,37,-31,7,1
29527,1,0,7,-7,14,0
101327,1,3,0,3,12,1
78329,4,24,21,3,2,0
40638,3,34,7,27,2,1
369159,3,19,7,12,11,1
242427,1,0,7,-7,6,0
196254,3,21,10,11,2,0
183360,1,14,3,11,14,1
82754,2,6,6,0,3,0
31532,4,3,17,-14,15,0
122905,4,34,6,28,4,0
151734,2,7,3,4,17,0
70182,3,30,14,16,15,0
180561,4,28,32,-4,13,1
108674,2,27,10,17,15,1
291458,3,14,20,-6,10,1
195336,2,3,3,0,2,0
29811,1,3,3,0,14,0
391951,4,30,34,-4,4,1
310116,2,7,0,7,2,1
247456,3,13,9,4,8,0
357530,2,10,6,4,5,0
341425,4,0,13,-13,16,1
226541,1,0,0,0,16,1
338256,3,27,31,-4,14,1
385793,3,27,3,24,1,0
355093,2,6,13,-7,4,0
135582,4,28,6,22,10,0
420961,3,7,14,-7,17,0
26525,1,3,0,3,13,0
95850,3,13,10,3,10,0
255142,1,0,0,0,12,1
235282,3,18,6,12,3,1
213590,4,29,14,15,10,0
193443,3,23,20,3,1,0
149252,2,7,13,-6,16,1
46809,4,14,33,-19,4,1
347732,1,0,0,0,1,0
356888,4,25,16,9,5,1
217187,4,12,16,-4,12,0
251349,2,21,14,7,10,0
283638,4,20,20,0,7,1
45151,2,7,7,0,4,0
235729,3,3,20,-17,3,1
102104,4,42,24,18,12,1
85069,4,31,16,15,4,0
285990,4,29,14,15,8,0
90610,3,17,20,-3,7,1
81209,1,0,7,-7,3,0
16360,2,14,7,7,8,1
82409,1,0,0,0,3,0
310321,3,26,0,26,2,0
313985,1,0,0,0,3,0
294552,4,24,13,11,12,0
126868,3,17,6,11,6,0
27963,3,21,17,4,13,1
248384,1,3,0,3,8,1
222494,3,6,14,-8,14,0
126545,3,10,6,4,6,1
179032,1,0,0,0,12,1
113521,4,3,7,-4,17,0
394935,4,7,17,-10,5,0
61841,3,13,20,-7,12,0
354621,2,3,7,-4,4,1
362894,1,0,0,0,8,0
325862,1,0,0,0,9,1
219387,4,23,20,3,13,1
412518,3,24,7,17,14,0
291518,1,3,0,3,11,0
239811,1,0,0,0,4,0
284472,2,14,15,-1,7,0
852,4,14,12,2,1,1
24711,3,20,14,6,12,0
164887,2,0,3,-3,6,1
381670,2,17,7,10,17,1
32839,3,6,7,-1,15,0
375121,2,7,7,0,14,0
350695,1,7,0,7,2,0
349665,1,7,0,7,2,0
227302,3,13,20,-7,16,1
406703,3,27,0,27,11,0
332141,2,0,7,-7,12,0
35404,5,30,30,0,16,0
398379,3,3,27,-24,7,1
325675,4,31,7,24,9,1
268770,3,24,3,21,17,0
103345,2,10,17,-7,13,1
368120,2,7,7,0,11,0
215679,4,14,6,8,11,1
209984,2,0,3,-3,8,0
21527,2,7,7,0,11,1
88877,1,7,0,7,6,1
406140,4,3,29,-26,11,1
410573,2,10,7,3,13,0
175134,3,28,10,18,10,1
265068,2,13,3,10,16,1
412310,2,7,7,0,13,0
298278,3,20,13,7,14,0
352383,2,28,7,21,3,0
288743,4,0,10,-10,9,1
299446,3,7,20,-13,14,0
115263,3,7,9,-2,1,0
299342,4,28,16,12,14,0
12444,4,10,6,4,6,1
288408,3,13,0,13,9,0
223628,1,6,0,6,15,0
94610,1,7,6,1,9,0
382564,4,0,17,-17,17,1
219162,2,0,3,-3,13,0
9481,3,10,3,7,5,1
390593,4,20,27,-7,3,0
48018,3,10,27,-17,5,0
102935,2,12,21,-9,13,0
389900,2,12,3,9,3,0
178135,1,0,7,-7,12,1
319136,2,2,0,2,5,0
262061,4,24,31,-7,14,0
531,3,7,20,-13,1,0
116333,4,33,13,20,1,1
307128,1,0,0,0,17,0
339016,4,20,3,17,15,1
154938,3,26,17,9,1,1
126060,3,7,3,4,6,1
146751,4,22,35,-13,15,1
233967,1,0,0,0,2,0
105853,3,16,10,6,14,0
134744,2,10,3,7,10,1
146462,1,0,0,0,15,1
378435,2,7,0,7,15,1
352301,4,6,6,0,3,0
1785,2,3,0,3,1,1
200677,4,41,28,13,4,0
348173,1,6,0,6,1,0
95613,4,12,13,-1,10,1
318246,2,3,0,3,5,0
70551,1,0,7,-7,15,0
109698,2,3,0,3,16,0
128896,1,0,3,-3,7,0
306688,1,3,0,3,17,0
260845,3,29,15,14,14,1
69318,4,19,3,16,15,0
323210,2,7,3,4,7,1
68885,4,6,20,-14,15,1
154598,2,14,14,0,1,1
177310,4,20,20,0,11,0
243054,2,0,9,-9,6,1
12075,1,7,0,7,6,1
143374,3,7,16,-9,14,1
179152,4,12,13,-1,12,0
156560,4,14,6,8,2,1
370363,4,20,35,-15,12,0
112132,3,7,20,-13,17,0
272823,2,20,0,20,2,0
325198,3,13,20,-7,8,0
232703,4,17,3,14,1,0
199577,3,34,10,24,4,0
236509,3,7,9,-2,3,1
226392,1,0,0,0,16,0
160234,4,37,14,23,3,1
145613,2,21,0,21,14,0
36295,1,7,0,7,17,0
234826,3,0,12,-12,2,0
305417,3,20,3,17,17,1
345901,3,10,23,-13,17,1
370779,3,19,17,2,12,1
175901,4,23,27,-4,11,0
349047,4,17,17,0,2,0
13859,1,7,0,7,7,0
44371,1,0,0,0,3,1
283901,3,28,17,11,7,1
67093,4,10,9,1,14,0
24795,1,6,0,6,12,1
234119,1,0,0,0,2,0
148195,3,13,21,-8,16,1
420221,4,3,10,-7,17,0
285242,2,0,6,-6,7,1
62311,3,21,19,2,12,1
18206,4,29,20,9,9,0
90928,4,61,7,54,7,0
129056,2,14,14,0,7,0
255979,3,9,12,-3,12,1
222019,2,7,3,4,14,1
178058,4,20,23,-3,12,0
142150,3,2,7,-5,13,0
355421,3,13,10,3,4,0
79139,2,0,0,0,2,1
189071,3,21,30,-9,16,1
66507,3,21,24,-3,14,1
24152,4,31,14,17,12,1
329631,2,10,7,3,11,1
73903,1,14,0,14,17,0
245693,2,3,10,-7,7,1
284715,1,0,7,-7,7,1
134489,3,3,30,-27,10,1
301043,3,17,3,14,15,1
29721,2,17,3,14,14,1
280364,1,0,0,0,5,1
234918,1,10,0,10,2,0
392907,1,0,3,-3,4,1
302083,3,20,24,-4,15,0
214968,1,0,0,0,11,1
53196,1,0,0,0,8,0
319024,3,7,23,-16,5,0
387418,3,21,10,11,2,1
290166,1,3,0,3,10,0
373377,3,10,7,3,13,1
408247,4,20,3,17,12,1
71122,1,12,0,12,16,1
81408,3,10,10,0,3,0
252127,2,7,10,-3,10,1
284861,5,29,30,-1,7,0
129105,3,26,28,-2,7,1
258236,1,7,0,7,13,0
405281,3,14,7,7,10,1
363821,2,13,10,3,8,1
63088,4,23,42,-19,12,0
198653,3,13,21,-8,3,0
164594,2,7,3,4,5,0
186838,4,29,14,15,15,0
326089,3,30,3,27,9,1
283199,4,26,9,17,7,0
143675,3,19,10,9,14,0
38180,1,3,7,-4,1,1
19178,3,21,13,8,10,1
300109,1,7,0,7,14,0
421838,3,0,13,-13,17,0
198869,1,0,6,-6,3,0
296405,1,7,0,7,13,1
64668,1,7,0,7,13,1
111766,1,3,6,-3,17,0
126444,1,0,0,0,6,1
264800,3,17,29,-12,16,0
200554,2,14,7,7,4,0
420011,2,10,7,3,17,0
3055,4,22,41,-19,2,1
245773,4,16,20,-4,7,1
380141,1,0,0,0,16,0
73763,2,3,0,3,17,1
350723,2,7,0,7,2,0
406066,2,0,13,-13,11,0
384786,1,6,0,6,1,0
59368,3,0,16,-16,11,1
285007,4,16,27,-11,7,1
109179,4,34,7,27,15,0
355160,4,26,23,3,4,0
119865,5,24,24,0,3,0
41353,3,14,12,2,2,1
140589,2,24,7,17,12,0
83605,4,3,17,-14,4,1
148039,3,7,3,4,15,0
213752,1,0,0,0,10,0
28576,4,33,7,26,14,1
402031,4,3,19,-16,9,0
230507,1,0,0,0,1,1
129829,2,10,0,10,7,1
70377,4,18,33,-15,15,1
220248,2,17,9,8,13,0
377294,4,14,14,0,15,0
390933,1,7,0,7,4,1
256954,4,32,27,5,12,0
76321,2,10,3,7,1,1
313330,4,13,24,-11,3,0
316490,4,22,17,5,4,0
246574,1,0,0,0,8,0
38864,4,3,13,-10,1,1
312473,1,3,0,3,3,1
202746,3,13,17,-4,5,1
223959,1,0,0,0,15,1
294201,2,0,7,-7,12,1
60631,1,0,3,-3,11,1
329247,4,24,13,11,10,0
209859,2,13,13,0,8,0
418128,2,14,3,11,16,1
396791,1,0,0,0,6,0
144876,3,14,7,7,14,0
115479,4,39,28,11,1,1
22607,3,23,3,20,11,0
146467,1,0,0,0,15,1
59892,1,3,0,3,11,0
97532,3,23,0,23,10,0
32123,4,24,21,3,15,1
224207,4,0,23,-23,15,1
132859,3,3,14,-11,9,1
312855,3,7,0,7,3,1
139340,4,20,13,7,12,0
405148,4,6,10,-4,10,1
139452,4,24,10,14,12,1
2643,1,3,0,3,2,0
146420,4,16,3,13,15,0
287339,2,13,0,13,8,0
52965,2,14,17,-3,7,1
314569,1,6,0,6,3,1
402609,3,17,16,1,9,1
116687,1,6,3,3,2,1
106002,3,17,3,14,14,1
315913,1,0,0,0,4,0
200817,4,38,17,21,4,1
277177,1,0,0,0,4,0
279171,1,0,0,0,5,0
85412,4,38,17,21,5,0
187808,2,7,3,4,16,1
416324,2,13,3,10,15,1
417826,2,10,0,10,16,0
213638,2,7,7,0,10,0
379433,2,7,0,7,16,1
258052,1,0,0,0,13,0
40056,3,20,7,13,1,0
358651,1,0,0,0,6,0
37516,3,10,7,3,17,0
111002,4,14,20,-6,16,0
350658,4,20,3,17,2,0
69683,2,6,7,-1,15,1
286630,4,17,41,-24,8,0
161977,1,0,0,0,4,0
126974,2,10,10,0,6,0
114450,1,0,7,-7,1,1
341534,3,6,7,-1,16,0
405810,4,21,24,-3,10,1
26348,4,19,21,-2,13,1
9274,1,7,0,7,5,0
208814,4,6,22,-16,8,0
280626,4,23,9,14,5,0
213876,4,54,14,40,10,1
243022,1,0,0,0,6,0
54609,1,7,6,1,8,1
419066,4,10,20,-10,16,1
401746,4,24,14,10,8,1
412883,1,0,0,0,14,1
231458,2,10,9,1,1,0
409803,2,10,0,10,12,1
345330,4,22,24,-2,17,1
158956,3,14,22,-8,3,1
262938,4,14,32,-18,15,1
361725,1,0,0,0,7,1
317002,1,0,10,-10,4,1
342020,4,20,3,17,16,1
135142,4,31,6,25,10,0
373875,3,27,10,17,13,1
41978,4,38,6,32,2,1
8191,2,0,7,-7,4,1
108131,4,13,42,-29,15,0
48645,1,0,0,0,5,1
347908,2,0,7,-7,1,0
158319,2,6,14,-8,3,1
363164,4,24,10,14,8,0
91175,3,10,14,-4,8,0
63048,3,16,21,-5,12,1
110502,4,20,6,14,16,0
239745,3,13,13,0,4,0
70608,3,16,10,6,15,1
94239,4,24,30,-6,9,1
226394,1,0,0,0,16,0
332595,2,17,3,14,12,0
24992,3,16,14,2,12,0
201955,2,0,0,0,5,1
67784,4,21,0,21,14,1
239970,2,0,10,-10,5,0
169899,1,0,0,0,8,0
415595,3,14,10,4,15,0
85555,4,17,22,-5,5,0
122596,3,20,7,13,4,1
163174,4,22,28,-6,5,1
176105,1,0,0,0,11,1
337234,3,16,23,-7,14,0
8744,2,0,0,0,4,1
416488,3,21,17,4,15,1
200602,3,24,14,10,4,1
235849,2,0,14,-14,3,1
232716,4,20,3,17,1,0
381326,1,6,0,6,16,1
66600,2,0,14,-14,14,0
147362,1,0,0,0,15,0
55025,1,0,0,0,8,0
140532,4,21,29,-8,12,0
188073,1,0,3,-3,16,1
110677,4,23,10,13,16,0
117413,4,34,17,17,2,0
416661,4,34,7,27,15,0
267393,3,0,10,-10,17,1
20162,2,10,0,10,10,0
360050,3,3,33,-30,7,1
3732,2,10,3,7,2,1
326235,3,10,41,-31,9,1
67629,3,7,35,-28,14,0
40187,3,27,7,20,2,0
194138,2,3,0,3,1,0
216112,4,24,26,-2,11,0
49496,2,7,3,4,6,0
12624,4,3,27,-24,6,1
169921,1,7,0,7,8,1
191021,4,26,9,17,17,0
112634,4,38,34,4,17,0
126938,1,3,0,3,6,0
273001,2,3,3,0,2,1
249458,5,18,18,0,9,0
47262,4,19,9,10,5,0
50797,1,0,0,0,6,1
93456,3,3,21,-18,9,1
259642,4,9,6,3,13,0
163255,2,6,6,0,5,0
50891,3,14,24,-10,6,1
121844,3,0,10,-10,4,0
330850,3,13,17,-4,11,0
220631,1,0,0,0,13,0
159667,1,0,0,0,3,0
413876,3,17,6,11,14,0
18438,2,7,7,0,9,0
218735,2,0,13,-13,13,1
336652,5,7,7,0,14,1
188792,4,7,20,-13,16,0
183406,2,24,3,21,14,0
350124,1,0,0,0,2,1
80562,4,16,10,6,3,0
167084,4,16,31,-15,7,0
290249,3,17,3,14,10,1
166290,3,7,9,-2,6,1
253411,3,14,28,-14,11,0
172040,2,7,0,7,9,0
389234,3,28,7,21,3,0
222814,3,10,13,-3,14,1
409031,1,0,0,0,12,1
223430,4,20,26,-6,15,0
65690,1,0,7,-7,13,0
371542,1,3,0,3,12,0
41000,1,3,7,-4,2,0
305375,2,14,3,11,17,1
224776,3,5,3,2,15,1
5177,1,0,3,-3,3,1
77293,4,26,17,9,1,0
32464,1,7,0,7,15,0
389534,4,20,17,3,3,1
419678,1,0,0,0,17,1
138726,4,28,38,-10,12,1
405465,4,24,10,14,10,0
26156,3,0,20,-20,13,1
277768,4,17,6,11,4,0
113695,1,0,10,-10,17,1
328550,1,0,0,0,10,1
131475,1,0,3,-3,8,1
374025,3,10,10,0,13,0
80477,2,5,3,2,3,1
173588,2,0,10,-10,10,0
139077,2,6,3,3,12,0
260561,4,27,8,19,14,1
368017,3,17,21,-4,11,0
338548,3,20,31,-11,14,1
322550,1,0,0,0,7,0
95413,2,28,7,21,10,1
267809,2,10,14,-4,17,1
185664,1,7,0,7,15,0
393804,1,0,3,-3,5,0
346490,2,17,14,3,1,0
364975,2,7,3,4,9,0
172016,1,0,0,0,9,1
376575,4,15,6,9,14,0
225471,2,0,7,-7,15,0
41050,3,3,13,-10,2,0
358554,2,10,3,7,6,1
4966,4,21,17,4,3,1
268907,2,6,30,-24,17,0
104321,2,38,21,17,13,0
410202,1,0,0,0,13,1
296393,1,0,0,0,13,1
111763,1,3,0,3,17,0
42506,3,10,12,-2,3,0
67891,2,16,3,13,14,1
77664,3,7,10,-3,1,0
182406,1,0,0,0,14,0
76571,4,7,41,-34,1,0
367993,2,17,21,-4,11,1
399438,1,0,10,-10,7,0
36070,2,24,0,24,17,1
167,1,3,0,3,1,1
58908,3,12,25,-13,10,1
94904,1,0,0,0,9,0
50554,2,0,6,-6,6,1
406196,2,7,3,4,11,0
8085,3,17,13,4,4,1
189029,2,14,7,7,16,0
49206,3,17,3,14,6,1
338185,2,7,14,-7,14,0
419389,1,0,0,0,16,0
119821,4,24,16,8,3,1
86785,1,0,0,0,5,0
306781,4,16,33,-17,17,1
386048,2,14,0,14,1,0
142617,2,13,3,10,13,0
228273,4,17,36,-19,17,1
223599,4,24,13,11,15,0
133846,1,0,0,0,9,0
44116,2,3,13,-10,3,0
167052,3,13,17,-4,7,0
306671,4,14,35,-21,17,0
51721,2,0,10,-10,7,1
323049,2,14,14,0,7,1
298845,3,21,9,12,14,0
94309,2,3,7,-4,9,1
97827,3,7,24,-17,11,1
328985,4,30,7,23,10,1
407447,3,14,10,4,11,0
210464,3,9,14,-5,9,1
205524,3,14,17,-3,6,0
34704,2,3,3,0,16,0
419931,4,16,18,-2,17,1
238624,1,6,0,6,4,1
207201,4,14,20,-6,7,1
374127,2,13,7,6,13,0
151058,3,10,10,0,17,1
243006,5,34,34,0,6,1
334560,3,21,17,4,13,1
154522,1,0,0,0,1,0
195663,2,7,7,0,2,1
348894,4,9,14,-5,2,0
249003,1,0,0,0,9,0
128338,2,0,3,-3,7,1
195087,3,7,26,-19,2,0
193051,1,0,0,0,1,0
198499,4,17,3,14,3,1
332508,4,23,9,14,12,0
101460,4,18,13,5,12,1
282043,1,3,0,3,6,0
206625,4,10,16,-6,7,0
256222,1,6,0,6,12,0
78351,4,31,35,-4,2,1
240202,4,16,6,10,5,0
76959,3,17,13,4,1,1
15223,3,13,7,6,8,1
182785,2,10,3,7,14,1
303644,4,31,13,18,16,1
59941,2,3,10,-7,11,0
46778,3,14,20,-6,4,0
363837,3,13,17,-4,8,0
221646,4,23,21,2,14,0
208657,4,6,6,0,8,1
246394,4,26,18,8,7,1
275027,3,31,10,21,3,0
419966,1,0,0,0,17,1
149642,1,7,0,7,16,0
355434,3,13,13,0,4,0
268192,4,12,17,-5,17,0
279304,4,19,23,-4,5,1
75035,4,34,17,17,17,0
402495,4,26,15,11,9,0
420820,3,10,10,0,17,1
17097,3,23,3,20,9,0
202792,4,19,17,2,5,1
202546,1,7,6,1,5,1
28335,1,3,0,3,14,1
135593,4,28,6,22,10,1
280560,2,14,6,8,5,1
32520,2,17,3,14,15,0
154070,1,0,0,0,1,1
318198,4,22,20,2,5,0
397738,3,9,14,-5,7,0
250020,2,17,6,11,9,0
389958,3,28,18,10,3,0
219465,2,0,14,-14,13,1
82068,4,20,10,10,3,1
199755,4,38,10,28,4,0
36271,4,24,27,-3,17,0
105887,4,19,10,9,14,0
82498,3,10,17,-7,3,0
398616,2,0,0,0,7,0
126148,1,0,0,0,6,0
160240,4,37,21,16,3,1
393754,4,7,7,0,5,0
167789,1,0,0,0,7,1
300156,2,21,3,18,14,1
163676,1,0,0,0,5,0
400778,2,14,0,14,8,0
43712,4,20,17,3,3,1
54479,2,7,7,0,8,0
321748,2,9,6,3,7,0
199145,4,14,38,-24,4,0
291712,2,0,6,-6,11,0
122777,4,10,27,-17,4,1
19652,4,23,28,-5,10,1
62161,3,7,14,-7,12,0
61269,3,21,14,7,11,0
266278,4,38,27,11,16,1
152309,1,7,0,7,17,0
179265,3,26,3,23,12,1
188263,2,14,7,7,16,0
316318,4,17,19,-2,4,0
198501,4,17,5,12,3,0
213995,3,29,7,22,10,0
174218,3,3,26,-23,10,1
42384,3,14,16,-2,2,1
311509,3,17,10,7,2,0
307590,1,0,0,0,17,1
324729,3,16,7,9,8,0
243462,3,3,23,-20,6,0
358022,4,24,16,8,6,0
69042,4,27,24,3,15,1
271995,1,0,0,0,2,1
162200,2,10,14,-4,4,1
198750,2,3,3,0,3,1
394016,2,6,13,-7,5,0
368651,1,0,3,-3,11,1
158644,2,14,7,7,3,1
173363,4,31,27,4,10,0
291695,2,0,3,-3,11,0
389780,2,10,6,4,3,0
139429,3,24,3,21,12,1
82153,2,10,3,7,3,0
352495,1,0,0,0,3,1
38270,4,13,14,-1,1,1
389522,3,20,10,10,3,0
102185,3,17,7,10,13,0
259234,4,28,32,-4,13,0
190427,4,7,13,-6,17,1
100207,3,17,0,17,12,0
65957,4,24,21,3,13,0
96236,4,3,29,-26,10,1
6006,4,17,36,-19,3,1
274336,1,3,6,-3,3,0
76584,1,0,0,0,1,1
249324,1,10,0,10,9,0
327088,2,7,0,7,9,0
359372,4,10,20,-10,6,1
150930,3,13,7,6,17,1
401613,4,24,31,-7,8,1
200655,4,35,28,7,4,0
344592,4,0,6,-6,17,0
67854,2,6,3,3,14,1
65913,3,17,14,3,13,0
325570,1,7,0,7,9,1
167459,2,0,0,0,7,0
26155,3,0,20,-20,13,1
62793,4,17,0,17,12,1
112244,2,14,7,7,17,0
150071,4,31,12,19,16,0
144648,1,0,0,0,14,0
6327,1,0,0,0,3,0
225616,2,0,7,-7,16,0
226521,4,14,20,-6,16,0
360002,2,3,26,-23,7,1
232359,3,6,15,-9,1,1
115628,4,30,9,21,1,1
155341,1,10,3,7,2,0
120193,1,0,0,0,3,1
80537,3,8,10,-2,3,0
54305,1,0,2,-2,8,1
110065,4,48,16,32,16,0
339606,3,24,14,10,15,0
292553,1,0,6,-6,11,1
328424,2,3,0,3,10,0
384340,4,16,10,6,1,1
98989,1,0,0,0,11,1
192463,2,0,17,-17,1,1
39333,4,20,27,-7,1,1
194779,3,10,16,-6,2,0
192213,4,3,33,-30,1,1
138037,3,22,17,5,11,1
328237,5,17,17,0,10,1
382947,2,0,13,-13,17,1
371742,3,14,14,0,12,0
420118,1,0,0,0,17,1
45438,2,14,7,7,4,1
407690,1,0,0,0,11,0
201412,1,6,0,6,5,1
7337,5,20,19,1,4,0
304018,2,0,13,-13,16,1
285826,4,14,24,-10,8,0
258164,4,13,13,0,13,1
347476,2,12,16,-4,1,1
15443,1,0,0,0,8,1
17050,2,13,0,13,9,0
337841,4,30,6,24,14,1
272122,4,17,9,8,2,1
272723,3,12,3,9,2,0
295196,1,6,0,6,12,1
76279,1,0,0,0,1,1
325917,2,10,7,3,9,1
108711,3,34,13,21,15,1
102148,2,14,0,14,13,0
286253,2,6,13,-7,8,1
32947,2,0,17,-17,15,0
286185,5,24,24,0,8,1
383828,3,3,7,-4,1,0
39366,1,0,0,0,1,1
100955,3,10,10,0,12,0
262985,1,0,0,0,15,1
164543,4,23,17,6,5,1
312324,1,7,14,-7,3,1
401293,3,13,21,-8,8,1
9857,1,0,0,0,5,0
182558,1,0,0,0,14,0
368550,2,9,0,9,11,1
401443,3,24,10,14,8,0
85619,2,7,0,7,5,1
213097,3,20,3,17,10,0
362389,4,30,20,10,8,0
319235,4,17,20,-3,5,0
172831,2,7,0,7,9,1
158948,3,14,15,-1,3,0
320489,4,26,17,9,6,0
129777,4,17,24,-7,7,0
207742,3,24,13,11,7,1
62791,4,17,0,17,12,0
105972,2,17,0,17,14,0
277885,3,7,17,-10,4,0
226428,2,0,7,-7,16,0
410941,4,14,28,-14,13,0
101628,4,13,38,-25,12,1
20212,3,17,10,7,10,1
349649,4,19,31,-12,2,1
307576,1,0,0,0,17,0
402503,4,26,18,8,9,0
419167,3,10,6,4,16,0
46962,4,26,36,-10,5,0
4432,1,0,0,0,2,1
152836,4,21,18,3,17,0
366400,2,26,0,26,10,0
87584,3,17,3,14,6,0
308654,1,0,6,-6,1,0
367515,1,7,0,7,10,0
98326,4,28,27,1,11,1
65982,1,0,0,0,13,1
314044,2,6,7,-1,3,1
155883,3,14,13,1,2,0
69710,2,10,7,3,15,0
290171,1,3,0,3,10,1
14253,1,0,0,0,7,1
179862,2,3,9,-6,13,1
82036,3,10,7,3,3,1
338059,2,0,7,-7,14,1
149101,3,14,17,-3,16,1
565,4,14,27,-13,1,1
147459,4,23,10,13,15,0
257269,4,19,26,-7,12,0
228326,2,0,7,-7,17,1
161619,3,30,16,14,4,0
227356,4,20,37,-17,16,0
237120,4,8,33,-25,3,1
395037,2,0,17,-17,5,1
95993,2,6,0,6,10,0
162683,3,16,24,-8,5,1
252149,2,16,10,6,10,1
257719,3,3,23,-20,13,0
132137,3,10,3,7,9,1
36626,2,3,3,0,17,1
103724,4,3,17,-14,13,1
186855,4,29,20,9,15,0
348910,4,9,21,-12,2,1
123245,4,19,21,-2,4,0
186131,2,3,3,0,15,1
27093,4,17,9,8,13,1
419774,4,17,17,0,17,1
146187,1,0,3,-3,15,0
115659,1,0,3,-3,1,1
297177,1,0,0,0,13,1
375855,4,20,7,13,14,0
180148,2,7,0,7,13,1
4454,1,7,3,4,2,0
194797,4,10,23,-13,2,1
105455,4,23,31,-8,14,0
198519,4,17,12,5,3,1
16042,1,13,0,13,8,1
334665,2,2,3,-1,13,1
278246,4,34,28,6,4,0
333925,1,0,7,-7,12,0
345493,1,0,0,0,17,0
264129,3,20,27,-7,15,1
9331,3,21,7,14,5,0
376005,4,23,21,2,14,1
70488,3,23,20,3,15,1
373670,2,0,12,-12,13,1
389812,3,17,6,11,3,1
181507,1,0,0,0,13,1
32804,2,6,0,6,15,0
158749,1,0,3,-3,3,1
262350,4,16,16,0,15,1
365206,4,14,38,-24,9,1
310113,2,7,0,7,2,0
308922,1,0,0,0,1,1
269203,2,3,3,0,17,1
166359,1,0,0,0,6,1
376825,3,14,7,7,15,1
88516,4,19,14,5,6,0
147004,3,24,0,24,15,0
203722,1,0,0,0,6,0
414123,2,10,10,0,14,0
119744,2,10,3,7,3,1
49878,4,28,20,8,6,1
1506,2,3,6,-3,1,0
118200,1,0,0,0,2,1
132199,1,0,0,0,9,0
329473,2,3,0,3,10,1
138546,5,31,37,-6,12,0
340096,4,20,15,5,15,0
130931,2,7,14,-7,8,0
94623,2,7,19,-12,9,1
366088,1,0,0,0,10,0
367336,4,6,20,-14,10,0
221532,1,13,9,4,14,0
314339,3,10,17,-7,3,0
233995,1,14,0,14,2,1
53437,3,3,28,-25,8,1
131001,4,10,30,-20,8,1
276657,3,20,6,14,4,1
252534,4,29,25,4,10,0
231318,2,3,10,-7,1,1
155948,1,0,0,0,2,0
320019,4,43,30,13,6,1
101209,2,7,7,0,12,0
78266,2,0,14,-14,2,1
232284,1,0,0,0,1,1
381291,4,31,20,11,16,0
303194,5,31,31,0,16,1
235292,4,25,6,19,3,0
51899,2,6,10,-4,7,1
310061,4,9,13,-4,2,1
160977,3,10,7,3,4,0
164274,1,0,0,0,5,0
354500,3,27,28,-1,4,0
20699,3,17,17,0,10,0
323850,3,16,23,-7,8,1
173086,4,24,27,-3,9,1
154630,3,21,21,0,1,1
295267,3,14,5,9,12,0
135892,5,24,24,0,10,1
390603,4,20,27,-7,3,1
16852,4,26,38,-12,8,1
400675,2,6,7,-1,8,1
381009,1,0,0,0,16,1
303328,3,34,0,34,16,0
120270,3,17,6,11,3,0
44162,4,13,20,-7,3,1
329792,3,17,20,-3,11,0
254838,1,0,0,0,12,0
99417,1,0,0,0,11,1
100866,4,19,22,-3,12,0
192043,4,24,27,-3,1,1
255276,4,13,17,-4,12,1
280921,4,21,10,11,6,0
206352,1,0,0,0,7,1
36393,4,13,26,-13,17,1
48620,4,21,27,-6,5,1
208439,1,7,0,7,8,1
298460,1,0,0,0,14,0
336965,4,21,24,-3,14,1
289723,1,0,7,-7,10,0
209496,1,7,3,4,8,1
266500,3,3,15,-12,16,1
334420,3,10,10,0,13,1
117644,2,13,13,0,2,0
406811,2,0,20,-20,11,1
94089,4,6,31,-25,9,1
62464,4,7,13,-6,12,1
322888,1,6,0,6,7,1
334739,3,25,9,16,13,0
76489,2,0,17,-17,1,0
414749,4,10,17,-7,14,1
51549,1,0,0,0,7,0
257877,4,16,12,4,13,1
350468,3,0,12,-12,2,1
331020,3,39,7,32,11,0
28271,4,17,14,3,13,0
184243,3,24,0,24,14,0
227822,4,6,35,-29,16,0
234308,2,10,0,10,2,0
188170,4,17,10,7,16,0
45257,1,0,0,0,4,1
146085,3,19,10,9,15,1
9192,3,3,16,-13,5,0
403732,2,9,3,6,9,1
170094,2,7,0,7,8,1
25704,3,14,7,7,12,0
137136,4,31,6,25,11,0
273089,1,0,0,0,2,1
362080,3,14,10,4,8,1
336122,2,10,3,7,13,1
5484,2,3,3,0,3,0
212187,3,3,17,-14,10,0
125526,4,30,7,23,5,1
188899,3,10,10,0,16,1
149183,5,31,31,0,16,0
270967,2,0,7,-7,1,0
122284,3,6,19,-13,4,1
65400,1,0,7,-7,13,1
249679,2,11,7,4,9,0
15497,3,16,6,10,8,1
55876,4,19,14,5,9,1
204650,4,17,48,-31,6,1
198401,1,3,0,3,3,0
284500,3,17,15,2,7,1
74901,4,20,20,0,17,1
294662,2,3,14,-11,12,1
170097,2,7,0,7,8,0
251600,4,19,20,-1,10,0
342419,2,10,3,7,16,0
286107,3,10,17,-7,8,1
341997,3,13,3,10,16,1
195167,1,7,0,7,2,0
161577,2,23,10,13,4,0
90882,2,31,0,31,7,0
23169,2,20,0,20,11,1
77619,2,0,7,-7,1,1
57153,2,7,0,7,10,0
381486,1,14,0,14,17,1
391828,2,10,0,10,4,0
250493,2,13,7,6,9,1
395334,2,14,3,11,5,0
347272,2,0,7,-7,1,1
262518,4,28,35,-7,15,1
388093,1,3,0,3,2,1
152277,4,28,0,28,17,0
80387,3,27,16,11,2,1
214340,1,0,0,0,11,0
233923,3,17,13,4,2,0
177920,4,21,23,-2,12,1
140145,3,10,3,7,12,0
296057,3,3,7,-4,13,1
378369,1,0,0,0,15,0
69132,3,14,10,4,15,0
70156,2,20,7,13,15,1
307375,4,16,25,-9,17,1
119441,3,7,14,-7,3,0
64451,2,14,13,1,13,1
282489,2,7,0,7,6,0
178046,4,13,23,-10,12,1
281810,2,10,0,10,6,0
132748,4,20,17,3,9,0
169601,1,3,0,3,8,1
148,5,10,10,0,1,1
15742,2,0,3,-3,8,1
285820,4,14,24,-10,8,1
59004,1,0,10,-10,10,1
146679,2,7,26,-19,15,0
95631,1,0,0,0,10,1
212205,4,3,24,-21,10,0
7674,1,0,0,0,4,0
308596,3,15,16,-1,1,0
254466,3,20,10,10,11,1
132007,3,0,24,-24,8,1
374193,4,23,28,-5,13,1
231394,1,0,0,0,1,0
36146,1,0,0,0,17,0
152293,1,0,0,0,17,0
22772,3,3,21,-18,11,0
123792,2,10,3,7,5,0
37153,1,0,0,0,17,1
211911,1,0,0,0,9,1
256281,3,6,17,-11,12,1
199229,2,17,20,-3,4,0
419720,2,0,10,-10,17,1
73752,1,3,0,3,17,0
125415,2,7,0,7,5,0
112933,4,19,6,13,17,0
230299,3,19,10,9,17,0
67681,1,0,0,0,14,0
225937,3,27,7,20,16,0
394729,2,14,0,14,5,1
350243,4,34,0,34,2,0
406292,4,27,35,-8,11,0
103447,1,0,0,0,13,1
341842,3,13,12,1,16,0
379727,2,9,0,9,16,0
73673,3,13,6,7,17,1
171963,4,14,14,0,9,0
231481,3,23,12,11,1,0
382532,2,0,10,-10,17,1
369067,1,0,0,0,11,1
66150,1,3,0,3,13,1
34089,2,0,0,0,16,1
378913,3,13,30,-17,15,1
335567,2,6,7,-1,13,1
36079,3,31,0,31,17,1
166176,3,28,19,9,6,1
74645,2,0,3,-3,17,1
160430,1,3,0,3,4,1
330238,3,17,14,3,11,0
373525,2,6,13,-7,13,1
309482,4,17,9,8,1,1
297280,4,24,6,18,13,0
356601,5,9,9,0,5,0
337939,3,13,0,13,14,1
409568,4,35,11,24,12,0
234783,2,0,3,-3,2,0
156393,4,38,20,18,2,1
273420,1,0,0,0,2,0
234521,4,20,20,0,2,1
14753,2,31,0,31,7,0
329484,2,10,0,10,10,0
343670,3,15,10,5,17,1
282266,3,19,14,5,6,1
300935,4,16,27,-11,15,1
268334,3,20,3,17,17,1
129026,1,0,0,0,7,0
367537,2,14,6,8,10,1
310585,2,9,20,-11,2,1
55972,2,10,13,-3,9,0
151143,1,3,10,-7,17,1
238707,4,19,17,2,4,0
135294,4,34,17,17,10,0
115996,2,13,0,13,1,0
296535,4,26,3,23,13,1
145844,4,13,33,-20,15,1
40629,3,31,7,24,2,1
39090,2,13,0,13,1,1
217524,4,19,3,16,12,1
85556,4,17,22,-5,5,0
140981,1,7,0,7,13,0
69181,4,17,17,0,15,0
162707,4,26,24,2,5,1
94385,4,17,20,-3,9,0
18855,2,3,6,-3,9,0
275632,3,24,3,21,3,0
139841,3,13,10,3,12,1
151259,4,24,26,-2,17,0
335974,2,0,15,-15,13,1
280000,3,3,13,-10,5,1
45594,2,7,13,-6,4,1
276340,2,14,21,-7,3,0
371336,3,35,10,25,12,0
215765,2,29,3,26,11,0
180295,2,9,7,2,13,0
113072,4,16,16,0,17,0
126711,3,7,13,-6,6,1
384322,3,16,3,13,1,0
245149,3,17,22,-5,7,0
144769,4,3,17,-14,14,1
111649,2,14,10,4,16,0
213240,3,10,16,-6,10,0
35346,3,22,6,16,16,1
107948,3,6,6,0,15,0
124753,3,3,6,-3,5,0
15265,4,23,7,16,8,1
21356,4,17,24,-7,11,1
233373,1,6,0,6,2,1
52292,4,30,19,11,7,0
130832,3,13,12,1,8,1
275806,4,16,3,13,3,0
175318,4,22,19,3,10,1
7249,2,7,13,-6,4,0
127895,1,10,0,10,6,1
284258,1,0,0,0,7,1
227730,2,3,7,-4,16,1
157699,2,10,3,7,2,1
161648,4,39,16,23,4,0
233716,2,7,21,-14,2,1
264153,4,27,27,0,15,1
291732,3,0,14,-14,11,1
373773,1,0,0,0,13,0
118330,4,26,7,19,2,1
265887,2,0,9,-9,16,1
206526,1,0,3,-3,7,0
22735,2,3,14,-11,11,0
341476,1,0,7,-7,16,1
259721,2,10,7,3,14,0
243305,3,7,10,-3,6,0
52913,1,0,0,0,7,0
224925,3,3,9,-6,15,1
16779,2,3,14,-11,8,0
398178,2,7,10,-3,7,1
257522,3,19,10,9,13,1
231417,1,0,6,-6,1,1
237925,4,14,27,-13,4,0
302361,3,10,10,0,15,0
38916,1,10,0,10,1,0
205180,2,7,10,-3,6,1
256922,3,14,21,-7,12,1
123847,4,17,3,14,5,0
383443,4,13,12,1,17,1
257234,3,19,23,-4,12,1
253645,1,0,0,0,11,0
54208,2,0,3,-3,8,0
285213,1,0,0,0,7,1
347090,1,3,3,0,1,1
353105,2,10,22,-12,3,0
3397,1,3,7,-4,2,0
126133,1,0,0,0,6,0
187828,2,7,13,-6,16,0
396170,4,24,23,1,6,0
131172,1,0,0,0,8,1
256773,3,10,13,-3,12,1
376246,3,10,14,-4,14,1
384687,2,10,17,-7,1,0
173065,4,24,12,12,9,1
56497,1,7,0,7,9,0
351061,3,14,16,-2,3,1
325021,3,20,21,-1,8,1
22100,1,0,0,0,11,1
105544,3,29,14,15,14,1
412162,2,7,3,4,13,1
357679,2,13,6,7,5,1
421708,3,17,10,7,17,1
257841,3,7,9,-2,13,0
407264,2,7,16,-9,11,1
23776,2,10,0,10,12,0
82691,4,12,19,-7,3,1
129036,1,0,7,-7,7,1
395820,3,3,7,-4,6,0
322320,2,14,7,7,7,0
284324,3,6,10,-4,7,0
285038,1,0,0,0,7,1
182488,3,14,0,14,14,1
143897,1,0,0,0,14,1
156478,2,0,3,-3,2,0
29487,4,10,14,-4,14,1
419382,4,3,26,-23,16,1
195003,1,7,0,7,2,1
121560,3,16,10,6,4,0
191077,2,7,3,4,17,1
125692,4,31,24,7,5,1
15795,3,0,12,-12,8,0
8625,2,7,10,-3,4,0
327750,4,13,16,-3,10,0
42121,4,27,27,0,2,0
113373,1,0,0,0,17,1
70165,3,20,7,13,15,1
134480,3,3,23,-20,10,0
387761,4,0,37,-37,2,1
130679,3,7,38,-31,8,0
184250,3,24,7,17,14,1
251713,3,21,3,18,10,1
187311,4,17,13,4,16,0
298887,4,21,23,-2,14,0
108527,3,17,14,3,15,1
43150,1,0,0,0,3,1
135077,2,17,6,11,10,0
372726,1,0,0,0,13,0
205671,3,17,12,5,7,0
246935,2,20,7,13,8,0
336225,1,0,0,0,13,1
412434,1,0,7,-7,14,1
49739,1,0,0,0,6,1
278521,4,36,0,36,4,0
388036,3,13,6,7,2,1
334811,1,7,0,7,13,1
221135,3,0,6,-6,14,0
85809,3,13,13,0,5,0
364205,1,0,0,0,9,0
421006,4,14,28,-14,17,0
217452,2,9,0,9,12,0
131780,1,0,0,0,8,0
268324,3,20,3,17,17,0
293921,2,7,21,-14,12,1
95601,4,12,10,2,10,0
230000,2,0,6,-6,17,1
196561,3,17,6,11,2,0
105785,1,0,3,-3,14,1
266542,4,10,22,-12,16,1
233935,4,17,13,4,2,1
366529,2,13,7,6,10,0
400933,2,13,7,6,8,1
227087,1,0,0,0,16,0
59679,4,24,6,18,11,0
304901,1,7,3,4,16,0
85325,2,21,3,18,5,1
136114,2,3,10,-7,10,0
130152,2,0,16,-16,8,1
164976,4,10,19,-9,6,1
293028,2,3,13,-10,11,1
195722,4,14,16,-2,2,1
231204,4,10,7,3,1,0
331376,4,8,33,-25,11,0
251584,4,16,20,-4,10,1
102347,3,13,13,0,13,0
31666,4,24,9,15,15,0
8277,1,0,0,0,4,1
415704,2,7,9,-2,15,0
331827,1,0,0,0,12,1
419818,1,0,0,0,17,0
170948,4,38,20,18,8,0
248856,1,0,0,0,9,1
6486,1,0,0,0,3,1
229202,1,0,0,0,17,1
146134,4,25,17,8,15,1
344058,1,0,0,0,17,0
340133,1,6,7,-1,15,1
417248,4,20,20,0,16,1
214594,3,3,6,-3,11,1
202019,4,17,10,7,5,1
267108,3,10,10,0,17,1
137471,1,0,0,0,11,1
344824,3,20,10,10,17,1
370031,3,10,13,-3,12,1
310573,1,3,13,-10,2,0
2484,1,0,0,0,2,1
92303,3,20,0,20,8,1
91059,3,9,0,9,7,1
317795,2,9,3,6,5,1
316439,3,16,10,6,4,1
186724,1,0,0,0,15,0
34651,4,31,10,21,16,1
343106,4,12,20,-8,16,1
357146,4,6,14,-8,5,0
236018,2,13,3,10,3,1
127290,2,10,7,3,6,0
160607,1,7,0,7,4,1
269946,2,16,10,6,1,1
335277,2,0,6,-6,13,1
107900,2,0,3,-3,15,1
43359,3,14,14,0,3,1
34851,2,10,0,10,16,0
161771,3,24,6,18,4,1
193668,1,3,20,-17,1,1
211811,2,14,7,7,9,0
314006,2,0,0,0,3,1
247125,3,20,6,14,8,1
269883,1,0,0,0,1,0
139998,3,28,10,18,12,0
48793,1,0,0,0,5,0
99410,1,0,0,0,11,1
274886,3,7,16,-9,3,1
13861,2,7,0,7,7,1
318031,4,17,16,1,5,1
76521,3,7,20,-13,1,0
144464,4,10,33,-23,14,1
359662,4,40,7,33,6,1
135270,4,24,16,8,10,0
340595,1,6,0,6,15,1
80348,2,13,6,7,2,1
280682,2,0,3,-3,5,0
21362,1,0,0,0,11,0
74999,3,27,17,10,17,0
408063,3,13,17,-4,12,0
65073,4,6,17,-11,13,0
366277,3,21,10,11,10,0
41190,3,0,7,-7,2,0
15161,1,0,0,0,8,0
62616,3,9,17,-8,12,0
284197,3,9,20,-11,7,0
11692,3,17,3,14,6,1
203484,2,21,3,18,6,0
253434,3,14,35,-21,11,1
157923,3,9,15,-6,3,1
53474,4,17,35,-18,8,0
131235,2,14,17,-3,8,1
362102,3,21,16,5,8,0
234464,2,17,12,5,2,0
338835,3,10,7,3,15,1
317747,1,0,0,0,5,1
41464,2,2,7,-5,2,1
416374,4,16,6,10,15,0
15840,4,8,12,-4,8,0
193701,2,3,20,-17,1,0
138399,1,7,0,7,12,0
211440,1,3,6,-3,9,0
86416,2,20,7,13,5,1
351105,4,29,30,-1,3,1
85008,2,25,7,18,4,0
346150,1,7,0,7,1,1
87553,2,17,3,14,6,1
367606,4,28,12,16,10,1
160007,2,3,23,-20,3,1
292151,2,21,0,21,11,1
205785,2,7,0,7,7,0
121342,2,7,0,7,3,0
138338,3,27,0,27,11,0
360662,4,17,34,-17,7,1
376881,4,28,21,7,15,1
288551,3,20,31,-11,9,1
90889,2,31,7,24,7,1
176486,2,9,10,-1,11,0
209221,3,17,7,10,8,1
183963,3,20,3,17,14,0
235257,3,15,6,9,3,1
261448,4,17,24,-7,14,0
378609,4,20,13,7,15,0
60310,1,3,0,3,11,1
339242,2,14,0,14,15,1
372907,2,19,0,19,13,0
22974,1,0,0,0,11,0
203365,3,21,33,-12,6,1
278837,4,14,24,-10,5,0
309443,3,7,6,1,1,1
379118,1,0,3,-3,16,0
315088,3,37,14,23,4,1
272354,2,21,0,21,2,0
212438,2,10,0,10,10,1
244377,3,0,17,-17,7,0
215784,3,29,6,23,11,1
112688,1,3,0,3,17,1
237256,4,20,0,20,3,1
360903,2,21,0,21,7,0
55384,2,10,7,3,9,1
327991,2,10,0,10,10,1
94120,1,3,0,3,9,0
305948,5,21,24,-3,17,1
394014,2,6,10,-4,5,0
229825,2,6,0,6,17,1
268209,4,12,28,-16,17,1
215926,3,10,14,-4,11,0
196745,4,54,0,54,3,0
139317,4,20,13,7,12,0
171322,2,10,3,7,9,0
280752,4,14,14,0,5,0
350609,3,10,0,10,2,0
216482,2,20,1,19,12,0
216856,3,10,14,-4,12,1
124004,4,13,14,-1,5,1
127018,3,24,20,4,6,1
196780,1,0,7,-7,3,1
406106,3,0,26,-26,11,1
226014,4,34,27,7,16,0
329401,4,16,41,-25,10,1
44613,3,20,21,-1,3,1
410347,4,15,26,-11,13,0
261302,4,38,0,38,14,1
94561,4,10,10,0,9,1
384072,1,0,7,-7,1,1
215731,1,16,0,16,11,0
31255,1,0,0,0,15,0
56910,3,27,7,20,9,1
309030,4,0,20,-20,1,1
27390,4,24,10,14,13,1
155345,2,10,3,7,2,1
9236,4,3,30,-27,5,1
275965,4,20,21,-1,3,0
120674,1,3,0,3,3,1
338331,2,3,0,3,14,1
83783,1,0,0,0,4,0
273341,3,28,0,28,2,0
159398,3,10,13,-3,3,0
272462,4,31,24,7,2,1
181648,4,23,6,17,13,0
63678,4,26,36,-10,12,1
6577,4,13,6,7,3,1
42015,1,6,0,6,2,0
289127,2,13,0,13,9,0
86262,2,6,17,-11,5,1
139860,3,13,17,-4,12,1
249947,1,0,0,0,9,1
240705,1,0,0,0,5,0
42680,3,7,10,-3,3,0
165994,3,17,20,-3,6,0
12445,4,10,6,4,6,1
156515,3,7,6,1,2,0
279365,2,6,7,-1,5,0
58301,4,20,13,7,10,1
271204,4,21,20,1,1,0
325569,1,7,0,7,9,1
375426,1,0,7,-7,14,1
247113,2,13,6,7,8,1
364334,4,9,39,-30,9,1
321277,2,9,10,-1,6,0
1569,4,16,13,3,1,0
84424,2,6,0,6,4,0
336136,2,10,3,7,13,1
273071,4,9,3,6,2,1
335493,4,13,12,1,13,0
392781,2,14,3,11,4,1
65109,1,0,0,0,13,0
178676,3,3,20,-17,12,1
376330,2,3,0,3,14,1
394248,4,47,32,15,5,0
63695,1,0,0,0,12,1
401765,4,27,14,13,8,1
246528,3,22,7,15,8,1
298120,3,3,31,-28,13,0
59443,2,3,10,-7,11,0
188425,3,3,3,0,16,1
312490,2,13,0,13,3,1
91382,4,21,7,14,8,0
376243,3,10,14,-4,14,1
52386,3,9,17,-8,7,0
73004,1,0,0,0,16,0
327409,3,3,14,-11,9,0
24694,3,20,7,13,12,0
342235,2,3,0,3,16,0
83252,3,9,10,-1,4,1
112816,1,0,0,0,17,1
393260,3,21,20,1,5,0
59796,3,12,13,-1,11,1
29444,3,7,14,-7,14,0
137781,4,17,37,-20,11,0
133800,3,16,10,6,9,1
316413,2,13,3,10,4,0
111427,4,0,20,-20,16,0
202343,4,20,6,14,5,0
274433,4,10,17,-7,3,1
221751,3,10,7,3,14,0
69002,3,21,14,7,15,0
20479,2,0,0,0,10,1
289983,4,6,9,-3,10,1
256986,1,0,7,-7,12,1
330658,2,6,3,3,11,0
141454,1,0,0,0,13,1
171504,3,17,10,7,9,1
239939,1,0,0,0,5,1
404605,2,7,10,-3,10,0
223554,3,10,13,-3,15,1
373207,2,3,10,-7,13,0
211642,2,16,3,13,9,1
81421,3,10,13,-3,3,1
411740,2,0,10,-10,13,0
399954,3,12,13,-1,8,0
19502,4,33,17,16,10,0
288749,4,0,10,-10,9,1
405812,4,21,24,-3,10,1
268666,4,20,20,0,17,0
99175,2,3,3,0,11,1
104430,1,0,7,-7,13,1
284249,4,16,33,-17,7,1
146067,2,13,3,10,15,0
340390,4,17,13,4,15,0
9405,1,0,0,0,5,1
357685,2,13,6,7,5,1
407445,3,14,10,4,11,0
136204,4,13,10,3,10,0
390144,4,20,35,-15,3,0
384860,3,6,12,-6,1,0
325046,3,26,24,2,8,1
265601,2,0,8,-8,16,1
121713,3,21,14,7,4,0
110141,2,10,10,0,16,0
70668,4,17,22,-5,15,1
110284,2,0,17,-17,16,0
173250,1,0,0,0,10,1
163706,1,0,6,-6,5,0
194359,4,23,6,17,2,1
25426,3,6,3,3,12,1
348032,1,0,7,-7,1,0
113829,1,0,0,0,17,1
304945,2,7,3,4,16,0
7075,2,7,14,-7,4,1
354337,2,35,3,32,4,0
364955,1,7,0,7,9,0
16475,2,9,0,9,8,1
282840,3,9,13,-4,6,1
328405,1,0,0,0,10,1
34473,4,38,3,35,16,1
90482,3,0,20,-20,7,0
113805,4,13,24,-11,17,1
172043,2,7,0,7,9,1
6484,1,0,0,0,3,0
19875,3,13,21,-8,10,0
2862,3,31,24,7,2,0
232364,3,13,15,-2,1,0
39657,1,0,0,0,1,1
143026,1,0,0,0,13,0
377982,2,0,7,-7,15,1
420426,1,0,7,-7,17,1
105921,4,19,13,6,14,0
219031,2,24,0,24,13,0
163777,3,10,12,-2,5,0
370141,2,10,3,7,12,1
201681,3,17,20,-3,5,0
39049,1,0,0,0,1,1
63812,4,14,34,-20,12,0
320666,1,7,10,-3,6,1
391236,1,7,0,7,4,0
217981,2,14,3,11,12,0
92563,2,17,0,17,8,0
26817,4,13,43,-30,13,0
242575,2,3,0,3,6,1
196341,1,7,0,7,2,1
20615,1,0,0,0,10,1
417829,2,10,0,10,16,1
242640,3,13,0,13,6,1
296466,3,17,0,17,13,0
25522,2,7,0,7,12,0
376686,3,3,0,3,14,1
220399,2,16,7,9,13,0
399621,2,6,3,3,8,0
51672,4,34,20,14,7,0
341632,1,3,0,3,16,0
220102,2,19,6,13,13,1
183792,2,10,14,-4,14,0
33509,2,14,0,14,16,1
326812,3,3,14,-11,9,1
175417,3,17,13,4,11,0
226907,3,3,10,-7,16,0
326842,4,10,17,-7,9,1
356387,4,31,14,17,5,0
54097,4,17,3,14,8,1
167625,1,7,7,0,7,1
349299,3,21,21,0,2,0
7705,2,10,0,10,4,0
164490,3,17,0,17,5,1
291788,4,9,23,-14,11,1
203630,2,7,7,0,6,0
287592,1,0,3,-3,9,0
313635,4,25,30,-5,3,1
9662,3,12,28,-16,5,1
194412,1,6,0,6,2,1
24997,3,16,14,2,12,0
196531,2,10,6,4,2,0
110973,4,7,20,-13,16,1
249587,4,21,13,8,9,0
281369,4,21,13,8,6,1
123377,3,21,24,-3,4,0
209062,2,3,10,-7,8,1
339396,2,0,3,-3,15,0
367886,4,20,20,0,10,1
35725,1,3,0,3,17,1
64294,2,6,10,-4,13,1
189399,4,33,24,9,16,0
106033,4,24,3,21,14,0
315948,2,0,7,-7,4,0
196484,1,0,3,-3,2,1
79573,2,7,0,7,2,1
27690,4,20,30,-10,13,1
314871,1,0,0,0,4,0
11618,1,7,0,7,6,1
335696,2,7,7,0,13,1
365218,1,0,0,0,9,0
158820,3,17,3,14,3,1
60330,1,3,0,3,11,0
379964,4,24,6,18,16,1
386015,1,7,0,7,1,1
77891,4,17,38,-21,1,1
163022,4,19,3,16,5,0
22832,1,0,0,0,11,1
112893,3,13,6,7,17,0
296817,4,7,7,0,13,1
22406,1,3,24,-21,11,1
179652,5,31,30,1,12,1
348950,1,7,0,7,2,1
193933,4,31,24,7,1,1
212634,3,7,31,-24,10,1
292778,3,26,17,9,11,1
182755,1,10,0,10,14,0
362634,2,0,7,-7,8,0
166812,4,30,16,14,6,1
215066,3,13,7,6,11,1
130652,3,7,28,-21,8,0
31005,2,0,3,-3,15,1
84141,2,7,0,7,4,1
265341,2,7,7,0,16,0
67592,2,0,20,-20,14,0
269081,3,13,16,-3,17,1
166666,4,32,20,12,6,0
161828,1,0,0,0,4,0
49313,2,7,3,4,6,0
61466,4,24,17,7,11,1
317252,4,7,16,-9,5,1
377527,2,0,6,-6,15,1
410264,2,7,7,0,13,0
283981,1,0,0,0,7,0
12406,3,10,6,4,6,0
6647,2,0,10,-10,3,1
354793,3,13,17,-4,4,0
228221,3,10,27,-17,17,1
98435,2,14,7,7,11,0
321362,4,35,22,13,6,1
67052,3,10,6,4,14,0
270476,4,13,7,6,1,1
138808,2,0,33,-33,12,1
54449,1,0,0,0,8,0
221550,2,20,12,8,14,0
278388,4,17,21,-4,4,0
354426,1,7,6,1,4,0
329398,4,16,34,-18,10,0
303449,3,19,7,12,16,0
402256,2,3,10,-7,9,0
244737,4,24,29,-5,7,1
401378,2,17,0,17,8,0
4858,1,7,0,7,3,1
3179,4,13,9,4,2,1
68466,1,0,0,0,14,0
15074,3,10,26,-16,7,0
141458,1,7,0,7,13,0
286511,1,3,7,-4,8,0
266609,2,3,0,3,16,0
282344,2,7,7,0,6,1
118572,3,17,3,14,2,1
180602,1,7,6,1,13,0
204764,3,21,14,7,6,0
403474,3,17,12,5,9,1
88506,3,16,14,2,6,1
258183,4,13,13,0,13,1
258579,3,13,3,10,13,0
27759,2,14,14,0,13,1
84662,4,26,16,10,4,1
395488,2,14,0,14,6,0
202716,2,6,10,-4,5,0
68641,2,7,0,7,15,0
289294,2,14,17,-3,9,1
143408,4,7,26,-19,14,0
202643,4,27,20,7,5,1
38833,3,3,10,-7,1,1
65158,2,0,3,-3,13,1
384366,4,16,17,-1,1,0
288303,1,0,0,0,9,1
341339,2,0,10,-10,16,1
257899,4,16,19,-3,13,1
347820,4,10,0,10,1,1
234267,1,0,0,0,2,0
46400,4,12,17,-5,4,0
191551,3,14,24,-10,17,1
8392,4,30,10,20,4,1
366720,3,24,10,14,10,1
302781,2,3,13,-10,15,1
84305,3,7,27,-20,4,1
103920,2,3,0,3,13,1
10404,4,10,45,-35,5,1
140283,2,7,6,1,12,1
180890,1,7,0,7,13,0
144436,3,3,26,-23,14,1
71669,4,3,34,-31,16,1
416860,1,0,0,0,15,1
56634,4,26,17,9,9,0
278312,2,14,0,14,4,0
349025,3,14,10,4,2,1
145451,3,9,14,-5,14,1
295358,1,3,0,3,12,1
302158,1,0,0,0,15,1
344844,3,23,10,13,17,1
138061,3,36,17,19,11,0
164054,2,3,3,0,5,0
268372,4,29,6,23,17,0
370462,3,13,6,7,12,0
344025,4,23,9,14,17,0
28902,4,30,10,20,14,1
4453,1,7,3,4,2,0
64427,2,0,6,-6,13,0
40784,3,17,28,-11,2,1
13390,1,0,0,0,7,0
395928,2,16,3,13,6,1
263491,3,20,16,4,15,0
44115,2,3,13,-10,3,1
337744,1,10,0,10,14,0
182604,2,0,6,-6,14,1
10716,5,17,17,0,5,1
92519,1,7,0,7,8,1
49623,1,0,7,-7,6,0
114463,1,3,10,-7,1,1
26433,3,17,16,1,13,1
420071,4,24,20,4,17,0
278672,4,17,3,14,4,0
32991,3,6,37,-31,15,1
161396,2,7,0,7,4,0
380443,4,10,24,-14,16,1
411598,2,13,13,0,13,1
13365,4,7,34,-27,7,1
303542,1,0,0,0,16,1
349520,1,0,0,0,2,1
191150,4,28,27,1,17,0
266397,3,36,8,28,16,0
403133,1,7,7,0,9,1
312395,3,20,27,-7,3,0
68543,3,10,28,-18,14,0
90825,1,0,0,0,7,1
98808,1,0,0,0,11,1
73895,1,7,0,7,17,0
22519,4,31,37,-6,11,0
137416,3,6,21,-15,11,0
180460,2,14,7,7,13,1
207535,1,7,0,7,7,0
96145,2,0,16,-16,10,1
167254,4,30,17,13,7,0
384175,4,29,20,9,1,0
19964,1,6,3,3,10,1
372989,4,28,13,15,13,1
386275,4,14,20,-6,2,1
375110,2,7,0,7,14,0
260255,4,17,3,14,14,0
84433,2,6,7,-1,4,1
148711,1,10,0,10,16,0
91742,1,0,0,0,8,1
324564,3,13,9,4,8,0
98519,1,0,0,0,11,1
97914,1,0,0,0,11,0
13173,3,19,16,3,6,1
336947,4,21,21,0,14,0
394305,2,10,10,0,5,1
30508,4,37,43,-6,14,1
233848,1,7,3,4,2,0
36086,3,31,0,31,17,1
330009,4,7,13,-6,11,0
396621,4,23,10,13,6,0
36319,2,7,7,0,17,0
101017,4,23,16,7,12,0
155280,4,28,27,1,1,1
24963,2,10,14,-4,12,1
369114,2,6,7,-1,11,0
6552,3,9,6,3,3,1
300786,3,10,33,-23,15,1
358658,1,0,0,0,6,1
38208,2,3,7,-4,1,0
104423,1,0,0,0,13,0
103521,3,20,0,20,13,0
260821,3,22,12,10,14,0
208673,4,6,6,0,8,1
358476,4,38,27,11,6,0
26056,4,13,19,-6,13,0
290912,1,0,0,0,10,1
406560,4,20,30,-10,11,0
96451,2,10,14,-4,10,0
286826,1,3,7,-4,8,1
72794,3,21,14,7,16,0
108790,1,0,7,-7,15,0
240362,4,14,23,-9,5,1
316540,2,0,3,-3,4,1
112398,2,10,13,-3,17,1
152374,3,21,3,18,17,1
384943,1,0,0,0,1,1
327225,2,0,3,-3,9,1
362938,2,21,6,15,8,1
106213,4,7,10,-3,14,0
203360,3,21,27,-6,6,0
335161,3,20,7,13,13,1
135379,3,21,17,4,10,1
353093,2,7,16,-9,3,0
258247,2,7,6,1,13,1
177557,2,10,0,10,11,0
325660,3,24,7,17,9,1
340803,3,17,16,1,15,0
353373,2,6,0,6,4,0
279008,4,13,30,-17,5,0
367480,4,36,30,6,10,0
218511,4,34,17,17,13,1
26959,4,16,6,10,13,0
412358,3,20,17,3,13,0
309601,4,16,3,13,1,1
51914,3,13,10,3,7,0
157842,1,6,9,-3,3,1
347847,4,16,8,8,1,0
115989,2,10,0,10,1,1
129385,2,16,7,9,7,0
312849,3,7,0,7,3,0
167917,4,21,19,2,7,1
400550,3,13,24,-11,8,1
354328,2,28,3,25,4,0
43596,4,31,3,28,3,0
220826,2,7,7,0,14,0
53593,3,14,15,-1,8,1
113567,2,0,0,0,17,1
116838,1,7,0,7,2,0
377980,2,0,7,-7,15,1
357381,2,14,10,4,5,0
112604,3,31,34,-3,17,1
138138,1,7,9,-2,11,1
269825,3,15,10,5,1,1
164024,2,0,3,-3,5,0
218062,4,21,24,-3,12,0
143488,2,14,21,-7,14,1
321617,3,17,6,11,7,0
195595,4,24,7,17,2,0
279993,2,3,13,-10,5,1
314062,3,16,14,2,3,0
404598,2,0,10,-10,10,1
66318,2,0,14,-14,14,1
68320,2,3,0,3,14,1
29268,2,21,0,21,14,0
61846,3,13,20,-7,12,0
304391,4,31,21,10,16,0
312766,1,0,0,0,3,1
416217,3,10,25,-15,15,1
4691,4,23,20,3,2,0
260636,2,7,13,-6,14,0
95452,4,34,7,27,10,0
110755,2,3,3,0,16,0
135555,3,14,6,8,10,0
375611,2,14,14,0,14,0
117809,2,6,6,0,2,1
242127,2,13,7,6,6,1
982,4,0,6,-6,1,1
82130,2,3,0,3,3,0
307749,1,7,7,0,1,1
245772,4,16,20,-4,7,1
118157,4,31,27,4,2,0
20860,3,27,9,18,10,1
207272,2,0,7,-7,7,0
248350,4,29,10,19,8,1
236683,3,17,7,10,3,1
343778,2,7,3,4,17,0
214719,2,3,7,-4,11,1
68384,3,3,14,-11,14,1
342160,4,15,19,-4,16,1
223979,2,7,6,1,15,0
342167,4,15,19,-4,16,1
178025,3,7,20,-13,12,0
165823,2,3,9,-6,6,1
191857,3,20,10,10,1,0
4213,2,10,6,4,2,1
132081,1,7,0,7,9,0
228029,2,0,0,0,17,1
421534,3,10,3,7,17,1
98309,3,28,27,1,11,1
107830,4,13,29,-16,15,0
117647,2,13,13,0,2,1
21526,1,7,7,0,11,1
104376,4,45,38,7,13,1
50011,4,28,10,18,6,0
4319,1,0,7,-7,2,0
167138,1,6,0,6,7,0
329825,4,17,20,-3,11,0
59761,2,9,10,-1,11,0
301319,2,14,7,7,15,0
41275,1,0,3,-3,2,0
231814,4,26,20,6,1,1
263373,4,31,17,14,15,1
679,3,0,17,-17,1,1
116359,4,40,13,27,1,1
171282,2,0,3,-3,9,0
12752,4,59,0,59,6,1
1024,1,0,0,0,1,1
83713,3,22,20,2,4,0
280254,2,3,13,-10,5,1
292765,3,26,17,9,11,1
171365,4,16,17,-1,9,0
269200,2,3,3,0,17,1
194347,4,20,6,14,2,1
232886,1,0,0,0,2,0
260982,4,10,3,7,14,1
75111,2,7,6,1,17,1
288183,1,3,0,3,9,0
376023,1,0,0,0,14,0
142935,3,3,10,-7,13,0
193160,4,16,6,10,1,0
294976,3,17,14,3,12,0
339394,2,0,3,-3,15,0
265898,2,0,9,-9,16,1
295136,3,7,14,-7,12,1
348701,3,17,10,7,2,1
48700,2,7,19,-12,5,1
318204,4,22,27,-5,5,1
391119,2,7,17,-10,4,1
226764,3,7,20,-13,16,1
156973,3,7,13,-6,2,1
73499,2,3,28,-25,17,0
138136,1,7,9,-2,11,1
18755,3,13,10,3,9,1
2205,1,7,0,7,1,1
309026,4,0,20,-20,1,0
283753,3,11,3,8,7,0
243538,1,3,0,3,6,0
223542,3,10,10,0,15,1
304093,3,6,23,-17,16,1
173290,2,14,10,4,10,0
112200,1,0,0,0,17,1
313467,3,17,14,3,3,1
289069,4,41,28,13,9,0
384716,3,13,23,-10,1,1
392361,3,17,28,-11,4,1
415797,4,27,24,3,15,0
102809,3,10,3,7,13,1
67590,2,0,20,-20,14,0
237557,4,31,14,17,3,1
266576,1,0,0,0,16,0
156146,2,7,7,0,2,0
10455,1,3,0,3,5,1
245887,3,6,30,-24,7,0
362891,1,0,0,0,8,1
364982,2,7,6,1,9,1
204785,4,21,21,0,6,1
374525,1,14,3,11,14,0
66064,3,7,3,4,13,1
192808,3,0,15,-15,1,0
378084,4,0,17,-17,15,0
77858,4,17,28,-11,1,1
407927,4,17,24,-7,11,0
302798,2,9,13,-4,15,0
52137,1,0,0,0,7,0
85263,4,24,17,7,4,1
68326,2,3,0,3,14,0
74408,3,10,13,-3,17,1
100837,4,12,19,-7,12,1
274243,3,17,7,10,3,1
294890,1,0,0,0,12,1
148914,2,3,9,-6,16,0
67048,3,10,6,4,14,1
186287,2,13,3,10,15,1
44887,3,7,24,-17,4,0
282775,2,0,10,-10,6,1
31253,1,0,0,0,15,0
254848,1,0,0,0,12,0
176372,3,16,28,-12,11,0
88370,4,24,10,14,6,1
175568,3,20,7,13,11,0
161821,4,37,13,24,4,1
398768,3,14,17,-3,7,1
296632,3,3,10,-7,13,0
94871,4,13,13,0,9,0
1468,1,0,0,0,1,0
267472,1,0,7,-7,17,0
92656,1,0,3,-3,8,0
352990,3,20,10,10,3,0
78051,4,12,23,-11,1,1
229824,2,6,0,6,17,1
304024,2,0,13,-13,16,0
324431,3,14,6,8,8,0
236507,3,7,9,-2,3,0
369542,2,11,0,11,11,1
236572,4,16,9,7,3,1
44327,4,24,23,1,3,1
213407,3,10,34,-24,10,1
148602,2,0,9,-9,16,1
420885,1,0,0,0,17,1
112779,4,20,10,10,17,1
122423,2,6,20,-14,4,0
319202,4,9,17,-8,5,1
269535,3,13,24,-11,1,0
160408,1,0,0,0,4,0
333371,3,17,10,7,12,1
371588,2,10,3,7,12,0
80512,3,5,10,-5,3,0
227069,4,20,9,11,16,0
417243,4,20,20,0,16,0
163135,3,16,19,-3,5,0
316556,2,3,3,0,4,0
116217,4,31,19,12,1,0
168464,3,0,24,-24,7,0
91132,1,3,7,-4,8,0
419046,3,7,20,-13,16,0
293491,2,10,3,7,11,0
414289,3,21,28,-7,14,0
381580,4,42,16,26,17,0
419313,3,0,17,-17,16,0
150391,1,0,0,0,16,0
81199,1,0,0,0,3,0
392751,1,7,3,4,4,1
416420,1,7,0,7,15,0
74625,1,0,3,-3,17,1
227956,4,30,27,3,16,0
61943,1,0,0,0,12,1
299359,1,0,0,0,14,0
54451,1,0,0,0,8,1
186171,3,16,6,10,15,1
187039,1,3,0,3,16,1
140431,2,7,7,0,12,1
158767,2,0,3,-3,3,1
227420,2,7,7,0,16,0
317396,4,7,10,-3,5,1
412347,3,10,17,-7,13,1
272272,4,9,10,-1,2,1
200357,4,33,14,19,4,0
345523,2,7,17,-10,17,1
26235,2,0,13,-13,13,0
263101,4,10,16,-6,15,0
350664,4,20,9,11,2,0
318074,1,9,0,9,5,0
22095,1,0,0,0,11,1
162650,2,10,10,0,5,0
137542,3,17,17,0,11,0
93129,1,0,0,0,9,1
254698,1,3,0,3,11,0
292855,1,7,0,7,11,1
160818,3,20,16,4,4,0
388512,4,3,23,-20,2,1
293216,2,16,7,9,11,0
99711,1,0,0,0,12,0
368166,3,13,21,-8,11,1
330188,1,0,0,0,11,1
275377,4,10,22,-12,3,1
323345,2,7,0,7,7,1
29060,1,0,0,0,14,0
259389,4,35,41,-6,13,0
104098,2,10,13,-3,13,1
100198,2,17,0,17,12,0
271411,2,7,0,7,1,1
188734,3,0,17,-17,16,1
11094,3,10,13,-3,5,1
180867,5,20,20,0,13,1
168955,1,0,0,0,7,0
393703,2,0,7,-7,5,1
148753,2,13,3,10,16,0
99159,2,3,3,0,11,0
301377,4,17,10,7,15,1
275779,3,16,3,13,3,0
55012,1,0,0,0,8,0
381467,1,6,0,6,17,1
105979,2,17,3,14,14,1
280132,2,21,0,21,5,0
116483,4,6,19,-13,1,1
27553,4,23,18,5,13,1
35006,2,9,0,9,16,0
116472,3,6,16,-10,1,0
268766,3,24,3,21,17,0
12493,1,0,0,0,6,0
99302,2,13,0,13,11,0
151423,1,7,0,7,17,1
366613,4,26,14,12,10,0
333249,3,6,14,-8,12,0
276153,1,10,0,10,3,0
42920,2,14,13,1,3,0
38754,1,0,3,-3,1,1
302663,3,17,13,4,15,1
84544,1,0,0,0,4,0
53295,4,9,10,-1,8,1
189074,3,21,30,-9,16,1
378080,4,0,17,-17,15,1
352211,1,0,3,-3,3,0
212913,2,7,7,0,10,0
345527,2,7,17,-10,17,1
154444,2,14,7,7,1,1
121823,2,0,7,-7,4,0
76364,3,16,6,10,1,1
321523,1,0,0,0,7,0
113518,4,3,7,-4,17,1
110032,3,34,10,24,16,0
152112,4,13,13,0,17,1
264997,1,0,0,0,16,0
315735,4,17,22,-5,4,1
48957,4,28,20,8,5,0
127720,1,0,7,-7,6,0
328191,4,14,17,-3,10,1
71894,2,12,13,-1,16,1
51964,4,13,16,-3,7,1
67968,4,35,13,22,14,1
317767,1,0,0,0,5,1
287308,1,3,0,3,8,1
92036,4,27,26,1,8,0
117022,2,0,10,-10,2,1
363782,1,0,7,-7,8,1
53285,4,3,7,-4,8,0
52318,1,3,0,3,7,0
79882,2,3,13,-10,2,1
271053,4,21,28,-7,1,1
390959,2,10,7,3,4,1
380670,3,7,7,0,16,0
391177,3,10,24,-14,4,1
355941,4,40,17,23,5,0
208115,1,0,0,0,8,0
267940,1,0,0,0,17,0
330438,4,13,20,-7,11,0
273026,3,6,3,3,2,1
13109,1,0,0,0,6,1
418085,1,0,0,0,16,1
309721,3,19,6,13,1,1
255474,2,7,0,7,12,1
18625,4,17,17,0,9,1
262277,2,3,9,-6,15,1
221733,3,10,7,3,14,1
179473,4,21,20,1,12,0
417218,3,17,17,0,16,0
57457,2,7,3,4,10,1
172274,4,24,13,11,9,0
59086,3,3,17,-14,10,0
119100,2,7,7,0,3,0
341685,3,20,13,7,16,1
20734,4,31,20,11,10,0
91063,4,9,0,9,7,1
298243,3,20,10,10,14,0
180064,4,28,20,8,13,0
341538,3,6,10,-4,16,1
212892,2,0,7,-7,10,1
397836,1,0,0,0,7,1
248388,1,3,0,3,8,1
408140,2,3,0,3,12,1
394883,2,0,17,-17,5,1
297645,2,7,0,7,13,0
189393,4,33,24,9,16,0
93616,3,13,6,7,9,1
142513,4,27,13,14,13,1
48626,4,21,27,-6,5,1
261047,1,0,7,-7,14,0
25297,3,34,14,20,12,1
56778,4,14,13,1,9,0
284877,1,0,0,0,7,0
376263,4,10,14,-4,14,0
421103,2,20,3,17,17,0
314037,2,6,0,6,3,0
20589,1,0,0,0,10,0
136405,2,3,6,-3,11,0
114616,2,3,3,0,1,1
205870,4,20,0,20,7,0
187689,2,13,6,7,16,0
73331,2,13,0,13,17,0
106243,1,0,0,0,14,0
123994,4,13,7,6,5,0
51486,3,27,24,3,7,1
301150,2,10,9,1,15,0
81839,2,0,21,-21,3,0
327566,3,10,15,-5,10,0
127271,1,3,7,-4,6,1
410041,4,6,45,-39,12,1
178268,1,0,0,0,12,1
254444,2,20,0,20,11,0
119196,4,16,7,9,3,0
375490,3,26,7,19,14,0
345295,4,19,17,2,17,0
282424,4,10,26,-16,6,1
5417,4,20,16,4,3,0
280261,2,6,13,-7,5,1
388892,2,10,14,-4,3,0
22742,2,3,21,-18,11,1
345107,3,12,3,9,17,1
277585,3,12,14,-2,4,0
25995,3,10,16,-6,13,1
70931,4,15,36,-21,15,1
3197,4,16,9,7,2,1
163123,2,16,19,-3,5,0
42935,3,24,23,1,3,1
348094,3,0,19,-19,1,1
316689,5,12,15,-3,4,1
403534,1,0,0,0,9,1
84217,4,17,10,7,4,0
370276,2,0,21,-21,12,0
317601,1,3,3,0,5,1
58257,3,14,10,4,10,0
369223,1,0,7,-7,11,1
147030,4,27,0,27,15,1
387434,3,21,16,5,2,0
333991,3,17,10,7,12,0
41541,4,18,7,11,2,0
53914,3,14,13,1,8,0
96673,1,0,0,0,10,1
109661,1,0,0,0,16,0
381108,3,24,28,-4,16,1
406670,2,14,0,14,11,1
347235,1,0,0,0,1,0
270203,1,3,7,-4,1,1
21501,1,0,0,0,11,0
139068,1,6,3,3,12,1
178243,4,6,10,-4,12,0
68883,4,6,20,-14,15,0
155069,2,6,26,-20,1,1
293487,2,10,3,7,11,0
266770,2,0,14,-14,16,0
329407,4,16,41,-25,10,1
82867,1,0,0,0,4,1
159029,1,0,0,0,3,1
333930,2,0,7,-7,12,1
223013,4,13,23,-10,14,1
161420,2,7,3,4,4,0
313742,3,21,3,18,3,0
417630,2,14,3,11,16,0
16662,3,14,27,-13,8,1
213174,2,3,7,-4,10,1
335688,2,7,7,0,13,0
150286,2,14,7,7,16,1
258828,2,7,7,0,13,0
176741,4,39,19,20,11,0
186397,1,0,0,0,15,0
408745,2,10,7,3,12,1
168335,4,17,24,-7,7,1
148094,4,14,10,4,15,0
145731,1,0,10,-10,15,1
31604,2,10,6,4,15,1
211442,1,3,7,-4,9,1
140212,5,13,13,0,12,1
268157,3,9,14,-5,17,0
140260,1,0,0,0,12,1
376202,2,10,7,3,14,0
276509,3,16,7,9,4,1
158610,2,7,7,0,3,0
371231,4,22,19,3,12,0
70828,1,7,0,7,15,0
177810,1,0,3,-3,12,1
217838,2,3,7,-4,12,0
319183,3,2,10,-8,5,1
355414,2,10,10,0,4,1
49908,1,7,0,7,6,1
292911,3,7,0,7,11,1
421379,2,13,17,-4,17,1
141339,2,3,13,-10,13,0
336239,1,3,0,3,13,1
34225,1,10,3,7,16,0
247772,4,10,6,4,8,0
130555,4,13,13,0,8,1
353707,3,3,10,-7,4,0
135319,1,0,10,-10,10,1
377180,4,16,17,-1,15,0
381249,3,17,10,7,16,0
106409,1,7,0,7,14,1
174709,4,9,7,2,10,1
390744,4,13,20,-7,3,0
259711,2,10,7,3,14,1
264824,4,17,37,-20,16,1
316479,4,16,17,-1,4,0
118958,2,0,17,-17,3,1
311034,2,10,0,10,2,0
65509,4,23,14,9,13,1
42788,2,6,21,-15,3,1
54834,3,13,0,13,8,1
131496,2,0,6,-6,8,0
213803,2,28,0,28,10,1
243579,2,10,7,3,6,0
81177,4,16,29,-13,3,0
211071,3,30,0,30,9,1
119614,3,10,9,1,3,1
187610,4,13,37,-24,16,1
97290,4,27,20,7,10,1
92860,2,24,0,24,8,0
219525,3,9,21,-12,13,0
380212,2,13,16,-3,16,1
84590,2,10,10,0,4,1
336074,1,0,0,0,13,1
285999,4,29,20,9,8,1
86824,2,9,6,3,5,0
112033,4,41,21,20,17,1
89503,1,0,3,-3,7,0
63712,1,7,3,4,12,1
54336,2,7,12,-5,8,1
157032,1,0,0,0,2,0
190190,1,0,0,0,17,0
91563,4,26,10,16,8,0
186469,3,10,13,-3,15,1
245992,1,0,3,-3,7,1
22931,4,3,23,-20,11,0
129115,3,27,28,-1,7,1
194294,2,10,3,7,2,0
308285,4,13,23,-10,1,1
307223,4,3,10,-7,17,1
406102,3,0,20,-20,11,0
209190,2,7,7,0,8,0
413095,2,27,21,6,14,0
93618,3,13,6,7,9,1
77657,2,6,10,-4,1,1
134375,4,29,21,8,10,0
398849,1,0,0,0,7,1
3452,3,3,23,-20,2,1
100633,2,7,7,0,12,0
310792,4,13,10,3,2,0
59549,4,13,35,-22,11,0
318107,2,9,7,2,5,1
180568,4,28,32,-4,13,1
44335,4,24,23,1,3,0
191774,1,0,0,0,1,0
411431,2,7,14,-7,13,0
105573,4,29,21,8,14,1
256059,1,0,3,-3,12,0
293236,3,16,7,9,11,1
391248,1,7,0,7,4,1
169662,3,20,10,10,8,0
151515,3,35,7,28,17,1
411145,2,0,20,-20,13,0
95948,1,0,0,0,10,0
26532,1,3,3,0,13,1
269355,2,7,14,-7,1,1
9427,2,0,0,0,5,1
258761,4,3,37,-34,13,1
313243,1,0,0,0,3,1
296140,1,10,6,4,13,1
122098,2,10,7,3,4,0
381430,4,23,7,16,16,0
138491,3,24,30,-6,12,0
290223,2,17,3,14,10,1
366602,4,26,14,12,10,1
34748,3,13,3,10,16,1
248782,3,27,14,13,9,1
6416,3,9,19,-10,3,0
26793,4,13,40,-27,13,1
402230,1,0,3,-3,9,1
17236,3,7,34,-27,9,1
242358,4,34,13,21,6,0
301013,2,10,3,7,15,1
325101,1,3,0,3,8,0
112455,4,13,16,-3,17,1
387302,4,6,10,-4,2,1
73591,1,0,0,0,17,1
177080,2,10,10,0,11,1
29086,1,0,6,-6,14,1
272669,2,9,0,9,2,0
217217,4,12,19,-7,12,0
218100,1,0,0,0,12,1
207760,3,24,13,11,7,1
348426,4,13,23,-10,1,1
25742,4,14,10,4,12,0
146901,4,34,0,34,15,0
226449,2,7,7,0,16,0
255378,3,21,6,15,12,0
386811,3,10,7,3,2,0
327978,2,7,0,7,10,1
126348,2,7,14,-7,6,0
153692,2,2,14,-12,1,1
419974,1,3,0,3,17,1
53663,1,0,0,0,8,0
311905,2,14,7,7,2,0
276356,3,17,28,-11,3,0
163379,1,0,6,-6,5,1
98402,2,7,7,0,11,0
73461,1,0,14,-14,17,1
191126,3,21,20,1,17,1
326712,4,23,13,10,9,0
306843,1,0,3,-3,17,0
367724,3,6,13,-7,10,1
46607,2,3,0,3,4,0
12726,3,52,0,52,6,1
406385,3,10,7,3,11,1
94953,2,3,6,-3,9,1
111986,3,17,21,-4,17,1
269074,3,13,16,-3,17,0
275755,2,16,3,13,3,1
283162,3,13,9,4,7,1
90294,2,7,14,-7,7,0
158438,1,0,0,0,3,0
358085,1,7,0,7,6,1
142594,2,3,3,0,13,1
387442,3,21,16,5,2,1
185465,4,17,20,-3,15,1
280844,2,10,3,7,6,0
323703,4,26,0,26,8,0
417942,1,7,14,-7,16,1
43467,1,0,0,0,3,1
194963,4,14,22,-8,2,1
205556,4,14,24,-10,6,1
219896,1,0,0,0,13,1
292717,1,7,7,0,11,0
251547,3,16,13,3,10,1
140058,1,0,0,0,12,1
7858,1,3,7,-4,4,1
413216,1,7,0,7,14,0
326964,2,2,7,-5,9,0
6318,4,19,25,-6,3,1
369285,3,14,14,0,11,0
201178,3,13,21,-8,5,1
15528,4,23,6,17,8,0
122656,1,0,0,0,4,0
79225,4,23,13,10,2,1
166023,4,17,21,-4,6,1
46365,3,6,17,-11,4,0
362577,4,33,18,15,8,0
155660,2,3,10,-7,2,1
258989,2,3,16,-13,13,0
273653,3,13,13,0,2,1
93586,2,6,6,0,9,0
70005,3,24,3,21,15,0
383320,1,0,0,0,17,1
288199,1,3,7,-4,9,1
245956,4,21,37,-16,7,1
156390,4,38,14,24,2,0
116228,1,3,0,3,1,0
157453,3,16,23,-7,2,0
141666,2,23,14,9,13,0
179422,3,6,13,-7,12,0
277144,4,10,24,-14,4,0
228139,1,0,0,0,17,0
359970,1,0,6,-6,7,1
131429,4,7,19,-12,8,0
61610,4,35,14,21,11,0
147784,1,0,7,-7,15,1
91457,2,9,0,9,8,1
200420,2,10,18,-8,4,0
53926,3,14,13,1,8,1
127919,2,16,0,16,6,0
213266,4,17,24,-7,10,0
44441,3,17,7,10,3,1
97476,1,13,0,13,10,0
134359,3,23,21,2,10,0
219571,4,21,24,-3,13,1
151490,3,35,7,28,17,0
394356,4,24,17,7,5,1
31541,4,10,17,-7,15,0
28761,1,0,0,0,14,0
30801,4,31,35,-4,15,0
39298,3,10,27,-17,1,1
292415,1,3,0,3,11,0
51955,4,13,16,-3,7,0
193277,3,3,20,-17,1,0
343330,2,0,10,-10,16,0
83565,3,0,17,-17,4,0
375648,3,17,17,0,14,0
366319,4,28,10,18,10,0
31911,2,6,10,-4,15,0
180786,3,10,13,-3,13,1
374178,4,23,21,2,13,1
178811,3,24,14,10,12,0
162757,1,0,0,0,5,0
276473,2,10,7,3,4,1
165250,3,17,7,10,6,0
383882,4,3,10,-7,1,1
367006,3,3,31,-28,10,0
348673,2,3,10,-7,2,1
203518,3,24,3,21,6,1
66258,4,45,3,42,13,1
76548,4,7,41,-34,1,1
64619,3,20,17,3,13,1
30217,4,13,31,-18,14,0
322842,4,10,40,-30,7,0
87557,2,17,3,14,6,0
232963,2,10,3,7,2,1
38557,3,30,6,24,1,1
264352,1,0,0,0,15,1
62224,1,0,7,-7,12,1
305422,3,20,3,17,17,1
282556,4,17,24,-7,6,1
46391,4,6,17,-11,4,1
376545,3,8,6,2,14,1
75388,1,7,0,7,17,1
241579,3,3,20,-17,5,1
58652,5,20,20,0,10,0
1335,1,0,0,0,1,0
414724,3,3,17,-14,14,1
71478,3,33,7,26,16,0
98254,2,7,24,-17,11,1
115924,4,20,30,-10,1,0
178813,3,24,14,10,12,0
266861,5,17,17,0,16,1
59732,1,6,7,-1,11,0
363099,2,7,3,4,8,0
1768,1,0,0,0,1,1
41924,3,21,6,15,2,0
243274,2,7,10,-3,6,1
281999,4,21,28,-7,6,1
30395,1,0,13,-13,14,1
85592,1,0,0,0,5,1
351955,2,21,14,7,3,0
362371,3,23,14,9,8,1
251619,4,19,20,-1,10,1
227750,2,3,14,-11,16,0
29022,4,14,10,4,14,0
315406,4,16,23,-7,4,0
52580,4,22,10,12,7,0
350197,3,19,0,19,2,0
31399,4,7,10,-3,15,1
153566,3,12,14,-2,1,1
342632,4,22,27,-5,16,0
119623,3,17,9,8,3,0
321697,1,0,3,-3,7,1
199497,1,14,0,14,4,0
142172,4,2,10,-8,13,1
316956,4,37,18,19,4,0
274747,4,24,20,4,3,1
189400,4,33,24,9,16,0
39095,2,13,0,13,1,0
242989,5,34,34,0,6,0
241922,4,23,20,3,5,0
120630,4,3,20,-17,3,0
309294,3,0,20,-20,1,0
324247,2,3,0,3,8,0
158021,2,0,6,-6,3,1
127384,4,17,23,-6,6,1
365231,1,0,7,-7,9,0
66022,2,7,0,7,13,1
140401,1,0,0,0,12,0
356022,3,21,10,11,5,1
350050,3,20,13,7,2,1
110895,2,7,3,4,16,1
231287,2,3,3,0,1,1
16913,2,14,13,1,8,0
396635,4,23,10,13,6,0
394318,3,17,10,7,5,1
135755,1,0,0,0,10,0
41208,3,6,13,-7,2,1
352558,3,27,13,14,3,0
311069,3,10,3,7,2,0
70688,1,0,3,-3,15,1
272097,3,17,6,11,2,0
170996,1,7,7,0,8,0
259956,4,20,20,0,14,1
303562,1,14,3,11,16,0
253787,4,24,17,7,11,0
204019,4,16,7,9,6,0
196521,2,10,3,7,2,0
267925,1,0,0,0,17,1
135126,4,31,6,25,10,0
96232,4,3,22,-19,10,0
368499,1,0,0,0,11,1
340101,4,20,15,5,15,0
329989,4,7,10,-3,11,1
131687,2,10,22,-12,8,0
21695,2,10,7,3,11,0
60910,1,0,0,0,11,1
399342,2,24,7,17,7,0
115096,2,3,13,-10,1,1
337403,4,21,14,7,14,1
150466,3,27,6,21,16,0
261197,1,20,0,20,14,1
373508,2,0,10,-10,13,0
180829,4,17,20,-3,13,1
273220,4,40,7,33,2,1
333497,2,6,0,6,12,0
116024,3,13,7,6,1,0
324859,2,10,10,0,8,0
287867,4,28,23,5,9,1
276658,3,20,6,14,4,1
339574,2,10,7,3,15,0
70573,2,0,7,-7,15,1
243338,4,14,30,-16,6,1
75404,2,10,0,10,17,0
389161,1,7,0,7,3,1
300213,4,31,3,28,14,0
411620,3,14,28,-14,13,1
405788,4,18,21,-3,10,1
180845,5,20,20,0,13,0
268489,3,23,9,14,17,0
362166,1,3,0,3,8,0
33696,3,28,0,28,16,1
183287,4,16,20,-4,14,1
292799,4,29,17,12,11,1
382603,1,0,0,0,17,0
272154,1,0,0,0,2,0
28844,3,16,7,9,14,1
129962,1,0,0,0,8,1
31364,3,7,3,4,15,1
18399,1,0,0,0,9,0
77170,1,0,0,0,1,0
36697,4,20,10,10,17,1
214521,1,0,0,0,11,0
141718,4,30,21,9,13,0
8557,1,0,0,0,4,0
367081,1,7,0,7,10,0
105714,3,28,3,25,14,1
172767,4,21,18,3,9,0
204297,3,0,10,-10,6,0
229720,3,13,17,-4,17,1
227268,2,3,13,-10,16,0
79112,1,0,0,0,2,0
35788,3,3,10,-7,17,1
44125,3,10,13,-3,3,0
282931,1,7,0,7,6,0
21514,1,0,0,0,11,1
73898,1,7,0,7,17,1
113069,4,16,16,0,17,0
267437,4,17,24,-7,17,1
275082,4,34,27,7,3,1
106328,3,14,19,-5,14,0
394567,1,0,0,0,5,1
380633,2,7,7,0,16,0
39518,1,0,0,0,1,0
405365,1,0,0,0,10,0
48687,2,7,10,-3,5,0
175534,2,16,0,16,11,1
10081,3,31,7,24,5,1
303736,2,14,10,4,16,1
216216,3,17,3,14,12,0
74950,2,17,10,7,17,0
155706,3,10,13,-3,2,0
144994,2,0,3,-3,14,1
257361,2,17,0,17,13,0
136879,2,0,10,-10,11,1
204653,4,17,48,-31,6,1
256941,4,20,21,-1,12,1
173043,3,21,6,15,9,1
327315,4,16,20,-4,9,0
18420,2,0,7,-7,9,1
178401,4,31,34,-3,12,1
43723,4,24,17,7,3,1
36942,3,0,25,-25,17,1
21717,3,17,7,10,11,0
260788,2,3,6,-3,14,1
264127,3,20,27,-7,15,1
403550,1,7,0,7,9,1
223553,3,10,13,-3,15,1
1938,2,3,0,3,1,1
149881,3,6,16,-10,16,0
377659,2,9,7,2,15,1
408677,4,31,17,14,12,1
319498,3,10,17,-7,6,0
68877,4,6,20,-14,15,1
374801,1,7,0,7,14,1
357399,2,17,17,0,5,0
371366,4,42,10,32,12,1
53319,4,24,16,8,8,0
94371,3,17,14,3,9,0
73739,1,3,0,3,17,1
421841,3,0,13,-13,17,0
165443,4,13,36,-23,6,0
306350,4,30,10,20,17,1
284716,1,0,7,-7,7,1
156837,3,23,23,0,2,1
212949,3,7,7,0,10,1
128720,4,13,30,-17,7,1
278049,3,10,10,0,4,1
383693,3,9,24,-15,17,0
288244,3,10,21,-11,9,0
48341,1,0,0,0,5,0
297932,2,16,7,9,13,1
254616,3,21,14,7,11,0
357923,1,0,0,0,6,0
413073,2,20,14,6,14,1
62866,2,3,3,0,12,1
35003,2,9,0,9,16,1
159871,2,17,0,17,3,0
157387,2,3,7,-4,2,1
234838,3,0,12,-12,2,1
240491,3,3,7,-4,5,0
323133,4,29,14,15,7,1
215603,2,14,3,11,11,1
137593,4,27,34,-7,11,0
17569,4,13,17,-4,9,1
193454,4,23,20,3,1,1
50986,2,0,7,-7,6,0
29511,4,10,14,-4,14,1
294839,3,35,21,14,12,0
350400,1,0,0,0,2,0
206018,4,16,17,-1,7,0
231898,3,7,34,-27,1,1
247949,1,0,0,0,8,0
325314,2,9,10,-1,8,1
266990,4,19,17,2,17,0
300337,3,3,7,-4,14,1
256072,1,0,3,-3,12,0
149655,1,14,0,14,16,0
362910,2,7,0,7,8,1
401425,3,17,10,7,8,1
279506,2,10,6,4,5,1
35539,4,30,7,23,17,1
8861,1,7,0,7,4,1
389383,3,30,13,17,3,0
66479,2,7,10,-3,14,0
227460,3,13,10,3,16,0
25761,4,17,17,0,12,1
402088,1,3,0,3,9,1
196992,3,20,17,3,3,1
7251,2,7,13,-6,4,0
243944,4,25,13,12,6,0
23987,4,23,6,17,12,1
291301,3,21,19,2,10,0
334627,1,0,0,0,13,1
301080,4,30,13,17,15,0
201852,4,26,30,-4,5,0
80829,3,3,3,0,3,1
118805,2,10,0,10,2,1
83014,1,0,0,0,4,1
110163,3,20,17,3,16,0
65431,2,0,14,-14,13,1
328750,2,14,6,8,10,0
314605,2,7,0,7,3,0
390437,4,14,27,-13,3,0
183653,2,0,8,-8,14,1
186351,4,29,17,12,15,0
234483,3,20,13,7,2,0
19981,2,6,3,3,10,1
59532,4,13,20,-7,11,0
219331,2,16,7,9,13,0
48872,2,9,0,9,5,1
180594,1,7,3,4,13,0
17631,1,6,3,3,9,1
242463,2,3,7,-4,6,0
148767,2,13,6,7,16,0
155715,3,10,20,-10,2,1
15274,4,30,7,23,8,0
371667,4,24,17,7,12,1
146416,3,16,3,13,15,1
95232,2,3,7,-4,10,1
209637,1,0,0,0,8,1
291464,4,20,20,0,10,1
48834,2,3,0,3,5,0
60270,4,10,16,-6,11,1
49122,5,20,23,-3,6,0
97988,3,17,10,7,11,0
298664,2,6,7,-1,14,1
102768,2,10,3,7,13,1
421746,4,24,17,7,17,1
250249,1,0,0,0,9,0
132910,4,6,21,-15,9,0
170162,4,10,13,-3,8,0
362343,2,10,7,3,8,1
355408,2,10,10,0,4,1
164550,4,26,17,9,5,0
285988,4,29,14,15,8,0
82594,1,0,10,-10,3,0
139393,2,14,0,14,12,1
329656,3,16,14,2,11,1
49364,3,7,10,-3,6,0
116431,2,3,10,-7,1,1
190812,2,13,3,10,17,1
218965,1,0,0,0,13,1
166227,1,0,0,0,6,1
278712,1,0,0,0,5,0
117456,2,7,7,0,2,1
261479,1,3,0,3,14,1
399226,3,13,13,0,7,0
46341,3,6,17,-11,4,0
200025,4,24,17,7,4,0
380850,4,9,31,-22,16,0
284145,2,3,6,-3,7,0
223644,2,6,3,3,15,0
256375,1,6,0,6,12,0
186129,2,3,3,0,15,1
154765,3,13,16,-3,1,1
400113,3,17,23,-6,8,1
135816,2,7,14,-7,10,0
285333,4,24,9,15,7,0
166891,2,7,3,4,6,1
135072,2,17,3,14,10,0
88767,2,12,3,9,6,1
387856,2,10,27,-17,2,0
330142,4,0,13,-13,11,0
198158,2,7,3,4,3,1
340114,1,0,0,0,15,1
183008,4,10,44,-34,14,1
15264,4,23,7,16,8,1
242448,2,0,7,-7,6,1
294194,2,0,7,-7,12,0
135224,2,13,3,10,10,0
383307,4,48,24,24,17,1
298205,2,7,3,4,14,0
317995,3,10,10,0,5,0
413473,4,17,38,-21,14,0
82763,2,6,6,0,3,0
79745,2,17,7,10,2,1
200640,3,27,28,-1,4,0
172600,4,17,24,-7,9,1
273515,4,14,21,-7,2,1
364217,2,0,0,0,9,0
302337,2,7,3,4,15,1
263527,4,20,26,-6,15,1
53279,3,3,7,-4,8,1
410740,3,17,6,11,13,0
254084,1,0,0,0,11,0
135318,1,0,10,-10,10,1
238418,4,17,33,-16,4,0
250641,2,3,9,-6,10,0
232777,2,13,0,13,2,0
403108,1,0,0,0,9,0
277761,4,14,6,8,4,1
276312,2,7,14,-7,3,1
168460,3,0,24,-24,7,0
91512,3,19,3,16,8,0
391490,1,0,0,0,4,0
289385,4,31,25,6,9,1
223485,2,7,3,4,15,0
56261,2,3,14,-11,9,1
69251,2,6,0,6,15,1
31420,1,3,0,3,15,0
120154,4,10,6,4,3,1
271921,3,17,13,4,2,0
390561,3,17,14,3,3,1
57341,3,7,3,4,10,1
132826,2,3,7,-4,9,1
273411,1,0,0,0,2,0
254558,1,0,7,-7,11,1
125258,1,0,0,0,5,1
130127,1,0,3,-3,8,1
3638,4,20,28,-8,2,1
16765,2,3,14,-11,8,0
326892,1,0,0,0,9,0
81518,2,0,14,-14,3,0
12240,2,0,3,-3,6,1
262415,2,7,7,0,15,0
36372,3,13,19,-6,17,1
148546,1,0,0,0,16,0
16018,1,6,0,6,8,1
307251,4,10,13,-3,17,1
243216,1,0,0,0,6,0
328532,4,15,3,12,10,0
43731,4,24,17,7,3,1
151151,2,3,10,-7,17,0
65414,2,0,7,-7,13,1
117877,4,12,20,-8,2,1
316799,3,16,7,9,4,1
189539,4,20,7,13,17,1
95352,1,0,0,0,10,1
299515,1,0,0,0,14,0
209507,2,20,3,17,8,0
406672,3,14,0,14,11,1
370020,3,10,7,3,12,1
143270,4,17,16,1,13,0
338864,3,13,20,-7,15,0
342022,4,20,3,17,16,1
244813,2,7,3,4,7,1
419117,1,10,0,10,16,0
373621,1,0,0,0,13,0
11510,2,6,10,-4,6,1
415835,1,0,13,-13,15,1
214313,4,14,10,4,11,1
65748,3,14,16,-2,13,1
58614,4,10,17,-7,10,1
312819,2,7,0,7,3,1
261827,2,6,10,-4,14,0
134613,3,24,17,7,10,1
196965,2,20,0,20,3,0
158721,1,0,0,0,3,1
178717,4,3,26,-23,12,1
148302,2,7,3,4,16,1
293960,4,7,21,-14,12,1
153133,3,19,17,2,1,1
36765,2,7,7,0,17,0
305613,4,23,10,13,17,0
291878,2,7,10,-3,11,1
362806,3,7,21,-14,8,1
387244,2,6,7,-1,2,0
399499,3,0,24,-24,7,0
183876,4,44,28,16,14,1
218845,1,7,3,4,13,1
81998,2,7,0,7,3,0
296916,2,13,0,13,13,1
411825,4,0,34,-34,13,1
186118,1,3,0,3,15,0
94098,4,6,31,-25,9,1
1644,1,0,0,0,1,0
50545,2,0,6,-6,6,1
97726,4,9,13,-4,11,1
181952,1,0,0,0,13,1
331628,4,23,30,-7,11,0
265082,3,13,3,10,16,0
240904,2,14,3,11,5,0
70913,3,15,33,-18,15,0
366437,3,26,10,16,10,1
122674,1,0,3,-3,4,1
94679,3,17,29,-12,9,1
311917,2,21,7,14,2,0
78143,2,17,3,14,2,1
175157,3,35,10,25,10,0
411493,3,13,17,-4,13,0
241856,2,13,6,7,5,1
170368,1,7,0,7,8,1
373532,3,7,19,-12,13,1
215269,1,0,0,0,11,0
221266,2,0,19,-19,14,0
331436,2,6,7,-1,11,0
378255,2,0,3,-3,15,0
370316,3,7,35,-28,12,1
52311,1,0,0,0,7,1
377097,2,10,7,3,15,0
391195,4,10,24,-14,4,1
182233,4,33,7,26,13,0
90210,4,6,3,3,7,1
225963,3,27,14,13,16,1
169798,2,3,14,-11,8,0
153453,4,20,17,3,1,1
296560,1,0,0,0,13,0
43981,3,3,14,-11,3,0
226068,1,0,7,-7,16,0
324879,3,10,13,-3,8,1
64364,4,27,27,0,13,0
186848,4,29,20,9,15,1
98171,4,21,19,2,11,1
213265,4,17,24,-7,10,1
166053,4,20,31,-11,6,1
118111,2,6,20,-14,2,1
175398,2,17,3,14,11,0
91123,1,0,7,-7,8,1
69582,3,7,10,-3,15,1
395797,2,0,7,-7,6,1
261109,3,7,21,-14,14,1
283261,2,10,9,1,7,1
18328,3,22,17,5,9,1
339846,1,16,0,16,15,0
103685,3,0,10,-10,13,0
396978,2,7,3,4,6,0
250325,2,7,7,0,9,0
349786,4,29,21,8,2,0
312840,3,7,0,7,3,0
127028,4,24,20,4,6,1
102450,2,3,3,0,13,1
146574,4,14,24,-10,15,0
39439,3,10,10,0,1,1
392204,3,10,13,-3,4,1
252796,3,6,6,0,11,1
344420,4,28,24,4,17,1
165079,3,10,24,-14,6,0
24809,2,6,3,3,12,1
191549,3,14,24,-10,17,0
41314,2,13,9,4,2,1
317947,2,10,3,7,5,1
188150,3,10,10,0,16,0
74612,1,0,0,0,17,0
13053,4,14,7,7,6,1
356915,1,3,0,3,5,1
241321,4,13,14,-1,5,1
11122,4,17,13,4,5,0
113246,1,7,0,7,17,0
116758,3,13,26,-13,2,1
197809,1,0,0,0,3,1
135432,4,28,27,1,10,1
20053,4,19,16,3,10,1
167816,1,0,13,-13,7,1
179656,5,31,30,1,12,1
110548,1,0,0,0,16,1
106547,1,7,0,7,14,1
158169,2,7,0,7,3,0
206646,4,10,16,-6,7,1
299784,4,17,17,0,14,1
396085,2,17,9,8,6,1
335523,1,0,0,0,13,1
98013,4,17,17,0,11,1
319691,4,33,9,24,6,1
124377,1,0,0,0,5,0
188002,3,20,14,6,16,1
339146,3,10,13,-3,15,1
179759,3,6,17,-11,12,1
280460,4,34,24,10,5,0
329865,1,0,0,0,11,1
254441,2,20,0,20,11,0
404256,1,0,0,0,10,0
79434,2,9,7,2,2,0
84019,3,27,3,24,4,0
220030,4,22,35,-13,13,1
313172,3,13,13,0,3,0
273334,3,28,0,28,2,0
223098,3,31,14,17,14,1
29845,2,6,10,-4,14,0
36629,2,3,3,0,17,1
342329,4,23,6,17,16,0
237520,3,24,7,17,3,0
96168,2,0,16,-16,10,1
287662,3,9,10,-1,9,1
365155,3,7,28,-21,9,1
151537,4,42,7,35,17,1
77543,3,20,14,6,1,1
182141,2,16,7,9,13,1
236784,2,0,9,-9,3,1
379841,1,7,0,7,16,0
379594,2,16,13,3,16,1
158133,1,0,0,0,3,0
291130,2,15,13,2,10,1
373777,1,0,0,0,13,0
57230,4,20,14,6,10,1
202241,1,3,0,3,5,1
212372,4,13,17,-4,10,1
350972,4,21,17,4,3,1
264447,4,13,28,-15,15,0
180087,4,31,20,11,13,0
403054,4,24,24,0,9,0
275925,3,13,18,-5,3,1
282,4,12,34,-22,1,1
28402,3,13,3,10,14,0
231812,4,26,20,6,1,1
60643,2,7,3,4,11,1
175584,3,27,7,20,11,0
230979,1,0,0,0,1,0
377011,4,15,19,-4,15,1
309047,4,0,20,-20,1,1
327699,2,3,10,-7,10,1
150101,1,0,6,-6,16,1
191215,2,0,17,-17,17,0
4809,4,27,3,24,3,1
363203,1,0,7,-7,8,1
369439,3,31,7,24,11,1
350797,4,17,10,7,2,0
155575,3,23,3,20,2,0
93353,4,30,6,24,9,0
348038,2,0,10,-10,1,1
17443,4,17,7,10,9,1
325316,2,9,10,-1,8,1
88837,4,13,13,0,6,0
404107,1,0,0,0,10,1
164890,2,0,3,-3,6,0
145463,3,16,14,2,14,0
45130,2,7,7,0,4,1
222129,1,0,0,0,14,1
16249,3,6,10,-4,8,1
156593,1,0,0,0,2,0
135985,2,3,10,-7,10,0
275647,3,27,3,24,3,1
176107,1,7,0,7,11,0
202776,4,16,17,-1,5,1
353818,1,7,13,-6,4,0
91886,1,0,0,0,8,0
117905,1,0,0,0,2,0
315919,1,0,0,0,4,1
158670,3,14,7,7,3,0
380720,4,7,16,-9,16,1
29419,2,0,14,-14,14,1
171260,1,0,0,0,9,0
142078,1,0,0,0,13,0
406319,1,0,0,0,11,0
358941,4,14,38,-24,6,0
238481,2,6,0,6,4,0
366102,1,7,7,0,10,0
62596,2,6,17,-11,12,1
109663,1,0,0,0,16,1
342197,1,0,0,0,16,0
36975,4,0,32,-32,17,1
254242,1,0,3,-3,11,1
27200,3,16,7,9,13,1
218579,2,7,17,-10,13,1
199357,2,0,3,-3,4,0
135576,4,21,6,15,10,1
148354,4,14,3,11,16,0
326021,1,9,0,9,9,0
362327,2,3,7,-4,8,1
163790,4,17,12,5,5,0
274665,2,7,3,4,3,1
201070,4,41,7,34,5,0
156128,2,7,7,0,2,0
268610,3,7,6,1,17,0
211974,2,3,10,-7,9,1
356012,2,14,10,4,5,1
41250,4,10,13,-3,2,1
182655,3,0,12,-12,14,1
191859,3,20,10,10,1,0
244150,1,0,7,-7,6,0
333464,1,3,0,3,12,0
213340,2,10,6,4,10,0
238876,4,41,13,28,4,0
266747,1,0,7,-7,16,0
64444,2,7,6,1,13,1
223181,1,3,0,3,15,0
243174,4,23,22,1,6,1
192694,4,19,7,12,1,0
122474,4,13,26,-13,4,1
361095,4,23,9,14,7,0
128235,3,20,7,13,7,1
293127,4,10,30,-20,11,1
356918,1,3,0,3,5,0
43464,1,0,0,0,3,1
237200,2,3,0,3,3,1
38478,1,0,3,-3,1,1
365421,2,7,12,-5,9,1
400761,1,7,0,7,8,0
406010,1,0,0,0,11,0
404009,2,3,14,-11,10,1
274663,2,7,3,4,3,1
38243,3,13,14,-1,1,1
316509,1,0,0,0,4,1
192939,2,7,17,-10,1,0
136550,1,0,10,-10,11,0
351215,3,28,10,18,3,0
35130,1,0,7,-7,16,1
123814,3,10,3,7,5,1
63244,1,0,0,0,12,0
218003,2,21,10,11,12,1
219293,1,10,6,4,13,0
186730,1,7,0,7,15,0
90367,4,20,32,-12,7,0
210957,4,33,23,10,9,0
95508,1,3,0,3,10,0
280449,3,19,24,-5,5,1
209995,2,7,3,4,8,0
210176,3,7,14,-7,9,0
86023,4,22,22,0,5,1
128592,1,0,0,0,7,1
196171,4,31,24,7,2,1
28888,4,23,10,13,14,1
237829,2,7,13,-6,4,1
307103,4,24,6,18,17,0
266111,4,17,13,4,16,1
223483,1,7,3,4,15,0
133357,4,14,9,5,9,1
337759,2,13,6,7,14,0
333262,4,6,21,-15,12,0
76523,3,7,20,-13,1,0
126944,1,3,7,-4,6,1
238240,4,3,16,-13,4,1
69835,2,14,3,11,15,1
148502,4,24,3,21,16,0
386229,3,12,17,-5,2,1
325279,2,3,3,0,8,1
33867,4,9,41,-32,16,0
269695,3,10,12,-2,1,0
413249,2,10,0,10,14,0
234964,2,10,3,7,2,1
304059,2,3,20,-17,16,0
281108,1,0,0,0,6,0
29642,4,14,21,-7,14,0
375616,2,14,17,-3,14,1
206394,2,10,0,10,7,1
225962,3,27,14,13,16,1
288133,4,16,7,9,9,1
42463,2,0,5,-5,3,1
377710,3,25,7,18,15,1
331116,2,7,6,1,11,0
264464,4,20,35,-15,15,1
116325,3,24,13,11,1,1
210600,2,13,14,-1,9,0
204199,4,24,20,4,6,0
164307,2,13,0,13,5,0
136712,2,6,10,-4,11,1
109619,4,25,14,11,16,1
132869,3,6,14,-8,9,0
1382,3,10,0,10,1,0
79497,4,12,17,-5,2,0
297317,1,0,3,-3,13,1
48038,4,10,27,-17,5,0
149594,4,17,26,-9,16,0
253569,3,6,10,-4,11,1
193708,3,3,27,-24,1,0
39756,3,9,7,2,1,1
381565,4,28,16,12,17,0
98644,4,14,10,4,11,1
72683,4,20,10,10,16,0
120689,2,10,0,10,3,0
225349,3,10,21,-11,15,0
101349,1,6,0,6,12,0
264346,1,0,0,0,15,1
22636,3,23,10,13,11,0
305457,4,20,3,17,17,0
385161,3,14,17,-3,1,0
325127,2,10,7,3,8,0
163546,2,7,6,1,5,1
399598,1,3,0,3,8,0
354950,2,7,3,4,4,0
188493,1,0,0,0,16,1
10173,2,6,3,3,5,1
331171,3,7,13,-6,11,1
342574,3,12,13,-1,16,0
263422,1,0,13,-13,15,1
204217,1,0,7,-7,6,1
10545,4,40,0,40,5,0
255191,2,7,7,0,12,1
108270,4,9,7,2,15,0
386493,2,7,6,1,2,0
261153,4,21,24,-3,14,0
194979,4,14,22,-8,2,0
234631,2,20,17,3,2,1
70980,1,3,0,3,16,1
58586,3,10,10,0,10,0
18676,1,0,0,0,9,0
207100,1,0,0,0,7,0
389607,2,7,7,0,3,1
264946,3,23,17,6,16,1
280559,2,14,6,8,5,1
46892,2,13,12,1,5,0
98083,1,0,0,0,11,1
16327,1,7,0,7,8,0
166677,1,0,0,0,6,1
370318,3,14,35,-21,12,0
335322,3,3,16,-13,13,0
163518,1,7,3,4,5,1
258241,1,7,0,7,13,0
407196,1,0,0,0,11,0
122451,3,13,26,-13,4,0
387822,2,10,7,3,2,1
296205,3,16,26,-10,13,0
141055,3,13,10,3,13,1
418229,1,0,0,0,16,0
151847,1,0,0,0,17,1
163289,3,13,13,0,5,1
61968,2,3,0,3,12,0
12407,3,10,6,4,6,0
417253,4,20,20,0,16,0
267332,1,0,0,0,17,0
374577,3,20,13,7,14,0
318003,3,10,13,-3,5,1
72406,4,17,23,-6,16,1
102443,2,3,3,0,13,0
241453,4,10,42,-32,5,1
144725,3,3,0,3,14,0
340941,3,7,10,-3,15,1
267671,2,6,24,-18,17,1
360999,1,0,2,-2,7,1
64375,4,30,27,3,13,0
203299,2,0,24,-24,6,1
7684,1,3,0,3,4,0
63536,1,0,0,0,12,1
220277,3,20,9,11,13,1
99579,1,0,0,0,11,0
268273,2,10,0,10,17,0
63924,3,6,24,-18,12,1
347487,3,12,16,-4,1,0
147084,2,7,17,-10,15,0
186947,3,7,9,-2,15,0
217887,3,17,21,-4,12,0
349188,4,27,14,13,2,0
27874,1,0,0,0,13,1
65586,2,6,6,0,13,1
183899,1,6,0,6,14,1
362502,2,14,6,8,8,0
291109,2,12,13,-1,10,1
419726,2,3,10,-7,17,0
90377,1,0,0,0,7,0
229088,2,10,7,3,17,0
243112,3,7,9,-2,6,0
99829,4,8,24,-16,12,0
215563,1,0,0,0,11,1
256898,2,14,16,-2,12,0
354434,1,7,7,0,4,1
91934,2,3,10,-7,8,1
347030,4,23,10,13,1,1
229475,4,13,9,4,17,0
2458,4,28,20,8,2,0
49489,2,0,3,-3,6,1
262663,4,29,16,13,15,1
206723,3,7,14,-7,7,0
406935,2,0,13,-13,11,1
97363,2,9,6,3,10,0
129165,1,0,0,0,7,1
316202,1,0,0,0,4,0
45484,3,27,17,10,4,0
152716,1,0,0,0,17,1
343959,2,16,6,10,17,1
340003,2,14,6,8,15,0
400423,4,24,10,14,8,0
161007,3,16,7,9,4,0
84924,4,47,17,30,4,1
264112,3,13,27,-14,15,0
396225,1,0,3,-3,6,1
236921,2,26,0,26,3,1
84301,3,7,27,-20,4,1
392444,1,0,0,0,4,1
179403,2,6,13,-7,12,1
31060,3,13,13,0,15,1
13477,3,6,21,-15,7,0
143830,4,12,7,5,14,1
146039,2,10,0,10,15,0
23994,4,26,6,20,12,0
369328,4,14,20,-6,11,1
283174,4,20,9,11,7,1
167308,2,16,10,6,7,0
21192,4,0,16,-16,10,1
330451,4,20,20,0,11,0
342034,4,20,3,17,16,1
340713,4,22,23,-1,15,1
57717,1,0,0,0,10,0
216004,1,0,9,-9,11,1
172400,3,13,35,-22,9,1
392543,4,3,20,-17,4,1
215417,1,7,0,7,11,0
385334,4,17,20,-3,1,1
863,4,14,12,2,1,1
333257,4,6,21,-15,12,1
148947,3,10,12,-2,16,1
200923,4,33,7,26,4,1
395620,2,7,10,-3,6,0
16409,4,21,16,5,8,1
8909,2,21,0,21,4,0
383830,3,3,7,-4,1,0
216853,2,7,14,-7,12,1
392355,3,17,28,-11,4,1
32921,1,0,7,-7,15,1
362614,2,0,7,-7,8,0
419589,2,20,10,10,17,0
139033,4,21,19,2,12,1
403187,3,17,14,3,9,0
310819,4,20,13,7,2,1
295445,4,17,13,4,12,0
245959,4,21,37,-16,7,1
299422,2,0,20,-20,14,0
226065,1,0,7,-7,16,1
218197,3,30,3,27,12,0
79204,3,20,10,10,2,1
66631,3,0,17,-17,14,1
376146,4,3,16,-13,14,0
148330,3,14,3,11,16,1
210901,3,12,3,9,9,1
42188,2,7,0,7,2,0
339176,4,23,13,10,15,1
42828,3,6,31,-25,3,1
344818,2,14,10,4,17,1
144110,3,16,0,16,14,1
4151,1,0,0,0,2,0
140127,2,10,0,10,12,0
393254,3,14,20,-6,5,1
324876,3,10,13,-3,8,1
204673,1,7,0,7,6,0
4030,2,10,7,3,2,0
306108,1,0,0,0,17,0
247931,4,20,6,14,8,0
401609,4,24,31,-7,8,1
75024,4,34,17,17,17,1
112110,2,7,17,-10,17,0
383667,2,6,14,-8,17,0
130337,2,7,0,7,8,1
146046,2,10,0,10,15,1
187591,4,13,23,-10,16,1
349113,2,7,0,7,2,1
31853,1,0,0,0,15,1
310499,4,20,9,11,2,1
70238,1,0,0,0,15,1
365422,2,7,12,-5,9,1
378911,3,13,30,-17,15,1
171017,2,7,10,-3,8,1
102617,2,12,6,6,13,1
305233,2,14,14,0,16,0
176104,1,0,0,0,11,1
63132,2,7,10,-3,12,1
22505,4,31,29,2,11,0
390356,2,7,7,0,3,0
40826,4,30,35,-5,2,1
195596,4,24,7,17,2,1
95812,2,6,3,3,10,0
381337,1,6,0,6,16,0
28934,1,0,0,0,14,1
84925,4,48,17,31,4,0
94933,2,3,3,0,9,0
419307,2,0,17,-17,16,1
153083,2,0,10,-10,1,1
45972,4,17,3,14,4,1
62074,1,0,0,0,12,1
30385,1,0,13,-13,14,1
255892,1,0,0,0,12,1
79086,4,22,21,1,2,1
39979,1,0,0,0,1,0
118822,2,20,0,20,2,0
214540,1,0,0,0,11,1
364616,4,21,37,-16,9,0
358872,2,6,21,-15,6,1
176040,3,24,0,24,11,1
328048,4,17,17,0,10,0
293083,3,10,13,-3,11,0
73244,3,7,16,-9,16,0
277360,2,14,6,8,4,1
88122,1,0,0,0,6,0
351959,2,21,14,7,3,1
349195,4,27,14,13,2,1
221661,5,29,24,5,14,1
79641,4,24,14,10,2,0
119081,1,0,7,-7,3,1
309441,3,7,6,1,1,1
155173,1,7,0,7,1,0
230419,2,14,0,14,1,0
129916,4,13,0,13,7,1
240432,1,0,0,0,5,0
176694,3,29,19,10,11,1
415348,4,14,21,-7,15,0
177347,1,3,0,3,11,1
55630,1,7,0,7,9,0
135210,2,13,3,10,10,1
367243,1,3,0,3,10,1
165285,4,17,21,-4,6,1
1200,2,10,0,10,1,1
242174,3,13,7,6,6,0
326115,4,30,3,27,9,0
109953,1,0,0,0,16,1
1838,3,16,7,9,1,0
198627,2,0,14,-14,3,1
33798,2,0,24,-24,16,1
105248,3,7,24,-17,14,1
135507,2,7,6,1,10,0
228413,4,10,20,-10,17,0
183616,1,0,0,0,14,0
342653,1,0,0,0,16,1
175639,1,0,0,0,11,1
338488,2,14,7,7,14,1
371587,2,10,3,7,12,0
156277,1,3,0,3,2,1
415990,2,7,0,7,15,1
313390,1,7,0,7,3,0
97731,4,9,13,-4,11,1
401770,4,27,14,13,8,0
176760,1,0,0,0,11,1
6146,4,7,17,-10,3,1
404906,2,3,3,0,10,0
56175,4,27,21,6,9,0
134139,1,0,0,0,10,1
271045,4,21,28,-7,1,0
227062,4,17,9,8,16,1
110671,4,23,10,13,16,1
255776,2,10,0,10,12,0
204263,2,0,7,-7,6,0
118206,1,3,0,3,2,1
43608,1,0,0,0,3,0
132585,3,12,32,-20,9,1
364880,3,6,20,-14,9,1
209015,1,3,0,3,8,1
344997,4,10,23,-13,17,1
324898,3,17,13,4,8,0
130592,1,7,6,1,8,0
47169,2,6,0,6,5,0
10925,2,6,7,-1,5,0
360996,1,0,2,-2,7,1
400894,1,6,0,6,8,0
148578,2,0,6,-6,16,1
308714,2,7,13,-6,1,1
13279,2,0,20,-20,7,1
139836,3,10,10,0,12,1
93968,1,0,7,-7,9,1
24930,1,3,7,-4,12,1
408565,1,7,0,7,12,0
419724,2,3,10,-7,17,0
66314,2,0,14,-14,14,1
145671,4,35,7,28,14,1
273765,2,7,7,0,2,0
235917,4,10,14,-4,3,1
97382,3,9,13,-4,10,0
88607,2,13,7,6,6,0
313021,3,17,0,17,3,1
166083,1,7,0,7,6,1
238807,2,20,0,20,4,1
232890,1,0,0,0,2,0
291020,4,20,13,7,10,0
363528,2,3,5,-2,8,1
281827,3,10,0,10,6,1
83743,4,22,23,-1,4,1
254389,1,7,0,7,11,0
401815,2,7,7,0,9,0
229668,1,7,7,0,17,1
58002,5,20,20,0,10,1
397993,1,0,0,0,7,0
401224,1,7,7,0,8,0
357618,5,16,16,0,5,0
119950,2,6,24,-18,3,1
414427,3,7,23,-16,14,0
67367,4,27,6,21,14,1
311831,4,17,20,-3,2,1
58785,4,10,29,-19,10,1
169017,2,19,14,5,7,1
66331,2,0,20,-20,14,0
299897,3,13,8,5,14,0
142237,1,0,0,0,13,0
219686,4,13,14,-1,13,0
79583,2,14,0,14,2,0
276875,4,26,20,6,4,1
178296,1,6,3,3,12,1
7764,3,30,3,27,4,0
235029,4,24,17,7,2,1
164524,4,23,9,14,5,0
75679,1,0,0,0,1,1
287696,4,9,13,-4,9,1
151723,1,7,0,7,17,0
122545,2,14,0,14,4,1
142052,4,23,14,9,13,1
372103,1,3,6,-3,13,0
355821,1,6,0,6,5,1
200343,4,30,14,16,4,0
198232,4,16,9,7,3,0
61752,4,24,45,-21,12,1
369256,2,14,14,0,11,1
354413,1,0,0,0,4,1
57483,2,14,10,4,10,1
44751,3,7,12,-5,3,1
335605,3,19,7,12,13,0
24086,3,7,7,0,12,0
146411,3,13,3,10,15,1
407970,1,0,0,0,12,0
140083,1,0,0,0,12,0
150787,4,20,9,11,17,0
419615,3,20,16,4,17,1
266305,1,0,0,0,16,0
161249,2,17,3,14,4,0
108886,4,17,17,0,15,0
41059,3,3,13,-10,2,0
133200,3,13,17,-4,9,1
181730,3,7,7,0,13,0
72748,1,13,0,13,16,1
177450,3,24,10,14,11,0
75226,1,7,0,7,17,0
6277,3,13,17,-4,3,1
90943,4,61,7,54,7,1
174239,4,10,26,-16,10,0
91744,1,0,0,0,8,1
11975,2,17,7,10,6,0
43443,5,24,24,0,3,0
359328,3,3,13,-10,6,0
292473,3,10,9,1,11,0
316394,2,13,0,13,4,1
311427,1,0,0,0,2,0
157213,1,7,0,7,2,1
260517,3,27,0,27,14,0
317367,3,0,3,-3,5,1
311983,4,35,17,18,2,1
159064,2,17,0,17,3,0
52376,3,6,17,-11,7,1
93785,4,3,19,-16,9,1
365666,1,6,0,6,9,1
40085,4,20,14,6,1,0
65833,1,0,0,0,13,0
344064,1,0,3,-3,17,1
240824,4,26,10,16,5,1
97632,2,3,0,3,11,0
338744,4,27,17,10,14,1
58381,2,28,0,28,10,0
395586,1,0,3,-3,6,1
2519,2,3,0,3,2,1
417028,2,3,0,3,15,1
266573,1,0,0,0,16,1
223573,4,17,13,4,15,1
330136,4,0,13,-13,11,1
360201,4,20,13,7,7,0
283551,2,6,14,-8,7,0
384778,1,0,0,0,1,1
63748,2,7,15,-8,12,0
145186,3,46,0,46,14,1
297392,3,9,24,-15,13,1
180429,1,7,7,0,13,0
121825,2,0,7,-7,4,0
215073,3,16,7,9,11,0
262160,3,28,6,22,15,1
137712,2,7,13,-6,11,0
64109,4,34,24,10,13,1
75307,3,14,26,-12,17,0
201578,1,0,0,0,5,0
391970,1,0,0,0,4,0
385951,3,17,21,-4,1,1
47724,4,6,17,-11,5,0
74292,4,10,30,-20,17,1
119875,5,24,24,0,3,0
177046,1,3,0,3,11,0
136300,3,18,7,11,11,0
298258,3,20,13,7,14,1
287016,2,13,14,-1,8,1
362783,2,7,14,-7,8,0
269852,4,22,10,12,1,1
143283,1,0,0,0,14,0
394991,1,0,7,-7,5,1
82977,4,13,16,-3,4,0
90128,2,3,0,3,7,0
126441,1,0,0,0,6,1
294011,1,0,0,0,12,1
311308,1,6,0,6,2,1
380427,4,10,24,-14,16,1
120106,2,10,0,10,3,0
304785,2,0,0,0,16,0
149043,1,0,7,-7,16,0
337208,3,16,13,3,14,0
361335,2,0,0,0,7,1
372562,1,0,0,0,13,1
195051,2,7,17,-10,2,1
126051,2,7,3,4,6,0
133562,1,0,0,0,9,1
360711,1,3,7,-4,7,1
58712,2,10,17,-7,10,1
341934,1,0,0,0,16,1
254806,4,20,10,10,11,0
244638,2,0,10,-10,7,0
216143,1,7,0,7,12,0
56447,3,0,35,-35,9,0
108938,1,13,7,6,15,0
174688,3,9,7,2,10,0
24603,4,10,26,-16,12,0
161388,1,0,0,0,4,1
258929,1,0,7,-7,13,1
158266,4,38,0,38,3,0
407726,2,10,0,10,11,0
220783,1,0,0,0,14,0
177414,3,17,10,7,11,0
411569,1,6,10,-4,13,1
48043,4,10,27,-17,5,0
345497,1,7,7,0,17,0
86912,4,23,26,-3,5,0
223457,1,0,0,0,15,0
103947,2,3,10,-7,13,1
180428,1,7,7,0,13,0
260191,2,7,0,7,14,1
410980,1,0,7,-7,13,0
68436,4,3,21,-18,14,1
354219,3,13,10,3,4,1
19086,4,10,6,4,10,0
94980,3,6,9,-3,9,0
406209,2,7,10,-3,11,1
197160,3,27,20,7,3,0
189720,1,0,3,-3,17,1
401839,2,7,14,-7,9,0
151657,4,23,27,-4,17,0
116525,1,0,0,0,2,1
43067,3,3,10,-7,3,1
197141,3,24,20,4,3,0
284630,3,14,17,-3,7,0
244915,1,0,0,0,7,0
353975,5,34,31,3,4,0
97277,4,27,20,7,10,0
89814,2,3,3,0,7,1
323626,2,10,0,10,8,0
352731,4,24,6,18,3,0
258679,2,0,7,-7,13,0
13018,3,14,7,7,6,0
210437,2,9,7,2,9,0
215582,1,14,0,14,11,0
137483,1,7,0,7,11,0
403602,2,17,10,7,9,0
30649,4,24,9,15,14,1
55483,1,0,0,0,9,1
216530,3,34,11,23,12,0
385500,1,0,0,0,1,0
14308,2,2,7,-5,7,1
5872,1,0,0,0,3,1
271304,3,6,17,-11,1,0
404400,4,20,13,7,10,0
361302,1,0,0,0,7,0
347763,2,7,0,7,1,1
171103,1,0,0,0,8,1
410966,1,0,0,0,13,0
156927,2,7,10,-3,2,1
45079,4,23,20,3,4,0
334081,1,0,0,0,13,1
42610,1,0,7,-7,3,1
215912,2,3,13,-10,11,0
329481,2,10,0,10,10,0
233761,3,13,27,-14,2,1
138615,2,3,6,-3,12,0
106987,4,29,13,16,14,0
359876,2,20,21,-1,6,1
131419,3,7,19,-12,8,0
103329,1,7,10,-3,13,0
349373,1,0,0,0,2,0
72799,3,21,14,7,16,1
61472,4,27,17,10,11,0
246051,3,10,13,-3,7,0
265541,4,17,13,4,16,1
304601,1,0,7,-7,16,1
1379,2,10,0,10,1,0
345969,4,27,30,-3,17,0
306867,2,0,6,-6,17,0
300096,1,0,0,0,14,1
354580,1,0,0,0,4,0
196220,2,7,3,4,2,0
241659,1,0,0,0,5,1
292612,3,9,16,-7,11,1
212227,4,3,24,-21,10,0
99449,2,0,3,-3,11,1
364577,3,15,28,-13,9,1
287561,4,20,43,-23,9,1
136382,1,0,0,0,11,0
8473,2,15,3,12,4,1
415081,1,0,0,0,15,1
309421,3,0,3,-3,1,1
137711,2,7,13,-6,11,0
121262,4,21,30,-9,3,1
20710,4,17,20,-3,10,1
47723,4,6,17,-11,5,0
36740,1,0,7,-7,17,1
257541,3,19,10,9,13,1
201521,3,32,7,25,5,0
321148,2,3,16,-13,6,1
388899,2,10,14,-4,3,1
383350,2,0,0,0,17,1
93247,4,11,27,-16,9,0
238563,4,16,20,-4,4,0
359320,2,3,13,-10,6,0
414236,2,14,14,0,14,0
239159,3,13,16,-3,4,0
374303,3,14,13,1,13,0
66171,2,17,0,17,13,0
404027,2,3,27,-24,10,1
63259,1,0,0,0,12,1
326811,3,3,14,-11,9,1
299265,2,20,0,20,14,0
142793,3,12,10,2,13,1
173104,1,0,0,0,9,1
124180,4,22,27,-5,5,1
28860,3,23,7,16,14,1
390285,4,17,13,4,3,1
385385,1,7,7,0,1,0
363086,2,7,3,4,8,0
123589,1,0,0,0,4,0
11234,3,17,14,3,6,0
297905,1,9,0,9,13,1
217767,3,10,10,0,12,1
252204,4,23,24,-1,10,0
84475,3,20,10,10,4,0
158518,3,10,10,0,3,1
390972,2,13,7,6,4,0
378671,1,0,0,0,15,1
84598,3,13,10,3,4,0
93897,3,17,6,11,9,1
42580,4,10,31,-21,3,1
358360,1,6,7,-1,6,1
275475,3,20,17,3,3,1
270924,4,19,20,-1,1,1
217311,2,0,7,-7,12,0
185153,4,0,23,-23,15,1
254230,1,0,0,0,11,0
154491,4,14,10,4,1,0
274056,2,10,0,10,3,1
214084,1,3,0,3,11,0
258068,1,3,0,3,13,1
99225,4,31,20,11,11,1
408021,2,3,0,3,12,0
383127,3,23,14,9,17,1
214880,2,0,12,-12,11,1
66689,4,10,31,-21,14,1
357591,4,13,13,0,5,1
409885,4,30,8,22,12,1
22363,4,0,6,-6,11,1
100325,2,9,14,-5,12,0
318664,4,10,16,-6,5,1
43305,1,7,0,7,3,0
69382,1,7,0,7,15,0
303374,1,0,0,0,16,1
21289,3,3,14,-11,11,0
360442,2,10,0,10,7,1
45361,4,20,16,4,4,0
314505,3,21,0,21,3,1
196771,1,0,0,0,3,0
386839,4,13,21,-8,2,1
405132,3,3,10,-7,10,0
249307,1,3,0,3,9,1
61727,4,24,31,-7,12,1
227574,2,21,0,21,16,1
413426,3,3,31,-28,14,0
255538,3,30,7,23,12,0
192579,1,3,0,3,1,0
240860,4,39,16,23,5,0
72011,2,0,10,-10,16,1
211837,3,22,10,12,9,0
181262,3,0,6,-6,13,1
273367,4,35,7,28,2,1
66909,3,9,7,2,14,1
11592,5,20,19,1,6,1
155186,1,7,7,0,1,1
90828,1,7,0,7,7,0
250816,3,3,9,-6,10,0
275472,3,20,17,3,3,0
230353,4,26,17,9,17,1
314032,2,6,0,6,3,1
289851,1,0,3,-3,10,1
27962,3,21,17,4,13,1
104617,2,7,3,4,14,1
35524,4,30,7,23,17,0
88103,4,24,3,21,6,1
143884,1,0,0,0,14,1
128939,2,22,3,19,7,1
343131,1,0,0,0,16,1
12017,4,24,14,10,6,1
355114,2,14,16,-2,4,0
114305,1,7,6,1,1,0
47080,4,24,7,17,5,0
357603,4,16,16,0,5,0
204585,2,0,38,-38,6,0
160462,2,19,7,12,4,1
38377,2,14,9,5,1,0
298646,2,3,0,3,14,1
84856,2,20,10,10,4,1
164113,4,15,6,9,5,0
179418,3,6,13,-7,12,0
102649,3,15,13,2,13,1
349070,1,7,0,7,2,0
22888,3,0,13,-13,11,0
46725,2,7,0,7,4,0
60500,2,27,7,20,11,0
125264,1,3,0,3,5,0
407076,1,0,6,-6,11,1
285706,1,0,0,0,8,0
286878,2,9,7,2,8,0
342220,1,3,0,3,16,1
362554,4,26,12,14,8,0
346532,3,24,33,-9,1,1
183226,2,7,14,-7,14,1
176074,4,24,8,16,11,0
94840,4,6,13,-7,9,1
230184,4,3,32,-29,17,1
50150,3,0,24,-24,6,1
357660,1,6,3,3,5,1
371474,3,14,17,-3,12,0
57732,1,0,0,0,10,1
99021,2,6,0,6,11,1
166072,1,7,0,7,6,0
194676,4,34,10,24,2,1
381508,2,14,0,14,17,1
269527,3,13,24,-11,1,1
150757,3,13,9,4,17,1
79633,4,21,14,7,2,0
85441,1,7,3,4,5,0
16110,3,33,10,23,8,0
115318,4,20,15,5,1,0
405964,4,14,7,7,11,1
133581,2,3,7,-4,9,1
63666,4,20,36,-16,12,1
300431,1,2,0,2,14,1
152897,2,6,7,-1,1,1
174731,4,9,10,-1,10,1
16264,3,13,23,-10,8,1
328677,4,27,38,-11,10,1
162248,4,23,20,3,4,0
351682,3,7,10,-3,3,0
57806,3,19,10,9,10,0
388824,4,14,14,0,3,0
216341,2,7,13,-6,12,1
299210,1,0,0,0,14,1
259099,1,0,0,0,13,0
402222,1,0,0,0,9,0
205484,2,14,3,11,6,1
118041,4,20,13,7,2,0
142395,1,0,0,0,13,1
192727,1,0,3,-3,1,1
316178,4,30,32,-2,4,0
81170,4,16,29,-13,3,1
260837,3,29,15,14,14,0
25285,3,34,7,27,12,0
45464,3,27,14,13,4,0
181326,4,3,23,-20,13,1
111679,3,21,10,11,16,1
124106,2,3,21,-18,5,0
163129,3,16,19,-3,5,0
2396,2,14,13,1,2,1
327603,4,10,22,-12,10,0
70578,2,7,7,0,15,0
351681,3,7,10,-3,3,0
172698,2,14,3,11,9,0
359799,4,30,33,-3,6,1
184022,4,29,10,19,14,0
93547,1,3,0,3,9,0
162308,1,3,0,3,4,1
195995,4,7,27,-20,2,0
221857,2,6,0,6,14,1
92807,1,0,0,0,8,1
347690,4,27,24,3,1,1
179221,2,14,3,11,12,1
252721,1,0,0,0,11,0
302025,1,7,3,4,15,0
52370,3,6,17,-11,7,0
32682,2,7,3,4,15,0
345629,4,24,26,-2,17,0
99872,1,0,0,0,12,0
226534,1,0,0,0,16,0
369229,1,7,7,0,11,1
244651,2,0,23,-23,7,1
125579,2,7,7,0,5,0
100621,2,7,7,0,12,0
283527,1,6,7,-1,7,1
12283,4,6,6,0,6,1
414359,1,7,3,4,14,1
200693,1,7,0,7,4,0
335656,1,7,0,7,13,0
102296,2,10,10,0,13,0
196703,3,33,0,33,3,0
362561,4,26,12,14,8,1
361166,1,0,0,0,7,0
402961,1,7,7,0,9,0
145068,4,20,13,7,14,0
372160,2,9,7,2,13,0
161410,2,7,3,4,4,1
186395,1,0,0,0,15,0
224949,3,3,9,-6,15,0
357646,1,6,0,6,5,0
300799,3,10,33,-23,15,1
216192,3,14,3,11,12,1
409239,2,13,3,10,12,0
207002,2,21,0,21,7,1
27893,2,0,0,0,13,0
323981,3,17,13,4,8,0
227687,1,0,0,0,16,1
125286,2,3,0,3,5,0
3959,4,22,14,8,2,1
343525,4,10,10,0,16,1
128724,4,20,30,-10,7,0
118464,4,27,10,17,2,0
28852,3,22,7,15,14,1
237043,2,0,14,-14,3,0
366310,4,28,10,18,10,1
119498,4,14,24,-10,3,1
33653,2,14,0,14,16,1
226746,3,7,13,-6,16,1
46450,2,7,0,7,4,1
93378,1,0,0,0,9,1
203117,1,0,7,-7,5,1
134818,3,48,17,31,10,0
51026,2,0,17,-17,6,1
140440,2,7,7,0,12,1
277304,4,0,16,-16,4,1
168286,2,10,7,3,7,1
139716,3,7,7,0,12,0
253578,3,6,10,-4,11,0
313046,4,20,0,20,3,1
376597,4,15,6,9,14,0
151439,1,21,0,21,17,0
332604,2,17,6,11,12,1
137743,3,10,34,-24,11,1
157700,2,10,3,7,2,1
155898,4,17,13,4,2,1
244032,2,13,17,-4,6,1
315293,5,20,19,1,4,0
388848,1,0,0,0,3,1
388039,3,19,6,13,2,1
39632,4,27,6,21,1,1
123268,1,0,0,0,4,0
221792,4,13,27,-14,14,0
194211,4,12,17,-5,1,0
125343,3,24,3,21,5,1
208690,4,9,13,-4,8,1
309880,4,24,7,17,1,1
219014,2,14,0,14,13,1
211478,2,19,7,12,9,1
231779,3,13,20,-7,1,0
205681,3,17,19,-2,7,1
336878,2,7,14,-7,14,0
115375,1,7,0,7,1,1
237974,2,3,10,-7,4,1
967,3,0,3,-3,1,0
232633,2,0,0,0,1,1
154746,2,9,10,-1,1,1
346980,2,7,3,4,1,0
380384,3,10,17,-7,16,0
54460,1,0,0,0,8,0
306864,2,0,6,-6,17,1
336565,3,7,0,7,14,0
21170,4,0,16,-16,10,0
72573,4,19,31,-12,16,1
337479,2,7,9,-2,14,0
131867,3,24,7,17,8,1
252158,3,17,10,7,10,1
341110,4,14,17,-3,15,0
47184,3,6,3,3,5,1
394423,1,0,3,-3,5,0
46222,3,14,24,-10,4,0
326004,1,0,0,0,9,1
350976,4,21,17,4,3,0
83474,1,0,0,0,4,1
286635,4,17,41,-24,8,1
374724,3,0,33,-33,14,1
123420,4,28,27,1,4,1
385550,2,0,10,-10,1,0
197483,4,13,9,4,3,1
157808,1,0,0,0,3,0
9280,1,7,0,7,5,1
386947,2,7,21,-14,2,0
34590,3,17,7,10,16,1
35408,5,30,30,0,16,1
29142,3,0,19,-19,14,1
40972,4,19,27,-8,2,1
317505,3,10,17,-7,5,0
108096,3,13,28,-15,15,0
269026,2,10,3,7,17,0
132586,3,12,32,-20,9,1
402170,3,19,7,12,9,1
375028,3,21,27,-6,14,1
117862,4,9,20,-11,2,0
111827,3,6,10,-4,17,0
26353,4,19,21,-2,13,1
9416,1,0,0,0,5,0
93681,1,0,0,0,9,0
163278,2,13,6,7,5,0
216487,2,20,8,12,12,1
401112,3,27,3,24,8,0
178608,2,3,3,0,12,1
22291,2,0,3,-3,11,1
265766,3,10,3,7,16,0
25092,1,3,0,3,12,1
106121,2,0,0,0,14,0
114438,1,0,0,0,1,0
273703,4,22,20,2,2,1
192025,4,24,20,4,1,0
413984,2,3,21,-18,14,0
145490,4,16,17,-1,14,0
278487,3,36,0,36,4,0
204280,2,0,7,-7,6,0
346385,3,9,13,-4,1,1
394419,1,0,3,-3,5,0
386861,4,26,28,-2,2,0
72738,1,7,0,7,16,0
157288,4,13,3,10,2,1
17800,2,7,3,4,9,1
375151,2,14,10,4,14,1
226700,1,7,3,4,16,1
112791,4,27,10,17,17,0
76122,1,0,0,0,1,0
128646,2,6,10,-4,7,0
299301,3,26,7,19,14,0
102952,3,12,30,-18,13,0
208179,3,0,3,-3,8,0
298967,2,9,9,0,14,1
103705,4,3,17,-14,13,0
272821,1,20,0,20,2,0
132682,2,3,10,-7,9,1
355938,4,40,17,23,5,0
66846,1,0,7,-7,14,1
100675,3,21,14,7,12,0
384298,3,6,0,6,1,1
227589,2,28,0,28,16,0
335562,2,6,7,-1,13,1
194858,1,0,7,-7,2,0
178341,3,14,10,4,12,0
408437,2,0,0,0,12,0
98318,4,28,27,1,11,0
323949,2,10,10,0,8,1
135962,2,3,3,0,10,0
362011,1,0,0,0,8,0
368290,3,6,6,0,11,1
2280,3,10,10,0,1,0
336614,4,7,0,7,14,0
326576,1,0,0,0,9,1
165824,2,3,9,-6,6,1
235628,4,33,34,-1,3,0
48355,1,0,7,-7,5,1
193911,4,31,10,21,1,0
365617,3,35,27,8,9,0
167079,4,16,31,-15,7,1
263193,3,10,17,-7,15,0
259093,1,0,0,0,13,1
135580,4,27,6,21,10,1
328315,2,3,14,-11,10,0
110191,4,23,30,-7,16,0
330525,2,7,7,0,11,1
387829,2,10,7,3,2,0
409455,4,34,3,31,12,0
361852,4,44,10,34,7,1
291243,2,7,6,1,10,0
277094,3,10,14,-4,4,0
272840,2,20,0,20,2,0
136333,4,18,7,11,11,0
323590,1,0,0,0,8,1
189148,1,21,0,21,16,0
260208,2,10,3,7,14,1
404596,2,0,10,-10,10,0
305203,1,7,0,7,16,0
279147,4,21,23,-2,5,1
230511,1,3,0,3,1,0
240000,2,3,13,-10,5,0
319231,4,17,17,0,5,0
344638,1,3,10,-7,17,0
419187,3,10,6,4,16,0
414923,4,42,21,21,15,1
91163,2,3,14,-11,8,1
25857,2,24,10,14,12,0
301454,2,17,3,14,15,0
259404,1,0,3,-3,13,1
78901,3,17,7,10,2,0
48434,3,17,17,0,5,1
239961,1,0,3,-3,5,0
372774,3,3,0,3,13,0
95369,1,7,0,7,10,1
176435,1,0,0,0,11,0
216931,1,0,0,0,12,0
202056,1,0,0,0,5,1
352371,2,21,7,14,3,0
297969,3,30,7,23,13,0
292969,4,10,7,3,11,0
166301,3,7,9,-2,6,1
152738,1,0,0,0,17,1
161195,1,0,0,0,4,1
186130,2,3,3,0,15,1
415051,4,10,27,-17,15,1
332716,2,14,6,8,12,1
132125,3,10,3,7,9,0
252444,2,0,5,-5,10,0
318199,4,22,26,-4,5,0
180799,3,10,20,-10,13,0
10385,3,10,38,-28,5,1
11471,1,6,7,-1,6,1
168127,2,9,2,7,7,0
218809,4,3,19,-16,13,0
98128,2,21,10,11,11,0
241475,4,10,42,-32,5,1
19978,2,6,3,3,10,0
284367,4,14,17,-3,7,0
293064,3,10,13,-3,11,0
71588,2,3,14,-11,16,0
114220,3,3,13,-10,1,0
181981,2,7,0,7,13,1
207256,1,0,0,0,7,0
94488,2,0,0,0,9,0
170096,2,7,0,7,8,0
198794,3,3,9,-6,3,1
28506,2,24,0,24,14,1
415956,4,24,30,-6,15,0
254280,2,6,9,-3,11,1
62565,2,3,7,-4,12,0
69567,2,7,10,-3,15,0
46148,1,7,7,0,4,1
139954,2,10,3,7,12,1
288844,2,10,17,-7,9,0
126212,3,21,6,15,6,1
172830,2,7,0,7,9,1
181803,1,0,0,0,13,1
300277,2,0,7,-7,14,1
166342,4,20,9,11,6,0
49316,2,7,3,4,6,0
35207,3,0,14,-14,16,1
69591,3,7,10,-3,15,0
236336,3,7,23,-16,3,0
18528,1,0,0,0,9,1
124828,2,0,3,-3,5,0
185290,4,33,22,11,15,1
39019,4,37,17,20,1,0
156884,1,0,0,0,2,0
149992,2,14,3,11,16,1
369529,2,3,0,3,11,1
98912,3,7,17,-10,11,1
329622,2,10,7,3,11,1
261081,2,0,14,-14,14,1
419529,4,10,23,-13,16,1
113761,3,3,17,-14,17,1
306126,1,0,0,0,17,1
198303,2,6,14,-8,3,0
400334,2,3,3,0,8,1
26466,4,27,19,8,13,1
368396,2,14,7,7,11,1
158485,2,3,7,-4,3,0
370211,4,31,10,21,12,1
74774,1,3,0,3,17,0
209662,1,6,0,6,8,1
37615,2,10,0,10,17,0
95641,1,7,0,7,10,1
239524,1,3,0,3,4,1
332498,4,23,9,14,12,1
25697,3,14,7,7,12,1
287741,1,14,0,14,9,0
337480,2,7,9,-2,14,0
25977,2,10,9,1,13,1
389968,3,28,25,3,3,0
249490,1,7,3,4,9,0
50756,4,21,14,7,6,0
374679,2,0,6,-6,14,0
392984,4,9,10,-1,4,1
388568,1,14,0,14,3,1
275239,1,0,0,0,3,1
180226,4,22,14,8,13,0
330457,1,0,0,0,11,0
71180,3,19,10,9,16,0
37980,4,17,14,3,1,0
357184,4,12,27,-15,5,1
242410,1,0,6,-6,6,0
387959,1,3,0,3,2,0
105877,4,19,10,9,14,0
328108,2,6,0,6,10,0
72464,2,7,10,-3,16,1
148487,3,24,3,21,16,1
52100,4,13,19,-6,7,1
170693,2,7,3,4,8,0
112895,3,13,6,7,17,1
334902,4,27,10,17,13,0
386274,4,14,20,-6,2,1
239063,1,0,0,0,4,1
79507,4,12,24,-12,2,1
366331,4,28,16,12,10,1
18461,3,7,7,0,9,0
368187,4,24,21,3,11,0
414380,2,7,17,-10,14,1
14835,1,0,0,0,7,1
332943,4,31,3,28,12,0
25964,2,3,6,-3,13,1
72398,4,17,23,-6,16,1
60694,3,21,3,18,11,0
199003,4,19,26,-7,3,1
368459,4,30,21,9,11,0
212202,3,3,24,-21,10,0
335617,4,19,10,9,13,1
115901,3,7,23,-16,1,1
319295,2,10,3,7,6,0
239843,2,7,0,7,4,0
152937,2,14,17,-3,1,0
374667,1,0,0,0,14,0
167494,2,0,3,-3,7,1
213708,3,17,17,0,10,1
189569,1,0,0,0,17,0
286707,2,10,7,3,8,1
318337,4,9,22,-13,5,1
66098,4,10,6,4,13,0
186502,4,17,20,-3,15,1
105456,4,23,31,-8,14,0
125760,2,7,14,-7,5,1
33792,2,0,17,-17,16,0
198883,1,0,13,-13,3,1
197316,3,17,0,17,3,0
180842,4,20,20,0,13,0
223054,2,14,7,7,14,1
22083,5,24,24,0,11,0
185811,1,0,0,0,15,0
212136,2,3,14,-11,10,0
180132,2,7,0,7,13,0
286561,2,10,21,-11,8,1
103562,4,33,0,33,13,1
168741,3,10,6,4,7,1
181124,3,24,14,10,13,0
131518,2,6,6,0,8,0
115386,2,20,0,20,1,0
53880,2,7,7,0,8,1
176278,1,0,7,-7,11,0
126032,2,7,0,7,6,0
147645,1,3,0,3,15,0
200569,2,14,7,7,4,0
50218,1,7,7,0,6,1
358332,4,3,27,-24,6,0
349963,1,0,0,0,2,0
92256,2,10,0,10,8,0
35253,1,0,0,0,16,1
294466,1,6,7,-1,12,1
219939,2,6,7,-1,13,1
261768,4,28,7,21,14,0
249388,3,18,15,3,9,0
36201,2,10,17,-7,17,1
304121,4,16,30,-14,16,0
131390,2,7,13,-6,8,0
420578,1,0,10,-10,17,1
348361,2,10,10,0,1,1
172056,2,7,3,4,9,1
359628,3,24,7,17,6,1
349369,4,37,42,-5,2,0
5786,2,21,7,14,3,1
256757,3,3,6,-3,12,0
200609,3,24,14,10,4,1
61165,4,0,14,-14,11,0
70912,3,15,33,-18,15,0
296038,3,3,7,-4,13,1
148988,4,13,12,1,16,1
122953,1,0,0,0,4,0
263877,1,0,0,0,15,1
320319,4,14,24,-10,6,1
327653,1,0,3,-3,10,1
359996,1,3,19,-16,7,1
44265,2,17,13,4,3,1
45453,2,21,7,14,4,0
305811,1,0,7,-7,17,0
319573,1,0,0,0,6,1
312885,4,14,13,1,3,0
78518,1,0,0,0,2,0
112541,2,10,9,1,17,0
297055,2,14,0,14,13,1
157608,3,12,3,9,2,1
116886,2,7,7,0,2,0
267107,3,10,10,0,17,1
151668,4,23,34,-11,17,1
51548,1,0,0,0,7,0
410403,2,6,10,-4,13,1
282480,2,7,0,7,6,1
3654,4,20,28,-8,2,0
69754,4,19,10,9,15,0
382041,1,0,0,0,17,1
66577,1,0,14,-14,14,0
84105,1,0,0,0,4,1
259668,4,9,9,0,13,0
200644,4,27,28,-1,4,1
322319,2,14,7,7,7,0
273949,3,7,9,-2,2,1
418283,2,6,0,6,16,0
92242,2,7,0,7,8,0
201258,1,0,0,0,5,1
366743,3,27,10,17,10,0
24613,4,10,26,-16,12,1
313699,1,7,3,4,3,1
411566,1,0,10,-10,13,1
226887,2,0,10,-10,16,1
390022,4,31,32,-1,3,1
206530,1,0,3,-3,7,1
242339,3,20,13,7,6,1
173660,4,13,20,-7,10,0
217746,3,10,7,3,12,1
254241,1,0,3,-3,11,0
360434,2,10,0,10,7,0
396986,2,7,3,4,6,1
7445,2,20,6,14,4,0
245502,1,7,0,7,7,0
241578,3,3,20,-17,5,1
59101,4,10,23,-13,10,0
226680,1,7,3,4,16,0
332062,4,10,9,1,12,0
226138,3,14,17,-3,16,1
243895,2,16,6,10,6,0
103206,2,3,0,3,13,0
297560,3,21,7,14,13,0
179214,2,7,3,4,12,1
389502,3,20,3,17,3,0
245756,3,16,17,-1,7,1
120510,5,42,41,1,3,0
285543,2,7,7,0,8,0
123025,3,7,13,-6,4,0
202820,1,0,0,0,5,1
260655,3,7,22,-15,14,1
300417,1,2,0,2,14,1
147835,2,3,14,-11,15,1
372778,3,3,0,3,13,0
420965,3,7,21,-14,17,1
177362,1,10,0,10,11,0
275663,4,36,3,33,3,1
308361,2,0,6,-6,1,0
209265,4,27,7,20,8,1
213039,2,17,0,17,10,0
108715,3,37,13,24,15,1
394549,1,0,0,0,5,1
13904,3,21,7,14,7,1
89589,4,7,40,-33,7,1
357176,4,12,20,-8,5,0
122582,3,14,7,7,4,1
8564,1,0,0,0,4,1
78763,3,13,20,-7,2,0
308266,3,10,13,-3,1,0
394730,2,14,0,14,5,0
171080,4,17,37,-20,8,0
220936,1,0,0,0,14,1
39,2,0,0,0,1,0
90671,4,27,33,-6,7,1
40290,2,6,0,6,2,1
38008,1,3,0,3,1,0
137974,1,7,7,0,11,0
176752,4,39,19,20,11,1
198987,4,19,23,-4,3,0
118298,3,19,7,12,2,0
85247,4,17,17,0,4,1
308992,3,0,17,-17,1,0
404294,2,0,3,-3,10,1
114078,3,21,0,21,17,1
119969,3,16,24,-8,3,0
342337,4,23,13,10,16,1
268002,3,14,9,5,17,0
259249,1,0,0,0,13,1
13169,3,19,16,3,6,1
340031,3,14,12,2,15,0
38622,1,0,0,0,1,0
419776,4,17,17,0,17,1
377045,1,0,0,0,15,1
146838,2,17,0,17,15,1
56213,1,3,0,3,9,0
101123,3,13,17,-4,12,1
55076,2,13,3,10,8,1
416597,2,13,7,6,15,1
15603,2,14,10,4,8,1
66778,3,10,6,4,14,0
22926,4,3,23,-20,11,1
19845,2,10,13,-3,10,0
32433,4,31,6,25,15,1
291772,4,9,17,-8,11,0
76505,2,7,20,-13,1,0
200529,1,0,0,0,4,1
41004,1,3,7,-4,2,0
322756,2,3,14,-11,7,0
364132,3,24,3,21,9,1
237438,4,12,24,-12,3,1
156668,3,6,7,-1,2,0
29964,2,14,0,14,14,0
113884,2,7,3,4,17,1
398210,3,28,10,18,7,0
194746,2,0,10,-10,2,0
344137,3,20,3,17,17,0
99275,1,7,0,7,11,1
119785,3,16,6,10,3,1
152082,3,6,7,-1,17,0
128104,3,10,6,4,7,1
389018,1,6,0,6,3,1
357807,2,3,14,-11,6,1
3621,3,20,21,-1,2,0
168285,2,10,7,3,7,1
364520,1,3,7,-4,9,0
127601,2,3,9,-6,6,1
225154,1,0,0,0,15,1
311040,2,10,0,10,2,0
285416,2,24,0,24,8,1
369769,4,45,43,2,11,0
206016,4,16,17,-1,7,0
265613,2,6,15,-9,16,1
111363,2,0,7,-7,16,1
322363,3,14,13,1,7,1
263475,3,13,13,0,15,0
359355,3,3,20,-17,6,0
168900,3,17,6,11,7,1
410376,1,0,7,-7,13,1
390872,3,9,28,-19,3,1
175436,4,17,23,-6,11,1
301055,3,17,10,7,15,1
227674,1,0,0,0,16,0
245116,2,17,6,11,7,0
254501,4,29,13,16,11,1
93904,3,17,6,11,9,1
282736,4,16,30,-14,6,0
44047,1,0,0,0,3,1
292738,2,13,10,3,11,0
246684,4,31,3,28,8,0
190697,3,28,17,11,17,1
261323,1,0,7,-7,14,0
76437,1,0,0,0,1,0
418881,3,10,10,0,16,1
304157,1,0,0,0,16,0
376543,3,8,6,2,14,0
297856,4,21,16,5,13,0
6176,1,0,0,0,3,1
339480,4,10,26,-16,15,1
187627,1,0,0,0,16,0
197280,2,0,0,0,3,1
277202,2,0,10,-10,4,1
232603,1,0,0,0,1,1
47514,2,17,6,11,5,1
313241,1,0,0,0,3,1
84803,4,13,31,-18,4,0
134282,1,0,7,-7,10,1
272829,2,20,0,20,2,1
312608,1,0,0,0,3,1
69454,3,24,10,14,15,1
239548,2,13,0,13,4,1
112669,1,3,0,3,17,0
279312,4,26,23,3,5,1
90453,2,0,13,-13,7,0
130043,3,10,27,-17,8,1
411373,4,20,13,7,13,1
170843,2,7,0,7,8,1
23092,4,10,17,-7,11,0
63558,1,10,0,10,12,0
123860,4,17,3,14,5,0
25050,4,24,24,0,12,1
83299,4,22,17,5,4,0
213095,3,20,3,17,10,0
314567,1,0,0,0,3,1
55086,2,16,3,13,8,0
420564,1,0,0,0,17,0
110969,4,7,17,-10,16,0
220318,4,26,9,17,13,1
370317,3,13,35,-22,12,1
203878,5,37,34,3,6,1
17685,3,14,6,8,9,1
381733,4,32,31,1,17,0
314794,3,21,7,14,4,1
292775,3,26,17,9,11,1
41395,4,14,15,-1,2,0
411445,2,7,17,-10,13,1
1013,1,0,0,0,1,1
231208,4,10,10,0,1,1
146573,4,14,24,-10,15,0
264150,4,27,27,0,15,0
43926,2,0,7,-7,3,0
332892,2,17,0,17,12,1
309322,4,3,23,-20,1,1
230356,1,0,0,0,1,0
237599,4,38,28,10,3,1
137745,3,10,34,-24,11,1
134327,2,16,14,2,10,0
301726,2,0,10,-10,15,0
233889,2,14,6,8,2,1
2239,2,7,7,0,1,1
384222,1,0,0,0,1,0
360715,1,10,7,3,7,0
104689,4,14,3,11,14,0
419571,1,13,7,6,17,1
326093,3,30,3,27,9,0
24231,3,10,17,-7,12,1
390754,4,13,20,-7,3,1
288882,3,13,24,-11,9,0
344869,4,30,10,20,17,1
335525,1,0,0,0,13,0
33900,1,0,3,-3,16,0
239176,4,20,16,4,4,0
305264,3,21,21,0,16,1
354909,1,0,0,0,4,0
249287,4,33,17,16,9,0
205453,1,7,0,7,6,1
180106,1,7,0,7,13,0
89019,1,0,0,0,6,1
279561,3,10,13,-3,5,0
291206,1,0,0,0,10,1
221417,2,3,24,-21,14,1
75506,4,37,7,30,17,0
24361,2,3,0,3,12,0
281557,4,27,23,4,6,0
125821,4,17,23,-6,5,0
150341,3,24,7,17,16,1
367220,1,0,0,0,10,1
132525,1,2,19,-17,9,0
59198,2,14,42,-28,10,0
312275,4,10,23,-13,2,1
283695,1,0,0,0,7,0
364330,4,9,39,-30,9,1
132071,1,6,0,6,9,1
154381,4,34,24,10,1,0
161462,3,7,3,4,4,1
183461,4,27,6,21,14,0
181869,3,21,14,7,13,0
364868,3,6,14,-8,9,0
305287,3,35,21,14,16,0
50656,1,0,0,0,6,0
346719,4,24,13,11,1,1
49389,4,10,20,-10,6,1
111443,4,0,20,-20,16,1
137497,1,7,7,0,11,1
238488,2,6,0,6,4,1
64700,2,14,0,14,13,0
278045,3,10,10,0,4,1
54571,4,28,18,10,8,0
148309,2,7,3,4,16,0
379033,2,7,6,1,15,1
138314,2,20,0,20,11,0
96522,4,17,24,-7,10,1
299137,3,3,16,-13,14,1
137840,2,10,6,4,11,0
337349,3,14,7,7,14,0
30540,1,0,0,0,14,0
359237,5,28,28,0,6,0
189460,2,14,0,14,17,0
357033,1,0,0,0,5,1
357543,3,10,6,4,5,1
385764,2,17,0,17,1,0
102678,4,29,28,1,13,1
289658,4,13,20,-7,10,0
65290,2,3,21,-18,13,1
142397,1,0,0,0,13,1
331166,3,7,13,-6,11,1
178198,3,3,10,-7,12,1
67290,1,14,0,14,14,0
38874,4,10,13,-3,1,0
409235,2,13,3,10,12,0
246921,2,14,7,7,8,1
290662,2,35,16,19,10,0
106417,2,13,0,13,14,0
37480,2,7,7,0,17,1
114738,4,15,17,-2,1,1
170722,3,21,6,15,8,1
160101,1,0,0,0,3,0
118950,2,0,10,-10,3,0
261104,3,7,21,-14,14,1
206109,3,20,6,14,7,1
247990,2,14,3,11,8,0
315195,2,10,10,0,4,1
212199,3,3,24,-21,10,0
339612,3,24,14,10,15,0
130372,3,7,3,4,8,1
251365,2,24,14,10,10,0
274303,4,32,16,16,3,0
30667,1,0,0,0,15,1
324634,4,19,15,4,8,1
158248,4,38,0,38,3,1
219239,4,19,3,16,13,0
343808,3,21,3,18,17,0
141752,4,33,21,12,13,0
59806,4,12,13,-1,11,0
403748,2,12,10,2,9,0
150014,3,14,6,8,16,1
160842,3,34,17,17,4,0
208542,4,47,23,24,8,1
33649,2,14,0,14,16,0
277416,3,31,9,22,4,1
222639,2,7,7,0,14,1
417702,4,28,12,16,16,1
350762,3,10,3,7,2,1
344237,2,7,10,-3,17,0
320891,3,3,14,-11,6,1
214891,2,0,12,-12,11,1
395131,4,24,34,-10,5,0
97318,1,0,3,-3,10,0
84956,1,6,7,-1,4,1
238644,2,6,14,-8,4,1
111489,2,7,0,7,16,1
334579,3,27,24,3,13,1
218127,2,7,3,4,12,0
22139,2,10,6,4,11,0
254903,2,17,7,10,12,1
135403,3,28,17,11,10,0
46504,3,27,6,21,4,1
295784,5,24,24,0,12,1
95793,2,3,3,0,10,1
99897,2,0,3,-3,12,1
222997,4,13,23,-10,14,1
130567,4,13,13,0,8,0
368903,4,38,3,35,11,1
204717,2,7,14,-7,6,1
346153,1,7,0,7,1,0
346037,2,3,6,-3,1,1
121310,1,0,0,0,3,0
152005,1,0,0,0,17,1
95203,1,0,0,0,10,1
85331,2,21,3,18,5,1
252754,2,3,3,0,11,0
230649,1,0,0,0,1,0
350319,2,14,3,11,2,1
344658,2,3,10,-7,17,0
293231,3,16,7,9,11,1
174983,3,6,21,-15,10,0
40172,3,13,7,6,2,1
294745,4,13,27,-14,12,0
107858,1,0,0,0,15,1
137931,4,27,15,12,11,1
94972,3,6,9,-3,9,1
233162,3,29,3,26,2,0
64246,1,0,0,0,13,0
277075,2,3,7,-4,4,0
357672,2,13,3,10,5,0
231291,2,3,3,0,1,1
220750,4,13,13,0,13,0
123574,4,19,17,2,4,0
275832,4,22,3,19,3,1
362530,3,16,12,4,8,1
251393,3,27,14,13,10,1
402225,1,0,3,-3,9,1
110674,4,23,10,13,16,0
303481,3,25,10,15,16,0
50340,4,13,23,-10,6,1
336067,4,16,31,-15,13,1
242880,2,14,10,4,6,0
237874,3,7,27,-20,4,0
262183,4,31,13,18,15,0
88472,2,10,7,3,6,1
323028,1,7,7,0,7,1
416108,4,21,13,8,15,1
88259,1,0,0,0,6,1
58876,2,3,15,-12,10,1
184318,1,0,0,0,14,0
347519,4,20,30,-10,1,0
339232,1,7,0,7,15,1
420935,2,7,14,-7,17,1
393939,1,0,0,0,5,0
237317,1,0,0,0,3,1
239496,1,0,0,0,4,0
121983,3,16,7,9,4,0
195535,3,6,0,6,2,1
66393,4,21,27,-6,14,0
418869,2,7,10,-3,16,1
91057,3,9,0,9,7,0
46491,3,27,6,21,4,1
95271,3,3,17,-14,10,1
359230,5,28,28,0,6,1
10888,1,0,7,-7,5,1
29218,1,0,0,0,14,1
393275,4,24,26,-2,5,0
59746,2,6,10,-4,11,1
78331,4,24,21,3,2,0
266234,3,31,13,18,16,0
111495,2,7,0,7,16,0
238220,3,3,16,-13,4,1
195489,1,0,0,0,2,1
152591,1,0,0,0,17,1
250558,4,19,22,-3,9,1
41412,1,2,0,2,2,0
359088,1,0,0,0,6,1
202714,2,6,10,-4,5,0
176500,2,9,17,-8,11,1
174297,1,7,0,7,10,1
157342,1,0,0,0,2,0
63189,3,14,23,-9,12,0
125186,3,17,7,10,5,1
12470,4,13,9,4,6,0
58401,2,34,7,27,10,1
420563,1,0,0,0,17,0
53299,4,10,10,0,8,0
243401,2,3,10,-7,6,0
324088,2,0,7,-7,8,0
140057,1,0,0,0,12,1
278929,2,7,23,-16,5,0
11178,1,0,0,0,6,0
306438,2,0,17,-17,17,1
217795,4,17,13,4,12,1
354092,3,19,0,19,4,0
165713,4,14,7,7,6,0
235919,4,10,14,-4,3,1
12486,1,0,0,0,6,0
197079,1,7,14,-7,3,1
200906,3,24,0,24,4,1
26249,2,7,14,-7,13,0
301007,2,10,3,7,15,0
62969,1,0,7,-7,12,1
47494,2,10,3,7,5,1
90886,2,31,7,24,7,1
83680,2,22,17,5,4,1
209009,1,3,0,3,8,1
362690,4,3,10,-7,8,0
139942,2,10,3,7,12,1
277862,2,7,14,-7,4,0
150494,4,34,6,28,16,1
342879,2,16,7,9,16,0
276866,4,26,20,6,4,0
96122,1,0,13,-13,10,0
351025,2,7,10,-3,3,0
302291,1,0,0,0,15,1
240728,1,0,7,-7,5,1
277257,3,0,13,-13,4,0
180257,1,0,0,0,13,1
173374,4,34,27,7,10,1
118929,1,0,7,-7,3,0
154652,4,24,21,3,1,0
293409,3,22,10,12,11,0
14690,4,36,21,15,7,1
410064,1,7,7,0,13,1
168450,3,0,24,-24,7,1
219432,1,0,0,0,13,0
23937,3,16,0,16,12,1
20727,4,31,20,11,10,0
230297,3,19,10,9,17,0
130741,1,0,3,-3,8,1
95423,3,28,7,21,10,0
302942,2,13,6,7,16,1
269696,4,10,12,-2,1,0
107632,3,13,20,-7,15,1
206284,3,10,6,4,7,1
366774,4,34,10,24,10,1
136790,4,13,10,3,11,0
177266,3,14,17,-3,11,1
141483,2,7,0,7,13,1
253831,1,14,14,0,11,1
207536,1,7,0,7,7,0
117021,2,0,10,-10,2,1
219929,2,6,0,6,13,1
391129,2,7,17,-10,4,0
251622,4,19,20,-1,10,1
153431,3,13,17,-4,1,1
334658,2,2,0,2,13,0
128174,2,7,0,7,7,0
293785,2,10,3,7,12,1
195695,3,14,10,4,2,0
387397,2,21,7,14,2,0
308212,2,7,10,-3,1,1
153653,1,2,0,2,1,1
362341,2,10,7,3,8,1
57769,2,16,3,13,10,0
267701,3,14,24,-10,17,0
30993,2,0,3,-3,15,0
274915,4,14,16,-2,3,0
308305,4,16,23,-7,1,0
265417,4,14,23,-9,16,0
192288,2,24,3,21,1,0
266600,1,0,0,0,16,0
53082,2,19,7,12,7,0
67922,3,19,3,16,14,1
410284,3,7,13,-6,13,0
1841,3,16,7,9,1,0
91174,3,10,14,-4,8,0
374230,1,7,0,7,13,0
121932,1,3,7,-4,4,0
79431,2,9,7,2,2,1
354753,2,6,9,-3,4,0
302954,2,20,6,14,16,0
368955,2,7,7,0,11,0
30563,2,10,0,10,14,1
36565,4,23,34,-11,17,0
156213,4,16,10,6,2,0
412734,1,0,7,-7,14,1
175598,4,33,7,26,11,0
415025,3,10,27,-17,15,0
243618,3,20,14,6,6,1
343765,2,7,3,4,17,0
237352,2,0,7,-7,3,1
169831,3,17,17,0,8,1
240151,2,13,3,10,5,1
106592,2,31,0,31,14,1
5443,4,20,23,-3,3,1
328523,4,15,3,12,10,0
167712,3,23,20,3,7,1
74373,2,7,10,-3,17,1
174129,1,0,0,0,10,1
67745,3,21,0,21,14,1
371014,2,7,7,0,12,0
92485,4,23,17,6,8,1
178232,4,6,10,-4,12,0
371793,4,24,14,10,12,1
262392,1,0,7,-7,15,1
193518,1,0,0,0,1,0
338523,3,20,14,6,14,0
121529,3,9,7,2,4,1
262576,2,19,3,16,15,1
190076,2,17,3,14,17,1
190361,2,7,0,7,17,0
248065,4,34,20,14,8,1
387,3,28,10,18,1,0
254701,1,3,0,3,11,0
420572,1,0,7,-7,17,0
77508,2,7,7,0,1,0
303197,5,31,31,0,16,1
390594,4,20,27,-7,3,0
254692,1,0,0,0,11,1
176687,3,29,12,17,11,1
168041,4,6,23,-17,7,0
211153,2,0,10,-10,9,0
118168,4,31,27,4,2,0
122929,4,37,6,31,4,0
193325,1,0,0,0,1,0
334207,1,0,0,0,13,1
63673,4,26,36,-10,12,1
63393,1,0,0,0,12,0
6938,2,0,0,0,3,0
216461,1,14,0,14,12,1
72909,2,10,7,3,16,1
390714,3,13,10,3,3,0
279757,4,30,6,24,5,0
96921,3,22,7,15,10,1
217062,4,23,3,20,12,1
222580,1,0,0,0,14,0
351824,3,20,14,6,3,1
47871,4,13,13,0,5,1
131852,3,17,7,10,8,1
175567,3,20,7,13,11,1
272467,4,31,24,7,2,0
298131,4,3,41,-38,13,1
100492,2,7,10,-3,12,1
225697,4,21,13,8,16,1
339335,4,45,7,38,15,1
178772,2,21,7,14,12,0
330134,4,0,13,-13,11,0
190667,2,28,14,14,17,0
298438,4,13,24,-11,14,1
292299,2,6,10,-4,11,1
302678,3,17,20,-3,15,1
264689,1,7,6,1,16,0
235890,3,7,14,-7,3,0
182850,4,36,20,16,14,0
337528,4,7,26,-19,14,1
237509,2,17,7,10,3,1
275555,1,7,0,7,3,0
274211,2,17,0,17,3,0
384912,4,13,36,-23,1,0
88282,2,7,0,7,6,0
274619,4,27,29,-2,3,0
134535,4,3,36,-33,10,0
393539,2,7,9,-2,5,0
409273,3,13,13,0,12,0
51435,2,3,17,-14,7,1
406888,4,27,23,4,11,0
49087,4,13,13,0,6,0
394867,2,0,14,-14,5,1
228821,3,6,17,-11,17,1
246180,2,14,3,11,7,0
15241,4,16,7,9,8,1
166132,2,14,6,8,6,0
153586,3,12,14,-2,1,1
181296,4,3,20,-17,13,1
368334,4,19,19,0,11,0
89329,1,0,6,-6,7,1
32204,2,14,7,7,15,0
12794,1,0,3,-3,6,1
406482,2,0,12,-12,11,0
120573,2,0,6,-6,3,0
51047,3,0,20,-20,6,1
119802,3,17,6,11,3,0
13720,2,0,17,-17,7,0
153479,4,23,17,6,1,0
144225,2,9,7,2,14,0
201889,5,31,30,1,5,1
224116,1,0,7,-7,15,0
377456,4,14,13,1,15,0
64576,2,10,7,3,13,0
415638,4,30,13,17,15,1
315296,5,20,19,1,4,0
413090,2,27,21,6,14,0
272104,3,17,6,11,2,0
68994,3,21,14,7,15,0
228317,1,0,7,-7,17,0
412439,1,0,7,-7,14,0
239024,4,29,18,11,4,0
142640,3,13,13,0,13,1
318092,2,9,7,2,5,0
319268,1,3,3,0,6,0
202754,3,16,17,-1,5,0
135615,1,7,0,7,10,0
62305,3,21,19,2,12,0
361,2,21,10,11,1,0
169158,1,3,6,-3,7,1
32114,3,24,13,11,15,0
220870,4,13,38,-25,14,0
206039,1,0,0,0,7,0
258543,2,0,0,0,13,0
191377,2,0,24,-24,17,1
250848,4,3,12,-9,10,0
6747,1,0,0,0,3,1
339162,4,20,13,7,15,1
301132,1,7,0,7,15,0
82590,1,0,10,-10,3,1
114970,2,10,12,-2,1,0
125183,3,17,7,10,5,1
370095,1,6,0,6,12,1
335039,4,16,13,3,13,0
406025,1,0,3,-3,11,1
308902,4,17,23,-6,1,1
281678,3,24,17,7,6,1
131365,2,7,10,-3,8,0
133503,4,27,20,7,9,1
164826,1,0,0,0,6,0
321205,4,3,19,-16,6,1
100038,2,3,3,0,12,1
46066,3,14,14,0,4,1
51131,2,7,3,4,7,1
377207,1,0,0,0,15,1
223340,1,0,3,-3,15,0
318899,4,21,22,-1,5,1
407906,3,9,17,-8,11,0
240687,4,36,24,12,5,0
269143,5,16,16,0,17,0
213641,2,7,14,-7,10,1
118268,2,12,7,5,2,0
173373,4,31,27,4,10,1
339595,3,17,14,3,15,1
149721,3,34,0,34,16,0
410704,2,10,3,7,13,0
152654,3,7,6,1,17,1
227796,4,6,21,-15,16,1
273931,2,7,6,1,2,0
133962,4,16,12,4,9,0
296971,4,29,7,22,13,0
88928,2,23,3,20,6,0
45633,3,13,13,0,4,0
167966,1,0,7,-7,7,0
387122,3,10,24,-14,2,0
43358,3,14,14,0,3,1
276920,2,14,7,7,4,0
329302,1,3,14,-11,10,1
323227,3,7,3,4,7,0
314470,2,7,0,7,3,1
371756,3,14,14,0,12,0
404611,2,13,10,3,10,0
392733,1,0,0,0,4,0
396830,2,10,7,3,6,1
370793,4,19,17,2,12,1
88812,3,13,13,0,6,1
137833,2,6,6,0,11,1
369166,3,19,14,5,11,1
224879,1,0,3,-3,15,0
317180,2,7,3,4,5,0
122340,4,6,19,-13,4,1
291005,3,20,13,7,10,0
119279,3,14,3,11,3,1
162458,1,7,3,4,4,0
381022,1,0,3,-3,16,1
267182,4,20,10,10,17,1
336493,4,20,17,3,14,0
176900,1,0,0,0,11,1
194256,1,0,0,0,2,1
255678,3,3,7,-4,12,0
216949,1,3,0,3,12,0
147274,3,0,24,-24,15,0
361078,3,16,9,7,7,1
86280,3,13,20,-7,5,0
28191,2,3,0,3,13,1
316487,4,22,17,5,4,0
15288,1,0,0,0,8,1
122353,4,13,19,-6,4,1
261892,4,6,27,-21,14,1
291262,2,7,12,-5,10,1
188321,4,23,13,10,16,0
346049,2,3,6,-3,1,1
388206,4,6,13,-7,2,1
307188,3,0,10,-10,17,0
372595,2,7,6,1,13,1
343353,3,0,20,-20,16,1
82550,4,17,27,-10,3,1
266667,3,22,3,19,16,0
130826,3,13,12,1,8,0
406913,1,0,6,-6,11,0
116549,1,0,0,0,2,1
141607,1,0,0,0,13,1
351069,3,21,16,5,3,0
23359,3,12,10,2,11,1
301085,4,30,13,17,15,1
412838,3,28,35,-7,14,0
416811,4,13,10,3,15,0
115871,3,7,16,-9,1,1
116545,1,0,0,0,2,0
203910,1,0,7,-7,6,1
31689,4,24,24,0,15,1
417607,1,14,0,14,16,0
346617,1,7,0,7,1,1
375931,2,14,6,8,14,1
418671,1,0,0,0,16,1
50465,4,17,10,7,6,1
47974,2,3,21,-18,5,0
346058,3,3,6,-3,1,0
156519,4,7,6,1,2,1
15017,2,0,13,-13,7,0
322117,4,33,0,33,7,0
211189,2,7,10,-3,9,0
99772,2,0,7,-7,12,0
279122,3,21,20,1,5,0
37814,3,14,9,5,1,1
77093,3,7,17,-10,1,1
265816,4,20,12,8,16,1
174064,3,0,33,-33,10,0
399118,4,16,36,-20,7,1
83291,4,22,16,6,4,0
160697,3,10,0,10,4,1
141548,3,27,10,17,13,0
294714,4,6,14,-8,12,0
19824,1,3,7,-4,10,0
147960,1,0,0,0,15,1
364727,3,6,3,3,9,0
236182,3,17,16,1,3,0
64587,2,10,14,-4,13,0
187564,3,13,16,-3,16,0
190267,3,7,14,-7,17,1
223080,2,24,7,17,14,1
212620,3,7,24,-17,10,1
384280,2,6,0,6,1,1
354957,2,7,6,1,4,1
161066,1,3,0,3,4,1
249122,4,28,26,2,9,0
122975,2,0,3,-3,4,1
398188,2,7,10,-3,7,1
178234,4,6,10,-4,12,1
280367,1,0,0,0,5,1
140737,2,15,14,1,12,0
304560,4,24,31,-7,16,1
407070,1,0,3,-3,11,0
236484,2,7,3,4,3,0
211668,2,23,3,20,9,0
166665,4,32,20,12,6,0
187984,3,13,14,-1,16,0
105197,2,7,13,-6,14,0
281931,2,7,7,0,6,0
113409,2,0,7,-7,17,1
317763,1,0,0,0,5,1
66419,1,0,0,0,14,1
284410,1,0,0,0,7,1
19406,1,14,7,7,10,0
330376,2,7,20,-13,11,1
140682,1,0,0,0,12,1
356905,1,3,0,3,5,0
228089,3,3,10,-7,17,0
251677,2,6,3,3,10,0
284874,1,0,0,0,7,1
251939,1,0,0,0,10,0
53228,2,3,0,3,8,0
280109,2,14,0,14,5,0
223325,1,0,0,0,15,0
146659,2,7,23,-16,15,0
220583,4,10,26,-16,13,1
296285,2,0,10,-10,13,0
144125,3,23,6,17,14,0
275831,4,22,3,19,3,0
258795,1,7,6,1,13,0
10231,4,6,10,-4,5,0
208216,4,3,10,-7,8,0
43355,3,14,14,0,3,1
358952,1,0,0,0,6,0
210510,4,9,27,-18,9,0
230564,2,10,10,0,1,1
404997,4,9,20,-11,10,0
207164,3,14,10,4,7,0
22282,2,0,3,-3,11,0
295051,1,0,0,0,12,0
309642,1,0,0,0,1,0
323542,4,24,17,7,7,1
40469,3,7,17,-10,2,1
295653,1,0,0,0,12,0
119392,1,0,14,-14,3,0
76622,2,7,0,7,1,1
372618,2,14,6,8,13,0
267740,4,16,34,-18,17,1
387172,4,10,41,-31,2,1
162514,3,21,10,11,4,1
305859,3,7,14,-7,17,1
6294,4,16,17,-1,3,0
55022,1,0,0,0,8,0
322763,2,3,20,-17,7,1
264444,4,10,28,-18,15,1
327442,4,3,20,-17,9,1
271514,4,28,0,28,1,0
237733,4,20,17,3,4,1
60260,4,10,16,-6,11,0
135139,4,31,6,25,10,0
397626,3,6,27,-21,7,1
331757,3,13,27,-14,12,0
190840,3,16,3,13,17,0
188025,4,23,17,6,16,1
150346,3,27,7,20,16,0
73317,1,13,0,13,17,0
32849,3,6,7,-1,15,0
55753,4,23,29,-6,9,0
103977,3,6,10,-4,13,0
42559,4,10,24,-14,3,1
82349,3,13,10,3,3,1
5523,2,13,10,3,3,0
108067,2,13,14,-1,15,0
347898,2,0,7,-7,1,0
123530,3,10,10,0,4,1
35807,3,3,10,-7,17,0
373189,2,3,3,0,13,0
289315,2,21,17,4,9,1
338872,4,13,22,-9,15,0
273121,1,0,0,0,2,1
408304,2,0,7,-7,12,1
24573,3,10,16,-6,12,1
129710,2,14,6,8,7,1
165119,4,17,24,-7,6,1
24625,1,0,0,0,12,1
300231,4,38,10,28,14,0
372966,4,25,7,18,13,1
412789,2,14,17,-3,14,1
311840,4,20,20,0,2,0
83639,1,0,0,0,4,0
406528,3,14,23,-9,11,1
179816,1,0,0,0,13,1
234374,4,17,10,7,2,1
151503,3,35,7,28,17,0
407463,4,14,10,4,11,1
286513,1,3,7,-4,8,0
48854,2,6,0,6,5,0
214127,3,3,6,-3,11,0
253247,3,3,7,-4,11,0
153401,2,10,10,0,1,1
416322,2,13,3,10,15,0
257566,4,19,10,9,13,0
201854,4,26,30,-4,5,0
325362,4,15,20,-5,8,1
388946,3,17,20,-3,3,0
308702,2,7,6,1,1,1
214498,4,7,20,-13,11,1
101478,1,0,0,0,12,1
244291,4,26,7,19,6,0
166634,3,22,20,2,6,0
176547,4,12,17,-5,11,1
301040,3,17,3,14,15,1
374809,1,7,0,7,14,1
254747,2,3,3,0,11,0
277392,3,17,9,8,4,1
322272,4,0,27,-27,7,0
41335,2,14,9,5,2,0
151243,4,17,26,-9,17,1
146655,2,7,23,-16,15,1
386439,4,23,17,6,2,1
260478,2,10,0,10,14,1
194086,1,0,0,0,1,1
92102,2,3,10,-7,8,1
110307,3,0,17,-17,16,1
129911,4,13,0,13,7,1
36003,1,0,0,0,17,1
49661,2,7,7,0,6,0
195911,2,0,14,-14,2,0
110923,2,7,10,-3,16,1
335887,3,28,14,14,13,1
282651,2,6,10,-4,6,1
370619,3,14,14,0,12,0
138916,1,0,3,-3,12,1
277981,2,0,7,-7,4,1
227513,4,19,17,2,16,1
162843,3,3,3,0,5,1
266951,3,16,7,9,17,1
321500,4,24,30,-6,7,1
339718,2,14,6,8,15,0
215451,2,7,3,4,11,1
4807,4,27,3,24,3,0
203192,3,7,17,-10,5,1
360572,2,7,10,-3,7,1
148956,3,10,12,-2,16,1
116381,1,0,0,0,1,0
75210,1,0,0,0,17,0
246785,3,3,13,-10,8,1
371191,3,11,19,-8,12,0
328830,4,17,20,-3,10,1
137586,4,20,34,-14,11,1
84010,3,20,3,17,4,1
56379,1,0,0,0,9,0
182818,3,26,17,9,14,1
3222,1,0,0,0,2,0
305089,2,21,10,11,16,1
47259,4,19,9,10,5,0
341715,4,23,13,10,16,1
15218,3,13,0,13,8,0
75517,4,37,7,30,17,0
352587,4,34,23,11,3,0
349168,3,27,7,20,2,1
128563,4,27,35,-8,7,1
51859,1,6,7,-1,7,1
331697,1,0,13,-13,12,0
192851,4,10,15,-5,1,0
346299,1,0,0,0,1,0
233844,1,7,3,4,2,1
384065,1,0,0,0,1,0
173756,2,3,3,0,10,1
60841,3,17,16,1,11,0
413365,1,0,7,-7,14,1
300355,4,10,7,3,14,1
321572,2,10,6,4,7,0
65408,1,0,7,-7,13,0
400566,4,13,24,-11,8,1
161830,1,0,0,0,4,1
23727,1,0,0,0,12,1
349522,1,0,0,0,2,0
195427,4,24,3,21,2,0
92426,3,17,10,7,8,1
162916,1,0,0,0,5,1
346008,2,0,3,-3,1,1
340731,1,0,6,-6,15,0
52285,4,27,19,8,7,1
143636,2,13,10,3,14,0
312805,2,0,0,0,3,1
128455,1,14,0,14,7,0
301800,4,3,34,-31,15,1
68257,4,20,27,-7,14,1
109036,4,16,34,-18,15,1
411573,1,7,10,-3,13,0
339704,2,7,3,4,15,0
264295,3,10,23,-13,15,0
223272,3,3,9,-6,15,0
89576,3,7,27,-20,7,1
191761,4,16,24,-8,17,1
106935,3,12,3,9,14,1
280529,2,7,0,7,5,0
364476,4,42,28,14,9,1
293160,1,6,0,6,11,1
396851,2,17,10,7,6,1
406707,4,27,0,27,11,0
107377,4,19,6,13,15,0
285258,2,7,6,1,7,1
55473,4,26,10,16,9,0
242253,1,0,0,0,6,0
129726,3,14,14,0,7,1
282947,2,7,3,4,6,1
2400,2,21,13,8,2,0
313942,4,28,29,-1,3,0
5206,2,7,10,-3,3,0
142752,2,9,10,-1,13,0
153148,3,20,17,3,1,0
6582,4,16,6,10,3,0
30746,3,24,28,-4,15,1
182518,4,28,14,14,14,1
125269,1,3,0,3,5,1
358120,2,17,6,11,6,0
33738,1,0,0,0,16,1
211740,4,29,16,13,9,0
377193,1,0,0,0,15,1
77366,2,7,7,0,1,1
35879,1,0,0,0,17,0
352674,2,7,3,4,3,1
406374,2,10,7,3,11,1
50418,2,7,7,0,6,0
28226,2,17,0,17,13,0
197260,2,0,0,0,3,0
241911,4,20,20,0,5,1
204452,3,7,23,-16,6,0
37338,2,14,0,14,17,0
297208,2,0,3,-3,13,0
7456,3,20,6,14,4,1
351284,4,31,17,14,3,0
184134,3,16,14,2,14,1
409258,3,13,13,0,12,0
359192,4,13,21,-8,6,0
191950,2,0,6,-6,1,0
286817,1,3,7,-4,8,1
131495,2,0,3,-3,8,0
115019,4,13,19,-6,1,1
68381,3,3,14,-11,14,1
313540,1,0,7,-7,3,0
256486,4,19,31,-12,12,1
352776,1,7,0,7,3,0
275455,2,20,10,10,3,0
128220,3,20,7,13,7,0
284913,2,7,14,-7,7,0
283338,4,10,16,-6,7,1
12417,3,10,6,4,6,0
170343,4,0,15,-15,8,1
259223,4,28,32,-4,13,0
235494,1,0,0,0,3,0
183527,2,7,3,4,14,0
171811,3,23,17,6,9,0
219824,3,38,0,38,13,0
297382,3,9,17,-8,13,0
104048,1,7,0,7,13,0
22710,1,3,7,-4,11,1
183483,1,0,0,0,14,1
382243,2,17,3,14,17,0
200619,3,27,21,6,4,1
299350,4,28,16,12,14,1
405547,2,0,14,-14,10,1
250134,2,7,0,7,9,1
22754,3,3,21,-18,11,0
393016,4,12,10,2,4,0
213879,4,54,14,40,10,1
305323,4,42,21,21,16,1
274889,3,7,16,-9,3,1
220210,1,17,0,17,13,0
23361,3,12,10,2,11,0
344144,3,20,3,17,17,0
204863,2,3,3,0,6,0
111284,4,10,16,-6,16,0
131414,3,7,16,-9,8,0
350142,1,0,0,0,2,1
148234,4,16,31,-15,16,1
132098,2,7,0,7,9,1
117325,2,14,0,14,2,1
362506,3,14,6,8,8,1
232484,2,10,3,7,1,1
326384,4,20,10,10,9,1
309103,2,9,3,6,1,0
265963,4,0,33,-33,16,1
394986,1,0,0,0,5,0
6817,2,3,21,-18,3,0
351999,4,28,21,7,3,1
358335,4,3,27,-24,6,0
307534,4,38,19,19,17,1
223042,1,7,7,0,14,1
270868,3,16,13,3,1,1
362498,2,7,6,1,8,1
320323,4,14,24,-10,6,0
362916,2,7,0,7,8,1
149933,1,7,0,7,16,0
215162,2,7,6,1,11,1
411860,1,0,0,0,13,1
339758,3,24,6,18,15,1
277751,3,14,6,8,4,0
70616,3,17,16,1,15,0
368711,3,7,16,-9,11,0
116271,2,17,3,14,1,1
268890,2,6,24,-18,17,1
144443,3,9,26,-17,14,1
269284,4,13,19,-6,17,1
305771,4,9,10,-1,17,1
420351,3,17,10,7,17,0
37079,3,13,14,-1,17,0
175077,1,7,3,4,10,0
326407,4,20,17,3,9,1
297347,2,3,10,-7,13,1
360494,4,17,6,11,7,0
225531,4,0,24,-24,15,1
168843,2,14,0,14,7,0
405575,2,7,14,-7,10,1
38744,1,0,0,0,1,0
412917,2,6,3,3,14,1
154028,3,10,21,-11,1,1
110331,3,10,17,-7,16,1
58204,1,0,3,-3,10,1
370163,3,17,3,14,12,0
391096,1,7,13,-6,4,0
367162,3,29,23,6,10,1
299338,4,28,16,12,14,1
52810,2,0,30,-30,7,0
17650,2,7,3,4,9,0
246408,4,26,18,8,7,0
24741,4,20,27,-7,12,1
19681,1,3,0,3,10,1
183092,2,7,3,4,14,1
323921,1,7,7,0,8,1
343609,2,15,7,8,17,0
296735,1,0,0,0,13,1
38059,2,3,0,3,1,1
182859,4,36,20,16,14,0
416266,1,7,0,7,15,0
103104,3,34,7,27,13,1
65556,1,6,0,6,13,0
25560,2,17,7,10,12,1
77856,4,17,28,-11,1,1
218554,1,0,14,-14,13,1
165850,3,6,16,-10,6,0
365287,2,10,13,-3,9,1
278368,4,17,21,-4,4,1
120570,2,0,6,-6,3,0
185602,3,13,20,-7,15,0
245812,1,0,7,-7,7,0
253819,1,7,7,0,11,1
37234,3,10,14,-4,17,0
302832,3,9,23,-14,15,1
340205,3,23,24,-1,15,1
98548,2,0,0,0,11,0
5416,4,20,16,4,3,0
141486,2,7,0,7,13,0
215346,3,14,13,1,11,1
392980,3,9,10,-1,4,1
183655,2,0,8,-8,14,1
30614,3,17,0,17,14,0
156230,4,16,23,-7,2,0
113322,3,16,31,-15,17,1
211082,3,37,0,37,9,0
305409,3,20,3,17,17,1
231605,2,14,10,4,1,1
220543,3,7,20,-13,13,0
27088,4,17,9,8,13,0
92274,2,10,0,10,8,1
247468,4,13,12,1,8,1
945,3,0,3,-3,1,1
186920,2,7,3,4,15,0
229107,2,13,7,6,17,1
71719,2,10,13,-3,16,0
32143,4,24,21,3,15,0
191056,1,7,0,7,17,0
73562,4,9,41,-32,17,0
193803,1,0,0,0,1,1
309611,4,16,3,13,1,0
264990,4,32,17,15,16,0
217024,3,20,3,17,12,0
95284,3,10,24,-14,10,1
82575,1,0,3,-3,3,0
68991,3,21,14,7,15,0
109670,1,0,0,0,16,1
33204,2,7,0,7,16,1
118844,3,20,7,13,2,0
220020,4,16,35,-19,13,1
16533,4,29,13,16,8,1
67176,2,0,0,0,14,1
173880,1,6,10,-4,10,1
91058,3,9,0,9,7,1
161621,3,30,16,14,4,0
414901,4,35,7,28,15,1
271848,1,0,3,-3,2,0
293552,3,13,17,-4,11,0
267031,1,0,0,0,17,0
363840,3,13,17,-4,8,0
288791,1,3,7,-4,9,1
314198,3,7,20,-13,3,1
133643,3,10,21,-11,9,1
275680,4,37,10,27,3,1
28142,4,30,10,20,13,0
189916,2,3,7,-4,17,0
334649,1,2,0,2,13,0
40956,4,16,20,-4,2,0
20641,2,0,13,-13,10,0
17532,2,13,0,13,9,1
285936,3,23,7,16,8,1
263962,3,23,0,23,15,1
27714,1,0,0,0,13,0
256340,1,0,0,0,12,1
190062,2,17,3,14,17,1
2245,2,10,7,3,1,0
358793,1,0,0,0,6,1
40283,2,6,0,6,2,0
21573,2,7,17,-10,11,1
291793,4,9,23,-14,11,1
90589,2,14,10,4,7,1
83503,2,0,7,-7,4,1
414591,4,21,9,12,14,1
2405,2,21,13,8,2,0
324061,1,0,0,0,8,0
64618,3,20,17,3,13,1
1053,2,7,15,-8,1,1
275419,1,6,10,-4,3,1
388638,3,17,0,17,3,0
29492,4,10,14,-4,14,1
411822,4,0,34,-34,13,1
391228,1,0,0,0,4,1
159309,4,27,24,3,3,0
158764,2,0,3,-3,3,1
149414,3,13,27,-14,16,1
304830,3,3,3,0,16,1
150285,2,14,7,7,16,1
60017,1,0,0,0,11,1
323501,2,10,10,0,7,0
240434,2,0,0,0,5,0
207162,3,14,10,4,7,0
141675,2,23,14,9,13,0
131095,2,20,6,14,8,0
232605,1,0,0,0,1,1
155531,2,20,3,17,2,1
9697,4,19,28,-9,5,0
327163,4,21,17,4,9,1
157398,2,6,7,-1,2,1
259017,3,3,16,-13,13,0
158251,4,38,0,38,3,1
118664,2,14,6,8,2,0
52695,3,3,13,-10,7,0
338684,3,20,10,10,14,0
363078,2,7,3,4,8,1
136715,2,6,10,-4,11,1
254889,2,14,7,7,12,0
317827,3,9,3,6,5,0
396878,3,27,13,14,6,1
159996,2,3,17,-14,3,0
99104,4,23,7,16,11,1
203095,4,39,17,22,5,1
17382,3,17,0,17,9,0
217239,1,0,0,0,12,1
253204,2,0,7,-7,11,0
53154,4,19,38,-19,7,1
11562,4,12,10,2,6,1
413139,4,33,35,-2,14,0
418975,2,7,7,0,16,1
66350,3,14,21,-7,14,0
402883,3,17,6,11,9,0
66034,2,7,0,7,13,1
187526,2,6,10,-4,16,0
149878,3,3,16,-13,16,1
318397,2,21,0,21,5,0
90498,4,0,26,-26,7,1
126220,3,21,6,15,6,0
375738,1,3,0,3,14,1
412612,2,3,3,0,14,1
118959,2,0,17,-17,3,1
100327,2,9,17,-8,12,0
248080,4,34,20,14,8,0
259142,2,14,7,7,13,0
363323,4,36,14,22,8,0
204074,1,3,7,-4,6,0
313063,4,20,0,20,3,0
238724,4,19,17,2,4,0
69876,3,24,9,15,15,0
168812,1,7,0,7,7,1
99170,2,3,3,0,11,0
258070,1,6,0,6,13,0
135216,2,13,3,10,10,0
305670,2,3,7,-4,17,1
155137,4,19,33,-14,1,0
323397,3,20,0,20,7,0
365584,2,28,14,14,9,1
224900,2,0,6,-6,15,0
181728,3,7,7,0,13,0
191365,2,0,17,-17,17,1
17049,2,13,0,13,9,0
306244,1,0,0,0,17,1
211302,2,3,3,0,9,1
159743,3,7,10,-3,3,0
383122,3,23,14,9,17,0
362484,2,7,6,1,8,1
227200,4,13,17,-4,16,1
58287,3,20,13,7,10,0
137112,3,24,6,18,11,1
364124,3,17,3,14,9,1
128069,2,3,6,-3,7,0
393404,3,21,17,4,5,0
367447,4,26,21,5,10,1
192802,3,0,15,-15,1,1
29871,3,9,16,-7,14,0
276219,3,24,10,14,3,0
189878,1,0,7,-7,17,1
164239,4,41,38,3,5,0
86882,4,9,23,-14,5,0
234921,1,10,0,10,2,0
113760,3,3,17,-14,17,1
46032,2,14,14,0,4,1
346524,3,24,30,-6,1,0
29687,1,3,0,3,14,1
61128,3,0,7,-7,11,0
73721,4,20,12,8,17,1
4861,1,14,0,14,3,0
283048,4,28,3,25,6,1
204852,2,3,0,3,6,0
198727,1,0,0,0,3,1
51674,4,34,20,14,7,1
233382,1,7,0,7,2,1
61490,1,0,7,-7,11,1
75332,4,21,33,-12,17,1
111006,4,14,20,-6,16,0
63247,1,0,0,0,12,0
128269,4,20,7,13,7,1
240318,3,7,16,-9,5,0
537,3,7,20,-13,1,1
137908,3,24,8,16,11,0
65922,3,17,14,3,13,1
367905,4,23,20,3,10,0
131122,3,27,9,18,8,0
109175,4,31,7,24,15,1
178077,4,23,23,0,12,1
156291,1,3,0,3,2,0
11235,3,17,14,3,6,0
355377,1,3,3,0,4,1
264354,1,0,0,0,15,1
139058,1,6,0,6,12,0
372616,2,7,6,1,13,1
140338,3,17,20,-3,12,1
103380,3,10,17,-7,13,0
379147,2,6,3,3,16,0
218440,2,17,14,3,13,0
36405,4,20,26,-6,17,1
13609,3,13,7,6,7,0
147052,1,0,0,0,15,0
197337,4,17,10,7,3,1
38210,2,3,7,-4,1,0
356797,2,0,0,0,5,0
303955,4,14,34,-20,16,1
215656,3,14,6,8,11,0
100389,4,9,20,-11,12,0
351503,2,0,27,-27,3,0
106799,4,27,22,5,14,0
201709,4,27,20,7,5,1
88200,3,14,17,-3,6,0
172279,4,24,19,5,9,0
184739,1,6,0,6,15,1
206254,3,7,6,1,7,1
195949,3,0,17,-17,2,1
214607,3,3,9,-6,11,0
356004,2,14,7,7,5,0
167096,4,16,34,-18,7,0
386525,3,7,21,-14,2,1
46278,1,0,7,-7,4,1
58313,4,27,13,14,10,1
146246,3,3,23,-20,15,0
154419,2,7,0,7,1,1
219131,1,0,0,0,13,0
352117,3,6,20,-14,3,1
293483,2,7,3,4,11,1
85345,3,21,3,18,5,1
106776,3,20,15,5,14,0
244135,4,26,34,-8,6,0
282438,4,10,26,-16,6,1
102149,2,14,0,14,13,0
357346,1,0,0,0,5,1
371916,4,27,17,10,12,0
236057,3,30,10,20,3,1
365360,4,17,19,-2,9,1
183907,1,7,3,4,14,0
167478,2,0,0,0,7,1
167355,3,23,16,7,7,1
187859,3,7,20,-13,16,0
305052,1,14,0,14,16,0
91202,3,10,17,-7,8,1
27184,2,13,7,6,13,0
120010,4,23,37,-14,3,0
7336,5,20,19,1,4,0
331823,1,0,0,0,12,0
221917,3,19,16,3,14,1
396670,1,7,7,0,6,0
29161,3,3,19,-16,14,1
82159,2,13,3,10,3,0
44519,1,0,0,0,3,0
248215,4,12,10,2,8,0
83256,3,9,10,-1,4,1
343535,4,10,10,0,16,0
225165,1,3,0,3,15,0
2029,4,21,15,6,1,1
199525,2,17,3,14,4,1
276388,4,25,38,-13,3,1
102277,2,10,7,3,13,0
414071,1,0,0,0,14,0
398880,2,3,3,0,7,0
96610,3,3,3,0,10,1
14360,4,2,17,-15,7,1
40147,2,13,7,6,2,0
323077,3,20,14,6,7,1
124993,2,3,3,0,5,1
85637,2,17,0,17,5,1
4375,3,7,7,0,2,1
166576,2,15,7,8,6,0
386919,2,7,14,-7,2,0
89495,1,0,0,0,7,0
126110,4,29,9,20,6,1
309574,3,16,0,16,1,0
307592,2,0,0,0,17,1
319169,3,2,3,-1,5,0
68217,3,10,14,-4,14,1
189223,3,33,3,30,16,0
293010,2,3,13,-10,11,1
401853,3,7,21,-14,9,1
259777,4,20,10,10,14,0
297825,3,14,7,7,13,0
74557,3,3,3,0,17,0
269861,4,22,10,12,1,1
57182,3,10,0,10,10,1
133263,1,0,0,0,9,0
92415,2,17,10,7,8,1
237594,4,38,28,10,3,0
249630,1,0,7,-7,9,1
328760,2,14,13,1,10,1
330107,3,0,13,-13,11,1
190393,3,7,0,7,17,0
382013,4,7,30,-23,17,0
17350,2,17,0,17,9,1
251290,4,13,30,-17,10,0
348641,1,0,3,-3,2,1
232378,4,13,15,-2,1,0
374376,1,7,0,7,14,1
343360,3,0,20,-20,16,1
174007,1,0,6,-6,10,0
408489,3,7,10,-3,12,1
317132,1,0,0,0,5,0
146081,3,19,10,9,15,0
45579,2,7,13,-6,4,0
143610,2,10,3,7,14,1
227165,3,10,7,3,16,1
345757,4,16,7,9,17,0
171888,2,0,7,-7,9,1
204773,3,21,21,0,6,1
130520,3,10,6,4,8,1
366363,1,6,0,6,10,0
201362,4,28,13,15,5,1
313868,2,14,19,-5,3,1
251836,2,7,10,-3,10,1
331608,3,20,30,-10,11,1
186660,3,24,3,21,15,1
376590,4,15,6,9,14,1
410396,2,6,7,-1,13,0
381112,4,24,28,-4,16,0
120150,4,10,6,4,3,1
274922,4,14,16,-2,3,1
382297,4,20,3,17,17,0
196162,4,31,24,7,2,0
286969,1,0,0,0,8,1
261275,4,38,0,38,14,1
18561,2,3,10,-7,9,1
284517,4,24,15,9,7,0
97974,2,7,10,-3,11,1
21023,4,14,31,-17,10,1
408259,1,0,0,0,12,0
238893,4,41,21,20,4,1
341498,2,3,7,-4,16,1
33605,5,17,16,1,16,0
53998,1,0,0,0,8,1
403522,4,24,19,5,9,0
38486,1,10,3,7,1,1
353210,1,0,7,-7,4,1
44632,4,20,24,-4,3,1
182906,2,0,17,-17,14,0
400015,1,0,3,-3,8,1
205880,4,20,7,13,7,0
278138,2,7,7,0,4,0
62944,4,17,17,0,12,1
97895,4,21,27,-6,11,0
396362,2,20,6,14,6,0
381518,2,14,0,14,17,0
100798,2,6,3,3,12,1
320638,4,38,18,20,6,0
222849,4,24,13,11,14,0
24953,2,10,14,-4,12,1
187719,3,16,13,3,16,1
149164,4,24,31,-7,16,0
415474,3,23,3,20,15,1
100440,1,0,7,-7,12,1
211488,2,19,7,12,9,0
180140,2,7,0,7,13,0
394848,1,0,14,-14,5,1
220105,2,19,6,13,13,1
87814,1,3,0,3,6,1
333569,4,16,10,6,12,1
324091,2,0,7,-7,8,1
256314,4,14,17,-3,12,1
255183,2,7,0,7,12,0
104127,3,17,20,-3,13,0
353289,3,31,20,11,4,0
254650,4,31,21,10,11,0
396279,3,3,6,-3,6,0
334345,1,0,3,-3,13,1
240048,4,17,20,-3,5,0
203545,4,31,3,28,6,1
72613,1,7,0,7,16,1
309593,4,16,3,13,1,0
98600,3,7,7,0,11,1
208801,3,6,22,-16,8,1
211080,3,37,0,37,9,0
59362,3,0,9,-9,11,0
346345,2,3,6,-3,1,1
317791,2,9,3,6,5,1
352893,4,14,16,-2,3,0
278622,2,14,0,14,4,0
79326,3,15,3,12,2,1
366160,3,7,38,-31,10,0
70126,2,13,0,13,15,0
334036,4,20,16,4,12,1
320053,1,0,0,0,6,1
22859,2,0,7,-7,11,0
312466,1,3,0,3,3,0
371797,4,24,14,10,12,0
48523,1,11,0,11,5,0
420695,4,21,19,2,17,1
353414,3,18,0,18,4,0
195014,1,7,7,0,2,0
173102,1,0,0,0,9,1
161849,1,6,0,6,4,1
322576,2,0,3,-3,7,1
124700,2,0,3,-3,5,1
324377,2,7,3,4,8,1
316657,4,12,12,0,4,0
302009,1,7,0,7,15,0
23038,3,7,14,-7,11,1
418863,2,7,10,-3,16,1
322480,2,15,3,12,7,0
177800,1,0,0,0,12,0
81716,3,17,17,0,3,0
117866,4,9,20,-11,2,1
364999,3,17,6,11,9,0
121696,3,14,7,7,4,1
132542,2,2,29,-27,9,1
269824,3,15,10,5,1,1
239531,2,3,0,3,4,0
89357,2,3,6,-3,7,0
113771,3,3,17,-14,17,1
284124,1,0,3,-3,7,0
415859,2,7,20,-13,15,1
64614,3,20,14,6,13,0
159121,4,24,7,17,3,0
379993,1,0,0,0,16,1
1271,4,17,13,4,1,0
316257,2,7,16,-9,4,1
207428,2,7,14,-7,7,1
132359,1,0,0,0,9,0
46122,1,0,0,0,4,1
127668,4,30,20,10,6,1
148737,2,13,3,10,16,0
405140,3,3,10,-7,10,1
243399,2,3,10,-7,6,1
203274,1,0,10,-10,6,1
42626,2,0,7,-7,3,0
177527,1,7,0,7,11,0
194659,4,31,7,24,2,1
118172,4,31,27,4,2,0
244882,4,7,10,-3,7,1
321753,3,9,6,3,7,1
298301,4,20,13,7,14,0
223476,1,0,3,-3,15,1
78512,1,0,0,0,2,0
307716,1,0,0,0,1,1
179896,3,17,9,8,13,1
251229,2,10,24,-14,10,1
170012,4,28,17,11,8,1
60532,3,30,14,16,11,0
376231,3,10,14,-4,14,1
178784,2,21,7,14,12,0
238599,1,0,0,0,4,1
291051,1,0,0,0,10,0
402776,4,30,14,16,9,0
226995,2,3,6,-3,16,1
330603,4,24,7,17,11,0
75050,1,0,0,0,17,0
75359,1,0,0,0,17,0
174398,4,17,3,14,10,1
336455,3,10,17,-7,14,0
191834,2,17,10,7,1,0
142107,2,0,7,-7,13,0
138897,1,0,3,-3,12,1
162735,4,29,24,5,5,0
393932,5,23,23,0,5,1
146487,1,7,0,7,15,0
88372,4,24,10,14,6,1
76743,1,3,0,3,1,1
6937,2,0,0,0,3,0
379562,2,13,6,7,16,1
188280,3,14,10,4,16,0
339690,1,7,3,4,15,1
232842,4,16,17,-1,2,1
150698,1,6,3,3,17,0
392048,3,10,23,-13,4,0
267398,3,0,10,-10,17,1
272824,2,20,0,20,2,1
239446,3,9,17,-8,4,1
277373,2,17,9,8,4,1
46025,2,14,13,1,4,0
108771,1,0,7,-7,15,1
213908,1,9,0,9,10,1
181555,2,12,0,12,13,1
198788,2,3,9,-6,3,0
7473,3,29,6,23,4,1
268842,1,0,0,0,17,0
269419,4,21,17,4,1,0
52581,4,22,10,12,7,0
13271,2,0,13,-13,7,1
289878,2,6,3,3,10,0
351591,4,6,27,-21,3,0
339666,1,0,0,0,15,1
340185,2,20,21,-1,15,1
385646,4,16,24,-8,1,0
165989,3,17,14,3,6,1
184265,3,31,7,24,14,0
355701,2,7,3,4,5,1
119649,4,17,12,5,3,1
332537,1,0,0,0,12,0
319523,4,13,17,-4,6,0
404920,2,3,10,-7,10,0
188649,5,20,19,1,16,0
320966,1,7,0,7,6,0
323606,1,7,0,7,8,1
277470,1,0,0,0,4,0
72840,4,37,17,20,16,1
335429,2,13,6,7,13,0
176626,1,0,12,-12,11,1
157975,4,16,25,-9,3,0
91758,2,0,0,0,8,1
279474,1,7,0,7,5,1
287080,4,26,30,-4,8,0
265325,2,7,0,7,16,0
327147,3,14,17,-3,9,1
234315,2,10,0,10,2,1
365295,3,10,16,-6,9,1
141478,1,7,0,7,13,0
235586,4,27,13,14,3,1
130121,1,0,3,-3,8,0
27047,3,10,3,7,13,0
247324,4,42,35,7,8,1
110466,3,17,0,17,16,0
291324,4,24,25,-1,10,0
23308,2,6,10,-4,11,0
177286,4,14,20,-6,11,1
360710,1,3,7,-4,7,1
328649,4,26,35,-9,10,1
9472,3,10,3,7,5,1
68314,1,3,0,3,14,0
164305,2,13,0,13,5,0
163154,3,22,25,-3,5,1
185778,4,25,3,22,15,1
179236,2,23,3,20,12,0
375743,2,6,0,6,14,1
82659,3,12,10,2,3,0
365111,2,0,7,-7,9,0
281446,2,0,10,-10,6,1
407198,1,0,0,0,11,0
291786,4,9,23,-14,11,1
93001,2,10,3,7,8,0
160646,2,7,0,7,4,1
180411,1,7,0,7,13,0
300874,2,0,7,-7,15,1
327146,3,14,17,-3,9,1
189202,3,24,3,21,16,1
293846,4,31,19,12,12,0
404931,2,3,10,-7,10,0
110226,1,0,3,-3,16,1
151367,3,31,14,17,17,1
291120,2,15,13,2,10,1
165977,2,10,14,-4,6,1
155424,3,13,10,3,2,1
275778,3,16,3,13,3,0
243809,4,24,20,4,6,1
49767,1,6,7,-1,6,1
255079,3,6,21,-15,12,0
77026,1,0,7,-7,1,1
267677,2,7,24,-17,17,0
130191,2,0,19,-19,8,0
206342,1,0,0,0,7,0
213749,1,0,0,0,10,0
335813,1,7,6,1,13,0
69538,1,0,0,0,15,0
267568,3,27,27,0,17,1
7566,2,7,0,7,4,1
113915,3,10,3,7,17,0
63429,2,14,9,5,12,0
70628,4,17,17,0,15,0
137491,1,7,0,7,11,0
178377,4,28,24,4,12,0
132883,3,6,14,-8,9,1
50587,2,3,6,-3,6,0
332605,2,17,6,11,12,1
121977,2,10,7,3,4,1
375937,2,14,6,8,14,0
359509,3,0,21,-21,6,0
164778,3,26,14,12,6,1
307865,4,27,35,-8,1,1
353163,4,20,29,-9,3,0
74168,1,3,0,3,17,0
202413,2,3,3,0,5,0
356169,2,19,0,19,5,0
366678,2,17,10,7,10,1
195076,3,7,23,-16,2,0
241275,3,3,0,3,5,1
179056,1,3,3,0,12,0
229359,1,0,0,0,17,1
46812,4,14,33,-19,4,1
195348,2,3,3,0,2,1
35201,3,0,14,-14,16,0
119656,4,17,12,5,3,1
47800,2,7,6,1,5,1
277159,4,17,27,-10,4,0
93470,3,3,28,-25,9,1
283958,1,0,0,0,7,0
18547,1,3,3,0,9,0
245278,3,9,3,6,7,1
206139,4,20,13,7,7,0
83282,4,22,10,12,4,0
38355,2,7,6,1,1,1
142620,2,13,6,7,13,0
267208,1,3,0,3,17,0
283021,4,21,3,18,6,1
372263,2,10,7,3,13,0
26040,4,10,19,-9,13,1
211824,2,20,10,10,9,1
179674,5,31,30,1,12,1
319988,3,43,17,26,6,1
261388,3,10,17,-7,14,0
21422,2,9,14,-5,11,1
333199,2,0,7,-7,12,0
194727,2,0,10,-10,2,1
357961,2,14,6,8,6,1
268613,3,7,6,1,17,1
150294,2,14,7,7,16,1
21284,3,3,14,-11,11,1
315718,4,17,19,-2,4,0
311321,2,7,0,7,2,1
207806,4,30,16,14,7,0
213300,1,0,0,0,10,1
247695,2,7,6,1,8,0
263012,2,10,0,10,15,0
53923,3,14,13,1,8,0
117149,1,6,3,3,2,1
101193,1,0,7,-7,12,0
342761,3,7,14,-7,16,0
163594,3,7,19,-12,5,0
101992,2,7,0,7,12,0
107079,3,39,0,39,15,1
303812,4,20,17,3,16,0
276143,1,7,0,7,3,1
59291,1,0,0,0,11,0
88335,3,14,7,7,6,0
368941,1,0,7,-7,11,1
90623,3,17,27,-10,7,0
145345,4,35,26,9,14,1
70243,1,0,0,0,15,1
62654,4,17,20,-3,12,0
294621,1,0,0,0,12,0
93793,4,3,19,-16,9,0
130292,1,0,0,0,8,1
147579,3,12,0,12,15,0
57775,2,16,10,6,10,1
253182,1,0,0,0,11,0
113587,2,3,0,3,17,1
299702,2,17,3,14,14,0
137932,4,27,15,12,11,1
303476,3,25,10,15,16,0
320125,3,17,0,17,6,0
231254,1,0,0,0,1,0
220180,4,29,13,16,13,1
339693,1,7,3,4,15,0
93278,2,14,3,11,9,0
415188,3,10,24,-14,15,1
245363,1,9,0,9,7,0
273613,2,10,3,7,2,0
350841,1,0,0,0,3,1
399114,4,10,36,-26,7,1
357814,2,3,14,-11,6,1
241804,1,3,3,0,5,0
392030,3,10,10,0,4,0
376221,2,10,13,-3,14,0
10400,4,10,45,-35,5,1
392044,3,10,17,-7,4,0
9113,4,30,19,11,4,0
14231,4,0,38,-38,7,0
218589,2,7,17,-10,13,0
183062,2,7,0,7,14,0
358025,4,24,16,8,6,0
109814,1,10,0,10,16,1
255716,4,3,20,-17,12,1
185232,2,10,6,4,15,1
25488,1,0,0,0,12,1
91107,1,0,0,0,8,1
416541,4,38,17,21,15,0
159771,4,7,13,-6,3,1
277915,4,7,20,-13,4,0
386203,2,6,10,-4,2,1
385482,4,35,10,25,1,1
348861,3,3,14,-11,2,1
97455,1,6,0,6,10,0
208276,1,0,7,-7,8,0
376139,4,3,16,-13,14,1
302709,4,23,20,3,15,1
204021,4,16,7,9,6,1
403882,2,10,7,3,10,0
360686,1,0,0,0,7,0
365029,4,17,6,11,9,1
138440,2,7,7,0,12,1
254976,4,45,14,31,12,1
420234,4,3,13,-10,17,1
417597,1,14,0,14,16,0
105385,3,23,7,16,14,0
290696,3,41,22,19,10,0
286607,4,17,38,-21,8,0
152444,1,7,0,7,17,1
355075,1,0,12,-12,4,0
393137,4,24,3,21,4,0
128629,2,3,10,-7,7,0
385704,1,0,0,0,1,1
233939,4,17,13,4,2,1
23962,3,16,3,13,12,0
420850,4,17,27,-10,17,0
261329,1,0,7,-7,14,1
163979,4,33,20,13,5,1
138872,4,12,47,-35,12,0
276863,4,26,20,6,4,1
253191,1,0,6,-6,11,0
345012,4,16,23,-7,17,1
42387,3,14,16,-2,2,1
253801,1,0,0,0,11,1
74255,3,9,10,-1,17,1
349409,2,0,7,-7,2,1
362027,1,0,0,0,8,0
343268,4,22,0,22,16,0
316572,2,3,6,-3,4,0
390518,2,10,7,3,3,1
166803,4,30,16,14,6,0
271320,3,9,24,-15,1,0
387536,2,3,0,3,2,0
89629,1,3,0,3,7,0
62546,1,3,0,3,12,0
57886,1,3,3,0,10,1
34707,2,3,3,0,16,1
8720,1,0,0,0,4,0
209844,2,10,13,-3,8,1
134873,1,7,0,7,10,0
112741,3,10,0,10,17,0
229016,4,21,16,5,17,1
149029,1,0,7,-7,16,1
396192,1,0,0,0,6,0
396627,4,23,10,13,6,0
222763,2,10,7,3,14,0
268985,1,0,0,0,17,1
366024,3,30,14,16,10,1
145326,3,28,12,16,14,1
273871,1,0,0,0,2,0
235937,4,23,21,2,3,0
58527,2,7,3,4,10,1
212369,4,13,10,3,10,0
36936,2,0,25,-25,17,1
8405,4,37,10,27,4,0
243899,3,16,6,10,6,0
385295,3,7,20,-13,1,1
240627,3,20,14,6,5,0
38367,2,7,9,-2,1,1
27675,4,14,27,-13,13,0
383464,1,0,0,0,17,1
79428,2,6,7,-1,2,1
194286,2,10,0,10,2,0
263566,1,0,0,0,15,0
194356,4,23,6,17,2,1
88752,2,6,3,3,6,1
20565,4,17,0,17,10,1
69344,4,19,9,10,15,1
138385,1,0,0,0,12,1
15679,4,37,10,27,8,0
252621,2,3,3,0,10,1
331285,2,0,7,-7,11,0
222138,1,0,0,0,14,1
304049,2,3,20,-17,16,1
148221,4,16,28,-12,16,0
154986,1,0,0,0,1,0
121038,3,11,21,-10,3,0
176099,4,24,16,8,11,0
61032,4,34,16,18,11,0
399888,2,0,3,-3,8,0
87141,3,14,10,4,5,0
132064,1,0,0,0,9,1
380879,1,0,0,0,16,0
397762,3,9,14,-5,7,1
404713,1,0,3,-3,10,1
399474,2,0,24,-24,7,0
206465,4,23,0,23,7,1
6492,2,0,0,0,3,1
110158,3,13,17,-4,16,1
254361,4,13,30,-17,11,0
207596,3,27,10,17,7,1
266936,2,13,7,6,17,1
87472,4,20,17,3,6,1
411537,1,0,0,0,13,1
30031,3,26,0,26,14,1
301506,3,20,15,5,15,0
154887,2,6,3,3,1,1
215917,2,3,14,-11,11,0
70671,4,17,22,-5,15,1
35213,4,0,14,-14,16,0
126532,3,7,6,1,6,1
76791,2,33,0,33,1,0
22189,3,10,15,-5,11,1
134658,4,34,24,10,10,0
22958,4,3,26,-23,11,0
73927,2,14,0,14,17,1
167754,4,26,23,3,7,0
272899,3,20,17,3,2,1
78025,3,12,16,-4,1,0
172031,1,0,0,0,9,1
42884,1,7,3,4,3,0
346367,3,6,13,-7,1,1
249819,1,6,3,3,9,0
334092,2,7,0,7,13,0
87727,3,6,20,-14,6,0
261458,1,0,0,0,14,1
137487,1,7,0,7,11,1
125148,2,14,7,7,5,1
224031,3,14,6,8,15,0
315422,4,23,30,-7,4,1
300436,1,9,0,9,14,0
234618,2,17,10,7,2,0
232453,1,3,0,3,1,0
21732,3,24,14,10,11,0
213071,3,17,3,14,10,1
359080,4,19,13,6,6,0
364305,4,3,32,-29,9,1
47096,4,31,10,21,5,0
92565,2,17,3,14,8,0
243730,2,17,3,14,6,0
194760,2,0,13,-13,2,0
70949,4,15,39,-24,15,1
85589,1,0,0,0,5,1
213622,1,7,0,7,10,1
30962,1,0,0,0,15,0
47363,3,3,13,-10,5,0
296650,3,3,16,-13,13,0
104918,2,3,6,-3,14,1
144324,4,29,7,22,14,1
280915,4,21,10,11,6,1
57256,1,0,0,0,10,0
190834,3,16,3,13,17,0
114044,2,14,0,14,17,0
51746,2,3,10,-7,7,0
178529,3,16,13,3,12,1
44733,2,7,12,-5,3,0
393409,3,28,17,11,5,0
285743,2,0,10,-10,8,1
304261,4,33,22,11,16,1
76850,4,33,7,26,1,0
338216,2,14,21,-7,14,0
215366,4,23,20,3,11,1
26171,3,0,26,-26,13,1
355411,2,10,10,0,4,1
155953,1,0,7,-7,2,1
33834,3,3,31,-28,16,0
368079,1,7,0,7,11,0
103163,1,0,0,0,13,0
368411,3,14,7,7,11,0
137273,4,7,20,-13,11,1
347692,4,27,24,3,1,1
246743,1,3,3,0,8,1
269678,3,10,3,7,1,0
258226,1,0,0,0,13,1
113970,4,20,20,0,17,0
139910,1,0,3,-3,12,1
343029,2,3,0,3,16,1
130394,4,7,6,1,8,0
19649,4,23,28,-5,10,1
203620,2,0,7,-7,6,1
65637,4,6,19,-13,13,1
259730,2,10,7,3,14,1
2432,3,21,13,8,2,1
324708,2,7,7,0,8,1
377549,2,7,9,-2,15,1
216574,4,40,11,29,12,1
224821,4,11,10,1,15,0
174670,2,9,7,2,10,1
208512,3,44,7,37,8,0
413947,1,3,7,-4,14,0
309933,1,0,0,0,2,1
420972,3,7,21,-14,17,1
229051,1,0,0,0,17,1
417919,4,16,10,6,16,0
168281,2,10,7,3,7,1
69957,1,21,0,21,15,0
60377,3,13,7,6,11,1
279409,3,13,24,-11,5,1
299354,4,28,16,12,14,1
378741,3,14,7,7,15,1
141382,3,10,17,-7,13,1
212323,3,10,3,7,10,1
92627,4,17,10,7,8,1
36484,2,3,6,-3,17,1
262758,3,28,3,25,15,0
42040,2,13,7,6,2,0
50772,4,21,21,0,6,1
234719,4,30,30,0,2,0
164672,4,21,27,-6,5,0
123352,3,21,14,7,4,0
202753,3,16,17,-1,5,0
167122,4,22,34,-12,7,1
178652,3,3,13,-10,12,1
355211,1,0,14,-14,4,1
52768,1,0,20,-20,7,1
66554,1,0,0,0,14,1
337084,4,26,0,26,14,1
332160,2,0,10,-10,12,0
301436,2,10,3,7,15,0
103034,1,0,0,0,13,1
401315,4,20,24,-4,8,1
301830,4,6,34,-28,15,1
323803,2,6,9,-3,8,1
28984,2,7,7,0,14,0
338507,2,17,14,3,14,1
169198,2,10,6,4,7,0
125720,1,0,7,-7,5,1
349798,4,29,29,0,2,1
183496,1,0,0,0,14,1
281158,2,14,13,1,6,1
172271,4,24,13,11,9,1
308243,3,10,13,-3,1,1
214878,2,0,12,-12,11,1
76115,4,13,30,-17,1,1
102565,1,2,0,2,13,1
98008,4,17,10,7,11,0
99490,3,3,10,-7,11,0
19597,3,17,21,-4,10,0
214883,2,0,12,-12,11,0
218472,3,24,17,7,13,1
141558,4,34,10,24,13,0
272786,4,15,16,-1,2,1
175910,4,23,27,-4,11,1
74663,2,0,10,-10,17,1
390674,2,3,3,0,3,1
346201,2,17,0,17,1,1
398284,1,3,0,3,7,0
370083,4,31,20,11,12,0
220315,4,26,9,17,13,1
379641,4,26,13,13,16,0
170456,3,21,3,18,8,0
326308,1,0,10,-10,9,1
100894,1,7,3,4,12,0
133406,1,0,7,-7,9,0
402886,3,17,6,11,9,1
340671,3,16,13,3,15,0
140203,4,13,10,3,12,0
368516,2,3,0,3,11,0
88034,3,24,3,21,6,1
63052,3,16,21,-5,12,0
176649,2,14,12,2,11,0
187041,1,3,0,3,16,1
213298,1,0,0,0,10,1
413361,1,0,6,-6,14,0
416999,1,0,0,0,15,0
402567,2,10,7,3,9,0
409677,2,10,6,4,12,0
33016,4,12,44,-32,15,0
43544,3,17,3,14,3,0
261751,4,14,7,7,14,1
167552,4,3,10,-7,7,0
243962,4,25,20,5,6,1
240571,1,3,0,3,5,1
39156,4,20,10,10,1,0
371735,2,14,14,0,12,1
287277,1,0,0,0,8,0
226900,3,3,10,-7,16,0
3583,2,20,14,6,2,0
99181,2,10,3,7,11,0
47659,2,3,17,-14,5,1
370551,1,7,0,7,12,0
5813,3,24,7,17,3,1
254000,2,0,6,-6,11,0
262152,3,21,6,15,15,1
159117,4,24,7,17,3,1
288793,1,3,7,-4,9,1
260065,2,3,7,-4,14,0
169214,3,10,6,4,7,1
260161,1,0,0,0,14,1
8818,4,26,0,26,4,0
298351,2,0,7,-7,14,0
33615,1,0,0,0,16,1
219862,4,45,0,45,13,1
94641,2,14,19,-5,9,1
189108,4,31,30,1,16,0
369113,2,6,7,-1,11,0
300434,1,8,0,8,14,1
270650,1,0,0,0,1,1
258568,2,7,0,7,13,0
188885,2,10,10,0,16,1
217906,4,17,28,-11,12,1
154838,1,3,0,3,1,0
300069,4,7,40,-33,14,1
392522,3,3,20,-17,4,0
219897,1,0,0,0,13,1
211836,3,22,10,12,9,0
222839,4,24,13,11,14,0
233500,4,26,10,16,2,0
262288,2,10,9,1,15,0
303570,2,14,6,8,16,1
198558,1,0,0,0,3,1
245226,1,3,0,3,7,0
219796,2,38,0,38,13,0
243491,4,10,30,-20,6,0
304921,2,7,3,4,16,1
212979,4,21,7,14,10,1
301499,3,20,12,8,15,0
294535,3,17,13,4,12,1
22422,2,17,24,-7,11,0
343922,2,7,0,7,17,1
134206,2,3,17,-14,10,0
211695,3,23,9,14,9,1
345427,3,0,13,-13,17,0
60133,4,27,19,8,11,0
100623,2,7,7,0,12,0
348227,3,9,17,-8,1,1
193266,3,3,17,-14,1,0
249384,3,10,15,-5,9,1
138337,3,27,0,27,11,0
277600,4,12,20,-8,4,0
276289,1,7,0,7,3,0
311130,4,13,13,0,2,0
49616,1,0,7,-7,6,1
327759,4,13,23,-10,10,1
148808,3,13,16,-3,16,0
77527,3,20,14,6,1,0
364212,1,0,0,0,9,0
365554,2,14,14,0,9,0
379486,4,23,3,20,16,1
232757,2,0,0,0,2,0
103668,3,0,10,-10,13,0
145043,3,13,6,7,14,1
121033,3,11,21,-10,3,0
323512,3,17,10,7,7,1
230304,3,19,10,9,17,1
233874,2,7,6,1,2,1
314276,1,0,0,0,3,1
307130,1,0,0,0,17,0
53001,4,27,24,3,7,1
295927,4,13,24,-11,12,1
26153,3,0,20,-20,13,1
274298,4,32,16,16,3,0
202491,4,9,16,-7,5,0
24350,2,3,0,3,12,1
240088,1,0,0,0,5,0
325857,4,13,20,-7,9,1
23631,2,7,13,-6,12,1
123410,4,28,27,1,4,0
189361,4,13,10,3,16,1
259791,4,20,13,7,14,0
338108,4,6,7,-1,14,0
65150,2,0,0,0,13,0
310568,1,3,13,-10,2,0
187086,2,10,0,10,16,1
211819,2,14,10,4,9,0
21045,4,21,34,-13,10,1
80591,1,0,7,-7,3,1
41074,4,3,16,-13,2,1
368872,3,24,3,21,11,1
86875,3,9,23,-14,5,0
207529,1,0,0,0,7,1
273475,2,7,13,-6,2,1
91188,3,10,17,-7,8,1
346817,2,10,3,7,1,0
367829,2,10,7,3,10,0
150283,2,14,7,7,16,0
87233,2,7,14,-7,6,1
128400,4,14,13,1,7,1
106457,3,16,0,16,14,0
254360,4,13,27,-14,11,0
119884,5,24,27,-3,3,0
396435,3,20,25,-5,6,1
189032,2,14,7,7,16,0
205459,2,14,0,14,6,0
264643,5,20,20,0,16,1
342322,4,20,6,14,16,0
318440,3,21,7,14,5,1
169296,1,0,0,0,8,1
403081,4,34,27,7,9,0
278278,1,7,0,7,4,0
292318,3,12,10,2,11,0
261824,2,6,10,-4,14,0
288597,4,23,38,-15,9,0
219419,4,33,34,-1,13,1
7669,4,34,10,24,4,0
85641,2,17,0,17,5,0
184270,3,31,7,24,14,0
355159,3,26,23,3,4,0
53219,2,3,0,3,8,0
152131,4,19,13,6,17,1
35762,2,3,0,3,17,0
59426,1,0,7,-7,11,0
20170,2,10,0,10,10,0
400421,4,24,10,14,8,0
316313,4,10,19,-9,4,1
1469,1,0,0,0,1,0
187635,1,0,3,-3,16,1
129613,4,13,23,-10,7,1
48605,4,21,24,-3,5,0
64680,1,14,0,14,13,1
349123,2,7,0,7,2,0
224025,3,14,6,8,15,1
184942,2,0,17,-17,15,1
293364,2,7,7,0,11,0
35754,2,3,0,3,17,1
361455,1,7,0,7,7,0
275648,3,27,3,24,3,1
343160,1,3,0,3,16,1
231180,3,10,7,3,1,0
174763,1,6,0,6,10,0
272918,4,20,20,0,2,0
276624,2,14,6,8,4,0
331709,2,0,13,-13,12,1
141446,1,0,0,0,13,0
59233,3,21,58,-37,10,1
76517,3,7,20,-13,1,1
221192,4,0,23,-23,14,1
95962,1,0,0,0,10,0
419527,4,10,23,-13,16,0
23796,3,17,0,17,12,0
71806,4,38,33,5,16,1
316827,4,16,10,6,4,1
374563,2,17,13,4,14,1
261760,4,21,7,14,14,0
171013,2,7,10,-3,8,1
385431,3,21,7,14,1,0
80370,3,20,9,11,2,1
320937,4,13,21,-8,6,0
226743,3,7,13,-6,16,0
194515,4,26,10,16,2,1
31020,2,3,6,-3,15,1
415274,2,0,0,0,15,0
359926,4,23,30,-7,6,1
314992,1,6,0,6,4,1
17975,2,13,21,-8,9,1
78052,4,12,23,-11,1,1
206385,2,3,0,3,7,1
377950,1,0,0,0,15,0
390626,1,0,0,0,3,1
14071,4,3,24,-21,7,0
173760,2,10,3,7,10,0
198706,4,15,27,-12,3,0
141355,2,3,17,-14,13,1
279589,4,10,16,-6,5,0
26314,4,19,21,-2,13,1
193057,1,0,0,0,1,1
269854,4,22,10,12,1,1
300312,2,0,7,-7,14,0
162204,2,10,20,-10,4,1
405181,4,12,16,-4,10,1
331390,1,3,6,-3,11,0
31880,1,6,0,6,15,1
187513,2,3,10,-7,16,1
115473,4,39,28,11,1,1
317145,1,0,0,0,5,0
117164,2,6,3,3,2,1
244469,1,0,3,-3,7,1
126190,2,14,6,8,6,1
244234,3,16,7,9,6,0
340686,4,16,20,-4,15,1
310023,3,9,10,-1,2,1
177917,4,21,23,-2,12,1
29793,4,48,3,45,14,1
412307,2,7,7,0,13,1
65030,3,0,17,-17,13,1
41786,3,10,14,-4,2,0
34136,3,10,3,7,16,0
254167,3,3,12,-9,11,0
305098,2,21,10,11,16,0
160126,1,7,0,7,3,0
59472,2,3,17,-14,11,1
141401,3,10,17,-7,13,0
124215,1,0,14,-14,5,1
152788,3,7,7,0,17,0
155293,4,28,27,1,1,0
78999,2,3,7,-4,2,1
298725,4,19,21,-2,14,1
265720,1,0,0,0,16,1
298408,3,7,14,-7,14,0
199037,1,0,7,-7,4,0
320270,2,14,7,7,6,0
225670,4,14,10,4,16,1
247508,1,3,0,3,8,0
170658,1,0,0,0,8,0
245984,1,0,0,0,7,0
24581,4,10,23,-13,12,1
351097,4,29,23,6,3,0
205269,1,0,0,0,6,1
348329,1,7,7,0,1,1
23897,2,3,0,3,12,1
105759,4,37,10,27,14,0
379521,1,0,0,0,16,0
196291,4,21,10,11,2,0
319262,1,0,3,-3,6,1
148882,1,3,6,-3,16,0
405396,2,7,10,-3,10,1
239826,2,0,0,0,4,1
240736,2,0,7,-7,5,0
268274,2,10,0,10,17,0
329135,4,27,7,20,10,1
63246,1,0,0,0,12,0
381016,1,0,0,0,16,0
206938,4,24,23,1,7,0
326335,2,0,10,-10,9,0
421436,4,31,20,11,17,0
358477,4,38,27,11,6,0
294963,3,17,7,10,12,0
381287,4,31,20,11,16,0
111717,4,37,16,21,16,0
45542,1,0,0,0,4,0
134897,2,7,13,-6,10,0
292804,4,29,17,12,11,1
255848,4,17,0,17,12,1
204800,4,28,24,4,6,1
256839,1,0,0,0,12,0
414479,4,16,23,-7,14,0
74841,3,20,13,7,17,0
9994,4,3,3,0,5,0
23603,2,7,7,0,12,1
255865,4,20,7,13,12,0
421493,2,0,3,-3,17,1
179423,3,6,13,-7,12,0
342547,2,3,6,-3,16,0
212680,4,9,31,-22,10,1
155116,4,19,33,-14,1,0
389573,1,6,0,6,3,1
185648,4,20,27,-7,15,0
388677,4,20,7,13,3,1
328597,2,10,14,-4,10,1
306637,3,14,27,-13,17,1
32744,4,7,24,-17,15,0
38609,1,0,0,0,1,0
11577,4,13,16,-3,6,1
53526,2,7,6,1,8,1
48445,3,17,17,0,5,0
127848,4,23,42,-19,6,1
146023,1,10,0,10,15,0
250574,1,0,0,0,10,0
417353,2,10,3,7,16,0
103752,1,0,0,0,13,1
417674,3,28,6,22,16,0
156640,2,3,0,3,2,0
366459,4,34,10,24,10,1
176140,2,14,7,7,11,1
72167,2,3,3,0,16,0
264902,2,17,14,3,16,0
130197,3,0,19,-19,8,1
277715,2,7,3,4,4,1
190026,1,7,0,7,17,1
404703,1,0,0,0,10,1
121926,1,0,7,-7,4,1
159141,4,31,7,24,3,1
256135,3,21,16,5,12,0
239479,4,21,24,-3,4,1
331424,2,6,7,-1,11,1
14993,1,0,7,-7,7,0
161152,3,3,33,-30,4,1
193845,2,23,0,23,1,1
171557,1,0,0,0,9,0
386672,3,17,13,4,2,1
344240,2,7,10,-3,17,0
34949,4,27,27,0,16,1
132350,1,0,0,0,9,0
101954,4,9,13,-4,12,1
71190,3,19,10,9,16,0
380003,1,7,0,7,16,0
54253,4,0,3,-3,8,1
132028,4,3,24,-21,8,0
187101,3,10,0,10,16,0
101959,1,0,0,0,12,1
324244,2,3,0,3,8,1
209863,2,13,16,-3,8,1
299811,1,0,0,0,14,1
191999,3,17,20,-3,1,0
381028,1,7,3,4,16,0
238172,2,3,16,-13,4,1
151751,2,7,6,1,17,0
350145,1,0,0,0,2,0
174810,2,13,17,-4,10,0
154563,2,7,7,0,1,1
199281,4,17,38,-21,4,1
110884,2,7,0,7,16,0
37450,1,0,7,-7,17,1
414708,3,3,17,-14,14,0
116341,4,40,13,27,1,0
16250,3,6,10,-4,8,1
258637,4,13,13,0,13,1
323247,3,7,10,-3,7,1
252517,3,17,25,-8,10,1
140784,4,22,24,-2,12,0
200678,4,41,28,13,4,0
275515,4,26,30,-4,3,0
277258,3,0,13,-13,4,0
319466,2,0,10,-10,6,1
52484,2,3,0,3,7,0
323383,3,17,0,17,7,1
140767,3,15,21,-6,12,0
186379,4,36,31,5,15,1
175029,4,20,28,-8,10,0
176266,1,0,6,-6,11,0
73464,1,0,14,-14,17,1
386469,1,0,0,0,2,1
226396,1,0,6,-6,16,0
276591,1,7,0,7,4,0
252607,2,3,3,0,10,0
45274,2,0,0,0,4,0
234405,1,0,0,0,2,1
181996,2,14,7,7,13,0
125122,2,7,7,0,5,1
58494,1,0,0,0,10,0
152430,4,38,3,35,17,0
15664,3,34,10,24,8,0
192592,1,3,7,-4,1,1
133932,3,6,6,0,9,0
360411,1,0,0,0,7,0
224492,3,12,10,2,15,1
147849,2,3,14,-11,15,0
188673,1,0,7,-7,16,0
143905,1,0,0,0,14,0
294688,3,6,14,-8,12,1
147609,4,15,0,15,15,1
338454,1,0,0,0,14,1
169223,3,10,6,4,7,1
9321,2,21,7,14,5,0
78676,1,7,0,7,2,1
81806,1,0,7,-7,3,1
103793,2,6,0,6,13,0
177674,2,10,7,3,12,1
138548,5,31,37,-6,12,0
244594,4,32,30,2,7,0
237945,1,0,0,0,4,1
114984,3,13,12,1,1,0
212105,1,3,7,-4,10,0
227040,3,10,6,4,16,1
51593,2,7,10,-3,7,1
160660,2,10,0,10,4,1
336324,4,20,10,10,13,0
11750,4,33,31,2,6,0
229867,3,13,7,6,17,0
342813,1,0,0,0,16,1
330154,4,0,16,-16,11,1
5956,3,17,23,-6,3,1
349439,2,0,20,-20,2,0
352033,4,31,21,10,3,0
290294,4,17,15,2,10,1
289258,1,7,7,0,9,0
149653,1,14,0,14,16,0
77612,1,0,7,-7,1,1
239923,4,13,9,4,4,0
149484,1,0,6,-6,16,1
375023,3,21,27,-6,14,0
86159,3,31,10,21,5,0
96420,1,0,14,-14,10,1
318873,3,21,15,6,5,1
5645,2,0,14,-14,3,0
219187,2,0,3,-3,13,1
257326,2,17,0,17,13,0
414280,3,21,27,-6,14,0
43794,2,14,13,1,3,1
280629,4,23,9,14,5,0
286079,2,10,3,7,8,0
185710,2,17,3,14,15,0
35561,1,7,0,7,17,1
140556,1,7,7,0,12,0
356537,4,9,6,3,5,0
155610,4,30,17,13,2,0
98794,4,34,8,26,11,0
319949,2,23,10,13,6,1
304161,1,0,0,0,16,1
209,2,6,10,-4,1,1
157049,1,0,0,0,2,0
106059,4,24,3,21,14,0
90365,4,20,32,-12,7,0
316722,1,7,0,7,4,1
396886,3,27,13,14,6,0
120599,3,3,20,-17,3,0
244726,4,24,26,-2,7,0
271906,3,10,13,-3,2,1
394471,3,7,18,-11,5,1
351695,3,14,17,-3,3,0
40201,4,34,7,27,2,0
107480,3,3,17,-14,15,1
186025,2,17,34,-17,15,0
320506,4,26,24,2,6,0
129563,3,6,17,-11,7,1
71568,1,3,7,-4,16,0
408832,4,16,28,-12,12,0
211170,2,0,10,-10,9,1
241197,1,0,0,0,5,1
56477,4,7,41,-34,9,0
230160,3,3,26,-23,17,1
190841,3,16,3,13,17,0
226584,2,3,3,0,16,1
226299,3,16,7,9,16,1
307222,4,3,10,-7,17,1
195225,3,16,10,6,2,1
388467,2,3,13,-10,2,0
198493,3,17,3,14,3,0
402905,4,17,9,8,9,0
398555,4,30,23,7,7,1
394762,2,21,0,21,5,0
244423,4,3,20,-17,7,1
56489,4,7,41,-34,9,0
269707,4,10,21,-11,1,1
332211,4,10,16,-6,12,0
26207,1,0,0,0,13,0
197257,2,0,0,0,3,1
158047,2,9,6,3,3,0
113477,3,3,7,-4,17,1
240412,1,0,0,0,5,1
101881,2,6,10,-4,12,0
263565,1,0,0,0,15,0
232141,1,3,0,3,1,0
294068,3,7,21,-14,12,1
314879,2,0,0,0,4,1
225264,4,17,7,10,15,1
269006,1,0,3,-3,17,1
394264,1,0,0,0,5,1
176556,4,19,17,2,11,1
23678,4,7,27,-20,12,1
133560,1,0,0,0,9,1
212823,4,17,21,-4,10,1
300555,1,0,0,0,15,0
66797,3,10,6,4,14,0
114607,2,3,3,0,1,1
143032,1,0,7,-7,13,1
343040,2,6,0,6,16,0
269361,2,7,14,-7,1,0
407388,2,0,7,-7,11,1
368333,4,18,19,-1,11,1
75678,1,0,0,0,1,1
200252,2,3,0,3,4,0
108466,1,0,0,0,15,0
29196,4,3,26,-23,14,0
295710,3,3,9,-6,12,1
24085,3,7,7,0,12,0
399666,3,16,9,7,8,1
118760,1,7,0,7,2,0
185484,4,24,20,4,15,1
117403,4,34,10,24,2,0
367852,3,13,10,3,10,1
310954,4,3,23,-20,2,0
157224,2,7,0,7,2,0
239112,2,10,10,0,4,1
97730,4,9,13,-4,11,1
356800,2,0,0,0,5,0
358435,3,29,20,9,6,1
65898,2,7,14,-7,13,1
407284,3,17,16,1,11,1
336561,2,0,0,0,14,1
39167,4,27,10,17,1,0
337763,2,20,6,14,14,0
330477,1,0,7,-7,11,1
105383,3,23,7,16,14,0
138160,2,7,9,-2,11,0
179109,2,9,6,3,12,0
216028,2,10,12,-2,11,1
22413,2,10,24,-14,11,0
385952,3,17,21,-4,1,1
274581,3,24,23,1,3,0
163916,3,23,10,13,5,0
372849,1,0,0,0,13,1
419305,2,0,16,-16,16,0
286823,1,3,7,-4,8,0
241954,1,7,0,7,5,0
365743,3,17,10,7,9,0
58985,1,0,7,-7,10,1
137372,2,3,14,-11,11,1
179528,2,0,16,-16,12,1
5329,1,7,0,7,3,0
298655,2,6,0,6,14,0
286742,3,20,14,6,8,1
401858,3,14,21,-7,9,0
351758,1,7,14,-7,3,1
99092,4,23,0,23,11,1
380110,4,35,30,5,16,1
408577,1,7,0,7,12,1
24758,4,20,34,-14,12,1
217109,2,0,7,-7,12,0
320164,4,17,17,0,6,0
135044,2,14,3,11,10,1
120670,1,3,0,3,3,0
87636,1,0,0,0,6,1
144470,4,10,33,-23,14,1
239253,2,0,7,-7,4,0
114498,2,17,20,-3,1,1
93964,1,0,7,-7,9,1
49432,5,20,20,0,6,1
380500,2,0,14,-14,16,1
234731,4,36,33,3,2,1
295913,3,13,17,-4,12,0
67028,2,7,0,7,14,0
15507,3,16,6,10,8,1
313865,2,14,13,1,3,1
309838,2,14,7,7,1,0
82377,4,13,10,3,3,0
59851,5,15,16,-1,11,1
404476,2,14,13,1,10,0
342956,4,37,17,20,16,0
229960,1,0,3,-3,17,1
93875,2,14,3,11,9,1
155544,3,23,3,20,2,0
360227,4,20,13,7,7,0
332544,1,0,3,-3,12,1
117156,1,6,3,3,2,0
97616,1,3,0,3,11,0
232725,1,0,0,0,2,0
403293,2,6,0,6,9,1
32507,2,14,3,11,15,0
17251,3,7,34,-27,9,0
197006,3,20,17,3,3,0
268857,1,0,10,-10,17,1
405001,4,9,20,-11,10,0
104183,4,27,34,-7,13,1
226965,1,3,0,3,16,0
236956,3,36,7,29,3,1
304032,2,3,13,-10,16,0
249899,3,12,20,-8,9,0
3731,2,10,3,7,2,1
151860,1,3,0,3,17,1
220726,4,13,6,7,13,0
26319,4,19,21,-2,13,0
96909,3,19,7,12,10,0
262750,3,21,0,21,15,0
288665,2,0,7,-7,9,1
283400,2,13,7,6,7,0
153701,2,2,14,-12,1,0
79528,1,0,0,0,2,0
386661,3,14,13,1,2,0
21939,1,7,0,7,11,0
196326,1,0,0,0,2,1
395730,4,26,37,-11,6,0
191358,2,0,17,-17,17,1
67000,1,0,0,0,14,0
404168,2,9,7,2,10,0
120909,4,21,31,-10,3,1
49963,2,21,0,21,6,1
368149,3,13,14,-1,11,1
361160,1,0,0,0,7,1
263060,3,10,6,4,15,1
160620,2,7,0,7,4,1
126936,1,3,0,3,6,0
258279,2,14,12,2,13,1
214895,3,7,12,-5,11,0
272846,2,20,0,20,2,1
6621,1,0,0,0,3,0
1487,1,0,6,-6,1,1
63109,1,7,3,4,12,0
306755,3,16,20,-4,17,0
288977,2,16,7,9,9,1
160992,3,10,7,3,4,0
74096,3,16,0,16,17,1
106169,3,0,7,-7,14,1
72404,4,17,23,-6,16,1
160577,4,23,20,3,4,1
116214,4,25,19,6,1,0
174512,2,7,7,0,10,1
132267,2,21,7,14,9,1
190194,1,0,0,0,17,1
357821,2,3,14,-11,6,1
40374,4,12,10,2,2,1
85884,1,0,7,-7,5,1
295270,3,14,5,9,12,1
101648,1,3,0,3,12,0
232239,4,15,12,3,1,1
52010,2,3,7,-4,7,0
303391,1,7,0,7,16,1
200766,3,31,3,28,4,0
163416,2,6,13,-7,5,1
240221,4,16,12,4,5,1
61839,3,6,20,-14,12,1
201351,3,28,13,15,5,0
238074,4,13,13,0,4,0
232437,1,3,0,3,1,1
283244,2,10,0,10,7,0
325751,2,0,7,-7,9,0
255580,4,30,7,23,12,0
408988,4,31,31,0,12,1
169239,3,17,6,11,7,1
170574,2,21,6,15,8,1
395000,1,0,7,-7,5,0
76250,4,12,27,-15,1,0
387960,1,3,0,3,2,0
27934,3,14,10,4,13,1
311437,1,0,3,-3,2,1
313326,3,13,24,-11,3,0
228651,2,13,14,-1,17,1
208655,3,6,6,0,8,1
419669,4,33,23,10,17,1
190364,2,7,0,7,17,1
344344,1,7,0,7,17,1
356007,2,14,10,4,5,1
148103,1,0,0,0,16,1
322934,3,13,0,13,7,1
124257,2,10,17,-7,5,0
253822,1,7,7,0,11,1
237259,4,23,0,23,3,0
88328,3,14,7,7,6,1
402586,3,10,10,0,9,0
189061,3,14,17,-3,16,1
297499,2,5,0,5,13,0
189842,4,27,17,10,17,0
52476,1,3,0,3,7,0
341472,1,0,6,-6,16,0
267271,3,17,14,3,17,0
264612,4,12,17,-5,16,0
207130,2,7,7,0,7,1
258480,4,21,21,0,13,0
34316,4,20,9,11,16,1
354757,2,6,9,-3,4,1
242276,1,7,7,0,6,0
273547,4,27,35,-8,2,1
395789,2,0,7,-7,6,0
264404,2,3,21,-18,15,1
309966,2,3,3,0,2,1
336191,4,24,10,14,13,0
418605,3,14,17,-3,16,1
323966,2,17,10,7,8,0
245702,2,3,10,-7,7,1
114092,3,21,7,14,17,1
95730,4,13,9,4,10,1
215998,1,0,0,0,11,0
23130,1,0,0,0,11,0
357468,4,31,33,-2,5,0
420808,3,3,10,-7,17,1
337681,4,24,13,11,14,1
320956,1,0,0,0,6,1
387145,3,10,34,-24,2,0
336886,2,7,14,-7,14,0
88715,1,0,0,0,6,1
86901,4,17,26,-9,5,0
78737,3,13,7,6,2,0
63818,4,14,34,-20,12,1
88972,3,36,10,26,6,1
101346,1,6,0,6,12,0
11394,3,23,0,23,6,1
279896,4,24,13,11,5,0
87756,4,6,20,-14,6,0
419388,1,0,0,0,16,0
205412,4,27,0,27,6,1
113127,2,21,0,21,17,1
124263,2,17,17,0,5,1
287790,2,21,10,11,9,1
233785,3,13,37,-24,2,0
190070,2,17,3,14,17,0
26674,1,0,6,-6,13,0
292681,4,22,16,6,11,0
88446,2,7,0,7,6,0
395265,4,10,13,-3,5,0
235975,1,7,0,7,3,1
362309,1,0,7,-7,8,1
28566,4,33,7,26,14,1
129112,3,27,28,-1,7,1
308103,2,13,13,0,1,0
73755,2,3,0,3,17,0
298893,4,21,23,-2,14,1
337005,2,10,0,10,14,1
207612,3,35,10,25,7,1
265535,4,14,13,1,16,1
403055,4,24,24,0,9,1
366194,4,7,51,-44,10,1
342460,4,20,3,17,16,0
379309,2,0,6,-6,16,1
18689,1,0,7,-7,9,1
243857,1,6,0,6,6,0
22893,3,0,13,-13,11,1
17702,3,14,6,8,9,1
287916,2,7,10,-3,9,1
223261,3,3,9,-6,15,0
98725,2,21,3,18,11,1
9586,1,3,6,-3,5,0
230785,4,9,27,-18,1,1
273942,3,7,9,-2,2,1
193393,2,7,17,-10,1,1
191519,2,14,14,0,17,0
258119,2,13,13,0,13,1
376194,2,7,7,0,14,1
304122,4,16,30,-14,16,1
351089,3,21,23,-2,3,1
390649,2,0,3,-3,3,1
400690,3,16,7,9,8,0
306014,2,3,10,-7,17,1
130365,3,7,3,4,8,1
15655,3,21,10,11,8,1
54777,2,10,0,10,8,1
292348,3,12,13,-1,11,0
409534,3,7,3,4,12,1
297095,3,24,0,24,13,0
319428,1,0,0,0,6,1
332503,4,23,9,14,12,0
287498,3,14,20,-6,9,0
267383,2,0,7,-7,17,0
57756,2,16,3,13,10,1
79241,1,0,0,0,2,1
356825,3,0,13,-13,5,1
55204,1,7,0,7,9,1
9112,4,30,19,11,4,0
334635,1,0,0,0,13,1
17641,1,7,3,4,9,1
13589,2,3,7,-4,7,0
92372,1,7,0,7,8,1
76620,2,7,0,7,1,1
162709,4,26,24,2,5,0
190641,2,14,7,7,17,0
183392,2,17,3,14,14,0
220502,1,0,14,-14,13,1
61822,2,3,17,-14,12,0
188143,3,10,10,0,16,1
22506,4,31,29,2,11,0
324951,1,0,7,-7,8,0
390881,4,15,28,-13,3,1
183493,1,0,0,0,14,1
84709,2,3,7,-4,4,1
15706,1,0,0,0,8,1
361270,4,21,29,-8,7,0
372701,1,0,0,0,13,0
264284,3,10,23,-13,15,1
294917,1,0,7,-7,12,1
190789,2,13,3,10,17,0
131486,1,0,3,-3,8,1
99235,4,31,20,11,11,0
239840,2,7,0,7,4,0
64125,1,0,0,0,13,1
8918,3,21,0,21,4,1
18329,3,22,17,5,9,1
351198,2,14,3,11,3,1
102051,3,21,10,11,12,1
61721,3,24,24,0,12,0
145426,2,3,14,-11,14,1
279841,3,14,13,1,5,1
389973,3,28,25,3,3,1
313565,2,3,17,-14,3,1
380269,4,29,16,13,16,0
323128,4,29,14,15,7,0
204176,4,24,17,7,6,0
417186,2,3,17,-14,16,0
124096,2,3,21,-18,5,0
327308,4,16,20,-4,9,1
393076,2,7,3,4,4,0
219959,3,6,14,-8,13,0
413135,3,33,35,-2,14,1
87561,2,17,3,14,6,1
300601,2,10,0,10,15,0
337896,2,10,0,10,14,0
306079,4,17,13,4,17,1
22484,3,31,29,2,11,1
415659,4,36,20,16,15,1
162398,4,13,20,-7,4,0
73526,3,3,38,-35,17,1
161642,4,36,16,20,4,1
311264,4,6,3,3,2,1
222667,3,14,24,-10,14,1
389930,2,18,10,8,3,0
328945,3,9,7,2,10,0
130179,2,0,19,-19,8,0
242885,2,14,13,1,6,1
396935,4,34,33,1,6,1
342165,4,15,19,-4,16,1
196932,1,6,0,6,3,1
163237,1,3,3,0,5,1
289368,4,31,25,6,9,1
358551,2,10,3,7,6,1
210102,1,0,0,0,9,1
198379,4,20,14,6,3,1
90049,4,18,21,-3,7,0
382971,3,3,13,-10,17,1
259312,3,13,13,0,13,0
55633,1,7,7,0,9,1
117849,4,9,13,-4,2,0
161855,1,13,0,13,4,0
377234,2,7,0,7,15,0
123711,4,10,32,-22,4,1
362748,1,0,0,0,8,0
105428,4,23,24,-1,14,0
374668,1,0,0,0,14,0
411981,4,20,17,3,13,0
334780,4,32,11,21,13,0
64747,3,28,6,22,13,0
226107,2,7,14,-7,16,0
226757,3,7,20,-13,16,1
134210,3,3,17,-14,10,0
292606,2,9,16,-7,11,0
313092,1,0,0,0,3,0
287681,4,9,13,-4,9,1
210030,3,7,10,-3,8,1
246369,3,20,10,10,7,0
86502,1,7,0,7,5,0
306933,4,6,30,-24,17,0
326410,4,20,17,3,9,1
92208,1,0,0,0,8,0
155192,2,13,7,6,1,1
171814,3,23,17,6,9,1
171682,4,19,23,-4,9,1
411949,3,17,10,7,13,0
415177,3,10,24,-14,15,0
29147,3,0,19,-19,14,0
238595,1,0,0,0,4,1
409043,1,3,7,-4,12,1
108352,2,0,14,-14,15,1
123381,4,21,24,-3,4,0
169282,4,23,6,17,7,0
23808,3,17,7,10,12,1
146892,4,31,0,31,15,1
261016,4,10,3,7,14,0
50411,2,7,7,0,6,1
361316,1,0,0,0,7,1
127675,4,30,20,10,6,0
179655,5,31,30,1,12,1
50992,2,0,7,-7,6,1
400926,2,13,7,6,8,0
365586,2,35,14,21,9,0
101995,2,7,0,7,12,0
126581,4,16,13,3,6,0
64676,1,14,0,14,13,0
202645,4,27,20,7,5,1
215160,2,7,6,1,11,0
243328,4,14,17,-3,6,0
372185,3,9,13,-4,13,0
244486,2,13,3,10,7,0
387298,4,6,10,-4,2,0
265878,2,0,9,-9,16,0
179003,4,19,3,16,12,1
222478,2,6,14,-8,14,1
188417,3,3,3,0,16,1
259206,4,14,32,-18,13,1
336648,5,7,7,0,14,1
58497,1,0,0,0,10,0
260922,2,0,0,0,14,0
189391,4,27,24,3,16,0
342661,1,0,0,0,16,0
189405,1,0,0,0,17,1
107060,2,24,0,24,15,1
161179,4,3,33,-30,4,0
288311,1,0,0,0,9,0
383019,4,10,24,-14,17,0
408022,2,3,6,-3,12,0
141325,2,3,7,-4,13,0
411244,4,11,26,-15,13,1
361828,3,37,10,27,7,1
119761,2,10,3,7,3,0
5285,4,24,31,-7,3,1
274389,2,3,10,-7,3,0
276005,1,3,0,3,3,0
232250,4,15,12,3,1,1
186731,1,7,0,7,15,0
398165,1,7,3,4,7,0
243383,1,3,7,-4,6,0
348324,1,7,7,0,1,1
350071,4,27,13,14,2,0
248118,1,0,3,-3,8,1
162148,1,0,0,0,4,1
75102,2,7,6,1,17,1
232726,1,0,0,0,2,0
103626,2,0,7,-7,13,1
264249,2,10,10,0,15,1
391133,2,7,24,-17,4,1
278825,3,14,21,-7,5,0
39112,2,13,7,6,1,0
396034,4,38,20,18,6,0
152609,1,0,3,-3,17,0
223632,1,6,3,3,15,1
50676,1,0,0,0,6,0
6165,4,7,27,-20,3,1
378006,2,0,7,-7,15,1
189993,4,16,7,9,17,0
34053,1,0,0,0,16,1
174439,5,17,17,0,10,0
273179,3,24,0,24,2,0
149142,4,17,31,-14,16,1
48147,3,10,13,-3,5,1
297396,3,9,24,-15,13,1
54718,1,0,0,0,8,1
333635,1,0,0,0,12,0
385676,5,27,24,3,1,0
30309,3,3,10,-7,14,0
116530,1,0,0,0,2,1
367431,3,20,14,6,10,0
276424,4,32,44,-12,3,0
174477,1,7,7,0,10,1
141118,1,0,0,0,13,0
86452,3,27,14,13,5,1
192084,1,0,0,0,1,0
195032,2,7,10,-3,2,0
102045,3,21,3,18,12,0
353672,2,3,0,3,4,0
69459,3,24,10,14,15,0
399065,3,10,19,-9,7,1
77214,2,6,0,6,1,1
133885,2,3,6,-3,9,0
315581,4,7,14,-7,4,0
109319,4,13,3,10,15,1
241383,2,7,14,-7,5,1
178767,1,21,7,14,12,0
323503,2,10,10,0,7,1
266671,3,29,3,26,16,0
332238,4,10,16,-6,12,0
126505,2,0,6,-6,6,1
374306,3,14,13,1,13,1
185019,4,14,32,-18,15,0
149346,1,3,0,3,16,0
25764,4,17,17,0,12,1
58102,2,10,10,0,10,1
81723,3,17,17,0,3,0
313005,3,10,0,10,3,0
53863,2,6,0,6,8,1
188384,2,3,0,3,16,0
124261,2,17,17,0,5,1
4821,4,27,3,24,3,1
88560,1,0,0,0,6,0
291516,1,3,0,3,11,0
402063,1,0,0,0,9,0
191883,4,29,10,19,1,0
189673,4,17,6,11,17,1
160193,3,30,7,23,3,0
45312,3,10,10,0,4,0
17988,3,16,21,-5,9,0
412772,2,14,10,4,14,0
80019,2,7,3,4,2,0
342762,3,7,14,-7,16,0
333880,4,28,28,0,12,1
322901,2,6,0,6,7,1
224747,2,5,0,5,15,0
270834,2,6,7,-1,1,1
16800,3,6,24,-18,8,1
81354,2,0,7,-7,3,1
324849,2,3,10,-7,8,1
11737,4,30,24,6,6,1
161624,3,30,16,14,4,1
197373,4,30,17,13,3,0
143198,2,7,3,4,13,0
266817,4,10,14,-4,16,1
183509,1,7,3,4,14,0
228035,2,3,0,3,17,0
205446,1,7,0,7,6,1
16485,2,13,7,6,8,1
83748,4,25,23,2,4,1
139435,3,24,3,21,12,0
208302,2,7,21,-14,8,1
219801,2,38,0,38,13,0
115483,4,46,28,18,1,0
380594,4,21,27,-6,16,1
122443,3,6,26,-20,4,1
342512,1,0,0,0,16,0
367972,2,3,14,-11,11,1
371083,4,13,26,-13,12,0
219641,2,10,6,4,13,0
278142,2,7,7,0,4,0
349437,2,0,14,-14,2,0
31353,3,7,3,4,15,1
348993,2,14,7,7,2,1
282375,3,10,13,-3,6,0
94044,3,6,21,-15,9,0
214386,2,0,7,-7,11,1
325469,3,16,3,13,8,1
359339,3,3,13,-10,6,0
260015,1,0,0,0,14,0
215653,3,14,6,8,11,1
108092,3,13,28,-15,15,1
47981,2,3,24,-21,5,1
27721,1,0,0,0,13,1
288004,4,20,22,-2,9,0
244128,4,20,34,-14,6,1
234891,4,3,19,-16,2,1
229462,4,13,9,4,17,1
80317,2,7,6,1,2,0
380475,1,0,7,-7,16,1
139819,2,10,10,0,12,0
62357,1,0,0,0,12,0
154587,2,14,7,7,1,1
19410,2,14,7,7,10,0
77573,4,27,14,13,1,0
259993,4,23,20,3,14,1
255193,2,7,7,0,12,1
306932,3,6,30,-24,17,0
21002,3,14,24,-10,10,0
89127,4,23,6,17,6,1
274950,4,17,19,-2,3,1
294234,3,13,14,-1,12,0
346294,4,47,3,44,1,0
382889,1,0,0,0,17,0
2083,2,0,7,-7,1,1
323672,3,20,0,20,8,0
362397,4,30,20,10,8,1
380765,2,3,7,-4,16,0
335398,1,0,3,-3,13,1
162524,3,34,10,24,4,1
402857,2,10,3,7,9,1
93680,1,0,0,0,9,0
14707,1,7,0,7,7,0
411976,4,20,17,3,13,0
20805,2,14,0,14,10,0
147086,2,7,24,-17,15,1
99952,3,10,16,-6,12,1
224907,2,0,6,-6,15,0
71822,1,0,0,0,16,1
72555,4,19,30,-11,16,0
56242,2,3,7,-4,9,1
252398,4,13,29,-16,10,0
242756,2,13,17,-4,6,1
86408,2,20,7,13,5,0
194588,2,21,0,21,2,0
7289,4,17,13,4,4,1
136643,4,15,19,-4,11,1
382396,2,0,21,-21,17,1
188274,3,14,10,4,16,0
208329,2,14,24,-10,8,0
420442,2,0,14,-14,17,1
275101,1,7,0,7,3,0
219647,2,10,7,3,13,1
358166,3,17,9,8,6,1
218417,2,10,14,-4,13,0
264951,3,23,17,6,16,0
28167,1,3,0,3,13,0
246831,4,10,20,-10,8,1
354911,1,0,0,0,4,1
378534,1,7,6,1,15,1
288622,4,23,41,-18,9,0
129458,4,23,23,0,7,0
162988,3,6,3,3,5,0
406402,3,17,7,10,11,1
367132,2,29,13,16,10,0
88780,3,13,10,3,6,1
314616,2,7,0,7,3,1
236429,1,0,0,0,3,0
97732,4,9,13,-4,11,1
253402,2,14,28,-14,11,1
299073,1,3,0,3,14,0
233693,2,7,14,-7,2,0
340551,4,7,42,-35,15,0
87427,3,17,7,10,6,1
114962,2,7,6,1,1,1
358955,1,0,0,0,6,1
348692,2,10,10,0,2,1
23216,3,23,13,10,11,1
320347,1,0,0,0,6,1
157873,2,6,12,-6,3,0
6228,2,13,0,13,3,0
384611,3,10,49,-39,1,0
282232,2,9,7,2,6,1
237232,3,13,0,13,3,1
115680,2,3,3,0,1,1
186035,3,24,34,-10,15,0
375358,3,14,17,-3,14,0
46308,2,3,14,-11,4,0
69089,1,0,7,-7,15,1
296601,2,3,0,3,13,0
334620,4,38,31,7,13,0
195414,4,24,3,21,2,1
168452,3,0,24,-24,7,0
366145,3,7,35,-28,10,1
379298,2,0,3,-3,16,0
305062,1,20,7,13,16,1
283874,2,14,10,4,7,0
38097,3,6,6,0,1,0
81964,1,0,0,0,3,1
393177,1,0,3,-3,5,1
100408,4,9,20,-11,12,1
49555,4,14,3,11,6,1
327214,1,0,3,-3,9,1
217864,2,10,21,-11,12,1
272569,3,13,3,10,2,1
348193,2,6,10,-4,1,1
388815,4,14,14,0,3,1
410991,1,7,7,0,13,1
259361,4,28,34,-6,13,0
272002,1,0,0,0,2,0
255666,3,3,7,-4,12,1
279318,4,29,23,6,5,0
17271,4,21,34,-13,9,0
27223,3,19,7,12,13,1
358367,1,9,7,2,6,0
39076,1,6,0,6,1,1
350192,3,19,0,19,2,1
80782,2,3,0,3,3,0
394231,4,40,25,15,5,0
399969,4,12,13,-1,8,0
378840,2,7,3,4,15,0
397034,3,21,9,12,6,1
245484,4,23,6,17,7,0
229870,3,13,7,6,17,0
267856,3,26,17,9,17,1
196042,1,0,14,-14,2,1
254542,1,0,0,0,11,1
356720,4,19,16,3,5,1
236871,1,6,0,6,3,0
37846,4,14,9,5,1,1
267139,3,10,10,0,17,0
114718,4,15,10,5,1,1
292528,4,10,19,-9,11,1
87487,1,0,0,0,6,0
53245,2,3,0,3,8,0
228736,4,26,33,-7,17,1
253904,3,38,14,24,11,1
264483,4,27,35,-8,15,0
183494,1,0,0,0,14,1
202837,1,7,0,7,5,0
228806,2,6,14,-8,17,1
305310,4,42,21,21,16,1
153102,2,6,10,-4,1,0
124963,2,0,3,-3,5,1
45490,3,27,20,7,4,0
60044,2,7,3,4,11,1
102533,4,31,10,21,13,0
247999,2,21,3,18,8,1
49252,4,17,10,7,6,0
214267,2,14,10,4,11,1
224968,4,10,16,-6,15,0
39005,4,30,17,13,1,1
45092,1,0,0,0,4,1
120171,4,19,6,13,3,1
372376,4,24,17,7,13,0
165545,3,3,28,-25,6,1
76123,1,0,0,0,1,0
265883,2,0,9,-9,16,1
93643,4,23,6,17,9,0
121340,2,7,0,7,3,0
97369,2,9,12,-3,10,0
130501,3,10,3,7,8,0
168849,2,14,0,14,7,0
185106,3,0,13,-13,15,0
324289,3,18,0,18,8,1
378495,4,23,0,23,15,1
353143,3,13,29,-16,3,0
157212,1,7,0,7,2,1
404482,3,20,13,7,10,0
283717,2,0,0,0,7,0
25259,2,14,7,7,12,1
200994,2,14,0,14,5,0
156619,2,3,0,3,2,1
53977,4,37,25,12,8,0
245025,4,14,27,-13,7,0
171332,3,10,3,7,9,0
303513,4,37,17,20,16,1
173907,2,13,10,3,10,1
52398,3,9,17,-8,7,1
87152,3,21,10,11,5,1
235054,1,0,0,0,2,0
144940,4,20,7,13,14,1
217664,4,26,23,3,12,0
242993,5,34,34,0,6,1
341876,4,23,15,8,16,0
314819,4,35,7,28,4,0
266725,1,0,0,0,16,0
201921,1,0,0,0,5,0
65682,1,0,7,-7,13,1
349610,3,13,28,-15,2,0
171939,3,14,7,7,9,0
71143,2,19,3,16,16,0
1867,4,19,10,9,1,1
375538,4,33,14,19,14,0
229111,2,16,7,9,17,1
227000,2,3,6,-3,16,1
342749,3,7,7,0,16,0
124511,1,3,0,3,5,0
159128,4,31,7,24,3,0
159564,3,17,6,11,3,0
238621,1,6,0,6,4,1
331097,1,0,6,-6,11,0
189040,3,14,10,4,16,0
219311,2,13,7,6,13,0
46758,3,7,13,-6,4,1
344165,4,35,11,24,17,0
111857,4,12,10,2,17,1
36127,4,44,7,37,17,0
418219,4,38,6,32,16,1
189319,2,3,7,-4,16,0
287422,1,6,0,6,9,1
8593,2,0,10,-10,4,1
386690,4,17,13,4,2,1
370499,4,27,9,18,12,0
103318,1,7,9,-2,13,0
371367,4,42,10,32,12,1
84493,4,20,17,3,4,0
92530,2,10,0,10,8,1
319219,4,17,17,0,5,0
213863,3,48,7,41,10,0
250511,3,16,7,9,9,1
14023,2,3,20,-17,7,0
417992,3,14,28,-14,16,1
214151,3,3,9,-6,11,1
84513,4,27,24,3,4,1
337637,2,14,10,4,14,0
298430,4,7,21,-14,14,0
195360,2,3,3,0,2,1
113997,5,20,20,0,17,1
57043,3,7,20,-13,9,1
128669,3,6,17,-11,7,1
88490,3,13,13,0,6,0
314865,1,0,0,0,4,0
231135,2,3,0,3,1,0
406745,1,0,0,0,11,0
70589,2,7,10,-3,15,1
420413,1,0,0,0,17,0
210881,2,10,3,7,9,0
172617,5,24,24,0,9,0
220655,1,7,0,7,13,1
146570,3,14,24,-10,15,0
43265,4,24,10,14,3,0
313780,4,31,17,14,3,1
146992,3,17,0,17,15,1
242813,4,21,34,-13,6,0
99626,2,7,3,4,11,1
128482,2,21,14,7,7,0
99778,3,0,7,-7,12,0
77327,1,7,7,0,1,0
289077,4,41,28,13,9,0
266738,1,0,7,-7,16,1
11375,2,20,0,20,6,0
262986,2,0,0,0,15,1
205337,2,20,0,20,6,0
332493,4,23,9,14,12,1
390861,3,9,28,-19,3,0
344383,2,21,14,7,17,1
96074,4,16,14,2,10,0
92788,4,12,26,-14,8,1
399505,3,0,24,-24,7,1
307943,2,7,3,4,1,0
215139,1,7,0,7,11,0
195599,4,24,7,17,2,1
48907,3,12,6,6,5,0
307236,4,10,10,0,17,0
253618,4,9,17,-8,11,0
408945,3,24,15,9,12,0
240920,2,14,6,8,5,0
60818,2,10,13,-3,11,0
22568,2,6,3,3,11,1
161281,3,20,3,17,4,0
74160,1,0,0,0,17,1
229163,4,19,7,12,17,0
13967,1,0,0,0,7,1
243391,1,3,10,-7,6,0
171102,1,0,0,0,8,1
230792,4,17,27,-10,1,0
142534,4,30,16,14,13,1
104350,3,45,31,14,13,1
190659,2,21,14,7,17,1
402300,3,20,16,4,9,0
10547,4,40,0,40,5,1
283220,1,7,0,7,7,1
74089,2,9,0,9,17,1
172417,3,13,42,-29,9,1
75573,2,7,3,4,17,1
190559,4,17,20,-3,17,1
383319,1,0,0,0,17,1
205574,4,17,24,-7,6,0
203445,2,0,3,-3,6,1
206011,4,16,17,-1,7,1
401045,1,0,0,0,8,1
37344,2,14,0,14,17,1
97589,4,44,7,37,10,0
96028,3,13,7,6,10,0
108844,3,7,10,-3,15,1
351648,2,7,7,0,3,0
117148,1,6,3,3,2,1
16616,2,7,27,-20,8,1
182882,1,0,3,-3,14,1
69388,1,7,0,7,15,1
357562,3,10,13,-3,5,1
80893,1,3,0,3,3,1
223461,1,0,0,0,15,0
109876,3,20,0,20,16,1
108138,4,13,42,-29,15,0
66357,3,14,24,-10,14,1
170432,2,21,3,18,8,1
158809,3,17,3,14,3,1
243572,2,10,7,3,6,1
362253,4,15,17,-2,8,0
197618,3,26,0,26,3,0
363630,1,0,0,0,8,1
372294,2,10,7,3,13,1
90036,4,11,21,-10,7,1
285095,3,3,0,3,7,0
416383,4,16,13,3,15,1
99819,4,8,24,-16,12,1
417191,2,3,17,-14,16,1
394245,4,47,32,15,5,0
412315,2,7,7,0,13,0
149074,2,14,7,7,16,0
141479,1,7,0,7,13,0
338631,1,6,0,6,14,1
376823,3,14,7,7,15,1
420656,3,21,16,5,17,1
246324,2,7,10,-3,7,1
177039,1,0,0,0,11,1
77787,2,7,14,-7,1,0
144209,1,3,7,-4,14,1
205603,1,7,3,4,7,1
406817,3,0,20,-20,11,1
251371,2,24,14,10,10,1
364507,1,0,7,-7,9,1
161298,3,20,6,14,4,1
331302,2,0,17,-17,11,0
44500,4,27,20,7,3,1
80948,2,13,0,13,3,0
214939,4,7,26,-19,11,1
276458,1,10,7,3,4,0
45097,1,0,0,0,4,0
305408,3,20,3,17,17,1
318793,4,17,29,-12,5,1
200062,4,24,20,4,4,1
315394,3,16,17,-1,4,0
258001,3,0,28,-28,13,1
353195,1,0,0,0,4,0
63768,3,14,18,-4,12,1
370960,1,0,0,0,12,1
378422,2,7,0,7,15,0
388311,2,10,3,7,2,1
225505,3,0,14,-14,15,0
255621,2,0,7,-7,12,1
128695,4,13,20,-7,7,0
166369,1,3,0,3,6,0
279111,3,21,17,4,5,1
229588,3,30,13,17,17,0
226689,1,7,3,4,16,1
318977,2,0,6,-6,5,1
86725,3,17,14,3,5,0
274893,3,7,16,-9,3,1
43960,2,3,7,-4,3,0
394624,3,17,7,10,5,0
387716,3,0,16,-16,2,1
215055,3,13,7,6,11,1
74829,3,13,12,1,17,0
13507,4,6,27,-21,7,0
114111,4,21,7,14,17,0
104605,2,7,3,4,14,0
110150,3,10,10,0,16,1
148887,1,3,6,-3,16,1
133073,4,15,20,-5,9,0
407028,4,11,34,-23,11,1
400794,2,14,7,7,8,0
16309,1,0,0,0,8,0
79238,4,23,13,10,2,1
380834,4,9,24,-15,16,1
296870,1,3,0,3,13,1
143292,1,0,7,-7,14,1
120566,2,0,6,-6,3,0
378980,1,0,0,0,15,0
138769,1,0,0,0,12,0
371489,4,14,24,-10,12,1
268455,3,14,9,5,17,0
191444,4,0,31,-31,17,0
80097,4,24,22,2,2,1
5727,4,0,24,-24,3,0
81294,4,10,14,-4,3,1
84993,2,19,7,12,4,0
408504,3,10,10,0,12,0
38529,2,24,3,21,1,0
310406,1,7,0,7,2,1
96260,1,0,6,-6,10,0
22535,1,0,0,0,11,1
84437,2,6,7,-1,4,0
210655,4,20,24,-4,9,0
55916,1,0,0,0,9,1
256157,3,24,22,2,12,1
368358,1,7,0,7,11,0
330161,1,0,0,0,11,0
416483,3,21,17,4,15,1
247519,1,3,3,0,8,1
306715,2,10,10,0,17,1
285115,3,3,0,3,7,0
313969,1,0,0,0,3,1
4396,4,7,14,-7,2,0
168299,3,10,14,-4,7,0
130073,3,17,30,-13,8,0
248212,4,12,10,2,8,1
101955,4,9,13,-4,12,1
310894,2,3,3,0,2,1
286172,5,24,24,0,8,1
363257,3,24,7,17,8,1
143875,1,0,0,0,14,1
119199,4,16,7,9,3,0
243051,2,0,9,-9,6,1
119917,1,6,14,-8,3,1
231774,3,10,20,-10,1,1
393083,2,7,3,4,4,1
152189,2,7,0,7,17,1
340077,4,17,15,2,15,1
369071,1,0,0,0,11,1
304956,3,7,6,1,16,0
63181,3,14,20,-6,12,0
171540,4,30,10,20,9,1
284238,4,16,26,-10,7,0
34806,1,0,0,0,16,0
397182,3,6,0,6,6,0
75362,1,0,0,0,17,1
163346,4,22,23,-1,5,0
307101,4,24,6,18,17,1
43437,5,24,24,0,3,0
51339,3,16,20,-4,7,1
153750,3,2,21,-19,1,1
414957,1,7,7,0,15,1
4025,1,7,7,0,2,1
333072,3,10,12,-2,12,0
304496,3,3,14,-11,16,1
338125,4,12,7,5,14,0
171206,3,6,14,-8,8,1
185534,2,10,3,7,15,1
275659,3,30,3,27,3,1
291434,3,14,17,-3,10,0
217811,1,0,6,-6,12,0
252194,4,23,17,6,10,1
321549,1,3,3,0,7,0
355200,1,0,7,-7,4,1
259538,1,0,0,0,13,1
380603,1,0,0,0,16,1
188816,4,7,39,-32,16,1
62257,2,14,7,7,12,1
3567,2,14,7,7,2,1
301547,4,20,24,-4,15,0
41800,3,10,14,-4,2,1
332215,4,10,16,-6,12,1
39595,3,27,6,21,1,0
35439,1,7,6,1,17,0
383310,4,48,24,24,17,1
274191,1,10,0,10,3,0
231876,2,7,20,-13,1,0
391535,2,10,21,-11,4,1
229342,1,0,0,0,17,0
284713,1,0,6,-6,7,0
316499,4,22,23,-1,4,1
342693,2,0,0,0,16,1
353441,4,25,3,22,4,0
186931,2,7,6,1,15,0
234546,4,20,20,0,2,1
202899,3,28,0,28,5,0
332132,1,0,0,0,12,0
49420,4,20,20,0,6,0
414387,2,7,17,-10,14,0
330318,1,0,0,0,11,0
100849,4,12,19,-7,12,0
33715,4,35,7,28,16,1
6685,3,3,20,-17,3,1
407802,4,17,7,10,11,1
328503,4,9,3,6,10,0
398456,2,7,0,7,7,0
116590,2,13,0,13,2,1
106118,2,0,0,0,14,1
193,2,3,10,-7,1,1
1837,3,16,7,9,1,0
161879,2,13,9,4,4,0
344892,1,0,7,-7,17,1
352386,2,28,7,21,3,0
331392,1,3,7,-4,11,1
279107,3,21,10,11,5,0
172973,1,7,0,7,9,1
393251,3,14,20,-6,5,0
365414,2,7,12,-5,9,1
51410,1,3,7,-4,7,0
11095,3,10,13,-3,5,1
83371,2,7,14,-7,4,1
95265,2,3,17,-14,10,1
8176,2,0,7,-7,4,1
238500,2,13,0,13,4,0
384760,4,19,37,-18,1,0
208059,4,21,13,8,8,1
56482,4,7,41,-34,9,0
272916,4,20,20,0,2,1
324337,4,31,10,21,8,1
253478,4,17,44,-27,11,1
132759,4,20,24,-4,9,1
221458,3,3,38,-35,14,0
308694,2,7,6,1,1,1
183238,2,10,14,-4,14,0
293255,3,23,7,16,11,1
344971,3,10,14,-4,17,0
205858,4,20,0,20,7,1
204934,4,13,19,-6,6,0
71972,4,25,16,9,16,0
31134,1,3,10,-7,15,0
224340,4,16,12,4,15,0
4238,3,13,6,7,2,0
142903,2,0,10,-10,13,1
117237,4,23,17,6,2,1
350722,2,7,0,7,2,1
272671,2,9,3,6,2,0
44914,4,7,38,-31,4,0
61213,1,7,0,7,11,1
283256,2,10,9,1,7,1
240837,4,29,10,19,5,1
65110,1,0,0,0,13,0
77068,2,7,17,-10,1,1
206214,2,0,3,-3,7,1
400121,4,20,23,-3,8,0
283180,4,20,9,11,7,1
372301,3,17,7,10,13,0
415698,2,7,3,4,15,0
205755,1,0,0,0,7,1
281124,1,0,0,0,6,1
42674,3,7,10,-3,3,0
46183,2,14,14,0,4,1
329162,1,3,3,0,10,1
331531,1,0,7,-7,11,0
335362,4,3,23,-20,13,1
18937,4,9,27,-18,9,0
144729,3,3,0,3,14,0
202481,4,9,16,-7,5,1
285894,1,13,0,13,8,0
140416,1,0,7,-7,12,1
642,2,0,3,-3,1,1
219882,1,0,0,0,13,1
358288,3,0,20,-20,6,0
319396,4,23,28,-5,6,0
84350,4,28,30,-2,4,0
327852,3,16,10,6,10,0
102972,4,12,31,-19,13,0
412054,2,21,0,21,13,0
53555,3,14,12,2,8,0
12414,3,10,6,4,6,0
378651,4,23,23,0,15,0
113606,3,6,3,3,17,0
237668,2,13,7,6,4,1
349146,2,20,7,13,2,0
239145,3,13,13,0,4,1
282391,3,10,23,-13,6,1
258564,2,0,0,0,13,0
82479,2,10,17,-7,3,0
305867,3,7,14,-7,17,1
332312,2,6,6,0,12,1
96171,2,0,16,-16,10,1
40545,1,7,0,7,2,1
239841,2,7,0,7,4,0
54064,3,10,3,7,8,1
210368,4,22,17,5,9,1
393353,1,7,7,0,5,1
180720,1,0,0,0,13,0
76087,4,13,23,-10,1,1
410925,4,14,15,-1,13,1
33716,4,35,7,28,16,1
147332,1,0,0,0,15,1
288330,1,0,0,0,9,1
11076,2,10,10,0,5,1
257556,4,19,10,9,13,1
319566,5,22,23,-1,6,0
174739,4,9,10,-1,10,0
401420,3,17,7,10,8,0
364845,2,6,14,-8,9,0
43505,2,7,3,4,3,1
31956,3,16,13,3,15,0
314242,4,17,20,-3,3,0
138894,1,0,3,-3,12,1
355661,4,38,23,15,5,0
173049,3,24,6,18,9,0
67571,2,0,7,-7,14,0
100336,2,9,17,-8,12,0
171180,3,3,7,-4,8,1
238902,4,41,21,20,4,0
51726,2,0,10,-10,7,0
214692,1,0,0,0,11,1
116469,3,6,16,-10,1,1
37969,4,17,14,3,1,0
252382,4,0,29,-29,10,1
185374,2,0,3,-3,15,0
421819,2,0,10,-10,17,0
152834,4,21,18,3,17,1
50516,1,0,0,0,6,0
386950,3,7,21,-14,2,0
407509,1,3,0,3,11,0
157401,2,6,7,-1,2,1
304971,3,10,14,-4,16,0
31775,3,0,17,-17,15,0
125195,3,31,7,24,5,0
61474,1,0,0,0,11,0
210036,3,10,10,0,8,0
112231,2,14,7,7,17,0
134999,4,14,34,-20,10,1
207462,3,14,14,0,7,1
98713,2,21,3,18,11,0
97525,3,16,0,16,10,1
80456,1,2,0,2,3,1
113919,3,10,10,0,17,1
269573,4,24,31,-7,1,0
22497,4,31,29,2,11,0
178922,2,3,3,0,12,1
301953,4,17,20,-3,15,1
49511,2,7,3,4,6,0
24680,2,20,7,13,12,0
131514,2,3,6,-3,8,1
255797,2,10,0,10,12,1
324353,1,7,0,7,8,0
341473,1,0,7,-7,16,1
30620,3,17,3,14,14,1
166085,1,7,0,7,6,1
348666,2,3,3,0,2,0
64015,2,17,3,14,13,0
213048,2,17,0,17,10,1
375447,2,7,7,0,14,0
84575,2,10,7,3,4,0
127764,2,7,21,-14,6,1
32643,2,0,0,0,15,0
330469,1,0,7,-7,11,1
207586,2,21,3,18,7,0
121541,3,16,7,9,4,0
376936,2,3,6,-3,15,1
60383,3,13,7,6,11,1
20059,4,19,16,3,10,0
62290,3,21,19,2,12,1
268790,3,31,10,21,17,1
198469,3,17,3,14,3,0
48759,4,10,25,-15,5,0
170306,3,0,12,-12,8,0
361825,3,37,10,27,7,1
204552,1,0,21,-21,6,0
38046,2,3,0,3,1,1
110248,1,0,3,-3,16,0
112217,1,7,7,0,17,1
119213,1,0,0,0,3,0
6024,1,0,0,0,3,0
201542,4,32,14,18,5,0
193614,4,7,17,-10,1,0
298715,4,19,21,-2,14,1
45571,2,7,13,-6,4,1
88581,1,3,7,-4,6,1
96366,4,9,30,-21,10,0
157656,1,0,0,0,2,0
79390,1,3,0,3,2,1
213290,4,17,27,-10,10,1
121460,1,0,0,0,4,1
186227,4,29,20,9,15,1
387839,2,10,13,-3,2,0
351613,1,0,7,-7,3,0
157139,3,16,20,-4,2,1
165196,1,0,7,-7,6,1
220487,1,0,6,-6,13,0
350507,4,10,19,-9,2,1
42567,4,10,31,-21,3,1
58675,1,7,0,7,10,0
223743,4,40,13,27,15,0
415744,3,14,10,4,15,0
15830,4,8,12,-4,8,1
15287,1,0,0,0,8,1
28398,3,13,3,10,14,1
27984,4,24,17,7,13,0
157113,3,13,14,-1,2,0
383186,1,13,0,13,17,1
266872,5,17,17,0,16,1
385850,1,0,0,0,1,0
407705,2,3,0,3,11,0
151522,4,35,7,28,17,1
164814,4,26,21,5,6,0
364496,1,0,0,0,9,0
159730,2,7,10,-3,3,0
326905,1,0,0,0,9,1
173673,4,20,22,-2,10,0
386751,1,0,0,0,2,1
2164,4,13,23,-10,1,1
14075,4,3,31,-28,7,1
378891,3,13,20,-7,15,1
408609,2,21,0,21,12,1
127008,3,24,13,11,6,0
52570,4,19,10,9,7,1
211907,4,43,23,20,9,0
373519,2,0,13,-13,13,1
64182,3,31,6,25,13,1
208356,3,17,27,-10,8,0
204972,1,0,0,0,6,1
302597,1,0,3,-3,15,1
243243,2,0,7,-7,6,1
190334,1,0,0,0,17,1
312712,3,28,14,14,3,1
277430,4,34,17,17,4,1
290333,2,6,3,3,10,0
227601,2,28,0,28,16,0
403867,2,10,0,10,10,0
18831,1,3,0,3,9,0
160777,1,10,7,3,4,1
74995,3,26,17,9,17,1
311848,4,20,27,-7,2,0
235248,2,15,6,9,3,1
323889,4,16,30,-14,8,0
341984,3,6,3,3,16,1
252471,2,7,19,-12,10,0
118511,2,17,0,17,2,1
414820,1,13,0,13,15,0
132750,4,20,23,-3,9,0
95467,4,43,7,36,10,0
267991,3,7,9,-2,17,0
290506,2,14,7,7,10,0
175349,1,7,0,7,11,1
224453,2,9,10,-1,15,0
215033,2,13,7,6,11,1
185951,4,28,37,-9,15,1
28243,3,17,0,17,13,1
417283,4,20,23,-3,16,1
374265,2,7,10,-3,13,1
109447,3,6,13,-7,16,1
75120,3,7,6,1,17,1
409483,1,0,0,0,12,1
125110,1,7,0,7,5,0
243818,4,27,20,7,6,0
12978,1,0,0,0,6,0
32241,3,21,14,7,15,0
229485,1,0,0,0,17,0
283511,1,0,0,0,7,1
303763,3,17,10,7,16,1
83647,1,0,3,-3,4,1
376060,2,0,3,-3,14,1
272068,2,10,3,7,2,0
233984,1,7,0,7,2,1
143245,3,10,16,-6,13,1
137274,4,7,20,-13,11,0
290029,2,7,3,4,10,1
224479,3,9,10,-1,15,1
406646,2,7,0,7,11,0
268094,1,0,7,-7,17,1
24815,2,6,3,3,12,1
205239,4,23,13,10,6,1
242049,4,10,9,1,5,0
131916,4,34,14,20,8,1
201682,3,17,20,-3,5,1
421435,4,31,20,11,17,0
298688,3,13,14,-1,14,1
62390,2,0,10,-10,12,0
60715,3,21,3,18,11,0
335261,2,0,3,-3,13,0
393619,4,7,33,-26,5,1
249938,4,18,23,-5,9,0
289287,2,14,14,0,9,0
224402,1,0,0,0,15,0
244712,4,21,26,-5,7,1
320127,3,17,0,17,6,0
95973,2,0,0,0,10,1
307750,1,7,7,0,1,1
345414,3,0,10,-10,17,0
156045,3,20,24,-4,2,1
242781,3,14,24,-10,6,0
83097,3,6,21,-15,4,0
295476,1,0,0,0,12,0
205623,2,7,6,1,7,0
209157,1,0,7,-7,8,1
374735,3,0,39,-39,14,1
63445,2,14,13,1,12,1
220819,2,7,7,0,14,0
248892,2,14,0,14,9,0
222277,1,0,0,0,14,1
390560,3,17,14,3,3,1
82140,2,3,3,0,3,1
362224,3,6,17,-11,8,1
89952,2,2,7,-5,7,0
293708,4,10,13,-3,12,0
252137,2,10,10,0,10,0
239190,4,27,19,8,4,0
331604,3,20,23,-3,11,0
58707,2,7,10,-3,10,1
402055,4,3,26,-23,9,1
207294,2,6,14,-8,7,1
373511,2,0,13,-13,13,0
59993,4,3,31,-28,11,1
404923,2,3,10,-7,10,1
395998,3,31,20,11,6,0
102919,2,9,21,-12,13,1
96726,2,0,10,-10,10,0
1423,4,16,0,16,1,1
313739,2,21,3,18,3,0
32371,2,14,6,8,15,0
95954,1,0,0,0,10,0
226870,2,0,7,-7,16,0
162256,4,23,20,3,4,1
356669,2,16,10,6,5,1
172011,1,0,0,0,9,1
105952,1,10,0,10,14,0
279327,1,0,0,0,5,0
178489,2,16,3,13,12,0
305090,2,21,10,11,16,1
89003,4,39,10,29,6,1
159945,4,45,17,28,3,0
121826,2,0,7,-7,4,0
113725,2,3,10,-7,17,0
59693,4,31,6,25,11,0
381669,2,17,7,10,17,1
72002,1,0,10,-10,16,1
243482,4,10,23,-13,6,0
384100,2,0,10,-10,1,1
1711,3,21,0,21,1,0
163057,1,0,0,0,5,0
295141,4,10,14,-4,12,0
38415,4,24,16,8,1,1
213414,3,10,40,-30,10,0
23235,4,23,13,10,11,1
336232,1,3,0,3,13,0
19648,4,23,28,-5,10,1
8714,1,0,0,0,4,1
241301,4,10,7,3,5,1
236526,3,10,9,1,3,0
58391,2,34,0,34,10,0
370493,4,20,9,11,12,1
376115,4,0,9,-9,14,0
164327,2,20,0,20,5,0
228374,3,7,17,-10,17,0
383710,3,16,24,-8,17,0
216451,1,14,0,14,12,1
274671,2,7,3,4,3,0
113999,5,20,20,0,17,1
243098,3,7,9,-2,6,0
25737,4,14,10,4,12,0
411720,1,0,3,-3,13,0
173861,1,6,7,-1,10,0
121470,1,0,0,0,4,1
149903,4,6,22,-16,16,0
77567,4,20,14,6,1,1
59116,4,18,36,-18,10,1
167213,3,23,17,6,7,1
362293,1,0,0,0,8,0
35892,2,0,0,0,17,0
328907,2,6,7,-1,10,1
354084,3,19,0,19,4,1
153706,2,2,21,-19,1,1
144792,4,10,17,-7,14,1
330842,2,10,17,-7,11,1
164738,2,13,14,-1,6,1
305092,2,21,10,11,16,1
383270,3,38,16,22,17,0
322966,4,13,0,13,7,0
404600,2,6,10,-4,10,1
238018,3,10,13,-3,4,1
419646,4,30,16,14,17,0
100418,4,12,20,-8,12,1
325892,2,3,0,3,9,0
201947,2,0,0,0,5,0
84191,4,17,10,7,4,0
84453,3,6,10,-4,4,1
404942,2,3,13,-10,10,1
402988,2,7,14,-7,9,0
225115,4,16,14,2,15,0
294699,3,6,14,-8,12,1
108411,3,6,21,-15,15,0
269895,1,0,0,0,1,1
167504,2,0,3,-3,7,1
234638,2,20,17,3,2,0
16488,2,13,7,6,8,1
365424,2,7,12,-5,9,1
104566,1,6,3,3,14,1
168050,4,6,24,-18,7,1
6718,4,3,23,-20,3,0
214293,3,14,10,4,11,1
327043,4,14,10,4,9,0
366413,3,26,10,16,10,0
213551,3,10,14,-4,10,0
385569,2,3,17,-14,1,1
188259,2,14,7,7,16,1
278070,4,13,10,3,4,0
165864,4,6,16,-10,6,0
238546,4,16,13,3,4,0
392792,2,17,3,14,4,0
254522,4,29,13,16,11,1
334368,2,0,10,-10,13,1
295895,3,10,14,-4,12,0
228694,3,16,23,-7,17,1
168974,1,0,7,-7,7,1
203849,4,31,31,0,6,1
109584,3,16,14,2,16,1
186964,3,10,12,-2,15,1
79096,1,0,0,0,2,0
133693,4,32,35,-3,9,1
142881,1,0,0,0,13,0
236755,1,0,3,-3,3,1
38831,3,3,10,-7,1,1
397466,3,13,16,-3,6,1
364998,2,17,6,11,9,1
289143,2,13,7,6,9,1
375190,4,17,17,0,14,1
215755,2,23,3,20,11,1
238009,3,10,13,-3,4,0
366832,2,0,3,-3,10,1
273206,3,33,7,26,2,1
281457,2,0,10,-10,6,1
180802,4,10,20,-10,13,0
149217,1,7,0,7,16,1
380083,4,35,20,15,16,0
33476,1,0,0,0,16,1
251291,4,13,30,-17,10,0
387412,3,21,10,11,2,1
34213,1,10,0,10,16,0
58777,4,10,26,-16,10,0
195486,1,0,0,0,2,1
150788,4,20,9,11,17,0
11,1,0,0,0,1,1
175138,3,28,10,18,10,1
174519,3,7,7,0,10,0
228769,1,0,7,-7,17,1
420197,4,3,3,0,17,0
132094,2,7,0,7,9,1
421586,4,16,9,7,17,1
24571,3,10,16,-6,12,1
113311,3,16,24,-8,17,0
339384,1,0,3,-3,15,1
128725,1,0,0,0,7,1
80325,2,13,6,7,2,1
86809,1,6,6,0,5,1
17213,2,7,28,-21,9,1
153259,2,2,0,2,1,0
360760,2,17,21,-4,7,1
36097,3,41,0,41,17,0
112774,4,20,10,10,17,0
285134,4,3,0,3,7,1
278175,3,24,14,10,4,1
54360,3,14,19,-5,8,0
407271,2,10,16,-6,11,1
48197,4,10,19,-9,5,0
39942,4,9,10,-1,1,0
348756,4,31,23,8,2,0
227990,1,0,0,0,17,0
63028,3,16,21,-5,12,0
21668,2,3,6,-3,11,0
59456,2,3,10,-7,11,1
340964,4,10,17,-7,15,1
246797,3,3,13,-10,8,0
243725,2,17,3,14,6,1
67556,1,0,0,0,14,0
24388,3,13,0,13,12,1
257411,4,20,14,6,13,1
85845,4,13,16,-3,5,0
364367,1,7,0,7,9,1
317209,3,7,13,-6,5,0
69011,3,21,17,4,15,1
38303,1,0,0,0,1,0
21763,4,31,17,14,11,0
115882,3,7,16,-9,1,0
240145,2,13,3,10,5,0
183514,2,7,3,4,14,1
180590,1,7,3,4,13,1
43481,1,0,0,0,3,1
232874,1,0,0,0,2,1
236211,4,20,16,4,3,1
255966,3,6,12,-6,12,1
385459,3,35,10,25,1,0
1136,4,10,36,-26,1,0
176410,4,22,28,-6,11,0
339590,3,17,14,3,15,0
116393,1,3,0,3,1,0
371093,4,13,27,-14,12,1
209482,1,0,3,-3,8,1
330046,1,0,0,0,11,0
142799,3,12,10,2,13,1
111849,3,6,10,-4,17,1
102946,3,12,24,-12,13,1
291558,2,10,3,7,11,0
109701,2,3,0,3,16,1
99001,1,0,0,0,11,1
48492,1,0,0,0,5,0
21360,1,0,0,0,11,0
76499,2,0,20,-20,1,1
377644,1,6,7,-1,15,0
48570,3,14,17,-3,5,1
154991,1,0,0,0,1,0
404399,4,20,13,7,10,0
399821,4,11,27,-16,8,1
362372,3,29,14,15,8,1
401505,1,0,7,-7,8,1
202291,3,6,3,3,5,1
375266,1,0,0,0,14,1
280394,2,3,7,-4,5,1
271817,4,42,27,15,2,0
246135,1,7,0,7,7,1
185142,4,0,23,-23,15,1
221576,2,20,15,5,14,1
38280,4,13,14,-1,1,0
308279,4,13,16,-3,1,0
267382,2,0,7,-7,17,0
149766,4,55,7,48,16,1
381167,1,0,0,0,16,1
310903,2,3,3,0,2,0
363781,1,0,7,-7,8,1
84801,4,13,31,-18,4,0
60326,1,3,0,3,11,0
111929,2,0,21,-21,17,1
253510,1,0,7,-7,11,0
249557,3,14,10,4,9,1
129768,4,17,24,-7,7,0
223446,4,20,26,-6,15,0
323566,4,34,17,17,7,0
381137,4,24,28,-4,16,1
105539,3,29,14,15,14,0
135609,1,7,0,7,10,0
372541,5,26,27,-1,13,1
125640,3,14,24,-10,5,1
237998,2,10,10,0,4,0
379295,2,0,3,-3,16,0
38820,3,3,10,-7,1,1
64746,3,28,0,28,13,0
400631,1,0,0,0,8,0
175511,2,0,0,0,11,1
398633,3,0,0,0,7,0
393401,3,21,17,4,5,0
164022,2,0,3,-3,5,0
230156,3,3,23,-20,17,0
29971,2,14,0,14,14,0
254268,2,6,9,-3,11,1
225305,2,0,14,-14,15,0
346033,2,3,6,-3,1,1
35358,3,23,13,10,16,1
193246,3,3,10,-7,1,0
404128,1,6,0,6,10,1
87376,2,7,0,7,6,0
264994,4,32,17,15,16,1
337345,3,14,7,7,14,1
351928,2,7,7,0,3,1
204285,3,0,10,-10,6,1
21075,1,0,0,0,10,0
300168,3,21,3,18,14,0
243242,2,0,7,-7,6,1
1264,3,17,13,4,1,0
215148,1,7,3,4,11,1
69600,3,7,17,-10,15,1
414742,3,10,17,-7,14,0
167378,4,30,30,0,7,1
160060,4,20,26,-6,3,1
118930,1,0,7,-7,3,0
87911,4,13,15,-2,6,1
401503,1,0,7,-7,8,1
380380,3,10,17,-7,16,1
304638,2,14,7,7,16,0
54394,4,24,19,5,8,1
133127,2,7,3,4,9,0
85099,4,31,16,15,4,0
3456,3,3,23,-20,2,0
41659,3,17,7,10,2,1
395434,1,0,0,0,6,1
151056,3,10,10,0,17,1
85895,1,7,7,0,5,0
137962,1,0,6,-6,11,0
178745,1,13,0,13,12,1
153460,4,20,17,3,1,0
87184,4,21,13,8,5,1
224085,4,17,9,8,15,0
119559,2,7,0,7,3,1
272123,4,17,9,8,2,1
189168,2,21,0,21,16,0
221582,3,20,18,2,14,0
64220,4,38,6,32,13,0
215077,4,16,7,9,11,0
270720,3,6,3,3,1,1
182664,3,0,12,-12,14,0
384396,1,14,0,14,1,0
5877,1,0,0,0,3,0
139377,1,14,0,14,12,0
90590,2,14,10,4,7,1
402017,4,3,19,-16,9,1
322039,2,13,0,13,7,0
302251,3,31,13,18,15,1
345675,1,7,0,7,17,0
81433,4,10,13,-3,3,0
212549,1,0,3,-3,10,0
87558,2,17,3,14,6,0
299139,3,3,16,-13,14,1
150245,1,0,0,0,16,0
208460,2,10,0,10,8,1
90927,4,54,7,47,7,1
227044,3,17,6,11,16,0
249988,2,7,3,4,9,0
43984,3,3,14,-11,3,0
351712,4,14,17,-3,3,0
121972,2,10,7,3,4,0
98836,1,7,0,7,11,1
69556,2,0,7,-7,15,0
24067,2,7,7,0,12,0
181437,3,24,24,0,13,1
4376,3,7,7,0,2,1
115543,2,3,3,0,1,0
206931,4,17,23,-6,7,1
325239,4,19,32,-13,8,1
183810,2,17,21,-4,14,1
380935,2,6,7,-1,16,1
267972,2,0,6,-6,17,1
284838,4,29,27,2,7,0
141599,1,0,0,0,13,1
114968,2,7,12,-5,1,1
118261,2,12,7,5,2,1
333744,4,21,14,7,12,1
31434,2,3,0,3,15,0
7143,3,34,21,13,4,1
391841,2,10,3,7,4,1
276868,4,26,20,6,4,0
129042,1,0,7,-7,7,1
402838,1,7,0,7,9,1
97057,2,19,3,16,10,0
374125,2,13,7,6,13,1
109165,4,31,7,24,15,1
21161,3,0,16,-16,10,0
103176,1,0,0,0,13,0
72564,4,19,31,-12,16,1
348643,1,3,3,0,2,1
352583,4,34,20,14,3,0
388209,4,6,13,-7,2,1
86275,2,13,17,-4,5,0
9659,3,12,28,-16,5,1
80935,2,13,0,13,3,0
21065,1,0,0,0,10,1
216168,2,14,0,14,12,0
413639,4,17,24,-7,14,0
411852,1,0,0,0,13,0
89932,1,0,7,-7,7,0
76735,1,0,0,0,1,1
346908,4,23,16,7,1,1
370340,4,14,35,-21,12,1
281926,2,7,7,0,6,0
418016,3,21,35,-14,16,1
176226,4,14,24,-10,11,0
89251,3,6,0,6,7,1
407836,1,3,0,3,11,1
85866,4,20,23,-3,5,1
372886,2,10,0,10,13,1
192688,4,19,7,12,1,0
219689,4,13,14,-1,13,1
22867,2,0,10,-10,11,0
346622,1,7,0,7,1,0
407448,3,14,10,4,11,1
2218,2,7,0,7,1,0
110673,4,23,10,13,16,0
257296,1,0,0,0,13,0
373619,1,0,0,0,13,1
404204,3,12,9,3,10,0
218908,3,34,17,17,13,0
305222,2,14,13,1,16,0
283893,3,27,17,10,7,1
167545,3,0,10,-10,7,1
112043,4,48,21,27,17,1
280388,2,3,6,-3,5,0
135506,2,7,6,1,10,0
374450,3,32,0,32,14,0
140517,4,21,29,-8,12,1
249191,1,9,0,9,9,1
11273,4,17,28,-11,6,1
320764,4,17,23,-6,6,1
201295,2,14,3,11,5,1
116723,2,6,17,-11,2,1
327863,3,16,17,-1,10,1
258273,2,14,12,2,13,1
8406,4,37,10,27,4,0
256602,3,20,0,20,12,1
52492,2,3,0,3,7,1
240240,1,0,0,0,5,1
285625,4,20,24,-4,8,1
238848,3,34,0,34,4,1
339276,2,24,0,24,15,0
263259,1,0,0,0,15,1
414373,2,7,10,-3,14,0
380416,4,10,24,-14,16,0
9966,4,3,3,0,5,1
254083,1,0,0,0,11,0
396143,3,24,23,1,6,0
330304,4,31,21,10,11,0
295727,3,10,9,1,12,0
325795,3,6,10,-4,9,1
311409,4,42,20,22,2,1
346116,4,10,12,-2,1,1
345126,3,15,3,12,17,0
95587,4,12,10,2,10,0
361574,4,19,17,2,7,1
117238,4,29,17,12,2,1
127911,2,10,0,10,6,1
55233,2,7,0,7,9,0
48723,3,10,19,-9,5,1
83124,4,6,30,-24,4,1
413175,4,40,45,-5,14,1
221813,1,0,0,0,14,1
161145,3,3,26,-23,4,0
117160,2,6,3,3,2,1
337023,2,13,0,13,14,1
288367,2,7,0,7,9,0
169979,3,21,10,11,8,1
89466,4,27,20,7,7,0
182534,4,35,21,14,14,1
928,2,0,0,0,1,1
253315,4,13,13,0,11,0
250006,2,7,6,1,9,1
189413,1,6,0,6,17,1
366742,3,27,10,17,10,0
176208,3,14,24,-10,11,1
62263,2,21,7,14,12,0
96628,3,3,3,0,10,0
318671,1,0,7,-7,5,1
94754,1,3,0,3,9,0
338781,1,7,0,7,15,0
335360,4,3,23,-20,13,1
270060,2,3,10,-7,1,1
122348,4,13,19,-6,4,0
246392,4,26,16,10,7,0
309259,2,0,7,-7,1,0
92464,4,23,10,13,8,0
272858,2,20,7,13,2,0
404188,3,9,9,0,10,0
80495,2,5,3,2,3,1
138720,4,28,35,-7,12,0
319139,2,2,0,2,5,1
315702,4,10,16,-6,4,1
213898,1,0,0,0,10,1
81211,1,0,7,-7,3,0
87206,1,0,0,0,6,0
247661,1,7,0,7,8,0
263549,4,20,29,-9,15,1
389041,2,20,0,20,3,1
270973,2,0,7,-7,1,0
299227,1,3,0,3,14,0
295259,3,14,5,9,12,1
197225,1,0,0,0,3,1
55695,3,23,14,9,9,1
276342,2,14,21,-7,3,0
358226,1,0,7,-7,6,0
180033,3,14,20,-6,13,1
185031,1,0,0,0,15,1
261669,2,7,0,7,14,0
307332,3,14,19,-5,17,0
77484,1,0,7,-7,1,0
366228,1,7,0,7,10,0
102157,2,14,7,7,13,1
120609,3,3,20,-17,3,1
259321,3,13,20,-7,13,1
144920,4,20,7,13,14,1
32351,2,14,0,14,15,0
147682,2,10,3,7,15,1
370981,1,7,0,7,12,0
231848,1,0,13,-13,1,0
146310,4,17,33,-16,15,1
350800,4,23,10,13,2,0
5974,3,17,23,-6,3,1
327059,1,0,0,0,9,1
358770,4,14,17,-3,6,0
418560,2,14,3,11,16,1
233284,3,7,10,-3,2,0
69788,1,7,0,7,15,0
137299,4,13,27,-14,11,1
290331,1,6,3,3,10,0
276092,3,34,3,31,3,1
9061,3,28,13,15,4,0
388989,4,24,27,-3,3,0
52103,4,13,19,-6,7,0
83241,3,9,7,2,4,0
31672,4,24,16,8,15,1
391360,1,0,0,0,4,0
106530,1,7,0,7,14,0
18493,4,17,14,3,9,1
291063,1,6,0,6,10,0
42667,3,0,10,-10,3,1
218105,1,7,0,7,12,0
53789,5,10,10,0,8,0
166566,2,6,7,-1,6,1
224834,4,11,16,-5,15,1
355199,1,0,6,-6,4,0
235125,3,0,10,-10,2,1
206219,2,0,3,-3,7,1
154608,3,14,14,0,1,1
4853,1,0,0,0,3,1
420900,1,7,0,7,17,0
202997,2,14,0,14,5,0
44442,3,17,7,10,3,1
211877,4,35,17,18,9,1
9634,2,12,21,-9,5,0
150332,3,24,7,17,16,1
224423,1,6,3,3,15,0
379917,3,14,6,8,16,1
129665,1,0,3,-3,7,0
9655,3,12,28,-16,5,1
195804,2,20,14,6,2,1
8449,2,9,0,9,4,1
381588,4,42,16,26,17,1
96239,4,3,29,-26,10,1
224578,2,6,7,-1,15,0
346698,3,21,6,15,1,1
102853,4,17,10,7,13,0
334408,3,10,10,0,13,0
143911,2,0,0,0,14,0
297704,3,10,13,-3,13,1
220133,3,26,13,13,13,0
44678,1,0,0,0,3,0
417818,2,10,0,10,16,1
72376,3,10,23,-13,16,1
295648,1,0,0,0,12,1
343283,1,0,0,0,16,0
260176,1,7,0,7,14,0
190986,3,12,3,9,17,1
3589,2,20,14,6,2,0
316880,2,9,2,7,4,0
237427,4,12,23,-11,3,0
134882,1,7,0,7,10,0
109702,2,3,0,3,16,1
298248,3,20,13,7,14,0
46107,4,28,21,7,4,0
293930,2,7,21,-14,12,0
17522,2,13,0,13,9,0
346014,2,0,3,-3,1,1
198389,1,0,0,0,3,1
327068,1,0,0,0,9,1
399043,2,10,12,-2,7,1
223416,3,13,19,-6,15,0
119635,4,17,12,5,3,1
279431,4,16,24,-8,5,0
354930,1,7,0,7,4,0
300033,3,0,27,-27,14,1
221214,1,0,3,-3,14,0
130666,3,7,35,-28,8,0
262234,1,3,0,3,15,0
281868,4,16,7,9,6,0
62592,2,6,10,-4,12,0
145779,2,13,10,3,15,0
401487,4,27,13,14,8,0
325784,2,6,10,-4,9,0
116974,1,0,0,0,2,0
98144,3,21,10,11,11,0
354645,3,10,7,3,4,1
221659,5,23,24,-1,14,1
50589,3,3,6,-3,6,1
103278,4,3,10,-7,13,1
90948,4,61,7,54,7,0
371033,3,10,10,0,12,0
7344,5,20,19,1,4,1
376582,4,15,6,9,14,0
11790,2,14,3,11,6,1
289274,1,7,14,-7,9,1
402879,3,17,6,11,9,0
68287,1,0,0,0,14,1
13081,4,21,14,7,6,0
277425,4,34,9,25,4,0
160663,3,10,0,10,4,1
315555,4,7,14,-7,4,0
50167,4,0,24,-24,6,1
160067,4,23,26,-3,3,1
391168,3,10,24,-14,4,1
171812,3,23,17,6,9,1
183110,3,7,6,1,14,1
118120,2,13,20,-7,2,1
103918,2,3,0,3,13,1
161262,2,17,3,14,4,1
269098,4,13,16,-3,17,1
94534,3,3,10,-7,9,0
54884,1,0,0,0,8,1
60405,3,20,7,13,11,1
385301,3,14,20,-6,1,0
141609,1,0,0,0,13,1
400174,1,0,0,0,8,0
119840,4,24,19,5,3,0
26456,3,27,16,11,13,0
46992,1,7,0,7,5,0
130170,2,0,16,-16,8,0
52276,4,27,19,8,7,0
338040,2,0,0,0,14,0
292217,4,24,17,7,11,0
261651,1,0,0,0,14,0
221950,4,22,19,3,14,1
152177,1,7,0,7,17,1
296993,4,32,14,18,13,1
371613,3,10,17,-7,12,0
105784,1,0,3,-3,14,1
390572,3,17,21,-4,3,1
226758,3,7,20,-13,16,1
382842,3,28,3,25,17,0
27025,2,10,0,10,13,0
183314,4,22,20,2,14,1
308394,2,0,12,-12,1,1
163292,3,13,13,0,5,1
228749,4,26,33,-7,17,0
22687,1,3,0,3,11,0
196758,4,54,13,41,3,1
199569,3,27,10,17,4,1
67252,4,7,3,4,14,0
306183,3,10,3,7,17,1
358466,4,35,27,8,6,0
2149,4,13,16,-3,1,0
175198,1,0,0,0,10,1
168778,4,16,9,7,7,0
262190,4,31,16,15,15,1
186623,2,24,3,21,15,0
240909,2,14,3,11,5,0
154374,4,34,24,10,1,1
134007,1,0,0,0,9,0
265015,1,0,0,0,16,1
409025,1,0,0,0,12,0
197095,2,7,14,-7,3,0
144544,2,7,10,-3,14,1
212116,1,3,7,-4,10,0
53762,4,10,9,1,8,0
316351,1,0,0,0,4,1
160705,4,10,0,10,4,0
250042,3,17,13,4,9,0
94907,1,0,0,0,9,0
180951,3,17,14,3,13,1
97644,2,3,3,0,11,1
22839,1,0,0,0,11,0
146618,1,0,7,-7,15,1
122855,2,10,6,4,4,0
378528,1,7,6,1,15,0
319618,2,16,3,13,6,0
57621,2,9,3,6,10,1
163328,4,16,23,-7,5,0
179379,2,3,13,-10,12,1
221444,3,3,31,-28,14,0
194336,3,17,6,11,2,1
165419,4,6,36,-30,6,1
169072,3,33,14,19,7,0
160423,1,3,0,3,4,0
178241,4,6,10,-4,12,0
116508,4,6,22,-16,1,1
191117,3,21,20,1,17,0
330526,2,7,7,0,11,0
21150,3,0,16,-16,10,1
340089,4,20,15,5,15,0
295281,3,14,5,9,12,0
92500,1,0,0,0,8,1
415420,2,9,0,9,15,1
285859,1,0,0,0,8,0
185939,4,22,30,-8,15,1
76551,4,7,41,-34,1,1
48531,2,11,0,11,5,0
361780,2,14,7,7,7,1
89776,1,3,0,3,7,1
418427,2,14,3,11,16,0
162098,4,42,13,29,4,0
312,1,7,0,7,1,1
401710,3,10,14,-4,8,1
55514,1,10,0,10,9,1
263712,1,0,0,0,15,0
170841,1,7,0,7,8,1
269954,2,16,10,6,1,0
76301,1,3,3,0,1,1
146079,2,19,10,9,15,1
360942,4,24,5,19,7,1
272318,1,0,0,0,2,1
361243,3,14,26,-12,7,0
390690,3,6,3,3,3,0
223778,1,0,0,0,15,0
97396,3,9,16,-7,10,0
143641,2,13,10,3,14,0
180004,2,7,13,-6,13,0
401866,3,14,28,-14,9,1
163761,3,7,12,-5,5,0
186934,2,7,6,1,15,0
180667,4,24,6,18,13,1
177479,4,27,16,11,11,0
197941,4,18,7,11,3,1
27582,1,7,0,7,13,0
48651,1,0,0,0,5,1
177214,2,7,0,7,11,0
88280,2,7,0,7,6,0
351393,3,10,13,-3,3,1
379889,2,14,0,14,16,1
373613,4,33,40,-7,13,0
188990,1,7,0,7,16,0
241635,1,0,0,0,5,1
24155,1,0,0,0,12,1
273726,1,0,0,0,2,0
159863,2,17,0,17,3,1
376941,2,3,6,-3,15,1
337229,3,16,23,-7,14,1
312344,2,7,17,-10,3,1
221939,4,19,19,0,14,0
46515,4,37,6,31,4,1
354195,2,6,7,-1,4,0
76325,2,13,3,10,1,0
150073,4,31,12,19,16,1
91781,2,3,0,3,8,0
201522,3,32,7,25,5,0
97594,1,0,0,0,11,1
315887,4,9,26,-17,4,1
7768,3,30,3,27,4,1
401979,2,3,9,-6,9,0
376207,2,10,7,3,14,1
339070,1,0,0,0,15,1
315862,4,9,19,-10,4,0
196762,4,54,13,41,3,0
40797,4,17,28,-11,2,0
315252,4,20,16,4,4,0
176225,4,14,24,-10,11,0
80484,2,5,3,2,3,1
71918,3,15,13,2,16,1
134039,2,13,3,10,9,1
244425,4,3,20,-17,7,1
246070,3,19,13,6,7,0
379992,1,0,0,0,16,1
411424,1,7,13,-6,13,0
199057,2,0,14,-14,4,1
364042,4,6,24,-18,8,0
344174,4,35,11,24,17,0
143217,3,10,13,-3,13,0
39802,4,12,7,5,1,0
101495,1,10,0,10,12,1
399851,1,0,0,0,8,1
400028,1,7,3,4,8,0
293488,2,10,3,7,11,0
49237,3,17,10,7,6,0
295356,1,3,0,3,12,1
374344,4,28,13,15,13,0
74849,3,20,20,0,17,1
235563,3,24,13,11,3,0
255492,2,10,7,3,12,1
218438,2,17,14,3,13,0
417633,2,14,3,11,16,1
305040,1,6,0,6,16,1
184365,2,7,6,1,14,1
169846,3,17,17,0,8,1
220298,4,26,9,17,13,0
74566,4,10,3,7,17,0
25609,4,30,10,20,12,1
279173,1,0,0,0,5,0
234789,2,0,3,-3,2,1
399233,3,13,13,0,7,0
320289,3,14,21,-7,6,1
368847,2,23,0,23,11,1
181198,1,0,0,0,13,0
5393,3,13,13,0,3,0
45976,4,20,3,17,4,1
253426,3,14,28,-14,11,0
72749,1,14,0,14,16,0
132366,1,0,0,0,9,0
174515,2,7,7,0,10,0
411253,4,11,26,-15,13,0
148478,3,20,3,17,16,1
219700,4,13,14,-1,13,1
98090,1,0,0,0,11,1
65291,2,3,21,-18,13,1
225116,4,16,14,2,15,0
403274,1,3,0,3,9,1
259499,3,28,10,18,13,1
63006,2,6,14,-8,12,0
178806,2,24,14,10,12,1
273474,2,7,13,-6,2,1
304385,4,28,21,7,16,1
123312,2,14,7,7,4,1
246296,1,7,3,4,7,0
401455,4,24,10,14,8,1
321781,3,18,9,9,7,0
238261,4,10,24,-14,4,0
380133,5,38,38,0,16,0
282566,4,17,24,-7,6,1
106373,4,21,19,2,14,1
276758,1,14,3,11,4,1
134580,2,10,3,7,10,1
405430,3,14,10,4,10,1
188476,4,10,9,1,16,0
290148,1,0,0,0,10,1
125880,2,13,10,3,6,1
389999,4,31,25,6,3,1
343880,4,26,6,20,17,0
162332,2,3,7,-4,4,1
102945,3,12,24,-12,13,1
226865,2,0,7,-7,16,1
173664,4,13,22,-9,10,0
174026,2,0,13,-13,10,1
86333,4,27,23,4,5,0
359727,2,17,6,11,6,0
343663,3,15,10,5,17,0
400045,1,14,3,11,8,0
414418,3,7,20,-13,14,0
369912,4,13,16,-3,12,1
271350,4,16,31,-15,1,0
295600,4,31,32,-1,12,0
280227,1,3,0,3,5,0
87320,4,24,24,0,6,0
138104,1,0,0,0,11,1
397025,3,21,6,15,6,0
344176,4,35,11,24,17,0
17464,1,0,0,0,9,1
119453,3,7,17,-10,3,1
178330,2,14,3,11,12,0
55607,4,27,7,20,9,0
34788,4,20,3,17,16,0
288787,1,3,7,-4,9,1
126719,3,10,13,-3,6,1
162190,2,7,7,0,4,1
252038,4,14,20,-6,10,0
304296,1,0,0,0,16,1
221791,4,13,21,-8,14,0
51072,4,3,23,-20,6,1
274361,2,3,7,-4,3,0
241679,2,7,3,4,5,0
379990,1,0,0,0,16,1
268190,4,12,17,-5,17,0
180592,1,7,3,4,13,1
311644,3,6,6,0,2,0
91056,3,9,0,9,7,0
212796,3,17,21,-4,10,1
396792,1,0,0,0,6,0
181401,2,17,14,3,13,0
337671,3,24,13,11,14,1
379311,2,3,6,-3,16,1
26592,3,10,6,4,13,0
283628,4,20,20,0,7,0
18387,1,0,0,0,9,0
386177,2,3,3,0,2,1
263390,1,0,0,0,15,0
191526,2,14,21,-7,17,1
213956,2,23,7,16,10,0
213647,2,7,14,-7,10,0
75353,4,28,33,-5,17,1
353263,2,28,17,11,4,0
76682,4,13,7,6,1,1
4368,3,7,7,0,2,0
155693,2,10,13,-3,2,1
149997,2,14,3,11,16,1
211318,2,10,3,7,9,1
89082,3,13,6,7,6,0
160981,3,10,7,3,4,1
174378,3,17,3,14,10,0
191241,3,7,17,-10,17,0
247903,3,17,6,11,8,0
157203,1,7,0,7,2,0
104426,1,0,0,0,13,0
218612,3,7,23,-16,13,1
91045,3,9,0,9,7,1
376107,3,0,9,-9,14,1
81029,4,23,23,0,3,0
355406,2,10,10,0,4,0
255256,4,13,17,-4,12,1
350566,1,10,0,10,2,0
416899,2,3,7,-4,15,0
113679,1,0,0,0,17,0
172891,3,24,24,0,9,1
95598,4,12,10,2,10,0
373345,2,7,0,7,13,0
1376,2,7,0,7,1,1
412755,1,0,10,-10,14,1
307466,2,28,13,15,17,1
87297,3,24,17,7,6,1
311984,4,35,17,18,2,1
374963,1,7,6,1,14,0
51134,2,7,3,4,7,1
384163,3,21,20,1,1,1
57056,3,7,20,-13,9,1
255919,2,3,3,0,12,1
174214,3,3,23,-20,10,0
407733,3,10,0,10,11,1
369085,1,3,0,3,11,0
339866,2,23,0,23,15,0
216214,3,17,3,14,12,0
61987,2,3,0,3,12,0
133954,4,13,6,7,9,1
395864,4,10,17,-7,6,0
420308,2,14,0,14,17,0
415063,4,13,34,-21,15,0
371257,1,0,0,0,12,0
245972,1,0,0,0,7,1
357048,1,6,7,-1,5,1
386820,3,10,14,-4,2,1
306494,4,17,17,0,17,0
286557,2,10,21,-11,8,1
96,3,7,7,0,1,1
166943,4,16,9,7,6,0
328876,1,3,0,3,10,1
353109,2,10,22,-12,3,0
266335,2,10,0,10,16,0
62544,1,3,0,3,12,1
84390,1,3,0,3,4,1
398278,1,3,0,3,7,0
94758,1,3,3,0,9,0
416538,4,38,17,21,15,0
261593,4,12,15,-3,14,1
177756,4,13,17,-4,12,0
76022,2,10,13,-3,1,0
20283,1,7,0,7,10,0
307509,3,38,13,25,17,1
193749,4,10,27,-17,1,0
294046,2,7,14,-7,12,0
8816,4,19,0,19,4,1
352963,2,13,3,10,3,1
178632,2,3,3,0,12,1
155673,2,3,13,-10,2,1
70077,4,31,17,14,15,1
330800,1,3,10,-7,11,1
246882,1,0,0,0,8,0
300019,2,0,20,-20,14,0
164927,3,0,6,-6,6,1
135610,1,7,0,7,10,0
200898,3,17,0,17,4,0
131626,1,0,6,-6,8,1
339238,2,14,0,14,15,0
369521,2,3,0,3,11,0
159938,4,38,17,21,3,1
32801,2,6,0,6,15,1
380690,3,7,7,0,16,1
217494,3,19,3,16,12,0
421059,1,6,0,6,17,0
375284,1,7,0,7,14,0
232263,4,18,12,6,1,0
131620,1,0,3,-3,8,0
329979,4,7,10,-3,11,1
33367,2,13,10,3,16,0
419546,1,7,7,0,17,0
37869,1,0,0,0,1,0
317924,1,7,0,7,5,0
224230,1,0,0,0,15,0
134675,4,34,31,3,10,1
268885,2,6,17,-11,17,1
392014,2,7,7,0,4,0
35087,4,15,19,-4,16,0
4349,2,0,7,-7,2,1
297210,2,0,3,-3,13,0
260149,1,0,0,0,14,1
414720,3,3,17,-14,14,1
150581,2,3,13,-10,17,1
96599,2,3,3,0,10,0
136440,2,10,7,3,11,0
173913,2,13,16,-3,10,1
164138,1,0,0,0,5,1
170195,4,24,30,-6,8,1
82326,3,6,10,-4,3,0
108163,4,20,42,-22,15,1
112631,4,38,34,4,17,1
42595,1,0,0,0,3,1
55977,3,10,20,-10,9,1
221716,2,10,0,10,14,1
148860,1,0,0,0,16,0
138572,5,31,37,-6,12,0
417129,1,0,0,0,16,1
144710,2,3,0,3,14,1
225386,4,24,34,-10,15,0
261031,1,0,0,0,14,0
37674,3,30,0,30,17,0
163310,3,13,16,-3,5,0
226305,3,19,7,12,16,1
150779,4,13,9,4,17,1
314423,1,0,0,0,3,1
45386,4,20,23,-3,4,0
413782,1,0,0,0,14,0
36061,2,23,0,23,17,1
375541,4,33,14,19,14,0
248135,2,3,3,0,8,1
420817,3,10,10,0,17,1
196827,2,0,10,-10,3,1
269337,2,7,7,0,1,0
167453,1,0,0,0,7,1
396699,2,7,7,0,6,0
313295,2,6,14,-8,3,0
174193,2,3,16,-13,10,1
82286,2,3,3,0,3,1
156749,1,7,7,0,2,1
337020,2,13,0,13,14,1
51102,1,0,0,0,7,1
253406,2,14,28,-14,11,0
371888,3,24,10,14,12,1
253401,2,14,28,-14,11,1
41859,1,7,0,7,2,0
259212,4,21,32,-11,13,1
12334,1,0,0,0,6,1
28572,4,33,7,26,14,0
289523,4,28,7,21,10,0
232219,3,9,12,-3,1,1
241231,2,3,0,3,5,0
193858,3,24,7,17,1,1
232365,3,13,15,-2,1,0
137211,2,7,3,4,11,0
69198,4,20,17,3,15,0
322837,4,3,40,-37,7,1
276134,1,0,0,0,3,1
325919,2,10,7,3,9,1
248653,4,24,10,14,9,0
310723,1,3,3,0,2,1
164449,2,14,0,14,5,0
197604,3,19,0,19,3,1
76546,4,7,34,-27,1,0
387810,1,10,0,10,2,1
408567,1,7,0,7,12,1
54506,3,7,7,0,8,0
321225,4,10,22,-12,6,1
21040,4,21,31,-10,10,0
150183,3,6,26,-20,16,0
296575,1,0,0,0,13,1
185463,4,17,20,-3,15,1
349282,2,13,21,-8,2,0
96853,1,10,0,10,10,1
21499,1,0,0,0,11,0
54352,2,14,19,-5,8,0
58375,2,21,0,21,10,1
345769,4,19,10,9,17,0
328480,3,6,3,3,10,0
114664,3,3,10,-7,1,0
79815,4,35,21,14,2,0
102912,2,6,20,-14,13,0
298895,4,24,23,1,14,1
395404,4,28,3,25,5,0
321709,1,3,3,0,7,0
84190,4,17,10,7,4,0
314434,1,7,0,7,3,0
62617,3,9,17,-8,12,0
133195,3,13,17,-4,9,0
254517,4,29,13,16,11,0
193688,2,3,20,-17,1,0
418531,1,0,0,0,16,1
371095,4,13,27,-14,12,1
198364,4,20,14,6,3,1
6661,2,3,10,-7,3,0
195254,3,23,17,6,2,0
13269,2,0,13,-13,7,0
15501,3,16,6,10,8,1
385148,3,14,17,-3,1,0
166560,1,6,7,-1,6,1
174005,1,0,6,-6,10,0
259875,2,7,7,0,14,1
170473,4,21,10,11,8,1
296133,1,10,6,4,13,0
300086,4,7,40,-33,14,1
244266,3,23,7,16,6,1
37819,4,14,9,5,1,0
81609,4,30,24,6,3,0
298755,1,0,0,0,14,1
341641,2,3,3,0,16,1
119384,1,0,14,-14,3,1
329032,1,0,7,-7,10,1
224449,2,9,10,-1,15,1
420663,3,21,16,5,17,1
4882,2,14,0,14,3,0
418821,1,0,3,-3,16,1
285833,4,14,27,-13,8,1
264668,1,0,0,0,16,1
45951,4,17,3,14,4,0
21056,4,34,34,0,10,1
73511,3,3,31,-28,17,0
357851,3,6,24,-18,6,0
329446,1,0,0,0,10,1
116874,2,7,7,0,2,0
7777,3,30,3,27,4,0
254322,3,6,19,-13,11,1
111142,4,31,10,21,16,1
399822,4,11,27,-16,8,1
409496,2,0,0,0,12,1
220440,3,23,14,9,13,0
387712,3,0,16,-16,2,0
347668,3,20,17,3,1,1
136366,1,0,0,0,11,1
175232,2,12,0,12,10,1
317234,3,7,16,-9,5,1
269206,2,3,3,0,17,0
390462,4,21,33,-12,3,1
293982,4,7,28,-21,12,1
53096,2,19,14,5,7,0
353117,3,10,29,-19,3,1
262773,3,28,17,11,15,1
341189,2,10,0,10,16,0
222554,4,17,14,3,14,1
28383,2,13,0,13,14,0
49355,3,7,10,-3,6,1
68097,4,3,10,-7,14,0
94138,2,3,7,-4,9,1
344929,2,3,7,-4,17,1
253209,2,0,7,-7,11,1
166607,3,22,14,8,6,1
139653,1,0,0,0,12,0
190842,3,16,3,13,17,0
383347,1,0,0,0,17,0
371207,3,14,19,-5,12,0
63278,1,0,0,0,12,1
107493,3,3,20,-17,15,1
233269,2,0,3,-3,2,1
10789,2,14,0,14,5,1
176866,4,17,16,1,11,0
244009,2,7,7,0,6,0
40855,1,0,3,-3,2,1
69739,3,16,7,9,15,0
79075,4,19,21,-2,2,0
331016,3,39,7,32,11,0
245400,2,9,3,6,7,0
274999,2,24,3,21,3,0
199132,3,14,31,-17,4,0
12565,3,3,17,-14,6,0
105439,4,23,24,-1,14,1
240608,2,13,7,6,5,1
259561,1,0,0,0,13,1
353904,3,17,28,-11,4,1
21818,1,0,0,0,11,1
77918,1,0,0,0,1,1
39169,4,27,10,17,1,0
175625,1,0,0,0,11,0
281597,1,7,0,7,6,1
100081,3,6,6,0,12,1
337773,2,20,6,14,14,1
205316,2,17,0,17,6,0
242320,2,10,10,0,6,0
233451,3,23,10,13,2,0
186119,1,3,0,3,15,0
384338,4,16,10,6,1,1
344105,2,10,3,7,17,1
181488,4,31,31,0,13,1
399999,4,12,13,-1,8,1
235388,2,21,7,14,3,0
409859,3,23,0,23,12,0
56667,1,0,0,0,9,0
306583,2,0,17,-17,17,0
419247,1,0,0,0,16,1
155746,4,20,23,-3,2,1
281758,1,0,0,0,6,0
23969,4,16,6,10,12,1
155727,3,20,20,0,2,0
373120,4,10,21,-11,13,1
238243,4,3,16,-13,4,1
316123,3,24,16,8,4,1
118140,3,23,20,3,2,0
415281,2,0,7,-7,15,0
352532,2,20,6,14,3,0
241095,2,13,7,6,5,1
234613,2,17,10,7,2,0
416286,1,10,3,7,15,1
9551,5,20,20,0,5,1
208148,2,0,0,0,8,0
288939,1,6,0,6,9,0
274024,1,0,0,0,3,1
21442,3,12,14,-2,11,0
288302,1,0,0,0,9,0
112595,3,30,26,4,17,1
156114,1,7,7,0,2,1
226041,1,0,0,0,16,1
162067,3,21,13,8,4,1
23450,1,7,0,7,11,0
121064,3,11,31,-20,3,1
167267,4,30,23,7,7,0
337881,1,10,0,10,14,1
198436,2,3,3,0,3,0
306703,1,3,3,0,17,1
311871,1,7,0,7,2,1
203396,4,27,33,-6,6,1
317961,2,10,10,0,5,0
121756,4,28,42,-14,4,0
369000,3,10,7,3,11,0
269557,4,21,31,-10,1,0
90449,2,0,13,-13,7,1
121599,4,22,16,6,4,1
190828,3,16,3,13,17,1
60710,3,21,3,18,11,0
411356,4,20,10,10,13,1
209852,2,13,13,0,8,0
90378,1,0,0,0,7,0
389124,4,30,7,23,3,1
121367,3,7,0,7,3,0
309286,3,0,20,-20,1,1
288226,2,3,14,-11,9,0
333891,1,0,0,0,12,1
228422,4,10,27,-17,17,1
341702,3,23,13,10,16,1
33487,1,7,0,7,16,1
119732,1,7,3,4,3,1
416772,2,7,10,-3,15,1
330760,5,9,9,0,11,1
109367,1,0,7,-7,16,1
71286,2,7,10,-3,16,1
302622,2,10,3,7,15,1
360807,4,24,30,-6,7,0
301550,1,0,0,0,15,1
13562,2,3,0,3,7,1
323301,1,0,0,0,7,1
167767,5,26,26,0,7,0
233593,3,20,34,-14,2,1
59759,2,9,10,-1,11,1
166202,4,35,19,16,6,0
69212,5,20,20,0,15,0
164835,1,0,3,-3,6,1
164045,2,3,3,0,5,1
339850,2,16,0,16,15,1
333656,2,7,0,7,12,0
181489,4,31,31,0,13,1
114761,1,0,3,-3,1,1
131116,3,20,9,11,8,1
269581,4,24,31,-7,1,1
214365,1,0,7,-7,11,1
409067,2,3,7,-4,12,0
59316,2,0,6,-6,11,1
75798,4,42,26,16,1,1
375817,3,20,7,13,14,1
296763,2,7,0,7,13,1
104151,4,24,27,-3,13,1
16641,3,7,27,-20,8,0
218795,4,3,19,-16,13,1
207617,3,35,10,25,7,1
263650,3,20,10,10,15,0
33829,3,3,31,-28,16,0
96712,2,0,7,-7,10,0
28483,1,17,0,17,14,0
64430,2,0,6,-6,13,1
377704,3,25,7,18,15,1
155254,3,28,14,14,1,0
249808,1,3,3,0,9,1
73068,3,7,10,-3,16,1
13814,4,7,36,-29,7,0
377420,3,7,13,-6,15,0
180427,1,7,7,0,13,0
197716,2,7,10,-3,3,0
111261,3,10,13,-3,16,1
178410,4,38,34,4,12,0
157451,3,16,17,-1,2,0
141922,1,7,0,7,13,1
403209,4,24,17,7,9,0
19126,2,7,3,4,10,1
208714,1,0,0,0,8,1
286585,3,17,31,-14,8,0
282794,2,0,13,-13,6,1
261412,3,10,24,-14,14,1
118493,1,7,0,7,2,1
155228,2,21,7,14,1,0
236548,3,10,9,1,3,1
337425,1,0,0,0,14,1
153394,2,10,10,0,1,0
73302,1,7,0,7,17,0
18135,2,3,17,-14,9,1
26426,2,17,10,7,13,0
195807,3,20,14,6,2,1
105251,3,7,24,-17,14,1
380210,2,13,15,-2,16,0
225811,3,17,14,3,16,0
57459,2,13,3,10,10,1
183294,4,22,20,2,14,0
375016,3,21,27,-6,14,0
365807,4,31,17,14,9,1
151971,4,33,27,6,17,1
392339,2,14,21,-7,4,0
136183,4,13,10,3,10,0
409625,1,0,0,0,12,0
271337,4,16,24,-8,1,0
325774,2,0,10,-10,9,1
34902,3,27,10,17,16,0
404117,1,6,0,6,10,1
169417,4,6,31,-25,8,1
67518,4,39,14,25,14,0
367232,1,0,0,0,10,1
35228,4,0,17,-17,16,1
387105,2,10,21,-11,2,1
294210,2,0,7,-7,12,1
309940,1,0,0,0,2,1
382702,3,3,6,-3,17,0
192203,4,3,27,-24,1,1
60360,2,10,7,3,11,0
210391,1,6,0,6,9,0
322859,1,0,0,0,7,1
121691,3,14,7,7,4,0
3497,4,10,30,-20,2,1
217312,2,0,7,-7,12,0
303928,3,14,24,-10,16,0
197296,2,14,0,14,3,0
54391,3,24,19,5,8,1
14318,3,2,7,-5,7,1
45433,2,13,7,6,4,1
57339,2,7,3,4,10,0
105622,1,0,0,0,14,1
277058,2,3,0,3,4,0
273383,4,38,7,31,2,0
325573,1,7,0,7,9,1
119366,1,0,0,0,3,1
225920,2,20,0,20,16,0
17457,1,0,0,0,9,0
237047,2,0,17,-17,3,1
112747,3,10,7,3,17,1
109564,2,9,7,2,16,0
310566,1,3,13,-10,2,1
113429,2,0,7,-7,17,1
19238,1,0,7,-7,10,1
321789,4,18,9,9,7,1
267953,2,0,3,-3,17,1
408389,4,19,14,5,12,0
323853,4,16,23,-7,8,0
229704,2,13,7,6,17,0
365891,3,14,14,0,9,1
190066,2,17,3,14,17,1
375492,3,26,7,19,14,0
204134,3,3,10,-7,6,1
184956,3,7,17,-10,15,1
234018,2,14,0,14,2,1
306056,3,17,13,4,17,0
141238,3,10,24,-14,13,0
255288,4,13,17,-4,12,1
174042,2,0,26,-26,10,1
305801,1,0,7,-7,17,1
355059,1,0,6,-6,4,0
75492,4,31,7,24,17,1
9424,1,0,0,0,5,1
161202,1,0,3,-3,4,1
158624,2,7,7,0,3,1
397261,1,0,7,-7,6,0
329393,4,16,34,-18,10,0
47344,3,3,10,-7,5,1
283080,1,3,0,3,7,1
391985,2,0,7,-7,4,0
103792,2,6,0,6,13,0
320131,3,17,0,17,6,0
305703,2,3,7,-4,17,1
239881,3,13,3,10,4,1
301716,1,0,3,-3,15,0
165368,2,3,10,-7,6,0
247425,3,10,9,1,8,1
90152,3,3,0,3,7,1
77757,1,7,0,7,1,0
21244,2,3,0,3,11,0
303969,4,14,34,-20,16,1
332125,1,0,0,0,12,1
335144,2,17,0,17,13,1
79272,2,9,3,6,2,1
350900,2,3,14,-11,3,0
126768,4,19,20,-1,6,1
403966,4,20,24,-4,10,1
130978,3,10,27,-17,8,1
82811,3,12,16,-4,3,1
322757,2,3,20,-17,7,0
369756,4,38,36,2,11,0
140866,2,17,0,17,13,0
17571,4,13,17,-4,9,1
184690,4,10,24,-14,15,1
298126,3,3,34,-31,13,1
307686,4,14,23,-9,17,1
275850,1,3,0,3,3,0
73338,2,13,0,13,17,1
406583,4,20,37,-17,11,1
220065,1,13,0,13,13,0
13258,1,0,6,-6,7,0
279298,4,19,16,3,5,0
152502,3,17,7,10,17,0
160722,4,10,3,7,4,0
134921,2,7,16,-9,10,0
38275,4,13,14,-1,1,0
225515,3,0,21,-21,15,1
397299,3,0,21,-21,6,0
369299,3,14,17,-3,11,0
153550,2,5,14,-9,1,1
410561,2,10,7,3,13,0
238231,3,3,16,-13,4,1
52987,3,27,17,10,7,0
10605,2,0,10,-10,5,0
417008,1,3,0,3,15,1
20875,4,28,16,12,10,0
64209,3,31,6,25,13,1
163061,1,0,3,-3,5,0
242283,2,7,7,0,6,1
376973,3,9,16,-7,15,1
164404,4,33,3,30,5,0
39386,2,0,3,-3,1,1
350529,4,17,19,-2,2,1
282553,4,17,24,-7,6,1
340154,2,20,7,13,15,1
364749,4,12,3,9,9,0
40680,1,0,0,0,2,1
88862,4,19,16,3,6,1
165509,2,0,14,-14,6,1
385474,4,35,10,25,1,0
173448,2,0,7,-7,10,1
417138,1,0,7,-7,16,0
4602,2,7,7,0,2,1
17849,3,16,10,6,9,0
13311,3,7,20,-13,7,0
262097,1,14,3,11,15,1
326759,2,3,7,-4,9,0
41839,4,28,14,14,2,0
356465,2,0,3,-3,5,0
272690,2,9,3,6,2,1
5332,1,7,0,7,3,0
146649,2,7,17,-10,15,1
367033,4,10,38,-28,10,0
224010,2,14,6,8,15,0
334286,3,9,7,2,13,0
391762,4,10,13,-3,4,0
386114,4,24,9,15,1,0
2843,3,24,24,0,2,1
381769,1,0,0,0,17,0
294737,4,13,27,-14,12,1
321457,3,21,20,1,7,0
129552,2,3,17,-14,7,1
6134,4,7,10,-3,3,0
18031,4,22,28,-6,9,0
42832,4,6,37,-31,3,1
12802,2,3,3,0,6,0
244235,3,16,7,9,6,0
237081,3,0,26,-26,3,0
61465,4,24,17,7,11,1
279565,3,10,13,-3,5,0
289712,1,0,7,-7,10,1
36011,1,7,0,7,17,0
11827,2,34,17,17,6,0
101084,2,7,10,-3,12,1
22593,2,19,3,16,11,1
305277,3,28,21,7,16,1
419553,1,7,7,0,17,1
98838,1,7,0,7,11,1
158303,1,6,7,-1,3,0
409375,2,10,3,7,12,1
317650,3,6,6,0,5,0
39571,2,14,6,8,1,0
225568,1,0,0,0,16,0
20574,4,17,0,17,10,0
241993,2,7,3,4,5,0
351673,3,7,10,-3,3,0
303724,2,14,10,4,16,0
76751,1,16,0,16,1,1
421470,1,0,0,0,17,1
3355,4,3,6,-3,2,1
383168,4,26,24,2,17,0
268558,1,7,3,4,17,0
289898,2,6,3,3,10,1
123755,2,7,3,4,5,0
347515,4,12,30,-18,1,1
31520,4,3,17,-14,15,1
145058,4,20,6,14,14,0
75867,2,14,7,7,1,1
75697,1,14,6,8,1,0
233815,4,31,37,-6,2,1
396559,2,17,10,7,6,1
345305,4,19,24,-5,17,1
278779,2,7,0,7,5,0
362523,3,16,6,10,8,0
262850,2,7,20,-13,15,1
410128,3,17,10,7,13,0
50255,2,10,14,-4,6,0
6837,3,10,21,-11,3,1
375469,2,16,7,9,14,0
130551,4,13,6,7,8,0
352400,2,35,7,28,3,0
269709,4,10,21,-11,1,0
300074,4,7,40,-33,14,0
127225,4,16,16,0,6,1
386530,3,7,21,-14,2,1
135474,1,7,0,7,10,1
229161,4,19,7,12,17,0
302843,4,12,23,-11,15,0
67605,2,0,26,-26,14,0
33972,3,10,27,-17,16,0
278422,1,6,0,6,4,1
153110,2,6,10,-4,1,0
167024,2,10,14,-4,7,0
412360,3,20,17,3,13,0
225213,3,3,7,-4,15,0
127357,4,10,20,-10,6,0
52336,2,3,3,0,7,0
396697,2,7,7,0,6,0
342560,2,9,13,-4,16,1
338963,2,13,0,13,15,0
2078,2,0,7,-7,1,1
400984,3,19,7,12,8,1
65949,4,24,21,3,13,1
272347,2,14,0,14,2,1
173908,2,13,10,3,10,1
218829,1,0,3,-3,13,1
72639,2,13,0,13,16,0
364181,4,34,3,31,9,1
132163,4,23,6,17,9,0
347534,4,20,37,-17,1,1
139057,1,6,0,6,12,0
66597,2,0,14,-14,14,0
285287,3,14,9,5,7,1
308023,4,21,12,9,1,1
276653,3,20,6,14,4,0
70117,1,10,0,10,15,1
266796,3,10,14,-4,16,0
329967,3,7,10,-3,11,0
256300,4,14,17,-3,12,0
87442,4,20,10,10,6,0
306478,3,10,17,-7,17,1
255475,2,7,0,7,12,1
202318,3,13,3,10,5,1
185444,4,17,10,7,15,0
354994,3,7,19,-12,4,1
222113,4,34,17,17,14,0
13755,3,0,20,-20,7,1
57650,3,17,10,7,10,1
304526,3,10,14,-4,16,0
345516,1,7,10,-3,17,0
293392,3,16,10,6,11,0
419766,3,17,17,0,17,0
135714,4,17,29,-12,10,1
284198,3,9,20,-11,7,0
409772,1,6,0,6,12,1
69923,4,34,23,11,15,0
77554,4,20,14,6,1,1
292425,2,3,0,3,11,1
228649,2,13,14,-1,17,1
173720,1,0,3,-3,10,1
360614,3,7,10,-3,7,0
231042,3,24,0,24,1,0
249689,2,17,14,3,9,1
411821,4,0,34,-34,13,1
232672,3,7,0,7,1,1
107103,4,40,6,34,15,0
89829,2,6,6,0,7,1
172544,2,6,21,-15,9,1
384337,4,16,9,7,1,0
393096,3,10,3,7,4,1
341192,2,10,7,3,16,1
22257,1,0,0,0,11,1
305390,2,17,3,14,17,0
410304,3,7,23,-16,13,1
195088,3,7,26,-19,2,0
348863,3,3,14,-11,2,1
53524,2,7,6,1,8,1
182523,4,35,14,21,14,0
389020,1,13,0,13,3,0
311913,2,14,7,7,2,1
172298,4,24,20,4,9,0
361944,3,10,3,7,7,1
106355,4,14,19,-5,14,1
174486,1,7,7,0,10,1
289922,3,6,3,3,10,1
164861,1,0,3,-3,6,0
68964,2,21,7,14,15,0
370668,4,24,14,10,12,1
28482,1,17,0,17,14,0
57368,3,14,3,11,10,0
242530,4,25,13,12,6,0
115249,2,0,9,-9,1,0
416986,4,10,17,-7,15,1
121321,2,0,0,0,3,0
162648,2,10,10,0,5,0
159873,2,17,0,17,3,0
157883,2,6,15,-9,3,1
12549,3,3,17,-14,6,1
39679,2,3,0,3,1,0
280561,2,14,6,8,5,1
100502,3,7,17,-10,12,1
179702,1,0,0,0,12,0
408812,3,13,25,-12,12,0
374821,2,7,0,7,14,1
122957,1,0,0,0,4,1
341948,2,6,0,6,16,1
259579,2,0,0,0,13,0
411423,1,7,7,0,13,0
402199,4,19,14,5,9,1
56861,1,0,0,0,9,1
213150,1,0,0,0,10,1
374867,3,14,3,11,14,0
345254,3,13,14,-1,17,0
18121,2,3,17,-14,9,0
179520,2,0,16,-16,12,0
354346,2,35,3,32,4,1
156667,3,6,7,-1,2,0
72370,3,10,20,-10,16,0
395377,3,28,3,25,5,0
220208,1,17,0,17,13,0
249202,2,9,7,2,9,1
282962,2,14,3,11,6,1
344250,3,7,13,-6,17,0
342930,4,23,17,6,16,1
183539,2,7,10,-3,14,0
366140,2,7,28,-21,10,1
411690,1,0,0,0,13,0
40076,4,20,14,6,1,0
382276,3,17,3,14,17,1
37185,2,3,7,-4,17,0
376068,2,0,3,-3,14,0
369022,4,13,7,6,11,1
409270,3,13,13,0,12,1
52909,1,0,0,0,7,1
382677,2,0,6,-6,17,1
342434,3,10,3,7,16,0
340944,3,10,10,0,15,1
30790,4,31,35,-4,15,0
209938,4,44,23,21,8,1
210944,4,26,16,10,9,1
194009,2,14,7,7,1,1
127097,1,3,2,1,6,0
20287,1,7,3,4,10,0
353272,3,28,20,8,4,1
401989,3,3,9,-6,9,1
336530,2,0,0,0,14,0
99250,4,31,20,11,11,1
238160,2,3,9,-6,4,0
5605,1,0,0,0,3,0
211443,1,3,7,-4,9,1
411548,1,0,7,-7,13,0
234209,3,20,10,10,2,1
123899,1,0,0,0,5,1
378814,1,0,0,0,15,0
375916,2,14,3,11,14,0
382026,4,7,33,-26,17,0
290564,4,23,20,3,10,0
274029,1,0,0,0,3,1
283971,1,0,0,0,7,1
26541,1,3,3,0,13,1
417797,1,7,0,7,16,1
41755,2,0,7,-7,2,1
41810,3,13,14,-1,2,1
172510,1,0,0,0,9,0
150655,4,17,22,-5,17,0
69712,2,10,7,3,15,1
333476,1,3,0,3,12,1
134657,4,34,24,10,10,0
205894,4,29,7,22,7,0
365438,2,7,19,-12,9,1
7153,4,34,21,13,4,0
409796,1,10,0,10,12,0
182398,4,24,20,4,14,0
336049,4,16,28,-12,13,1
208306,2,7,21,-14,8,0
340630,2,13,3,10,15,1
407025,4,11,34,-23,11,0
307722,1,0,0,0,1,1
190064,2,17,3,14,17,1
355644,4,38,17,21,5,0
78986,2,0,7,-7,2,1
55792,2,0,7,-7,9,1
280901,4,21,3,18,6,0
329617,2,10,7,3,11,1
45558,1,0,13,-13,4,1
91907,1,0,3,-3,8,1
405179,4,12,16,-4,10,1
310596,2,10,20,-10,2,1
39225,2,3,0,3,1,0
7803,4,30,9,21,4,0
412589,1,0,0,0,14,1
361364,3,10,7,3,7,1
416709,1,0,0,0,15,1
12403,3,10,6,4,6,0
149437,4,13,27,-14,16,1
239855,2,10,3,7,4,1
322590,2,3,3,0,7,0
125187,3,17,7,10,5,1
418019,3,21,35,-14,16,0
1072,2,7,29,-22,1,1
202168,4,13,6,7,5,0
81352,1,0,7,-7,3,1
210468,3,9,14,-5,9,0
138937,2,7,3,4,12,0
5212,2,7,10,-3,3,1
238028,3,10,13,-3,4,1
29624,4,14,21,-7,14,1
29861,2,9,16,-7,14,1
388713,1,0,0,0,3,0
331657,4,31,33,-2,11,1
56087,1,7,0,7,9,1
220635,1,0,0,0,13,1
139931,1,7,3,4,12,1
241964,1,7,0,7,5,0
169065,3,33,14,19,7,0
225124,4,16,14,2,15,0
348093,3,0,19,-19,1,1
152039,2,3,0,3,17,0
144893,3,14,7,7,14,0
52196,2,7,3,4,7,0
47379,4,3,13,-10,5,0
86622,4,47,3,44,5,0
264048,1,7,14,-7,15,1
239431,3,9,10,-1,4,0
208931,3,14,6,8,8,1
315508,2,6,3,3,4,1
116249,1,10,0,10,1,0
284801,3,26,20,6,7,1
193081,2,0,6,-6,1,1
358629,4,27,16,11,6,1
101680,2,3,0,3,12,1
262377,1,0,0,0,15,0
299769,4,17,14,3,14,1
406571,4,20,37,-17,11,1
86039,4,25,29,-4,5,1
238457,1,3,0,3,4,1
394439,2,7,10,-3,5,0
378153,2,21,9,12,15,0
135068,2,17,3,14,10,0
336282,2,10,0,10,13,1
148935,2,3,9,-6,16,0
137739,3,10,27,-17,11,0
405151,4,6,10,-4,10,1
321263,2,6,9,-3,6,0
141263,4,10,24,-14,13,1
105832,2,13,3,10,14,0
243724,2,17,3,14,6,1
415542,1,0,0,0,15,1
265070,2,13,3,10,16,1
181832,2,14,7,7,13,1
375066,4,28,30,-2,14,0
74744,4,14,17,-3,17,1
45601,2,7,13,-6,4,1
254107,1,0,6,-6,11,1
286662,1,7,0,7,8,1
311263,4,6,3,3,2,1
92937,1,0,0,0,8,0
34752,3,13,3,10,16,1
148485,3,21,3,18,16,1
201408,1,6,0,6,5,0
235704,2,3,10,-7,3,0
256551,2,7,0,7,12,1
388251,1,3,0,3,2,0
122157,4,24,21,3,4,0
297954,2,20,7,13,13,1
102034,2,14,3,11,12,1
53778,5,10,10,0,8,1
210781,4,24,10,14,9,0
26130,2,0,13,-13,13,1
202341,4,20,6,14,5,0
324252,2,3,0,3,8,1
77029,1,7,7,0,1,0
30180,3,13,17,-4,14,1
388355,4,17,12,5,2,1
96329,3,3,16,-13,10,0
87654,1,0,7,-7,6,1
103190,2,3,0,3,13,1
405445,3,21,10,11,10,1
20333,2,10,13,-3,10,1
201873,4,31,30,1,5,1
226981,1,3,3,0,16,1
346107,4,10,12,-2,1,0
20227,4,24,10,14,10,1
249999,2,7,6,1,9,1
165200,2,0,7,-7,6,1
419771,4,17,17,0,17,1
161456,3,7,3,4,4,0
217202,4,12,19,-7,12,0
71624,3,3,31,-28,16,0
208000,2,14,0,14,8,1
48505,1,11,0,11,5,0
395117,4,24,34,-10,5,0
243292,3,7,10,-3,6,1
226894,3,3,10,-7,16,1
298160,4,10,41,-31,13,1
48533,2,11,0,11,5,0
191015,4,26,3,23,17,0
377278,3,14,6,8,15,1
108992,3,16,27,-11,15,0
361186,1,0,7,-7,7,1
315882,4,9,19,-10,4,0
346147,1,7,0,7,1,1
36259,4,23,27,-4,17,1
51892,2,6,10,-4,7,0
208103,1,0,0,0,8,1
96917,3,22,7,15,10,0
341330,2,0,10,-10,16,1
343559,4,10,10,0,16,1
15824,4,8,12,-4,8,0
372220,4,9,25,-16,13,1
163305,3,13,16,-3,5,1
167666,2,10,20,-10,7,0
345089,2,6,3,3,17,0
116707,2,6,10,-4,2,0
16947,3,27,20,7,8,1
127770,2,10,21,-11,6,0
38308,1,0,0,0,1,1
119813,3,24,13,11,3,0
301883,2,0,6,-6,15,0
90659,4,27,33,-6,7,0
75167,4,10,6,4,17,1
29064,1,0,3,-3,14,1
364271,3,0,26,-26,9,1
310664,4,13,33,-20,2,0
418178,3,24,6,18,16,0
73160,1,7,0,7,16,0
85339,3,21,3,18,5,1
392213,3,10,16,-6,4,1
337584,1,7,7,0,14,1
81389,2,7,7,0,3,0
168591,3,14,10,4,7,1
416091,4,21,13,8,15,0
133930,3,6,6,0,9,0
80581,1,0,0,0,3,0
97236,3,12,6,6,10,0
264300,3,10,23,-13,15,1
258686,2,0,14,-14,13,1
246240,4,21,16,5,7,1
61746,4,24,38,-14,12,0
230975,1,0,0,0,1,0
394643,4,17,21,-4,5,1
336618,4,7,0,7,14,0
97090,3,31,6,25,10,0
100926,2,7,3,4,12,1
275314,3,10,8,2,3,0
176137,2,14,7,7,11,1
6487,1,0,0,0,3,1
359139,2,7,0,7,6,0
26253,2,7,14,-7,13,1
351690,3,7,17,-10,3,1
421013,4,14,28,-14,17,0
205140,1,7,0,7,6,0
320749,3,14,23,-9,6,1
79703,1,7,7,0,2,1
35707,1,3,0,3,17,0
380401,3,10,17,-7,16,0
41138,1,0,0,0,2,0
23451,1,7,0,7,11,0
315879,4,9,19,-10,4,0
364077,1,7,3,4,9,1
399515,3,0,26,-26,7,0
297524,2,11,0,11,13,1
196840,3,3,13,-10,3,0
394418,1,0,3,-3,5,0
285937,3,23,7,16,8,1
253206,2,0,7,-7,11,0
168322,3,17,21,-4,7,0
25288,3,34,14,20,12,1
98995,1,0,0,0,11,1
258065,1,3,0,3,13,1
35376,4,23,16,7,16,0
21407,2,6,7,-1,11,1
134975,4,7,25,-18,10,1
190201,2,0,0,0,17,1
387263,3,6,10,-4,2,1
250959,2,3,6,-3,10,1
421810,2,0,10,-10,17,1
258600,3,13,10,3,13,0
392021,2,7,10,-3,4,1
234258,4,20,24,-4,2,1
380567,4,21,24,-3,16,0
195881,1,0,0,0,2,0
84555,1,0,7,-7,4,1
249942,4,18,23,-5,9,0
153252,2,2,0,2,1,0
645,2,0,3,-3,1,0
159749,3,7,10,-3,3,0
197242,1,0,0,0,3,1
14479,3,24,16,8,7,1
295868,2,7,14,-7,12,0
138598,1,3,0,3,12,0
149690,2,20,0,20,16,1
51575,1,7,3,4,7,0
298961,2,6,9,-3,14,1
236427,1,0,0,0,3,0
41893,2,14,3,11,2,1
328833,4,17,20,-3,10,1
46538,4,40,6,34,4,0
417896,4,13,10,3,16,0
304658,3,14,7,7,16,1
8830,4,32,0,32,4,1
311625,2,6,3,3,2,0
238400,4,17,33,-16,4,1
346750,4,27,20,7,1,1
285390,2,10,0,10,8,1
122576,3,14,7,7,4,0
170733,3,24,6,18,8,1
318955,1,0,3,-3,5,1
110014,3,27,10,17,16,0
60822,2,10,13,-3,11,0
44772,4,13,12,1,3,0
336961,4,21,21,0,14,0
69439,3,24,3,21,15,0
16122,4,40,17,23,8,0
121163,2,0,13,-13,3,1
77406,3,14,21,-7,1,0
261217,2,21,0,21,14,0
131753,4,24,28,-4,8,1
202138,3,13,3,10,5,0
163745,2,0,9,-9,5,0
62860,2,3,3,0,12,0
374137,2,16,7,9,13,0
13766,3,7,20,-13,7,0
300178,3,21,3,18,14,1
360497,4,17,6,11,7,0
363708,3,8,13,-5,8,1
123322,2,20,7,13,4,1
356551,4,9,6,3,5,0
374015,3,10,7,3,13,0
279924,1,0,0,0,5,0
90020,3,5,21,-16,7,1
347214,1,0,0,0,1,0
217509,4,19,3,16,12,0
37517,3,10,7,3,17,0
132935,4,13,21,-8,9,1
292576,2,6,9,-3,11,0
328195,4,14,17,-3,10,1
136419,2,10,7,3,11,0
377048,1,0,0,0,15,0
353848,2,7,14,-7,4,1
28302,4,27,14,13,13,0
299207,1,0,0,0,14,0
61310,4,31,21,10,11,0
361479,2,7,0,7,7,0
61303,4,31,20,11,11,0
267869,4,26,17,9,17,1
387005,4,14,21,-7,2,0
357573,3,13,13,0,5,1
140874,2,17,6,11,13,0
64809,1,0,0,0,13,1
67900,3,16,3,13,14,1
350783,4,17,3,14,2,0
316491,4,22,17,5,4,0
315060,3,30,14,16,4,1
79488,4,12,17,-5,2,0
319948,2,23,10,13,6,1
247682,2,7,6,1,8,1
248569,1,0,0,0,9,1
284795,3,26,17,9,7,0
196586,3,20,13,7,2,0
205456,1,14,0,14,6,0
244570,4,25,16,9,7,0
288524,2,3,21,-18,9,1
213560,4,10,14,-4,10,1
236768,2,0,9,-9,3,0
382230,2,10,3,7,17,0
71431,2,24,0,24,16,1
259108,1,0,0,0,13,1
372706,1,0,0,0,13,0
280527,2,7,0,7,5,0
36239,3,10,24,-14,17,0
285843,4,14,27,-13,8,0
236317,2,0,16,-16,3,0
1238,3,10,6,4,1,1
240648,3,20,24,-4,5,1
38669,3,7,7,0,1,1
387019,4,14,28,-14,2,1
364153,4,31,3,28,9,0
6267,3,13,14,-1,3,0
310555,1,0,6,-6,2,1
392309,2,0,14,-14,4,1
318315,3,9,19,-10,5,1
224271,2,6,9,-3,15,0
221180,4,0,23,-23,14,1
397658,4,6,30,-24,7,0
8674,4,7,10,-3,4,0
177102,2,23,13,10,11,1
269232,3,3,6,-3,17,0
373358,2,7,7,0,13,1
338970,2,13,0,13,15,0
172221,2,7,13,-6,9,1
386666,3,14,13,1,2,0
193999,2,14,7,7,1,0
370917,4,20,17,3,12,0
322925,2,13,0,13,7,1
365277,2,10,13,-3,9,0
249466,1,0,0,0,9,1
251519,2,16,13,3,10,1
338700,3,27,10,17,14,0
61913,4,27,30,-3,12,1
338966,2,13,0,13,15,0
345537,2,7,17,-10,17,1
40940,4,16,20,-4,2,1
215782,3,29,6,23,11,0
241234,2,3,0,3,5,1
276925,2,14,14,0,4,1
221544,2,20,12,8,14,0
18460,3,7,7,0,9,0
199358,2,0,3,-3,4,0
276772,2,17,10,7,4,1
207680,1,0,0,0,7,0
160830,3,27,17,10,4,1
363848,3,13,26,-13,8,1
357414,3,17,17,0,5,1
195531,2,6,0,6,2,1
418135,2,21,3,18,16,0
124390,2,6,0,6,5,0
399171,2,7,6,1,7,1
138063,3,36,17,19,11,0
404536,4,34,27,7,10,0
87204,1,0,0,0,6,1
89074,2,13,6,7,6,0
275736,2,7,0,7,3,1
16173,1,0,0,0,8,0
400281,4,24,9,15,8,0
379914,3,14,6,8,16,1
316163,4,24,29,-5,4,0
54674,3,20,29,-9,8,1
137033,1,7,0,7,11,1
309174,4,35,9,26,1,0
115,4,7,7,0,1,0
287405,4,20,10,10,8,1
404347,3,20,6,14,10,0
351335,2,7,7,0,3,0
128730,1,0,0,0,7,1
277943,4,7,27,-20,4,1
154668,4,31,28,3,1,1
117992,3,20,6,14,2,0
313712,2,14,3,11,3,0
359912,3,23,27,-4,6,1
50114,2,0,17,-17,6,0
354331,2,28,3,25,4,1
50869,2,7,17,-10,6,0
241352,1,0,0,0,5,1
343501,3,7,10,-3,16,0
414650,1,0,0,0,14,0
44174,4,13,20,-7,3,0
212546,1,0,0,0,10,0
52457,1,3,0,3,7,1
170604,3,34,9,25,8,1
220430,3,23,14,9,13,1
45997,1,0,7,-7,4,1
60278,4,10,16,-6,11,1
283349,4,10,16,-6,7,1
193763,4,10,27,-17,1,0
316388,2,13,0,13,4,0
380170,2,7,3,4,16,0
125236,4,31,21,10,5,0
319197,3,9,17,-8,5,1
77386,3,13,14,-1,1,1
35818,4,9,10,-1,17,1
98660,4,14,10,4,11,0
86953,2,14,0,14,5,0
158687,3,17,7,10,3,1
384674,1,7,17,-10,1,1
202621,3,24,13,11,5,1
362657,3,3,7,-4,8,0
196949,2,14,0,14,3,0
409943,2,0,14,-14,12,1
68249,4,20,17,3,14,0
204270,2,0,7,-7,6,1
79209,4,20,10,10,2,1
45362,4,20,16,4,4,0
264702,1,7,13,-6,16,1
379064,3,7,6,1,15,1
223216,2,3,6,-3,15,0
404308,2,0,3,-3,10,0
18810,1,0,0,0,9,1
53160,4,19,38,-19,7,0
33895,1,0,3,-3,16,1
271617,3,23,20,3,2,0
252928,2,6,0,6,11,1
223254,3,3,6,-3,15,0
124950,1,0,3,-3,5,1
306645,4,14,27,-13,17,0
383276,3,38,17,21,17,1
351631,1,0,7,-7,3,1
122879,3,24,6,18,4,0
255278,4,13,17,-4,12,1
320761,3,17,23,-6,6,1
85749,1,7,0,7,5,0
147238,2,0,21,-21,15,0
322455,2,12,0,12,7,0
320538,1,14,0,14,6,1
307773,2,17,7,10,1,0
337622,2,14,7,7,14,0
65819,5,34,33,1,13,1
319086,4,26,41,-15,5,1
206720,3,6,14,-8,7,1
194276,2,7,0,7,2,1
335711,2,10,7,3,13,1
133711,1,0,0,0,9,0
89913,1,0,0,0,7,0
153351,1,0,0,0,1,1
114337,2,14,6,8,1,1
197259,2,0,0,0,3,0
185414,3,7,10,-3,15,1
20312,2,10,10,0,10,1
166455,3,17,10,7,6,0
382453,4,0,24,-24,17,1
212033,3,10,37,-27,9,0
406510,2,7,16,-9,11,1
160581,1,0,0,0,4,0
214537,1,0,0,0,11,1
62755,3,14,0,14,12,1
194964,4,14,22,-8,2,1
95039,4,20,16,4,9,0
61900,4,27,23,4,12,1
337440,1,0,6,-6,14,0
332323,3,13,6,7,12,1
43071,3,3,10,-7,3,1
77432,4,27,21,6,1,0
7784,4,30,9,21,4,1
83087,3,6,21,-15,4,0
395832,3,3,14,-11,6,0
177640,1,0,0,0,12,0
13304,2,7,20,-13,7,0
254606,3,14,14,0,11,1
33855,4,9,41,-32,16,1
266504,3,3,15,-12,16,1
397286,2,0,21,-21,6,1
289035,3,26,21,5,9,0
233186,4,36,18,18,2,1
10064,2,28,7,21,5,1
193141,4,13,6,7,1,1
217008,3,6,3,3,12,1
275532,4,26,36,-10,3,1
163296,3,13,13,0,5,0
347587,1,7,7,0,1,1
160289,2,3,0,3,4,1
295574,3,23,25,-2,12,0
235898,3,7,14,-7,3,1
77742,1,0,0,0,1,1
185679,1,7,0,7,15,0
390292,4,17,20,-3,3,1
130839,3,13,12,1,8,0
253321,4,13,13,0,11,1
146151,1,0,0,0,15,1
373266,4,13,16,-3,13,1
414038,4,10,45,-35,14,0
404972,3,9,13,-4,10,1
175733,4,37,13,24,11,1
353361,2,3,0,3,4,1
218733,2,0,13,-13,13,0
80150,2,7,0,7,2,0
80390,4,27,16,11,2,1
297050,2,14,0,14,13,1
359767,3,27,16,11,6,0
234053,3,20,0,20,2,0
364900,4,13,20,-7,9,0
10384,3,10,38,-28,5,1
101909,3,6,13,-7,12,1
103383,3,10,20,-10,13,1
50999,2,0,7,-7,6,0
223753,4,40,13,27,15,0
320394,2,14,0,14,6,0
229998,2,0,6,-6,17,0
314279,1,0,0,0,3,0
31649,3,24,9,15,15,1
401995,3,3,9,-6,9,0
279527,2,10,6,4,5,1
117787,2,6,6,0,2,0
291963,1,0,0,0,11,0
66960,4,21,7,14,14,0
276180,2,17,3,14,3,1
273722,1,0,0,0,2,0
179271,3,26,3,23,12,1
406965,2,3,13,-10,11,0
95130,3,9,17,-8,9,1
284661,3,14,27,-13,7,0
70446,2,14,17,-3,15,0
233213,1,0,0,0,2,1
160827,3,27,17,10,4,0
27310,2,14,3,11,13,1
102070,3,35,10,25,12,0
272560,3,13,3,10,2,1
217102,1,0,0,0,12,0
265281,4,15,6,9,16,1
13114,1,0,0,0,6,1
228411,4,10,20,-10,17,1
107767,2,7,13,-6,15,1
340872,1,0,0,0,15,0
48064,1,0,0,0,5,0
82174,3,13,3,10,3,1
116383,1,0,0,0,1,1
412895,1,0,0,0,14,0
17523,2,13,0,13,9,1
187693,3,13,6,7,16,0
103394,3,10,20,-10,13,1
154303,2,6,14,-8,1,1
281216,4,24,16,8,6,1
378693,1,7,7,0,15,0
406352,2,10,7,3,11,0
125051,4,3,19,-16,5,0
16366,2,21,7,14,8,0
84962,1,6,7,-1,4,1
261529,3,12,0,12,14,0
50000,3,28,10,18,6,1
240704,1,0,0,0,5,0
279158,4,21,23,-2,5,1
203209,3,10,17,-7,5,1
39068,1,6,0,6,1,0
114817,3,13,20,-7,1,0
397338,4,3,24,-21,6,0
17983,2,13,21,-8,9,1
324826,2,3,0,3,8,0
17995,3,16,21,-5,9,0
359873,2,20,21,-1,6,1
158071,3,22,9,13,3,0
21073,1,0,0,0,10,0
180027,3,14,20,-6,13,0
116870,2,7,7,0,2,0
311470,2,10,3,7,2,0
139816,2,10,10,0,12,1
327857,3,16,10,6,10,0
398835,4,21,27,-6,7,1
65570,2,6,3,3,13,0
321211,4,3,19,-16,6,1
253461,4,14,38,-24,11,1
21553,2,7,10,-3,11,0
340432,1,0,0,0,15,0
57219,4,20,7,13,10,0
104652,3,7,3,4,14,1
49730,4,28,31,-3,6,1
413572,3,6,17,-11,14,1
262357,4,16,16,0,15,0
419873,2,3,11,-8,17,1
235931,4,16,21,-5,3,1
98112,2,14,7,7,11,0
195256,3,23,17,6,2,0
419887,3,6,17,-11,17,0
225410,4,27,38,-11,15,1
408915,2,17,9,8,12,1
301832,4,6,34,-28,15,1
222836,4,23,13,10,14,1
41372,4,14,12,2,2,1
146378,2,10,3,7,15,0
271739,2,13,10,3,2,0
83641,1,0,0,0,4,0
288845,2,10,17,-7,9,0
329207,2,10,13,-3,10,1
83353,2,0,14,-14,4,1
5823,3,27,7,20,3,0
412324,2,7,14,-7,13,1
294921,1,0,7,-7,12,1
207224,4,20,20,0,7,0
114118,4,21,13,8,17,0
115570,3,24,9,15,1,1
4233,3,10,6,4,2,1
209093,3,3,20,-17,8,0
238343,2,3,16,-13,4,1
145883,1,0,0,0,15,0
73409,4,30,3,27,17,0
209022,1,3,0,3,8,0
148949,3,10,12,-2,16,1
139796,2,7,3,4,12,0
158598,1,7,7,0,3,1
189059,3,14,17,-3,16,1
115728,3,13,13,0,1,1
320729,2,14,23,-9,6,1
90652,4,20,33,-13,7,1
68957,2,14,7,7,15,1
266763,2,0,14,-14,16,0
314579,1,7,0,7,3,1
81198,1,0,0,0,3,0
110365,4,20,17,3,16,1
152613,2,0,6,-6,17,0
282847,4,9,20,-11,6,1
269474,1,3,3,0,1,1
123129,1,3,0,3,4,0
14454,2,24,3,21,7,1
189285,1,3,0,3,16,1
48525,1,11,0,11,5,1
10291,1,0,7,-7,5,0
151069,3,17,10,7,17,0
217116,2,0,7,-7,12,0
256018,4,25,12,13,12,1
362933,2,14,0,14,8,1
240246,1,7,0,7,5,0
296026,2,3,7,-4,13,1
35681,4,23,10,13,17,0
4459,1,7,9,-2,2,1
329829,4,17,20,-3,11,0
4584,1,7,7,0,2,0
410713,2,16,3,13,13,1
236838,4,3,9,-6,3,1
100707,4,21,24,-3,12,1
294954,3,14,7,7,12,0
7486,4,29,6,23,4,0
342319,4,20,6,14,16,0
250300,2,7,0,7,9,0
52840,3,14,37,-23,7,0
182049,3,17,14,3,13,0
148296,2,7,3,4,16,1
232163,2,6,0,6,1,1
97990,3,17,10,7,11,0
404483,3,21,13,8,10,0
75962,4,35,7,28,1,0
267724,4,14,34,-20,17,1
318725,2,10,23,-13,5,0
51031,3,0,17,-17,6,1
395938,2,24,3,21,6,0
161307,4,20,6,14,4,0
253985,2,0,6,-6,11,1
105488,1,20,0,20,14,0
191502,2,14,14,0,17,0
374083,1,6,0,6,13,1
255420,4,24,6,18,12,0
167621,1,7,7,0,7,1
100479,2,7,10,-3,12,1
340559,4,7,42,-35,15,1
349090,1,7,0,7,2,1
154751,2,10,10,0,1,0
36708,4,23,10,13,17,0
410667,1,0,3,-3,13,1
398838,1,0,0,0,7,0
194840,1,0,0,0,2,0
152861,1,0,0,0,1,0
252338,3,0,22,-22,10,0
334532,2,14,14,0,13,0
235114,2,0,10,-10,2,0
35652,3,20,3,17,17,1
376352,2,3,0,3,14,1
166025,4,17,21,-4,6,1
30269,2,3,7,-4,14,0
319760,1,0,0,0,6,1
339660,1,0,0,0,15,1
201645,3,10,13,-3,5,0
88255,1,0,0,0,6,1
297592,4,21,7,14,13,1
154511,4,21,17,4,1,0
258365,1,7,0,7,13,0
224721,1,3,0,3,15,0
269496,2,10,10,0,1,0
6746,1,0,0,0,3,1
246909,2,14,7,7,8,0
65487,3,23,14,9,13,1
166030,4,20,21,-1,6,0
299921,4,16,11,5,14,0
314973,4,0,20,-20,4,1
339067,1,0,0,0,15,0
12776,1,0,0,0,6,0
402985,2,7,14,-7,9,0
160325,3,3,14,-11,4,0
376696,3,3,0,3,14,1
331227,4,17,20,-3,11,1
158729,1,0,0,0,3,0
356377,4,24,14,10,5,1
67180,2,0,0,0,14,0
297284,4,24,6,18,13,1
126005,1,0,0,0,6,0
289617,3,10,13,-3,10,0
390341,1,7,7,0,3,0
231647,3,14,13,1,1,0
109517,1,0,6,-6,16,0
159773,4,7,13,-6,3,1
261764,4,21,7,14,14,1
369412,2,17,7,10,11,0
304985,4,10,20,-10,16,1
324160,4,3,10,-7,8,1
41637,2,17,0,17,2,0
245674,1,3,3,0,7,1
76998,4,17,20,-3,1,1
184242,3,24,0,24,14,0
63766,3,14,15,-1,12,0
109884,3,20,0,20,16,1
415607,3,14,13,1,15,1
103586,4,33,14,19,13,1
154552,1,7,6,1,1,0
367745,4,13,20,-7,10,1
345416,3,0,10,-10,17,0
280967,1,0,0,0,6,0
115113,2,3,20,-17,1,1
385089,1,0,3,-3,1,1
341271,4,23,13,10,16,0
331758,3,13,27,-14,12,0
157297,4,16,3,13,2,1
409225,2,13,3,10,12,0
357241,2,3,3,0,5,1
162199,2,10,14,-4,4,1
94811,3,3,9,-6,9,1
10639,3,7,17,-10,5,1
331656,4,31,33,-2,11,1
384453,3,21,0,21,1,0
168618,4,17,16,1,7,1
367932,1,0,7,-7,11,0
287543,4,14,40,-26,9,1
188400,2,3,3,0,16,1
399477,2,0,24,-24,7,1
103102,3,34,7,27,13,0
391204,4,10,24,-14,4,0
210487,4,9,14,-5,9,0
203453,2,7,3,4,6,1
294694,3,6,14,-8,12,0
327753,4,13,16,-3,10,0
50635,4,16,9,7,6,1
285263,2,14,6,8,7,0
184554,4,41,14,27,14,1
65048,3,3,17,-14,13,1
124907,4,9,16,-7,5,1
98529,1,0,0,0,11,1
238861,4,41,0,41,4,0
136992,4,20,20,0,11,1
211482,2,19,7,12,9,0
371472,3,14,17,-3,12,1
199297,4,17,38,-21,4,1
272100,3,17,6,11,2,0
320832,1,3,4,-1,6,0
84858,2,20,10,10,4,1
36731,1,0,7,-7,17,1
85645,2,17,7,10,5,1
350746,2,10,0,10,2,0
361012,2,9,2,7,7,1
331600,3,20,23,-3,11,0
190176,1,0,0,0,17,0
304614,2,14,7,7,16,0
60146,4,34,19,15,11,0
25374,2,6,0,6,12,0
86268,2,13,17,-4,5,0
132434,3,0,21,-21,9,0
212974,4,21,7,14,10,0
343623,2,15,7,8,17,1
309162,3,35,3,32,1,0
103099,3,33,7,26,13,1
39229,2,3,3,0,1,1
102973,4,12,31,-19,13,0
302105,3,27,27,0,15,0
339493,4,10,26,-16,15,1
310735,2,3,3,0,2,0
326257,4,10,48,-38,9,1
21646,1,0,0,0,11,0
269100,4,13,16,-3,17,1
405052,1,0,3,-3,10,1
38677,3,14,7,7,1,0
125154,2,14,7,7,5,1
181705,2,7,7,0,13,1
66152,1,3,0,3,13,1
229164,4,19,7,12,17,1
339671,1,7,0,7,15,0
214335,4,21,13,8,11,0
16263,3,13,23,-10,8,1
91837,4,24,6,18,8,0
54020,2,0,0,0,8,1
284579,1,7,0,7,7,1
313173,3,13,13,0,3,0
273097,1,0,0,0,2,0
13776,3,7,27,-20,7,1
148346,3,14,3,11,16,1
273251,1,0,0,0,2,1
295813,5,27,27,0,12,0
356663,2,16,10,6,5,1
154610,3,21,14,7,1,0
25471,4,13,17,-4,12,1
54810,3,10,0,10,8,1
360705,1,0,7,-7,7,1
406191,1,7,3,4,11,0
82713,1,0,0,0,3,0
183465,4,27,6,21,14,1
8839,4,32,0,32,4,0
35374,4,23,16,7,16,0
72009,2,0,10,-10,16,0
84352,4,28,30,-2,4,0
331546,1,7,14,-7,11,0
185002,4,14,20,-6,15,0
332735,2,21,9,12,12,0
265522,4,14,10,4,16,1
79023,3,10,7,3,2,0
2988,3,13,17,-4,2,0
275845,1,0,0,0,3,1
129868,2,10,0,10,7,1
166504,4,23,24,-1,6,1
69360,1,0,0,0,15,0
26566,2,10,6,4,13,1
395833,3,3,17,-14,6,0
108779,1,0,7,-7,15,1
379844,1,7,0,7,16,0
414382,2,7,17,-10,14,1
331857,2,0,0,0,12,0
383691,3,9,24,-15,17,0
385911,2,3,7,-4,1,0
26834,1,7,0,7,13,0
327802,1,0,10,-10,10,1
31540,4,10,17,-7,15,0
287471,2,14,13,1,9,0
196962,2,14,0,14,3,0
26986,1,7,0,7,13,1
338695,3,26,10,16,14,1
267517,2,13,14,-1,17,0
138521,4,31,30,1,12,0
253635,4,9,17,-8,11,1
45657,4,13,13,0,4,0
350149,1,0,0,0,2,1
126952,2,3,7,-4,6,0
160929,2,7,7,0,4,1
159875,2,17,0,17,3,1
231693,4,31,19,12,1,0
55045,1,7,0,7,8,1
245783,4,23,20,3,7,1
150118,1,0,6,-6,16,1
57543,4,24,16,8,10,0
391791,4,10,16,-6,4,1
355832,2,13,0,13,5,0
275124,2,7,3,4,3,0
402965,1,7,7,0,9,0
31435,2,3,0,3,15,0
163313,3,13,16,-3,5,0
86406,2,20,7,13,5,1
193459,4,23,20,3,1,0
13184,3,22,16,6,6,0
191072,2,7,0,7,17,0
72824,4,31,17,14,16,0
137953,4,30,22,8,11,0
165652,2,0,7,-7,6,0
2844,3,24,24,0,2,1
123803,3,10,3,7,5,1
260138,4,6,35,-29,14,0
364624,4,21,37,-16,9,0
99025,2,6,0,6,11,0
398102,4,24,28,-4,7,1
116433,2,3,10,-7,1,1
167132,1,6,0,6,7,0
160378,4,3,28,-25,4,0
158087,3,22,9,13,3,0
296579,1,0,0,0,13,1
241360,1,7,0,7,5,0
172470,4,13,49,-36,9,0
16626,2,7,27,-20,8,0
213667,2,14,14,0,10,0
44037,1,0,0,0,3,0
236181,3,16,16,0,3,1
361750,1,7,0,7,7,1
74656,2,0,3,-3,17,0
70250,1,7,0,7,15,0
10806,3,21,0,21,5,1
354098,3,19,0,19,4,0
31771,2,0,17,-17,15,1
194802,4,10,23,-13,2,0
360321,3,0,20,-20,7,1
44684,1,0,6,-6,3,0
384060,4,27,30,-3,1,0
203431,1,0,3,-3,6,1
407469,4,17,10,7,11,0
155021,1,6,12,-6,1,0
38287,4,13,14,-1,1,1
266118,4,17,13,4,16,0
401820,2,7,14,-7,9,1
346278,4,40,3,37,1,1
31141,2,3,13,-10,15,1
246351,3,17,10,7,7,0
122430,2,6,26,-20,4,1
11013,4,9,31,-22,5,0
117411,4,34,17,17,2,0
216226,4,17,10,7,12,1
230678,1,6,14,-8,1,0
171308,2,7,3,4,9,0
9802,3,9,17,-8,5,0
57086,4,21,27,-6,9,0
327022,4,8,10,-2,9,1
241503,1,0,0,0,5,0
299028,4,16,18,-2,14,1
179293,4,33,3,30,12,0
229291,3,24,24,0,17,1
410438,3,9,17,-8,13,0
258509,1,0,0,0,13,1
376467,1,0,0,0,14,1
399551,4,0,33,-33,7,1
100434,1,0,6,-6,12,0
119562,2,7,0,7,3,1
168944,4,31,13,18,7,0
134459,2,3,20,-17,10,1
7639,4,28,3,25,4,1
108274,4,9,7,2,15,1
63216,4,17,23,-6,12,0
116931,3,21,10,11,2,0
1927,2,0,0,0,1,0
342347,1,0,0,0,16,0
290133,4,21,15,6,10,1
286937,4,23,19,4,8,1
416818,4,13,10,3,15,1
296722,1,0,0,0,13,1
75869,2,14,7,7,1,0
222080,4,27,10,17,14,0
38821,3,3,10,-7,1,1
148277,1,7,0,7,16,0
395095,4,10,31,-21,5,1
31697,5,24,24,0,15,1
58289,3,20,13,7,10,1
196020,1,0,0,0,2,1
32698,3,7,6,1,15,1
302354,2,10,3,7,15,0
369377,1,3,0,3,11,1
241827,2,10,3,7,5,0
190892,4,34,20,14,17,1
95978,2,0,0,0,10,0
328758,2,14,13,1,10,1
138724,4,28,38,-10,12,1
327106,2,7,3,4,9,1
294826,3,28,21,7,12,1
313557,2,3,10,-7,3,0
124224,1,0,14,-14,5,1
222221,3,13,10,3,14,0
98747,3,28,6,22,11,0
160380,4,3,28,-25,4,0
103808,2,9,0,9,13,0
167058,3,13,24,-11,7,1
90711,1,7,0,7,7,0
46011,1,7,7,0,4,1
298300,4,20,13,7,14,0
339138,3,10,13,-3,15,1
221519,1,6,2,4,14,0
210302,2,6,10,-4,9,1
397800,4,24,14,10,7,0
398569,1,0,0,0,7,1
288116,3,13,7,6,9,1
211604,1,0,3,-3,9,1
156865,4,23,29,-6,2,1
75230,1,7,0,7,17,0
224250,1,6,3,3,15,0
249782,4,35,28,7,9,0
34857,2,17,7,10,16,0
8431,1,3,0,3,4,0
370910,3,13,17,-4,12,1
60225,3,10,7,3,11,1
222449,1,3,7,-4,14,1
301209,3,20,14,6,15,0
68677,2,17,0,17,15,0
215009,2,10,0,10,11,0
90248,1,0,7,-7,7,0
377118,2,10,10,0,15,1
330320,1,0,0,0,11,0
377637,1,0,7,-7,15,1
414760,4,10,17,-7,14,0
141703,3,23,21,2,13,0
118560,3,17,3,14,2,1
94580,4,13,17,-4,9,1
227491,3,19,10,9,16,0
354803,3,13,28,-15,4,1
252663,3,6,3,3,10,0
213067,3,17,3,14,10,0
233333,4,13,23,-10,2,0
206851,2,3,7,-4,7,1
134533,4,3,36,-33,10,0
281618,2,21,0,21,6,1
35786,3,3,10,-7,17,0
308119,3,13,19,-6,1,1
6834,3,10,21,-11,3,0
62504,4,13,16,-3,12,1
103004,1,0,0,0,13,1
140561,1,7,7,0,12,1
51581,2,7,3,4,7,0
126682,2,7,6,1,6,1
247252,2,21,14,7,8,1
245762,4,16,17,-1,7,0
304890,1,0,0,0,16,1
381679,3,17,7,10,17,0
103757,1,0,0,0,13,1
395780,2,0,7,-7,6,1
412523,4,30,14,16,14,1
149508,1,14,6,8,16,1
247864,2,10,3,7,8,0
322712,1,0,0,0,7,0
81943,4,7,36,-29,3,1
145659,4,34,7,27,14,1
296366,4,13,25,-12,13,0
228182,2,7,27,-20,17,1
5986,4,17,29,-12,3,1
195875,1,0,0,0,2,0
17957,2,13,21,-8,9,1
413536,2,0,10,-10,14,1
31440,2,3,7,-4,15,1
176796,2,9,7,2,11,1
246438,1,7,0,7,8,1
36945,3,0,25,-25,17,1
128818,3,13,13,0,7,1
287644,3,3,10,-7,9,0
21658,1,0,0,0,11,1
320701,2,14,17,-3,6,0
115781,4,20,16,4,1,0
406011,1,0,0,0,11,0
65858,2,7,7,0,13,0
421762,4,31,24,7,17,1
396958,1,0,0,0,6,1
411922,2,17,10,7,13,1
321273,2,6,10,-4,6,1
270347,1,0,0,0,1,1
347745,2,0,0,0,1,1
34442,3,24,3,21,16,1
176335,3,16,14,2,11,0
167437,1,0,0,0,7,0
410482,4,9,26,-17,13,0
313822,1,7,0,7,3,0
375076,4,28,33,-5,14,0
383760,1,0,0,0,1,1
345519,2,7,10,-3,17,0
75674,1,0,0,0,1,1
394834,1,0,7,-7,5,1
48260,2,3,10,-7,5,0
185178,1,0,0,0,15,1
276040,2,13,3,10,3,1
330537,3,7,7,0,11,0
113039,3,13,16,-3,17,1
150395,1,0,0,0,16,1
336925,4,13,21,-8,14,1
108935,1,13,7,6,15,0
258019,4,7,35,-28,13,0
45522,4,27,26,1,4,1
207304,2,10,14,-4,7,0
234889,4,3,19,-16,2,1
148840,4,16,23,-7,16,1
286613,4,17,38,-21,8,0
9249,4,10,37,-27,5,1
25834,2,17,7,10,12,0
305163,4,27,10,17,16,0
155274,4,28,21,7,1,0
126543,3,10,6,4,6,0
131538,3,6,16,-10,8,1
37760,2,7,0,7,1,0
32728,4,7,24,-17,15,0
30774,4,31,28,3,15,1
408403,1,0,0,0,12,1
100604,1,0,0,0,12,0
413005,4,16,15,1,14,0
415379,1,0,0,0,15,0
64586,2,10,14,-4,13,0
382681,2,3,6,-3,17,0
330566,4,14,7,7,11,0
212074,4,24,40,-16,9,0
218378,1,0,0,0,13,1
172692,2,14,3,11,9,1
33214,2,10,0,10,16,1
82243,4,16,13,3,3,1
70586,2,7,10,-3,15,1
290215,2,17,0,17,10,0
382739,4,9,20,-11,17,1
349657,1,0,0,0,2,1
185319,4,41,30,11,15,1
324445,4,14,6,8,8,1
103683,3,0,10,-10,13,0
78834,1,0,0,0,2,1
272692,2,9,3,6,2,1
236845,4,6,9,-3,3,0
342196,4,22,19,3,16,1
252883,1,3,0,3,11,0
303402,1,10,0,10,16,1
23978,4,23,6,17,12,0
408801,3,10,25,-15,12,1
299110,2,3,10,-7,14,1
314922,3,0,3,-3,4,0
1808,2,10,0,10,1,0
123281,1,7,0,7,4,0
251885,3,14,13,1,10,1
91449,2,9,0,9,8,0
363413,3,21,21,0,8,1
181893,3,21,28,-7,13,0
29166,3,3,19,-16,14,0
228793,2,3,14,-11,17,1
45306,2,7,10,-3,4,1
153455,4,20,17,3,1,0
350567,2,10,0,10,2,0
182268,1,7,0,7,14,0
192728,1,0,3,-3,1,1
87910,4,13,15,-2,6,1
280609,4,20,9,11,5,0
87018,4,14,21,-7,5,0
304929,2,7,3,4,16,0
347867,1,0,0,0,1,0
138594,1,3,0,3,12,0
67756,3,21,0,21,14,1
248646,3,17,10,7,9,1
72708,4,34,13,21,16,0
376557,3,15,6,9,14,1
202366,1,0,0,0,5,0
150320,3,24,7,17,16,0
64996,2,0,7,-7,13,0
24946,2,10,7,3,12,0
321064,4,16,14,2,6,0
417158,1,0,10,-10,16,1
60765,1,0,0,0,11,0
208169,2,0,0,0,8,0
392499,2,3,17,-14,4,0
248741,2,20,7,13,9,0
420575,1,0,7,-7,17,0
10996,4,9,28,-19,5,0
370706,1,3,7,-4,12,1
283308,3,10,9,1,7,0
201121,1,6,6,0,5,0
37192,2,3,7,-4,17,0
3125,2,3,6,-3,2,0
421406,3,24,20,4,17,0
332683,1,0,0,0,12,1
173763,2,10,3,7,10,0
277918,4,7,20,-13,4,0
30732,3,17,21,-4,15,1
386896,1,7,6,1,2,0
319902,1,6,7,-1,6,1
317508,3,10,24,-14,5,0
296320,3,6,13,-7,13,0
24135,4,17,14,3,12,0
123680,4,10,22,-12,4,0
331845,2,0,0,0,12,1
35746,2,3,0,3,17,0
138758,1,0,0,0,12,1
310266,2,10,0,10,2,0
404192,3,9,9,0,10,1
293711,4,10,13,-3,12,0
326369,3,17,10,7,9,1
399698,1,0,0,0,8,0
88519,4,19,14,5,6,0
339637,4,31,17,14,15,0
387422,3,21,16,5,2,0
389849,4,24,6,18,3,0
258478,4,21,21,0,13,0
393963,1,3,0,3,5,0
61458,4,16,17,-1,11,1
400218,2,10,6,4,8,1
50776,4,24,21,3,6,0
310786,3,6,10,-4,2,1
78631,4,30,13,17,2,1
64519,4,34,16,18,13,0
62517,5,16,16,0,12,1
333441,4,26,13,13,12,0
110397,1,0,0,0,16,1
311758,2,7,13,-6,2,0
418575,2,14,3,11,16,1
305871,3,7,14,-7,17,0
11833,3,34,17,17,6,1
246946,2,20,7,13,8,0
238420,4,17,33,-16,4,0
368562,3,9,0,9,11,0
120191,1,0,0,0,3,1
108368,2,0,14,-14,15,0
252666,3,6,3,3,10,1
209618,4,50,34,16,8,0
338427,4,30,24,6,14,1
170102,2,7,0,7,8,0
4829,4,34,3,31,3,0
405142,3,3,10,-7,10,1
367330,4,6,20,-14,10,1
34782,4,20,3,17,16,0
167366,3,23,23,0,7,1
91677,4,21,21,0,8,0
126903,4,17,14,3,6,1
23651,3,7,13,-6,12,0
268680,4,27,20,7,17,1
368776,4,21,22,-1,11,0
369724,3,22,23,-1,11,1
74624,1,0,3,-3,17,1
204374,1,0,3,-3,6,0
53423,3,3,28,-25,8,0
85103,4,31,16,15,4,1
316978,1,0,0,0,4,0
77,2,7,7,0,1,1
399964,4,12,13,-1,8,1
51772,3,3,19,-16,7,1
10732,1,7,0,7,5,0
192807,3,0,15,-15,1,0
121507,2,9,7,2,4,1
46209,3,14,21,-7,4,0
11379,2,20,0,20,6,1
337676,4,24,13,11,14,0
65133,2,0,0,0,13,1
185749,3,23,3,20,15,1
300261,1,0,0,0,14,0
243451,3,3,17,-14,6,1
191848,3,17,10,7,1,1
210719,2,14,0,14,9,1
268661,4,20,20,0,17,1
77995,3,3,16,-13,1,0
684,3,0,17,-17,1,1
168975,1,0,7,-7,7,1
49396,4,10,20,-10,6,1
197603,3,19,0,19,3,1
129148,4,34,28,6,7,0
420718,1,0,0,0,17,0
250980,3,3,6,-3,10,1
72375,3,10,23,-13,16,1
349106,2,7,0,7,2,1
357970,2,21,6,15,6,0
406964,2,3,13,-10,11,1
17978,2,13,21,-8,9,1
199941,1,3,10,-7,4,1
288079,2,10,0,10,9,1
401375,2,17,0,17,8,0
364550,2,9,21,-12,9,1
327666,1,3,3,0,10,0
419084,4,13,27,-14,16,1
185538,2,10,3,7,15,0
402319,4,23,18,5,9,0
324257,2,9,0,9,8,0
7752,3,27,3,24,4,1
87698,2,0,20,-20,6,1
61691,3,17,10,7,12,0
147268,3,0,24,-24,15,1
236626,1,0,0,0,3,1
301805,4,3,34,-31,15,1
88111,1,0,0,0,6,1
294476,2,7,7,0,12,0
306705,1,3,3,0,17,1
184871,4,27,20,7,15,0
361463,1,7,0,7,7,0
415433,2,12,0,12,15,0
180942,2,17,7,10,13,0
330627,1,0,0,0,11,1
170880,3,7,7,0,8,1
362987,3,27,16,11,8,0
234576,1,7,0,7,2,1
64005,2,14,3,11,13,1
272313,4,15,13,2,2,1
349155,3,20,7,13,2,1
274554,3,21,16,5,3,1
30825,1,0,14,-14,15,1
28006,1,0,0,0,13,1
313729,2,14,3,11,3,1
411645,3,26,28,-2,13,0
195174,1,7,0,7,2,1
259914,2,17,10,7,14,1
374254,2,7,3,4,13,1
138476,3,24,14,10,12,0
76377,3,29,6,23,1,0
280437,3,16,24,-8,5,1
111258,3,10,10,0,16,0
263355,4,24,10,14,15,1
261146,4,21,24,-3,14,0
321630,3,17,13,4,7,0
349731,3,17,7,10,2,1
122491,4,20,33,-13,4,0
286319,4,22,19,3,8,1
414225,2,7,14,-7,14,1
177412,3,17,10,7,11,1
104620,2,7,3,4,14,1
245881,2,3,30,-27,7,1
35677,4,23,10,13,17,0
362277,4,18,24,-6,8,0
44497,4,27,20,7,3,0
259157,3,14,13,1,13,1
141711,3,23,21,2,13,1
418668,4,28,38,-10,16,0
83448,4,10,23,-13,4,1
206490,4,27,0,27,7,0
71930,4,15,13,2,16,1
211027,2,17,0,17,9,1
213250,4,16,16,0,10,1
74437,4,13,20,-7,17,1
176383,4,16,28,-12,11,1
167517,3,0,3,-3,7,0
324318,4,25,7,18,8,1
224692,4,19,17,2,15,0
36276,4,24,27,-3,17,0
174862,4,19,17,2,10,0
138451,2,14,7,7,12,0
416041,3,14,3,11,15,1
382566,4,0,17,-17,17,1
223972,1,0,6,-6,15,1
90781,4,20,7,13,7,0
198321,3,6,14,-8,3,1
68629,1,7,0,7,15,0
59299,1,0,3,-3,11,0
255073,3,6,21,-15,12,0
119311,3,14,13,1,3,0
310718,1,3,3,0,2,0
10997,4,9,28,-19,5,0
95196,4,23,30,-7,9,1
205656,2,14,12,2,7,1
42228,3,24,0,24,2,0
191715,3,13,17,-4,17,0
294268,4,28,21,7,12,0
147395,2,13,7,6,15,1
119172,4,13,7,6,3,1
403500,4,24,12,12,9,0
138112,1,7,0,7,11,1
374277,2,14,10,4,13,0
28249,3,17,0,17,13,0
366144,3,7,35,-28,10,1
190208,2,7,0,7,17,0
270489,1,0,0,0,1,0
56832,5,20,20,0,9,1
330874,3,13,17,-4,11,0
350682,1,0,0,0,2,0
288903,4,13,31,-18,9,1
323453,1,0,3,-3,7,0
406128,4,3,26,-23,11,0
180362,3,15,14,1,13,0
239600,3,20,10,10,4,1
9051,3,21,13,8,4,1
375887,1,7,3,4,14,1
79676,1,0,0,0,2,0
68005,1,0,3,-3,14,0
373403,3,10,10,0,13,0
296127,1,7,6,1,13,1
254915,3,24,7,17,12,1
121109,4,25,31,-6,3,0
344693,3,6,20,-14,17,0
186362,4,29,24,5,15,1
324948,1,0,7,-7,8,1
169817,3,3,17,-14,8,1
418883,3,10,10,0,16,1
205233,4,23,13,10,6,0
234158,2,3,7,-4,2,0
332764,3,28,9,19,12,0
169990,3,21,10,11,8,1
404070,3,10,49,-39,10,1
265702,1,0,0,0,16,1
8027,2,10,7,3,4,0
303357,4,41,3,38,16,1
414113,2,3,10,-7,14,1
243128,4,7,15,-8,6,0
119567,2,7,0,7,3,1
124673,1,0,0,0,5,0
257335,2,17,0,17,13,1
164443,1,14,0,14,5,0
300602,2,10,0,10,15,0
64594,3,17,14,3,13,0
122980,2,0,3,-3,4,0
4550,4,24,26,-2,2,0
181053,2,7,0,7,13,1
127523,4,3,23,-20,6,1
142781,3,12,10,2,13,1
175801,1,14,0,14,11,0
121271,4,28,30,-2,3,0
161668,4,39,24,15,4,0
253142,4,21,20,1,11,1
58398,2,34,7,27,10,1
393519,1,7,6,1,5,1
291845,2,0,7,-7,11,0
406282,4,21,35,-14,11,1
228698,3,19,23,-4,17,0
279990,2,3,13,-10,5,0
411666,4,34,28,6,13,1
199447,4,22,17,5,4,0
249716,3,21,14,7,9,0
6478,1,0,0,0,3,0
372604,2,7,6,1,13,1
151707,1,0,0,0,17,1
240398,5,24,23,1,5,1
321903,3,14,21,-7,7,1
194956,4,14,22,-8,2,1
348564,3,28,17,11,2,1
12773,1,0,0,0,6,0
53797,5,10,10,0,8,1
327859,3,16,16,0,10,0
19564,2,7,14,-7,10,1
315036,2,21,7,14,4,1
324915,4,17,23,-6,8,1
30731,3,17,21,-4,15,1
180993,4,31,31,0,13,1
198522,4,17,12,5,3,0
121907,4,0,33,-33,4,0
103994,4,13,13,0,13,0
144335,1,0,0,0,14,0
159286,3,24,24,0,3,1
309382,2,0,0,0,1,0
21210,1,0,0,0,11,1
19383,1,0,0,0,10,0
284832,4,29,27,2,7,1
330121,4,0,13,-13,11,0
271066,4,28,34,-6,1,1
248340,3,24,10,14,8,1
348011,1,0,0,0,1,1
299069,1,3,0,3,14,0
408828,4,13,28,-15,12,1
386108,4,21,9,12,1,1
244545,3,25,13,12,7,0
358091,1,14,0,14,6,0
150049,4,31,6,25,16,0
71093,4,27,3,24,16,1
181939,4,28,35,-7,13,1
269689,3,10,12,-2,1,1
248144,2,3,3,0,8,0
32659,2,0,0,0,15,1
238292,1,0,0,0,4,0
265657,4,9,15,-6,16,1
179953,1,0,6,-6,13,0
308692,2,7,6,1,1,1
472,1,0,3,-3,1,0
246458,2,9,0,9,8,1
282090,2,9,8,1,6,1
383094,2,20,7,13,17,1
200102,2,7,10,-3,4,1
94658,2,17,26,-9,9,1
115059,1,0,0,0,1,1
182414,1,0,0,0,14,1
220854,3,7,28,-21,14,0
243283,3,7,10,-3,6,0
6278,3,13,17,-4,3,1
279748,4,30,6,24,5,1
244891,1,0,0,0,7,0
394828,1,0,0,0,5,0
10495,2,13,0,13,5,0
262451,3,7,21,-14,15,1
186151,2,6,6,0,15,0
340566,4,7,42,-35,15,0
202519,1,0,0,0,5,0
84027,3,27,15,12,4,1
380985,4,9,14,-5,16,0
388010,3,6,3,3,2,0
85428,1,0,0,0,5,1
21019,4,14,24,-10,10,0
309858,3,21,7,14,1,0
418789,4,14,24,-10,16,0
229094,2,10,7,3,17,1
35776,2,3,9,-6,17,0
336952,4,21,21,0,14,1
175858,2,20,24,-4,11,0
233345,4,19,23,-4,2,1
411495,3,13,17,-4,13,0
132272,3,21,7,14,9,1
367155,3,29,16,13,10,0
294134,4,21,27,-6,12,0
359999,2,3,26,-23,7,1
113960,4,20,13,7,17,1
60332,1,3,0,3,11,1
302582,1,0,0,0,15,1
108633,1,6,0,6,15,0
120067,1,3,0,3,3,1
73668,3,13,0,13,17,1
198177,3,10,6,4,3,1
389398,4,30,19,11,3,1
252641,2,6,3,3,10,0
173954,4,20,19,1,10,1
202333,4,13,6,7,5,1
220184,1,0,0,0,13,1
66526,4,31,24,7,14,0
274937,4,17,16,1,3,1
287336,2,13,0,13,8,0
296477,3,17,0,17,13,0
402160,3,19,7,12,9,1
332,1,14,3,11,1,1
30592,2,17,0,17,14,0
112278,3,24,17,7,17,1
232039,2,0,17,-17,1,0
102080,4,35,17,18,12,1
245554,2,34,0,34,7,0
417484,2,10,21,-11,16,1
313263,2,3,7,-4,3,1
97661,2,3,3,0,11,0
378793,4,14,10,4,15,1
120667,1,3,0,3,3,0
126828,2,6,6,0,6,1
165500,2,0,7,-7,6,0
151879,2,13,0,13,17,0
283819,1,6,0,6,7,1
112702,2,3,0,3,17,1
45192,4,7,10,-3,4,0
391391,2,7,10,-3,4,1
370672,4,24,14,10,12,0
297755,1,0,0,0,13,1
353896,3,10,28,-18,4,1
116720,2,6,17,-11,2,1
379053,3,7,6,1,15,0
79008,2,10,7,3,2,0
78037,4,12,23,-11,1,1
372389,1,6,0,6,13,0
393394,2,21,14,7,5,0
95734,4,13,9,4,10,1
167952,1,0,7,-7,7,1
396783,4,7,20,-13,6,0
225166,1,3,0,3,15,0
149394,3,6,20,-14,16,1
414530,2,14,3,11,14,1
366210,1,0,0,0,10,1
358824,1,0,7,-7,6,1
417647,2,21,3,18,16,1
200730,2,16,0,16,4,1
421691,2,17,7,10,17,0
225537,4,8,24,-16,15,0
234742,1,0,0,0,2,1
156740,1,7,7,0,2,0
243821,4,27,20,7,6,0
386413,4,20,17,3,2,1
132238,2,7,7,0,9,1
357943,1,7,6,1,6,1
51317,2,16,17,-1,7,0
290433,4,35,10,25,10,1
112762,3,13,7,6,17,0
27456,2,10,0,10,13,0
398016,1,13,7,6,7,1
127813,3,10,28,-18,6,1
7747,2,27,3,24,4,1
115725,3,13,10,3,1,0
23570,1,6,0,6,12,1
58484,4,48,23,25,10,0
94336,2,17,7,10,9,0
387304,4,6,10,-4,2,1
10274,1,0,0,0,5,0
374378,1,7,0,7,14,0
396369,2,20,6,14,6,0
99378,4,23,10,13,11,1
61827,2,3,17,-14,12,0
120423,3,19,9,10,3,1
95363,1,7,0,7,10,1
201254,1,0,0,0,5,0
365820,1,0,0,0,9,1
18465,3,7,13,-6,9,0
356456,2,0,3,-3,5,1
9211,3,3,23,-20,5,1
184017,4,22,10,12,14,1
143729,1,0,0,0,14,1
167171,2,13,7,6,7,1
376647,2,0,0,0,14,1
326309,1,0,10,-10,9,1
120035,4,30,38,-8,3,1
304283,1,0,0,0,16,1
359105,1,7,0,7,6,0
170305,3,0,12,-12,8,0
245799,4,30,23,7,7,0
366494,1,7,0,7,10,0
90165,3,3,0,3,7,0
385832,4,33,3,30,1,0
204922,3,13,19,-6,6,0
51641,3,27,20,7,7,1
410780,4,22,6,16,13,0
199499,2,14,0,14,4,0
375209,4,17,17,0,14,0
44152,4,13,20,-7,3,0
207714,2,0,13,-13,7,1
405992,4,21,7,14,11,1
107140,1,0,6,-6,15,0
102976,4,12,31,-19,13,0
55610,4,27,14,13,9,1
89519,2,0,3,-3,7,0
372746,2,0,0,0,13,0
6480,1,0,0,0,3,0
307468,2,28,13,15,17,1
365922,4,14,21,-7,9,1
173475,3,3,10,-7,10,1
334879,3,24,10,14,13,1
350193,3,19,0,19,2,1
397899,3,7,6,1,7,1
389835,4,24,6,18,3,1
300985,1,3,0,3,15,1
4944,3,14,17,-3,3,1
17244,3,7,34,-27,9,0
374190,4,23,28,-5,13,1
285756,2,7,10,-3,8,1
95623,1,0,0,0,10,0
32916,1,0,0,0,15,0
322807,3,3,27,-24,7,0
82514,3,10,20,-10,3,1
132283,3,24,7,17,9,1
110089,1,0,0,0,16,0
332855,1,7,0,7,12,1
292798,4,29,17,12,11,1
27519,3,23,9,14,13,0
306852,1,0,3,-3,17,0
285878,1,6,0,6,8,0
151492,3,35,7,28,17,0
179174,4,19,16,3,12,0
421611,1,0,0,0,17,1
101653,1,3,0,3,12,0
40445,2,7,14,-7,2,1
269685,3,10,6,4,1,1
51958,4,13,16,-3,7,0
161479,3,10,6,4,4,0
159912,3,31,7,24,3,1
225336,2,7,21,-14,15,1
198328,3,13,14,-1,3,0
339207,1,0,0,0,15,0
269116,4,16,16,0,17,1
315070,3,30,14,16,4,1
342696,2,0,0,0,16,0
416210,3,10,25,-15,15,1
117388,4,34,3,31,2,1
126935,1,3,0,3,6,0
387262,3,6,10,-4,2,1
79430,2,6,7,-1,2,1
75604,3,7,3,4,17,0
119254,2,7,3,4,3,0
6859,4,10,31,-21,3,0
334869,3,24,10,14,13,1
340535,4,7,40,-33,15,0
359834,1,7,7,0,6,1
337354,3,14,7,7,14,0
419500,4,10,17,-7,16,1
136251,2,12,7,5,11,1
154876,2,3,3,0,1,1
245166,4,17,28,-11,7,0
1574,4,16,13,3,1,0
116315,3,24,13,11,1,0
211072,3,30,0,30,9,1
213005,1,0,0,0,10,1
141013,2,7,0,7,13,0
414438,3,13,23,-10,14,0
54409,4,33,25,8,8,0
338768,1,0,0,0,15,1
61799,2,0,17,-17,12,1
42376,3,14,9,5,2,0
280098,2,7,0,7,5,1
196170,4,31,24,7,2,0
409795,1,10,0,10,12,0
230007,3,0,6,-6,17,1
103565,4,33,0,33,13,1
354399,4,45,10,35,4,1
194028,3,17,7,10,1,1
149913,4,6,23,-17,16,0
190990,3,12,3,9,17,1
262140,3,21,3,18,15,0
85139,1,0,3,-3,4,1
384859,3,6,12,-6,1,0
155129,4,19,33,-14,1,1
163415,2,0,13,-13,5,1
87702,2,0,20,-20,6,1
29451,3,7,14,-7,14,1
127062,4,31,23,8,6,0
382360,1,0,7,-7,17,1
17183,2,7,14,-7,9,0
148451,2,7,3,4,16,1
92822,1,7,0,7,8,1
377157,4,13,10,3,15,0
356527,3,9,3,6,5,0
132136,3,10,3,7,9,1
233079,1,0,0,0,2,1
156298,1,10,0,10,2,0
287903,1,7,3,4,9,0
195541,3,6,0,6,2,0
389246,4,31,7,24,3,0
73604,1,0,0,0,17,0
72587,1,0,0,0,16,1
37860,1,0,0,0,1,0
292440,2,3,3,0,11,0
182508,3,21,14,7,14,1
334166,4,23,14,9,13,1
351019,2,7,7,0,3,1
146782,1,7,0,7,15,0
101944,4,9,13,-4,12,1
72643,2,13,3,10,16,1
5728,1,0,0,0,3,1
72793,3,21,14,7,16,0
55431,3,20,10,10,9,1
310861,1,3,0,3,2,0
21676,2,3,7,-4,11,1
272621,4,19,9,10,2,0
113031,3,13,13,0,17,0
85059,3,31,16,15,4,1
407501,1,3,0,3,11,0
162672,3,16,17,-1,5,0
9144,1,0,13,-13,5,1
91439,2,3,0,3,8,0
271173,3,7,17,-10,1,1
54897,1,0,0,0,8,1
219259,4,22,10,12,13,0
250298,2,7,0,7,9,0
377471,4,14,13,1,15,1
255929,2,6,3,3,12,0
380919,2,3,0,3,16,1
210585,2,6,14,-8,9,1
81135,3,13,14,-1,3,1
421677,2,17,7,10,17,1
11664,2,14,0,14,6,1
165433,4,6,36,-30,6,1
80005,2,7,0,7,2,1
84591,2,10,10,0,4,1
79269,1,9,3,6,2,1
162011,1,14,3,11,4,0
31800,3,13,17,-4,15,0
30778,4,31,28,3,15,0
345420,3,0,13,-13,17,1
55381,2,10,7,3,9,0
268794,3,31,10,21,17,1
225699,4,21,13,8,16,1
407632,4,10,17,-7,11,0
202536,1,7,3,4,5,0
50816,1,0,7,-7,6,1
184966,3,7,17,-10,15,0
309157,3,35,3,32,1,1
263799,3,0,24,-24,15,1
167034,2,10,14,-4,7,0
277461,4,41,32,9,4,1
132009,3,0,24,-24,8,1
340542,4,7,40,-33,15,1
106897,2,9,3,6,14,1
17455,1,0,0,0,9,1
396555,2,17,7,10,6,0
37546,4,10,10,0,17,1
293447,4,42,24,18,11,1
202475,4,9,10,-1,5,0
65867,2,7,7,0,13,0
206286,3,10,6,4,7,1
108377,2,0,21,-21,15,1
301776,3,0,27,-27,15,0
263108,1,0,0,0,15,0
264876,1,3,7,-4,16,1
392171,2,3,13,-10,4,0
299498,4,10,23,-13,14,1
171905,2,7,7,0,9,1
99723,1,0,0,0,12,1
77993,2,3,13,-10,1,0
353010,4,23,10,13,3,0
297549,3,14,0,14,13,1
7537,1,7,0,7,4,0
186559,5,34,33,1,15,0
54954,3,3,3,0,8,1
95882,4,13,23,-10,10,1
337605,2,14,7,7,14,1
366196,4,13,51,-38,10,1
154237,1,0,0,0,1,1
295698,2,3,9,-6,12,1
206253,3,7,6,1,7,1
275393,1,0,7,-7,3,1
193004,4,17,20,-3,1,1
241065,1,7,0,7,5,0
54661,3,14,22,-8,8,0
87300,4,24,17,7,6,0
141189,2,3,21,-18,13,1
206942,4,24,23,1,7,0
30991,2,0,3,-3,15,0
286170,5,24,24,0,8,1
332118,1,0,0,0,12,0
175075,1,0,3,-3,10,1
380535,3,7,17,-10,16,0
254200,4,3,18,-15,11,0
317061,3,7,10,-3,4,1
382593,4,0,24,-24,17,1
97273,4,27,20,7,10,0
265729,1,3,0,3,16,0
145553,1,7,0,7,14,0
80698,4,24,26,-2,3,1
216600,4,43,18,25,12,1
101333,1,3,0,3,12,1
250260,1,0,0,0,9,1
316870,1,3,2,1,4,1
106509,4,36,9,27,14,0
130718,4,7,45,-38,8,1
179983,1,7,6,1,13,0
180947,3,17,7,10,13,0
71531,4,33,14,19,16,0
330971,2,22,7,15,11,1
217242,1,0,0,0,12,0
391427,2,10,17,-7,4,1
126774,1,0,0,0,6,0
365880,3,14,14,0,9,0
23162,2,20,0,20,11,1
214183,4,19,9,10,11,1
394259,1,0,0,0,5,1
395822,3,3,14,-11,6,1
336540,2,0,0,0,14,0
80819,3,3,0,3,3,0
311930,3,21,10,11,2,1
68363,3,3,14,-11,14,0
98471,3,23,14,9,11,1
229226,2,3,7,-4,17,0
45957,4,17,3,14,4,1
84571,2,7,7,0,4,1
412411,4,37,30,7,13,1
383935,1,0,0,0,1,1
403393,1,0,0,0,9,1
217097,1,0,0,0,12,0
178465,2,10,3,7,12,1
185931,4,22,23,-1,15,0
163735,2,0,9,-9,5,1
9114,4,30,19,11,4,0
4333,2,0,7,-7,2,0
243042,1,0,3,-3,6,1
399775,3,0,24,-24,8,1
147224,2,0,21,-21,15,1
58064,1,7,10,-3,10,0
118951,2,0,10,-10,3,0
54987,4,13,9,4,8,0
138596,1,3,0,3,12,0
97042,2,19,3,16,10,0
357827,2,6,21,-15,6,1
10575,1,0,0,0,5,0
226258,2,6,0,6,16,0
242731,2,7,7,0,6,0
24213,2,10,7,3,12,0
306591,2,0,17,-17,17,0
306415,2,0,10,-10,17,0
335652,1,6,0,6,13,1
130222,3,3,26,-23,8,1
174713,4,9,7,2,10,0
50397,2,7,7,0,6,1
285853,4,14,30,-16,8,1
205111,1,0,0,0,6,0
271415,2,7,0,7,1,1
214852,1,0,9,-9,11,1
189792,3,17,6,11,17,0
416149,1,3,6,-3,15,0
181782,4,10,17,-7,13,1
67349,3,20,6,14,14,1
202237,1,3,0,3,5,1
35794,3,3,10,-7,17,0
404389,4,20,13,7,10,0
306734,2,10,17,-7,17,1
407019,4,11,34,-23,11,0
228641,2,13,14,-1,17,0
266857,4,17,17,0,16,1
281375,4,28,13,15,6,0
158230,3,31,0,31,3,0
115499,1,0,0,0,1,1
408079,4,20,17,3,12,0
400820,3,17,13,4,8,1
359687,1,0,0,0,6,0
360826,4,24,37,-13,7,1
191989,3,10,20,-10,1,1
33553,3,17,3,14,16,1
162671,3,16,17,-1,5,0
3795,4,20,10,10,2,1
322895,2,6,0,6,7,0
136468,3,17,13,4,11,0
296262,1,0,3,-3,13,1
20347,2,10,13,-3,10,0
5160,1,0,0,0,3,1
136029,4,6,10,-4,10,1
114620,2,3,3,0,1,0
206543,2,0,3,-3,7,1
38656,2,0,0,0,1,0
346208,2,20,0,20,1,0
313234,1,0,0,0,3,1
354668,3,10,10,0,4,0
130559,4,13,13,0,8,1
130049,3,10,27,-17,8,0
407161,4,17,27,-10,11,1
249731,3,21,21,0,9,1
30109,1,3,0,3,14,0
365816,1,0,0,0,9,1
361133,4,23,23,0,7,1
179351,1,0,0,0,12,1
220496,1,0,7,-7,13,0
40893,2,13,17,-4,2,0
326276,4,17,51,-34,9,0
353720,3,10,17,-7,4,0
270925,4,19,20,-1,1,1
292188,3,21,14,7,11,1
127438,2,3,0,3,6,0
131085,2,17,6,11,8,0
247061,1,2,3,-1,8,1
12536,2,3,17,-14,6,0
315107,4,53,14,39,4,0
23652,3,7,13,-6,12,0
298451,4,13,27,-14,14,1
309102,2,9,3,6,1,1
10120,4,44,7,37,5,1
63450,2,14,13,1,12,0
148736,2,13,3,10,16,0
350638,4,13,3,10,2,1
282406,3,10,23,-13,6,1
104698,1,0,0,0,14,1
32797,2,0,0,0,15,1
414834,2,13,7,6,15,1
315713,4,17,16,1,4,0
75570,2,7,3,4,17,1
26962,4,16,6,10,13,0
155922,4,17,16,1,2,0
59091,4,3,23,-20,10,1
136375,1,0,0,0,11,1
250526,3,16,7,9,9,0
226840,1,0,0,0,16,1
342641,4,22,27,-5,16,1
167956,1,0,7,-7,7,1
175079,1,7,3,4,10,0
51129,1,7,3,4,7,1
279772,1,0,0,0,5,0
318827,1,7,6,1,5,1
416485,3,21,17,4,15,1
368421,3,20,7,13,11,0
305768,4,9,10,-1,17,1
278302,2,14,0,14,4,1
308359,1,0,3,-3,1,0
178810,3,24,14,10,12,0
287360,3,20,3,17,8,0
282390,3,10,23,-13,6,1
115681,2,9,3,6,1,1
147041,4,34,0,34,15,1
359760,3,24,16,8,6,1
214700,1,3,0,3,11,0
399540,4,0,33,-33,7,1
245610,4,40,13,27,7,0
112962,1,6,0,6,17,1
96737,2,0,10,-10,10,0
397150,2,6,0,6,6,0
105103,3,26,14,12,14,0
350103,4,30,27,3,2,1
189161,2,21,0,21,16,1
357966,2,21,6,15,6,0
327196,1,0,0,0,9,0
231657,4,17,13,4,1,0
392529,3,3,20,-17,4,1
348728,4,24,10,14,2,0
236761,1,0,3,-3,3,0
210567,2,6,7,-1,9,1
153437,3,20,17,3,1,0
16740,1,3,0,3,8,0
211496,2,19,7,12,9,1
203501,3,21,3,18,6,0
12747,4,59,0,59,6,0
299960,1,0,7,-7,14,0
262716,2,14,0,14,15,1
302988,3,20,16,4,16,1
229592,3,30,13,17,17,0
291610,4,23,6,17,11,1
407945,4,17,24,-7,11,1
32140,4,24,21,3,15,0
370408,1,7,0,7,12,1
105241,3,7,24,-17,14,1
149104,3,17,17,0,16,0
140353,4,17,26,-9,12,0
209717,3,9,6,3,8,1
352987,3,19,10,9,3,1
391259,2,14,0,14,4,0
224893,2,0,6,-6,15,1
131444,4,20,19,1,8,0
25155,3,20,3,17,12,0
173918,3,13,16,-3,10,0
152846,4,28,18,10,17,0
344571,4,0,6,-6,17,0
413182,4,46,45,1,14,0
77322,1,7,7,0,1,1
407920,4,17,24,-7,11,0
119684,4,20,19,1,3,0
107705,1,0,0,0,15,1
47771,1,0,0,0,5,0
254156,3,3,12,-9,11,0
375367,3,14,24,-10,14,1
320767,4,17,23,-6,6,1
355487,4,23,20,3,4,0
379228,4,12,16,-4,16,1
282502,2,14,3,11,6,0
80953,3,20,0,20,3,0
267260,3,17,14,3,17,1
224739,2,5,0,5,15,1
383508,2,14,3,11,17,1
4285,4,27,6,21,2,1
20378,3,10,13,-3,10,1
6796,2,3,7,-4,3,0
20219,4,24,10,14,10,0
123076,4,14,21,-7,4,0
269205,2,3,3,0,17,0
386400,4,20,9,11,2,1
199108,3,14,24,-10,4,0
176285,1,0,14,-14,11,1
321058,4,16,14,2,6,1
31847,4,23,31,-8,15,0
399800,3,11,24,-13,8,1
85143,2,0,3,-3,4,1
187309,4,10,13,-3,16,1
66404,4,21,30,-9,14,1
88673,4,23,20,3,6,1
100751,1,6,0,6,12,1
240579,1,3,0,3,5,0
151585,2,0,3,-3,17,0
113611,3,6,3,3,17,0
60760,1,0,0,0,11,1
185776,4,25,3,22,15,1
177872,3,21,16,5,12,0
35040,3,9,10,-1,16,1
323964,2,17,10,7,8,0
214029,4,36,7,29,10,1
224950,3,3,9,-6,15,0
380234,3,13,16,-3,16,1
199724,4,28,10,18,4,1
297241,3,14,6,8,13,1
251844,2,14,10,4,10,0
301387,4,17,10,7,15,0
194084,4,35,14,21,1,1
218505,4,34,17,17,13,0
174298,1,7,0,7,10,1
46524,4,40,6,34,4,0
86146,3,28,10,18,5,1
278798,3,7,7,0,5,0
376002,4,23,15,8,14,0
289994,1,0,0,0,10,0
417237,3,17,20,-3,16,1
349943,4,10,12,-2,2,1
20742,4,31,20,11,10,0
98434,2,14,7,7,11,0
71643,3,3,31,-28,16,1
255344,2,14,0,14,12,0
132424,3,0,21,-21,9,1
134954,3,7,22,-15,10,1
122658,1,0,0,0,4,0
325482,3,19,3,16,8,0
206558,2,7,10,-3,7,1
118723,4,20,9,11,2,0
268401,1,7,0,7,17,1
176972,3,10,6,4,11,0
232198,3,9,9,0,1,1
113089,4,16,23,-7,17,1
86986,3,14,6,8,5,1
105593,4,32,28,4,14,1
12043,4,27,14,13,6,1
46087,4,21,14,7,4,0
207996,2,14,0,14,8,0
389208,2,21,7,14,3,0
141829,2,10,14,-4,13,1
1918,1,0,0,0,1,0
148335,3,14,3,11,16,1
346971,2,7,3,4,1,1
194864,1,0,7,-7,2,0
6996,3,10,7,3,3,1
374479,4,32,7,25,14,0
130539,4,13,6,7,8,1
51540,5,34,34,0,7,1
182642,3,0,6,-6,14,1
215895,2,3,7,-4,11,1
309840,2,14,7,7,1,1
157148,4,19,20,-1,2,0
363581,4,10,15,-5,8,0
209649,1,3,0,3,8,1
90992,2,3,0,3,7,0
351180,2,14,0,14,3,0
306075,4,17,13,4,17,1
306526,4,17,20,-3,17,1
94808,3,3,9,-6,9,1
148760,2,13,6,7,16,1
344629,1,0,10,-10,17,0
239720,3,10,10,0,4,0
418330,4,9,21,-12,16,0
236829,4,3,9,-6,3,1
206587,3,10,13,-3,7,1
335619,4,19,10,9,13,1
11343,2,14,0,14,6,1
8572,1,0,0,0,4,0
324779,4,26,14,12,8,0
87145,3,14,10,4,5,0
141704,3,23,21,2,13,0
377279,3,14,6,8,15,0
290329,1,6,3,3,10,1
55515,1,10,0,10,9,0
229022,4,23,16,7,17,1
317062,3,7,10,-3,4,1
208413,1,0,0,0,8,0
198775,2,3,6,-3,3,1
292790,3,29,17,12,11,1
304838,3,3,3,0,16,1
43828,3,14,16,-2,3,1
170041,4,35,17,18,8,1
130281,1,0,0,0,8,0
96813,4,7,17,-10,10,1
12732,3,52,0,52,6,1
358639,4,27,16,11,6,1
185858,2,9,3,6,15,0
110508,4,20,6,14,16,0
411995,1,0,0,0,13,1
147302,4,6,31,-25,15,1
232129,1,0,0,0,1,1
398688,1,0,0,0,7,0
342045,4,20,3,17,16,1
40998,1,3,7,-4,2,0
279681,2,23,3,20,5,0
10180,2,6,3,3,5,1
310334,4,26,0,26,2,1
398864,1,3,0,3,7,0
21293,3,3,14,-11,11,0
304578,4,31,34,-3,16,0
375398,4,14,24,-10,14,1
275819,4,16,3,13,3,0
131042,1,0,0,0,8,1
163136,3,16,22,-6,5,0
261925,1,0,3,-3,14,1
348660,2,3,3,0,2,0
86981,3,14,6,8,5,0
412661,3,13,10,3,14,1
303492,4,25,10,15,16,0
192842,4,7,15,-8,1,1
79886,2,3,13,-10,2,1
152442,1,7,0,7,17,1
384351,4,16,10,6,1,0
114421,4,41,20,21,1,1
366648,1,7,3,4,10,1
50500,4,20,17,3,6,0
232257,4,18,12,6,1,0
239367,1,0,7,-7,4,1
319950,2,29,10,19,6,1
149634,1,0,0,0,16,1
418139,2,21,3,18,16,1
132018,3,3,24,-21,8,0
294796,2,20,14,6,12,1
391889,3,13,20,-7,4,1
89077,3,13,6,7,6,0
112526,2,10,9,1,17,0
40597,2,24,7,17,2,0
46067,3,20,14,6,4,1
293736,1,7,0,7,12,0
213110,4,20,3,17,10,0
139664,1,0,0,0,12,1
179277,3,33,3,30,12,0
7500,4,29,6,23,4,1
315532,3,7,14,-7,4,1
317335,2,0,0,0,5,0
108167,1,0,0,0,15,1
89594,4,7,40,-33,7,0
255800,2,17,0,17,12,0
281534,4,17,16,1,6,0
332712,2,14,0,14,12,1
54443,1,0,0,0,8,0
288218,2,3,14,-11,9,1
161651,4,39,16,23,4,0
377886,3,20,10,10,15,0
304908,1,7,3,4,16,0
299058,1,0,0,0,14,1
350550,1,7,0,7,2,1
70427,2,14,17,-3,15,1
45797,4,13,14,-1,4,1
91210,4,10,17,-7,8,1
84889,3,27,17,10,4,1
43787,2,14,10,4,3,0
249671,2,11,7,4,9,1
223175,1,0,0,0,15,1
190821,3,16,3,13,17,1
196340,1,7,0,7,2,1
105369,2,23,7,16,14,0
68369,3,3,14,-11,14,0
344607,1,0,0,0,17,0
400637,2,3,0,3,8,0
278492,3,36,0,36,4,1
246201,3,21,6,15,7,0
392185,3,3,13,-10,4,1
113383,1,0,0,0,17,1
411324,2,10,10,0,13,0
384314,3,16,0,16,1,0
254426,2,20,0,20,11,0
398676,4,0,6,-6,7,0
19516,1,0,0,0,10,1
175025,4,20,28,-8,10,0
394250,4,53,32,21,5,0
338732,4,27,17,10,14,0
12322,4,6,14,-8,6,1
350163,2,8,0,8,2,1
198807,3,3,16,-13,3,1
316566,2,3,6,-3,4,1
248852,1,0,0,0,9,1
13708,1,0,14,-14,7,1
61046,4,34,19,15,11,1
30143,2,10,10,0,14,1
287823,3,28,17,11,9,0
397078,4,24,16,8,6,0
296114,1,0,0,0,13,1
297949,2,20,7,13,13,1
271833,1,0,0,0,2,0
235766,4,13,27,-14,3,1
129912,4,13,0,13,7,1
51290,2,6,3,3,7,0
171705,1,0,0,0,9,0
42981,4,38,23,15,3,0
147741,4,17,24,-7,15,1
408298,2,0,0,0,12,0
393776,4,7,14,-7,5,0
321301,3,9,19,-10,6,1
44622,4,20,21,-1,3,0
160123,1,7,0,7,3,0
228450,1,3,0,3,17,1
26240,2,0,14,-14,13,1
121166,2,7,13,-6,3,0
188341,1,0,0,0,16,1
298807,2,14,6,8,14,1
404824,4,20,20,0,10,1
97727,4,9,13,-4,11,1
377337,4,24,17,7,15,0
241466,4,10,42,-32,5,0
414469,4,16,23,-7,14,1
387594,4,6,3,3,2,1
417642,2,21,3,18,16,1
132351,1,0,0,0,9,0
42002,1,3,0,3,2,0
234449,2,10,6,4,2,1
265302,1,0,0,0,16,0
194509,4,26,10,16,2,1
197620,3,26,0,26,3,0
327784,1,0,0,0,10,1
106235,5,10,10,0,14,1
63013,2,6,21,-15,12,0
56036,4,17,23,-6,9,0
258565,2,0,0,0,13,0
212795,3,17,21,-4,10,0
256240,2,6,7,-1,12,1
345410,2,0,10,-10,17,1
21989,2,7,10,-3,11,1
328394,1,0,0,0,10,1
324260,2,15,0,15,8,0
410928,4,14,15,-1,13,0
276564,1,0,0,0,4,0
98124,2,14,10,4,11,1
350743,2,10,0,10,2,0
369893,3,7,9,-2,12,0
280747,3,14,14,0,5,1
411844,4,7,34,-27,13,0
326549,4,44,22,22,9,1
238573,4,16,20,-4,4,1
340924,2,0,10,-10,15,1
190561,4,17,20,-3,17,1
254486,4,23,13,10,11,1
359551,1,0,0,0,6,1
221873,2,6,7,-1,14,1
420136,2,0,3,-3,17,1
393554,2,7,9,-2,5,1
65616,3,6,9,-3,13,0
17643,2,7,3,4,9,1
347109,2,10,3,7,1,1
229726,3,13,17,-4,17,0
211565,4,42,21,21,9,1
324726,3,16,7,9,8,1
225170,2,3,0,3,15,0
17184,2,7,14,-7,9,0
238265,4,10,24,-14,4,0
300678,4,24,3,21,15,1
239965,1,0,10,-10,5,1
334046,1,0,0,0,13,1
381145,4,31,28,3,16,0
394910,3,0,17,-17,5,1
272534,2,10,3,7,2,0
309135,3,26,3,23,1,0
17890,4,24,17,7,9,1
303532,1,0,0,0,16,1
414998,2,10,10,0,15,0
360049,3,3,33,-30,7,1
399049,2,10,12,-2,7,1
101372,2,6,0,6,12,0
48072,1,0,0,0,5,0
374795,1,7,0,7,14,0
116789,4,25,26,-1,2,1
190966,3,12,0,12,17,0
20166,2,10,0,10,10,0
80589,1,0,7,-7,3,1
39372,1,0,0,0,1,0
384251,1,6,0,6,1,0
257867,3,13,12,1,13,1
251061,1,7,7,0,10,0
306485,3,10,17,-7,17,1
315400,3,16,23,-7,4,1
290254,3,17,3,14,10,1
147793,1,0,7,-7,15,0
328521,4,15,3,12,10,0
43920,1,0,7,-7,3,0
205079,4,19,20,-1,6,1
83335,1,0,7,-7,4,0
287204,3,13,20,-7,8,1
308871,3,10,13,-3,1,1
51804,4,10,22,-12,7,1
16886,1,7,13,-6,8,1
347645,3,17,10,7,1,1
289755,2,0,10,-10,10,0
300482,2,16,3,13,14,1
62768,3,17,0,17,12,1
212520,4,13,16,-3,10,1
260329,2,0,0,0,14,0
5833,3,27,7,20,3,0
232573,4,26,24,2,1,1
411914,2,17,3,14,13,0
144706,2,3,0,3,14,0
341636,1,3,3,0,16,1
69434,3,24,3,21,15,0
387663,2,0,7,-7,2,1
395611,2,7,10,-3,6,0
387696,3,0,13,-13,2,0
206880,3,10,17,-7,7,0
95073,1,0,7,-7,9,0
347687,4,27,24,3,1,0
335503,1,0,0,0,13,0
268574,2,7,3,4,17,1
145784,3,13,10,3,15,1
211494,2,19,7,12,9,1
417146,1,0,10,-10,16,1
403829,4,18,30,-12,9,1
125156,2,14,7,7,5,1
97005,1,7,0,7,10,1
189959,3,13,7,6,17,0
277259,3,0,13,-13,4,0
303397,1,10,0,10,16,0
201475,2,12,7,5,5,1
155817,2,7,10,-3,2,0
15808,3,0,12,-12,8,0
303671,4,38,19,19,16,0
180734,2,0,3,-3,13,1
59708,1,0,0,0,11,0
55755,1,0,0,0,9,0
294409,4,19,9,10,12,1
405744,3,10,7,3,10,1
128157,1,7,0,7,7,0
148080,4,14,10,4,15,1
273098,1,0,0,0,2,0
261517,2,9,0,9,14,1
140804,4,22,30,-8,12,0
166225,1,0,0,0,6,1
331323,3,0,27,-27,11,1
331620,3,23,30,-7,11,0
125626,3,14,24,-10,5,1
119055,1,0,0,0,3,0
111545,3,21,10,11,16,1
153883,3,7,3,4,1,1
185755,3,23,3,20,15,1
75039,4,34,17,17,17,0
293113,4,10,27,-17,11,0
360365,4,7,20,-13,7,0
213201,2,3,10,-7,10,0
1637,1,0,0,0,1,1
345014,4,16,23,-7,17,1
178003,3,7,13,-6,12,1
375910,2,14,3,11,14,0
379511,4,26,18,8,16,1
172330,1,0,0,0,9,0
330915,4,23,31,-8,11,1
386072,3,14,3,11,1,1
194867,1,0,10,-10,2,1
302874,4,15,23,-8,15,0
27503,3,20,9,11,13,1
235578,3,27,13,14,3,0
350207,3,19,0,19,2,1
54174,2,0,3,-3,8,1
280753,4,14,14,0,5,0
111452,4,0,20,-20,16,0
283099,2,3,0,3,7,0
369617,4,20,14,6,11,1
331375,4,8,33,-25,11,0
183593,1,0,0,0,14,1
224357,4,16,12,4,15,1
16667,3,14,27,-13,8,0
76664,3,10,0,10,1,1
299262,2,17,0,17,14,1
214857,2,0,9,-9,11,1
56794,4,17,13,4,9,0
382089,2,21,3,18,17,0
219104,4,45,20,25,13,1
31321,2,7,3,4,15,1
238679,3,16,17,-1,4,1
34014,4,17,27,-10,16,0
292507,4,10,12,-2,11,1
40257,1,0,0,0,2,1
71565,1,3,7,-4,16,0
410051,1,0,0,0,13,0
227013,2,10,6,4,16,0
93767,4,3,16,-13,9,1
358739,3,14,17,-3,6,1
178599,1,3,3,0,12,0
144948,4,20,7,13,14,0
168421,2,0,10,-10,7,1
179762,3,6,17,-11,12,0
144216,1,3,7,-4,14,0
356486,2,0,3,-3,5,1
376661,2,3,0,3,14,1
217006,3,6,3,3,12,0
257999,3,0,28,-28,13,1
348737,4,24,17,7,2,1
343349,2,0,20,-20,16,1
208341,3,17,24,-7,8,1
188537,2,3,3,0,16,0
95037,4,20,16,4,9,0
145335,3,35,19,16,14,1
218799,4,3,19,-16,13,0
213778,1,14,0,14,10,0
322305,1,7,0,7,7,0
122882,3,24,6,18,4,1
9963,4,3,3,0,5,1
409467,1,0,0,0,12,0
217020,3,13,3,10,12,0
403395,1,0,0,0,9,0
188481,4,10,17,-7,16,0
57947,3,13,17,-4,10,1
210098,1,0,0,0,9,1
231321,2,9,10,-1,1,0
174592,4,13,20,-7,10,0
141269,4,10,24,-14,13,1
109413,2,6,10,-4,16,1
144946,4,20,7,13,14,0
228247,4,10,27,-17,17,0
93776,4,3,16,-13,9,0
101066,2,7,10,-3,12,0
228361,3,7,17,-10,17,0
335727,3,10,7,3,13,0
165022,2,7,10,-3,6,1
83907,4,23,17,6,4,0
159049,1,10,0,10,3,0
43496,2,7,0,7,3,0
380371,2,10,10,0,16,0
229403,2,3,0,3,17,0
179695,1,0,0,0,12,0
166513,4,23,27,-4,6,0
306322,3,24,10,14,17,0
79037,3,10,7,3,2,0
16060,2,16,0,16,8,1
283672,1,0,0,0,7,0
204222,1,0,7,-7,6,0
332126,1,0,0,0,12,1
253668,2,0,0,0,11,1
280244,2,3,13,-10,5,1
121442,1,0,0,0,4,1
282574,4,23,24,-1,6,1
257166,1,0,6,-6,12,0
368483,1,0,0,0,11,1
30992,2,0,3,-3,15,0
388357,4,17,12,5,2,1
384476,4,28,0,28,1,0
333625,1,0,0,0,12,1
185554,2,10,10,0,15,0
186489,3,17,19,-2,15,0
241532,2,3,3,0,5,0
241418,3,7,28,-21,5,0
12455,4,13,6,7,6,1
100672,3,21,14,7,12,0
408942,3,17,15,2,12,1
17583,4,13,17,-4,9,1
241794,1,0,3,-3,5,1
315324,1,3,3,0,4,0
130670,3,7,38,-31,8,1
9118,1,0,0,0,5,0
203522,4,24,3,21,6,1
17577,4,13,17,-4,9,0
408077,4,20,17,3,12,0
362685,3,3,10,-7,8,1
156523,4,7,6,1,2,1
300294,2,0,7,-7,14,0
110609,2,17,10,7,16,1
392090,4,18,40,-22,4,1
47362,3,3,13,-10,5,1
9507,4,13,10,3,5,0
344278,3,14,13,1,17,0
294081,3,7,21,-14,12,0
288781,1,0,7,-7,9,1
191093,2,7,10,-3,17,0
186751,2,20,0,20,15,0
21490,4,15,17,-2,11,0
340381,3,17,13,4,15,1
25149,3,17,3,14,12,1
238466,1,6,0,6,4,1
45479,3,27,17,10,4,1
159175,1,7,0,7,3,0
160867,4,34,27,7,4,0
269805,2,13,7,6,1,1
111870,4,16,10,6,17,0
171388,4,16,20,-4,9,1
21944,1,7,0,7,11,1
339515,1,0,0,0,15,1
293072,3,10,13,-3,11,1
257404,4,20,14,6,13,0
402937,1,0,0,0,9,0
387338,1,7,0,7,2,0
167046,3,13,17,-4,7,1
345880,2,3,14,-11,17,0
335189,4,20,13,7,13,1
329244,3,17,13,4,10,1
258516,1,0,0,0,13,1
157727,2,10,10,0,2,1
389243,3,28,7,21,3,1
309738,3,19,9,10,1,1
189143,1,14,0,14,16,1
116760,3,13,26,-13,2,1
242324,3,10,13,-3,6,1
193786,1,0,0,0,1,0
307305,2,14,6,8,17,1
138565,5,31,37,-6,12,0
124622,4,13,17,-4,5,0
34816,1,0,0,0,16,1
52475,1,3,0,3,7,0
64754,3,28,7,21,13,1
293933,2,7,21,-14,12,0
176960,2,10,3,7,11,1
356,2,14,10,4,1,1
257543,3,19,10,9,13,1
388536,4,3,23,-20,2,0
36069,2,24,0,24,17,1
111017,4,14,29,-15,16,0
237588,4,38,22,16,3,0
28868,3,23,7,16,14,0
406439,4,31,7,24,11,0
324497,1,0,0,0,8,0
264993,4,32,17,15,16,1
198027,3,0,30,-30,3,0
11656,2,14,0,14,6,1
384410,2,14,0,14,1,0
418377,1,14,0,14,16,0
244835,3,7,3,4,7,0
318146,3,9,10,-1,5,1
42459,1,0,5,-5,3,1
356639,1,7,3,4,5,0
243068,2,0,9,-9,6,1
336790,4,10,17,-7,14,1
368948,1,7,7,0,11,0
194652,3,24,7,17,2,1
373550,3,10,26,-16,13,1
357742,4,43,13,30,5,0
27492,3,20,7,13,13,0
143697,4,19,10,9,14,1
280679,2,0,3,-3,5,0
158535,4,10,17,-7,3,1
399526,3,0,26,-26,7,0
144178,4,30,13,17,14,0
403767,3,12,13,-1,9,0
187214,2,0,6,-6,16,0
394157,2,16,10,6,5,0
209963,1,0,3,-3,8,0
178052,4,13,23,-10,12,1
72955,3,30,7,23,16,1
952,3,0,3,-3,1,0
234401,4,24,10,14,2,0
406611,1,0,0,0,11,1
228639,2,13,14,-1,17,0
92193,4,10,43,-33,8,0
291308,3,21,22,-1,10,1
223448,4,20,26,-6,15,0
337897,2,10,0,10,14,0
125035,3,3,12,-9,5,0
132640,1,0,0,0,9,0
245673,1,3,3,0,7,1
398858,1,3,0,3,7,0
234093,4,26,14,12,2,1
175793,1,7,0,7,11,0
191345,1,0,14,-14,17,0
61833,2,3,20,-17,12,1
292993,1,0,6,-6,11,1
116768,3,16,26,-10,2,1
174934,2,3,7,-4,10,0
307320,2,14,19,-5,17,1
69100,2,7,7,0,15,0
337004,2,10,0,10,14,1
183689,3,6,14,-8,14,0
16814,3,13,24,-11,8,1
22838,1,0,0,0,11,0
139715,3,7,7,0,12,0
173813,4,17,3,14,10,1
413588,3,9,17,-8,14,0
302901,1,13,0,13,16,0
247615,4,19,23,-4,8,0
14387,1,0,0,0,7,0
17832,2,13,10,3,9,1
203007,2,14,0,14,5,0
386076,3,14,3,11,1,0
350858,1,0,0,0,3,0
355769,4,10,6,4,5,0
31014,2,3,3,0,15,0
67416,1,7,0,7,14,1
377837,2,17,6,11,15,0
246938,2,20,7,13,8,0
356766,1,0,0,0,5,1
9829,4,20,17,3,5,0
320678,1,14,10,4,6,0
15757,2,0,5,-5,8,0
225103,4,13,14,-1,15,0
298890,4,21,23,-2,14,1
333140,1,0,0,0,12,0
312337,2,7,17,-10,3,1
163168,4,22,28,-6,5,1
365947,4,14,28,-14,9,0
4498,2,14,19,-5,2,1
276426,1,0,0,0,4,1
338270,4,34,31,3,14,0
235147,3,0,10,-10,2,0
326353,3,14,10,4,9,1
228672,3,16,17,-1,17,1
293893,1,0,7,-7,12,0
330742,4,9,6,3,11,1
182308,2,14,7,7,14,0
256887,2,7,10,-3,12,1
369945,1,0,0,0,12,1
349712,2,14,7,7,2,0
62651,4,17,20,-3,12,0
390043,1,0,0,0,3,1
351565,4,0,27,-27,3,1
32664,2,0,0,0,15,1
353440,4,25,3,22,4,0
24310,1,0,0,0,12,0
237633,2,3,7,-4,4,1
133236,4,23,20,3,9,1
186969,4,10,12,-2,15,0
182827,3,29,17,12,14,0
61291,4,28,14,14,11,1
201354,4,28,13,15,5,0
321890,2,14,21,-7,7,1
372783,3,3,0,3,13,1
62402,2,0,10,-10,12,0
419251,1,0,0,0,16,1
199589,4,40,17,23,4,1
273347,3,28,0,28,2,1
375667,3,17,20,-3,14,1
40952,4,16,20,-4,2,1
233574,2,14,27,-13,2,1
3772,3,20,10,10,2,0
399295,1,14,0,14,7,0
232444,1,3,0,3,1,1
14698,1,6,0,6,7,1
348135,4,17,22,-5,1,1
279267,3,19,13,6,5,0
411247,4,11,26,-15,13,1
28623,1,0,0,0,14,1
219368,3,23,13,10,13,1
64924,4,10,6,4,13,1
132297,3,24,14,10,9,1
321007,3,10,7,3,6,1
177735,3,13,17,-4,12,1
48917,4,15,13,2,5,0
147965,1,0,0,0,15,0
145625,3,21,0,21,14,0
300576,1,0,0,0,15,0
211779,1,0,7,-7,9,0
155154,1,0,0,0,1,0
194946,4,14,10,4,2,0
395111,4,17,34,-17,5,1
408294,2,0,0,0,12,0
188404,2,3,3,0,16,0
294336,2,10,3,7,12,1
291994,2,6,3,3,11,0
191198,1,0,10,-10,17,0
392610,2,7,0,7,4,1
7827,1,0,0,0,4,0
275330,3,10,16,-6,3,0
84705,2,3,7,-4,4,1
178712,4,3,20,-17,12,0
7572,2,14,0,14,4,0
3886,2,19,7,12,2,1
313978,1,0,0,0,3,1
57824,4,19,10,9,10,1
313491,4,17,17,0,3,0
282082,2,9,8,1,6,0
166444,3,17,7,10,6,0
267261,3,17,14,3,17,1
66346,3,7,21,-14,14,1
262696,1,7,0,7,15,0
28308,1,0,0,0,14,1
91389,4,21,14,7,8,1
165286,4,17,21,-4,6,1
233190,4,43,18,25,2,0
6109,3,7,10,-3,3,0
140392,4,17,29,-12,12,1
72364,3,7,20,-13,16,1
217894,3,17,21,-4,12,0
12740,4,59,0,59,6,1
215928,3,10,14,-4,11,0
95981,2,0,0,0,10,0
360026,2,3,26,-23,7,0
330512,2,7,7,0,11,0
397529,1,0,0,0,7,1
306605,2,7,20,-13,17,0
137990,2,7,14,-7,11,1
348636,1,0,3,-3,2,1
147705,3,10,10,0,15,0
303243,1,3,0,3,16,1
192075,1,0,0,0,1,0
339464,3,10,23,-13,15,0
332165,2,0,10,-10,12,1
64304,2,6,10,-4,13,0
204328,4,0,17,-17,6,0
222086,4,27,17,10,14,1
384614,3,10,49,-39,1,0
47948,2,0,21,-21,5,1
257036,2,0,14,-14,12,1
268036,4,21,9,12,17,1
389701,4,27,16,11,3,1
16907,2,14,13,1,8,1
306448,2,3,17,-14,17,0
239025,4,29,18,11,4,1
400465,1,0,0,0,8,0
44085,2,0,12,-12,3,0
66476,2,7,10,-3,14,0
220662,2,10,0,10,13,0
82968,3,13,16,-3,4,0
286310,4,22,16,6,8,0
66113,4,10,6,4,13,1
297204,2,0,0,0,13,0
42998,1,0,0,0,3,0
369858,2,7,3,4,12,1
276238,4,31,10,21,3,0
238184,2,3,16,-13,4,1
347816,3,10,0,10,1,1
146990,3,17,0,17,15,1
59762,2,9,10,-1,11,0
313732,2,14,3,11,3,1
251996,2,7,13,-6,10,1
42543,4,10,21,-11,3,0
340253,4,29,34,-5,15,1
209884,3,16,16,0,8,0
72184,2,10,10,0,16,0
407775,4,10,7,3,11,0
42904,2,7,6,1,3,0
223279,4,3,9,-6,15,0
209222,3,17,7,10,8,1
34078,2,0,0,0,16,1
58303,4,20,13,7,10,1
415079,1,0,0,0,15,0
205334,2,20,0,20,6,1
283185,4,26,9,17,7,0
37972,4,17,14,3,1,1
86780,1,0,0,0,5,1
249249,3,19,14,5,9,0
17156,1,0,0,0,9,0
406071,2,0,13,-13,11,0
69993,2,21,3,18,15,0
280859,3,10,3,7,6,1
230651,1,0,0,0,1,0
144445,3,10,26,-16,14,0
28823,2,10,6,4,14,0
274345,1,3,7,-4,3,0
113697,1,0,10,-10,17,1
232272,1,0,0,0,1,1
154137,2,0,6,-6,1,1
377575,3,17,12,5,15,1
396246,2,0,3,-3,6,1
175467,4,20,30,-10,11,1
56841,1,0,0,0,9,1
14010,2,3,14,-11,7,1
20549,4,17,0,17,10,0
400568,4,13,24,-11,8,0
293726,4,13,13,0,12,1
154290,2,6,14,-8,1,0
226651,4,17,13,4,16,0
302172,1,14,0,14,15,1
126096,4,20,9,11,6,1
355648,4,38,17,21,5,0
58481,4,48,23,25,10,1
311970,4,35,17,18,2,1
405371,1,0,0,0,10,1
289132,2,13,0,13,9,1
57952,3,13,17,-4,10,0
410387,2,0,7,-7,13,0
284945,3,10,14,-4,7,0
129636,4,23,23,0,7,0
289040,3,32,21,11,9,0
94042,3,6,21,-15,9,0
120560,2,0,6,-6,3,0
26511,5,30,29,1,13,0
46900,3,13,20,-7,5,1
29325,3,21,7,14,14,0
366599,4,26,14,12,10,0
147943,4,31,41,-10,15,1
110320,3,3,17,-14,16,1
169428,4,13,31,-18,8,1
262722,2,21,0,21,15,0
32280,4,27,27,0,15,0
278773,2,0,0,0,5,1
344261,3,7,13,-6,17,1
262321,3,13,9,4,15,1
290772,1,0,0,0,10,0
225133,1,0,0,0,15,0
409926,1,0,7,-7,12,0
23629,2,7,10,-3,12,0
164721,1,6,7,-1,6,1
129846,2,10,0,10,7,1
250130,1,7,0,7,9,1
90054,4,18,21,-3,7,0
99511,3,3,10,-7,11,0
356061,4,27,10,17,5,0
119845,4,24,21,3,3,1
325321,3,12,10,2,8,1
257961,2,0,7,-7,13,0
334488,1,0,14,-14,13,1
290173,1,3,0,3,10,1
226043,1,0,0,0,16,1
133961,4,16,6,10,9,0
7014,4,13,7,6,3,1
328796,3,17,13,4,10,1
419312,3,0,17,-17,16,0
333721,4,21,7,14,12,1
301368,4,17,7,10,15,0
351482,1,0,17,-17,3,0
135212,2,13,3,10,10,0
339201,1,0,0,0,15,0
261780,1,0,0,0,14,0
319693,4,33,9,24,6,1
261887,4,6,26,-20,14,0
210626,3,13,17,-4,9,1
263281,1,7,0,7,15,1
292412,1,3,0,3,11,0
378964,4,23,30,-7,15,1
82564,1,0,0,0,3,0
199907,4,17,24,-7,4,0
38318,1,0,0,0,1,0
164733,2,13,14,-1,6,1
63735,2,7,12,-5,12,1
377378,2,0,6,-6,15,1
250565,4,19,22,-3,9,1
244573,4,25,16,9,7,0
137538,2,17,17,0,11,1
395811,3,3,7,-4,6,1
265854,1,0,6,-6,16,1
193828,2,10,0,10,1,1
79578,2,7,0,7,2,1
281986,3,21,21,0,6,0
122470,3,13,26,-13,4,0
256397,2,9,7,2,12,1
340884,1,0,3,-3,15,0
252898,2,6,0,6,11,0
356998,3,20,3,17,5,1
177794,1,0,0,0,12,0
259395,1,0,0,0,13,1
58900,3,6,25,-19,10,1
296292,2,0,10,-10,13,1
401303,4,20,21,-1,8,0
286900,3,16,7,9,8,0
42856,4,6,37,-31,3,1
46408,4,12,17,-5,4,0
11006,4,9,31,-22,5,0
103633,2,0,7,-7,13,0
287963,3,14,13,1,9,1
174246,4,10,33,-23,10,1
104497,3,14,31,-17,13,0
4172,1,7,3,4,2,0
314211,3,14,20,-6,3,1
118776,1,10,0,10,2,0
146863,3,31,0,31,15,0
407280,3,17,16,1,11,0
233439,3,17,10,7,2,0
162163,1,7,0,7,4,1
96214,4,3,19,-16,10,0
324242,2,3,0,3,8,1
239892,3,13,3,10,4,0
274708,3,10,12,-2,3,0
22268,2,0,0,0,11,0
316975,4,44,18,26,4,0
384555,2,3,28,-25,1,0
186424,2,10,7,3,15,0
358711,2,7,13,-6,6,0
146239,3,3,16,-13,15,0
386403,4,20,9,11,2,0
127708,1,0,0,0,6,0
63411,1,6,3,3,12,1
283317,4,10,9,1,7,1
341905,4,37,15,22,16,0
412072,3,24,0,24,13,0
119272,2,13,3,10,3,1
39474,4,13,12,1,1,1
388537,4,3,23,-20,2,1
402594,3,10,16,-6,9,0
9095,4,30,13,17,4,1
329683,3,23,17,6,11,1
343348,2,0,20,-20,16,1
114654,2,3,10,-7,1,1
406457,1,0,3,-3,11,1
52970,3,14,17,-3,7,1
210307,3,9,10,-1,9,1
405882,2,7,0,7,11,0
254764,3,10,3,7,11,0
137333,1,3,0,3,11,0
12088,2,7,7,0,6,1
2427,3,21,13,8,2,1
339024,4,20,3,17,15,0
95,3,7,7,0,1,1
96663,4,3,17,-14,10,1
209048,2,3,3,0,8,0
325477,3,19,3,16,8,0
358980,2,7,0,7,6,1
135676,3,7,10,-3,10,1
340724,1,0,0,0,15,1
12492,1,0,0,0,6,0
222812,3,10,13,-3,14,1
155716,3,10,20,-10,2,1
44706,2,0,9,-9,3,0
378324,3,9,6,3,15,0
54008,1,0,0,0,8,0
407294,3,17,16,1,11,0
141886,4,24,21,3,13,1
371567,2,3,0,3,12,0
127737,1,0,7,-7,6,0
5654,2,0,14,-14,3,0
365653,4,45,35,10,9,1
183633,2,0,8,-8,14,1
57308,2,7,0,7,10,1
344700,3,6,20,-14,17,0
99573,1,0,0,0,11,1
194792,3,10,23,-13,2,1
48203,1,0,0,0,5,1
221828,1,0,0,0,14,0
301829,4,6,34,-28,15,1
154760,3,13,10,3,1,0
200522,1,0,0,0,4,0
245203,4,19,28,-9,7,1
261270,4,38,0,38,14,1
415873,2,7,20,-13,15,1
5191,1,7,3,4,3,0
141141,1,3,7,-4,13,0
37558,4,13,10,3,17,1
150131,2,3,13,-10,16,1
1616,1,0,0,0,1,0
139906,1,0,0,0,12,0
29354,4,21,16,5,14,1
369173,4,19,14,5,11,0
89104,3,16,6,10,6,0
94559,4,10,10,0,9,1
263522,4,20,26,-6,15,1
4583,1,6,7,-1,2,1
125719,1,0,7,-7,5,1
18459,3,7,7,0,9,0
15181,2,3,0,3,8,0
141442,4,16,23,-7,13,1
186098,1,0,0,0,15,1
18993,2,0,0,0,10,0
176721,4,36,19,17,11,0
53727,3,7,3,4,8,1
309355,1,0,0,0,1,0
105706,3,28,3,25,14,1
167326,2,16,16,0,7,1
268851,1,0,7,-7,17,1
69554,2,0,7,-7,15,0
76089,4,13,23,-10,1,1
249809,1,3,3,0,9,1
77169,1,0,0,0,1,0
306617,3,7,20,-13,17,1
59028,2,0,10,-10,10,1
205608,1,7,3,4,7,0
283722,2,8,3,5,7,0
179712,2,0,7,-7,12,0
354425,1,7,0,7,4,0
55874,4,19,14,5,9,0
65725,2,7,16,-9,13,0
264975,4,29,17,12,16,0
195224,3,16,10,6,2,1
145349,4,42,26,16,14,0
13849,1,0,0,0,7,1
337574,1,7,0,7,14,0
205902,1,0,0,0,7,1
124533,2,6,0,6,5,1
91732,1,0,0,0,8,0
31437,2,3,0,3,15,0
66688,4,10,30,-20,14,0
20800,2,7,0,7,10,1
87845,2,10,9,1,6,0
86587,3,30,3,27,5,1
236422,1,0,0,0,3,1
7727,2,17,3,14,4,1
368241,2,0,3,-3,11,1
94184,2,17,7,10,9,1
141360,2,3,17,-14,13,1
77650,2,0,10,-10,1,1
221364,1,0,10,-10,14,0
121615,1,0,0,0,4,1
145261,1,14,6,8,14,0
167720,4,26,20,6,7,0
250969,3,3,6,-3,10,0
4367,3,7,7,0,2,0
245569,2,40,0,40,7,0
308277,4,13,16,-3,1,0
161633,4,36,16,20,4,0
163160,3,22,25,-3,5,0
157737,3,10,10,0,2,1
53047,1,7,0,7,7,1
259452,2,14,10,4,13,0
42747,1,3,0,3,3,0
13572,2,3,0,3,7,0
224045,3,14,6,8,15,0
74421,3,10,20,-10,17,1
137392,2,3,21,-18,11,1
197336,4,17,10,7,3,1
97467,1,6,0,6,10,1
83511,2,0,7,-7,4,1
297472,1,0,0,0,13,0
330610,1,0,0,0,11,0
385811,4,30,3,27,1,0
21484,4,15,17,-2,11,1
391785,4,10,13,-3,4,0
223196,2,3,3,0,15,1
95837,3,6,10,-4,10,0
253848,2,20,14,6,11,1
255907,1,3,0,3,12,0
9187,3,3,16,-13,5,1
80728,1,0,0,0,3,1
142917,2,3,10,-7,13,1
286897,3,16,7,9,8,0
211465,2,13,7,6,9,0
301681,4,17,6,11,15,0
100262,4,24,14,10,12,1
400056,2,14,3,11,8,0
365291,2,10,16,-6,9,0
170854,2,7,0,7,8,1
128013,1,0,0,0,7,1
409756,4,13,9,4,12,0
256550,2,7,0,7,12,1
80094,4,24,22,2,2,1
26572,2,10,6,4,13,0
107433,1,0,3,-3,15,0
415049,4,10,27,-17,15,1
170494,4,21,10,11,8,0
38269,4,13,14,-1,1,1
35610,2,7,3,4,17,1
417357,2,10,3,7,16,0
277848,2,7,14,-7,4,1
212947,3,7,7,0,10,1
182726,4,27,26,1,14,0
17911,1,0,0,0,9,1
227582,2,28,0,28,16,0
364415,3,35,14,21,9,1
107956,3,6,6,0,15,1
244938,2,0,20,-20,7,1
187055,2,3,0,3,16,1
157849,2,6,9,-3,3,0
45946,4,17,3,14,4,1
288999,2,19,7,12,9,0
100363,3,9,20,-11,12,1
161155,4,3,33,-30,4,1
153601,4,12,14,-2,1,0
414549,2,21,3,18,14,0
302043,2,7,10,-3,15,0
387681,2,0,7,-7,2,0
298479,1,10,0,10,14,1
109857,2,17,0,17,16,1
71915,3,15,13,2,16,1
213117,4,20,6,14,10,1
170264,2,0,9,-9,8,0
137531,2,17,17,0,11,0
133124,2,7,3,4,9,0
368844,2,17,0,17,11,1
357130,3,6,14,-8,5,1
38467,1,0,0,0,1,0
279155,4,21,23,-2,5,0
51846,1,0,0,0,7,0
111738,4,44,16,28,16,0
166206,4,35,19,16,6,1
256511,1,0,0,0,12,0
421621,1,3,0,3,17,0
346582,4,32,47,-15,1,1
138523,4,31,30,1,12,0
411155,2,0,20,-20,13,1
379560,2,13,3,10,16,0
184183,1,0,0,0,14,1
165203,2,7,7,0,6,0
338027,1,0,0,0,14,0
126296,1,0,7,-7,6,1
215224,3,10,16,-6,11,1
168019,3,3,14,-11,7,0
151738,2,7,6,1,17,0
47234,4,12,9,3,5,0
239290,3,3,7,-4,4,0
11814,2,27,10,17,6,0
206028,4,16,17,-1,7,1
222344,3,21,3,18,14,0
233318,4,7,23,-16,2,1
250221,4,24,23,1,9,1
191955,2,0,12,-12,1,0
127255,1,0,0,0,6,1
311176,1,3,0,3,2,0
289782,3,10,10,0,10,0
317390,3,7,10,-3,5,1
195542,3,6,0,6,2,0
415294,2,0,14,-14,15,1
165037,2,7,17,-10,6,1
71351,4,10,20,-10,16,0
197545,1,9,0,9,3,1
305776,4,16,10,6,17,0
337779,2,23,6,17,14,0
328421,1,3,0,3,10,0
211796,2,0,7,-7,9,0
349593,3,13,28,-15,2,1
68128,4,6,10,-4,14,1
19550,2,0,7,-7,10,1
311219,3,6,0,6,2,0
195365,2,10,3,7,2,0
86787,1,0,0,0,5,0
264283,3,10,23,-13,15,1
200103,2,7,10,-3,4,1
83354,2,0,14,-14,4,1
420968,3,7,21,-14,17,1
154481,3,14,10,4,1,1
227576,2,21,0,21,16,1
340418,4,24,13,11,15,0
45691,1,0,0,0,4,1
70738,2,7,10,-3,15,0
297964,3,30,7,23,13,0
134879,1,7,0,7,10,0
396242,2,0,3,-3,6,1
255748,1,0,0,0,12,1
185899,3,16,16,0,15,0
15844,4,8,12,-4,8,1
297928,2,10,0,10,13,0
312803,2,0,0,0,3,1
415233,1,0,0,0,15,0
104726,1,3,13,-10,14,1
78373,1,0,0,0,2,1
87045,4,14,22,-8,5,0
27998,4,30,17,13,13,0
314082,3,30,14,16,3,0
147375,2,0,7,-7,15,1
126255,4,28,9,19,6,0
336793,4,10,17,-7,14,1
10164,2,6,0,6,5,0
54572,4,28,18,10,8,0
100119,4,16,6,10,12,0
325036,3,20,24,-4,8,1
413738,3,21,16,5,14,1
67158,2,0,0,0,14,0
225232,3,10,7,3,15,0
215490,3,10,3,7,11,1
248273,2,7,0,7,8,1
361131,4,23,23,0,7,1
348614,4,34,23,11,2,0
356807,2,0,7,-7,5,1
243695,1,7,3,4,6,1
197696,2,7,3,4,3,1
89725,4,16,20,-4,7,0
368618,4,16,13,3,11,1
33372,2,13,10,3,16,1
85199,3,10,10,0,4,0
161882,2,13,9,4,4,0
362681,3,3,10,-7,8,0
274213,2,17,0,17,3,0
143331,2,0,13,-13,14,1
379410,1,0,0,0,16,1
211452,2,6,7,-1,9,1
92974,2,10,0,10,8,0
375491,3,26,7,19,14,0
132899,4,6,21,-15,9,0
295322,4,14,5,9,12,0
195711,4,14,13,1,2,0
394166,2,16,10,6,5,0
300162,2,21,3,18,14,0
234406,1,0,0,0,2,1
164364,3,20,3,17,5,1
387399,2,21,7,14,2,0
400720,4,16,16,0,8,0
75907,3,29,7,22,1,0
284684,4,17,27,-10,7,1
38563,4,37,6,31,1,1
398388,4,3,27,-24,7,0
149160,4,17,31,-14,16,1
382749,4,9,20,-11,17,0
252421,1,0,0,0,10,0
399629,2,6,6,0,8,1
124917,4,9,16,-7,5,0
390339,1,0,7,-7,3,1
190389,2,7,0,7,17,0
20307,2,10,3,7,10,0
229669,1,7,7,0,17,1
234928,1,10,3,7,2,1
292069,4,22,19,3,11,0
171142,2,3,0,3,8,1
167155,1,6,0,6,7,0
332423,2,7,3,4,12,1
358035,4,24,22,2,6,1
250172,2,17,0,17,9,1
25940,1,3,0,3,13,0
89899,4,30,20,10,7,0
19868,2,10,21,-11,10,1
159047,1,10,0,10,3,1
216557,4,37,11,26,12,0
301857,1,0,0,0,15,1
59838,4,15,16,-1,11,1
184319,1,0,0,0,14,0
12177,1,0,0,0,6,1
132361,1,0,0,0,9,0
296931,3,25,0,25,13,1
354196,2,6,7,-1,4,0
177827,2,7,10,-3,12,1
408552,1,0,0,0,12,1
267726,4,14,34,-20,17,0
247845,2,7,3,4,8,1
356987,3,20,3,17,5,0
84547,1,0,0,0,4,0
353459,4,25,12,13,4,1
385192,4,21,20,1,1,0
398787,3,14,24,-10,7,1
1198,1,10,0,10,1,0
243915,3,19,6,13,6,0
116526,1,0,0,0,2,1
221442,3,3,31,-28,14,0
90677,4,27,33,-6,7,0
121622,1,0,0,0,4,0
45996,1,0,7,-7,4,1
238121,1,0,0,0,4,0
255427,4,24,6,18,12,0
258456,4,21,13,8,13,1
58340,1,7,0,7,10,0
40122,1,6,0,6,2,1
295308,4,14,5,9,12,1
11093,3,10,13,-3,5,1
222070,3,20,10,10,14,1
296516,4,26,3,23,13,0
336362,4,20,20,0,13,0
385406,2,14,7,7,1,1
257531,3,19,10,9,13,0
130279,1,0,0,0,8,0
6743,1,0,0,0,3,0
342520,1,0,6,-6,16,1
274754,4,24,20,4,3,1
183453,4,27,6,21,14,0
115784,4,20,16,4,1,0
296883,2,10,0,10,13,0
204562,2,0,35,-35,6,1
268994,1,0,3,-3,17,1
285015,1,0,0,0,7,1
30921,4,3,24,-21,15,1
96789,4,7,16,-9,10,0
317330,2,0,0,0,5,1
357701,2,26,6,20,5,1
207301,2,10,14,-4,7,0
372888,2,10,0,10,13,1
378681,1,7,0,7,15,0
400614,1,0,0,0,8,0
380695,3,7,7,0,16,1
86698,2,10,7,3,5,1
235330,4,32,21,11,3,0
172625,5,24,24,0,9,1
100872,4,19,22,-3,12,0
113362,4,26,38,-12,17,1
260390,3,13,7,6,14,0
261207,2,21,0,21,14,0
77797,2,7,14,-7,1,0
388603,2,14,0,14,3,0
96560,1,0,3,-3,10,1
363060,1,0,0,0,8,1
314277,1,0,0,0,3,0
224724,1,3,0,3,15,0
398218,3,28,10,18,7,0
287257,4,23,23,0,8,0
341130,4,21,24,-3,15,0
115749,4,13,13,0,1,1
71878,2,12,6,6,16,1
191430,4,0,31,-31,17,1
193360,2,7,10,-3,1,1
354077,3,19,0,19,4,0
52485,2,3,0,3,7,0
383015,4,10,24,-14,17,1
340327,2,17,7,10,15,0
100273,1,6,0,6,12,0
322681,4,9,9,0,7,1
350166,2,8,0,8,2,1
135775,1,0,7,-7,10,0
410240,2,7,0,7,13,1
135129,4,31,6,25,10,0
68717,4,31,0,31,15,0
92912,4,34,7,27,8,0
366952,1,0,7,-7,10,0
168172,3,19,12,7,7,1
395350,2,14,3,11,5,1
370119,1,7,3,4,12,1
139234,2,3,6,-3,12,1
411701,1,0,3,-3,13,1
69639,4,14,17,-3,15,1
275304,2,10,8,2,3,1
97493,2,16,0,16,10,0
217487,3,12,3,9,12,1
366698,2,17,10,7,10,1
279666,2,14,0,14,5,1
26458,3,27,16,11,13,0
289112,1,3,0,3,9,1
99190,2,10,10,0,11,1
216493,2,20,8,12,12,1
377689,2,19,7,12,15,0
235283,3,18,6,12,3,1
44659,4,23,31,-8,3,1
137147,4,31,6,25,11,1
126434,4,33,24,9,6,0
82567,1,0,3,-3,3,1
392,3,28,17,11,1,1
345260,3,13,14,-1,17,0
40044,3,20,7,13,1,0
49800,2,14,7,7,6,0
143195,2,7,3,4,13,0
232036,2,0,17,-17,1,0
311583,1,3,0,3,2,0
201973,3,3,0,3,5,0
372921,3,22,0,22,13,0
171951,3,14,14,0,9,1
51167,2,23,3,20,7,1
297580,4,21,7,14,13,0
298089,2,3,17,-14,13,0
138993,3,14,9,5,12,0
94125,1,3,0,3,9,1
276393,4,25,44,-19,3,1
85407,4,38,17,21,5,0
261748,4,14,7,7,14,1
260974,3,10,3,7,14,0
365656,4,45,35,10,9,1
201589,1,0,0,0,5,1
278781,2,7,0,7,5,1
114300,1,6,6,0,1,1
134367,4,29,21,8,10,0
164758,3,23,14,9,6,1
13966,1,0,0,0,7,1
1221,2,10,6,4,1,1
398347,2,3,13,-10,7,1
19642,4,23,28,-5,10,1
53585,3,14,15,-1,8,1
151494,3,35,7,28,17,1
193076,2,0,0,0,1,0
55231,2,7,0,7,9,0
222186,2,10,10,0,14,1
126081,3,20,3,17,6,1
93480,4,3,28,-25,9,0
140141,3,10,3,7,12,1
43157,1,0,0,0,3,0
316365,1,7,0,7,4,0
421897,4,21,26,-5,17,1
399197,2,10,13,-3,7,1
293653,2,10,7,3,12,0
335906,4,28,14,14,13,1
116256,2,10,0,10,1,0
230301,3,19,10,9,17,1
46325,2,3,17,-14,4,1
216151,1,7,0,7,12,0
124922,4,11,16,-5,5,0
102568,1,2,0,2,13,0
251514,2,16,13,3,10,1
339225,1,7,0,7,15,0
301679,4,17,6,11,15,0
48891,3,12,0,12,5,1
384034,4,20,23,-3,1,1
171309,2,7,3,4,9,0
31102,1,0,0,0,15,0
317229,3,7,16,-9,5,0
260043,2,3,7,-4,14,0
20249,4,27,10,17,10,0
333753,1,0,0,0,12,1
317754,1,0,0,0,5,0
124682,2,0,3,-3,5,1
21616,4,7,38,-31,11,1
168197,4,29,15,14,7,1
127516,4,3,23,-20,6,0
106807,4,27,22,5,14,0
228379,3,7,17,-10,17,1
298871,4,21,15,6,14,1
125130,2,7,7,0,5,1
261317,1,0,0,0,14,0
158396,4,16,20,-4,3,1
219880,4,51,0,51,13,0
90529,4,0,26,-26,7,0
162406,4,13,27,-14,4,0
375406,4,21,24,-3,14,0
390774,1,0,0,0,3,0
138252,4,10,12,-2,11,1
24414,4,16,7,9,12,0
43695,3,14,10,4,3,0
16834,4,26,31,-5,8,0
328165,3,6,14,-8,10,1
338483,2,14,0,14,14,0
312911,4,21,24,-3,3,1
63528,4,31,25,6,12,0
372894,2,16,0,16,13,0
63177,3,14,20,-6,12,0
307264,1,0,3,-3,17,0
329087,3,10,7,3,10,1
183232,2,10,14,-4,14,1
410665,1,0,3,-3,13,0
196475,1,0,0,0,2,0
96850,1,10,0,10,10,1
44292,3,17,20,-3,3,0
359849,1,17,7,10,6,0
208701,1,0,0,0,8,0
207789,4,24,16,8,7,1
130018,2,7,13,-6,8,0
413009,4,16,18,-2,14,0
32832,3,6,7,-1,15,1
74659,2,0,10,-10,17,1
27592,1,7,3,4,13,1
397949,4,10,17,-7,7,0
176243,4,14,27,-13,11,1
280010,3,3,13,-10,5,0
56661,1,0,0,0,9,1
88247,1,0,0,0,6,0
280758,4,14,14,0,5,1
175825,2,17,10,7,11,1
373280,4,16,23,-7,13,0
221350,1,0,0,0,14,0
180630,2,10,6,4,13,1
243591,3,10,7,3,6,1
123623,2,0,0,0,4,0
394675,4,24,21,3,5,0
403443,2,14,6,8,9,0
123232,4,19,21,-2,4,0
277235,2,0,13,-13,4,1
74513,2,0,3,-3,17,0
288583,3,23,31,-8,9,0
38050,2,3,0,3,1,0
404469,2,14,13,1,10,0
306559,1,0,14,-14,17,1
210723,2,14,0,14,9,1
40549,1,7,0,7,2,1
129921,4,13,0,13,7,0
369471,4,48,7,41,11,0
285727,1,0,3,-3,8,0
67709,2,7,0,7,14,0
176873,4,17,16,1,11,1
245393,2,9,3,6,7,1
171835,4,26,17,9,9,0
331903,3,0,15,-15,12,0
373415,4,10,17,-7,13,0
38613,1,0,0,0,1,1
411818,4,0,34,-34,13,1
85068,4,31,16,15,4,0
9492,3,13,3,10,5,0
112870,2,10,3,7,17,0
103384,3,10,20,-10,13,1
323610,1,7,0,7,8,0
244259,3,23,7,16,6,0
144777,4,10,17,-7,14,0
267894,4,26,24,2,17,1
346962,2,7,3,4,1,1
11961,2,7,0,7,6,1
186879,1,7,0,7,15,1
282841,3,9,13,-4,6,1
391342,4,24,3,21,4,1
159275,3,17,24,-7,3,0
197930,4,18,7,11,3,0
251153,4,10,27,-17,10,1
273213,4,39,7,32,2,1
48933,4,15,13,2,5,1
50997,2,0,7,-7,6,0
133674,4,24,35,-11,9,1
284226,4,9,26,-17,7,1
368647,1,0,3,-3,11,1
179659,5,31,30,1,12,0
133062,4,12,14,-2,9,1
393624,4,7,33,-26,5,0
300504,3,23,16,7,14,0
111054,2,10,0,10,16,0
262404,2,7,7,0,15,1
66645,3,7,17,-10,14,1
343289,1,0,0,0,16,0
221126,2,0,6,-6,14,0
96505,4,17,24,-7,10,0
379654,4,26,13,13,16,0
241153,4,20,10,10,5,1
150197,3,6,26,-20,16,1
294685,3,6,14,-8,12,0
341699,3,23,13,10,16,1
120157,4,10,6,4,3,1
51380,4,22,23,-1,7,1
411511,4,13,24,-11,13,0
184649,2,10,16,-6,15,0
329,1,14,3,11,1,0
109099,2,7,7,0,15,1
278262,1,0,0,0,4,0
108166,1,0,0,0,15,1
67609,3,0,32,-32,14,1
185596,3,10,20,-10,15,1
81570,3,17,21,-4,3,0
86553,2,23,3,20,5,1
95674,2,10,3,7,10,1
7393,1,3,0,3,4,1
72850,4,45,17,28,16,0
247450,3,13,9,4,8,1
230637,4,16,31,-15,1,1
117081,3,7,17,-10,2,0
194809,4,10,23,-13,2,0
125219,4,31,14,17,5,1
59633,3,14,3,11,11,1
405470,4,24,16,8,10,1
189699,4,20,6,14,17,0
364965,2,7,0,7,9,0
240429,1,0,0,0,5,0
410176,4,20,17,3,13,0
143501,3,14,21,-7,14,0
70109,1,10,0,10,15,0
348959,2,14,0,14,2,0
347938,3,0,21,-21,1,1
396383,2,20,12,8,6,1
295971,1,0,0,0,13,1
76509,3,7,20,-13,1,0
161765,3,24,6,18,4,1
362452,1,0,3,-3,8,1
264948,3,23,17,6,16,1
94460,2,0,0,0,9,0
327298,4,16,20,-4,9,1
173105,1,0,0,0,9,1
255324,2,14,0,14,12,1
287264,5,23,23,0,8,1
391380,1,7,3,4,4,0
128802,3,13,13,0,7,0
18450,3,7,7,0,9,0
156028,3,20,17,3,2,0
187575,3,13,16,-3,16,0
324889,3,17,13,4,8,0
290963,2,17,10,7,10,1
66264,4,45,3,42,13,0
347035,4,24,17,7,1,0
1278,4,17,16,1,1,1
226034,5,34,34,0,16,0
127754,2,7,14,-7,6,0
94547,4,10,10,0,9,0
168305,3,10,21,-11,7,1
146448,4,24,3,21,15,0
355616,3,24,10,14,5,0
260901,1,0,0,0,14,0
126209,3,21,6,15,6,0
322094,4,26,0,26,7,0
357328,4,14,22,-8,5,1
384016,3,10,23,-13,1,1
144098,2,13,0,13,14,1
367980,2,10,14,-4,11,0
173170,2,10,17,-7,9,0
126000,1,0,0,0,6,0
64348,4,18,20,-2,13,1
251103,3,10,14,-4,10,1
31443,2,3,7,-4,15,1
409993,3,6,35,-29,12,0
254464,3,20,10,10,11,1
48000,3,3,24,-21,5,1
283494,4,23,20,3,7,0
188357,1,0,0,0,16,0
91845,4,24,13,11,8,1
12436,4,10,6,4,6,1
270483,1,0,0,0,1,1
185188,1,6,0,6,15,1
253442,4,14,35,-21,11,0
55006,4,20,10,10,8,0
247730,3,7,6,1,8,0
289145,2,13,7,6,9,1
297753,4,31,23,8,13,1
275080,4,34,27,7,3,1
335839,2,14,7,7,13,1
296895,2,10,0,10,13,1
324597,4,16,9,7,8,1
320576,2,24,0,24,6,1
171242,4,9,14,-5,8,1
227869,2,10,6,4,16,1
184603,1,7,0,7,15,0
181094,3,17,7,10,13,1
191830,2,17,10,7,1,0
22450,3,24,27,-3,11,1
320238,2,14,0,14,6,0
296554,1,0,0,0,13,1
228287,1,0,0,0,17,1
70342,3,10,33,-23,15,1
244985,3,0,20,-20,7,0
8458,2,15,0,15,4,0
275540,4,32,36,-4,3,1
188666,1,0,0,0,16,0
421485,2,0,0,0,17,0
60686,3,21,3,18,11,0
47296,1,0,7,-7,5,0
153841,2,0,0,0,1,0
160789,2,17,7,10,4,0
41166,2,0,7,-7,2,1
140280,2,7,6,1,12,1
322015,2,3,0,3,7,1
228399,4,10,20,-10,17,0
357554,3,10,13,-3,5,1
385829,4,33,3,30,1,1
47250,4,18,9,9,5,1
237980,2,3,10,-7,4,1
181123,3,24,14,10,13,0
86889,4,9,26,-17,5,1
42288,4,37,13,24,2,0
118063,1,0,6,-6,2,1
268843,1,0,0,0,17,0
27670,4,7,27,-20,13,1
167706,3,23,20,3,7,0
416757,2,7,7,0,15,0
193616,4,7,17,-10,1,0
298280,4,20,13,7,14,1
44575,2,10,14,-4,3,1
31298,2,7,3,4,15,1
399858,1,0,0,0,8,0
95049,1,0,0,0,9,0
130888,1,0,0,0,8,0
312288,4,10,23,-13,2,0
39436,3,10,10,0,1,1
63864,2,3,14,-11,12,0
253916,4,41,14,27,11,1
409634,1,0,0,0,12,1
78130,2,14,3,11,2,1
122159,4,24,21,3,4,0
247361,1,0,0,0,8,1
377963,1,0,7,-7,15,1
407727,2,10,0,10,11,0
82587,1,0,3,-3,3,0
393066,2,0,3,-3,4,1
228104,4,6,10,-4,17,0
321552,1,3,3,0,7,0
5635,2,0,14,-14,3,1
18536,1,3,0,3,9,0
337201,3,9,13,-4,14,1
230828,1,0,0,0,1,0
386040,2,7,0,7,1,1
90681,1,0,0,0,7,0
278762,2,0,0,0,5,0
111879,4,16,10,6,17,1
245630,4,43,20,23,7,0
240573,1,3,0,3,5,1
57205,3,13,7,6,10,0
412101,4,31,3,28,13,1
399951,3,6,13,-7,8,1
353199,1,0,0,0,4,0
73171,2,7,0,7,16,1
246286,1,0,0,0,7,0
93965,1,0,7,-7,9,1
10720,1,0,0,0,5,0
104069,1,10,7,3,13,1
277277,3,0,13,-13,4,0
259689,1,0,0,0,14,1
191279,4,10,17,-7,17,0
52373,3,6,17,-11,7,1
175034,4,20,28,-8,10,1
350843,1,0,0,0,3,1
29578,2,7,13,-6,14,0
219483,2,0,21,-21,13,1
322543,4,15,3,12,7,1
358877,3,6,21,-15,6,0
6578,4,13,6,7,3,1
60415,4,23,7,16,11,0
338311,1,0,0,0,14,1
362949,2,27,6,21,8,0
249929,4,18,23,-5,9,1
215005,2,10,0,10,11,1
300137,2,13,3,10,14,1
221941,4,19,19,0,14,1
257302,1,0,0,0,13,1
33427,4,20,20,0,16,0
159443,4,20,20,0,3,0
53906,3,7,13,-6,8,1
292233,4,24,17,7,11,0
199264,3,17,31,-14,4,1
132949,1,0,6,-6,9,0
14196,3,0,31,-31,7,0
177530,1,7,0,7,11,0
916,2,0,0,0,1,1
195942,2,0,17,-17,2,0
419398,1,3,0,3,16,0
125807,4,17,23,-6,5,0
205432,1,0,0,0,6,1
80038,3,10,3,7,2,0
120602,3,3,20,-17,3,0
52507,2,10,0,10,7,0
242999,5,34,34,0,6,0
297970,3,30,7,23,13,0
407724,2,10,0,10,11,0
188153,3,10,10,0,16,1
140068,1,0,0,0,12,0
263953,3,23,0,23,15,1
144361,1,0,3,-3,14,1
168193,4,29,15,14,7,0
184462,1,0,0,0,14,0
99691,4,26,3,23,11,1
330795,1,3,3,0,11,0
284254,1,0,0,0,7,1
390845,3,3,28,-25,3,1
373656,2,0,12,-12,13,1
211431,1,3,0,3,9,0
203633,2,7,10,-3,6,1
160547,4,23,14,9,4,1
284001,2,3,0,3,7,0
282632,2,6,7,-1,6,0
282315,1,0,0,0,6,1
7233,2,0,13,-13,4,1
330131,4,0,13,-13,11,0
12061,1,7,0,7,6,0
177147,4,37,13,24,11,0
90956,1,0,0,0,7,1
100097,4,13,6,7,12,0
325284,2,3,3,0,8,1
232013,2,0,7,-7,1,0
61203,1,6,0,6,11,1
21092,2,0,0,0,10,0
135919,5,24,24,0,10,0
169256,4,23,6,17,7,0
83951,1,7,0,7,4,1
366255,2,7,10,-3,10,1
257513,2,19,10,9,13,0
413543,2,3,10,-7,14,0
62145,3,7,13,-6,12,0
365110,2,0,7,-7,9,0
243512,1,0,0,0,6,1
146125,4,25,17,8,15,0
98975,1,0,0,0,11,1
115760,4,13,16,-3,1,1
169167,2,3,6,-3,7,1
147053,1,0,6,-6,15,0
407574,3,10,9,1,11,0
410288,3,7,16,-9,13,1
396522,2,17,7,10,6,0
364516,1,3,7,-4,9,0
15294,1,0,0,0,8,0
66222,3,24,3,21,13,1
44953,1,0,0,0,4,1
415135,2,0,21,-21,15,1
163872,1,6,10,-4,5,0
127446,2,3,7,-4,6,1
244893,1,0,0,0,7,0
350593,2,10,0,10,2,1
313468,4,17,14,3,3,1
177343,1,3,0,3,11,0
191230,2,7,17,-10,17,0
63401,1,0,0,0,12,1
280298,3,16,16,0,5,0
294093,3,7,24,-17,12,0
325456,2,16,3,13,8,1
26887,2,10,6,4,13,1
141659,2,20,14,6,13,1
164241,4,41,38,3,5,0
165569,4,3,28,-25,6,0
199099,3,14,24,-10,4,0
69194,4,17,17,0,15,1
2690,3,6,7,-1,2,0
9545,4,13,20,-7,5,1
45456,2,21,13,8,4,0
87254,2,10,14,-4,6,0
210807,4,24,10,14,9,0
213784,2,21,0,21,10,0
148348,3,14,3,11,16,1
268679,4,27,20,7,17,1
215601,2,14,3,11,11,0
198521,4,17,12,5,3,1
394098,1,0,0,0,5,0
79026,3,10,7,3,2,0
287053,3,19,24,-5,8,1
353284,3,28,20,8,4,1
366658,1,14,3,11,10,0
228768,1,0,7,-7,17,1
225040,2,0,7,-7,15,0
345491,1,0,0,0,17,0
181787,4,10,17,-7,13,0
127044,4,24,23,1,6,1
196363,2,10,0,10,2,1
200311,3,27,14,13,4,1
74918,1,7,0,7,17,1
167571,4,3,17,-14,7,0
294649,2,0,7,-7,12,1
69192,4,17,17,0,15,1
269507,2,13,10,3,1,0
10619,2,0,10,-10,5,1
419068,4,10,20,-10,16,1
93990,1,0,14,-14,9,1
41033,2,3,10,-7,2,0
61343,1,0,0,0,11,0
376920,1,0,3,-3,15,1
228853,4,9,17,-8,17,0
330517,2,7,7,0,11,1
177826,2,7,10,-3,12,1
243921,3,19,6,13,6,0
176475,2,0,10,-10,11,1
155859,3,7,10,-3,2,0
24474,1,0,0,0,12,0
392644,3,10,0,10,4,0
249574,3,21,13,8,9,0
55892,4,19,22,-3,9,1
89632,1,3,0,3,7,0
408404,1,0,0,0,12,1
210286,2,6,7,-1,9,0
173039,3,21,6,15,9,1
172550,3,7,21,-14,9,0
245451,4,16,6,10,7,1
48001,3,3,24,-21,5,0
366736,3,24,10,14,10,1
271363,1,0,0,0,1,0
385611,3,6,17,-11,1,0
18401,1,0,0,0,9,0
180457,2,14,7,7,13,0
26061,1,0,0,0,13,1
188617,4,20,19,1,16,1
125056,4,3,26,-23,5,1
158332,2,12,14,-2,3,1
68009,1,0,9,-9,14,0
223774,1,0,0,0,15,1
58132,3,20,10,10,10,0
29969,2,14,0,14,14,0
135600,1,0,0,0,10,1
353923,4,17,28,-11,4,1
115559,2,10,3,7,1,1
167663,2,10,20,-10,7,0
120125,3,10,3,7,3,1
52228,3,7,16,-9,7,0
140978,1,7,0,7,13,0
411447,2,7,17,-10,13,1
316919,3,9,15,-6,4,1
143517,3,17,21,-4,14,0
221060,1,0,0,0,14,1
163429,3,7,20,-13,5,0
173657,4,13,20,-7,10,0
257488,2,6,3,3,13,1
2275,3,10,10,0,1,0
18852,2,3,6,-3,9,0
281006,2,14,13,1,6,1
397100,1,0,0,0,6,1
241331,1,0,0,0,5,1
248907,2,17,0,17,9,0
401634,1,0,0,0,8,0
220815,2,7,7,0,14,0
95443,3,31,7,24,10,0
350700,1,7,0,7,2,1
335000,2,16,10,6,13,1
407190,4,17,34,-17,11,0
77572,4,27,14,13,1,0
396601,4,20,10,10,6,0
170898,3,7,20,-13,8,1
193461,4,23,20,3,1,0
201723,4,30,20,10,5,0
416588,1,7,0,7,15,0
101257,3,7,7,0,12,1
104070,1,10,7,3,13,1
352518,2,14,6,8,3,1
268978,1,0,0,0,17,0
300879,2,3,7,-4,15,0
31087,4,13,16,-3,15,1
297655,2,7,3,4,13,1
31840,4,23,24,-1,15,0
149395,3,6,20,-14,16,1
345885,2,3,14,-11,17,0
419294,2,0,10,-10,16,0
224982,4,10,22,-12,15,1
48826,1,3,0,3,5,1
63308,2,3,3,0,12,1
18070,1,0,7,-7,9,0
116921,3,21,10,11,2,0
64142,1,7,6,1,13,1
152616,2,0,6,-6,17,1
161485,4,10,6,4,4,0
230126,2,3,10,-7,17,0
136162,3,10,10,0,10,1
39781,4,9,7,2,1,1
26927,4,13,6,7,13,0
21617,4,7,38,-31,11,1
416153,2,3,9,-6,15,1
232485,2,10,3,7,1,1
208440,1,7,0,7,8,1
293610,1,7,0,7,12,0
69345,4,19,9,10,15,1
95698,3,10,9,1,10,1
113,4,7,7,0,1,0
201210,4,20,24,-4,5,1
269432,4,21,20,1,1,0
238627,2,6,0,6,4,1
88412,1,0,0,0,6,1
128937,2,22,3,19,7,1
123,4,7,10,-3,1,1
421820,2,0,10,-10,17,0
8721,1,0,0,0,4,0
168081,4,6,24,-18,7,0
76389,3,29,6,23,1,0
390136,4,20,35,-15,3,1
238577,4,16,20,-4,4,1
165342,1,0,7,-7,6,1
28475,1,10,0,10,14,1
412264,4,28,15,13,13,0
121645,2,0,7,-7,4,0
89263,4,12,0,12,7,0
139189,4,19,13,6,12,1
333339,2,10,7,3,12,0
154997,1,6,0,6,1,0
266798,3,10,14,-4,16,1
361896,2,0,0,0,7,0
341874,4,23,15,8,16,0
174839,3,13,17,-4,10,1
76442,1,0,7,-7,1,1
413862,3,17,6,11,14,0
150488,3,34,6,28,16,0
207665,1,0,0,0,7,1
109074,1,0,0,0,15,1
374114,2,13,7,6,13,1
16704,4,21,33,-12,8,1
239788,4,20,20,0,4,1
30797,4,31,35,-4,15,1
13100,1,0,0,0,6,0
51884,2,6,10,-4,7,0
391846,2,10,3,7,4,1
246337,2,14,10,4,7,0
161214,1,0,3,-3,4,0
80210,3,21,24,-3,2,1
68030,2,0,10,-10,14,0
317523,3,10,27,-17,5,1
105852,3,16,10,6,14,1
385255,2,0,3,-3,1,0
103488,2,6,0,6,13,1
312214,2,7,14,-7,2,1
149002,4,13,12,1,16,0
22419,2,10,24,-14,11,1
146789,1,7,0,7,15,1
370956,1,0,0,0,12,1
394428,2,0,10,-10,5,1
182899,1,0,17,-17,14,1
74357,2,7,3,4,17,0
188374,2,3,0,3,16,0
243804,4,24,20,4,6,1
153929,4,7,12,-5,1,0
174046,2,0,26,-26,10,1
301826,4,6,34,-28,15,0
234903,1,0,0,0,2,1
173777,3,10,3,7,10,1
358930,4,14,35,-21,6,0
172075,2,10,3,7,9,1
35558,1,7,0,7,17,0
39267,3,3,13,-10,1,1
81107,2,10,14,-4,3,1
143742,1,0,0,0,14,1
73131,4,13,17,-4,16,0
40169,3,13,7,6,2,1
412667,3,20,10,10,14,0
307439,2,20,10,10,17,1
284823,4,29,20,9,7,0
258895,4,20,26,-6,13,1
212915,2,7,7,0,10,1
356304,2,17,0,17,5,0
100072,3,6,3,3,12,0
368665,1,0,10,-10,11,1
1985,3,10,9,1,1,0
48331,4,22,13,9,5,0
389810,3,17,6,11,3,1
17319,1,7,0,7,9,1
143094,3,17,17,0,13,0
256385,2,6,7,-1,12,1
407967,4,17,24,-7,11,1
130114,1,0,0,0,8,0
191376,2,0,24,-24,17,1
109679,1,3,0,3,16,0
293079,3,10,13,-3,11,0
355613,3,24,10,14,5,1
415182,3,10,24,-14,15,0
155892,4,17,13,4,2,0
135264,4,22,10,12,10,1
86422,2,20,7,13,5,0
260613,2,0,7,-7,14,0
326760,2,3,7,-4,9,0
269106,4,13,16,-3,17,1
346734,4,27,13,14,1,1
356784,1,0,0,0,5,1
356558,4,9,6,3,5,1
286665,1,7,0,7,8,1
412872,4,38,35,3,14,0
242458,2,3,7,-4,6,0
270556,3,10,14,-4,1,1
351474,1,0,17,-17,3,1
4196,2,10,6,4,2,0
258341,4,41,39,2,13,0
375824,3,20,7,13,14,0
7836,1,0,7,-7,4,0
371230,4,22,19,3,12,0
90586,2,14,10,4,7,1
169924,1,7,0,7,8,1
387927,4,10,28,-18,2,0
150458,2,27,6,21,16,0
17468,1,0,0,0,9,1
369450,3,38,7,31,11,0
162782,2,0,0,0,5,0
127751,2,0,14,-14,6,1
291024,4,20,13,7,10,1
64403,1,0,3,-3,13,1
379564,2,13,6,7,16,1
4830,4,34,3,31,3,0
103922,2,3,0,3,13,0
225077,3,10,14,-4,15,1
269982,3,16,13,3,1,0
111048,1,10,0,10,16,0
349002,3,14,7,7,2,0
374100,1,13,6,7,13,0
313483,4,17,17,0,3,0
371338,3,35,10,25,12,1
192065,4,31,34,-3,1,1
314856,1,0,0,0,4,1
62008,3,10,7,3,12,1
390668,2,3,3,0,3,0
329855,4,24,26,-2,11,1
162883,4,13,6,7,5,0
158695,4,24,7,17,3,0
385674,5,27,24,3,1,0
392650,3,13,0,13,4,0
102661,4,22,20,2,13,1
182110,1,9,0,9,13,1
352209,1,0,3,-3,3,1
118777,1,10,0,10,2,0
249804,1,3,0,3,9,0
137100,3,17,6,11,11,1
342675,1,0,0,0,16,0
146565,3,14,24,-10,15,0
261165,1,0,0,0,14,1
91070,4,9,0,9,7,0
387079,2,7,14,-7,2,0
89872,4,23,13,10,7,1
342455,4,13,3,10,16,1
369782,4,45,50,-5,11,1
797,2,7,6,1,1,1
190258,3,7,14,-7,17,0
189904,2,0,7,-7,17,0
7051,1,6,7,-1,4,1
57220,4,20,7,13,10,0
48198,4,10,19,-9,5,0
315516,3,7,3,4,4,1
417938,1,7,14,-7,16,1
53509,2,7,3,4,8,1
82474,2,7,17,-10,3,1
48527,2,11,0,11,5,1
158005,1,0,3,-3,3,1
413936,1,3,0,3,14,0
362230,3,6,17,-11,8,1
47098,4,31,10,21,5,0
304781,2,0,0,0,16,1
355475,4,23,19,4,4,0
68727,4,34,0,34,15,0
209333,2,7,7,0,8,0
153165,4,20,17,3,1,1
151323,2,7,14,-7,17,1
389908,2,12,3,9,3,0
204657,4,17,48,-31,6,1
288352,2,7,0,7,9,1
355396,2,3,10,-7,4,1
17333,1,14,0,14,9,0
111537,3,21,10,11,16,0
398707,1,0,7,-7,7,0
365736,2,17,10,7,9,0
421635,1,3,7,-4,17,1
35836,4,10,17,-7,17,0
169711,4,20,17,3,8,1
223314,4,6,12,-6,15,0
290115,4,13,15,-2,10,1
144883,3,14,7,7,14,0
266899,1,0,0,0,17,0
313273,2,6,7,-1,3,0
150107,1,0,6,-6,16,1
45399,1,7,0,7,4,0
244629,1,0,10,-10,7,0
154961,4,29,24,5,1,0
352293,4,3,6,-3,3,1
171862,1,0,0,0,9,0
254116,2,3,6,-3,11,0
263888,1,6,0,6,15,0
279102,3,21,10,11,5,0
239913,4,13,9,4,4,1
124421,3,6,7,-1,5,1
276818,3,20,17,3,4,0
304073,3,3,20,-17,16,1
267355,2,0,7,-7,17,1
23266,1,0,0,0,11,0
45213,4,14,10,4,4,0
1211,2,10,6,4,1,1
28979,2,0,7,-7,14,1
136646,4,15,19,-4,11,1
4455,1,7,3,4,2,0
269372,3,7,17,-10,1,0
174705,3,9,7,2,10,1
351104,4,29,30,-1,3,1
227280,2,3,20,-17,16,1
245398,2,9,3,6,7,1
322481,3,15,3,12,7,1
77413,4,14,21,-7,1,0
248515,4,23,20,3,8,1
96616,3,3,3,0,10,0
125265,1,3,0,3,5,0
243492,4,10,30,-20,6,0
318194,4,22,20,2,5,1
277789,1,0,6,-6,4,0
37587,1,7,0,7,17,0
222969,3,13,13,0,14,1
114947,2,7,3,4,1,0
403654,4,30,20,10,9,1
264704,1,7,13,-6,16,1
358964,1,0,0,0,6,1
288659,1,0,7,-7,9,0
413828,2,14,0,14,14,0
280957,1,0,0,0,6,1
262530,4,35,35,0,15,0
18079,1,0,14,-14,9,1
414763,4,10,17,-7,14,1
154697,1,0,0,0,1,1
172623,5,24,24,0,9,1
351521,2,0,27,-27,3,1
379565,2,13,6,7,16,1
361459,1,7,0,7,7,1
124586,3,6,17,-11,5,1
168039,4,6,17,-11,7,0
73932,2,14,0,14,17,0
21184,4,0,16,-16,10,0
345651,1,7,0,7,17,0
152143,1,0,0,0,17,1
103984,3,6,13,-7,13,1
97195,2,3,6,-3,10,1
20673,3,10,17,-7,10,1
360793,3,24,30,-6,7,0
284309,2,3,10,-7,7,1
146480,1,7,0,7,15,1
219218,3,13,3,10,13,0
282789,2,0,10,-10,6,0
240947,3,14,9,5,5,1
383860,4,3,7,-4,1,1
100976,3,10,16,-6,12,0
63065,4,16,34,-18,12,0
272693,2,9,3,6,2,1
225864,4,24,24,0,16,1
151002,1,0,0,0,17,0
180095,1,0,0,0,13,0
236971,4,38,7,31,3,0
43512,2,7,3,4,3,0
134717,1,3,0,3,10,1
39892,3,6,7,-1,1,0
81462,4,10,16,-6,3,1
147462,4,23,10,13,15,0
303180,4,24,28,-4,16,1
267428,4,17,17,0,17,0
53170,4,25,38,-13,7,1
242295,2,10,7,3,6,1
280784,4,14,14,0,5,0
103923,2,3,0,3,13,0
163434,3,7,20,-13,5,0
292904,3,7,0,7,11,0
309438,3,7,6,1,1,0
118925,1,0,7,-7,3,1
81655,1,7,7,0,3,1
335549,2,3,0,3,13,0
386231,3,12,17,-5,2,1
282681,3,6,17,-11,6,0
22461,3,24,27,-3,11,0
58190,1,0,0,0,10,1
381613,1,0,0,0,17,1
113817,4,16,24,-8,17,0
178158,1,0,7,-7,12,1
381129,4,24,28,-4,16,0
197119,2,14,17,-3,3,0
294277,4,28,21,7,12,1
148789,3,13,16,-3,16,1
199903,4,17,24,-7,4,0
194099,1,0,0,0,1,0
106431,2,16,0,16,14,0
319913,1,13,7,6,6,1
127940,3,23,0,23,6,0
87975,1,3,0,3,6,0
305338,1,0,0,0,17,1
344704,3,6,20,-14,17,0
3009,3,13,31,-18,2,0
206645,4,10,16,-6,7,1
169641,2,13,7,6,8,1
360092,4,10,40,-30,7,0
219136,1,0,3,-3,13,1
174529,3,7,14,-7,10,1
335334,4,3,23,-20,13,0
59462,2,3,10,-7,11,0
400464,1,0,0,0,8,0
378267,2,0,3,-3,15,0
342458,4,19,3,16,16,1
314560,4,27,10,17,3,0
281437,2,0,10,-10,6,0
323011,1,7,0,7,7,0
331199,4,10,13,-3,11,0
117348,3,21,0,21,2,0
348312,1,7,0,7,1,1
106264,1,0,3,-3,14,1
340426,4,31,19,12,15,0
114562,4,17,40,-23,1,1
113244,1,7,0,7,17,0
22592,2,13,3,10,11,1
140246,1,0,0,0,12,0
309056,4,0,20,-20,1,1
56172,4,27,21,6,9,1
29355,4,21,16,5,14,1
413338,4,20,7,13,14,0
396914,4,27,27,0,6,0
222397,4,24,10,14,14,1
184508,2,14,14,0,14,1
26686,1,0,7,-7,13,1
133370,4,21,9,12,9,1
178586,1,0,3,-3,12,0
146106,3,22,17,5,15,1
374192,4,23,28,-5,13,1
403760,3,12,13,-1,9,0
149396,3,6,20,-14,16,0
193888,3,24,10,14,1,0
345188,1,0,0,0,17,1
239376,1,3,7,-4,4,0
321595,2,10,6,4,7,1
193444,3,23,20,3,1,0
121399,4,7,6,1,3,0
324081,2,0,7,-7,8,1
361905,2,0,0,0,7,1
292647,4,22,16,6,11,0
334098,2,7,0,7,13,1
54353,2,14,19,-5,8,1
239569,2,13,3,10,4,0
127999,4,23,33,-10,6,1
308484,1,0,0,0,1,0
130058,3,17,30,-13,8,0
136667,1,0,0,0,11,1
121305,1,0,0,0,3,0
228601,1,7,14,-7,17,1
52819,2,0,37,-37,7,0
396638,4,23,17,6,6,1
384858,3,6,12,-6,1,0
79992,1,7,0,7,2,1
95908,4,20,23,-3,10,1
52030,2,3,10,-7,7,1
193514,1,0,0,0,1,0
124283,3,27,17,10,5,1
324184,4,3,17,-14,8,1
320123,3,17,0,17,6,0
93708,2,0,3,-3,9,1
84799,4,13,31,-18,4,1
284996,4,16,27,-11,7,1
122132,3,17,14,3,4,1
141619,1,3,7,-4,13,1
20783,1,7,0,7,10,1
127790,3,10,21,-11,6,0
345668,1,7,0,7,17,1
261009,4,10,3,7,14,0
279097,2,21,7,14,5,0
307417,1,7,0,7,17,0
187885,4,7,23,-16,16,0
154747,2,10,10,0,1,0
218287,2,7,14,-7,12,1
163828,4,17,25,-8,5,1
262795,4,35,17,18,15,0
102836,4,10,10,0,13,1
116240,1,3,0,3,1,1
72330,2,0,14,-14,16,1
147392,2,7,7,0,15,0
22134,2,10,6,4,11,0
39359,1,0,0,0,1,1
338176,1,7,14,-7,14,1
167413,1,0,0,0,7,1
384697,2,13,20,-7,1,0
268749,2,17,3,14,17,1
207153,2,7,10,-3,7,0
394406,1,0,3,-3,5,1
405504,4,24,16,8,10,0
355840,2,13,7,6,5,1
153378,2,0,10,-10,1,1
152490,2,17,7,10,17,0
5223,2,14,17,-3,3,1
147088,2,7,24,-17,15,1
96126,2,0,16,-16,10,1
39521,1,0,3,-3,1,1
287395,4,20,3,17,8,0
218508,4,34,17,17,13,1
15700,4,37,17,20,8,0
155291,4,28,27,1,1,1
10297,1,0,14,-14,5,1
156984,3,7,13,-6,2,1
329119,4,27,7,20,10,0
38271,4,13,14,-1,1,0
176060,4,24,0,24,11,1
401113,3,27,3,24,8,0
292008,2,6,3,3,11,0
104440,1,0,7,-7,13,0
73104,4,13,10,3,16,0
62195,4,13,17,-4,12,0
30441,2,17,22,-5,14,0
100124,4,16,6,10,12,0
343044,2,6,7,-1,16,1
102079,4,35,17,18,12,1
119052,1,0,0,0,3,1
243855,1,3,0,3,6,1
51790,4,10,19,-9,7,0
78408,2,14,0,14,2,0
135125,4,31,6,25,10,0
252328,3,0,19,-19,10,0
227218,4,16,17,-1,16,0
332797,4,28,16,12,12,1
245805,1,0,0,0,7,0
198217,4,13,9,4,3,1
203671,3,14,23,-9,6,1
47753,4,6,23,-17,5,1
387516,1,3,0,3,2,0
333226,3,3,7,-4,12,1
302991,3,20,16,4,16,1
24642,1,7,0,7,12,1
64903,3,10,3,7,13,1
61736,4,24,31,-7,12,0
169295,1,0,0,0,8,1
420934,2,7,14,-7,17,0
345212,1,7,14,-7,17,1
21592,3,7,24,-17,11,0
234753,1,0,0,0,2,0
276945,3,17,17,0,4,0
339109,2,10,0,10,15,0
231301,2,3,3,0,1,0
246515,3,19,7,12,8,1
350380,4,31,13,18,2,0
106770,3,20,15,5,14,0
111175,1,7,0,7,16,0
170678,2,6,3,3,8,1
383708,3,9,24,-15,17,1
184552,3,35,14,21,14,1
63146,2,7,10,-3,12,1
134673,4,34,31,3,10,1
190928,2,6,0,6,17,1
66842,1,0,0,0,14,0
84345,4,27,30,-3,4,1
288273,4,10,35,-25,9,0
334864,3,24,3,21,13,0
409391,2,13,3,10,12,1
304141,1,0,0,0,16,1
214816,4,10,27,-17,11,1
241978,2,7,0,7,5,0
54603,1,7,6,1,8,1
392698,4,16,0,16,4,0
295486,1,0,0,0,12,0
134083,3,27,13,14,9,0
83671,2,22,10,12,4,0
120869,2,14,17,-3,3,0
257423,4,23,14,9,13,0
8461,2,15,0,15,4,0
207305,2,10,14,-4,7,0
356651,2,13,3,10,5,1
340560,4,7,42,-35,15,1
163354,4,22,26,-4,5,1
293822,3,17,6,11,12,0
108809,2,0,10,-10,15,0
26167,3,0,26,-26,13,1
393837,2,7,17,-10,5,1
366470,4,34,22,12,10,0
301262,4,27,20,7,15,0
316219,1,0,7,-7,4,0
212226,4,3,24,-21,10,0
43668,3,14,10,4,3,1
149717,3,27,0,27,16,1
214229,1,0,10,-10,11,1
193548,2,0,7,-7,1,0
115811,1,0,0,0,1,0
352598,4,34,23,11,3,0
159631,4,27,20,7,3,1
218727,2,0,10,-10,13,1
346234,3,40,0,40,1,0
22523,4,31,37,-6,11,1
58764,3,10,23,-13,10,0
103407,4,10,20,-10,13,0
152015,1,0,0,0,17,1
405299,3,14,7,7,10,0
268763,2,24,3,21,17,0
223305,4,6,12,-6,15,1
252952,3,9,7,2,11,1
290339,2,6,3,3,10,1
231395,1,0,0,0,1,0
289168,2,20,7,13,9,0
51258,1,3,0,3,7,1
178716,4,3,26,-23,12,1
233806,4,19,37,-18,2,1
228155,1,7,10,-3,17,0
222865,4,24,13,11,14,0
345624,4,24,23,1,17,0
307936,2,7,3,4,1,1
67265,1,0,0,0,14,1
140465,3,14,13,1,12,0
8753,2,0,0,0,4,1
330720,4,6,6,0,11,1
418341,4,9,24,-15,16,1
95749,4,20,9,11,10,1
224993,4,10,22,-12,15,0
53095,2,19,14,5,7,0
348022,1,0,6,-6,1,0
256926,3,14,21,-7,12,1
17812,2,10,3,7,9,0
17874,4,24,17,7,9,1
154154,3,7,6,1,1,0
150304,2,17,7,10,16,1
249163,1,0,0,0,9,1
286208,1,0,6,-6,8,1
377836,2,17,0,17,15,0
263511,4,20,23,-3,15,0
69848,2,14,9,5,15,0
361116,4,23,16,7,7,0
359736,2,17,9,8,6,1
110922,2,7,10,-3,16,1
177289,4,14,20,-6,11,1
354314,2,14,3,11,4,1
160465,2,20,7,13,4,0
269239,3,3,13,-10,17,1
400676,2,6,7,-1,8,1
177520,1,0,0,0,11,1
150580,2,3,13,-10,17,0
72112,4,10,17,-7,16,1
267952,2,0,3,-3,17,1
333151,1,0,0,0,12,1
192827,3,0,15,-15,1,1
379099,4,7,12,-5,15,0
326603,1,10,3,7,9,0
388257,1,3,0,3,2,1
256648,4,35,7,28,12,0
330193,2,0,0,0,11,1
410586,3,10,7,3,13,1
123954,3,10,0,10,5,1
94510,3,0,0,0,9,0
304912,1,7,3,4,16,0
245648,1,0,0,0,7,0
88657,3,20,13,7,6,0
322599,2,3,3,0,7,0
182820,3,26,17,9,14,1
64842,2,7,0,7,13,1
107574,1,0,7,-7,15,1
59793,3,12,10,2,11,0
165759,1,0,0,0,6,0
49422,4,20,20,0,6,1
150743,3,13,9,4,17,0
168410,2,0,3,-3,7,0
363725,3,23,13,10,8,0
146890,4,31,0,31,15,1
167447,1,0,0,0,7,1
380350,2,7,7,0,16,1
396127,3,17,23,-6,6,0
298752,1,0,0,0,14,1
199266,3,17,31,-14,4,1
93318,3,24,3,21,9,0
269595,1,0,0,0,1,1
16404,4,21,16,5,8,0
107477,2,0,17,-17,15,1
260296,1,0,0,0,14,1
117012,2,0,10,-10,2,1
217441,2,9,0,9,12,1
149972,2,14,3,11,16,1
31814,4,16,17,-1,15,0
220170,4,29,13,16,13,1
360057,3,10,33,-23,7,0
106729,2,7,12,-5,14,1
272242,3,6,3,3,2,1
220142,3,26,13,13,13,1
311713,1,0,0,0,2,1
50837,2,7,14,-7,6,0
115518,2,0,3,-3,1,0
176623,1,0,12,-12,11,1
161847,1,6,0,6,4,1
402196,4,19,14,5,9,1
135187,1,10,0,10,10,0
115855,2,7,10,-3,1,0
104072,2,10,13,-3,13,1
170416,2,14,3,11,8,1
282342,2,7,7,0,6,1
216179,2,14,3,11,12,1
331164,3,7,13,-6,11,1
69947,1,14,0,14,15,0
141291,1,0,6,-6,13,0
273780,2,7,7,0,2,1
196,2,3,10,-7,1,1
160892,1,0,0,0,4,1
255939,2,6,3,3,12,0
203945,2,3,7,-4,6,0
386510,2,7,13,-6,2,0
185585,3,10,20,-10,15,0
257722,4,3,24,-21,13,1
77232,3,16,0,16,1,1
174627,1,3,0,3,10,0
383383,3,3,9,-6,17,0
246542,4,29,7,22,8,0
205581,4,17,30,-13,6,1
409042,1,3,7,-4,12,1
298123,3,3,31,-28,13,0
72704,4,33,13,20,16,1
15402,4,10,24,-14,8,0
134239,3,3,23,-20,10,0
148428,2,7,0,7,16,1
133079,4,15,22,-7,9,0
168145,2,16,5,11,7,1
251956,1,0,7,-7,10,1
339554,2,10,7,3,15,1
183414,3,24,3,21,14,0
421474,1,0,0,0,17,1
183786,2,10,14,-4,14,0
22390,1,3,3,0,11,1
268564,1,7,3,4,17,1
362559,4,26,12,14,8,1
188829,1,0,0,0,16,1
420838,4,17,17,0,17,0
154152,3,7,6,1,1,1
26966,1,0,0,0,13,1
205387,4,27,0,27,6,0
370454,2,13,6,7,12,1
394942,4,7,17,-10,5,1
370864,2,3,3,0,12,1
371872,2,21,10,11,12,0
67545,1,0,0,0,14,1
384569,2,3,35,-32,1,0
2064,1,0,7,-7,1,1
63231,4,17,26,-9,12,0
166834,1,0,3,-3,6,1
335336,4,3,23,-20,13,0
356410,4,31,20,11,5,1
386308,1,7,0,7,2,1
348102,3,3,19,-16,1,1
100391,4,9,20,-11,12,1
379256,1,0,3,-3,16,0
20450,1,0,0,0,10,0
167984,2,0,14,-14,7,1
347217,1,0,0,0,1,1
172775,4,21,18,3,9,1
191693,2,7,17,-10,17,1
252809,3,9,6,3,11,0
349918,4,3,12,-9,2,0
147018,4,27,0,27,15,0
276496,2,16,7,9,4,1
180406,1,0,0,0,13,1
151420,1,7,0,7,17,0
387893,3,10,28,-18,2,0
90723,2,14,0,14,7,0
366663,1,14,3,11,10,1
216275,1,0,0,0,12,1
256965,4,32,27,5,12,0
124311,4,34,20,14,5,1
109187,4,34,14,20,15,1
56111,2,17,7,10,9,0
411793,3,0,34,-34,13,1
122466,3,13,26,-13,4,1
382670,2,0,6,-6,17,1
411156,2,0,20,-20,13,0
398356,3,3,13,-10,7,0
102743,1,3,0,3,13,1
231714,1,0,7,-7,1,1
233832,1,6,0,6,2,1
160845,4,34,17,17,4,0
230484,4,28,14,14,1,1
390939,1,7,0,7,4,1
273736,1,0,0,0,2,0
278510,3,36,0,36,4,0
45916,3,16,3,13,4,1
39249,2,3,3,0,1,0
410574,2,10,7,3,13,0
206076,2,14,3,11,7,0
87922,4,19,15,4,6,1
293363,2,7,7,0,11,0
263791,3,0,24,-24,15,1
33511,2,14,0,14,16,1
147977,1,0,3,-3,15,1
304020,2,0,13,-13,16,1
380119,4,35,30,5,16,0
140042,4,28,10,18,12,0
381475,1,14,0,14,17,0
387253,2,6,7,-1,2,1
356497,3,6,3,3,5,1
34933,4,27,24,3,16,1
284294,2,3,3,0,7,0
288784,1,0,7,-7,9,1
345825,1,0,7,-7,17,0
29298,3,21,7,14,14,0
313650,4,25,30,-5,3,0
203573,1,0,0,0,6,0
399257,4,13,20,-7,7,0
276896,1,7,0,7,4,0
283013,3,21,3,18,6,0
172156,4,13,21,-8,9,0
365116,2,0,14,-14,9,1
260930,2,0,0,0,14,1
29307,3,21,7,14,14,0
378823,1,0,3,-3,15,1
170938,4,31,20,11,8,0
166115,2,14,3,11,6,0
104837,4,27,33,-6,14,1
89169,1,0,0,0,7,0
78218,1,0,0,0,2,0
299363,1,0,7,-7,14,1
218851,2,7,3,4,13,1
260338,2,0,0,0,14,0
269881,4,29,10,19,1,0
337582,1,7,0,7,14,0
109804,1,3,0,3,16,1
351064,3,20,16,4,3,1
138803,2,0,33,-33,12,1
146274,3,3,30,-27,15,1
419651,4,30,16,14,17,0
404099,4,13,49,-36,10,0
23522,4,17,17,0,11,0
213344,2,10,6,4,10,0
17357,2,17,0,17,9,1
341215,2,13,7,6,16,0
12928,5,13,13,0,6,1
316227,1,0,10,-10,4,0
124336,4,41,27,14,5,1
416952,4,10,10,0,15,1
380744,1,0,0,0,16,1
418986,2,7,7,0,16,1
196230,2,14,10,4,2,0
207967,1,7,0,7,8,0
393707,2,0,7,-7,5,1
386117,4,24,9,15,1,0
50592,3,3,6,-3,6,1
112522,1,10,9,1,17,0
347026,4,17,10,7,1,0
323358,2,10,0,10,7,0
19746,3,9,9,0,10,0
242525,4,18,13,5,6,0
217825,1,3,7,-4,12,0
35238,4,0,17,-17,16,1
235181,4,7,20,-13,2,1
149282,3,13,20,-7,16,0
137268,4,7,13,-6,11,0
162495,2,14,10,4,4,1
8251,4,16,10,6,4,0
211382,4,10,10,0,9,1
188547,2,3,10,-7,16,1
196673,2,27,0,27,3,0
104602,2,7,3,4,14,1
23942,3,16,0,16,12,0
257818,2,7,3,4,13,1
218953,4,48,27,21,13,1
403793,4,15,23,-8,9,1
340798,3,17,16,1,15,1
266080,3,17,3,14,16,0
117883,4,12,20,-8,2,1
263715,1,0,0,0,15,0
244584,4,25,30,-5,7,1
141683,3,23,14,9,13,0
349068,1,6,0,6,2,1
70231,4,33,30,3,15,0
331085,1,0,0,0,11,0
345920,3,17,23,-6,17,1
219703,4,13,14,-1,13,1
134648,3,31,24,7,10,1
58545,2,10,10,0,10,1
28585,4,33,7,26,14,0
266568,4,16,22,-6,16,1
147091,2,7,24,-17,15,0
394343,3,24,17,7,5,1
307212,3,0,10,-10,17,1
325420,1,13,0,13,8,1
251548,3,16,13,3,10,1
186715,1,0,0,0,15,1
82219,4,16,10,6,3,1
398816,4,21,24,-3,7,0
220933,1,0,0,0,14,1
336040,4,16,25,-9,13,1
254510,4,29,13,16,11,0
256412,2,9,14,-5,12,1
80290,1,6,3,3,2,1
59978,4,3,24,-21,11,0
154806,4,24,23,1,1,0
263481,3,13,16,-3,15,0
42182,1,7,0,7,2,0
381382,2,16,0,16,16,0
90499,4,0,26,-26,7,1
187771,1,7,0,7,16,0
169655,3,20,10,10,8,0
35931,3,3,0,3,17,1
260397,4,13,7,6,14,1
268030,4,21,9,12,17,0
111418,4,0,20,-20,16,0
151318,2,7,14,-7,17,0
31533,4,3,17,-14,15,0
27794,3,14,14,0,13,0
240102,1,6,0,6,5,0
393631,4,7,33,-26,5,0
269630,2,3,0,3,1,1
148755,2,13,6,7,16,0
177603,4,17,17,0,11,0
5147,4,19,14,5,3,1
161581,2,29,10,19,4,1
416741,2,7,0,7,15,0
161162,4,3,33,-30,4,0
275488,3,20,17,3,3,1
366211,1,0,0,0,10,0
11817,2,27,17,10,6,1
199209,2,10,7,3,4,0
114206,2,3,0,3,1,0
252626,2,6,3,3,10,0
365316,3,17,16,1,9,0
18347,4,25,20,5,9,1
161678,1,0,0,0,4,1
386992,4,14,21,-7,2,0
137812,1,0,6,-6,11,1
53939,4,14,13,1,8,0
115997,2,13,0,13,1,0
7806,4,30,9,21,4,0
175002,3,13,28,-15,10,1
336445,3,10,17,-7,14,0
22938,4,3,26,-23,11,1
312178,1,0,0,0,2,0
103647,2,0,7,-7,13,1
271494,4,21,0,21,1,0
393170,1,0,3,-3,5,0
415323,3,7,14,-7,15,0
128880,1,0,3,-3,7,0
285014,4,16,27,-11,7,0
66290,1,0,0,0,14,0
339291,3,31,0,31,15,0
45907,3,10,3,7,4,0
58234,2,7,3,4,10,1
313862,2,14,10,4,3,0
354244,4,20,17,3,4,1
144406,2,0,10,-10,14,0
121076,4,11,31,-20,3,0
378290,2,3,3,0,15,1
48829,2,3,0,3,5,1
82195,3,16,3,13,3,0
28387,3,13,3,10,14,0
218541,1,0,7,-7,13,1
24055,2,0,7,-7,12,1
18679,1,0,0,0,9,0
33030,4,12,44,-32,15,0
328481,3,6,3,3,10,0
94482,2,0,0,0,9,1
402821,1,0,0,0,9,1
169292,4,23,6,17,7,0
382614,1,0,0,0,17,0
321207,4,3,19,-16,6,0
201519,3,25,7,18,5,1
377962,1,0,7,-7,15,1
43009,1,0,0,0,3,0
102161,2,14,7,7,13,0
220765,1,0,0,0,14,0
236128,1,0,3,-3,3,0
209552,3,34,20,14,8,1
163631,4,21,22,-1,5,1
168270,2,10,7,3,7,0
404213,4,12,9,3,10,1
401582,3,17,14,3,8,0
49053,3,10,13,-3,6,1
407130,3,7,20,-13,11,1
227322,3,19,27,-8,16,1
183367,2,14,3,11,14,1
248581,1,7,0,7,9,0
295635,1,0,0,0,12,1
75416,2,10,7,3,17,0
159864,2,17,0,17,3,1
341038,2,7,14,-7,15,1
239494,1,0,0,0,4,0
8921,3,21,0,21,4,1
85534,3,17,12,5,5,0
353974,5,34,31,3,4,0
341299,1,0,0,0,16,0
186553,5,34,33,1,15,1
375350,3,7,17,-10,14,1
201784,2,13,0,13,5,1
297272,4,24,6,18,13,1
329960,3,7,10,-3,11,1
21389,1,6,7,-1,11,0
157026,4,13,13,0,2,0
391572,3,10,21,-11,4,1
371198,3,11,19,-8,12,1
266927,2,13,0,13,17,1
200233,1,0,0,0,4,0
397146,2,3,0,3,6,1
214472,3,7,17,-10,11,0
285380,1,3,0,3,8,1
78496,4,24,0,24,2,1
305699,2,3,7,-4,17,1
189497,3,17,0,17,17,0
255497,2,17,7,10,12,0
303380,1,7,0,7,16,0
368634,1,0,0,0,11,1
314437,1,7,0,7,3,1
373163,1,0,0,0,13,0
61975,2,3,0,3,12,1
354478,2,21,28,-7,4,1
37212,2,3,14,-11,17,1
200910,3,27,0,27,4,0
62644,4,17,17,0,12,0
373406,3,10,16,-6,13,0
132003,3,0,24,-24,8,1
49950,2,21,0,21,6,0
203248,4,17,24,-7,5,0
395987,3,24,20,4,6,0
329411,4,16,41,-25,10,0
142717,1,0,7,-7,13,1
180963,3,17,21,-4,13,1
188487,1,0,0,0,16,1
44798,4,19,19,0,3,1
151545,1,0,0,0,17,0
350625,3,13,0,13,2,0
233473,4,23,10,13,2,1
326157,1,7,7,0,9,0
280960,1,0,0,0,6,1
84604,3,13,10,3,4,1
185678,1,7,0,7,15,0
16016,1,0,0,0,8,1
67729,2,14,0,14,14,1
78798,4,16,30,-14,2,1
190265,3,7,14,-7,17,1
89417,3,10,20,-10,7,1
238271,4,10,24,-14,4,1
19734,3,9,6,3,10,1
419520,4,10,23,-13,16,1
235549,3,10,13,-3,3,0
276770,2,17,9,8,4,0
108788,1,0,7,-7,15,0
384915,4,13,36,-23,1,0
267413,3,10,10,0,17,0
265023,1,7,0,7,16,0
369149,3,19,7,12,11,1
195613,1,0,0,0,2,1
53210,1,0,0,0,8,1
159848,2,14,0,14,3,1
311776,2,10,20,-10,2,1
31658,4,24,9,15,15,0
109139,3,24,7,17,15,0
257315,1,3,0,3,13,1
309068,1,0,0,0,1,1
344628,1,0,10,-10,17,0
240968,3,21,16,5,5,1
81829,1,0,21,-21,3,1
331165,3,7,13,-6,11,1
155160,1,7,0,7,1,0
380996,4,9,14,-5,16,1
140746,2,15,14,1,12,1
26216,1,0,7,-7,13,1
184422,4,24,6,18,14,1
16456,1,3,0,3,8,1
51326,3,16,17,-1,7,0
402686,1,0,0,0,9,1
396537,2,17,7,10,6,1
407016,4,3,34,-31,11,1
44929,4,14,38,-24,4,1
115953,1,0,0,0,1,1
54017,2,0,0,0,8,1
149249,2,7,13,-6,16,1
37447,1,0,7,-7,17,1
111302,4,17,19,-2,16,0
186884,1,7,0,7,15,0
140132,3,10,0,10,12,0
29839,2,6,10,-4,14,0
98976,1,0,0,0,11,1
90183,3,3,0,3,7,0
281285,2,7,6,1,6,1
230021,3,3,6,-3,17,1
84795,4,13,31,-18,4,0
125444,2,13,0,13,5,0
347148,3,16,10,6,1,1
103913,1,3,0,3,13,0
219105,4,45,20,25,13,1
295341,1,3,0,3,12,0
244945,2,0,20,-20,7,1
421532,3,10,3,7,17,1
298024,4,40,7,33,13,0
335470,4,13,12,1,13,0
127727,1,0,7,-7,6,0
255275,4,13,17,-4,12,0
56905,3,27,7,20,9,0
215186,2,7,9,-2,11,1
233029,4,24,10,14,2,0
177112,3,24,13,11,11,1
217436,2,9,0,9,12,0
94962,2,6,6,0,9,0
42711,4,7,20,-13,3,1
46586,2,3,0,3,4,1
409535,3,7,3,4,12,1
254281,2,6,9,-3,11,0
234574,1,7,0,7,2,1
203600,2,0,0,0,6,0
173593,2,0,13,-13,10,1
370601,3,14,14,0,12,1
32218,2,14,7,7,15,0
337370,3,21,7,14,14,0
37136,4,16,20,-4,17,1
231340,3,9,16,-7,1,0
249301,1,0,0,0,9,1
200566,2,14,7,7,4,0
189297,2,3,0,3,16,0
88771,2,13,3,10,6,0
332533,1,0,0,0,12,0
268407,1,7,0,7,17,1
237241,3,13,0,13,3,1
37014,1,3,0,3,17,1
4371,3,7,7,0,2,0
79187,3,17,10,7,2,1
54666,3,14,22,-8,8,0
70627,3,17,17,0,15,0
163624,3,21,19,2,5,0
235753,4,10,27,-17,3,1
269628,2,3,0,3,1,1
129767,4,17,24,-7,7,0
209279,4,34,7,27,8,0
106948,3,12,6,6,14,1
373886,4,34,16,18,13,1
205985,3,13,10,3,7,0
103749,1,0,0,0,13,1
198618,2,0,7,-7,3,0
225686,4,21,10,11,16,0
261974,2,14,10,4,14,0
227987,1,0,0,0,17,0
398019,2,14,7,7,7,0
228257,4,10,27,-17,17,1
377998,2,0,7,-7,15,0
312890,4,14,14,0,3,1
139291,3,20,13,7,12,0
372455,2,9,14,-5,13,1
6540,3,3,3,0,3,0
321981,1,0,0,0,7,0
162862,4,6,3,3,5,1
413314,4,20,0,20,14,1
103937,2,3,0,3,13,0
165815,2,3,6,-3,6,0
77130,4,14,17,-3,1,1
183834,3,27,21,6,14,1
224367,4,16,12,4,15,1
236727,4,30,7,23,3,0
190128,4,27,3,24,17,0
89585,4,7,27,-20,7,0
143489,2,14,21,-7,14,1
214242,2,7,10,-3,11,1
115492,1,0,0,0,1,1
56583,3,16,17,-1,9,1
408984,4,31,24,7,12,0
180798,3,10,20,-10,13,0
136466,3,16,13,3,11,1
341391,3,0,10,-10,16,0
30102,1,0,0,0,14,1
357261,2,3,16,-13,5,1
297206,2,0,3,-3,13,0
421639,1,3,7,-4,17,0
129227,2,14,6,8,7,0
205690,3,20,19,1,7,0
334807,1,7,0,7,13,0
392295,1,0,7,-7,4,1
142054,4,23,14,9,13,1
408927,2,17,9,8,12,0
330140,4,0,13,-13,11,0
295866,2,7,14,-7,12,0
256116,2,14,16,-2,12,0
337248,4,16,23,-7,14,0
230712,2,6,27,-21,1,1
264424,3,3,28,-25,15,0
127147,2,10,9,1,6,0
363773,1,0,7,-7,8,1
385692,5,27,27,0,1,0
200713,2,7,0,7,4,0
73738,1,3,0,3,17,0
104910,2,3,3,0,14,0
418167,3,24,3,21,16,0
138552,5,31,37,-6,12,0
98509,4,31,24,7,11,0
157805,4,20,10,10,2,0
187140,4,13,0,13,16,1
222390,4,24,10,14,14,0
262010,3,24,17,7,14,0
125969,4,16,23,-7,6,1
284351,3,6,17,-11,7,1
412900,1,0,0,0,14,0
416248,4,10,39,-29,15,1
370328,4,14,35,-21,12,1
296486,3,17,3,14,13,1
71734,2,10,20,-10,16,1
257906,4,16,19,-3,13,1
65365,4,13,28,-15,13,1
154393,1,0,0,0,1,0
177546,2,7,0,7,11,1
328024,3,17,9,8,10,0
143946,2,0,10,-10,14,1
366636,1,0,0,0,10,1
49686,3,14,21,-7,6,0
51391,1,0,0,0,7,0
12293,4,6,6,0,6,1
107586,2,6,7,-1,15,0
332343,3,16,6,10,12,0
220745,4,13,13,0,13,1
130885,1,0,0,0,8,0
48013,3,10,24,-14,5,0
199731,4,35,10,25,4,0
265881,2,0,9,-9,16,0
178458,2,10,3,7,12,0
184133,3,16,14,2,14,1
393565,2,7,9,-2,5,0
159001,4,27,29,-2,3,0
30779,4,31,28,3,15,0
2724,4,9,7,2,2,1
85634,2,17,0,17,5,0
107901,2,0,3,-3,15,1
379001,2,7,3,4,15,0
337828,4,30,6,24,14,1
344866,4,30,10,20,17,0
416375,4,16,6,10,15,0
294042,2,7,14,-7,12,0
173532,4,13,27,-14,10,0
421371,2,12,10,2,17,1
2894,4,31,31,0,2,0
353782,5,20,23,-3,4,1
380087,4,35,23,12,16,1
146248,3,3,29,-26,15,0
165935,1,3,7,-4,6,1
134764,2,20,3,17,10,0
55594,4,27,7,20,9,0
21237,1,3,0,3,11,1
320822,1,3,4,-1,6,0
52374,3,6,17,-11,7,1
176039,3,24,0,24,11,0
206593,3,10,13,-3,7,0
213979,2,29,7,22,10,0
113812,4,16,24,-8,17,0
174078,3,0,36,-36,10,1
330445,4,13,20,-7,11,1
27032,2,10,0,10,13,0
238376,3,10,23,-13,4,1
141235,3,3,24,-21,13,1
405325,4,14,12,2,10,0
212243,4,3,24,-21,10,1
344164,4,33,11,22,17,1
275741,2,10,0,10,3,1
55591,4,24,7,17,9,1
241833,2,10,3,7,5,1
81771,4,31,24,7,3,1
89867,3,23,13,10,7,1
186447,2,10,10,0,15,0
348881,4,6,14,-8,2,1
11153,4,24,27,-3,5,1
57404,4,14,6,8,10,1
337678,4,24,13,11,14,1
330609,1,0,0,0,11,0
275357,4,10,19,-9,3,0
99714,1,0,0,0,12,0
219498,2,3,21,-18,13,1
302613,2,3,3,0,15,1
373969,2,7,0,7,13,1
91090,4,9,0,9,7,0
366768,4,34,10,24,10,0
45510,4,27,26,1,4,0
245350,1,6,0,6,7,0
217192,4,12,16,-4,12,0
358104,2,14,0,14,6,1
397193,3,13,0,13,6,0
137623,5,34,34,0,11,1
70717,2,7,10,-3,15,0
207361,4,13,21,-8,7,0
30641,4,24,9,15,14,0
224180,3,0,20,-20,15,0
342008,3,20,3,17,16,0
15746,2,0,5,-5,8,1
155692,2,10,13,-3,2,1
221847,2,6,0,6,14,1
214031,4,43,7,36,10,0
399187,2,10,6,4,7,1
171558,1,0,0,0,9,0
105717,3,34,3,31,14,1
252217,4,23,24,-1,10,1
293214,2,16,7,9,11,0
279058,1,7,0,7,5,1
232406,4,20,25,-5,1,1
338810,2,10,0,10,15,0
166189,4,28,19,9,6,1
341204,2,13,7,6,16,0
379429,2,7,0,7,16,0
403564,2,17,0,17,9,0
334772,4,32,11,21,13,0
165865,4,6,16,-10,6,0
399777,3,0,24,-24,8,1
399258,4,13,20,-7,7,0
253004,4,18,13,5,11,1
407853,2,3,0,3,11,1
370673,4,24,14,10,12,0
162074,3,28,13,15,4,0
197899,3,11,7,4,3,1
69792,1,7,0,7,15,1
55865,4,13,14,-1,9,1
131323,1,0,0,0,8,0
95390,2,21,0,21,10,0
313537,1,0,7,-7,3,0
119836,4,24,19,5,3,1
419296,2,0,10,-10,16,0
111987,3,17,21,-4,17,1
119833,4,24,16,8,3,0
374514,1,7,0,7,14,0
355241,2,3,14,-11,4,1
348929,1,0,0,0,2,0
213297,1,0,0,0,10,1
353385,2,13,0,13,4,0
289054,4,32,21,11,9,0
262642,4,26,10,16,15,1
301534,4,20,24,-4,15,1
398535,4,28,16,12,7,1
80201,3,21,10,11,2,0
409700,3,10,6,4,12,1
339720,2,14,6,8,15,0
261158,4,21,24,-3,14,1
162925,1,0,0,0,5,1
326790,2,3,14,-11,9,1
367630,4,31,12,19,10,1
59799,3,12,13,-1,11,1
245106,2,14,6,8,7,0
192913,2,7,7,0,1,1
419242,4,17,9,8,16,1
333908,1,0,7,-7,12,1
420733,1,0,0,0,17,1
334870,3,24,10,14,13,1
389779,2,10,6,4,3,1
246858,5,20,20,0,8,0
39206,1,0,0,0,1,0
14022,2,3,14,-11,7,0
54456,1,0,0,0,8,0
287946,3,14,13,1,9,1
410148,3,17,17,0,13,1
392040,3,10,17,-7,4,0
187423,3,41,13,28,16,0
409831,2,13,0,13,12,1
159384,2,7,13,-6,3,0
336519,1,0,0,0,14,0
418158,3,24,3,21,16,0
268330,3,20,3,17,17,1
203409,1,0,0,0,6,0
109788,1,0,0,0,16,0
306057,3,17,13,4,17,0
139315,4,20,13,7,12,0
52612,1,0,0,0,7,0
334594,4,30,30,0,13,0
103700,3,3,17,-14,13,0
247574,3,16,16,0,8,0
381780,2,0,0,0,17,0
383826,3,3,7,-4,1,1
420888,1,0,0,0,17,1
40510,4,7,20,-13,2,1
373580,4,23,33,-10,13,0
225114,4,16,14,2,15,1
255863,4,20,7,13,12,0
226021,4,34,34,0,16,1
407414,2,14,7,7,11,0
34179,4,10,10,0,16,1
231030,3,24,0,24,1,0
176564,4,19,17,2,11,0
350176,2,11,0,11,2,0
99804,3,0,21,-21,12,0
162328,2,3,7,-4,4,1
257570,4,19,10,9,13,0
299986,2,0,14,-14,14,1
249486,1,0,3,-3,9,1
274352,1,3,7,-4,3,1
260468,1,7,0,7,14,1
319025,3,7,23,-16,5,0
398455,2,7,0,7,7,0
253443,4,14,35,-21,11,0
367300,3,3,17,-14,10,0
404335,3,13,6,7,10,0
197485,4,13,9,4,3,1
68244,3,20,17,3,14,0
406195,2,7,3,4,11,0
77585,4,27,14,13,1,0
303222,5,31,31,0,16,0
193821,2,10,0,10,1,0
407790,4,10,7,3,11,1
304659,3,14,7,7,16,1
344972,3,10,14,-4,17,0
153685,2,2,14,-12,1,0
99940,3,10,9,1,12,1
235478,1,0,0,0,3,1
383588,4,24,21,3,17,0
115451,4,39,14,25,1,0
253694,2,3,3,0,11,1
1685,2,13,0,13,1,1
238022,3,10,13,-3,4,1
265173,1,0,3,-3,16,0
243485,4,10,30,-20,6,1
164491,3,17,0,17,5,1
68069,3,3,10,-7,14,0
249816,1,6,3,3,9,0
376462,1,0,0,0,14,1
203378,4,21,33,-12,6,0
382474,1,0,0,0,17,0
312527,2,23,0,23,3,0
84243,1,0,7,-7,4,1
229062,1,3,0,3,17,0
137435,4,6,21,-15,11,0
338091,3,6,7,-1,14,0
111603,1,0,3,-3,16,1
419853,2,0,6,-6,17,1
195391,3,17,3,14,2,1
214569,2,3,3,0,11,1
370265,2,0,14,-14,12,0
267850,3,26,17,9,17,0
39162,4,20,10,10,1,1
182829,3,29,17,12,14,0
416442,2,7,0,7,15,1
154253,1,0,7,-7,1,1
156362,3,31,0,31,2,0
417568,4,31,31,0,16,1
38145,5,9,9,0,1,0
189039,3,14,10,4,16,0
33885,1,0,0,0,16,0
306860,2,0,3,-3,17,0
46943,4,20,33,-13,5,1
266210,2,24,6,18,16,1
49023,2,10,7,3,6,0
345480,4,16,22,-6,17,1
95799,2,6,3,3,10,1
396736,3,7,17,-10,6,0
68417,4,3,21,-18,14,1
221064,1,0,0,0,14,1
275379,4,10,22,-12,3,1
123543,4,13,10,3,4,1
333695,3,21,0,21,12,0
34332,4,23,9,14,16,0
289700,1,0,0,0,10,0
412541,4,31,14,17,14,1
249856,2,6,17,-11,9,0
89372,2,3,13,-10,7,1
342716,2,0,7,-7,16,1
32141,4,24,21,3,15,0
44163,4,13,20,-7,3,1
141577,4,34,18,16,13,1
145505,4,23,17,6,14,0
212238,4,3,24,-21,10,0
226410,2,0,7,-7,16,1
305637,1,0,0,0,17,1
165915,1,0,7,-7,6,1
189755,2,7,6,1,17,0
239614,4,20,10,10,4,0
54444,1,0,0,0,8,0
187983,3,13,14,-1,16,0
411619,3,14,27,-13,13,0
30467,3,31,34,-3,14,0
397210,4,13,0,13,6,1
47767,1,0,0,0,5,1
277842,2,7,14,-7,4,0
141426,4,13,20,-7,13,0
293406,3,16,10,6,11,1
119506,4,14,24,-10,3,0
343059,3,9,13,-4,16,1
166837,1,0,3,-3,6,0
347180,4,23,23,0,1,0
377343,1,0,0,0,15,1
132528,1,2,26,-24,9,1
33251,2,10,0,10,16,1
16912,2,14,13,1,8,1
85284,1,0,3,-3,5,1
30071,4,46,7,39,14,0
239062,1,0,0,0,4,1
42054,3,20,7,13,2,0
277754,4,14,6,8,4,1
304703,4,21,7,14,16,0
408590,2,14,0,14,12,1
340587,1,3,0,3,15,0
140071,1,0,0,0,12,1
364019,4,6,12,-6,8,0
384335,4,16,3,13,1,0
109300,3,13,3,10,15,0
195874,4,30,21,9,2,0
272583,4,13,6,7,2,0
215795,3,32,6,26,11,0
409116,3,3,10,-7,12,0
408730,1,3,7,-4,12,0
227545,1,0,0,0,16,1
181047,1,7,0,7,13,0
33889,1,0,3,-3,16,1
3677,4,23,31,-8,2,1
131312,1,0,0,0,8,0
172383,2,10,28,-18,9,0
356834,3,0,16,-16,5,1
320641,4,38,24,14,6,1
100482,2,7,10,-3,12,1
367102,2,14,7,7,10,0
194778,3,10,16,-6,2,0
303299,2,26,0,26,16,1
408272,1,0,0,0,12,1
302785,2,3,13,-10,15,1
82695,4,12,19,-7,3,1
317076,3,14,17,-3,4,1
337207,3,16,13,3,14,0
67160,2,0,0,0,14,0
13330,3,7,27,-20,7,1
225285,1,0,7,-7,15,0
88707,1,0,0,0,6,0
165709,4,14,7,7,6,1
362624,2,0,7,-7,8,1
217022,3,13,3,10,12,1
98576,2,7,7,0,11,0
130626,2,7,20,-13,8,0
306620,3,7,20,-13,17,1
169777,2,0,14,-14,8,1
315231,3,20,10,10,4,1
305992,2,3,3,0,17,0
141815,2,10,14,-4,13,0
187973,3,6,14,-8,16,0
389366,3,23,13,10,3,1
223852,3,9,3,6,15,1
185604,3,13,20,-7,15,0
52834,3,7,37,-30,7,1
105580,4,32,21,11,14,0
214486,4,7,20,-13,11,1
300024,2,0,20,-20,14,0
355742,3,7,6,1,5,1
241851,2,13,6,7,5,1
117950,2,7,6,1,2,1
382866,4,35,3,32,17,1
189678,4,17,6,11,17,1
99585,1,0,3,-3,11,1
270463,4,10,7,3,1,1
183366,2,14,3,11,14,0
40307,3,6,0,6,2,0
217688,1,7,0,7,12,1
281348,3,21,13,8,6,0
302306,1,7,3,4,15,1
320113,2,17,0,17,6,0
419580,2,13,7,6,17,1
386907,2,7,7,0,2,0
119597,3,10,9,1,3,0
242534,4,25,13,12,6,0
358388,2,9,13,-4,6,1
137679,1,0,13,-13,11,1
60104,3,20,12,8,11,0
362871,4,14,28,-14,8,1
212745,2,10,21,-11,10,1
263952,3,23,0,23,15,0
142714,1,0,7,-7,13,1
189687,4,20,6,14,17,0
190676,3,28,14,14,17,0
399214,3,13,13,0,7,0
249233,3,19,7,12,9,0
269092,4,13,16,-3,17,0
93130,1,0,0,0,9,1
185324,4,48,30,18,15,0
200330,4,30,14,16,4,0
237532,3,24,7,17,3,1
232137,1,0,0,0,1,1
110863,1,7,0,7,16,1
341505,2,3,7,-4,16,0
19241,1,0,7,-7,10,1
415865,2,7,20,-13,15,1
214769,3,3,13,-10,11,0
199414,3,16,10,6,4,1
140801,4,22,30,-8,12,0
119361,4,17,22,-5,3,1
128611,1,3,10,-7,7,1
67714,2,7,0,7,14,1
306918,3,6,30,-24,17,1
34518,1,0,0,0,16,1
327747,4,6,16,-10,10,1
85530,3,14,12,2,5,1
103527,3,20,0,20,13,1
294090,3,7,24,-17,12,0
86044,4,25,35,-10,5,1
143051,2,3,7,-4,13,1
9004,1,7,0,7,4,0
61993,2,3,7,-4,12,1
319703,4,33,9,24,6,1
108200,1,6,0,6,15,0
178604,1,3,3,0,12,1
348569,3,28,17,11,2,1
252710,4,6,10,-4,10,1
118557,3,17,3,14,2,0
280567,2,14,6,8,5,1
12094,2,7,7,0,6,0
359153,2,7,0,7,6,1
72828,4,31,17,14,16,1
60199,2,3,7,-4,11,0
226079,2,0,13,-13,16,0
160602,1,7,0,7,4,0
321567,2,3,6,-3,7,1
249170,1,2,0,2,9,1
225810,3,17,14,3,16,0
379639,4,26,13,13,16,0
61026,4,34,16,18,11,0
139670,1,0,0,0,12,1
356053,3,24,10,14,5,0
52683,3,3,13,-10,7,0
373745,4,16,21,-5,13,1
131531,2,6,13,-7,8,1
288081,2,10,0,10,9,1
1514,2,3,6,-3,1,0
358200,4,23,17,6,6,0
103411,4,10,23,-13,13,1
291090,2,12,10,2,10,0
386658,3,7,13,-6,2,1
71748,2,17,23,-6,16,0
271652,4,23,37,-14,2,1
189915,2,3,7,-4,17,0
220356,1,3,0,3,13,1
408107,1,0,0,0,12,0
310482,3,20,9,11,2,0
305939,5,21,21,0,17,0
134915,2,7,16,-9,10,1
378210,4,41,16,25,15,0
221026,4,21,28,-7,14,1
31831,4,16,24,-8,15,1
85844,4,13,13,0,5,0
62360,1,0,0,0,12,0
325746,2,0,7,-7,9,1
51980,1,0,0,0,7,0
81694,2,14,17,-3,3,0
100213,3,17,0,17,12,0
213575,4,17,14,3,10,0
196981,2,20,7,13,3,0
145953,3,7,21,-14,15,1
130305,1,7,0,7,8,1
266257,4,38,19,19,16,1
286571,3,10,31,-21,8,1
372385,1,6,0,6,13,1
33082,2,3,14,-11,16,1
53352,1,3,7,-4,8,0
364679,2,3,0,3,9,0
84679,1,3,0,3,4,0
345795,1,0,0,0,17,0
299087,2,3,3,0,14,0
157236,2,7,3,4,2,1
304799,2,0,0,0,16,0
203135,1,0,7,-7,5,1
392608,2,7,0,7,4,1
270283,3,10,24,-14,1,0
92825,1,14,0,14,8,0
216750,4,27,9,18,12,0
310447,2,14,3,11,2,1
6563,4,10,6,4,3,1
137516,2,14,14,0,11,0
368371,2,7,0,7,11,1
75680,1,0,0,0,1,1
81894,3,0,30,-30,3,1
208381,4,17,37,-20,8,0
364556,2,15,21,-6,9,0
359285,2,3,6,-3,6,0
228925,2,7,9,-2,17,0
158093,4,22,9,13,3,1
415762,3,14,16,-2,15,0
71394,1,7,0,7,16,1
150433,2,20,0,20,16,1
234370,4,17,10,7,2,1
7989,1,3,0,3,4,1
43850,4,21,16,5,3,1
82302,2,3,10,-7,3,1
215511,3,13,3,10,11,0
224628,3,16,10,6,15,1
386321,1,7,3,4,2,1
312017,1,0,0,0,2,1
332368,4,16,13,3,12,0
339640,4,31,17,14,15,0
291142,3,18,13,5,10,0
206212,2,0,3,-3,7,0
201937,2,0,0,0,5,1
227844,1,7,6,1,16,0
90383,1,0,0,0,7,1
74854,3,20,20,0,17,0
25246,2,7,0,7,12,0
75186,4,13,6,7,17,0
148012,2,7,3,4,15,1
371801,4,24,14,10,12,0
168956,1,0,0,0,7,0
375557,4,33,14,19,14,0
69749,4,16,10,6,15,1
312286,4,10,23,-13,2,0
158504,2,10,10,0,3,0
124405,2,6,0,6,5,1
1835,3,16,7,9,1,0
62335,4,21,22,-1,12,1
302289,1,0,0,0,15,1
98586,3,7,7,0,11,0
234861,4,3,12,-9,2,0
25643,1,7,0,7,12,0
404937,2,3,13,-10,10,1
70981,1,3,0,3,16,0
59942,2,3,10,-7,11,0
176150,2,14,7,7,11,0
367430,3,20,14,6,10,0
397886,2,7,3,4,7,0
409446,4,34,3,31,12,1
231377,4,9,16,-7,1,0
220979,2,14,10,4,14,1
308172,4,16,28,-12,1,1
149387,2,6,6,0,16,0
333874,4,28,28,0,12,1
122494,4,20,33,-13,4,0
381433,4,23,7,16,16,0
326723,1,0,0,0,9,1
304200,2,13,7,6,16,0
114733,4,15,10,5,1,0
176890,4,20,16,4,11,0
164056,2,3,3,0,5,0
135202,2,10,3,7,10,1
43453,1,0,0,0,3,1
27787,3,14,14,0,13,1
155951,1,0,7,-7,2,1
909,2,0,0,0,1,1
227733,2,3,7,-4,16,0
210332,3,16,16,0,9,0
375223,4,23,24,-1,14,1
244500,2,25,3,22,7,0
207757,3,24,13,11,7,0
342816,1,0,0,0,16,1
354194,2,6,7,-1,4,0
155405,3,13,3,10,2,0
294111,4,7,27,-20,12,1
302411,4,16,16,0,15,0
69883,3,24,16,8,15,0
211614,1,7,3,4,9,0
388027,3,6,6,0,2,1
417714,4,35,18,17,16,0
349923,4,3,12,-9,2,1
290718,4,44,25,19,10,1
242541,1,0,0,0,6,1
399567,4,0,33,-33,7,1
87157,3,21,10,11,5,1
95531,2,6,7,-1,10,0
219523,3,9,21,-12,13,1
173238,4,20,24,-4,9,0
226157,4,21,20,1,16,1
178837,3,27,14,13,12,0
54736,1,0,0,0,8,1
178972,3,12,3,9,12,0
94726,4,38,43,-5,9,0
327888,4,23,24,-1,10,1
229079,2,10,0,10,17,0
110202,4,23,33,-10,16,1
213242,3,10,16,-6,10,0
237507,2,17,7,10,3,1
259130,2,14,0,14,13,0
37147,1,0,0,0,17,1
168220,1,0,0,0,7,1
206002,4,16,10,6,7,0
250576,1,0,0,0,10,0
34153,3,10,3,7,16,0
231546,5,33,29,4,1,0
149954,2,7,3,4,16,1
72779,2,14,14,0,16,1
106372,4,21,19,2,14,1
35578,1,7,0,7,17,1
186372,4,36,24,12,15,0
26322,4,19,21,-2,13,0
155372,2,10,3,7,2,1
132055,4,3,24,-21,8,1
144608,4,20,19,1,14,0
28986,3,7,7,0,14,1
400564,4,13,24,-11,8,1
182953,3,10,37,-27,14,0
95115,2,9,10,-1,9,0
2145,4,13,16,-3,1,0
12358,1,7,3,4,6,0
285357,1,0,0,0,8,0
62185,4,13,17,-4,12,0
173848,1,0,7,-7,10,1
396512,1,14,7,7,6,0
98768,3,34,6,28,11,0
244983,3,0,20,-20,7,1
228072,3,3,3,0,17,0
295158,4,10,21,-11,12,1
330524,2,7,7,0,11,1
184691,4,10,24,-14,15,1
279103,3,21,10,11,5,0
24444,4,16,7,9,12,0
185640,4,20,27,-7,15,0
234492,3,20,20,0,2,1
317212,3,7,13,-6,5,0
131571,4,9,23,-14,8,0
268508,4,23,9,14,17,1
362539,3,23,12,11,8,1
299473,4,10,20,-10,14,0
80659,3,17,16,1,3,0
68977,2,21,7,14,15,0
376715,4,3,0,3,14,1
49602,1,0,0,0,6,0
304439,1,0,7,-7,16,0
138503,4,31,30,1,12,0
357861,3,6,31,-25,6,1
131935,1,0,0,0,8,0
393469,4,34,27,7,5,1
222802,3,10,10,0,14,0
44866,2,0,17,-17,4,1
367791,1,3,0,3,10,0
104903,2,3,3,0,14,1
149448,4,13,27,-14,16,1
96916,3,22,7,15,10,0
418340,4,9,24,-15,16,1
396223,1,0,3,-3,6,1
141870,4,24,14,10,13,0
358894,3,6,28,-22,6,0
109658,1,0,0,0,16,0
35916,2,3,0,3,17,1
29387,1,0,0,0,14,0
222757,2,3,7,-4,14,1
161796,4,24,6,18,4,1
132421,2,0,21,-21,9,1
107468,2,0,17,-17,15,0
131795,1,0,0,0,8,1
148569,1,0,6,-6,16,1
66741,2,0,3,-3,14,1
369863,2,7,3,4,12,0
405595,3,14,17,-3,10,0
351769,1,10,14,-4,3,1
258398,2,14,6,8,13,0
222001,1,7,0,7,14,0
126542,3,10,6,4,6,0
13410,1,3,14,-11,7,1
18853,2,3,6,-3,9,0
2043,1,0,0,0,1,1
169659,3,20,10,10,8,0
25968,2,10,6,4,13,0
49573,4,21,3,18,6,0
189241,4,46,11,35,16,0
400033,1,7,3,4,8,1
381455,4,26,14,12,16,1
162045,2,21,13,8,4,0
135065,2,17,3,14,10,0
40799,4,17,28,-11,2,1
203149,2,0,7,-7,5,0
138683,3,6,28,-22,12,1
287939,2,14,13,1,9,0
300256,1,0,0,0,14,0
265029,2,7,3,4,16,1
281677,3,24,17,7,6,1
33158,4,17,42,-25,16,0
319164,2,2,3,-1,5,0
303220,5,31,31,0,16,0
381981,3,0,23,-23,17,0
370100,1,7,0,7,12,0
141783,1,7,6,1,13,0
123896,1,0,0,0,5,1
278056,3,13,10,3,4,1
274985,1,14,3,11,3,1
324928,4,23,23,0,8,1
418134,2,21,3,18,16,0
9719,1,0,7,-7,5,0
114102,3,21,7,14,17,1
407576,3,10,9,1,11,0
94114,1,0,0,0,9,1
247347,4,42,48,-6,8,1
372730,1,0,0,0,13,0
293425,4,29,24,5,11,1
6112,3,7,10,-3,3,0
258880,4,20,14,6,13,1
124147,4,19,21,-2,5,0
235501,1,0,7,-7,3,1
346773,1,0,0,0,1,0
4081,3,16,21,-5,2,0
271760,3,23,10,13,2,0
171210,4,6,14,-8,8,1
274586,4,24,26,-2,3,0
136963,4,17,13,4,11,0
62047,4,24,10,14,12,0
251145,4,10,20,-10,10,0
204788,4,21,21,0,6,1
214459,3,7,17,-10,11,1
326572,1,0,0,0,9,1
253264,3,3,13,-10,11,1
241739,3,7,9,-2,5,1
103654,2,0,7,-7,13,0
180128,2,7,0,7,13,1
302178,1,14,0,14,15,1
130419,4,7,6,1,8,0
385078,1,0,0,0,1,0
376697,3,3,0,3,14,1
231473,3,10,12,-2,1,1
296746,2,0,0,0,13,0
257918,1,0,0,0,13,0
116091,1,0,0,0,1,1
231267,1,0,3,-3,1,1
279244,3,16,13,3,5,1
109364,1,0,7,-7,16,0
385059,5,30,24,6,1,1
69301,3,16,3,13,15,0
341635,1,3,3,0,16,1
382753,1,0,0,0,17,1
353815,1,7,7,0,4,0
1585,4,16,20,-4,1,1
268252,1,0,0,0,17,1
69315,3,19,3,16,15,1
114456,1,3,7,-4,1,1
199975,2,17,10,7,4,0
266250,4,38,19,19,16,0
51239,4,39,25,14,7,0
398007,1,7,7,0,7,1
173493,3,3,20,-17,10,0
252063,4,14,23,-9,10,1
159800,4,7,27,-20,3,1
32415,3,31,6,25,15,1
9563,5,20,20,0,5,0
359867,2,17,14,3,6,1
344210,1,0,3,-3,17,1
256367,1,6,0,6,12,0
297175,1,0,0,0,13,1
380792,2,9,21,-12,16,1
184237,2,24,0,24,14,0
9742,1,0,7,-7,5,1
352817,2,14,0,14,3,0
210019,3,7,10,-3,8,1
27444,1,3,0,3,13,1
315783,2,0,3,-3,4,0
99896,2,0,3,-3,12,1
174669,2,9,7,2,10,1
131358,2,7,10,-3,8,0
359539,4,0,21,-21,6,0
375386,4,14,24,-10,14,1
276050,2,13,3,10,3,1
242297,2,10,7,3,6,0
190706,4,42,17,25,17,0
398780,3,14,17,-3,7,1
223683,3,13,13,0,15,1
191348,1,0,14,-14,17,0
261812,2,3,10,-7,14,1
393061,2,0,3,-3,4,0
134122,4,27,13,14,9,0
110841,5,13,13,0,16,0
253772,4,24,10,14,11,0
328600,2,16,14,2,10,1
351935,2,14,7,7,3,0
348031,1,0,7,-7,1,0
119316,4,14,13,1,3,0
277370,2,17,6,11,4,0
235529,2,3,13,-10,3,0
320929,4,13,21,-8,6,0
57268,1,0,0,0,10,1
349670,1,7,0,7,2,0
75276,2,7,16,-9,17,1
67326,2,20,6,14,14,0
34988,1,6,0,6,16,0
299509,1,0,0,0,14,0
286804,1,0,0,0,8,1
114172,1,0,0,0,1,0
28118,4,27,10,17,13,1
417577,1,0,0,0,16,1
381894,4,35,28,7,17,0
259169,3,14,13,1,13,1
410164,4,20,17,3,13,0
411341,3,17,10,7,13,0
351580,4,0,27,-27,3,1
95633,1,6,0,6,10,1
197078,1,7,13,-6,3,0
160508,3,20,7,13,4,0
271490,4,20,0,20,1,1
159423,3,13,20,-7,3,0
285807,3,7,24,-17,8,1
179339,1,0,0,0,12,1
226564,2,3,3,0,16,1
77840,3,14,21,-7,1,1
269388,3,7,17,-10,1,0
317215,3,7,16,-9,5,1
106406,1,7,0,7,14,1
255926,2,6,3,3,12,0
136415,2,9,7,2,11,1
295571,3,23,19,4,12,0
82941,2,3,16,-13,4,1
264797,3,17,29,-12,16,1
87453,4,20,10,10,6,0
218339,4,17,23,-6,12,0
157023,4,13,13,0,2,0
86741,3,24,14,10,5,0
326635,2,16,6,10,9,0
396860,3,20,10,10,6,1
50392,2,0,7,-7,6,1
304477,2,0,7,-7,16,1
295748,4,10,16,-6,12,1
69759,4,19,10,9,15,1
404769,2,10,6,4,10,0
113390,1,0,0,0,17,0
104295,2,24,14,10,13,1
104007,4,13,13,0,13,0
90717,2,7,0,7,7,1
299732,3,17,6,11,14,1
272504,1,7,0,7,2,0
18881,3,9,13,-4,9,1
269073,3,13,16,-3,17,0
291164,3,18,23,-5,10,1
192645,3,10,7,3,1,1
140402,1,0,0,0,12,0
333125,4,27,30,-3,12,0
377790,1,0,0,0,15,0
146401,3,10,3,7,15,1
395742,1,0,0,0,6,1
96362,4,3,30,-27,10,1
105337,2,7,7,0,14,0
130109,4,17,36,-19,8,1
265506,3,7,7,0,16,0
24998,3,16,20,-4,12,0
398421,1,0,0,0,7,0
105727,3,35,3,32,14,1
230680,2,6,14,-8,1,0
7124,3,31,21,10,4,0
370552,1,7,0,7,12,0
93071,4,20,20,0,8,0
34716,2,6,3,3,16,0
173901,2,13,10,3,10,0
132444,3,0,21,-21,9,1
96897,2,19,7,12,10,0
52512,2,10,0,10,7,0
413433,3,10,38,-28,14,0
7811,4,30,17,13,4,1
108307,4,19,14,5,15,1
75091,2,7,6,1,17,1
129377,2,16,7,9,7,1
391155,3,7,24,-17,4,1
42587,1,0,0,0,3,1
65786,4,27,25,2,13,0
413170,4,40,45,-5,14,1
220892,4,28,41,-13,14,0
257876,4,16,12,4,13,0
415730,2,14,10,4,15,1
212253,1,0,0,0,10,1
367388,2,10,14,-4,10,1
31371,4,7,3,4,15,0
319429,1,0,0,0,6,1
224074,4,14,9,5,15,1
239853,2,7,3,4,4,1
224596,2,6,7,-1,15,1
325928,3,13,7,6,9,0
320213,1,7,0,7,6,1
331135,2,7,13,-6,11,1
33383,2,13,10,3,16,1
234770,2,0,3,-3,2,0
24478,1,0,0,0,12,0
114226,3,3,14,-11,1,1
292270,1,6,7,-1,11,0
115894,3,7,23,-16,1,0
114670,3,3,10,-7,1,0
67035,2,7,3,4,14,1
303861,1,0,7,-7,16,1
298862,4,21,9,12,14,0
236370,3,7,23,-16,3,1
178138,1,0,7,-7,12,1
352476,1,0,0,0,3,1
320369,1,7,0,7,6,1
250585,1,0,0,0,10,0
279206,2,3,3,0,5,1
139658,1,0,0,0,12,0
128701,4,13,20,-7,7,0
220982,3,14,10,4,14,1
162541,3,35,10,25,4,0
266824,4,10,14,-4,16,0
348680,2,10,10,0,2,0
349691,2,14,7,7,2,1
72865,1,0,0,0,16,1
390644,1,0,3,-3,3,1
348494,2,20,0,20,2,1
117976,3,17,6,11,2,1
258585,3,13,10,3,13,1
53565,3,14,12,2,8,1
269293,4,13,19,-6,17,1
134351,3,16,21,-5,10,1
370762,3,12,10,2,12,1
83060,2,6,14,-8,4,1
334833,2,10,3,7,13,1
419809,4,24,27,-3,17,1
219561,4,21,21,0,13,0
35646,3,17,3,14,17,1
219130,1,0,0,0,13,0
298531,2,13,0,13,14,0
49359,3,7,10,-3,6,1
59001,1,0,7,-7,10,0
146213,2,0,10,-10,15,0
394125,1,7,7,0,5,0
118215,1,9,0,9,2,0
58729,2,10,17,-7,10,1
169689,4,20,17,3,8,1
9979,4,3,3,0,5,1
231463,3,10,9,1,1,0
77479,1,0,7,-7,1,0
58304,4,20,13,7,10,1
140436,2,7,7,0,12,1
228487,2,10,7,3,17,1
255479,2,7,0,7,12,1
378737,3,14,7,7,15,0
417478,2,10,20,-10,16,0
283707,2,0,0,0,7,1
152830,4,21,16,5,17,0
168010,3,3,14,-11,7,1
231504,4,23,20,3,1,1
196173,4,31,24,7,2,1
379039,2,7,6,1,15,0
141525,3,17,10,7,13,1
304315,2,7,0,7,16,1
287387,4,20,3,17,8,1
10006,1,0,0,0,5,1
55071,2,13,3,10,8,1
56900,3,27,7,20,9,1
308439,3,7,25,-18,1,1
281168,2,14,13,1,6,1
181058,2,7,0,7,13,0
4154,1,0,3,-3,2,1
352686,2,14,3,11,3,1
131208,2,7,10,-3,8,0
324989,2,13,20,-7,8,0
249688,2,11,14,-3,9,1
388647,3,17,0,17,3,0
111964,2,14,21,-7,17,0
302765,2,3,10,-7,15,0
284304,2,3,10,-7,7,1
158986,4,21,29,-8,3,1
406093,3,0,20,-20,11,1
223082,2,24,7,17,14,1
60092,3,7,12,-5,11,0
333005,1,3,3,0,12,1
218539,1,0,7,-7,13,1
88115,1,0,0,0,6,1
86067,1,14,0,14,5,1
415811,1,0,0,0,15,0
409096,3,3,10,-7,12,0
365590,2,35,17,18,9,0
186190,3,16,13,3,15,1
119407,2,0,14,-14,3,0
79654,4,24,21,3,2,1
366365,1,6,0,6,10,1
190450,4,14,13,1,17,1
222749,1,3,0,3,14,0
408011,2,3,0,3,12,0
340687,4,19,20,-1,15,1
81713,3,17,17,0,3,0
136394,1,3,0,3,11,1
274570,3,21,23,-2,3,1
130613,2,7,14,-7,8,1
421088,2,13,3,10,17,0
267391,3,0,10,-10,17,1
42549,4,10,21,-11,3,0
410307,3,7,23,-16,13,1
381393,3,16,0,16,16,0
328601,2,17,14,3,10,0
186196,4,16,13,3,15,1
224463,2,9,10,-1,15,0
199456,4,22,17,5,4,1
211099,4,37,0,37,9,0
371199,3,11,19,-8,12,1
193510,1,0,0,0,1,1
299018,4,16,18,-2,14,0
50919,4,17,24,-7,6,0
263692,4,30,13,17,15,0
269784,2,10,7,3,1,1
6503,2,3,0,3,3,0
264883,2,10,7,3,16,0
153863,2,7,3,4,1,0
395220,3,10,13,-3,5,0
330777,1,0,0,0,11,0
290563,4,23,20,3,10,0
190899,1,0,0,0,17,0
276752,1,14,0,14,4,0
219785,2,34,0,34,13,1
252557,4,29,39,-10,10,1
391151,3,7,24,-17,4,1
5927,2,7,23,-16,3,1
125818,4,17,23,-6,5,1
138532,4,31,36,-5,12,0
331909,4,0,16,-16,12,1
381712,4,20,24,-4,17,0
337805,3,23,6,17,14,0
385057,5,24,24,0,1,1
31687,4,24,24,0,15,1
168477,4,3,24,-21,7,0
105991,3,17,3,14,14,1
249739,3,21,21,0,9,1
249066,2,21,17,4,9,0
253355,1,7,7,0,11,1
290854,4,17,21,-4,10,1
202654,4,34,20,14,5,1
119892,1,0,7,-7,3,0
103367,3,10,17,-7,13,0
130021,2,7,20,-13,8,1
259468,3,21,10,11,13,1
263277,1,7,0,7,15,1
261184,1,14,0,14,14,0
233584,2,17,27,-10,2,1
127732,1,0,7,-7,6,1
215944,3,13,21,-8,11,0
158857,4,23,3,20,3,1
399237,3,13,20,-7,7,1
239270,2,3,7,-4,4,0
279815,2,7,6,1,5,1
125729,1,7,7,0,5,1
359747,2,24,9,15,6,0
356860,4,16,16,0,5,0
340206,3,23,24,-1,15,1
382348,1,0,0,0,17,0
352231,2,3,3,0,3,0
268262,1,3,0,3,17,1
46699,1,0,0,0,4,0
81136,3,13,14,-1,3,1
421036,1,0,0,0,17,1
216897,4,13,17,-4,12,0
274011,1,0,0,0,3,1
275151,2,14,10,4,3,0
37326,2,7,0,7,17,0
10325,2,10,14,-4,5,1
15182,2,3,0,3,8,1
74880,4,20,20,0,17,0
102536,4,31,10,21,13,0
27895,2,0,0,0,13,0
279951,1,0,10,-10,5,0
104155,4,24,27,-3,13,1
366558,3,20,7,13,10,0
15282,1,0,0,0,8,0
81958,1,0,0,0,3,1
146495,1,7,7,0,15,1
180105,1,6,0,6,13,1
65217,4,10,10,0,13,0
144748,3,3,7,-4,14,0
398596,2,0,0,0,7,0
224554,1,0,0,0,15,1
184380,3,21,6,15,14,1
360020,2,3,26,-23,7,1
235299,4,25,6,19,3,0
383917,1,0,0,0,1,0
2027,4,19,15,4,1,1
346598,1,6,0,6,1,1
263181,2,3,17,-14,15,0
393015,4,12,10,2,4,0
386600,1,0,7,-7,2,0
46078,4,21,14,7,4,0
261072,2,0,14,-14,14,1
199710,3,28,7,21,4,0
33112,3,10,21,-11,16,0
113151,2,41,7,34,17,1
3973,4,29,14,15,2,0
153823,1,0,0,0,1,1
131509,2,3,6,-3,8,1
120543,1,0,6,-6,3,0
10113,4,44,7,37,5,0
412284,1,0,7,-7,13,1
304260,4,33,22,11,16,1
181714,2,7,7,0,13,1
25266,2,27,7,20,12,0
209452,4,17,17,0,8,0
381156,1,0,0,0,16,0
284372,4,14,17,-3,7,1
248995,4,27,3,24,9,0
18408,2,0,7,-7,9,1
290188,2,3,0,3,10,1
106029,4,24,3,21,14,1
131178,1,0,0,0,8,0
98885,2,7,7,0,11,0
272924,4,20,20,0,2,0
357431,3,30,24,6,5,1
222322,2,7,3,4,14,1
278349,3,17,14,3,4,1
330242,3,17,14,3,11,1
315529,3,7,6,1,4,0
93143,2,0,0,0,9,0
39785,4,9,7,2,1,1
186607,2,17,3,14,15,1
75807,4,42,26,16,1,0
314438,1,7,0,7,3,1
36702,4,23,10,13,17,1
85381,4,31,10,21,5,0
294749,1,0,0,0,12,0
390619,1,0,0,0,3,1
351786,2,16,14,2,3,1
323649,2,13,0,13,8,1
35894,2,0,0,0,17,1
377446,4,7,13,-6,15,0
331249,1,0,0,0,11,0
177078,2,10,10,0,11,1
157165,4,19,20,-1,2,1
215021,2,10,0,10,11,1
124867,3,9,6,3,5,0
285652,4,27,27,0,8,1
329192,2,9,6,3,10,1
409734,4,10,6,4,12,1
26954,4,16,6,10,13,0
165319,4,17,31,-14,6,1
314778,2,21,0,21,4,0
101941,4,9,13,-4,12,0
147600,4,15,0,15,15,0
408538,4,10,13,-3,12,0
372686,4,21,17,4,13,0
12280,3,6,6,0,6,1
78600,3,23,13,10,2,0
17165,1,0,7,-7,9,1
2333,1,0,0,0,2,0
8998,1,0,0,0,4,1
88565,1,3,0,3,6,1
219134,1,0,3,-3,13,1
362434,1,0,0,0,8,0
250697,4,17,22,-5,10,0
418622,3,21,24,-3,16,0
58933,4,20,32,-12,10,1
111285,4,10,16,-6,16,0
335054,4,16,20,-4,13,1
420126,2,0,0,0,17,0
311897,2,7,7,0,2,1
65271,2,0,14,-14,13,1
32448,4,31,6,25,15,1
54416,4,33,25,8,8,0
270012,4,19,20,-1,1,1
34586,3,17,6,11,16,0
52084,4,13,19,-6,7,1
114314,1,7,6,1,1,0
263727,1,0,0,0,15,1
193065,2,0,0,0,1,0
49136,1,0,0,0,6,1
66030,2,7,0,7,13,1
133875,1,0,6,-6,9,1
199329,1,0,0,0,4,1
372598,2,7,6,1,13,1
350622,3,13,0,13,2,0
95691,3,10,6,4,10,0
52480,1,3,0,3,7,1
236248,1,0,0,0,3,1
191801,1,3,0,3,1,0
136480,4,17,13,4,11,0
341989,3,13,3,10,16,0
103014,1,0,0,0,13,0
100283,1,6,0,6,12,0
71426,2,24,0,24,16,0
71820,4,38,33,5,16,1
10415,4,10,45,-35,5,0
76545,4,7,34,-27,1,0
216765,4,27,9,18,12,1
41780,3,10,14,-4,2,1
118761,1,7,0,7,2,0
246072,3,19,13,6,7,0
207437,2,14,14,0,7,0
126495,2,0,6,-6,6,0
319413,1,0,0,0,6,1
362420,4,30,20,10,8,0
177327,1,0,0,0,11,1
288937,1,6,0,6,9,0
319497,3,3,16,-13,6,0
51284,2,6,0,6,7,0
397343,4,3,24,-21,6,0
418228,1,0,0,0,16,0
413657,1,0,3,-3,14,0
10038,2,28,0,28,5,0
70257,1,7,0,7,15,0
412269,4,28,22,6,13,1
326072,3,16,3,13,9,1
218441,2,17,14,3,13,1
105137,4,33,14,19,14,1
80867,4,6,13,-7,3,1
200223,1,0,0,0,4,1
109616,4,25,14,11,16,1
129288,4,17,13,4,7,0
9213,3,3,23,-20,5,1
206675,1,0,7,-7,7,0
408666,4,28,17,11,12,1
213376,2,10,20,-10,10,1
158244,4,38,0,38,3,1
139208,1,3,6,-3,12,0
19365,4,24,17,7,10,1
133900,2,3,6,-3,9,0
163017,4,16,3,13,5,1
99782,3,0,7,-7,12,0
184815,3,17,20,-3,15,1
210431,2,9,7,2,9,1
82454,2,0,14,-14,3,1
208618,2,6,3,3,8,0
175045,4,20,28,-8,10,0
55915,1,0,0,0,9,1
152571,4,24,21,3,17,1
58447,4,41,17,24,10,1
152232,3,21,0,21,17,1
200475,3,23,18,5,4,1
226435,2,0,7,-7,16,1
248302,2,17,7,10,8,1
355520,1,7,0,7,5,1
283845,2,7,0,7,7,0
206589,3,10,13,-3,7,1
287072,4,26,24,2,8,0
249501,2,14,3,11,9,0
199987,3,17,10,7,4,0
265584,1,0,8,-8,16,1
320234,2,14,0,14,6,1
17196,2,7,21,-14,9,0
195172,1,7,0,7,2,1
279942,1,0,10,-10,5,0
377000,4,15,16,-1,15,0
365860,2,7,7,0,9,1
158985,4,21,29,-8,3,0
113615,3,6,6,0,17,1
257815,2,7,3,4,13,1
421665,2,10,7,3,17,0
76818,3,33,0,33,1,1
285609,3,20,17,3,8,1
116694,2,6,3,3,2,0
351403,3,13,13,0,3,1
117123,1,0,0,0,2,0
268410,1,7,0,7,17,1
368032,4,17,21,-4,11,1
357171,4,12,20,-8,5,1
229599,4,30,13,17,17,1
402207,4,19,14,5,9,1
173570,1,0,10,-10,10,1
229266,3,17,14,3,17,0
4288,4,27,6,21,2,0
250681,4,10,22,-12,10,1
347672,3,20,17,3,1,0
366104,2,7,7,0,10,0
255321,1,14,0,14,12,0
42089,4,27,17,10,2,0
81120,3,13,14,-1,3,0
304118,4,16,30,-14,16,0
263798,3,0,24,-24,15,1
133791,3,16,10,6,9,0
94763,1,3,3,0,9,0
331587,2,17,23,-6,11,1
202206,4,13,17,-4,5,0
406346,2,7,7,0,11,1
71866,2,9,0,9,16,0
163435,3,7,20,-13,5,0
53904,3,7,13,-6,8,1
134427,1,0,7,-7,10,0
48450,4,17,20,-3,5,1
222800,3,10,10,0,14,1
405060,1,0,3,-3,10,0
330728,4,6,6,0,11,1
408357,3,19,7,12,12,1
102670,4,22,20,2,13,1
315766,2,0,3,-3,4,1
93057,4,20,12,8,8,0
20058,4,19,16,3,10,1
177611,4,17,20,-3,11,1
51192,3,24,6,18,7,1
309395,2,0,0,0,1,0
400090,3,17,15,2,8,0
269321,1,0,7,-7,1,1
47023,2,17,0,17,5,0
276524,3,19,7,12,4,1
271923,3,17,20,-3,2,1
294557,4,24,13,11,12,1
117485,2,7,14,-7,2,1
85354,3,28,3,25,5,0
39916,4,6,10,-4,1,0
401569,3,17,14,3,8,1
117435,1,7,0,7,2,0
196280,3,21,10,11,2,1
69400,2,7,3,4,15,1
369960,1,7,0,7,12,0
366844,2,3,3,0,10,0
102664,4,22,20,2,13,0
418105,1,14,0,14,16,1
24542,3,10,13,-3,12,1
250337,3,7,7,0,9,0
105371,2,23,7,16,14,1
123737,1,7,3,4,5,0
403413,1,7,0,7,9,0
103895,1,0,0,0,13,1
167809,1,0,6,-6,7,0
148403,1,0,0,0,16,0
357143,4,6,14,-8,5,0
291919,4,24,10,14,11,0
407814,1,0,0,0,11,1
172455,4,13,49,-36,9,0
332180,3,3,13,-10,12,1
287956,3,14,13,1,9,0
409888,4,30,8,22,12,1
368574,3,9,0,9,11,1
128605,1,3,7,-4,7,0
158950,3,14,15,-1,3,0
334640,1,0,0,0,13,0
237472,1,7,0,7,3,1
101524,2,10,14,-4,12,0
311408,4,42,20,22,2,1
106721,2,7,12,-5,14,1
245530,2,28,0,28,7,0
74266,3,10,17,-7,17,1
146794,2,7,0,7,15,1
156913,1,7,10,-3,2,1
229360,1,0,0,0,17,1
74919,1,7,0,7,17,1
31436,2,3,0,3,15,0
160381,4,3,28,-25,4,0
84804,4,13,31,-18,4,0
376610,4,15,6,9,14,0
36155,1,0,7,-7,17,1
112916,4,16,6,10,17,0
256152,3,24,22,2,12,1
23551,4,17,17,0,11,0
411249,4,11,26,-15,13,1
216132,1,0,0,0,12,1
412033,2,7,0,7,13,0
6626,1,0,0,0,3,0
183862,4,37,28,9,14,0
141145,1,3,7,-4,13,0
9788,3,2,17,-15,5,1
307495,3,38,13,25,17,1
201898,1,0,0,0,5,1
254188,4,3,18,-15,11,0
114343,2,17,6,11,1,0
208928,3,14,6,8,8,0
51269,1,6,0,6,7,1
17591,4,20,17,3,9,0
94491,2,0,0,0,9,1
261254,3,31,0,31,14,0
302827,3,9,20,-11,15,0
179833,1,0,0,0,13,1
382946,2,0,13,-13,17,1
399041,2,10,12,-2,7,1
41670,4,24,7,17,2,1
13068,4,14,7,7,6,0
142812,4,12,10,2,13,1
411282,2,0,3,-3,13,1
403184,3,17,14,3,9,1
311822,4,17,20,-3,2,1
84563,2,7,7,0,4,0
67481,3,36,7,29,14,0
335153,3,20,0,20,13,0
54714,4,34,36,-2,8,1
406132,4,3,26,-23,11,0
170353,4,6,15,-9,8,0
388633,3,14,0,14,3,1
205872,4,20,6,14,7,0
169795,2,3,14,-11,8,0
333813,2,14,14,0,12,0
227482,3,16,10,6,16,1
174644,2,6,0,6,10,1
150829,1,0,0,0,17,0
409741,4,13,6,7,12,0
192528,4,14,17,-3,1,1
50199,1,7,0,7,6,0
262269,2,3,9,-6,15,1
87355,1,7,0,7,6,0
286047,2,10,0,10,8,0
57889,1,3,3,0,10,1
152356,2,14,3,11,17,1
205674,3,17,12,5,7,0
237017,1,0,7,-7,3,1
72,2,7,7,0,1,1
188722,2,0,17,-17,16,0
401091,2,21,3,18,8,0
33975,3,10,27,-17,16,1
325509,4,22,13,9,8,1
246216,3,21,16,5,7,1
322387,4,17,16,1,7,0
293705,4,10,13,-3,12,0
32414,3,31,6,25,15,0
413215,1,7,0,7,14,0
280402,2,6,7,-1,5,0
15042,2,7,19,-12,7,0
18327,3,22,17,5,9,0
100885,1,0,0,0,12,0
109166,4,31,7,24,15,1
337767,2,20,6,14,14,0
25041,4,24,24,0,12,0
380315,1,0,0,0,16,1
332946,4,31,3,28,12,0
59384,4,0,16,-16,11,0
2685,2,6,7,-1,2,1
197464,3,13,9,4,3,1
165234,2,14,7,7,6,1
76783,2,24,0,24,1,1
114771,1,7,10,-3,1,1
44986,2,10,0,10,4,0
50164,4,0,24,-24,6,1
320607,3,31,6,25,6,0
33990,3,10,27,-17,16,1
340013,2,14,6,8,15,0
404286,2,0,3,-3,10,0
164576,1,0,0,0,5,0
345522,2,7,16,-9,17,0
108900,4,17,17,0,15,0
30824,1,0,13,-13,15,0
60221,2,9,7,2,11,1
255692,4,3,10,-7,12,0
52726,4,6,23,-17,7,1
150747,3,13,9,4,17,1
224141,2,0,20,-20,15,1
273395,4,38,7,31,2,0
33222,2,10,0,10,16,0
387861,2,10,28,-18,2,1
418067,5,35,35,0,16,0
352951,2,13,0,13,3,0
403656,4,30,20,10,9,1
54684,4,27,29,-2,8,1
84909,4,41,17,24,4,0
70986,1,3,0,3,16,0
214441,3,7,14,-7,11,0
291730,3,0,14,-14,11,1
282728,4,16,27,-11,6,0
62564,2,3,7,-4,12,0
156021,3,17,17,0,2,1
401500,1,0,0,0,8,0
313436,3,17,7,10,3,1
378032,3,0,7,-7,15,0
307584,1,0,0,0,17,1
323994,3,17,16,1,8,1
247458,4,13,9,4,8,0
300806,4,10,33,-23,15,0
335340,4,3,23,-20,13,1
390787,1,0,7,-7,3,0
223412,3,13,19,-6,15,1
126523,2,7,6,1,6,1
269880,4,29,10,19,1,0
375844,4,20,7,13,14,0
5103,3,13,7,6,3,0
107810,3,7,20,-13,15,1
214173,4,19,9,10,11,0
387607,4,13,3,10,2,0
228939,2,7,9,-2,17,1
212223,4,3,24,-21,10,1
64158,2,21,6,15,13,0
369313,4,14,20,-6,11,1
160525,3,20,14,6,4,1
368399,2,14,7,7,11,1
374956,1,7,6,1,14,1
128885,1,0,3,-3,7,0
162665,3,16,17,-1,5,1
282876,4,16,23,-7,6,0
413527,2,0,3,-3,14,0
358292,3,0,20,-20,6,1
334654,1,2,0,2,13,0
385923,3,3,14,-11,1,1
198104,1,0,0,0,3,0
213325,1,3,3,0,10,0
341671,2,17,13,4,16,0
183708,4,22,20,2,14,1
64566,2,7,7,0,13,1
188728,2,0,17,-17,16,0
14004,2,3,7,-4,7,1
357933,1,7,6,1,6,0
132569,3,5,29,-24,9,0
316234,2,0,10,-10,4,1
274649,1,7,0,7,3,1
115532,2,0,3,-3,1,0
158974,3,21,29,-8,3,0
200164,3,7,31,-24,4,1
417396,4,16,17,-1,16,1
217201,4,12,19,-7,12,1
402257,2,3,10,-7,9,0
119082,1,6,7,-1,3,1
279749,4,30,6,24,5,1
335026,3,16,10,6,13,0
280052,4,6,23,-17,5,1
395451,1,0,0,0,6,0
294588,4,38,19,19,12,0
105973,2,17,0,17,14,0
71681,1,0,0,0,16,1
420390,4,20,20,0,17,0
45605,2,10,13,-3,4,1
48005,3,3,24,-21,5,1
91689,4,21,21,0,8,0
89555,3,0,20,-20,7,0
81117,3,13,14,-1,3,1
234029,2,14,0,14,2,1
312877,4,14,0,14,3,0
162472,2,7,3,4,4,0
79900,3,3,16,-13,2,1
348234,3,16,17,-1,1,0
376355,2,3,0,3,14,0
335808,1,7,0,7,13,0
70849,2,7,10,-3,15,1
138391,1,0,0,0,12,1
27,1,0,0,0,1,0
226990,2,3,3,0,16,0
319924,2,16,7,9,6,1
137881,3,17,8,9,11,0
217246,1,0,0,0,12,0
83011,1,0,0,0,4,1
376562,3,15,6,9,14,1
145417,2,0,7,-7,14,0
270692,2,3,3,0,1,1
101608,4,13,38,-25,12,1
139239,2,10,6,4,12,0
60131,4,27,19,8,11,0
356171,2,19,0,19,5,0
81645,1,7,0,7,3,0
246739,1,3,0,3,8,0
402060,1,0,0,0,9,0
178913,1,3,3,0,12,0
18114,2,3,17,-14,9,1
356876,4,19,16,3,5,1
385617,4,6,24,-18,1,1
205125,1,0,0,0,6,0
258513,1,0,0,0,13,1
64312,2,6,10,-4,13,0
281338,3,21,13,8,6,0
100780,2,6,3,3,12,0
103454,1,3,0,3,13,0
405739,3,10,7,3,10,0
63362,4,17,3,14,12,0
389697,4,27,16,11,3,0
224424,2,6,3,3,15,0
294320,2,10,3,7,12,1
30007,2,20,0,20,14,1
370824,1,0,0,0,12,0
207059,4,38,3,35,7,0
236481,2,7,3,4,3,0
259388,4,35,41,-6,13,1
100240,4,17,14,3,12,0
348543,3,28,14,14,2,1
133830,4,19,24,-5,9,1
18683,1,0,7,-7,9,1
214454,3,7,14,-7,11,0
100375,3,9,20,-11,12,1
337493,2,7,12,-5,14,0
391689,2,0,3,-3,4,1
193501,1,0,0,0,1,0
419788,4,17,20,-3,17,1
88068,4,24,3,21,6,1
2693,3,6,7,-1,2,0
44565,2,7,14,-7,3,1
122606,3,27,7,20,4,0
173014,2,14,0,14,9,0
102399,4,19,34,-15,13,0
137863,2,10,6,4,11,0
24288,4,13,17,-4,12,0
55101,3,23,3,20,8,0
12346,1,0,0,0,6,1
367055,4,10,38,-28,10,0
135952,1,0,3,-3,10,1
46220,3,14,21,-7,4,0
388734,2,8,0,8,3,1
51566,1,7,0,7,7,0
137562,3,17,27,-10,11,1
312905,4,21,21,0,3,0
92005,4,27,23,4,8,0
246899,1,7,7,0,8,0
345393,2,0,10,-10,17,0
175992,2,14,0,14,11,0
137309,4,13,27,-14,11,1
396547,2,17,7,10,6,0
119704,5,20,19,1,3,0
147060,1,0,7,-7,15,0
188996,1,7,6,1,16,0
99409,1,0,0,0,11,0
160592,1,0,0,0,4,0
370872,2,9,3,6,12,1
41656,3,17,7,10,2,1
323768,1,6,3,3,8,0
421863,3,7,19,-12,17,1
376629,1,0,0,0,14,0
325895,2,3,0,3,9,1
243150,4,20,22,-2,6,0
103500,2,13,0,13,13,1
198016,3,0,30,-30,3,1
164905,2,0,3,-3,6,1
137092,3,17,3,14,11,0
136270,2,15,7,8,11,1
57614,2,3,3,0,10,1
217241,1,0,0,0,12,0
162739,4,35,24,11,5,0
193581,3,0,10,-10,1,0
402635,4,20,23,-3,9,0
207118,1,0,0,0,7,1
97876,4,14,27,-13,11,0
285116,3,3,0,3,7,0
260628,2,0,10,-10,14,0
290557,4,20,20,0,10,1
317524,3,10,27,-17,5,1
366451,4,34,10,24,10,0
1648,2,0,0,0,1,0
69012,3,21,17,4,15,1
11535,3,6,10,-4,6,1
346678,3,21,6,15,1,0
252168,3,20,10,10,10,0
220545,3,7,20,-13,13,1
94745,1,0,0,0,9,1
41875,1,7,3,4,2,1
326135,1,0,0,0,9,1
404573,1,0,7,-7,10,0
138911,1,0,3,-3,12,1
65546,1,3,0,3,13,1
221654,5,23,24,-1,14,0
274723,3,16,12,4,3,1
258756,4,3,34,-31,13,0
291066,1,6,0,6,10,0
387789,1,3,0,3,2,0
108384,3,0,21,-21,15,1
165861,3,6,16,-10,6,0
258620,4,13,13,0,13,0
142082,1,0,0,0,13,0
389063,2,20,0,20,3,1
279782,1,7,3,4,5,0
27416,4,27,17,10,13,1
360293,2,0,13,-13,7,1
191572,4,14,24,-10,17,1
206779,4,14,27,-13,7,1
363635,1,0,0,0,8,0
194669,4,34,7,27,2,0
159402,3,10,20,-10,3,1
288161,4,19,14,5,9,0
265494,3,7,7,0,16,1
48727,3,10,19,-9,5,1
58461,4,48,17,31,10,0
287692,4,9,13,-4,9,1
68143,4,6,10,-4,14,1
178332,2,14,3,11,12,0
343785,2,7,3,4,17,1
164375,3,23,3,20,5,0
47683,3,3,17,-14,5,0
40497,4,7,20,-13,2,0
338500,2,17,7,10,14,0
46124,1,0,0,0,4,0
151013,2,0,0,0,17,0
150934,3,13,7,6,17,0
234879,4,3,12,-9,2,0
319109,1,0,0,0,5,0
61773,1,0,7,-7,12,1
53881,2,7,7,0,8,0
302805,3,9,13,-4,15,1
133308,2,7,0,7,9,0
18944,1,0,0,0,10,1
33017,4,12,44,-32,15,0
133336,3,14,6,8,9,0
313745,3,21,3,18,3,1
278644,3,14,3,11,4,0
43646,2,7,3,4,3,1
386986,4,7,21,-14,2,1
250904,1,0,0,0,10,0
154699,1,0,0,0,1,1
307292,2,14,3,11,17,0
35148,2,0,7,-7,16,1
193937,4,31,24,7,1,0
72856,4,45,17,28,16,1
361035,2,16,2,14,7,0
214457,3,7,17,-10,11,0
122594,3,20,7,13,4,0
310981,4,16,37,-21,2,0
287078,4,26,24,2,8,0
307447,2,21,10,11,17,1
408470,2,7,3,4,12,0
39633,4,27,6,21,1,1
242719,1,7,7,0,6,0
194089,1,0,0,0,1,1
393780,4,7,14,-7,5,0
222266,4,13,27,-14,14,1
246999,4,20,24,-4,8,0
146704,3,7,32,-25,15,1
318728,2,10,23,-13,5,0
228045,2,3,3,0,17,1
299898,3,13,8,5,14,0
47575,4,40,6,34,5,0
397022,3,21,6,15,6,0
342691,2,0,0,0,16,1
106759,3,17,15,2,14,1
283862,2,7,3,4,7,0
217105,1,0,7,-7,12,1
197717,2,7,10,-3,3,0
233642,4,23,41,-18,2,0
172044,2,7,0,7,9,0
202043,5,17,17,0,5,1
272719,3,12,3,9,2,0
111313,1,0,0,0,16,0
348765,4,31,24,7,2,0
93306,2,21,3,18,9,0
390257,3,10,6,4,3,0
378830,1,0,3,-3,15,1
99833,4,8,27,-19,12,1
244968,2,0,20,-20,7,0
316238,2,0,10,-10,4,0
355937,4,40,17,23,5,0
304822,3,3,3,0,16,0
94200,3,17,14,3,9,1
257051,3,7,14,-7,12,0
110237,1,0,3,-3,16,0
413705,2,14,13,1,14,1
7668,4,34,10,24,4,0
375561,4,33,14,19,14,0
324571,3,13,9,4,8,1
236323,2,0,23,-23,3,1
283054,1,0,0,0,7,0
334819,2,10,0,10,13,1
61240,2,14,7,7,11,1
126528,3,7,6,1,6,1
343175,2,3,0,3,16,0
110474,3,17,0,17,16,0
265797,4,20,12,8,16,1
52441,4,18,17,1,7,0
407106,2,7,20,-13,11,0
82392,4,13,10,3,3,0
12439,4,10,6,4,6,0
357757,4,43,19,24,5,1
225958,3,27,7,20,16,0
421416,3,24,20,4,17,1
186812,3,26,7,19,15,1
232523,3,20,10,10,1,0
189540,4,20,7,13,17,1
308224,2,7,10,-3,1,1
121179,2,7,13,-6,3,1
60640,2,7,3,4,11,0
218789,4,3,19,-16,13,1
150871,2,0,7,-7,17,1
375605,2,7,14,-7,14,1
367921,4,23,27,-4,10,1
183750,1,6,7,-1,14,1
153144,3,20,17,3,1,0
274466,4,10,17,-7,3,1
31438,2,3,6,-3,15,0
65185,3,3,3,0,13,1
387583,3,6,3,3,2,1
99344,3,20,3,17,11,1
265941,3,0,23,-23,16,0
391949,4,30,34,-4,4,1
347951,3,0,21,-21,1,0
96771,3,7,10,-3,10,0
160815,3,20,10,10,4,0
94186,3,17,7,10,9,0
19717,2,6,6,0,10,0
32561,3,20,13,7,15,0
193134,4,13,6,7,1,0
118966,2,0,17,-17,3,0
141212,3,3,21,-18,13,0
172022,1,0,0,0,9,0
286719,2,17,7,10,8,1
158587,1,0,6,-6,3,0
258832,2,7,7,0,13,0
51695,1,0,3,-3,7,1
219481,2,0,21,-21,13,1
306427,2,0,10,-10,17,0
356425,1,0,0,0,5,0
184046,1,0,0,0,14,1
19124,2,7,3,4,10,1
43465,1,0,0,0,3,1
162865,4,6,3,3,5,1
285168,5,3,3,0,7,1
248545,5,23,26,-3,8,1
134080,3,26,13,13,9,1
355558,2,14,3,11,5,0
103898,1,0,0,0,13,0
74672,3,7,10,-3,17,1
208476,2,17,7,10,8,1
50007,4,28,10,18,6,1
61325,4,31,28,3,11,0
150716,2,6,6,0,17,0
327470,4,10,30,-20,9,1
227934,3,27,20,7,16,0
262794,4,35,17,18,15,0
409201,2,3,0,3,12,0
146872,3,31,0,31,15,0
364544,2,9,20,-11,9,0
353153,4,13,29,-16,3,1
256365,1,6,0,6,12,0
402544,2,7,7,0,9,0
415100,1,0,7,-7,15,0
392927,2,3,3,0,4,1
148492,3,24,3,21,16,0
343419,1,0,0,0,16,0
398537,4,28,16,12,7,1
35399,5,30,30,0,16,1
69406,2,14,3,11,15,0
2596,4,10,27,-17,2,1
244524,3,25,13,12,7,1
121872,3,0,17,-17,4,1
240508,3,6,7,-1,5,0
17061,2,13,0,13,9,0
72546,4,19,24,-5,16,1
261682,2,13,0,13,14,1
222112,4,34,17,17,14,0
56290,3,3,20,-17,9,1
266822,4,10,14,-4,16,0
15587,2,7,3,4,8,1
89999,3,5,21,-16,7,1
73191,2,7,0,7,16,1
293651,2,10,7,3,12,0
188277,3,14,10,4,16,0
204178,4,24,17,7,6,0
41514,3,15,7,8,2,1
358070,1,0,0,0,6,1
104284,2,24,7,17,13,0
57411,4,14,6,8,10,0
123538,4,13,10,3,4,0
215111,4,22,7,15,11,0
381006,1,0,0,0,16,0
73042,2,7,10,-3,16,0
275742,2,16,0,16,3,0
356206,3,22,7,15,5,1
168546,2,7,10,-3,7,1
267349,1,0,7,-7,17,1
139228,1,3,6,-3,12,1
301725,1,0,10,-10,15,0
198693,4,15,27,-12,3,1
328845,4,24,20,4,10,0
377165,4,13,17,-4,15,1
145162,2,29,0,29,14,1
222538,4,17,14,3,14,1
285365,1,0,0,0,8,1
12368,2,7,3,4,6,1
279737,4,29,6,23,5,1
315711,4,17,16,1,4,0
240630,3,20,14,6,5,0
297010,1,0,0,0,13,1
190312,4,7,20,-13,17,1
207411,2,7,0,7,7,0
15735,1,0,3,-3,8,1
224846,4,11,16,-5,15,1
339045,4,20,10,10,15,0
86841,2,9,16,-7,5,1
395316,1,14,0,14,5,0
172942,4,55,31,24,9,0
419108,1,3,0,3,16,1
99284,2,10,0,10,11,0
271720,2,13,10,3,2,1
232279,1,0,0,0,1,1
378172,3,24,16,8,15,0
55395,2,13,7,6,9,0
118047,4,20,20,0,2,1
333009,2,3,3,0,12,0
308770,4,10,20,-10,1,1
269660,2,10,0,10,1,0
218545,1,0,7,-7,13,0
207087,4,38,10,28,7,0
310808,4,13,13,0,2,0
241254,2,3,0,3,5,0
234467,2,17,13,4,2,1
399276,1,0,0,0,7,0
159672,1,0,7,-7,3,1
38373,2,7,9,-2,1,1
82220,4,16,10,6,3,0
260422,4,20,7,13,14,0
370968,1,0,0,0,12,0
244596,4,32,30,2,7,0
20933,1,7,7,0,10,0
349122,2,7,0,7,2,0
197918,4,11,7,4,3,1
276994,4,24,20,4,4,0
164217,3,27,35,-8,5,0
361478,2,7,0,7,7,0
90473,3,0,20,-20,7,1
231084,4,27,14,13,1,0
357553,3,10,13,-3,5,1
264279,3,10,17,-7,15,0
102936,2,12,21,-9,13,0
346858,3,16,6,10,1,1
277990,2,3,7,-4,4,0
363369,2,7,10,-3,8,1
378125,2,21,0,21,15,1
87818,1,10,0,10,6,0
372720,1,0,0,0,13,0
345641,1,0,0,0,17,1
374231,1,7,0,7,13,0
122215,1,3,7,-4,4,0
365469,3,10,19,-9,9,0
260893,1,0,0,0,14,1
133151,2,10,17,-7,9,1
289151,2,13,7,6,9,0
109752,3,13,0,13,16,0
405360,1,0,0,0,10,0
241469,4,10,42,-32,5,1
184051,1,0,0,0,14,1
117136,1,6,3,3,2,0
69331,4,19,3,16,15,0
133566,1,0,0,0,9,1
394063,4,9,16,-7,5,1
391029,4,27,34,-7,4,1
264679,1,7,0,7,16,1
117470,2,7,14,-7,2,0
181678,1,0,0,0,13,0
169187,2,10,6,4,7,0
342622,4,22,27,-5,16,0
251489,2,16,3,13,10,0
150015,3,14,6,8,16,1
48036,4,10,27,-17,5,0
161864,2,13,3,10,4,0
183947,2,7,3,4,14,1
247674,1,7,3,4,8,0
420966,3,7,21,-14,17,1
107856,1,0,0,0,15,1
104351,3,45,31,14,13,1
177049,1,3,0,3,11,0
90611,3,17,20,-3,7,0
63871,2,3,14,-11,12,0
20746,4,31,20,11,10,1
356991,3,20,3,17,5,0
363723,3,22,13,9,8,1
285417,2,24,0,24,8,1
158122,4,25,9,16,3,1
329242,3,17,13,4,10,1
144890,3,14,7,7,14,1
189614,2,10,3,7,17,0
110723,1,3,3,0,16,0
108060,2,6,14,-8,15,1
62108,2,7,7,0,12,1
291108,2,12,13,-1,10,1
163156,3,22,25,-3,5,0
372334,4,24,17,7,13,1
203112,1,0,0,0,5,0
371779,4,24,14,10,12,1
151015,2,0,0,0,17,0
358446,3,32,20,12,6,0
231035,3,24,0,24,1,0
274385,2,3,10,-7,3,0
281586,1,7,0,7,6,0
384299,3,6,0,6,1,1
100721,4,28,24,4,12,0
181243,2,0,0,0,13,0
168592,3,14,10,4,7,1
231817,4,26,20,6,1,1
28456,1,7,0,7,14,0
244976,2,0,20,-20,7,1
337216,3,16,16,0,14,1
5577,4,19,10,9,3,1
115195,1,0,0,0,1,1
136232,1,6,0,6,11,1
151080,4,17,10,7,17,0
421583,4,16,6,10,17,0
257345,2,17,0,17,13,0
341174,1,3,0,3,16,1
189298,2,3,0,3,16,0
15790,3,0,12,-12,8,1
225417,4,27,38,-11,15,1
238350,2,10,16,-6,4,0
90951,1,0,0,0,7,0
236802,3,3,9,-6,3,1
107105,4,40,6,34,15,0
329094,3,17,7,10,10,0
227726,2,3,0,3,16,1
242327,3,10,13,-3,6,1
238315,1,3,9,-6,4,1
378931,4,16,30,-14,15,0
83075,2,6,14,-8,4,1
39664,1,0,0,0,1,1
310650,3,13,30,-17,2,0
85969,3,14,14,0,5,1
268805,4,31,10,21,17,1
392043,3,10,17,-7,4,0
126084,3,20,3,17,6,0
244981,3,0,20,-20,7,1
358672,1,0,0,0,6,1
316362,1,0,0,0,4,1
354240,4,20,10,10,4,0
170953,4,38,20,18,8,1
301845,1,0,0,0,15,0
245186,4,17,28,-11,7,0
44944,1,0,0,0,4,0
347631,2,17,10,7,1,0
272539,2,10,3,7,2,1
218585,2,7,17,-10,13,0
285300,3,14,9,5,7,1
233449,3,23,10,13,2,1
52092,4,13,19,-6,7,0
31011,2,3,3,0,15,0
44350,4,24,23,1,3,0
297318,1,0,3,-3,13,1
146593,4,21,38,-17,15,1
1172,1,0,0,0,1,1
273627,2,10,6,4,2,1
86448,3,27,14,13,5,1
317404,4,7,10,-3,5,0
134934,3,7,16,-9,10,1
348308,1,7,0,7,1,0
242050,4,10,9,1,5,0
305505,1,6,0,6,17,1
149362,2,3,6,-3,16,1
289525,4,28,7,21,10,0
378829,1,0,3,-3,15,1
371752,3,14,14,0,12,1
419767,3,17,17,0,17,0
127787,3,10,21,-11,6,0
330312,1,0,0,0,11,1
97869,4,14,27,-13,11,1
36807,3,10,16,-6,17,0
333767,1,6,0,6,12,0
329015,1,0,0,0,10,0
9927,3,0,3,-3,5,1
241805,1,3,3,0,5,0
100979,3,10,16,-6,12,1
238657,2,16,14,2,4,1
79354,4,32,3,29,2,0
260958,3,10,0,10,14,0
282041,1,0,0,0,6,1
323377,3,17,0,17,7,0
247751,3,10,6,4,8,0
368169,3,19,21,-2,11,1
370056,4,31,19,12,12,0
136358,4,18,14,4,11,0
303501,4,25,17,8,16,1
133951,4,13,6,7,9,1
385624,4,6,24,-18,1,1
38599,4,38,13,25,1,1
186893,2,7,0,7,15,0
248792,3,30,14,16,9,1
357869,3,13,31,-18,6,0
315044,2,24,7,17,4,0
410807,4,22,6,16,13,1
195673,2,7,10,-3,2,1
276882,1,0,0,0,4,1
63561,1,10,0,10,12,0
292513,4,10,12,-2,11,0
411001,2,7,7,0,13,1
314021,2,3,0,3,3,1
293477,1,0,3,-3,11,1
224408,1,0,0,0,15,0
57631,2,10,3,7,10,1
72590,1,0,0,0,16,1
286014,1,0,0,0,8,1
200703,1,7,0,7,4,1
226470,3,7,10,-3,16,1
301281,1,7,0,7,15,1
55216,2,7,0,7,9,0
208513,3,44,7,37,8,0
127409,1,0,0,0,6,1
406034,1,0,3,-3,11,1
366792,1,0,0,0,10,0
57005,2,0,10,-10,9,0
116033,3,13,7,6,1,0
84703,2,3,7,-4,4,0
401360,1,10,0,10,8,1
123417,4,28,27,1,4,0
40906,3,13,20,-7,2,1
104684,4,14,3,11,14,0
274701,2,10,12,-2,3,1
142739,2,9,10,-1,13,1
354773,2,13,17,-4,4,0
246863,5,20,20,0,8,0
66749,2,7,3,4,14,0
195230,3,16,10,6,2,0
241042,1,0,0,0,5,1
91646,3,21,14,7,8,0
329258,4,31,13,18,10,0
39272,3,3,13,-10,1,0
301947,3,17,20,-3,15,1
182311,2,14,7,7,14,1
123828,3,10,3,7,5,0
300667,4,24,3,21,15,0
259921,3,17,10,7,14,1
354108,4,19,0,19,4,0
375228,4,24,24,0,14,1
58744,3,10,17,-7,10,0
327245,2,6,3,3,9,0
360476,3,17,0,17,7,0
261831,2,6,10,-4,14,1
375025,3,21,27,-6,14,0
282625,2,3,7,-4,6,1
90534,4,0,26,-26,7,0
155928,4,17,16,1,2,1
121416,4,7,12,-5,3,1
305150,4,21,10,11,16,1
372937,3,25,7,18,13,1
353034,4,26,10,16,3,0
156483,3,0,6,-6,2,0
236844,4,6,9,-3,3,1
51567,1,7,0,7,7,0
88952,3,26,9,17,6,0
34355,1,0,0,0,16,1
227318,3,13,27,-14,16,1
82422,1,0,7,-7,3,1
386581,1,0,0,0,2,1
186116,1,3,0,3,15,1
8589,1,0,10,-10,4,1
177388,2,17,7,10,11,0
260012,1,0,0,0,14,0
74256,3,10,10,0,17,0
51699,1,0,3,-3,7,0
267335,1,0,6,-6,17,0
20852,3,21,9,12,10,1
112114,2,7,20,-13,17,0
240756,2,7,7,0,5,1
338906,1,0,0,0,15,1
139646,1,0,0,0,12,1
354802,3,13,28,-15,4,1
146634,1,0,7,-7,15,1
168518,1,0,0,0,7,1
10254,4,13,10,3,5,1
203257,1,0,0,0,6,1
406261,3,21,27,-6,11,1
205733,4,27,19,8,7,0
94770,2,3,3,0,9,1
155089,3,6,33,-27,1,1
197692,1,7,3,4,3,1
19871,2,13,21,-8,10,0
13990,2,3,0,3,7,1
268973,4,6,36,-30,17,0
295165,4,10,21,-11,12,0
180416,1,7,0,7,13,0
84857,2,20,10,10,4,1
287149,2,10,3,7,8,0
115929,4,20,30,-10,1,0
238279,4,10,24,-14,4,1
286526,2,3,14,-11,8,1
251449,1,0,0,0,10,0
144988,2,0,3,-3,14,0
267273,3,17,14,3,17,0
100335,2,9,17,-8,12,0
138234,4,10,12,-2,11,1
341179,2,3,0,3,16,1
304042,2,3,13,-10,16,0
280285,3,13,16,-3,5,1
230777,4,9,27,-18,1,0
2214,2,7,0,7,1,1
338667,2,13,7,6,14,0
373724,4,13,21,-8,13,1
316717,1,7,0,7,4,0
34434,2,21,3,18,16,1
387456,4,21,16,5,2,1
266661,3,19,3,16,16,1
304911,1,7,3,4,16,0
421291,4,19,10,9,17,0
67452,2,13,7,6,14,1
167192,2,23,7,16,7,0
23685,4,7,27,-20,12,0
292150,2,21,0,21,11,1
234649,3,20,20,0,2,0
69102,2,7,7,0,15,0
6483,1,0,0,0,3,0
184442,4,31,13,18,14,1
52824,2,0,37,-37,7,1
221893,3,13,7,6,14,0
287853,4,28,20,8,9,0
158829,3,20,3,17,3,0
88931,2,23,3,20,6,0
72499,3,13,17,-4,16,0
398132,4,30,42,-12,7,0
84970,1,9,7,2,4,0
293382,3,13,10,3,11,1
105016,1,0,7,-7,14,1
85117,1,0,3,-3,4,1
406718,4,33,0,33,11,1
378398,2,7,0,7,15,1
340541,4,7,40,-33,15,1
267644,1,0,14,-14,17,0
173744,2,3,3,0,10,0
214121,2,3,6,-3,11,1
316309,3,10,19,-9,4,1
136767,3,13,10,3,11,0
236388,4,14,23,-9,3,0
26784,4,13,33,-20,13,0
232829,4,16,17,-1,2,0
174742,4,9,10,-1,10,0
293077,3,10,13,-3,11,1
168895,3,17,6,11,7,1
216484,2,20,1,19,12,0
285701,1,0,0,0,8,0
7988,1,0,0,0,4,1
413031,4,19,21,-2,14,1
131022,4,17,30,-13,8,1
76303,1,3,3,0,1,0
332149,2,0,10,-10,12,1
64078,4,27,24,3,13,0
196245,2,20,10,10,2,1
420038,3,24,14,10,17,0
96598,2,3,3,0,10,1
365229,1,0,7,-7,9,0
414655,1,0,0,0,14,1
40581,2,17,7,10,2,0
213173,2,3,7,-4,10,1
384489,4,28,6,22,1,1
130945,2,7,21,-14,8,0
117361,3,21,3,18,2,1
339443,3,10,17,-7,15,1
109298,3,13,3,10,15,0
53104,2,19,21,-2,7,0
70021,3,24,10,14,15,0
47245,4,12,9,3,5,1
331434,2,6,7,-1,11,0
283183,4,20,9,11,7,1
404337,3,13,6,7,10,1
244072,3,20,27,-7,6,1
134228,3,3,23,-20,10,1
78897,3,17,7,10,2,0
252909,2,6,0,6,11,1
316833,4,16,10,6,4,0
352230,2,3,3,0,3,0
329193,2,10,6,4,10,0
221566,2,20,12,8,14,0
225660,3,14,10,4,16,1
270291,4,10,27,-17,1,0
386110,4,21,9,12,1,1
417878,3,13,10,3,16,0
10805,3,21,0,21,5,1
78198,4,41,3,38,2,1
388971,4,17,27,-10,3,1
197502,4,20,9,11,3,1
373110,4,10,21,-11,13,1
228776,1,0,7,-7,17,1
4992,4,24,17,7,3,1
304277,1,0,0,0,16,1
242433,2,0,7,-7,6,1
331548,1,7,14,-7,11,0
23360,3,12,10,2,11,1
323183,2,7,0,7,7,0
386195,2,6,3,3,2,0
32782,1,0,0,0,15,1
421147,3,37,16,21,17,0
362994,3,33,16,17,8,0
205651,2,14,9,5,7,0
65768,3,14,25,-11,13,1
128639,2,3,10,-7,7,1
253559,2,6,7,-1,11,0
358800,1,0,0,0,6,0
353370,2,6,0,6,4,0
91516,3,19,3,16,8,0
82769,2,6,6,0,3,1
417296,1,0,3,-3,16,1
70870,2,7,17,-10,15,1
338071,2,0,7,-7,14,0
329246,4,24,13,11,10,0
386826,3,13,14,-1,2,0
346663,2,14,6,8,1,0
199558,3,20,10,10,4,1
186911,2,7,3,4,15,1
360831,4,31,37,-6,7,0
397887,2,7,3,4,7,0
63440,2,14,10,4,12,0
358983,2,7,0,7,6,0
251490,2,16,3,13,10,0
23894,2,3,0,3,12,1
69369,1,0,0,0,15,0
247984,2,7,3,4,8,1
239503,1,0,0,0,4,1
200800,4,31,17,14,4,0
162736,4,35,24,11,5,0
121944,2,3,7,-4,4,0
297338,2,3,10,-7,13,1
116688,1,6,3,3,2,0
50325,4,13,23,-10,6,1
111321,1,0,7,-7,16,1
24736,4,20,14,6,12,0
242117,1,13,0,13,6,0
45848,1,6,0,6,4,1
49,2,0,0,0,1,1
328283,1,3,7,-4,10,0
21094,2,0,0,0,10,1
277407,3,24,9,15,4,1
106534,1,7,0,7,14,0
28026,1,0,7,-7,13,0
86635,1,0,0,0,5,1
20196,3,17,10,7,10,1
263570,1,0,0,0,15,0
379259,1,0,3,-3,16,0
114189,2,3,0,3,1,1
171751,2,3,7,-4,9,1
94180,2,17,7,10,9,0
88062,3,24,3,21,6,0
338039,2,0,0,0,14,0
386263,4,14,17,-3,2,0
300062,4,7,40,-33,14,0
18726,2,3,7,-4,9,1
293666,3,10,7,3,12,0
59206,3,14,45,-31,10,1
384425,2,21,0,21,1,0
302091,3,20,24,-4,15,0
214332,4,21,13,8,11,0
171959,3,14,14,0,9,1
222222,3,13,16,-3,14,0
379022,2,7,6,1,15,0
402471,4,24,15,9,9,1
167906,4,21,19,2,7,0
237059,2,0,17,-17,3,0
122648,1,0,0,0,4,1
332548,1,0,3,-3,12,1
29053,4,20,10,10,14,1
315065,3,30,14,16,4,1
124524,1,3,0,3,5,1
385783,3,20,0,20,1,0
82513,3,10,20,-10,3,1
153904,4,7,6,1,1,1
26053,4,13,19,-6,13,1
36656,3,13,3,10,17,0
329506,3,17,7,10,10,1
300295,2,0,7,-7,14,0
123019,3,0,13,-13,4,1
228137,1,0,0,0,17,0
364236,2,0,13,-13,9,1
263518,4,20,23,-3,15,0
60627,1,0,3,-3,11,1
102898,2,3,14,-11,13,1
350198,3,19,0,19,2,0
331332,3,0,27,-27,11,0
245897,3,6,37,-31,7,0
409684,2,10,6,4,12,1
71205,3,19,20,-1,16,1
325028,3,20,21,-1,8,0
52609,1,0,0,0,7,0
162737,4,35,24,11,5,0
116440,3,6,10,-4,1,0
60070,2,7,3,4,11,0
67583,2,0,20,-20,14,1
63706,1,7,0,7,12,0
369874,3,7,9,-2,12,0
106420,2,13,0,13,14,0
106437,2,16,0,16,14,0
9907,2,0,3,-3,5,1
108554,3,17,14,3,15,0
248580,1,7,0,7,9,0
410546,2,7,7,0,13,0
234976,3,13,3,10,2,0
248422,2,10,3,7,8,1
226789,4,7,20,-13,16,1
53270,3,3,7,-4,8,1
120143,3,10,6,4,3,0
194943,4,14,10,4,2,0
7247,2,6,13,-7,4,1
175431,3,17,23,-6,11,0
130577,5,13,19,-6,8,0
209500,1,7,3,4,8,1
6730,4,3,23,-20,3,1
368912,4,38,3,35,11,0
39496,4,13,19,-6,1,1
3748,2,13,3,10,2,0
233491,4,26,10,16,2,0
126604,4,23,20,3,6,1
267395,3,0,10,-10,17,1
251023,4,3,6,-3,10,1
57801,3,19,10,9,10,1
75001,3,27,17,10,17,0
116928,3,21,10,11,2,1
118122,2,13,20,-7,2,1
343781,2,7,3,4,17,1
145332,3,35,19,16,14,1
160473,2,20,7,13,4,0
25394,2,6,0,6,12,0
307659,3,14,17,-3,17,0
3660,4,20,28,-8,2,1
385716,1,0,0,0,1,1
289567,1,7,6,1,10,0
386785,2,7,7,0,2,1
401944,2,0,3,-3,9,1
163297,3,13,13,0,5,0
20392,4,10,13,-3,10,1
285712,1,0,3,-3,8,0
29800,1,0,0,0,14,1
279430,4,16,24,-8,5,0
269277,4,10,19,-9,17,1
221596,3,20,18,2,14,1
293257,4,23,7,16,11,1
246477,2,9,0,9,8,0
142821,4,12,10,2,13,0
55601,4,27,7,20,9,0
59424,1,0,7,-7,11,0
137543,3,17,17,0,11,0
186843,4,29,14,15,15,0
217574,2,3,9,-6,12,0
315479,2,0,0,0,4,0
192343,4,27,20,7,1,0
275411,1,6,7,-1,3,0
195157,1,0,0,0,2,1
395532,3,21,14,7,6,0
407627,4,10,17,-7,11,1
252497,3,10,22,-12,10,0
113688,1,0,7,-7,17,0
69493,4,31,24,7,15,1
145986,4,13,21,-8,15,1
52193,2,7,3,4,7,0
46272,1,0,0,0,4,1
184591,1,0,0,0,15,1
100943,2,10,3,7,12,1
115665,2,3,3,0,1,0
390031,1,0,0,0,3,0
9080,4,28,13,15,4,1
346180,2,17,0,17,1,0
416976,4,10,17,-7,15,1
195185,2,10,0,10,2,0
7127,3,31,21,10,4,1
355642,4,38,17,21,5,0
192210,4,3,27,-24,1,1
350227,4,27,0,27,2,1
279219,2,10,6,4,5,1
96976,4,22,17,5,10,1
51393,1,0,0,0,7,0
9225,4,3,23,-20,5,0
288525,2,9,21,-12,9,1
55677,2,17,14,3,9,1
347432,1,3,13,-10,1,1
387921,4,10,28,-18,2,0
301130,1,7,0,7,15,0
125942,3,16,13,3,6,0
329703,4,37,17,20,11,1
241508,1,0,3,-3,5,1
23565,1,0,0,0,12,1
49995,3,28,10,18,6,0
313523,1,0,6,-6,3,0
37391,3,24,0,24,17,1
92688,2,3,10,-7,8,0
177213,2,7,0,7,11,0
61857,3,13,23,-10,12,1
249221,2,19,7,12,9,0
394473,3,7,18,-11,5,1
70892,3,7,20,-13,15,1
218614,3,10,23,-13,13,1
225662,3,14,10,4,16,1
419070,4,13,20,-7,16,1
6037,1,0,7,-7,3,0
366108,2,7,14,-7,10,1
161671,4,39,32,7,4,1
81393,3,7,10,-3,3,1
207792,4,27,16,11,7,0
418913,4,20,17,3,16,0
262950,4,14,32,-18,15,1
95149,3,23,17,6,9,0
344159,4,27,11,16,17,1
245971,1,0,0,0,7,1
395387,3,28,3,25,5,1
170668,1,0,0,0,8,0
11414,3,26,0,26,6,0
250529,3,16,7,9,9,0
261422,4,10,24,-14,14,1
144378,2,0,3,-3,14,1
244306,1,0,0,0,7,1
150224,4,6,26,-20,16,1
63564,1,10,7,3,12,1
413926,1,0,0,0,14,1
361877,1,0,0,0,7,1
306749,3,10,20,-10,17,0
400803,2,14,13,1,8,1
191075,2,7,3,4,17,0
106,3,7,7,0,1,0
185126,3,0,16,-16,15,1
385293,3,7,20,-13,1,1
148350,4,14,3,11,16,0
42442,1,0,0,0,3,0
180855,5,20,20,0,13,1
215135,1,7,0,7,11,0
418996,2,7,7,0,16,1
141896,4,27,21,6,13,1
364,2,21,10,11,1,0
391315,3,17,3,14,4,1
101420,3,15,7,8,12,1
334163,4,23,14,9,13,1
392094,4,24,40,-16,4,1
131439,4,13,19,-6,8,1
102264,1,7,0,7,13,0
127742,1,0,14,-14,6,1
404867,4,30,27,3,10,0
288126,3,16,7,9,9,0
142459,3,7,10,-3,13,1
390969,2,13,7,6,4,0
295940,4,13,24,-11,12,0
337656,3,21,13,8,14,1
405243,2,7,7,0,10,1
3683,1,0,0,0,2,0
9470,2,10,3,7,5,1
72988,1,0,0,0,16,0
106391,1,0,0,0,14,1
258759,4,3,34,-31,13,0
164902,2,0,3,-3,6,0
104762,2,17,16,1,14,1
225594,1,0,7,-7,16,0
113191,4,41,16,25,17,0
392791,2,17,3,14,4,0
93979,1,0,7,-7,9,1
130972,3,10,24,-14,8,0
234526,4,20,20,0,2,0
319151,2,2,0,2,5,0
415103,1,0,14,-14,15,1
300769,3,10,13,-3,15,0
6235,2,13,0,13,3,0
45033,3,20,10,10,4,1
180815,4,10,20,-10,13,1
148120,1,0,0,0,16,0
331383,1,3,0,3,11,0
289325,2,28,17,11,9,0
219037,3,24,6,18,13,0
41790,3,10,14,-4,2,0
376106,3,0,9,-9,14,1
63552,1,10,0,10,12,0
333162,1,0,0,0,12,0
324045,1,0,0,0,8,1
264302,3,10,23,-13,15,0
262118,2,14,3,11,15,1
44067,1,0,3,-3,3,0
172537,2,0,7,-7,9,0
338458,1,7,0,7,14,0
174715,4,9,7,2,10,0
388445,2,0,13,-13,2,1
42945,3,24,23,1,3,1
149035,1,0,7,-7,16,1
189056,3,14,17,-3,16,1
275858,1,3,0,3,3,1
254041,3,14,13,1,11,0
228112,4,13,10,3,17,1
150310,2,24,7,17,16,0
257905,4,16,19,-3,13,1
409183,1,0,0,0,12,1
277908,4,7,20,-13,4,1
264661,5,23,20,3,16,0
161352,5,20,19,1,4,1
216227,4,17,10,7,12,0
343180,2,3,0,3,16,0
340581,1,0,0,0,15,1
386200,2,6,10,-4,2,1
292693,1,0,0,0,11,1
65996,1,0,0,0,13,0
255127,1,0,0,0,12,1
86801,1,6,3,3,5,0
216105,4,24,26,-2,11,0
269431,4,21,20,1,1,0
181764,4,7,14,-7,13,0
330587,4,21,7,14,11,1
170059,1,0,0,0,8,1
389272,4,34,7,27,3,0
394126,1,7,7,0,5,0
173935,3,13,19,-6,10,1
15948,3,9,14,-5,8,1
190154,4,30,3,27,17,1
336656,1,0,0,0,14,0
123880,1,0,0,0,5,0
252651,3,6,3,3,10,0
105861,3,16,10,6,14,1
11269,3,17,28,-11,6,0
197862,2,11,7,4,3,0
8334,2,16,3,13,4,1
117618,2,6,10,-4,2,1
43232,3,17,10,7,3,0
328121,2,6,0,6,10,1
269933,2,13,10,3,1,1
304515,3,10,14,-4,16,0
163747,2,0,9,-9,5,0
279898,4,24,13,11,5,1
386089,3,14,6,8,1,1
327861,3,16,17,-1,10,1
234290,1,7,0,7,2,1
158265,4,38,0,38,3,0
43577,4,24,3,21,3,0
54818,3,13,0,13,8,0
151336,2,19,14,5,17,0
78556,2,13,7,6,2,0
200783,4,31,9,22,4,0
17507,2,13,0,13,9,1
84150,2,10,0,10,4,0
161573,2,15,10,5,4,1
390595,4,20,27,-7,3,0
362915,2,7,0,7,8,1
94908,1,0,0,0,9,0
320121,3,17,0,17,6,0
261255,3,31,0,31,14,0
7592,2,14,3,11,4,1
32565,3,20,13,7,15,1
346930,1,0,3,-3,1,0
36518,3,10,20,-10,17,0
372213,4,9,25,-16,13,1
107047,2,17,0,17,15,1
130487,2,3,3,0,8,1
146535,2,14,10,4,15,0
413341,4,20,7,13,14,0
269495,2,10,10,0,1,0
160885,4,34,27,7,4,0
281640,2,21,3,18,6,0
59491,3,6,20,-14,11,1
355168,4,26,26,0,4,1
421739,4,24,17,7,17,0
36616,2,3,3,0,17,1
10873,1,0,0,0,5,0
196948,2,14,0,14,3,0
273577,1,3,3,0,2,0
253780,4,24,17,7,11,1
403379,4,26,11,15,9,1
192731,1,0,3,-3,1,0
207066,4,38,3,35,7,0
281960,2,14,14,0,6,0
238049,4,13,13,0,4,0
50536,1,0,3,-3,6,0
214601,3,3,9,-6,11,1
33188,1,7,0,7,16,0
304690,4,14,7,7,16,1
22278,2,0,3,-3,11,1
101118,3,10,17,-7,12,1
222626,2,7,7,0,14,0
400263,3,17,6,11,8,0
217195,4,12,16,-4,12,0
274266,3,29,7,22,3,0
163878,2,6,10,-4,5,1
349363,4,30,42,-12,2,1
27865,1,0,0,0,13,0
258692,2,0,14,-14,13,0
250322,2,7,7,0,9,0
393902,4,20,20,0,5,1
229467,4,13,9,4,17,1
263226,4,17,20,-3,15,1
326488,2,24,9,15,9,1
228079,3,3,10,-7,17,1
186411,1,3,0,3,15,0
261459,1,0,0,0,14,1
279670,2,17,0,17,5,0
409393,2,13,3,10,12,0
17935,1,7,13,-6,9,0
33381,2,13,10,3,16,0
350424,1,0,3,-3,2,0
241210,1,0,0,0,5,1
420006,2,3,7,-4,17,1
346563,4,24,47,-23,1,1
13677,1,0,0,0,7,1
305488,1,0,0,0,17,0
414272,3,21,21,0,14,1
359796,4,30,32,-2,6,0
132285,3,24,7,17,9,1
416823,4,19,10,9,15,0
300507,3,23,17,6,14,1
397087,4,24,22,2,6,1
159264,3,17,24,-7,3,0
166832,1,0,3,-3,6,0
246350,3,17,10,7,7,0
409628,1,0,0,0,12,0
107927,2,6,3,3,15,0
172245,3,14,13,1,9,1
209924,4,37,16,21,8,0
171790,3,23,14,9,9,0
104533,4,14,38,-24,13,1
249957,1,0,0,0,9,0
72341,2,0,14,-14,16,0
2527,2,9,0,9,2,1
50077,2,0,7,-7,6,0
253812,1,7,0,7,11,0
332298,2,3,6,-3,12,1
195417,4,24,3,21,2,1
181111,3,24,7,17,13,0
214669,4,17,19,-2,11,1
151901,2,13,7,6,17,1
154211,4,10,20,-10,1,0
279027,4,13,33,-20,5,0
190182,1,0,0,0,17,1
248446,2,10,6,4,8,0
21091,2,0,0,0,10,0
299169,4,10,16,-6,14,0
397892,2,7,3,4,7,0
150250,1,0,0,0,16,1
374462,4,32,7,25,14,1
161239,2,13,3,10,4,1
29514,1,0,0,0,14,1
228976,3,14,9,5,17,0
356791,2,0,0,0,5,0
366726,3,24,10,14,10,0
65907,3,14,14,0,13,1
95687,3,10,6,4,10,1
165585,4,3,35,-32,6,1
109472,4,9,13,-4,16,1
296069,4,9,7,2,13,0
335222,4,43,20,23,13,0
332214,4,10,16,-6,12,1
58721,2,10,17,-7,10,0
269801,2,10,7,3,1,1
328175,3,14,14,0,10,0
56531,2,13,0,13,9,0
229719,3,13,17,-4,17,1
409811,2,10,0,10,12,0
115823,1,0,3,-3,1,1
136368,1,0,0,0,11,0
167564,4,3,17,-14,7,1
160559,4,23,17,6,4,0
170865,2,7,0,7,8,0
45765,3,10,14,-4,4,1
76035,2,10,13,-3,1,0
23798,3,17,0,17,12,0
44628,4,20,24,-4,3,1
322148,1,0,14,-14,7,1
202590,2,21,13,8,5,1
195425,4,24,3,21,2,0
87596,4,17,10,7,6,0
310536,4,26,9,17,2,0
134482,3,3,23,-20,10,0
72648,3,13,3,10,16,1
395060,3,0,17,-17,5,0
364403,2,35,7,28,9,0
229737,3,13,17,-4,17,1
92040,4,27,26,1,8,0
205008,2,9,7,2,6,0
320469,4,17,17,0,6,1
99985,4,17,19,-2,12,0
53428,3,3,28,-25,8,1
21915,4,35,9,26,11,1
418117,2,14,0,14,16,0
108785,1,0,7,-7,15,0
128955,2,25,3,22,7,1
399203,2,13,13,0,7,1
85390,4,31,10,21,5,1
177867,3,21,16,5,12,1
301199,3,20,14,6,15,0
221174,4,0,23,-23,14,1
379509,4,26,10,16,16,0
252436,2,0,0,0,10,0
246689,4,38,3,35,8,0
273773,2,7,7,0,2,0
204832,1,3,0,3,6,0
36669,3,20,3,17,17,0
364795,1,0,0,0,9,1
46034,2,14,14,0,4,0
251113,3,10,14,-4,10,1
145886,1,0,0,0,15,1
20591,1,0,0,0,10,0
115390,2,20,0,20,1,0
6014,4,17,36,-19,3,0
211790,2,0,7,-7,9,1
404775,2,10,12,-2,10,0
396177,4,24,31,-7,6,1
382275,3,17,3,14,17,1
173932,3,13,19,-6,10,0
401687,2,3,14,-11,8,0
320447,3,17,10,7,6,1
332757,3,21,9,12,12,1
82666,4,12,10,2,3,0
28441,4,13,6,7,14,0
248288,2,17,0,17,8,0
85120,1,0,3,-3,4,0
279423,3,16,24,-8,5,0
106834,4,34,37,-3,14,1
297220,2,0,6,-6,13,1
368167,3,13,21,-8,11,1
173456,2,0,7,-7,10,0
249516,2,14,3,11,9,1
340513,3,0,34,-34,15,0
22037,4,17,17,0,11,0
334924,4,30,10,20,13,0
174069,3,0,33,-33,10,1
262872,2,7,20,-13,15,0
49362,3,7,10,-3,6,0
164996,1,0,3,-3,6,1
339316,4,38,7,31,15,1
393146,4,24,3,21,4,1
73209,2,7,6,1,16,1
101100,3,10,10,0,12,0
345335,1,0,0,0,17,1
201923,1,0,0,0,5,0
44357,1,0,0,0,3,1
394860,2,0,14,-14,5,1
335757,4,10,7,3,13,1
374958,1,7,6,1,14,1
421483,1,0,0,0,17,0
301030,2,10,3,7,15,1
171730,1,3,0,3,9,0
119056,1,0,0,0,3,0
184160,4,16,17,-1,14,1
161138,3,3,26,-23,4,0
327287,3,16,20,-4,9,1
374719,3,0,33,-33,14,0
176224,4,14,24,-10,11,0
399872,1,0,0,0,8,0
326280,1,0,0,0,9,0
180970,3,24,21,3,13,0
389308,1,0,6,-6,3,1
356129,2,7,0,7,5,1
194135,2,3,0,3,1,0
349214,4,27,21,6,2,1
421200,1,3,0,3,17,1
219436,1,0,0,0,13,0
358488,4,41,27,14,6,0
114757,1,0,3,-3,1,0
10497,2,13,0,13,5,0
34510,1,0,0,0,16,0
254655,4,31,21,10,11,0
393738,3,7,7,0,5,0
204897,3,3,13,-10,6,1
374979,2,14,20,-6,14,1
71861,2,9,0,9,16,1
303995,1,0,7,-7,16,1
184125,3,16,14,2,14,0
24808,2,6,3,3,12,1
235293,4,25,6,19,3,0
235842,2,0,14,-14,3,1
277455,4,41,25,16,4,0
211419,1,0,0,0,9,1
147199,1,0,7,-7,15,1
377725,3,32,7,25,15,0
158479,2,3,7,-4,3,1
71029,2,17,0,17,16,1
66321,2,0,14,-14,14,0
242342,3,26,13,13,6,1
376322,1,3,0,3,14,1
200348,4,30,14,16,4,1
50036,4,28,17,11,6,1
370900,3,13,10,3,12,0
306784,4,16,33,-17,17,1
299300,3,26,7,19,14,0
315860,4,9,19,-10,4,1
299458,3,7,20,-13,14,1
162632,2,3,10,-7,5,1
177740,3,13,17,-4,12,1
167820,1,0,13,-13,7,1
49596,1,0,0,0,6,0
176441,1,0,6,-6,11,0
156539,4,14,6,8,2,0
320084,2,10,0,10,6,0
185765,3,23,3,20,15,1
267697,3,14,24,-10,17,0
37335,2,7,0,7,17,1
211530,3,36,14,22,9,0
161740,2,17,6,11,4,0
233810,4,19,37,-18,2,1
57236,4,20,14,6,10,0
60620,1,0,3,-3,11,0
181210,2,0,0,0,13,1
20817,2,14,3,11,10,0
253403,2,14,28,-14,11,1
82116,1,0,0,0,3,0
191152,4,28,27,1,17,0
292119,1,14,0,14,11,0
340794,3,17,16,1,15,1
359895,3,20,24,-4,6,1
347646,3,17,10,7,1,1
325034,3,20,24,-4,8,1
369558,3,14,0,14,11,1
338430,4,30,24,6,14,0
22385,1,0,3,-3,11,0
244978,2,0,20,-20,7,1
349645,4,13,31,-18,2,1
252293,2,0,13,-13,10,0
104659,4,7,3,4,14,1
326117,4,30,3,27,9,0
22639,3,23,10,13,11,0
311298,1,0,0,0,2,1
352720,4,23,6,17,3,1
251988,2,7,13,-6,10,0
246339,3,14,10,4,7,0
4665,3,13,13,0,2,1
123016,3,0,13,-13,4,1
307871,4,27,42,-15,1,1
104,3,7,7,0,1,0
359961,4,30,30,0,6,1
73117,4,13,10,3,16,0
145900,2,0,0,0,15,1
380327,1,7,0,7,16,0
101219,2,7,7,0,12,0
116695,2,6,3,3,2,1
180616,2,7,6,1,13,1
295734,4,10,16,-6,12,1
374216,1,0,0,0,13,1
60795,2,10,3,7,11,1
127842,4,23,42,-19,6,0
210557,1,6,7,-1,9,0
42037,2,13,7,6,2,0
342669,1,0,0,0,16,1
341492,2,0,7,-7,16,1
275404,1,6,7,-1,3,1
253605,4,9,17,-8,11,1
84462,3,13,10,3,4,0
4198,2,10,6,4,2,0
19225,4,28,19,9,10,0
193604,4,0,17,-17,1,0
330032,1,0,0,0,11,0
341210,2,13,7,6,16,1
34880,3,20,7,13,16,0
27022,2,10,0,10,13,0
3502,4,10,30,-20,2,1
170479,4,21,10,11,8,1
185707,2,17,3,14,15,0
23523,4,17,17,0,11,0
212211,4,3,24,-21,10,1
134588,2,17,3,14,10,0
420717,1,0,0,0,17,0
278952,2,7,23,-16,5,0
5275,4,24,31,-7,3,0
176734,4,39,19,20,11,0
240489,3,3,7,-4,5,0
92866,3,24,0,24,8,0
152211,2,14,0,14,17,1
246188,2,14,3,11,7,0
421620,1,3,0,3,17,0
207385,1,0,0,0,7,1
268164,3,9,14,-5,17,0
48817,1,3,0,3,5,0
394213,4,33,17,16,5,0
128001,4,23,33,-10,6,1
414475,4,16,23,-7,14,1
295236,2,14,5,9,12,0
366845,2,3,3,0,10,0
7750,3,27,3,24,4,1
136580,2,9,13,-4,11,1
235189,1,2,0,2,3,1
325092,4,39,38,1,8,1
201925,1,0,0,0,5,0
87114,2,7,3,4,5,0
220135,3,26,13,13,13,0
288682,2,0,7,-7,9,0
364063,1,0,0,0,9,0
103864,4,26,0,26,13,0
300512,3,23,17,6,14,0
45032,3,20,10,10,4,0
123201,3,6,21,-15,4,0
275228,4,17,29,-12,3,1
182592,2,0,3,-3,14,0
302836,3,9,23,-14,15,1
132082,1,7,0,7,9,0
329256,4,30,13,17,10,1
252504,3,16,25,-9,10,1
314155,1,7,7,0,3,0
120144,3,10,6,4,3,0
160045,3,13,26,-13,3,0
44222,1,7,10,-3,3,1
277767,4,17,6,11,4,0
236612,1,0,0,0,3,0
18723,2,3,7,-4,9,1
187631,1,0,0,0,16,0
249327,1,10,0,10,9,0
17980,2,13,21,-8,9,1
48720,3,10,19,-9,5,0
126453,1,0,3,-3,6,1
291640,4,23,13,10,11,0
80113,4,24,22,2,2,0
110731,2,3,3,0,16,1
274876,2,7,13,-6,3,0
387168,4,10,41,-31,2,1
416656,3,31,7,24,15,1
51789,4,10,19,-9,7,0
121715,3,21,14,7,4,0
337243,4,16,23,-7,14,1
186928,2,7,6,1,15,1
49239,3,17,10,7,6,1
11491,2,6,7,-1,6,0
222330,2,14,3,11,14,0
321431,2,14,17,-3,7,0
364029,4,6,18,-12,8,1
40403,1,0,7,-7,2,1
165150,5,24,24,0,6,1
168646,4,17,16,1,7,1
36688,4,20,9,11,17,0
165656,2,0,7,-7,6,0
100713,4,21,24,-3,12,1
16815,3,19,24,-5,8,1
290194,2,10,0,10,10,0
265919,2,0,16,-16,16,0
121315,1,0,0,0,3,1
75461,3,31,7,24,17,1
265248,3,9,6,3,16,0
348467,1,7,0,7,2,0
247675,1,7,3,4,8,0
241216,1,0,0,0,5,1
236204,4,20,16,4,3,0
300167,3,21,3,18,14,0
230049,4,19,6,13,17,0
160816,3,20,10,10,4,0
153224,1,2,0,2,1,0
108144,4,13,42,-29,15,1
241213,1,0,0,0,5,0
301293,1,14,0,14,15,1
183281,3,16,20,-4,14,1
321787,4,18,9,9,7,1
70387,1,0,0,0,15,0
399832,4,17,27,-10,8,1
231236,4,10,16,-6,1,0
174791,2,13,7,6,10,0
141674,2,23,14,9,13,0
414199,1,0,0,0,14,0
87608,4,17,10,7,6,1
416066,4,21,6,15,15,0
303776,3,20,10,10,16,0
377579,3,17,12,5,15,1
206975,1,20,0,20,7,1
330632,1,0,0,0,11,0
329454,1,0,0,0,10,1
37866,1,0,0,0,1,1
180185,3,13,7,6,13,1
381227,2,14,10,4,16,0
188107,2,0,10,-10,16,1
248678,4,31,10,21,9,0
256682,1,0,0,0,12,0
343926,2,7,0,7,17,1
111854,4,6,10,-4,17,1
326704,4,23,13,10,9,0
177471,4,27,10,17,11,0
299142,3,3,16,-13,14,1
144511,1,0,7,-7,14,0
136641,4,15,19,-4,11,0
420153,2,0,3,-3,17,0
260438,1,0,0,0,14,1
108489,2,7,7,0,15,0
248652,4,23,10,13,9,1
53540,2,14,6,8,8,0
368097,1,7,0,7,11,0
53059,1,10,6,4,7,0
366136,2,7,28,-21,10,1
285100,3,3,0,3,7,0
93090,5,20,20,0,8,1
384030,4,20,23,-3,1,0
83930,1,0,0,0,4,0
418148,3,21,3,18,16,1
356404,4,31,20,11,5,1
361193,2,0,10,-10,7,1
75794,4,42,26,16,1,1
335785,4,24,14,10,13,0
245043,4,14,27,-13,7,1
169344,2,3,14,-11,8,1
97149,4,34,13,21,10,1
242252,1,0,0,0,6,0
136194,4,13,10,3,10,1
63575,2,13,7,6,12,0
156338,2,24,0,24,2,0
188450,4,3,6,-3,16,0
228285,1,0,0,0,17,1
167249,4,30,17,13,7,0
417264,4,20,23,-3,16,1
94352,3,17,7,10,9,0
163356,4,22,26,-4,5,1
369561,3,14,0,14,11,1
350516,4,17,19,-2,2,0
363877,4,13,29,-16,8,1
365399,2,7,6,1,9,0
379210,3,9,13,-4,16,1
99157,2,3,3,0,11,1
184595,1,7,0,7,15,0
232151,1,6,0,6,1,0
153892,3,7,3,4,1,0
86867,3,9,23,-14,5,0
349929,4,3,12,-9,2,1
403256,1,0,0,0,9,1
308440,3,7,25,-18,1,1
220145,3,26,13,13,13,1
81903,3,7,30,-23,3,0
301978,4,20,20,0,15,1
165840,3,6,16,-10,6,1
75824,4,42,33,9,1,0
99066,3,22,0,22,11,1
410988,1,7,7,0,13,0
224388,1,0,0,0,15,1
160603,1,7,0,7,4,0
214206,1,0,0,0,11,0
307420,1,7,0,7,17,0
294906,1,0,7,-7,12,1
248038,3,31,13,18,8,0
55582,3,24,7,17,9,1
42471,2,0,5,-5,3,0
324780,4,32,14,18,8,1
44424,2,3,0,3,3,1
183814,2,17,21,-4,14,1
51371,4,22,20,2,7,0
28591,4,33,7,26,14,1
127542,4,3,26,-23,6,1
3287,2,3,3,0,2,1
115112,2,3,20,-17,1,1
183212,2,7,0,7,14,0
312555,3,37,0,37,3,0
164961,4,10,16,-6,6,0
124582,3,6,17,-11,5,0
363494,1,0,2,-2,8,1
259469,3,21,10,11,13,1
113808,4,13,24,-11,17,1
278204,3,24,21,3,4,1
250237,4,27,23,4,9,1
171955,3,14,14,0,9,0
371637,4,17,17,0,12,1
416247,4,10,39,-29,15,1
86973,2,14,3,11,5,0
110736,2,3,3,0,16,0
224905,2,0,6,-6,15,0
97575,4,37,7,30,10,1
176641,2,14,12,2,11,0
384644,4,10,59,-49,1,0
214043,4,43,14,29,10,0
133214,4,20,17,3,9,0
116878,2,7,7,0,2,1
297991,3,30,7,23,13,0
143674,3,19,10,9,14,0
351933,2,14,7,7,3,0
71527,4,33,14,19,16,1
397116,1,3,0,3,6,0
128486,2,21,21,0,7,1
114624,2,3,3,0,1,1
246694,4,38,10,28,8,1
50470,4,17,10,7,6,0
235268,3,15,6,9,3,1
138221,4,10,12,-2,11,1
266888,1,0,0,0,17,0
102780,2,10,3,7,13,1
372930,3,22,7,15,13,1
24702,3,20,14,6,12,0
141010,2,7,0,7,13,1
53656,1,0,0,0,8,0
231445,2,10,6,4,1,1
48476,4,27,33,-6,5,0
366262,2,14,10,4,10,0
56475,4,7,41,-34,9,0
57073,4,7,27,-20,9,1
228708,3,19,23,-4,17,0
100360,3,9,20,-11,12,1
42314,1,0,9,-9,2,1
297940,2,17,7,10,13,1
276307,2,7,13,-6,3,0
292155,2,21,0,21,11,0
38960,2,23,3,20,1,1
247421,2,9,9,0,8,1
41450,2,2,7,-5,2,1
168263,2,7,7,0,7,1
17752,4,24,19,5,9,0
315119,4,56,14,42,4,1
316229,2,0,10,-10,4,1
357205,1,0,0,0,5,0
187655,2,7,3,4,16,0
41236,4,10,13,-3,2,1
124105,2,3,21,-18,5,1
391543,2,10,21,-11,4,1
294837,3,35,21,14,12,0
371166,2,3,19,-16,12,1
47196,3,9,3,6,5,0
323902,1,0,0,0,8,1
83778,1,0,0,0,4,1
112357,1,3,0,3,17,1
199246,3,17,21,-4,4,0
2135,4,10,16,-6,1,1
130918,2,0,14,-14,8,1
364359,1,7,0,7,9,0
111241,3,10,3,7,16,0
319647,2,24,3,21,6,0
297107,3,24,0,24,13,1
304883,1,0,0,0,16,0
170997,1,7,7,0,8,0
92167,4,3,37,-34,8,1
247897,3,10,6,4,8,1
91241,4,20,17,3,8,1
246834,4,10,20,-10,8,1
308534,2,0,9,-9,1,1
130412,4,7,6,1,8,1
305836,2,0,14,-14,17,0
254700,1,3,0,3,11,0
339899,3,26,0,26,15,1
151290,1,7,7,0,17,0
180373,4,15,14,1,13,1
294497,2,10,10,0,12,1
389778,2,10,6,4,3,1
295479,1,0,0,0,12,1
415513,1,0,0,0,15,0
140619,3,31,10,21,12,1
104986,4,17,22,-5,14,0
224848,1,0,0,0,15,0
37160,1,0,0,0,17,0
216282,1,0,0,0,12,0
334617,4,38,31,7,13,0
176239,4,14,27,-13,11,1
246027,2,7,6,1,7,0
131177,1,0,0,0,8,0
364119,2,14,3,11,9,1
141329,2,3,7,-4,13,0
126113,4,30,9,21,6,0
133526,4,30,20,10,9,1
99105,4,23,7,16,11,0
85487,2,14,3,11,5,0
135551,3,14,6,8,10,1
56537,2,13,7,6,9,1
156112,1,7,7,0,2,1
92069,1,3,7,-4,8,0
163102,2,13,12,1,5,0
310951,3,3,23,-20,2,1
244533,3,25,13,12,7,1
141408,4,10,20,-10,13,0
379302,2,0,6,-6,16,1
111881,4,16,10,6,17,1
252586,1,0,0,0,10,0
204581,2,0,38,-38,6,1
374363,1,7,0,7,14,0
73870,4,13,7,6,17,0
132722,3,10,17,-7,9,0
337809,3,29,6,23,14,1
227201,4,13,17,-4,16,1
57062,3,7,20,-13,9,1
411770,3,0,20,-20,13,1
384066,1,0,0,0,1,0
69496,4,31,24,7,15,0
39644,4,30,6,24,1,0
148916,2,3,9,-6,16,0
314733,1,14,0,14,4,1
146551,3,14,17,-3,15,0
174971,2,6,14,-8,10,0
366082,1,0,0,0,10,0
15791,3,0,12,-12,8,1
283408,2,13,7,6,7,1
209501,1,7,3,4,8,1
171500,3,17,10,7,9,1
5957,3,17,23,-6,3,1
297851,3,20,16,4,13,1
287688,4,9,13,-4,9,0
113868,2,7,3,4,17,1
407757,3,10,7,3,11,1
187354,2,14,7,7,16,0
110132,2,7,10,-3,16,1
377817,2,7,0,7,15,1
344469,1,0,0,0,17,0
318156,3,16,10,6,5,0
339805,4,24,13,11,15,0
25869,3,24,17,7,12,1
199455,4,22,17,5,4,1
402087,1,3,0,3,9,1
57374,3,14,3,11,10,1
310296,2,23,0,23,2,1
235762,4,13,27,-14,3,1
328375,4,3,40,-37,10,1
362016,1,0,0,0,8,1
294212,2,0,7,-7,12,1
233304,3,7,20,-13,2,1
180172,3,10,0,10,13,1
24689,3,20,7,13,12,0
321339,4,22,19,3,6,0
357210,1,0,0,0,5,0
194136,2,3,0,3,1,0
5541,3,16,10,6,3,0
416072,4,21,6,15,15,0
168503,4,10,30,-20,7,1
187263,3,10,6,4,16,1
47524,2,29,6,23,5,1
15967,3,12,14,-2,8,0
321436,2,14,20,-6,7,1
393598,3,7,26,-19,5,1
285027,1,0,0,0,7,1
270313,4,17,27,-10,1,1
155141,4,19,33,-14,1,0
391914,4,23,27,-4,4,1
316555,2,3,3,0,4,0
225970,3,34,20,14,16,0
260526,3,27,0,27,14,1
51293,2,6,9,-3,7,0
259895,2,14,10,4,14,0
225292,1,0,7,-7,15,0
249889,3,12,20,-8,9,0
380467,1,0,0,0,16,0
74345,1,7,3,4,17,0
124151,4,19,21,-2,5,1
155448,4,13,10,3,2,1
252521,4,17,25,-8,10,0
384524,1,0,14,-14,1,1
14307,2,2,7,-5,7,1
196695,2,33,0,33,3,1
177649,1,0,0,0,12,1
232854,4,16,17,-1,2,1
45397,1,7,0,7,4,0
264905,2,17,14,3,16,1
60991,3,33,16,17,11,1
136660,4,22,19,3,11,1
207466,3,20,14,6,7,1
418056,4,28,35,-7,16,1
418123,2,14,3,11,16,0
227715,2,0,0,0,16,1
227830,4,6,35,-29,16,1
382619,1,0,0,0,17,0
332159,2,0,10,-10,12,0
370470,3,13,9,4,12,1
410214,1,7,0,7,13,0
397379,1,0,0,0,6,0
225458,2,0,7,-7,15,1
143816,3,6,7,-1,14,1
155902,4,17,13,4,2,0
348409,4,13,20,-7,1,1
144711,2,3,0,3,14,1
34946,4,27,27,0,16,1
1936,2,0,0,0,1,1
330776,1,0,0,0,11,0
217538,1,0,0,0,12,1
302908,1,13,0,13,16,0
251542,3,16,13,3,10,0
413977,2,3,14,-11,14,0
365013,3,17,6,11,9,0
153439,3,20,17,3,1,0
11301,4,17,28,-11,6,0
392985,4,12,10,2,4,1
275123,1,7,3,4,3,0
110275,2,0,10,-10,16,0
250577,1,0,0,0,10,0
65373,4,13,28,-15,13,0
360575,2,7,10,-3,7,0
298858,4,21,9,12,14,0
60842,3,17,16,1,11,0
394388,4,31,17,14,5,0
361063,3,16,9,7,7,1
404,3,31,17,14,1,0
283034,4,28,3,25,6,0
127836,4,17,42,-25,6,1
328781,3,17,13,4,10,1
145989,4,13,21,-8,15,1
332127,1,0,0,0,12,0
10193,2,6,3,3,5,1
11061,2,10,7,3,5,1
15498,3,16,6,10,8,1
156598,2,0,0,0,2,0
193482,4,30,20,10,1,1
281679,3,24,17,7,6,1
169991,3,21,10,11,8,1
384995,3,17,9,8,1,1
91089,4,9,0,9,7,0
401227,2,7,7,0,8,1
374916,4,14,25,-11,14,0
233005,3,17,10,7,2,0
256790,4,13,13,0,12,1
33551,3,17,3,14,16,1
242794,4,14,31,-17,6,0
108791,1,0,7,-7,15,0
257496,2,9,3,6,13,0
142421,1,7,10,-3,13,1
371935,4,34,17,17,12,1
312914,4,21,24,-3,3,1
38859,4,3,13,-10,1,1
148930,2,3,9,-6,16,1
188523,2,3,3,0,16,0
286440,3,17,3,14,8,0
209678,2,6,0,6,8,1
398246,4,35,17,18,7,0
249314,1,3,0,3,9,1
324457,4,17,6,11,8,1
259040,4,3,16,-13,13,0
217151,3,3,9,-6,12,0
403572,2,17,7,10,9,1
121394,4,7,6,1,3,0
34956,4,27,27,0,16,1
4499,2,14,19,-5,2,1
203308,2,0,24,-24,6,1
202673,1,0,0,0,5,0
208498,3,44,7,37,8,0
47931,1,0,7,-7,5,1
107516,4,3,23,-20,15,1
281764,1,0,0,0,6,1
359894,3,20,24,-4,6,1
184418,4,24,6,18,14,0
103715,4,3,17,-14,13,0
268271,2,10,0,10,17,0
311855,1,0,0,0,2,1
124164,4,19,21,-2,5,1
8757,2,0,0,0,4,1
227199,4,13,17,-4,16,1
346918,1,0,0,0,1,0
330117,3,0,13,-13,11,0
141333,2,3,7,-4,13,0
238340,2,3,16,-13,4,1
49464,1,0,0,0,6,0
48215,1,0,3,-3,5,1
370213,4,31,10,21,12,1
14980,1,0,0,0,7,0
96866,2,10,0,10,10,0
220416,3,23,14,9,13,1
206122,3,20,6,14,7,0
62349,4,24,22,2,12,1
313242,1,0,0,0,3,1
150811,4,20,9,11,17,1
358530,1,10,3,7,6,0
420638,2,13,16,-3,17,1
66997,1,0,0,0,14,1
181518,1,3,0,3,13,1
285518,1,0,0,0,8,0
26924,3,13,6,7,13,0
151706,1,0,0,0,17,1
148666,4,10,9,1,16,0
2122,3,10,13,-3,1,1
94102,1,0,0,0,9,1
181387,2,17,7,10,13,0
374350,4,28,13,15,13,1
101302,4,17,20,-3,12,0
26086,1,0,10,-10,13,1
157175,4,25,20,5,2,0
296216,4,16,26,-10,13,1
406619,1,0,0,0,11,0
360693,1,0,7,-7,7,1
111772,1,3,7,-4,17,0
234736,1,0,0,0,2,0
401345,1,0,0,0,8,1
157380,2,3,7,-4,2,1
346713,3,24,13,11,1,1
29443,3,7,14,-7,14,0
261250,3,28,0,28,14,1
364834,2,3,14,-11,9,1
256307,4,14,17,-3,12,1
231983,1,0,0,0,1,0
289853,1,0,3,-3,10,1
82557,4,17,27,-10,3,1
220013,4,16,35,-19,13,0
96960,4,22,10,12,10,0
15346,2,7,6,1,8,1
371126,1,0,6,-6,12,0
8693,4,10,10,0,4,1
215852,1,0,0,0,11,1
180061,4,28,20,8,13,1
211372,4,10,10,0,9,0
211609,1,0,3,-3,9,1
198626,2,0,14,-14,3,1
415713,2,13,10,3,15,1
273350,3,28,0,28,2,1
260194,2,10,0,10,14,0
380794,2,9,21,-12,16,1
418999,2,7,7,0,16,0
217948,1,0,0,0,12,0
188677,1,0,7,-7,16,0
277579,3,6,14,-8,4,1
143902,1,0,0,0,14,0
245,3,12,17,-5,1,0
275278,2,10,2,8,3,1
153495,1,0,0,0,1,1
20425,1,0,0,0,10,1
1462,1,0,0,0,1,0
306763,3,16,20,-4,17,0
224236,1,6,0,6,15,0
78629,4,30,13,17,2,1
139748,4,14,21,-7,12,1
60578,4,30,41,-11,11,1
16781,2,3,14,-11,8,0
381094,3,24,14,10,16,0
351573,4,0,27,-27,3,0
288911,4,19,31,-12,9,1
118771,1,10,0,10,2,0
18267,2,7,17,-10,9,1
112179,4,20,34,-14,17,1
42195,2,7,0,7,2,1
303871,1,0,7,-7,16,0
262561,1,7,0,7,15,1
317926,1,7,3,4,5,1
138529,4,31,30,1,12,0
129260,3,17,13,4,7,0
189016,2,7,7,0,16,0
21548,2,7,7,0,11,1
341600,4,26,17,9,16,0
69534,1,0,0,0,15,1
258198,4,20,20,0,13,1
312834,2,7,0,7,3,0
182932,2,7,37,-30,14,1
305432,3,20,3,17,17,0
199510,2,17,0,17,4,1
81415,3,10,10,0,3,0
88721,1,3,0,3,6,1
294705,3,6,14,-8,12,0
76877,1,0,3,-3,1,1
86592,3,33,3,30,5,0
115910,4,13,23,-10,1,0
388951,3,17,20,-3,3,0
348187,2,6,10,-4,1,1
128005,4,23,33,-10,6,1
247162,4,20,6,14,8,0
213990,3,29,7,22,10,1
55922,1,0,0,0,9,0
104760,2,17,16,1,14,1
254743,2,3,3,0,11,0
197890,3,11,7,4,3,1
170766,4,24,6,18,8,1
163759,3,6,12,-6,5,1
56368,1,0,0,0,9,1
390672,2,3,3,0,3,0
71716,2,10,13,-3,16,0
338762,1,0,0,0,15,0
119167,4,10,7,3,3,1
401359,1,10,0,10,8,1
376328,1,3,0,3,14,1
234032,2,14,0,14,2,1
230313,3,19,10,9,17,1
37941,3,10,14,-4,1,0
263068,4,10,6,4,15,0
224954,4,3,16,-13,15,1
228334,2,0,14,-14,17,1
166990,1,0,7,-7,7,0
44104,2,0,13,-13,3,0
407822,1,3,0,3,11,0
172612,4,24,24,0,9,0
30389,1,0,13,-13,14,1
281941,2,7,14,-7,6,1
142111,2,0,7,-7,13,1
413455,4,17,38,-21,14,0
116494,4,6,19,-13,1,0
356642,1,7,3,4,5,0
161657,4,39,16,23,4,0
404545,4,34,27,7,10,0
173300,2,14,17,-3,10,1
157108,3,10,14,-4,2,1
267229,2,10,14,-4,17,1
31194,3,23,27,-4,15,1
124186,4,22,27,-5,5,1
106735,2,14,12,2,14,0
350702,1,7,0,7,2,1
291249,2,7,12,-5,10,1
46330,2,3,17,-14,4,1
294413,4,19,9,10,12,0
155392,2,13,3,10,2,1
130507,3,10,3,7,8,0
280423,3,9,17,-8,5,1
87329,4,24,24,0,6,1
381617,1,0,0,0,17,1
119523,1,0,0,0,3,0
174365,3,17,3,14,10,1
326881,4,10,20,-10,9,1
360638,4,10,20,-10,7,0
132568,3,5,29,-24,9,0
267475,1,0,7,-7,17,1
52506,2,10,0,10,7,0
229196,1,0,0,0,17,0
44038,1,0,0,0,3,0
206742,4,7,24,-17,7,1
234503,3,20,20,0,2,0
376830,3,21,7,14,15,0
106894,2,9,3,6,14,1
265926,3,0,16,-16,16,0
165603,1,0,0,0,6,0
185047,1,0,3,-3,15,0
81369,2,0,7,-7,3,1
348686,2,10,10,0,2,0
332123,1,0,0,0,12,1
112325,4,45,17,28,17,1
322653,4,6,9,-3,7,1
391789,4,10,16,-6,4,1
386484,2,7,0,7,2,1
294395,3,16,9,7,12,1
295319,4,14,5,9,12,0
314046,2,6,7,-1,3,1
381889,4,35,28,7,17,0
378292,2,3,3,0,15,0
128233,3,20,7,13,7,0
216209,3,14,3,11,12,1
116624,4,13,3,10,2,1
285143,4,3,0,3,7,1
6254,3,13,14,-1,3,1
343746,1,7,0,7,17,1
92064,1,3,7,-4,8,1
271967,4,23,27,-4,2,0
86601,4,40,3,37,5,0
27654,3,7,27,-20,13,0
407200,1,0,0,0,11,0
258311,4,28,19,9,13,0
305957,1,0,0,0,17,0
131437,4,7,19,-12,8,1
126792,1,0,3,-3,6,0
295254,3,14,5,9,12,0
228118,4,20,10,10,17,0
412027,2,7,0,7,13,1
91767,2,3,0,3,8,0
7239,2,0,13,-13,4,1
194191,3,6,17,-11,1,0
204442,3,7,17,-10,6,1
181446,4,24,24,0,13,0
95132,3,9,17,-8,9,1
297190,2,0,0,0,13,0
181888,3,21,28,-7,13,1
59088,3,3,23,-20,10,0
218858,2,14,3,11,13,0
285279,3,14,6,8,7,0
90091,1,0,0,0,7,1
57091,4,21,27,-6,9,0
139866,4,20,17,3,12,0
410105,2,14,7,7,13,1
204011,4,16,7,9,6,0
391558,2,10,21,-11,4,1
178450,1,7,3,4,12,0
316107,2,24,13,11,4,0
71330,3,10,20,-10,16,1
166830,1,0,0,0,6,0
338426,4,30,24,6,14,1
419144,2,10,3,7,16,1
109152,3,31,7,24,15,1
362410,4,30,20,10,8,1
349509,4,12,20,-8,2,0
249619,4,28,23,5,9,1
103149,1,0,0,0,13,1
28767,1,0,0,0,14,1
76653,3,10,0,10,1,1
192189,4,3,20,-17,1,1
263043,3,10,3,7,15,0
222986,4,13,13,0,14,0
297883,4,21,27,-6,13,0
401898,4,17,28,-11,9,1
222925,2,13,6,7,14,0
383897,4,3,10,-7,1,0
380037,2,21,14,7,16,0
99024,2,6,0,6,11,0
53709,3,7,0,7,8,0
10907,2,6,7,-1,5,0
241470,4,10,42,-32,5,1
408172,2,6,0,6,12,1
160631,2,7,0,7,4,1
276901,1,7,0,7,4,1
368668,1,0,10,-10,11,1
282869,4,9,23,-14,6,1
246,3,12,17,-5,1,0
115576,3,24,9,15,1,1
113752,3,3,17,-14,17,0
206872,3,3,17,-14,7,1
192037,4,24,27,-3,1,1
194410,1,3,0,3,2,1
269130,4,16,16,0,17,1
215626,3,14,6,8,11,0
125476,3,16,0,16,5,0
288618,4,23,41,-18,9,0
408456,2,7,3,4,12,0
331439,2,6,7,-1,11,1
272282,4,12,10,2,2,1
251579,4,16,20,-4,10,1
142889,2,0,3,-3,13,1
214617,3,3,16,-13,11,0
16465,2,3,0,3,8,0
155739,4,20,20,0,2,0
120523,1,0,6,-6,3,0
313560,2,3,16,-13,3,0
307082,4,24,6,18,17,0
151128,1,0,0,0,17,1
52566,4,19,10,9,7,1
160994,3,10,7,3,4,1
347244,1,0,0,0,1,1
276635,2,14,6,8,4,1
333461,1,3,0,3,12,0
74549,3,0,3,-3,17,1
4722,1,7,0,7,3,0
383616,1,0,0,0,17,0
346056,3,3,6,-3,1,1
293691,4,10,10,0,12,0
40009,2,14,7,7,1,0
240714,1,0,0,0,5,1
176406,4,22,28,-6,11,1
372954,4,25,7,18,13,0
26933,4,13,6,7,13,0
406289,4,27,35,-8,11,0
397692,1,3,0,3,7,1
415988,1,7,0,7,15,1
198735,1,3,0,3,3,0
16771,2,3,14,-11,8,1
187069,2,10,0,10,16,1
199802,2,3,3,0,4,1
110044,4,48,10,38,16,0
327796,1,0,3,-3,10,0
171799,3,23,14,9,9,1
389818,3,24,6,18,3,0
243868,2,13,3,10,6,0
168588,3,14,10,4,7,0
199176,1,0,0,0,4,1
153284,3,2,7,-5,1,0
68433,4,3,21,-18,14,1
370509,4,27,9,18,12,0
372306,3,17,10,7,13,0
94413,4,17,24,-7,9,0
293806,3,17,6,11,12,1
420402,4,20,20,0,17,0
21692,2,10,7,3,11,0
140389,4,17,29,-12,12,1
124246,2,7,17,-10,5,1
167403,4,37,40,-3,7,1
175579,3,27,7,20,11,1
232996,3,10,10,0,2,1
126784,1,0,3,-3,6,1
158223,3,31,0,31,3,0
344011,4,23,6,17,17,1
319565,5,22,23,-1,6,0
266833,4,17,14,3,16,0
7450,3,20,6,14,4,0
254768,3,10,10,0,11,1
30829,1,0,14,-14,15,1
158550,4,10,17,-7,3,1
63020,3,9,21,-12,12,1
64112,1,0,0,0,13,1
267092,2,3,3,0,17,1
269230,3,3,6,-3,17,1
313718,2,14,3,11,3,1
33593,4,17,16,1,16,1
189994,4,16,7,9,17,0
161061,1,3,0,3,4,0
198115,1,0,3,-3,3,1
223604,1,6,0,6,15,0
78967,1,0,0,0,2,1
409730,4,10,6,4,12,1
266711,4,49,10,39,16,0
346717,4,24,13,11,1,1
254757,3,10,3,7,11,1
55580,3,24,7,17,9,1
129647,4,23,23,0,7,1
296111,1,0,0,0,13,1
196546,2,17,6,11,2,0
416473,3,21,10,11,15,0
94504,3,0,0,0,9,1
131376,2,7,13,-6,8,1
233194,4,43,18,25,2,0
99676,4,26,3,23,11,0
259414,1,3,3,0,13,0
32253,3,21,14,7,15,1
411382,4,20,13,7,13,1
80684,4,17,26,-9,3,0
108720,3,37,13,24,15,0
374244,1,7,0,7,13,0
40499,4,7,20,-13,2,1
214279,3,14,10,4,11,1
84266,2,6,14,-8,4,1
10133,1,0,0,0,5,0
251117,3,10,14,-4,10,0
17556,3,13,10,3,9,0
155396,3,13,3,10,2,0
267380,2,0,7,-7,17,0
333335,2,10,7,3,12,0
98396,2,0,7,-7,11,1
365625,4,35,27,8,9,0
146881,4,31,0,31,15,1
104993,4,17,22,-5,14,1
57852,4,22,17,5,10,1
59682,4,24,6,18,11,0
304424,1,0,0,0,16,0
73257,4,7,16,-9,16,1
254026,3,7,13,-6,11,1
197452,3,13,6,7,3,0
263218,4,17,17,0,15,0
226613,3,10,3,7,16,1
175409,3,17,6,11,11,0
390166,4,20,38,-18,3,1
51337,3,16,20,-4,7,1
10218,3,6,3,3,5,0
334698,2,15,3,12,13,0
376967,3,9,16,-7,15,0
337312,2,7,7,0,14,1
298195,1,0,3,-3,14,0
217663,4,26,23,3,12,0
187741,4,16,20,-4,16,1
320785,4,17,23,-6,6,0
34514,1,0,0,0,16,0
176552,4,19,17,2,11,0
317753,1,0,0,0,5,0
138463,3,21,14,7,12,1
274681,2,7,9,-2,3,1
6745,1,0,0,0,3,1
123192,3,6,21,-15,4,1
249852,2,6,17,-11,9,0
337986,4,23,0,23,14,0
359342,3,3,13,-10,6,0
211412,1,0,0,0,9,0
159481,1,0,0,0,3,1
186996,4,10,15,-5,15,1
251618,4,19,20,-1,10,1
80503,2,5,3,2,3,1
325555,1,0,0,0,9,1
380679,3,7,7,0,16,0
211968,2,0,10,-10,9,1
336195,4,24,10,14,13,0
396755,4,7,20,-13,6,0
318555,2,10,0,10,5,1
352274,3,3,6,-3,3,0
359147,2,7,0,7,6,1
29028,4,14,10,4,14,1
252908,2,6,0,6,11,1
323760,1,6,3,3,8,1
36494,2,10,6,4,17,0
249168,1,0,0,0,9,1
176018,2,17,0,17,11,0
171183,3,3,7,-4,8,0
363663,2,0,10,-10,8,1
47603,1,0,0,0,5,0
61027,4,34,16,18,11,0
299818,1,0,0,0,14,1
112667,1,3,0,3,17,1
292266,1,0,7,-7,11,1
355380,1,3,3,0,4,1
128788,2,10,13,-3,7,1
293841,4,24,19,5,12,1
26861,2,10,3,7,13,0
138627,2,3,7,-4,12,0
71590,2,3,14,-11,16,0
115708,3,10,3,7,1,0
244387,3,0,17,-17,7,0
364338,4,9,39,-30,9,0
373128,4,10,21,-11,13,0
150261,1,7,0,7,16,0
248392,1,9,0,9,8,1
180588,1,7,3,4,13,0
227923,3,27,20,7,16,1
320247,2,14,7,7,6,1
354207,2,13,10,3,4,0
283483,4,23,14,9,7,1
238778,2,7,0,7,4,1
313886,3,21,19,2,3,1
231628,3,14,13,1,1,1
222705,4,14,24,-10,14,0
336162,3,17,3,14,13,0
328307,2,3,14,-11,10,0
27579,1,7,0,7,13,0
365042,4,17,6,11,9,0
303884,2,0,14,-14,16,0
217717,2,7,0,7,12,0
283855,2,7,3,4,7,0
368117,2,7,7,0,11,0
326124,4,30,10,20,9,1
356194,3,19,0,19,5,1
184142,4,16,14,2,14,1
229638,4,46,13,33,17,0
135052,2,14,3,11,10,1
54487,2,7,7,0,8,1
356451,1,0,3,-3,5,0
231274,1,0,3,-3,1,1
90749,3,17,7,10,7,0
121716,3,21,14,7,4,0
89024,1,0,0,0,6,0
280822,2,7,0,7,6,1
165359,2,0,10,-10,6,1
174618,1,3,0,3,10,1
262960,1,0,0,0,15,0
419245,1,0,0,0,16,1
322388,4,17,16,1,7,0
154778,3,13,16,-3,1,0
390403,3,7,27,-20,3,1
176263,1,0,0,0,11,0
290417,4,28,10,18,10,1
39557,2,0,6,-6,1,1
277633,4,27,28,-1,4,1
2603,4,10,27,-17,2,1
357083,2,6,14,-8,5,1
266907,1,7,0,7,17,1
342306,4,20,3,17,16,0
54471,2,0,7,-7,8,1
164235,4,39,38,1,5,1
200361,1,0,0,0,4,0
338084,3,3,7,-4,14,0
189763,2,10,6,4,17,1
270559,3,10,14,-4,1,1
247366,1,3,0,3,8,0
104210,1,0,0,0,13,1
6530,3,3,3,0,3,0
17722,4,17,6,11,9,1
158865,4,23,3,20,3,0
226525,1,0,0,0,16,1
7005,4,13,7,6,3,0
275563,1,7,0,7,3,1
78497,4,24,0,24,2,1
238540,3,16,13,3,4,1
382101,2,21,3,18,17,1
181762,4,7,14,-7,13,0
174586,4,13,14,-1,10,0
395555,4,28,14,14,6,1
168214,4,29,15,14,7,0
318668,1,0,0,0,5,0
348482,1,14,0,14,2,1
22878,2,0,13,-13,11,1
373303,1,0,0,0,13,1
313163,3,13,13,0,3,1
161477,3,10,3,7,4,0
164888,2,0,3,-3,6,1
78532,1,0,7,-7,2,1
295863,2,7,14,-7,12,0
318819,1,7,0,7,5,0
389996,4,28,25,3,3,1
8954,4,28,13,15,4,1
250612,2,3,0,3,10,0
154934,3,26,10,16,1,0
320423,2,17,0,17,6,0
20023,3,19,6,13,10,0
328143,3,6,7,-1,10,1
155553,3,23,3,20,2,0
23615,2,7,7,0,12,0
321710,1,3,3,0,7,1
85085,4,31,16,15,4,1
176051,3,24,0,24,11,1
79250,1,9,0,9,2,1
163350,4,22,26,-4,5,1
335897,4,28,14,14,13,0
158224,3,31,0,31,3,0
196166,4,31,24,7,2,0
226943,4,3,19,-16,16,0
415075,1,0,0,0,15,0
117948,2,7,6,1,2,1
131759,4,24,28,-4,8,0
143602,1,10,3,7,14,1
330229,2,7,14,-7,11,1
127629,3,17,9,8,6,1
47328,2,0,10,-10,5,1
66922,3,12,7,5,14,0
74473,1,0,0,0,17,1
294771,1,0,7,-7,12,1
216455,1,14,0,14,12,0
194490,4,23,10,13,2,0
126872,3,17,6,11,6,1
349496,4,9,20,-11,2,1
334900,4,27,10,17,13,1
405852,1,0,0,0,11,1
339634,4,31,17,14,15,0
358404,2,16,13,3,6,0
58827,1,0,0,0,10,1
412878,4,38,35,3,14,1
412459,2,10,7,3,14,1
172276,4,24,13,11,9,0
408195,3,13,3,10,12,1
257137,4,24,24,0,12,0
63263,1,0,0,0,12,0
64632,4,20,17,3,13,0
25017,3,16,21,-5,12,0
165867,4,6,16,-10,6,0
198744,1,3,0,3,3,0
241645,1,0,0,0,5,0
250943,2,3,6,-3,10,1
278272,1,0,0,0,4,1
73707,4,20,9,11,17,0
353025,4,23,10,13,3,0
14029,2,3,21,-18,7,1
290576,4,26,20,6,10,1
70184,3,30,14,16,15,0
109457,3,9,13,-4,16,0
246626,2,17,3,14,8,1
346608,1,7,0,7,1,1
133231,4,23,20,3,9,0
399863,1,0,0,0,8,1
79420,2,6,0,6,2,0
23096,4,10,17,-7,11,1
394714,1,14,0,14,5,1
390982,2,13,21,-8,4,1
296181,3,16,19,-3,13,0
319458,2,0,10,-10,6,1
37133,4,16,20,-4,17,1
282409,4,10,23,-13,6,0
100481,2,7,10,-3,12,1
343582,1,12,0,12,17,0
222645,2,7,7,0,14,0
172085,3,10,9,1,9,1
170478,4,21,10,11,8,0
354606,2,3,7,-4,4,0
398608,2,0,0,0,7,1
208668,4,6,6,0,8,0
31133,1,3,10,-7,15,0
256372,1,6,0,6,12,1
111485,1,7,0,7,16,0
138589,1,0,0,0,12,1
140881,2,17,7,10,13,0
301522,4,20,18,2,15,0
70204,4,30,22,8,15,0
343674,3,15,10,5,17,1
248321,3,17,7,10,8,0
208253,1,0,0,0,8,1
233728,2,13,21,-8,2,0
184329,1,0,3,-3,14,0
242800,4,14,31,-17,6,0
84139,2,7,0,7,4,1
232706,4,17,3,14,1,1
233012,4,17,10,7,2,1
396862,3,20,10,10,6,1
160746,1,0,0,0,4,1
56753,3,7,13,-6,9,1
413643,1,0,0,0,14,0
416028,2,7,3,4,15,0
412539,4,31,14,17,14,1
192003,3,17,20,-3,1,0
322928,2,13,0,13,7,0
121794,1,0,0,0,4,1
157486,4,23,37,-14,2,0
287639,3,3,10,-7,9,1
389176,1,7,0,7,3,1
392241,4,10,16,-6,4,1
283036,4,28,3,25,6,0
332354,4,16,13,3,12,0
82216,4,16,10,6,3,1
139475,4,27,10,17,12,1
9667,3,12,28,-16,5,1
157468,4,16,37,-21,2,1
307077,4,24,6,18,17,1
155907,4,17,13,4,2,1
263129,1,0,7,-7,15,0
265588,1,0,8,-8,16,0
214218,1,0,3,-3,11,1
414571,3,21,9,12,14,1
370615,3,14,14,0,12,1
92649,1,0,0,0,8,0
18730,2,6,7,-1,9,1
29857,2,6,16,-10,14,1
272395,2,24,0,24,2,0
313190,3,20,16,4,3,0
220029,4,16,35,-19,13,1
346772,1,0,0,0,1,0
227049,4,17,6,11,16,0
399267,4,13,30,-17,7,1
169573,4,10,41,-31,8,1
62621,3,9,17,-8,12,1
373138,4,10,24,-14,13,0
90812,4,34,7,27,7,0
52266,4,20,19,1,7,0
243375,1,0,7,-7,6,1
263458,2,6,13,-7,15,0
50419,2,7,7,0,6,0
133185,3,13,17,-4,9,1
238106,5,13,13,0,4,0
182426,1,7,0,7,14,1
328418,1,0,0,0,10,1
178863,4,27,21,6,12,1
388162,3,3,6,-3,2,1
25230,1,7,0,7,12,0
386739,1,0,0,0,2,0
366174,4,7,45,-38,10,0
289061,4,32,28,4,9,1
403986,1,0,7,-7,10,1
40170,3,13,7,6,2,1
287852,4,28,20,8,9,0
292423,1,3,0,3,11,1
275620,2,24,3,21,3,1
199679,2,14,7,7,4,1
104667,4,7,3,4,14,0
84526,4,27,31,-4,4,1
277086,2,3,14,-11,4,1
10388,3,10,38,-28,5,0
98010,4,17,17,0,11,1
219357,3,16,13,3,13,1
17197,2,7,21,-14,9,0
273275,1,7,0,7,2,1
95679,2,10,3,7,10,0
266877,1,0,0,0,17,0
265152,1,0,0,0,16,0
185438,4,17,10,7,15,0
8853,1,7,0,7,4,0
230050,4,19,6,13,17,0
266737,1,0,7,-7,16,1
149862,3,3,16,-13,16,1
305804,1,0,7,-7,17,1
312057,2,14,7,7,2,0
14280,2,0,7,-7,7,1
133341,3,14,9,5,9,1
350943,4,14,14,0,3,0
190203,2,0,0,0,17,1
195497,2,0,0,0,2,1
374475,4,32,7,25,14,1
14593,2,3,7,-4,7,0
17550,3,13,9,4,9,0
36869,4,24,42,-18,17,0
330272,4,24,21,3,11,1
179394,2,6,13,-7,12,1
339129,3,10,6,4,15,1
203316,2,14,24,-10,6,0
254591,3,7,14,-7,11,0
53224,2,3,0,3,8,1
376063,2,0,3,-3,14,1
393208,2,7,6,1,5,0
148289,2,7,0,7,16,0
243173,4,23,22,1,6,0
71693,1,3,0,3,16,0
343085,3,12,13,-1,16,0
386084,3,14,3,11,1,0
250899,1,0,0,0,10,0
92900,4,34,6,28,8,0
112626,4,38,34,4,17,0
62201,4,13,17,-4,12,0
208822,4,6,22,-16,8,0
142536,4,30,16,14,13,0
350634,3,13,3,10,2,0
294050,2,7,14,-7,12,1
297222,2,0,6,-6,13,1
61353,1,0,0,0,11,1
125276,1,3,0,3,5,0
293941,3,7,21,-14,12,0
392613,2,7,0,7,4,0
6812,2,3,21,-18,3,1
141902,4,27,21,6,13,0
159892,3,31,0,31,3,0
32349,2,14,0,14,15,0
366998,3,3,31,-28,10,1
396037,1,0,0,0,6,1
339320,4,38,7,31,15,0
259821,4,23,20,3,14,0
258922,1,0,0,0,13,0
153805,4,2,27,-25,1,0
234031,2,14,0,14,2,1
130593,1,7,7,0,8,1
247449,3,13,9,4,8,1
124199,1,0,6,-6,5,0
296076,4,9,13,-4,13,0
298920,1,0,6,-6,14,0
262589,2,20,3,17,15,1
273519,4,14,21,-7,2,1
41061,3,3,13,-10,2,0
30819,1,0,7,-7,15,0
112333,1,0,0,0,17,1
16176,1,0,0,0,8,1
107954,3,6,6,0,15,0
186295,2,16,3,13,15,0
43914,1,0,7,-7,3,1
201769,2,6,0,6,5,0
108559,3,17,14,3,15,0
59609,2,14,3,11,11,1
410401,2,6,10,-4,13,1
372146,2,9,7,2,13,0
226323,3,19,7,12,16,1
176603,1,0,0,0,11,0
207285,2,0,7,-7,7,0
311426,1,0,0,0,2,0
317792,2,9,3,6,5,1
236503,2,7,9,-2,3,1
303335,4,34,0,34,16,1
411543,1,0,7,-7,13,1
413718,3,14,13,1,14,1
52897,4,14,58,-44,7,0
136284,2,15,7,8,11,1
201565,4,32,28,4,5,0
84341,4,21,30,-9,4,1
69487,4,31,24,7,15,1
54845,4,16,0,16,8,0
243105,3,7,9,-2,6,0
287202,3,10,20,-10,8,1
323086,3,23,14,9,7,0
347773,2,7,0,7,1,1
52481,1,3,0,3,7,1
329236,3,17,13,4,10,1
356371,3,24,14,10,5,0
305160,4,27,10,17,16,1
230435,3,21,3,18,1,0
336898,3,7,14,-7,14,0
40937,4,16,20,-4,2,1
218902,3,28,17,11,13,0
340893,2,0,10,-10,15,1
283149,3,13,9,4,7,0
363490,1,0,2,-2,8,0
196679,2,33,0,33,3,0
143332,2,0,13,-13,14,1
417229,3,17,20,-3,16,1
44449,3,17,7,10,3,0
286892,3,16,7,9,8,0
32311,1,0,0,0,15,0
58249,2,14,10,4,10,0
1383,3,10,0,10,1,0
393470,4,34,27,7,5,0
344457,1,0,0,0,17,1
359389,4,13,23,-10,6,0
362242,4,12,17,-5,8,1
89852,3,16,12,4,7,0
61747,4,24,38,-14,12,0
172922,4,40,24,16,9,1
196189,1,7,0,7,2,0
265670,4,9,18,-9,16,0
281633,2,21,3,18,6,0
138610,1,3,0,3,12,0
281785,2,3,0,3,6,1
338945,2,6,0,6,15,0
317088,4,17,17,0,4,1
125308,2,10,3,7,5,1
108629,1,6,0,6,15,0
166621,3,22,20,2,6,1
55693,3,20,14,6,9,1
319320,3,10,18,-8,6,1
328847,4,24,20,4,10,0
343997,4,23,6,17,17,0
396128,3,17,23,-6,6,0
41812,3,21,14,7,2,0
132685,2,3,10,-7,9,0
327150,3,14,17,-3,9,1
177946,1,7,0,7,12,0
410386,2,0,7,-7,13,0
34455,3,38,3,35,16,0
387465,4,21,16,5,2,0
100967,3,10,16,-6,12,0
11364,2,17,0,17,6,1
123525,3,10,9,1,4,0
161180,4,3,33,-30,4,0
334889,4,27,10,17,13,1
359002,2,10,0,10,6,1
332297,2,3,6,-3,12,1
300210,4,28,3,25,14,1
343680,3,15,10,5,17,0
217642,4,19,16,3,12,1
333179,2,0,6,-6,12,0
80745,1,3,0,3,3,1
212020,3,10,23,-13,9,0
40765,3,17,21,-4,2,0
165872,4,6,19,-13,6,1
107970,4,6,13,-7,15,1
137361,2,3,7,-4,11,1
12411,3,10,6,4,6,1
44122,3,9,13,-4,3,1
103502,2,13,0,13,13,1
72226,3,17,17,0,16,1
411378,4,20,13,7,13,1
140384,4,17,29,-12,12,0
16350,2,7,7,0,8,1
150929,3,10,7,3,17,1
385777,3,20,0,20,1,0
397863,2,0,3,-3,7,1
101071,2,7,10,-3,12,1
341114,4,14,17,-3,15,0
44445,3,17,7,10,3,0
409492,1,0,0,0,12,1
94535,3,3,10,-7,9,0
243232,1,0,7,-7,6,1
293123,4,10,30,-20,11,1
341509,2,3,7,-4,16,1
226763,3,7,20,-13,16,1
132821,2,3,7,-4,9,1
284990,4,16,27,-11,7,0
414950,1,7,7,0,15,1
29550,2,0,13,-13,14,1
32191,1,14,7,7,15,0
14974,4,17,24,-7,7,1
200931,4,40,7,33,4,0
315851,4,9,19,-10,4,1
373687,3,6,15,-9,13,0
271143,2,7,10,-3,1,1
254879,2,7,7,0,12,1
29486,4,10,14,-4,14,1
210002,2,7,3,4,8,1
345026,4,23,23,0,17,0
298731,4,22,21,1,14,0
39776,4,9,7,2,1,0
67376,4,30,6,24,14,0
199296,4,17,38,-21,4,1
10247,4,13,10,3,5,0
68146,1,0,0,0,14,0
53527,2,7,6,1,8,0
70797,4,30,27,3,15,0
30419,2,10,13,-3,14,0
128213,3,20,7,13,7,0
380342,2,7,7,0,16,1
177691,2,10,14,-4,12,1
225130,4,16,14,2,15,0
126345,2,7,14,-7,6,0
24732,4,20,14,6,12,0
203247,4,16,24,-8,5,1
21264,2,3,6,-3,11,0
341011,1,0,0,0,15,0
72941,3,17,7,10,16,1
22275,2,0,3,-3,11,1
194532,4,29,10,19,2,0
346477,1,10,7,3,1,0
277638,1,0,0,0,4,1
31153,2,10,13,-3,15,1
50305,3,13,16,-3,6,0
17656,2,7,3,4,9,0
230769,4,9,27,-18,1,0
8754,2,0,0,0,4,1
389770,2,10,3,7,3,0
39731,3,9,0,9,1,1
268841,1,0,0,0,17,0
289432,2,0,0,0,10,0
208805,3,6,22,-16,8,0
338472,2,7,0,7,14,1
310349,4,29,0,29,2,0
308,1,7,0,7,1,0
53503,1,7,3,4,8,1
263408,1,0,0,0,15,1
314103,4,33,20,13,3,0
167146,1,6,0,6,7,1
388880,2,10,14,-4,3,1
364418,3,35,14,21,9,0
283453,3,23,14,9,7,1
368434,3,23,7,16,11,0
377502,1,0,0,0,15,0
192810,3,0,15,-15,1,0
221493,4,10,41,-31,14,0
318883,3,21,15,6,5,0
170602,3,34,9,25,8,1
226113,2,7,14,-7,16,0
104281,2,17,7,10,13,1
269423,4,21,20,1,1,1
171107,1,0,0,0,8,1
246552,4,36,7,29,8,0
366354,1,6,0,6,10,0
89180,1,0,0,0,7,0
364229,2,0,7,-7,9,0
300503,3,23,10,13,14,0
149496,1,7,6,1,16,1
205952,2,6,3,3,7,0
19503,4,33,17,16,10,0
161216,1,0,3,-3,4,0
9721,1,0,7,-7,5,0
197947,1,0,0,0,3,0
146078,2,19,10,9,15,1
279972,2,3,10,-7,5,1
390590,4,17,27,-10,3,1
68026,2,0,10,-10,14,1
50027,4,28,10,18,6,0
1321,1,0,0,0,1,1
189493,3,17,0,17,17,0
297025,1,7,0,7,13,1
170337,4,0,15,-15,8,1
397745,3,9,14,-5,7,0
138952,2,7,3,4,12,0
85301,2,7,3,4,5,1
211426,1,0,0,0,9,0
262956,1,0,0,0,15,0
348585,4,28,17,11,2,0
333232,3,6,7,-1,12,0
86539,2,20,3,17,5,0
302782,2,3,13,-10,15,1
405839,5,24,24,0,10,0
292126,2,14,0,14,11,1
323675,3,20,0,20,8,1
70694,1,7,3,4,15,0
305019,4,24,27,-3,16,1
176452,1,0,7,-7,11,0
344188,1,0,0,0,17,0
256794,4,13,13,0,12,1
82969,3,13,16,-3,4,0
383090,2,20,7,13,17,1
218956,4,48,27,21,13,0
164752,2,20,14,6,6,1
188129,3,10,10,0,16,1
230814,1,0,0,0,1,1
258896,4,20,26,-6,13,1
247992,2,14,3,11,8,0
224572,1,3,7,-4,15,1
398971,4,23,20,3,7,0
106830,4,34,35,-1,14,0
167913,4,21,19,2,7,1
222985,4,13,13,0,14,0
197726,3,7,10,-3,3,1
405378,1,0,7,-7,10,1
368292,3,9,6,3,11,0
243106,3,7,9,-2,6,0
200806,4,31,17,14,4,1
185164,4,0,23,-23,15,0
406493,2,0,13,-13,11,0
314516,3,21,7,14,3,1
89365,2,3,13,-10,7,1
384115,2,0,17,-17,1,1
7476,3,29,6,23,4,0
319529,4,13,17,-4,6,1
241325,4,13,14,-1,5,0
419454,2,10,6,4,16,0
361487,2,7,0,7,7,0
225759,2,10,7,3,16,0
233991,1,14,0,14,2,0
70140,2,13,7,6,15,1
295614,4,34,32,2,12,1
405101,2,0,10,-10,10,1
267175,4,17,10,7,17,1
120086,2,3,0,3,3,0
181568,2,13,0,13,13,0
55539,2,10,7,3,9,1
145234,4,56,0,56,14,1
247691,2,7,6,1,8,1
318196,4,22,20,2,5,1
169701,4,20,17,3,8,1
296639,3,3,10,-7,13,1
214395,2,0,7,-7,11,1
233177,4,29,10,19,2,1
210070,4,17,17,0,8,1
344297,4,19,13,6,17,1
400299,4,31,9,22,8,1
29240,1,14,0,14,14,1
309767,4,29,12,17,1,0
70525,4,39,23,16,15,1
7447,2,20,6,14,4,0
156580,1,0,0,0,2,0
321740,2,6,6,0,7,1
95119,2,9,10,-1,9,0
283562,2,6,17,-11,7,1
78225,1,0,0,0,2,0
210756,3,21,10,11,9,1
218546,1,0,7,-7,13,0
146734,4,22,32,-10,15,0
204626,3,10,38,-28,6,0
390233,2,3,6,-3,3,0
60412,4,20,7,13,11,1
325896,2,3,0,3,9,1
390487,1,7,0,7,3,0
211729,4,29,16,13,9,0
309258,2,0,7,-7,1,0
290146,1,0,0,0,10,1
58988,1,0,7,-7,10,1
318776,4,17,26,-9,5,1
231985,1,0,6,-6,1,0
23904,2,3,0,3,12,1
186146,2,6,3,3,15,0
125033,3,3,12,-9,5,0
65548,1,3,0,3,13,1
88072,4,24,3,21,6,0
268716,1,0,3,-3,17,1
173075,4,24,19,5,9,1
311550,4,17,19,-2,2,1
9121,1,0,0,0,5,0
333937,2,7,7,0,12,0
124655,1,0,0,0,5,1
135723,4,17,29,-12,10,0
98778,4,34,8,26,11,0
244287,4,26,7,19,6,0
197755,3,20,17,3,3,1
256798,4,13,13,0,12,0
416815,4,13,10,3,15,1
55246,2,7,9,-2,9,0
156645,2,3,6,-3,2,0
352430,3,35,16,19,3,0
253917,4,41,14,27,11,1
55834,3,7,7,0,9,1
237724,4,20,17,3,4,1
262787,4,35,17,18,15,0
165197,2,0,7,-7,6,1
382643,2,0,0,0,17,1
258874,3,20,14,6,13,0
305855,3,7,14,-7,17,1
67092,4,10,9,1,14,0
343287,1,0,0,0,16,0
255762,1,0,0,0,12,1
174780,2,6,7,-1,10,1
248830,4,37,22,15,9,0
80457,1,2,0,2,3,1
373743,4,16,21,-5,13,0
313487,4,17,17,0,3,1
248006,2,21,3,18,8,0
155965,1,3,13,-10,2,0
306345,4,24,10,14,17,0
132416,2,0,20,-20,9,0
7862,2,3,7,-4,4,0
55342,1,0,0,0,9,1
392461,1,0,9,-9,4,1
3915,3,19,14,5,2,1
383789,2,3,7,-4,1,1
299923,4,16,11,5,14,0
41382,4,14,12,2,2,0
236026,2,20,3,17,3,0
399460,2,0,17,-17,7,0
411715,1,0,3,-3,13,1
56716,2,0,10,-10,9,1
149907,4,6,23,-17,16,1
313790,4,34,17,17,3,0
347361,4,14,21,-7,1,0
161413,2,7,3,4,4,1
161037,4,30,7,23,4,0
66229,3,31,3,28,13,1
189178,2,21,0,21,16,1
366506,1,7,7,0,10,1
141018,2,7,0,7,13,0
265783,3,17,3,14,16,0
402035,4,3,19,-16,9,1
324013,4,20,22,-2,8,0
409333,1,0,0,0,12,0
127365,4,10,20,-10,6,0
314901,2,0,0,0,4,1
65596,2,6,6,0,13,0
5394,3,13,13,0,3,0
100151,1,7,0,7,12,0
394829,1,0,0,0,5,0
355341,4,14,26,-12,4,0
138345,3,27,0,27,11,0
311535,4,17,13,4,2,0
154739,2,3,10,-7,1,1
151154,2,3,10,-7,17,0
411021,2,14,14,0,13,1
13905,3,21,7,14,7,1
218615,3,10,23,-13,13,0
103177,2,0,0,0,13,0
31219,4,23,34,-11,15,1
408311,2,0,7,-7,12,1
156440,1,0,3,-3,2,1
17022,1,0,0,0,9,1
263579,1,0,7,-7,15,1
154955,4,29,24,5,1,1
330888,4,13,24,-11,11,1
227499,4,19,17,2,16,1
200804,4,31,17,14,4,1
361124,4,23,23,0,7,1
24143,4,24,14,10,12,0
172559,3,7,21,-14,9,0
245614,4,40,13,27,7,0
241172,4,20,10,10,5,0
216738,4,27,9,18,12,1
66412,4,21,30,-9,14,1
300368,4,10,7,3,14,1
73725,1,0,0,0,17,0
392401,4,27,45,-18,4,1
353595,4,37,0,37,4,1
334591,4,30,24,6,13,0
138411,1,7,0,7,12,1
120676,1,3,0,3,3,1
393637,4,7,33,-26,5,1
388321,3,10,6,4,2,1
271114,2,0,10,-10,1,1
331486,3,9,23,-14,11,0
356969,2,17,3,14,5,1
7321,4,20,19,1,4,1
208079,4,21,19,2,8,1
281704,4,31,24,7,6,0
334301,4,9,14,-5,13,0
116765,3,13,26,-13,2,1
312378,3,13,24,-11,3,0
201812,3,13,16,-3,5,0
23438,1,7,0,7,11,0
142949,3,3,13,-10,13,1
251139,4,10,20,-10,10,1
386079,3,14,3,11,1,0
117173,2,13,10,3,2,1
307791,2,17,7,10,1,0
306505,4,17,17,0,17,1
11864,4,41,17,24,6,0
179212,1,7,3,4,12,1
343472,2,7,7,0,16,1
262914,4,14,23,-9,15,0
421666,2,10,7,3,17,1
359202,4,13,21,-8,6,1
56325,4,3,26,-23,9,0
1210,2,10,0,10,1,1
70660,4,17,22,-5,15,1
54644,2,14,19,-5,8,0
244089,4,20,27,-7,6,0
237077,2,0,23,-23,3,0
369096,1,6,0,6,11,0
323353,2,7,0,7,7,1
127,4,7,10,-3,1,1
300807,4,10,33,-23,15,0
114754,1,0,0,0,1,0
4335,2,0,7,-7,2,0
145644,3,28,7,21,14,1
102835,4,10,10,0,13,1
94158,2,10,7,3,9,1
201228,4,23,24,-1,5,0
347315,3,7,21,-14,1,1
113533,1,0,0,0,17,0
88171,2,14,10,4,6,0
214851,1,0,9,-9,11,1
234698,4,30,23,7,2,0
195183,2,10,0,10,2,0
215645,3,14,6,8,11,0
333603,4,24,23,1,12,1
69464,4,24,10,14,15,1
395806,2,3,7,-4,6,0
235394,2,21,7,14,3,0
72652,3,13,3,10,16,1
32961,2,0,24,-24,15,1
195190,2,10,0,10,2,1
28172,1,3,0,3,13,1
146798,2,10,0,10,15,0
293638,2,10,7,3,12,1
46980,1,0,0,0,5,0
37495,2,7,7,0,17,0
267626,1,0,0,0,17,1
155851,2,7,10,-3,2,1
223820,2,9,0,9,15,1
155312,1,7,0,7,2,0
127620,3,17,9,8,6,1
15512,3,16,6,10,8,0
260180,2,7,0,7,14,0
86952,2,13,0,13,5,1
250124,1,7,0,7,9,0
6398,3,9,13,-4,3,0
154427,2,14,0,14,1,0
415204,4,17,24,-7,15,0
129167,1,0,0,0,7,1
108284,4,12,7,5,15,0
108796,2,0,7,-7,15,0
65164,3,3,3,0,13,0
165494,2,0,7,-7,6,0
139259,2,13,6,7,12,0
32109,3,21,13,8,15,1
186856,4,29,20,9,15,0
29093,1,0,6,-6,14,1
323766,1,6,3,3,8,0
155328,1,10,0,10,2,0
376122,4,0,9,-9,14,1
280707,2,0,6,-6,5,1
256657,4,35,14,21,12,1
357510,2,7,6,1,5,1
237468,1,7,0,7,3,1
295905,3,10,17,-7,12,1
286496,1,3,0,3,8,0
80650,3,10,16,-6,3,1
182051,4,17,14,3,13,0
297521,2,11,0,11,13,1
206692,2,0,7,-7,7,0
303350,4,41,0,41,16,0
244640,2,0,10,-10,7,0
44253,2,17,13,4,3,0
34904,3,27,10,17,16,1
224940,3,3,9,-6,15,1
259084,1,0,0,0,13,0
236383,4,7,23,-16,3,1
129882,3,13,0,13,7,0
406892,4,27,23,4,11,0
22973,1,0,0,0,11,0
309291,3,0,20,-20,1,0
145344,3,35,26,9,14,1
22146,2,10,6,4,11,0
316561,2,3,6,-3,4,1
297185,1,0,0,0,13,0
284807,3,26,20,6,7,1
216304,1,7,6,1,12,0
277982,2,0,7,-7,4,1
212570,1,7,10,-3,10,1
287168,2,10,10,0,8,0
199701,3,21,7,14,4,1
322633,3,3,6,-3,7,1
174136,1,0,0,0,10,0
115074,1,3,0,3,1,0
143609,2,10,3,7,14,0
72936,3,17,7,10,16,1
165025,2,7,10,-3,6,0
42719,4,7,20,-13,3,1
166758,3,20,9,11,6,0
280130,2,21,0,21,5,1
224771,3,5,3,2,15,1
321747,2,9,6,3,7,0
258128,3,13,13,0,13,1
61959,2,0,0,0,12,1
124305,3,34,20,14,5,0
392994,4,12,10,2,4,1
81104,2,10,14,-4,3,0
241446,4,10,35,-25,5,1
165038,2,7,17,-10,6,1
280813,1,7,0,7,6,1
139626,4,9,14,-5,12,0
377825,2,14,0,14,15,1
103523,3,20,0,20,13,0
363122,3,7,3,4,8,0
65594,2,6,6,0,13,0
412131,1,0,0,0,13,0
78118,2,7,3,4,2,1
375917,2,14,3,11,14,0
509,2,7,6,1,1,1
100822,3,9,13,-4,12,1
257227,3,19,16,3,12,0
10876,1,0,0,0,5,1
176794,2,3,7,-4,11,1
172769,4,21,18,3,9,0
359721,2,17,6,11,6,0
138912,1,0,3,-3,12,1
84682,1,3,0,3,4,0
111598,1,0,0,0,16,0
40982,1,0,7,-7,2,1
326166,2,7,10,-3,9,0
256584,2,7,0,7,12,1
320796,4,17,26,-9,6,1
347469,2,12,13,-1,1,0
182821,3,26,17,9,14,1
182429,1,7,0,7,14,0
3917,3,19,14,5,2,0
20982,2,14,24,-10,10,1
131968,2,0,7,-7,8,0
59589,2,7,3,4,11,0
147508,1,0,0,0,15,1
411165,2,0,23,-23,13,1
80031,2,7,3,4,2,1
385420,2,21,7,14,1,0
8057,2,17,7,10,4,0
22524,4,31,37,-6,11,1
33031,4,12,44,-32,15,0
144261,3,9,7,2,14,1
344071,1,3,3,0,17,0
171202,3,6,14,-8,8,1
19830,1,3,7,-4,10,1
136387,1,0,0,0,11,1
65743,3,14,16,-2,13,0
41491,3,5,7,-2,2,1
296426,2,7,0,7,13,1
228133,1,0,0,0,17,0
415054,4,13,27,-14,15,0
18762,3,13,10,3,9,0
134783,3,34,10,24,10,0
341720,4,23,13,10,16,1
316187,4,30,35,-5,4,1
216024,2,7,12,-5,11,1
342706,2,0,6,-6,16,0
235634,1,0,0,0,3,0
421855,3,7,13,-6,17,0
214451,3,7,14,-7,11,0
12989,2,0,7,-7,6,0
303584,2,21,13,8,16,1
191448,4,0,34,-34,17,1
353536,2,10,0,10,4,0
203857,4,34,31,3,6,0
270435,3,10,7,3,1,1
315253,4,20,16,4,4,0
137188,1,0,0,0,11,1
243333,4,14,30,-16,6,1
46870,2,13,3,10,5,0
95722,4,13,9,4,10,0
304230,3,33,14,19,16,1
9131,1,0,13,-13,5,1
297442,4,38,24,14,13,0
220929,1,0,0,0,14,0
204335,4,0,17,-17,6,1
104325,3,38,21,17,13,0
347897,2,0,7,-7,1,0
391218,4,10,24,-14,4,1
317165,2,0,3,-3,5,1
320152,4,17,14,3,6,1
36632,2,9,3,6,17,1
45109,1,0,0,0,4,1
112493,1,0,9,-9,17,0
127891,1,10,0,10,6,1
257172,1,0,9,-9,12,1
60987,3,27,16,11,11,1
63471,3,28,13,15,12,0
157645,4,29,3,26,2,1
379468,3,16,0,16,16,1
122036,4,19,13,6,4,0
147205,1,0,7,-7,15,0
23913,2,6,0,6,12,1
183431,3,24,6,18,14,1
115601,4,30,9,21,1,0
227117,2,0,0,0,16,1
403792,4,15,23,-8,9,1
178735,4,11,26,-15,12,1
114707,4,15,10,5,1,0
199010,4,19,26,-7,3,1
413882,3,17,6,11,14,0
346766,1,0,0,0,1,1
392354,3,17,28,-11,4,1
21710,2,17,7,10,11,0
64458,3,14,13,1,13,1
259814,4,23,20,3,14,0
110137,2,7,10,-3,16,1
250879,4,10,18,-8,10,1
227772,3,3,14,-11,16,1
111655,2,14,10,4,16,1
21665,1,3,0,3,11,0
334074,1,0,0,0,13,0
45534,1,0,0,0,4,1
419999,2,3,7,-4,17,0
3455,3,3,23,-20,2,0
376009,4,26,21,5,14,0
260843,3,29,15,14,14,1
202477,4,9,10,-1,5,0
323577,4,34,24,10,7,0
165042,2,10,17,-7,6,1
237637,2,3,7,-4,4,0
30907,3,3,24,-21,15,0
69000,3,21,14,7,15,0
182880,1,0,3,-3,14,1
109907,4,23,0,23,16,0
115945,1,0,0,0,1,0
200071,1,0,0,0,4,1
34761,4,20,3,17,16,0
164085,3,12,6,6,5,1
306712,2,10,10,0,17,1
203167,2,0,10,-10,5,0
264271,3,10,17,-7,15,1
152191,2,14,0,14,17,0
216113,4,24,26,-2,11,0
123730,1,7,0,7,5,0
276690,4,23,13,10,4,0
414172,4,16,20,-4,14,1
361189,2,0,7,-7,7,0
224324,3,16,12,4,15,0
408888,1,13,0,13,12,1
371476,3,14,17,-3,12,0
362364,3,23,14,9,8,0
283788,4,18,3,15,7,1
410638,4,17,24,-7,13,0
225757,2,10,7,3,16,0
102038,2,20,3,17,12,1
306288,2,17,0,17,17,0
141005,2,7,0,7,13,1
406310,1,0,0,0,11,0
189937,2,3,7,-4,17,1
219429,1,0,0,0,13,1
412575,1,0,0,0,14,1
227093,1,0,0,0,16,1
406183,1,7,0,7,11,0
146998,3,24,0,24,15,0
379969,4,24,6,18,16,0
344253,3,7,13,-6,17,1
159736,3,7,10,-3,3,1
209822,1,7,10,-3,8,1
338493,2,14,7,7,14,1
361461,1,7,0,7,7,1
287219,4,13,23,-10,8,1
23081,4,10,17,-7,11,1
180330,3,12,7,5,13,0
10950,3,9,21,-12,5,0
226137,3,14,17,-3,16,0
291258,2,7,12,-5,10,0
414483,1,0,0,0,14,0
230153,3,3,23,-20,17,0
276098,4,34,3,31,3,1
268573,2,7,3,4,17,1
156800,2,20,20,0,2,1
100166,2,7,0,7,12,0
290456,1,0,0,0,10,1
71596,2,3,17,-14,16,1
99194,2,17,10,7,11,0
21799,1,0,0,0,11,0
91035,3,6,0,6,7,1
294225,3,13,7,6,12,0
27106,4,17,9,8,13,0
38946,2,23,0,23,1,0
210906,3,19,9,10,9,0
228236,3,10,27,-17,17,1
210649,4,13,24,-11,9,1
202584,2,20,13,7,5,1
213418,3,10,41,-31,10,1
378111,1,14,0,14,15,1
259905,2,14,10,4,14,1
60960,2,14,6,8,11,1
150011,3,14,6,8,16,1
210704,1,7,0,7,9,1
182246,1,0,0,0,14,1
108631,1,6,0,6,15,0
15379,3,10,9,1,8,0
51729,2,0,10,-10,7,1
84934,4,48,17,31,4,0
167752,4,26,23,3,7,1
398652,3,0,3,-3,7,1
36152,1,0,0,0,17,0
336018,3,13,25,-12,13,1
22883,2,0,13,-13,11,0
14233,1,0,0,0,7,1
289966,4,6,6,0,10,0
54868,4,26,3,23,8,1
77246,3,16,7,9,1,1
64717,2,21,0,21,13,0
288450,4,19,7,12,9,0
281684,3,31,17,14,6,0
405321,4,14,12,2,10,1
400419,4,24,10,14,8,1
226671,1,7,0,7,16,0
142087,1,0,7,-7,13,1
109304,3,13,3,10,15,0
328025,3,17,9,8,10,0
299394,2,0,13,-13,14,1
252795,3,6,6,0,11,1
259960,4,20,20,0,14,0
120231,2,7,3,4,3,1
323716,4,26,0,26,8,1
186275,2,13,3,10,15,1
140574,1,17,7,10,12,1
88010,2,17,0,17,6,0
117893,4,18,20,-2,2,1
260402,4,20,7,13,14,0
152142,4,20,13,7,17,1
11293,4,17,28,-11,6,1
98872,2,7,7,0,11,1
73620,2,0,0,0,17,0
86398,2,20,7,13,5,0
34763,4,20,3,17,16,1
270742,4,6,3,3,1,1
295334,1,0,0,0,12,1
353564,3,24,0,24,4,1
191367,2,0,17,-17,17,1
230776,4,9,27,-18,1,1
172546,2,7,21,-14,9,0
141830,2,10,14,-4,13,1
415494,4,23,3,20,15,0
258638,4,13,13,0,13,1
93249,1,0,0,0,9,1
380659,2,7,7,0,16,1
312220,2,7,14,-7,2,0
24862,4,13,3,10,12,1
155749,4,20,23,-3,2,1
43136,1,0,0,0,3,0
300245,1,0,0,0,14,0
4913,2,14,7,7,3,0
338316,1,0,0,0,14,1
307091,4,24,6,18,17,0
273379,4,38,7,31,2,0
184257,3,24,7,17,14,1
402070,1,0,0,0,9,1
375722,1,3,0,3,14,1
335139,2,17,0,17,13,1
305005,4,24,20,4,16,0
271629,4,23,27,-4,2,0
46795,4,14,27,-13,4,1
214542,1,0,0,0,11,1
121650,2,0,7,-7,4,0
159145,4,31,7,24,3,1
363979,3,3,9,-6,8,1
304545,4,18,21,-3,16,0
396015,4,38,20,18,6,0
393052,1,0,3,-3,4,1
393370,2,21,7,14,5,1
347329,4,7,21,-14,1,0
232884,1,0,0,0,2,1
169796,2,3,14,-11,8,0
87932,4,19,15,4,6,1
411116,1,0,0,0,13,0
172910,4,34,24,10,9,0
309759,4,26,12,14,1,1
145981,4,13,21,-8,15,0
400772,1,14,0,14,8,0
204215,1,0,7,-7,6,1
150140,2,3,13,-10,16,1
390206,2,0,6,-6,3,0
56983,1,0,10,-10,9,1
93604,3,6,6,0,9,1
135458,1,0,0,0,10,0
167738,4,26,23,3,7,0
233921,3,17,13,4,2,0
74534,3,0,3,-3,17,0
285282,3,14,6,8,7,0
279587,4,10,16,-6,5,0
80217,3,21,24,-3,2,1
215970,4,20,34,-14,11,0
416634,3,31,7,24,15,0
175424,3,17,20,-3,11,0
94692,4,24,36,-12,9,1
356993,3,20,3,17,5,0
25415,3,6,3,3,12,0
192562,4,33,17,16,1,0
78223,1,0,0,0,2,1
144552,2,7,16,-9,14,1
187557,3,13,16,-3,16,1
41268,1,0,0,0,2,0
364390,2,27,7,20,9,1
185066,2,0,3,-3,15,0
146812,2,10,0,10,15,1
285194,5,6,6,0,7,0
110687,4,23,17,6,16,1
269735,1,0,0,0,1,1
360627,3,7,20,-13,7,1
310344,4,29,0,29,2,0
290678,3,35,16,19,10,0
407086,2,0,13,-13,11,0
409812,2,10,0,10,12,1
179613,4,28,23,5,12,1
143955,3,0,10,-10,14,1
244646,2,0,17,-17,7,1
92291,3,20,0,20,8,0
65657,4,6,19,-13,13,1
45551,1,0,13,-13,4,1
60791,1,7,3,4,11,1
77811,2,7,14,-7,1,0
142915,2,3,10,-7,13,0
289064,4,35,28,7,9,1
279486,1,7,6,1,5,1
365646,4,44,35,9,9,1
368057,4,27,24,3,11,1
29007,3,7,7,0,14,1
317660,3,6,6,0,5,1
159172,1,6,0,6,3,1
162094,3,35,13,22,4,1
221103,2,0,6,-6,14,0
389983,4,28,25,3,3,0
136685,1,0,7,-7,11,1
125559,1,0,7,-7,5,1
139755,4,21,21,0,12,0
139673,1,0,0,0,12,1
74174,1,3,0,3,17,1
249427,4,18,15,3,9,0
149607,4,17,26,-9,16,0
37815,3,14,9,5,1,1
194425,2,9,0,9,2,0
408628,3,28,3,25,12,0
381781,2,0,0,0,17,0
139786,1,0,3,-3,12,1
391277,2,14,0,14,4,0
95488,1,0,0,0,10,1
380279,4,29,23,6,16,1
352001,4,28,21,7,3,1
238099,5,13,13,0,4,1
103997,4,13,13,0,13,0
261489,1,6,0,6,14,1
108912,5,17,17,0,15,1
52947,2,14,14,0,7,1
416171,2,10,9,1,15,0
258348,4,41,39,2,13,1
410765,3,22,6,16,13,1
403925,3,20,14,6,10,1
155768,4,27,30,-3,2,1
42420,4,14,22,-8,2,1
255066,3,6,21,-15,12,0
134513,4,3,33,-30,10,0
272679,2,9,3,6,2,1
306741,2,10,17,-7,17,0
297082,3,24,0,24,13,0
277032,1,0,0,0,4,1
153475,4,23,17,6,1,0
58778,4,10,29,-19,10,0
92235,1,7,0,7,8,0
196884,4,10,20,-10,3,0
118888,4,27,14,13,2,0
89230,3,6,0,6,7,1
12519,2,0,17,-17,6,0
373823,2,13,0,13,13,0
57463,2,14,3,11,10,0
123233,4,19,21,-2,4,0
27533,4,23,12,11,13,0
187725,3,16,13,3,16,0
407847,2,3,0,3,11,0
105679,2,21,3,18,14,0
337875,1,9,0,9,14,1
42079,3,27,10,17,2,0
168295,2,10,14,-4,7,1
280573,3,17,6,11,5,0
228796,2,3,14,-11,17,1
192821,3,0,15,-15,1,0
148413,1,0,0,0,16,1
91543,4,26,10,16,8,0
410977,1,0,7,-7,13,1
197798,4,21,20,1,3,0
55210,2,7,0,7,9,1
55906,1,0,0,0,9,0
74329,1,0,3,-3,17,1
90655,4,20,33,-13,7,1
251867,3,14,13,1,10,0
286934,4,23,19,4,8,1
302468,2,3,3,0,15,0
149412,3,13,27,-14,16,1
218812,4,3,19,-16,13,1
160377,4,3,28,-25,4,0
402894,3,17,6,11,9,0
378181,3,24,16,8,15,1
381507,2,14,0,14,17,1
95906,4,20,23,-3,10,1
221891,3,13,7,6,14,1
276893,1,7,0,7,4,0
268736,2,10,3,7,17,0
117214,3,23,10,13,2,0
172375,2,10,28,-18,9,1
215431,1,7,3,4,11,1
181,1,3,0,3,1,0
114248,4,10,17,-7,1,0
328992,4,33,7,26,10,0
101439,4,18,7,11,12,0
197981,2,0,17,-17,3,1
160475,2,20,7,13,4,0
283612,3,13,20,-7,7,1
285188,5,6,6,0,7,1
62330,4,21,19,2,12,0
397840,1,0,0,0,7,0
346751,4,27,20,7,1,1
71998,1,0,10,-10,16,1
197308,3,14,0,14,3,1
163671,4,21,36,-15,5,0
75997,1,7,13,-6,1,1
193799,1,0,0,0,1,1
109576,3,16,7,9,16,0
144102,2,16,0,16,14,1
345975,1,0,0,0,1,0
111604,1,0,3,-3,16,1
34753,3,13,3,10,16,1
418527,1,0,0,0,16,0
160623,2,7,0,7,4,1
99767,2,0,7,-7,12,1
299067,1,3,0,3,14,0
87438,3,20,7,13,6,0
271253,1,3,0,3,1,1
254331,4,13,25,-12,11,0
229295,3,24,24,0,17,0
384896,4,13,29,-16,1,1
189844,4,27,17,10,17,1
320331,4,17,24,-7,6,0
305995,2,3,3,0,17,0
105711,3,28,3,25,14,1
148854,4,16,23,-7,16,1
210161,2,0,7,-7,9,0
362251,4,15,17,-2,8,0
389386,4,30,13,17,3,0
218837,1,7,3,4,13,0
337553,4,7,33,-26,14,1
228988,3,14,9,5,17,0
20215,4,23,10,13,10,1
330392,3,10,20,-10,11,0
357180,4,12,26,-14,5,0
4166,1,0,3,-3,2,1
34118,2,3,0,3,16,0
217305,2,0,7,-7,12,0
201053,3,41,0,41,5,0
23732,1,0,0,0,12,0
16920,2,14,13,1,8,1
141929,1,7,0,7,13,1
225952,3,27,7,20,16,0
320116,2,17,0,17,6,1
65739,3,7,16,-9,13,1
147653,1,3,0,3,15,1
137191,1,7,0,7,11,0
223860,3,9,6,3,15,1
251941,1,0,7,-7,10,1
258592,3,13,10,3,13,1
22455,3,24,27,-3,11,1
99293,2,10,0,10,11,1
418897,3,13,17,-4,16,1
12249,3,0,3,-3,6,1
4897,2,14,7,7,3,0
276985,4,23,20,3,4,1
118319,4,26,7,19,2,0
252875,1,0,0,0,11,1
301676,4,17,6,11,15,1
77376,3,7,14,-7,1,1
279554,3,10,13,-3,5,1
75658,4,13,6,7,17,1
89708,3,9,20,-11,7,1
54579,1,0,0,0,8,1
119695,5,20,19,1,3,1
234099,4,27,14,13,2,0
1714,3,28,0,28,1,0
325786,2,6,10,-4,9,0
235547,2,10,13,-3,3,0
221510,1,6,0,6,14,0
414945,1,6,7,-1,15,1
269163,1,0,0,0,17,0
112062,1,7,0,7,17,0
266552,4,10,22,-12,16,0
291295,3,21,19,2,10,0
143749,1,0,0,0,14,1
221854,2,6,0,6,14,1
367906,4,23,20,3,10,0
384956,2,7,0,7,1,0
80146,1,7,0,7,2,0
76472,2,0,14,-14,1,1
270078,2,10,10,0,1,1
12786,1,0,3,-3,6,1
225909,2,14,0,14,16,0
60735,4,28,3,25,11,0
409565,3,35,11,24,12,1
292959,4,10,0,10,11,0
162051,2,21,13,8,4,1
284785,3,26,17,9,7,1
116432,2,3,10,-7,1,1
20358,3,10,13,-3,10,0
110572,2,17,7,10,16,0
386261,4,14,17,-3,2,1
375300,2,7,0,7,14,0
188608,4,20,13,7,16,0
112456,4,13,16,-3,17,1
143824,3,12,7,5,14,0
67585,2,0,20,-20,14,1
230200,4,3,32,-29,17,0
222553,4,17,14,3,14,1
334494,1,7,14,-7,13,0
279152,4,21,23,-2,5,0
70976,1,0,0,0,16,1
106757,3,17,15,2,14,0
366287,3,28,10,18,10,0
128647,2,6,10,-4,7,0
174689,3,9,7,2,10,0
240328,3,7,23,-16,5,1
377924,4,30,16,14,15,1
105576,4,29,21,8,14,1
338161,1,7,7,0,14,1
178868,4,27,21,6,12,1
258116,2,13,13,0,13,1
325378,4,15,20,-5,8,1
52610,1,0,0,0,7,0
318877,3,21,15,6,5,1
391577,3,10,21,-11,4,0
132344,4,31,17,14,9,1
44764,4,13,12,1,3,0
388690,4,20,7,13,3,0
21052,4,28,34,-6,10,0
272804,1,7,0,7,2,0
211864,4,22,10,12,9,1
66836,1,0,0,0,14,0
237173,1,0,0,0,3,1
360005,2,3,26,-23,7,0
212874,1,0,0,0,10,0
130465,2,3,3,0,8,0
391338,4,24,3,21,4,1
335208,4,30,20,10,13,1
203676,3,14,23,-9,6,1
147948,4,31,41,-10,15,1
414078,1,0,3,-3,14,0
115679,2,3,3,0,1,1
173005,2,14,0,14,9,0
286033,1,0,0,0,8,1
42552,4,10,24,-14,3,1
352651,2,0,0,0,3,0
213901,1,3,0,3,10,1
368495,1,0,0,0,11,0
219756,1,14,0,14,13,1
259399,1,0,0,0,13,0
205835,3,20,0,20,7,0
258609,4,13,10,3,13,0
405704,2,10,0,10,10,0
119726,1,7,3,4,3,0
1121,3,10,36,-26,1,0
232099,4,7,33,-26,1,0
194473,3,16,3,13,2,0
77535,3,20,14,6,1,0
381426,4,23,7,16,16,0
201013,2,27,0,27,5,0
291934,4,24,17,7,11,1
271562,2,7,13,-6,2,1
183202,1,0,0,0,14,1
257762,4,3,27,-24,13,0
208757,2,3,6,-3,8,0
286470,4,20,10,10,8,0
172343,1,3,7,-4,9,0
44834,1,0,7,-7,4,1
129139,4,34,28,6,7,0
284879,1,0,0,0,7,0
92159,3,3,37,-34,8,0
343014,2,3,0,3,16,1
139766,4,21,21,0,12,1
394853,1,0,14,-14,5,0
275961,4,20,21,-1,3,0
119031,4,7,33,-26,3,1
256649,4,35,7,28,12,0
378438,3,10,0,10,15,1
73713,4,20,9,11,17,0
201872,4,31,30,1,5,0
210469,3,9,14,-5,9,0
214825,1,0,0,0,11,0
151792,3,14,13,1,17,0
372738,2,0,0,0,13,0
50358,1,0,0,0,6,0
414748,4,10,17,-7,14,1
218517,4,34,17,17,13,0
251186,1,10,7,3,10,0
188334,1,0,0,0,16,0
38302,1,0,0,0,1,0
228927,2,7,9,-2,17,0
383893,4,3,10,-7,1,1
294559,4,24,13,11,12,1
178239,4,6,10,-4,12,0
375549,4,33,14,19,14,1
399876,2,0,0,0,8,0
394992,1,0,7,-7,5,1
35900,2,0,0,0,17,0
405389,1,7,7,0,10,0
78080,1,7,0,7,2,0
97968,2,7,10,-3,11,0
284583,1,7,0,7,7,0
168813,1,7,0,7,7,1
223764,1,0,0,0,15,1
14990,1,0,7,-7,7,0
251737,4,24,3,21,10,0
364244,2,0,13,-13,9,1
127006,3,24,13,11,6,0
378338,4,12,6,6,15,0
198314,2,6,14,-8,3,1
30995,2,0,3,-3,15,0
161666,4,39,24,15,4,0
13924,3,21,7,14,7,0
41748,2,0,7,-7,2,1
237833,2,7,13,-6,4,0
392223,4,10,16,-6,4,0
232046,3,0,24,-24,1,0
160223,4,37,14,23,3,0
377140,3,10,10,0,15,1
64237,4,38,13,25,13,1
329254,4,24,13,11,10,1
282932,1,7,0,7,6,1
330240,3,17,14,3,11,0
399572,4,0,33,-33,7,0
141190,2,3,21,-18,13,1
153482,4,23,17,6,1,1
269270,4,10,19,-9,17,0
202560,2,7,6,1,5,1
272350,2,20,0,20,2,1
196008,4,7,30,-23,2,1
281907,1,7,0,7,6,0
43296,1,0,0,0,3,1
412919,2,6,3,3,14,1
71383,1,7,0,7,16,0
73280,4,14,23,-9,16,0
94601,1,7,0,7,9,0
130849,4,20,12,8,8,0
194392,1,0,0,0,2,1
257173,1,0,9,-9,12,1
114859,4,16,30,-14,1,0
58491,1,0,0,0,10,0
407854,2,3,6,-3,11,0
120644,4,3,27,-24,3,1
187702,3,13,6,7,16,1
158926,2,14,9,5,3,0
273795,3,10,7,3,2,1
126338,2,7,14,-7,6,1
80914,2,6,0,6,3,0
209764,4,16,6,10,8,0
119942,2,6,14,-8,3,0
148814,3,13,16,-3,16,0
47920,1,0,0,0,5,1
38566,4,38,6,32,1,0
189193,3,24,3,21,16,1
180306,2,9,7,2,13,0
36602,1,3,3,0,17,0
207589,3,21,10,11,7,1
259163,3,14,13,1,13,1
367767,4,20,27,-7,10,0
104177,4,27,27,0,13,0
76242,4,12,27,-15,1,1
390123,3,17,21,-4,3,1
228500,2,17,7,10,17,1
293819,3,17,6,11,12,0
115281,3,14,9,5,1,0
420026,3,17,14,3,17,0
301824,4,6,34,-28,15,0
354287,1,7,0,7,4,1
246923,2,14,7,7,8,1
253179,1,0,0,0,11,0
400094,3,17,23,-6,8,1
59642,3,21,3,18,11,0
266108,4,17,10,7,16,0
323876,4,16,30,-14,8,0
65806,4,33,33,0,13,1
107511,4,3,23,-20,15,1
98194,4,35,26,9,11,0
410673,1,0,3,-3,13,0
246901,1,7,7,0,8,0
20911,1,0,0,0,10,0
317217,3,7,16,-9,5,1
394168,2,16,17,-1,5,1
373457,1,0,0,0,13,0
65023,3,0,17,-17,13,0
33148,4,10,42,-32,16,1
29547,2,0,10,-10,14,0
81236,2,7,7,0,3,0
160563,4,23,20,3,4,0
140439,2,7,7,0,12,1
170388,1,14,0,14,8,1
253404,2,14,28,-14,11,1
63724,2,7,9,-2,12,0
293443,4,42,24,18,11,0
5511,2,10,10,0,3,1
238618,1,6,0,6,4,0
337666,3,24,13,11,14,0
162371,3,10,10,0,4,0
63627,3,13,33,-20,12,1
163775,3,10,12,-2,5,0
153097,2,6,10,-4,1,0
100394,4,9,20,-11,12,1
85817,3,13,13,0,5,1
285135,4,3,0,3,7,1
170849,2,7,0,7,8,0
237488,2,14,6,8,3,0
194881,2,0,10,-10,2,0
148942,3,10,12,-2,16,0
331311,3,0,24,-24,11,1
306122,1,0,0,0,17,1
170144,3,7,10,-3,8,1
38281,4,13,14,-1,1,0
189123,1,0,0,0,16,1
296430,2,14,0,14,13,0
418870,2,7,10,-3,16,1
319914,1,13,7,6,6,1
364813,1,3,7,-4,9,1
273170,2,23,0,23,2,1
412896,1,0,0,0,14,0
62240,1,14,7,7,12,0
302203,2,21,7,14,15,1
302580,1,0,0,0,15,1
135550,3,14,6,8,10,1
219165,2,0,3,-3,13,0
197038,4,23,33,-10,3,1
140973,1,0,0,0,13,1
102632,3,15,6,9,13,0
233843,1,7,3,4,2,1
76606,1,7,0,7,1,0
29344,4,21,10,11,14,0
266539,4,10,22,-12,16,1
91992,3,13,23,-10,8,1
378052,4,0,14,-14,15,1
117083,3,7,23,-16,2,0
216694,3,24,6,18,12,1
395960,2,24,10,14,6,0
355067,1,0,6,-6,4,1
258291,3,21,12,9,13,0
70143,2,20,7,13,15,0
413539,2,0,10,-10,14,1
303300,2,27,0,27,16,0
198345,3,20,14,6,3,0
152592,1,0,0,0,17,1
169769,2,0,7,-7,8,0
15732,1,0,3,-3,8,1
251478,1,16,3,13,10,1
253678,2,3,0,3,11,1
366744,3,27,10,17,10,0
250422,1,0,0,0,9,0
250693,4,10,22,-12,10,1
6149,4,7,17,-10,3,0
266960,3,16,10,6,17,1
224631,3,16,10,6,15,1
174603,4,19,21,-2,10,0
48697,2,7,10,-3,5,0
32205,2,14,7,7,15,0
411196,3,3,23,-20,13,0
190021,1,7,0,7,17,0
198937,2,13,16,-3,3,1
212078,4,24,40,-16,9,0
289897,2,6,3,3,10,1
401280,3,13,14,-1,8,0
287542,4,14,40,-26,9,1
252787,2,3,6,-3,11,1
147022,4,27,0,27,15,1
361943,3,10,3,7,7,1
156695,4,14,17,-3,2,0
373375,3,10,7,3,13,1
398063,3,21,21,0,7,0
190139,4,30,3,27,17,1
356401,4,31,20,11,5,0
37163,1,0,0,0,17,1
68456,1,0,0,0,14,1
115201,1,0,0,0,1,0
238429,4,17,36,-19,4,1
78429,3,17,0,17,2,0
233737,2,13,24,-11,2,1
335214,4,37,20,17,13,0
80507,2,5,9,-4,3,0
148486,3,21,3,18,16,1
179885,2,17,9,8,13,1
20725,4,31,20,11,10,0
179112,3,9,6,3,12,0
58247,2,7,10,-3,10,1
39816,1,3,0,3,1,0
265845,1,0,0,0,16,1
19659,1,0,0,0,10,0
311313,1,7,0,7,2,0
102588,2,5,6,-1,13,1
62575,2,3,10,-7,12,1
221092,2,0,0,0,14,0
25509,1,0,0,0,12,1
299257,2,17,0,17,14,0
196518,2,10,3,7,2,1
48212,1,0,3,-3,5,1
176775,1,3,0,3,11,0
108183,1,3,0,3,15,0
298347,1,0,7,-7,14,0
368629,4,16,13,3,11,0
91411,1,0,0,0,8,1
27629,2,7,13,-6,13,0
385736,2,7,0,7,1,1
54006,1,0,0,0,8,0
172038,2,7,0,7,9,0
305009,4,24,20,4,16,0
74532,3,0,3,-3,17,0
233998,1,14,0,14,2,0
109108,2,10,7,3,15,1
192469,2,0,17,-17,1,0
253257,3,3,7,-4,11,1
385044,4,24,22,2,1,0
31260,1,0,0,0,15,1
92341,4,23,0,23,8,0
118440,4,20,10,10,2,1
54439,1,0,0,0,8,1
144488,4,17,33,-16,14,1
241385,2,7,14,-7,5,0
275769,3,16,3,13,3,0
157701,2,10,3,7,2,1
77020,1,0,7,-7,1,1
149180,5,31,31,0,16,1
123481,2,0,0,0,4,1
51717,2,0,10,-10,7,0
25300,3,37,14,23,12,0
211910,1,0,0,0,9,1
202061,1,0,0,0,5,0
249736,3,21,21,0,9,0
72299,1,0,0,0,16,1
256730,2,0,6,-6,12,0
309097,1,9,3,6,1,1
270367,1,0,0,0,1,1
265433,1,0,0,0,16,0
102444,2,3,3,0,13,0
404895,1,3,3,0,10,0
200861,2,14,0,14,4,0
76180,2,9,13,-4,1,0
215566,1,6,0,6,11,1
161603,3,30,13,17,4,1
2451,4,28,19,9,2,0
42840,4,6,37,-31,3,0
260104,3,6,21,-15,14,0
255780,2,10,0,10,12,0
154956,4,29,24,5,1,1
339292,3,31,0,31,15,0
274571,3,24,23,1,3,1
139324,4,20,13,7,12,0
61523,2,7,7,0,11,1
67215,3,0,3,-3,14,1
162509,3,21,10,11,4,0
327903,4,30,24,6,10,0
109791,1,0,0,0,16,0
27334,2,21,3,18,13,0
217033,3,20,3,17,12,1
378274,2,0,3,-3,15,1
9335,3,21,7,14,5,1
397255,1,0,7,-7,6,1
111621,1,7,10,-3,16,1
118225,1,9,0,9,2,0
86541,2,20,3,17,5,1
254761,3,10,3,7,11,1
378174,3,24,16,8,15,1
124281,3,27,17,10,5,0
395415,4,28,3,25,5,1
57672,4,17,17,0,10,0
315138,1,6,7,-1,4,1
133880,2,3,6,-3,9,0
312950,1,0,0,0,3,0
291881,2,10,10,0,11,1
121540,3,16,7,9,4,0
12731,3,52,0,52,6,1
93195,3,0,13,-13,9,1
17861,3,24,17,7,9,0
232935,2,7,3,4,2,0
250582,1,0,0,0,10,1
365685,1,7,3,4,9,1
167302,1,3,10,-7,7,1
309536,2,6,0,6,1,1
323184,2,7,0,7,7,0
7042,1,0,0,0,4,0
174542,3,10,14,-4,10,1
398273,1,0,0,0,7,1
151077,3,17,10,7,17,0
40934,3,16,20,-4,2,0
404779,2,10,13,-3,10,1
218821,1,0,3,-3,13,1
395323,1,14,0,14,5,1
368457,4,30,21,9,11,0
199545,2,20,10,10,4,1
275734,2,7,0,7,3,1
402347,4,26,24,2,9,0
129297,4,17,13,4,7,0
38148,5,9,9,0,1,0
400834,3,24,13,11,8,0
158694,4,24,7,17,3,0
75767,3,35,26,9,1,1
237978,2,3,10,-7,4,1
117652,2,19,13,6,2,1
337654,3,21,13,8,14,1
294419,4,19,9,10,12,0
320040,4,49,36,13,6,1
203245,4,10,24,-14,5,1
288486,1,3,0,3,9,0
5428,4,20,23,-3,3,0
204814,4,28,31,-3,6,0
258621,4,13,13,0,13,0
244774,1,0,0,0,7,1
380788,2,9,20,-11,16,0
358361,1,6,7,-1,6,1
153441,3,20,17,3,1,0
137060,2,14,3,11,11,0
273195,3,27,7,20,2,0
180480,2,14,17,-3,13,1
186505,4,17,20,-3,15,1
145859,1,0,0,0,15,1
249540,2,14,3,11,9,1
277590,3,12,14,-2,4,1
94301,2,3,0,3,9,0
109486,4,12,16,-4,16,0
127881,1,10,0,10,6,0
188624,4,20,19,1,16,0
175808,2,14,0,14,11,0
132736,3,10,17,-7,9,1
399819,4,11,27,-16,8,0
403296,2,6,0,6,9,0
270237,2,3,21,-18,1,0
213913,1,10,0,10,10,0
318368,1,0,0,0,5,1
53589,3,14,15,-1,8,0
296661,3,3,16,-13,13,1
189611,2,7,3,4,17,1
357383,2,14,10,4,5,0
283465,4,23,14,9,7,1
404422,1,6,0,6,10,1
168102,1,6,0,6,7,0
119064,1,0,7,-7,3,1
155400,3,13,3,10,2,1
319505,3,10,17,-7,6,1
325927,3,13,7,6,9,0
105266,4,10,24,-14,14,1
43532,3,10,3,7,3,1
409594,4,42,20,22,12,1
368866,3,24,3,21,11,1
36899,1,0,7,-7,17,0
39237,2,3,3,0,1,0
95677,2,10,3,7,10,1
365918,4,14,21,-7,9,0
147310,4,7,31,-24,15,1
304576,4,31,31,0,16,0
193111,3,13,6,7,1,1
193157,4,16,6,10,1,0
34286,3,20,9,11,16,1
216844,2,7,14,-7,12,1
294025,1,7,7,0,12,1
70687,1,0,3,-3,15,1
322347,2,14,7,7,7,1
171847,4,26,20,6,9,1
30252,1,3,7,-4,14,1
113274,2,10,21,-11,17,1
66037,2,7,0,7,13,0
286966,1,0,0,0,8,1
508,2,7,6,1,1,1
377406,3,7,13,-6,15,0
174557,4,10,14,-4,10,1
270582,3,13,14,-1,1,0
269387,3,7,17,-10,1,0
14684,4,33,21,12,7,1
139433,3,24,3,21,12,0
313131,2,7,10,-3,3,1
251464,1,9,3,6,10,1
79850,1,0,6,-6,2,1
302187,2,21,0,21,15,0
297359,2,6,10,-4,13,0
45828,1,0,0,0,4,1
415460,3,23,3,20,15,1
399680,4,19,9,10,8,1
207289,2,0,14,-14,7,1
233586,2,17,27,-10,2,1
297456,4,38,24,14,13,0
149570,3,14,16,-2,16,0
140539,4,21,29,-8,12,1
62774,3,17,0,17,12,1
212081,1,0,0,0,10,1
345946,4,27,23,4,17,1
405759,3,10,7,3,10,0
42690,3,7,10,-3,3,0
100308,2,6,7,-1,12,1
61714,3,24,24,0,12,1
63044,3,16,21,-5,12,1
124943,1,0,0,0,5,0
240604,2,13,7,6,5,0
165032,2,7,16,-9,6,0
278041,3,10,10,0,4,0
35719,1,3,0,3,17,0
320259,2,14,7,7,6,0
314439,1,7,0,7,3,1
339104,2,10,0,10,15,0
337609,2,14,7,7,14,0
117138,1,6,3,3,2,1
400147,4,27,23,4,8,0
248251,1,0,0,0,8,0
354148,1,0,0,0,4,0
315228,3,17,10,7,4,1
137786,4,17,37,-20,11,0
189254,4,53,11,42,16,0
30233,1,0,0,0,14,1
84812,1,0,0,0,4,0
259097,1,0,0,0,13,1
324904,3,17,20,-3,8,0
277385,2,17,9,8,4,1
136833,5,20,21,-1,11,0
378193,4,24,16,8,15,1
159946,4,45,17,28,3,0
363892,4,20,29,-9,8,1
78819,1,0,0,0,2,0
412506,3,24,7,17,14,0
394634,3,17,14,3,5,1
50203,1,7,0,7,6,0
410504,4,18,26,-8,13,1
279479,1,7,6,1,5,1
6510,2,3,0,3,3,0
414126,3,10,13,-3,14,0
82082,4,20,17,3,3,1
346254,3,40,3,37,1,1
62215,1,0,0,0,12,0
335792,1,0,0,0,13,1
174082,3,0,36,-36,10,1
132318,4,31,17,14,9,1
100362,3,9,20,-11,12,1
64412,1,0,3,-3,13,1
116449,3,6,10,-4,1,1
419459,2,10,6,4,16,1
293815,3,17,6,11,12,0
350125,1,0,0,0,2,1
38793,2,3,10,-7,1,0
352609,4,34,23,11,3,1
155402,3,13,3,10,2,1
71132,1,12,0,12,16,0
221233,2,0,16,-16,14,1
371091,4,13,27,-14,12,0
174479,1,7,7,0,10,1
251512,2,16,13,3,10,0
334251,2,6,7,-1,13,1
43207,2,14,7,7,3,0
281174,3,21,13,8,6,1
126459,1,0,3,-3,6,0
292333,3,12,13,-1,11,0
229080,2,10,0,10,17,0
288020,1,0,0,0,9,0
188183,4,17,13,4,16,1
18781,4,13,13,0,9,1
197738,3,14,10,4,3,0
78101,1,7,3,4,2,0
242853,1,7,3,4,6,1
396330,1,0,0,0,6,1
320755,3,17,23,-6,6,0
194601,2,21,6,15,2,0
381875,4,25,28,-3,17,1
256188,4,30,22,8,12,1
141673,2,23,14,9,13,0
236779,2,0,9,-9,3,0
367272,2,3,3,0,10,0
157991,1,0,0,0,3,0
192120,2,0,6,-6,1,0
212703,1,0,7,-7,10,0
129774,4,17,24,-7,7,0
177813,2,0,3,-3,12,1
34083,2,0,0,0,16,0
206000,4,13,10,3,7,1
84157,3,10,0,10,4,0
103566,4,33,0,33,13,0
345828,1,0,7,-7,17,1
116910,3,14,10,4,2,0
232323,2,6,3,3,1,0
89811,2,3,3,0,7,1
111003,4,14,20,-6,16,0
9741,1,0,7,-7,5,1
274633,1,0,0,0,3,1
3724,2,10,0,10,2,0
167944,1,0,0,0,7,0
30119,2,9,7,2,14,1
414163,4,10,20,-10,14,0
322238,4,0,27,-27,7,0
275058,4,34,20,14,3,1
38499,2,10,3,7,1,1
178385,4,28,27,1,12,1
10615,2,0,10,-10,5,1
356295,1,14,0,14,5,0
91476,2,12,0,12,8,1
201402,1,0,0,0,5,0
195651,2,7,7,0,2,0
26877,2,10,6,4,13,0
172181,1,0,0,0,9,0
185663,1,7,0,7,15,0
96115,1,0,13,-13,10,1
268852,1,0,7,-7,17,0
421363,2,6,10,-4,17,0
136913,3,0,13,-13,11,0
391344,4,24,3,21,4,0
15082,3,10,26,-16,7,1
391879,3,13,13,0,4,0
413899,4,17,9,8,14,1
253373,2,7,14,-7,11,1
332124,1,0,0,0,12,1
80349,2,13,6,7,2,1
215003,2,10,0,10,11,0
189349,3,10,10,0,16,1
416755,2,7,7,0,15,1
225421,4,27,38,-11,15,0
208035,3,21,0,21,8,0
400653,2,3,0,3,8,1
337647,3,14,13,1,14,1
49526,3,7,3,4,6,1
101499,1,10,0,10,12,0
337858,1,0,0,0,14,1
251342,2,14,7,7,10,0
106538,1,7,0,7,14,0
265324,2,7,0,7,16,0
11655,2,14,0,14,6,1
238003,2,10,10,0,4,0
12310,4,6,6,0,6,0
420923,2,7,13,-6,17,0
134336,3,16,21,-5,10,1
146454,4,24,3,21,15,1
74609,1,0,0,0,17,1
142497,3,27,10,17,13,0
254605,3,14,14,0,11,0
283071,1,3,0,3,7,0
100292,1,6,7,-1,12,1
53708,3,7,0,7,8,0
51510,4,34,24,10,7,0
327316,4,16,20,-4,9,0
296037,3,3,7,-4,13,1
221902,3,19,7,12,14,0
98878,2,7,7,0,11,0
32979,3,0,24,-24,15,1
417794,1,7,0,7,16,0
230390,2,0,0,0,1,1
111475,1,7,0,7,16,0
398091,3,24,28,-4,7,0
2486,1,0,0,0,2,1
213770,1,13,0,13,10,1
259342,3,21,27,-6,13,0
88774,2,13,3,10,6,0
59987,4,3,24,-21,11,0
142614,2,13,3,10,13,0
163382,1,0,6,-6,5,1
306800,4,19,36,-17,17,1
37408,4,24,0,24,17,0
208878,2,7,0,7,8,0
257456,1,0,0,0,13,0
314522,4,24,7,17,3,0
402437,3,21,12,9,9,1
26700,2,3,7,-4,13,0
228507,3,20,7,13,17,0
60107,3,20,12,8,11,0
197873,2,11,7,4,3,1
354651,3,10,7,3,4,0
258785,1,7,0,7,13,0
209323,1,0,7,-7,8,1
33195,1,7,0,7,16,1
225099,4,13,14,-1,15,0
221681,1,3,0,3,14,1
276917,2,14,0,14,4,0
298121,3,3,31,-28,13,0
293839,4,24,19,5,12,1
104175,4,27,27,0,13,0
53116,3,19,30,-11,7,0
268813,4,38,10,28,17,0
200989,2,14,0,14,5,1
273954,3,7,9,-2,2,1
189151,2,21,0,21,16,0
117931,2,7,3,4,2,0
225415,4,27,38,-11,15,0
402195,4,19,14,5,9,1
358708,2,7,7,0,6,0
368468,4,37,28,9,11,0
9988,4,3,3,0,5,0
46696,1,0,0,0,4,1
122713,2,7,16,-9,4,0
140989,1,7,0,7,13,1
303472,3,22,10,12,16,1
381715,4,20,24,-4,17,0
43568,4,24,3,21,3,1
233136,3,29,3,26,2,0
395162,1,3,7,-4,5,1
150257,1,0,0,0,16,1
248589,2,7,3,4,9,1
24403,3,13,7,6,12,1
103398,3,10,20,-10,13,0
154780,3,13,16,-3,1,0
319345,3,13,21,-8,6,1
129325,1,0,6,-6,7,0
320410,2,14,0,14,6,1
60490,2,14,7,7,11,1
205963,2,6,10,-4,7,1
303962,4,14,34,-20,16,0
386969,3,7,21,-14,2,0
44464,3,17,9,8,3,0
394777,3,21,0,21,5,1
417821,2,10,0,10,16,0
62887,3,10,3,7,12,0
414928,4,42,21,21,15,1
102338,3,13,13,0,13,0
185671,1,7,0,7,15,1
361200,2,0,10,-10,7,1
117231,4,23,17,6,2,1
324395,2,7,3,4,8,1
303888,2,0,17,-17,16,1
278863,4,14,31,-17,5,1
296487,3,17,3,14,13,1
310501,4,20,9,11,2,1
402293,3,13,16,-3,9,1
136519,1,0,7,-7,11,1
59917,2,3,0,3,11,0
59249,4,28,58,-30,10,0
183745,1,0,7,-7,14,1
205103,4,22,30,-8,6,1
283033,4,27,3,24,6,1
308196,1,7,7,0,1,0
324439,3,14,6,8,8,1
51938,4,13,16,-3,7,0
1362,2,7,0,7,1,0
321194,4,3,19,-16,6,1
386194,2,6,3,3,2,0
252239,4,26,27,-1,10,0
32543,3,20,3,17,15,0
84759,3,10,24,-14,4,1
168530,1,0,3,-3,7,1
200633,3,27,21,6,4,0
287837,3,28,17,11,9,0
186867,1,0,0,0,15,1
181397,2,17,14,3,13,0
57690,4,24,23,1,10,0
367013,3,3,31,-28,10,1
285940,3,26,7,19,8,1
61406,3,13,3,10,11,1
419679,1,0,0,0,17,1
125419,2,7,0,7,5,0
177130,3,24,13,11,11,0
137068,2,14,3,11,11,0
393098,3,10,3,7,4,1
60830,3,10,16,-6,11,0
48403,2,3,17,-14,5,1
372554,1,0,0,0,13,1
383820,2,3,7,-4,1,1
2281,3,10,10,0,1,1
42642,2,0,7,-7,3,0
392418,4,40,45,-5,4,0
267855,3,26,17,9,17,1
93003,2,10,3,7,8,0
223139,4,40,24,16,14,0
34291,3,20,9,11,16,1
18209,4,29,20,9,9,0
56302,3,3,20,-17,9,0
326796,2,3,14,-11,9,1
85074,4,31,16,15,4,1
207019,2,28,0,28,7,0
352390,2,28,7,21,3,1
242087,4,20,16,4,5,0
335806,1,7,0,7,13,0
104535,4,14,38,-24,13,1
155178,1,7,6,1,1,0
136259,2,12,7,5,11,1
347875,1,0,0,0,1,1
51097,1,0,0,0,7,1
300855,1,0,7,-7,15,0
273039,3,6,3,3,2,1
259860,1,7,7,0,14,0
344263,3,7,13,-6,17,1
284121,1,0,3,-3,7,0
86025,4,22,22,0,5,1
141684,3,23,20,3,13,0
106214,4,7,10,-3,14,0
334090,2,6,0,6,13,1
66856,1,0,7,-7,14,0
51935,4,13,16,-3,7,1
26803,4,13,43,-30,13,1
247039,1,0,0,0,8,0
399394,4,30,10,20,7,1
108004,4,6,20,-14,15,1
134820,3,48,17,31,10,0
421407,3,24,20,4,17,0
407681,1,0,0,0,11,1
109861,2,17,0,17,16,1
260058,2,3,7,-4,14,0
44243,2,10,13,-3,3,1
62557,1,3,7,-4,12,1
403540,1,7,0,7,9,0
37121,4,16,17,-1,17,0
141438,4,13,23,-10,13,1
389681,4,24,16,8,3,1
168232,1,0,7,-7,7,1
307430,1,14,3,11,17,0
395242,3,10,13,-3,5,0
124318,4,34,20,14,5,0
118473,4,27,10,17,2,0
281709,4,31,30,1,6,0
102074,3,35,10,25,12,1
169498,2,0,28,-28,8,1
204750,3,14,14,0,6,0
137934,4,27,15,12,11,1
136943,3,3,13,-10,11,1
369612,4,20,6,14,11,0
397701,1,6,0,6,7,0
268194,4,12,17,-5,17,1
415193,4,17,24,-7,15,0
167842,2,7,13,-6,7,0
196731,3,54,0,54,3,0
378742,3,14,7,7,15,1
55504,1,10,0,10,9,0
192813,3,0,15,-15,1,1
329451,1,0,0,0,10,1
43714,4,21,17,4,3,0
109787,4,27,0,27,16,0
24472,1,0,0,0,12,0
369543,2,11,0,11,11,1
317356,2,0,0,0,5,1
8420,1,0,0,0,4,1
338530,3,20,17,3,14,0
131308,4,27,24,3,8,1
417194,2,3,17,-14,16,1
341416,4,0,13,-13,16,0
420318,3,17,3,14,17,0
242285,2,7,7,0,6,1
389925,2,15,10,5,3,1
32397,3,31,6,25,15,1
410710,2,10,3,7,13,1
221093,2,0,0,0,14,0
27971,4,21,17,4,13,0
314584,1,7,0,7,3,1
384208,4,32,20,12,1,0
399262,4,13,30,-17,7,1
314631,3,7,7,0,3,1
421432,4,24,20,4,17,0
117998,3,20,6,14,2,0
353230,2,7,10,-3,4,1
323578,4,34,24,10,7,0
56752,3,7,13,-6,9,0
276184,2,24,3,21,3,0
106459,3,16,0,16,14,0
304109,4,13,30,-17,16,1
123746,2,7,3,4,5,0
99907,2,3,3,0,12,1
192298,2,24,3,21,1,1
328370,4,3,40,-37,10,0
165938,1,3,7,-4,6,0
177209,1,6,0,6,11,1
225399,4,27,35,-8,15,1
320873,3,3,14,-11,6,0
6287,4,16,17,-1,3,0
102622,2,12,6,6,13,1
307087,4,24,6,18,17,1
208962,4,20,14,6,8,1
64394,1,0,3,-3,13,1
383550,3,14,13,1,17,1
293585,4,27,20,7,11,1
309143,3,26,3,23,1,1
352143,4,9,20,-11,3,0
177115,3,24,13,11,11,1
59454,2,3,10,-7,11,0
319236,4,17,20,-3,5,1
8415,1,0,0,0,4,1
6694,3,3,20,-17,3,0
414173,4,17,20,-3,14,0
121508,2,9,7,2,4,1
281016,3,17,13,4,6,1
233355,4,19,26,-7,2,1
65256,1,0,7,-7,13,0
355810,1,6,0,6,5,0
191756,4,16,23,-7,17,0
157450,3,16,17,-1,2,0
140107,2,7,0,7,12,1
5925,2,7,22,-15,3,0
258595,3,13,10,3,13,1
27140,1,0,6,-6,13,0
337964,4,20,0,20,14,1
196455,4,20,28,-8,2,1
179792,4,6,27,-21,12,1
201029,3,27,0,27,5,0
233539,1,7,7,0,2,0
180922,2,10,7,3,13,0
170666,1,0,0,0,8,1
31537,4,10,17,-7,15,0
76722,4,16,14,2,1,1
168413,2,0,3,-3,7,0
115906,4,7,23,-16,1,0
116868,2,7,7,0,2,1
310736,2,3,3,0,2,0
329095,3,17,7,10,10,0
228683,3,16,23,-7,17,0
176251,4,14,27,-13,11,1
17119,4,23,10,13,9,0
259464,3,21,10,11,13,0
233526,1,0,7,-7,2,0
225192,2,3,7,-4,15,1
271558,2,7,6,1,2,0
360513,4,17,20,-3,7,0
59029,2,0,10,-10,10,1
297293,4,26,6,20,13,1
280058,4,12,23,-11,5,1
123206,3,6,21,-15,4,0
171460,2,7,3,4,9,0
263175,2,3,14,-11,15,1
63408,1,0,3,-3,12,1
266328,2,7,0,7,16,1
58704,2,7,10,-3,10,1
106733,2,14,12,2,14,0
354095,3,19,0,19,4,1
173421,1,0,7,-7,10,0
210384,1,0,0,0,9,0
110524,4,20,13,7,16,0
23823,4,24,7,17,12,0
302744,1,0,3,-3,15,1
402755,3,24,7,17,9,0
99594,2,0,3,-3,11,0
219210,3,13,3,10,13,0
309392,2,0,0,0,1,0
235652,1,0,3,-3,3,0
316621,4,9,12,-3,4,1
205009,2,9,7,2,6,0
97758,1,0,0,0,11,1
87955,1,0,0,0,6,0
205037,3,9,17,-8,6,0
374567,3,17,13,4,14,1
281936,2,7,14,-7,6,1
168480,4,3,24,-21,7,0
163076,1,0,10,-10,5,1
609,1,0,0,0,1,0
374239,1,7,0,7,13,0
347841,4,16,8,8,1,0
189101,4,31,30,1,16,0
196911,4,10,22,-12,3,1
382002,3,0,30,-30,17,1
124465,4,16,14,2,5,0
384780,1,0,0,0,1,1
357101,2,6,14,-8,5,1
41973,4,38,6,32,2,0
246625,2,17,3,14,8,1
223411,3,10,19,-9,15,1
227423,2,7,7,0,16,1
303411,2,10,0,10,16,0
156493,3,0,6,-6,2,1
355651,4,38,17,21,5,0
50403,2,7,7,0,6,0
307163,2,0,10,-10,17,0
110957,3,7,10,-3,16,1
101567,3,13,24,-11,12,0
335375,1,0,0,0,13,0
133330,3,7,6,1,9,1
50515,1,0,0,0,6,0
69040,4,27,24,3,15,0
397789,4,24,14,10,7,1
138605,1,3,0,3,12,1
155474,1,0,0,0,2,1
304497,3,3,14,-11,16,1
405905,2,14,0,14,11,1
66571,1,0,14,-14,14,1
324785,4,33,14,19,8,0
135806,2,7,14,-7,10,0
250657,3,3,22,-19,10,1
281300,2,14,6,8,6,0
216503,2,27,8,19,12,0
287890,1,0,0,0,9,0
360345,4,7,20,-13,7,1
282949,2,7,3,4,6,1
312648,2,13,7,6,3,1
310056,4,9,10,-1,2,0
407855,2,3,7,-4,11,1
117019,2,0,10,-10,2,1
173817,4,17,3,14,10,1
194467,3,16,3,13,2,0
120011,4,23,38,-15,3,1
377959,1,0,0,0,15,0
388043,4,20,6,14,2,0
5790,2,21,7,14,3,1
273490,3,14,13,1,2,0
339268,2,21,0,21,15,1
252298,2,0,13,-13,10,0
258433,3,21,13,8,13,0
265814,4,20,12,8,16,0
358395,2,9,13,-4,6,1
19270,2,7,14,-7,10,0
393054,1,0,3,-3,4,1
85467,2,14,3,11,5,1
25326,4,39,14,25,12,1
128871,1,0,0,0,7,1
135808,2,7,14,-7,10,1
111195,1,7,0,7,16,0
311124,4,13,13,0,2,1
62871,2,3,3,0,12,1
281462,2,0,10,-10,6,1
273518,4,14,21,-7,2,1
347485,3,12,16,-4,1,0
313987,1,0,0,0,3,1
339042,4,20,10,10,15,1
297031,1,13,0,13,13,1
172841,2,14,0,14,9,0
292135,2,21,0,21,11,0
64397,1,0,3,-3,13,1
222893,1,0,3,-3,14,1
411809,3,0,34,-34,13,0
370263,2,0,14,-14,12,0
138727,4,28,38,-10,12,1
38548,3,24,6,18,1,1
327616,4,10,22,-12,10,1
130924,2,0,14,-14,8,1
389642,3,17,10,7,3,0
111472,1,7,0,7,16,0
235505,1,0,7,-7,3,0
61166,4,0,20,-20,11,0
69068,1,0,0,0,15,1
197032,4,23,33,-10,3,1
136640,4,15,19,-4,11,0
352158,4,15,20,-5,3,0
92030,4,27,26,1,8,1
307350,3,14,22,-8,17,1
112445,4,13,13,0,17,0
248563,1,0,0,0,9,1
388076,4,27,9,18,2,1
11544,3,6,10,-4,6,1
180337,3,12,7,5,13,0
61439,4,16,17,-1,11,1
153481,4,23,17,6,1,1
24737,4,20,20,0,12,0
371903,3,27,10,17,12,1
148820,4,13,23,-10,16,1
270676,2,3,3,0,1,1
271491,4,21,0,21,1,0
118852,3,20,7,13,2,1
277828,2,7,7,0,4,0
323344,2,7,0,7,7,1
357482,1,0,3,-3,5,1
382858,4,28,3,25,17,1
182170,3,26,7,19,13,0
162515,3,21,10,11,4,1
296409,1,7,0,7,13,1
357791,1,3,7,-4,6,0
34863,2,17,7,10,16,1
46611,2,3,0,3,4,1
214809,4,10,27,-17,11,0
181217,2,0,0,0,13,0
328628,3,20,35,-15,10,1
334324,1,0,0,0,13,0
368881,3,31,3,28,11,0
196494,1,7,3,4,2,0
373416,4,10,17,-7,13,0
417411,4,24,17,7,16,0
415841,2,7,13,-6,15,0
398386,4,3,27,-24,7,0
191068,2,7,0,7,17,0
110164,3,20,17,3,16,0
280206,4,28,14,14,5,1
301344,3,17,7,10,15,1
47652,2,3,17,-14,5,0
237905,4,14,27,-13,4,1
189375,4,20,17,3,16,1
388344,3,17,12,5,2,1
73567,4,9,41,-32,17,1
372627,3,14,6,8,13,0
201627,2,7,10,-3,5,1
238717,4,19,17,2,4,1
301911,2,11,13,-2,15,0
335555,2,3,0,3,13,1
249138,4,28,28,0,9,0
353421,3,18,0,18,4,0
22956,4,3,26,-23,11,0
81865,2,0,24,-24,3,1
96985,4,22,17,5,10,1
235678,2,0,3,-3,3,0
393245,3,14,20,-6,5,1
314420,4,10,24,-14,3,1
114748,1,0,0,0,1,0
237071,2,0,23,-23,3,1
40135,2,13,0,13,2,0
383205,1,14,0,14,17,0
188516,2,0,3,-3,16,1
364890,3,13,20,-7,9,1
120203,1,7,0,7,3,0
251652,1,6,3,3,10,0
91525,4,19,10,9,8,1
275397,1,0,7,-7,3,0
56194,1,0,0,0,9,0
13630,3,13,10,3,7,0
173890,2,6,10,-4,10,1
340783,3,17,10,7,15,0
257848,3,7,9,-2,13,0
176073,4,24,8,16,11,0
289244,4,30,20,10,9,1
106158,3,0,0,0,14,1
356212,4,29,7,22,5,0
371119,1,0,6,-6,12,1
69801,1,7,0,7,15,0
294003,1,0,0,0,12,0
366985,2,0,24,-24,10,0
1399,3,10,0,10,1,0
266242,3,31,19,12,16,1
60917,1,0,0,0,11,0
130435,1,0,0,0,8,1
409107,3,3,10,-7,12,1
336660,1,0,0,0,14,0
116961,4,35,13,22,2,0
257557,4,19,10,9,13,1
387296,4,6,10,-4,2,0
396990,2,7,3,4,6,0
227566,2,20,0,20,16,1
155933,4,17,16,1,2,1
339180,4,30,13,17,15,0
47578,4,40,6,34,5,1
314091,4,30,20,10,3,1
323574,4,34,24,10,7,1
275395,1,0,7,-7,3,1
180436,2,7,7,0,13,1
98729,2,27,3,24,11,1
331190,3,10,13,-3,11,0
357285,3,3,19,-16,5,1
396864,3,20,10,10,6,1
383158,4,26,17,9,17,0
155925,4,17,16,1,2,1
242451,2,3,7,-4,6,1
250017,2,10,6,4,9,1
69424,2,23,3,20,15,1
339096,2,3,0,3,15,0
237268,4,23,0,23,3,1
139198,1,0,6,-6,12,1
155398,3,13,3,10,2,0
164956,4,3,16,-13,6,1
420450,2,0,14,-14,17,1
346130,4,18,12,6,1,0
148577,2,0,6,-6,16,1
12532,2,0,17,-17,6,1
150303,2,17,7,10,16,1
258772,4,3,37,-34,13,1
157311,4,19,3,16,2,0
284618,2,14,10,4,7,0
155586,4,23,10,13,2,0
282836,3,9,13,-4,6,0
142521,4,30,13,17,13,0
53130,3,19,38,-19,7,1
219637,2,10,0,10,13,0
225736,1,3,0,3,16,0
293117,4,10,30,-20,11,0
144859,2,14,0,14,14,1
394824,4,31,6,25,5,0
110787,3,3,10,-7,16,1
55196,1,7,0,7,9,0
352592,4,34,23,11,3,1
70251,1,7,0,7,15,0
330315,1,0,0,0,11,0
34843,2,10,0,10,16,0
277128,4,10,17,-7,4,0
324196,1,0,0,0,8,0
331347,4,0,30,-30,11,1
200010,3,24,17,7,4,0
299276,2,23,0,23,14,0
218458,3,24,14,10,13,0
219944,2,6,7,-1,13,0
375788,2,13,0,13,14,1
91002,2,3,0,3,7,0
193897,4,24,10,14,1,0
337328,2,14,7,7,14,0
270880,3,16,13,3,1,1
321715,2,3,3,0,7,1
138421,1,7,0,7,12,1
318328,4,9,19,-10,5,0
249933,4,18,23,-5,9,1
242126,2,13,7,6,6,1
22582,2,13,3,10,11,0
173072,4,24,19,5,9,1
331987,2,0,0,0,12,0
104736,2,16,13,3,14,1
24782,1,6,0,6,12,1
200363,1,0,0,0,4,0
65351,4,13,21,-8,13,0
253177,1,0,0,0,11,0
207979,1,13,0,13,8,1
95937,1,0,0,0,10,1
383414,3,10,9,1,17,0
13549,1,0,0,0,7,1
207406,1,7,0,7,7,1
1233,2,10,6,4,1,0
139691,2,0,0,0,12,1
12990,2,0,7,-7,6,0
99935,3,10,6,4,12,0
266047,2,10,3,7,16,1
319667,3,26,3,23,6,1
295103,2,7,14,-7,12,1
388588,2,14,0,14,3,0
199395,3,13,10,3,4,1
44562,2,7,14,-7,3,0
82846,4,15,16,-1,3,1
334536,2,14,17,-3,13,0
224217,4,0,23,-23,15,0
419249,1,0,0,0,16,1
395144,1,0,0,0,5,1
235393,2,21,7,14,3,0
290539,3,17,20,-3,10,1
381277,4,24,17,7,16,0
157169,4,19,20,-1,2,1
275904,2,13,12,1,3,1
291843,2,0,7,-7,11,0
134989,4,7,27,-20,10,1
330108,3,0,13,-13,11,1
246954,3,20,10,10,8,0
124113,3,3,21,-18,5,1
123524,3,10,3,7,4,0
246232,4,21,16,5,7,0
374430,3,18,0,18,14,1
83519,2,0,7,-7,4,1
391867,2,13,10,3,4,0
174266,4,10,33,-23,10,1
413160,4,40,42,-2,14,0
360023,2,3,26,-23,7,1
39313,4,17,27,-10,1,0
390461,4,21,33,-12,3,1
473,1,0,6,-6,1,0
334379,2,7,10,-3,13,0
33465,1,0,0,0,16,0
157303,4,19,3,16,2,1
321800,4,21,9,12,7,1
143335,2,0,13,-13,14,1
49907,1,7,0,7,6,1
261615,4,12,15,-3,14,0
224766,3,5,3,2,15,0
233686,1,7,7,0,2,1
379529,1,0,3,-3,16,1
350650,4,13,3,10,2,1
342513,1,0,0,0,16,0
231432,2,7,6,1,1,1
30092,1,0,0,0,14,1
420350,3,17,10,7,17,0
196214,2,7,3,4,2,0
356767,1,0,0,0,5,1
103869,4,26,0,26,13,1
22269,2,0,0,0,11,0
335469,4,13,12,1,13,1
294658,2,3,7,-4,12,0
268188,4,12,17,-5,17,0
385596,3,3,17,-14,1,0
410832,1,14,3,11,13,0
359433,1,0,7,-7,6,1
48336,4,22,20,2,5,1
10174,2,6,3,3,5,0
401782,1,7,0,7,9,0
311281,4,9,3,6,2,0
349734,3,17,7,10,2,1
194557,1,7,0,7,2,1
373489,1,0,10,-10,13,0
258983,2,0,16,-16,13,1
178728,4,11,26,-15,12,1
38620,1,0,0,0,1,0
291977,1,0,0,0,11,0
166721,2,7,3,4,6,1
370843,1,0,0,0,12,1
285090,2,3,0,3,7,1
393492,1,0,0,0,5,0
295088,2,7,6,1,12,0
283125,2,3,3,0,7,1
193040,1,0,0,0,1,1
268944,3,6,36,-30,17,1
22317,3,0,3,-3,11,1
33469,1,0,0,0,16,0
316914,3,9,15,-6,4,1
269202,2,3,3,0,17,1
301784,3,0,27,-27,15,1
133940,3,6,6,0,9,1
203679,4,14,23,-9,6,0
421199,1,3,0,3,17,1
293191,2,13,7,6,11,0
395189,2,10,10,0,5,1
219367,3,23,13,10,13,1
248370,4,29,10,19,8,0
214272,3,14,10,4,11,1
199980,2,17,10,7,4,1
211674,3,23,3,20,9,1
416320,2,13,3,10,15,0
366295,3,28,10,18,10,1
256824,4,13,19,-6,12,0
365516,4,17,25,-8,9,1
272921,4,20,20,0,2,0
21721,3,17,14,3,11,1
233070,1,0,0,0,2,0
415709,2,7,10,-3,15,1
262309,3,10,9,1,15,0
371280,2,0,10,-10,12,1
331663,4,31,33,-2,11,0
64742,3,21,0,21,13,1
69402,2,13,3,10,15,1
111777,1,3,7,-4,17,1
152806,3,14,7,7,17,0
250226,4,24,23,1,9,1
342820,1,7,0,7,16,0
84946,1,0,0,0,4,1
226585,2,9,3,6,16,1
126258,4,28,9,19,6,0
357928,1,0,6,-6,6,1
294414,4,19,9,10,12,0
208521,4,44,15,29,8,1
175737,4,37,13,24,11,1
285564,2,7,10,-3,8,1
22712,1,3,7,-4,11,0
230948,1,0,0,0,1,0
285377,1,3,0,3,8,0
345886,2,3,17,-14,17,0
164677,4,21,27,-6,5,1
334839,2,10,3,7,13,1
107720,1,7,0,7,15,0
8045,2,10,7,3,4,1
305618,4,23,16,7,17,0
57902,2,10,10,0,10,1
32608,1,0,0,0,15,1
315307,1,0,0,0,4,1
179960,1,0,6,-6,13,1
349321,3,28,28,0,2,0
149512,2,14,6,8,16,0
308309,4,16,23,-7,1,0
390835,2,0,21,-21,3,0
244386,3,0,17,-17,7,0
275291,2,10,2,8,3,0
137166,4,31,6,25,11,1
280488,1,0,0,0,5,1
216212,3,14,3,11,12,1
230554,2,10,7,3,1,0
324734,3,16,7,9,8,1
151606,2,13,10,3,17,0
234130,1,0,0,0,2,1
377298,4,14,14,0,15,1
137440,4,6,27,-21,11,0
339095,2,3,0,3,15,0
406341,2,7,7,0,11,1
341548,3,13,10,3,16,0
391511,1,6,14,-8,4,1
286133,4,16,17,-1,8,1
39567,2,7,6,1,1,0
141158,2,3,14,-11,13,1
133585,2,3,7,-4,9,1
64873,3,10,3,7,13,1
154625,3,21,20,1,1,0
288848,2,10,17,-7,9,0
315944,2,0,7,-7,4,0
328699,1,0,0,0,10,1
302651,2,17,6,11,15,0
33624,1,0,0,0,16,0
291072,1,6,3,3,10,0
66254,4,45,3,42,13,1
198173,3,10,3,7,3,0
153488,1,0,0,0,1,0
299730,3,17,6,11,14,1
299205,1,0,0,0,14,0
280970,1,0,3,-3,6,1
4687,4,20,20,0,2,1
156318,2,17,0,17,2,1
10421,4,10,45,-35,5,1
256009,4,19,12,7,12,1
358207,1,0,0,0,6,0
275717,1,0,0,0,3,0
334136,3,16,7,9,13,0
316961,4,37,18,19,4,0
402992,2,7,14,-7,9,0
385080,1,0,0,0,1,0
136472,4,17,13,4,11,0
335463,3,13,9,4,13,0
59367,3,0,16,-16,11,1
384095,2,0,10,-10,1,1
128304,1,0,0,0,7,0
361869,1,0,0,0,7,0
97045,2,19,3,16,10,1
393473,4,34,27,7,5,0
384567,2,3,35,-32,1,0
137875,3,17,6,11,11,0
225357,3,10,21,-11,15,1
305002,4,24,20,4,16,0
195627,1,7,0,7,2,0
238537,3,16,13,3,4,0
296676,4,10,16,-6,13,1
183104,3,7,3,4,14,0
232828,4,16,17,-1,2,0
174927,1,0,7,-7,10,1
379625,3,26,13,13,16,0
405402,2,7,10,-3,10,1
257990,3,0,21,-21,13,1
6781,2,3,0,3,3,0
284766,2,26,10,16,7,0
158838,4,20,3,17,3,1
305451,4,20,3,17,17,1
207805,4,30,16,14,7,0
90405,1,0,6,-6,7,0
306672,4,14,35,-21,17,1
100966,3,10,16,-6,12,1
199064,2,7,14,-7,4,0
243120,3,7,12,-5,6,1
305865,3,7,14,-7,17,1
412431,1,0,7,-7,14,1
285682,5,27,27,0,8,0
380978,4,9,14,-5,16,1
351491,2,0,24,-24,3,1
362602,1,0,0,0,8,0
70784,4,20,27,-7,15,1
225120,4,16,14,2,15,1
79789,4,20,14,6,2,1
282638,2,6,7,-1,6,0
99222,4,31,20,11,11,1
409599,4,42,20,22,12,0
239735,3,10,13,-3,4,1
28375,2,6,0,6,14,1
354988,3,7,12,-5,4,0
261734,4,14,7,7,14,1
146182,1,0,3,-3,15,1
397155,2,6,0,6,6,0
47050,3,17,7,10,5,1
328504,4,9,3,6,10,1
415753,3,14,10,4,15,0
200110,2,7,10,-3,4,0
194352,4,23,6,17,2,0
2091,2,7,7,0,1,0
80934,2,13,0,13,3,0
304136,1,0,0,0,16,0
376596,4,15,6,9,14,0
293956,3,7,21,-14,12,1
250470,2,13,7,6,9,1
237938,1,0,0,0,4,0
9275,1,7,0,7,5,1
117783,2,3,6,-3,2,1
14888,2,7,0,7,7,0
332243,4,10,16,-6,12,1
30023,3,23,0,23,14,1
30049,4,33,7,26,14,1
296460,2,14,0,14,13,1
73689,4,13,9,4,17,1
140110,2,7,0,7,12,1
314633,3,7,7,0,3,1
18825,1,3,0,3,9,1
418549,1,14,0,14,16,0
183584,3,20,24,-4,14,1
289780,3,10,10,0,10,0
238633,2,6,0,6,4,0
389232,3,28,7,21,3,0
50438,3,10,7,3,6,1
44187,4,13,27,-14,3,1
357719,3,33,13,20,5,0
155214,2,14,7,7,1,0
295453,4,17,16,1,12,1
56280,3,3,17,-14,9,0
276669,3,23,6,17,4,0
322870,1,0,0,0,7,0
280,4,12,33,-21,1,0
401918,1,0,0,0,9,0
295820,1,0,0,0,12,0
18382,1,0,0,0,9,1
385353,4,17,31,-14,1,0
115761,4,13,16,-3,1,1
382774,1,7,0,7,17,0
273705,4,25,20,5,2,1
70042,4,31,10,21,15,1
186195,3,16,13,3,15,1
124363,1,0,0,0,5,0
371129,1,0,6,-6,12,0
262799,4,35,17,18,15,1
278227,4,31,21,10,4,1
225612,2,0,7,-7,16,1
244112,4,20,34,-14,6,0
38707,4,17,14,3,1,0
120272,3,17,6,11,3,0
259100,1,0,0,0,13,0
16703,4,21,33,-12,8,1
269079,3,13,16,-3,17,0
114614,2,3,3,0,1,1
240410,1,0,0,0,5,1
104893,2,0,3,-3,14,1
137150,4,31,6,25,11,0
51279,1,6,0,6,7,0
29643,4,14,21,-7,14,1
113622,3,6,12,-6,17,0
137825,1,0,6,-6,11,0
143056,2,3,7,-4,13,0
27571,1,0,0,0,13,1
246704,4,45,10,35,8,1
192252,1,9,3,6,1,1
421738,4,24,17,7,17,0
257811,2,7,3,4,13,0
32632,1,0,0,0,15,1
161030,4,23,7,16,4,1
33906,1,0,10,-10,16,1
279191,1,3,3,0,5,0
102323,3,13,10,3,13,0
357750,4,43,19,24,5,1
213709,4,17,17,0,10,1
96655,4,3,10,-7,10,0
370177,3,24,3,21,12,0
141848,3,17,14,3,13,1
20974,2,14,24,-10,10,1
107026,2,10,0,10,15,1
121550,3,16,10,6,4,1
21230,1,3,0,3,11,0
188360,1,0,0,0,16,1
403520,4,24,19,5,9,0
222552,4,17,14,3,14,1
382038,4,14,33,-19,17,1
198757,2,3,3,0,3,0
236876,1,12,0,12,3,0
198003,2,0,20,-20,3,0
338422,4,30,17,13,14,1
286129,4,16,17,-1,8,1
237086,3,0,26,-26,3,0
176476,2,0,10,-10,11,1
183601,1,0,0,0,14,0
58362,1,21,0,21,10,0
366759,4,27,10,17,10,0
162565,4,38,17,21,4,1
350955,4,14,17,-3,3,1
233110,2,14,3,11,2,1
166692,1,7,0,7,6,0
168236,1,0,7,-7,7,1
175974,1,7,0,7,11,0
283507,1,0,0,0,7,1
288285,4,10,35,-25,9,1
89991,3,5,14,-9,7,1
386527,3,7,21,-14,2,1
328719,1,7,6,1,10,1
224091,4,17,9,8,15,1
99482,3,3,10,-7,11,1
376878,4,28,14,14,15,0
419710,2,0,10,-10,17,1
203008,2,14,0,14,5,0
50974,1,0,7,-7,6,1
353761,5,20,20,0,4,0
52539,3,16,0,16,7,0
205741,4,27,25,2,7,0
295676,2,0,0,0,12,0
376364,2,3,0,3,14,1
24466,1,0,0,0,12,1
331816,1,0,0,0,12,0
151442,2,21,0,21,17,0
14623,3,17,7,10,7,1
386406,4,20,17,3,2,1
259343,3,21,27,-6,13,0
49906,1,7,0,7,6,1
225532,4,0,24,-24,15,1
379169,2,6,10,-4,16,1
58496,1,0,0,0,10,0
222957,3,13,13,0,14,1
92652,1,0,0,0,8,0
189543,1,0,0,0,17,0
102367,4,13,13,0,13,0
108592,4,26,20,6,15,0
323914,1,7,0,7,8,0
220245,2,17,6,11,13,0
418545,1,14,0,14,16,0
187666,2,7,3,4,16,0
336364,1,0,0,0,14,0
189635,3,10,6,4,17,0
194707,1,0,0,0,2,0
23418,1,0,0,0,11,1
181114,3,24,7,17,13,0
229819,2,6,0,6,17,0
113133,2,34,0,34,17,0
26736,2,6,14,-8,13,0
281159,2,14,13,1,6,1
240606,2,13,7,6,5,0
109456,3,9,13,-4,16,1
30754,3,31,28,3,15,0
214344,1,0,0,0,11,1
212237,4,3,24,-21,10,0
177700,2,13,14,-1,12,1
356338,2,23,0,23,5,1
251405,3,36,14,22,10,1
393791,1,0,0,0,5,0
398785,3,14,23,-9,7,0
273880,1,0,3,-3,2,0
122384,1,0,17,-17,4,1
326922,1,2,0,2,9,1
129792,1,0,0,0,7,0
364841,2,6,14,-8,9,0
36811,3,16,17,-1,17,1
167828,2,0,13,-13,7,1
380577,4,21,27,-6,16,1
152182,2,7,0,7,17,1
104815,4,27,33,-6,14,1
140175,4,10,3,7,12,1
118907,4,27,21,6,2,1
68920,1,0,0,0,15,0
208508,3,44,7,37,8,1
197271,2,0,0,0,3,1
343276,4,22,0,22,16,1
400905,1,6,0,6,8,0
396898,4,27,20,7,6,0
84614,3,20,10,10,4,0
64177,2,31,6,25,13,1
156554,4,14,6,8,2,0
383933,1,0,0,0,1,1
375821,3,20,7,13,14,0
49005,2,10,7,3,6,1
416009,2,7,0,7,15,1
141733,4,33,21,12,13,1
201164,2,6,21,-15,5,1
91870,4,30,13,17,8,0
169322,1,3,7,-4,8,1
347311,3,7,21,-14,1,1
316350,1,0,0,0,4,0
35989,4,6,21,-15,17,1
267288,3,17,17,0,17,1
29706,2,10,0,10,14,0
392321,2,7,21,-14,4,0
376937,2,3,6,-3,15,1
46840,1,7,0,7,5,1
277965,1,0,0,0,4,1
258728,3,3,20,-17,13,0
264604,4,12,17,-5,16,0
315456,1,0,0,0,4,0
302762,1,3,10,-7,15,0
190004,4,16,10,6,17,0
13954,4,24,21,3,7,1
217086,1,0,0,0,12,1
404180,3,9,7,2,10,0
21072,1,0,0,0,10,0
82046,3,17,7,10,3,0
62893,3,10,10,0,12,1
160648,2,7,0,7,4,1
75002,3,27,17,10,17,1
148566,1,0,0,0,16,1
219863,4,45,0,45,13,1
321921,3,14,21,-7,7,0
52755,1,0,0,0,7,0
230942,4,31,10,21,1,1
116429,2,3,10,-7,1,1
417034,2,10,0,10,15,1
80884,1,0,0,0,3,1
214414,2,7,7,0,11,1
247576,3,16,16,0,8,0
20545,4,17,0,17,10,0
408735,1,3,7,-4,12,1
374932,4,14,28,-14,14,1
420797,2,3,10,-7,17,0
300998,1,3,3,0,15,0
159107,3,24,0,24,3,0
121051,3,11,24,-13,3,0
170198,4,24,30,-6,8,1
143803,3,6,0,6,14,0
91104,1,0,0,0,8,1
262792,4,35,17,18,15,1
3996,1,0,0,0,2,1
207992,2,14,0,14,8,1
86277,2,13,20,-7,5,0
236354,3,7,23,-16,3,1
157205,1,7,0,7,2,0
393316,4,30,29,1,5,0
193367,2,7,10,-3,1,0
208213,4,3,10,-7,8,0
421453,4,38,20,18,17,1
372352,4,24,17,7,13,0
122075,1,0,7,-7,4,1
175416,3,17,12,5,11,0
66672,4,7,24,-17,14,1
206045,1,0,3,-3,7,1
61279,3,21,14,7,11,1
136688,1,0,7,-7,11,0
120746,3,23,0,23,3,0
363631,1,0,0,0,8,0
108184,1,3,0,3,15,0
17921,1,0,7,-7,9,1
213066,3,17,3,14,10,0
208114,1,0,0,0,8,0
343847,4,24,3,21,17,1
345002,4,10,23,-13,17,1
262862,2,7,20,-13,15,0
66481,2,7,10,-3,14,0
6132,4,7,10,-3,3,0
413424,3,3,31,-28,14,0
165729,4,14,7,7,6,0
418008,3,21,28,-7,16,0
242041,3,7,9,-2,5,1
289923,3,6,3,3,10,1
48436,3,17,17,0,5,1
74030,1,0,0,0,17,1
73566,4,9,41,-32,17,0
378610,4,20,13,7,15,0
204611,3,0,38,-38,6,1
178211,3,6,10,-4,12,0
255343,2,14,0,14,12,0
45038,3,23,10,13,4,0
21152,3,0,16,-16,10,1
329930,2,7,10,-3,11,0
408142,2,3,0,3,12,1
416626,3,28,7,21,15,1
346143,1,7,0,7,1,0
3790,4,20,10,10,2,1
205576,4,17,24,-7,6,0
163235,1,3,3,0,5,0
120697,2,10,0,10,3,1
98641,4,14,10,4,11,1
386325,2,10,3,7,2,1
89095,3,13,6,7,6,1
35458,2,7,7,0,17,1
195195,2,10,0,10,2,0
253685,2,3,3,0,11,1
290478,2,13,0,13,10,1
289135,2,13,0,13,9,1
167431,1,0,0,0,7,0
213108,4,20,3,17,10,0
113345,4,26,37,-11,17,0
14009,2,3,13,-10,7,0
70234,4,33,30,3,15,0
221937,4,19,19,0,14,0
333504,2,13,0,13,12,0
268139,2,6,7,-1,17,0
79198,3,20,10,10,2,0
280920,4,21,10,11,6,0
300151,2,21,3,18,14,0
260828,3,22,15,7,14,1
160262,1,3,0,3,4,0
315960,2,0,14,-14,4,1
165648,2,0,7,-7,6,1
4803,3,27,0,27,3,0
276151,1,10,0,10,3,0
201491,3,19,7,12,5,1
185391,2,0,10,-10,15,1
215995,1,0,0,0,11,0
207899,3,21,7,14,8,1
109288,3,6,0,6,15,0
35808,3,3,10,-7,17,1
62524,5,16,16,0,12,0
41447,2,2,7,-5,2,1
109525,1,0,7,-7,16,0
238945,2,14,6,8,4,0
158464,2,0,7,-7,3,1
134815,3,48,17,31,10,1
159325,4,27,24,3,3,0
411964,4,17,17,0,13,0
90857,2,21,0,21,7,1
99867,1,0,0,0,12,1
290793,2,3,0,3,10,1
243099,3,7,9,-2,6,1
101846,1,3,0,3,12,0
390090,2,10,14,-4,3,1
190396,3,7,0,7,17,0
322475,2,15,3,12,7,0
307780,2,17,7,10,1,0
196085,2,6,21,-15,2,1
105840,2,13,3,10,14,1
145171,3,43,0,43,14,0
306666,4,14,35,-21,17,1
184493,2,14,7,7,14,0
196069,2,3,21,-18,2,1
10618,2,0,10,-10,5,1
216191,2,14,3,11,12,1
222960,3,13,13,0,14,0
30241,1,0,0,0,14,1
66035,2,7,0,7,13,1
278301,2,14,0,14,4,0
384261,2,6,0,6,1,1
363934,1,0,3,-3,8,0
326343,2,7,10,-3,9,0
383735,4,16,27,-11,17,1
270010,4,19,20,-1,1,1
91084,4,9,0,9,7,0
15064,3,10,26,-16,7,0
130642,2,7,21,-14,8,0
178932,2,6,3,3,12,0
385728,1,7,0,7,1,1
244690,3,14,23,-9,7,1
312109,3,30,10,20,2,1
289926,3,6,3,3,10,1
345927,4,20,23,-3,17,1
301789,3,0,27,-27,15,1
362865,4,14,28,-14,8,0
113641,4,9,13,-4,17,0
407652,4,10,17,-7,11,0
184419,4,24,6,18,14,0
19568,2,7,14,-7,10,1
259089,1,0,0,0,13,0
305772,4,15,10,5,17,1
395925,2,10,0,10,6,0
156652,3,3,7,-4,2,1
330449,4,20,20,0,11,0
17225,3,7,31,-24,9,0
179037,1,3,0,3,12,0
215377,4,24,20,4,11,0
10751,2,7,0,7,5,0
118988,3,0,23,-23,3,0
65916,3,17,14,3,13,1
412121,1,0,0,0,13,1
410901,3,14,15,-1,13,1
273412,1,0,0,0,2,1
53803,5,10,10,0,8,0
291170,4,18,23,-5,10,0
118037,4,20,13,7,2,0
358818,1,0,7,-7,6,1
395575,1,0,0,0,6,0
158505,3,10,10,0,3,0
38549,3,24,6,18,1,1
109070,1,0,0,0,15,0
371772,3,23,14,9,12,1
234007,2,14,0,14,2,0
367746,4,13,20,-7,10,1
53577,3,14,12,2,8,0
333630,1,0,0,0,12,0
366047,4,50,14,36,10,1
162822,2,3,3,0,5,1
114675,3,3,10,-7,1,1
227204,4,13,17,-4,16,1
107617,2,13,7,6,15,0
140908,3,17,10,7,13,0
79147,2,3,0,3,2,1
352668,2,7,0,7,3,0
385724,1,7,0,7,1,0
130621,2,7,14,-7,8,0
308154,4,16,19,-3,1,0
284196,3,9,20,-11,7,0
150500,4,34,6,28,16,1
276942,2,17,14,3,4,0
86913,4,23,26,-3,5,0
211058,3,27,0,27,9,0
395109,4,17,31,-14,5,0
166245,1,0,3,-3,6,1
48596,3,14,24,-10,5,1
357486,1,0,3,-3,5,1
109420,2,6,10,-4,16,1
191485,1,7,7,0,17,0
188911,3,17,10,7,16,0
248177,3,6,10,-4,8,1
412006,1,6,0,6,13,1
243786,4,24,17,7,6,0
262704,1,7,0,7,15,1
194059,4,27,7,20,1,0
391880,3,13,13,0,4,1
213700,3,17,17,0,10,0
45494,3,27,20,7,4,1
59314,2,0,6,-6,11,1
82375,4,13,10,3,3,0
259413,1,3,3,0,13,0
13810,4,7,36,-29,7,1
174426,4,17,10,7,10,1
43912,1,0,7,-7,3,1
123600,1,0,0,0,4,1
242161,2,13,7,6,6,1
10275,1,0,0,0,5,0
181451,4,31,24,7,13,0
128009,1,0,0,0,7,1
305259,3,21,21,0,16,0
401717,3,10,14,-4,8,1
275227,4,17,29,-12,3,1
44907,4,7,38,-31,4,1
230055,4,19,6,13,17,0
16889,1,7,13,-6,8,1
268808,4,31,10,21,17,1
358263,2,0,14,-14,6,0
384404,2,14,0,14,1,1
1414,4,16,0,16,1,1
241834,2,10,3,7,5,1
375590,1,7,7,0,14,1
116123,2,0,3,-3,1,1
191271,3,7,17,-10,17,1
336297,3,17,3,14,13,0
235956,1,0,0,0,3,1
259272,1,13,0,13,13,0
251915,4,20,19,1,10,1
23585,1,7,0,7,12,0
201200,3,20,24,-4,5,1
183384,2,17,3,14,14,1
243040,1,0,3,-3,6,1
128373,3,7,13,-6,7,0
283489,4,23,14,9,7,0
349755,4,20,14,6,2,1
222646,2,7,7,0,14,0
55598,4,27,7,20,9,0
315692,4,10,13,-3,4,0
264465,4,20,35,-15,15,1
113666,4,9,13,-4,17,0
25631,1,0,0,0,12,0
393587,3,7,25,-18,5,0
108182,1,3,0,3,15,0
409073,2,3,10,-7,12,1
40050,3,20,7,13,1,1
373139,4,10,24,-14,13,1
292981,1,0,0,0,11,1
119971,3,16,24,-8,3,0
23445,1,7,0,7,11,1
85934,2,7,14,-7,5,1
322144,1,0,7,-7,7,0
140813,1,0,0,0,13,1
175550,3,20,0,20,11,1
403642,4,30,20,10,9,1
228763,1,0,7,-7,17,0
7088,2,21,14,7,4,0
22221,4,10,15,-5,11,1
59605,2,14,3,11,11,0
151766,2,14,6,8,17,1
403720,2,9,3,6,9,0
256243,2,6,7,-1,12,0
384982,2,17,6,11,1,0
384434,2,21,0,21,1,1
178293,1,0,3,-3,12,1
137107,3,24,6,18,11,0
375027,3,21,27,-6,14,1
132000,3,0,17,-17,8,0
412205,3,14,3,11,13,0
391839,2,10,3,7,4,0
342568,2,12,13,-1,16,0
184491,2,7,7,0,14,1
131540,3,6,16,-10,8,1
263337,3,24,7,17,15,0
81220,2,0,7,-7,3,1
236749,1,0,3,-3,3,1
156932,2,7,10,-3,2,0
206737,4,7,21,-14,7,1
70594,2,7,10,-3,15,1
300932,4,10,27,-17,15,1
142888,2,0,3,-3,13,1
398171,2,7,3,4,7,0
273881,1,0,3,-3,2,1
258711,2,0,20,-20,13,1
2475,4,28,20,8,2,0
264031,1,7,0,7,15,0
283774,3,18,3,15,7,0
252755,2,3,3,0,11,0
138027,2,22,17,5,11,0
145670,4,35,7,28,14,1
396902,4,27,20,7,6,0
29464,3,10,14,-4,14,0
67728,2,14,0,14,14,1
56960,4,43,7,36,9,0
73028,2,0,3,-3,16,0
153001,4,42,17,25,1,0
360126,1,7,3,4,7,1
152289,4,28,0,28,17,1
12057,1,7,0,7,6,0
357162,4,6,14,-8,5,1
409298,4,13,16,-3,12,1
291399,2,7,7,0,10,0
19856,2,10,14,-4,10,0
191784,1,0,0,0,1,1
287133,2,10,3,7,8,0
119089,2,7,7,0,3,0
30450,3,17,28,-11,14,1
145065,4,20,13,7,14,1
388337,3,17,6,11,2,0
118201,1,0,0,0,2,1
343359,3,0,20,-20,16,1
3764,3,20,10,10,2,0
408741,2,10,7,3,12,0
268042,4,21,9,12,17,0
389722,1,0,0,0,3,1
331270,2,0,7,-7,11,1
77999,3,9,16,-7,1,0
193723,3,3,27,-24,1,0
56164,4,27,21,6,9,0
240169,3,16,3,13,5,1
343891,1,0,0,0,17,0
242563,1,3,0,3,6,0
338025,1,0,0,0,14,0
237311,1,0,0,0,3,0
351484,2,0,17,-17,3,0
208533,4,47,15,32,8,0
299237,1,3,0,3,14,1
231604,2,14,10,4,1,1
239967,2,0,10,-10,5,1
167470,2,0,0,0,7,0
253455,4,14,38,-24,11,0
215438,1,7,3,4,11,1
109145,3,24,7,17,15,1
267394,3,0,10,-10,17,1
341135,4,21,24,-3,15,0
288397,3,10,0,10,9,0
76947,3,14,13,1,1,1
334474,4,24,13,11,13,0
391892,3,16,20,-4,4,0
402166,3,19,7,12,9,0
286367,1,0,0,0,8,1
369089,1,3,0,3,11,1
172648,1,7,0,7,9,0
420622,2,7,13,-6,17,0
359194,4,13,21,-8,6,0
90219,4,6,3,3,7,0
242634,3,13,0,13,6,0
375805,3,20,0,20,14,0
15986,4,18,14,4,8,0
351998,4,28,21,7,3,0
343338,2,0,17,-17,16,1
111244,3,10,3,7,16,0
126647,1,0,0,0,6,0
101332,1,3,0,3,12,1
274873,2,7,10,-3,3,0
281333,3,14,13,1,6,1
170156,3,7,13,-6,8,1
310263,2,10,0,10,2,0
310648,3,13,30,-17,2,0
3168,3,13,9,4,2,0
403910,3,20,14,6,10,0
21971,2,7,3,4,11,1
360714,1,9,7,2,7,1
109309,4,13,3,10,15,0
302070,2,20,24,-4,15,0
390942,1,7,0,7,4,1
199911,1,0,0,0,4,0
305729,3,9,7,2,17,0
258707,2,0,20,-20,13,1
361579,4,19,17,2,7,0
24673,2,17,7,10,12,1
73944,2,17,0,17,17,0
265468,2,7,7,0,16,1
146301,4,17,33,-16,15,1
350437,2,0,6,-6,2,1
149792,1,3,7,-4,16,0
212776,3,10,21,-11,10,1
35961,3,3,7,-4,17,0
3155,3,10,9,1,2,1
43166,1,0,7,-7,3,1
362020,1,0,0,0,8,0
392236,4,10,16,-6,4,0
396031,4,38,20,18,6,1
288326,1,0,0,0,9,0
407226,1,0,9,-9,11,1
358436,3,29,20,9,6,1
356754,4,32,31,1,5,1
221241,2,0,16,-16,14,0
7419,2,13,3,10,4,0
316796,3,16,7,9,4,0
48517,1,11,0,11,5,1
299913,4,13,11,2,14,1
222679,3,14,24,-10,14,1
127428,1,0,0,0,6,1
50229,1,7,7,0,6,0
167220,3,23,17,6,7,0
87172,4,21,10,11,5,0
204535,1,0,14,-14,6,1
309835,2,14,7,7,1,0
1453,1,0,0,0,1,1
253532,2,3,7,-4,11,0
118463,4,27,10,17,2,0
208914,2,7,6,1,8,0
107389,4,19,6,13,15,0
264518,1,7,7,0,16,1
328452,2,3,0,3,10,0
113672,4,9,13,-4,17,1
139150,3,19,6,13,12,0
225112,4,13,14,-1,15,1
369706,2,22,17,5,11,0
186600,2,17,0,17,15,0
414570,3,21,9,12,14,1
76934,2,14,13,1,1,0
325442,2,13,3,10,8,0
87629,4,17,13,4,6,0
403022,3,13,21,-8,9,0
309347,1,0,0,0,1,1
285352,1,0,0,0,8,1
267467,1,0,7,-7,17,1
320169,4,17,17,0,6,0
350932,3,6,14,-8,3,1
96680,1,0,0,0,10,1
348502,2,21,0,21,2,0
242729,2,7,7,0,6,0
340868,1,0,0,0,15,0
48328,4,22,13,9,5,0
242317,2,10,10,0,6,0
123217,3,13,21,-8,4,0
136983,4,17,20,-3,11,1
104599,2,7,3,4,14,1
130854,4,20,12,8,8,0
182177,3,26,7,19,13,1
196626,1,0,0,0,3,1
195944,2,0,17,-17,2,1
151055,3,10,9,1,17,0
292168,3,21,7,14,11,1
282607,1,0,7,-7,6,1
153324,4,2,10,-8,1,0
238731,4,19,20,-1,4,1
36092,3,34,0,34,17,1
296818,4,13,7,6,13,1
311934,3,21,10,11,2,1
264063,2,7,20,-13,15,1
275353,4,10,19,-9,3,0
60284,4,17,16,1,11,0
400610,1,0,0,0,8,1
243393,2,3,10,-7,6,1
410828,1,14,0,14,13,0
343848,4,24,3,21,17,1
187273,4,10,6,4,16,0
171767,2,6,14,-8,9,1
37792,3,7,9,-2,1,1
153101,2,6,10,-4,1,0
171338,3,16,3,13,9,0
263520,4,20,26,-6,15,0
370866,2,3,3,0,12,0
115967,1,7,0,7,1,1
326290,1,0,3,-3,9,0
194985,4,14,25,-11,2,1
109264,2,6,0,6,15,0
387010,4,14,28,-14,2,1
207062,4,38,3,35,7,0
301622,3,10,3,7,15,0
312933,1,0,0,0,3,0
246722,1,0,0,0,8,1
72466,2,7,10,-3,16,1
384449,3,21,0,21,1,0
342309,4,20,6,14,16,0
357680,2,13,6,7,5,1
393140,4,24,3,21,4,1
112458,4,13,16,-3,17,1
45787,3,13,14,-1,4,0
103938,2,3,0,3,13,0
1159,4,10,36,-26,1,1
288914,4,19,31,-12,9,1
154408,1,6,0,6,1,1
152478,2,10,7,3,17,1
381026,1,0,3,-3,16,1
16867,1,0,7,-7,8,1
154414,2,7,0,7,1,0
45162,3,7,10,-3,4,0
192924,2,7,10,-3,1,1
295821,1,0,0,0,12,0
43689,3,14,10,4,3,0
97433,4,16,36,-20,10,0
65264,1,0,13,-13,13,0
65377,1,0,0,0,13,0
195782,2,10,7,3,2,1
113290,2,13,24,-11,17,0
341631,1,3,0,3,16,0
36500,3,10,13,-3,17,1
258755,4,3,34,-31,13,0
208721,1,0,0,0,8,0
61780,1,0,10,-10,12,1
66472,2,7,10,-3,14,1
318526,1,0,0,0,5,0
16155,1,0,0,0,8,1
59751,2,6,10,-4,11,1
324707,2,7,7,0,8,1
59022,2,0,10,-10,10,1
172635,1,0,0,0,9,0
181742,3,7,7,0,13,0
237211,2,3,0,3,3,1
88307,2,14,7,7,6,1
14306,2,2,7,-5,7,1
361169,1,0,6,-6,7,0
146537,3,14,10,4,15,1
38057,2,3,0,3,1,1
197251,1,0,0,0,3,0
147820,2,0,7,-7,15,1
138620,2,3,7,-4,12,1
1791,2,3,0,3,1,1
356324,2,17,0,17,5,1
173276,1,7,10,-3,10,1
393605,4,7,26,-19,5,1
352419,3,35,16,19,3,0
104141,3,24,27,-3,13,0
403974,4,26,24,2,10,0
209319,1,0,7,-7,8,1
301854,1,0,0,0,15,0
366201,4,14,51,-37,10,0
341663,2,17,12,5,16,0
309473,4,17,9,8,1,1
273758,2,0,7,-7,2,1
373348,2,7,0,7,13,0
349866,2,3,3,0,2,1
260664,3,10,22,-12,14,0
301895,2,0,13,-13,15,1
382160,4,30,3,27,17,1
45263,1,0,0,0,4,0
374872,3,14,3,11,14,1
268894,2,6,30,-24,17,0
287,4,12,34,-22,1,0
381835,3,10,14,-4,17,0
43001,1,0,0,0,3,0
168198,4,29,15,14,7,0
132240,2,7,7,0,9,1
123870,4,17,3,14,5,1
255351,2,14,3,11,12,1
275782,3,16,3,13,3,0
123090,5,21,21,0,4,1
254821,4,20,10,10,11,0
288104,3,10,7,3,9,1
137005,5,20,20,0,11,0
402765,4,24,7,17,9,0
413082,2,27,14,13,14,0
14042,3,3,21,-18,7,1
29657,1,0,0,0,14,1
56992,1,0,10,-10,9,0
381626,1,7,0,7,17,1
381334,1,6,0,6,16,0
59779,3,9,10,-1,11,1
308042,1,0,7,-7,1,1
37317,1,7,0,7,17,0
279771,1,0,0,0,5,0
387058,1,7,14,-7,2,1
331832,1,0,0,0,12,1
334800,1,6,0,6,13,1
337830,4,30,6,24,14,0
39990,2,7,7,0,1,0
379587,2,16,6,10,16,0
286270,3,13,13,0,8,0
2318,4,19,17,2,1,1
99970,4,17,16,1,12,0
385339,4,17,20,-3,1,0
116803,4,34,33,1,2,1
193891,3,24,10,14,1,1
117474,2,7,14,-7,2,1
192928,2,7,16,-9,1,0
10916,2,6,7,-1,5,0
70964,1,0,0,0,16,0
31241,4,33,34,-1,15,0
322419,1,0,0,0,7,0
403145,2,10,7,3,9,0
306626,3,14,27,-13,17,1
312022,1,7,0,7,2,0
184679,3,10,24,-14,15,0
318162,3,16,10,6,5,0
166112,2,14,3,11,6,1
360571,2,7,10,-3,7,1
110085,1,0,0,0,16,1
150550,1,3,3,0,17,0
380072,3,35,20,15,16,0
178078,5,23,23,0,12,1
220639,1,0,0,0,13,1
37205,2,3,13,-10,17,0
281184,3,21,13,8,6,1
155071,3,6,26,-20,1,1
19849,2,10,14,-4,10,1
60419,4,23,7,16,11,0
16861,1,0,0,0,8,0
269273,4,10,19,-9,17,1
10957,3,9,21,-12,5,0
190998,4,19,3,16,17,1
242810,4,20,34,-14,6,1
270963,1,0,7,-7,1,0
412512,3,24,7,17,14,0
196287,4,21,10,11,2,0
121718,3,21,21,0,4,1
300171,3,21,3,18,14,0
125632,3,14,24,-10,5,0
406270,4,21,27,-6,11,0
330730,4,6,6,0,11,1
260622,2,0,10,-10,14,0
110263,2,0,10,-10,16,1
327597,4,10,21,-11,10,0
317163,2,0,3,-3,5,1
296743,1,0,0,0,13,0
172238,3,14,13,1,9,0
173168,2,10,14,-4,9,0
264622,4,12,17,-5,16,0
72399,4,17,23,-6,16,1
69366,1,0,0,0,15,1
96470,3,10,17,-7,10,1
337601,2,14,7,7,14,0
46864,2,10,3,7,5,1
152134,4,20,13,7,17,0
182451,2,7,0,7,14,1
217690,1,7,0,7,12,1
246832,4,10,20,-10,8,1
58460,4,48,17,31,10,0
272000,1,0,0,0,2,1
265285,4,16,6,10,16,1
25355,1,3,0,3,12,0
279228,2,13,6,7,5,0
368582,3,9,0,9,11,1
52462,1,3,0,3,7,0
388778,3,14,0,14,3,0
19598,3,17,21,-4,10,0
413944,1,3,7,-4,14,0
45751,3,10,7,3,4,1
8845,1,0,0,0,4,1
405021,4,9,26,-17,10,1
40836,1,0,0,0,2,0
399471,2,0,24,-24,7,1
319767,2,7,0,7,6,1
386926,2,7,21,-14,2,1
390408,3,7,27,-20,3,0
258482,4,21,21,0,13,1
4817,4,27,3,24,3,0
7213,1,0,7,-7,4,1
273709,4,31,20,11,2,0
239669,1,7,3,4,4,0
384756,4,19,37,-18,1,0
126985,2,10,10,0,6,1
353556,2,17,0,17,4,1
218064,4,21,24,-3,12,1
400428,4,24,10,14,8,0
226663,4,17,13,4,16,1
403463,2,17,9,8,9,0
325702,4,34,21,13,9,1
63191,3,14,23,-9,12,0
238496,2,13,0,13,4,1
71261,1,0,0,0,16,1
192322,3,27,17,10,1,1
93078,4,20,20,0,8,0
28276,4,17,14,3,13,1
287568,1,0,0,0,9,1
288282,4,10,35,-25,9,1
207798,4,27,16,11,7,1
307736,1,7,0,7,1,0
393496,1,0,0,0,5,0
20310,2,10,10,0,10,1
218899,3,21,17,4,13,1
93632,4,20,6,14,9,1
181840,2,21,7,14,13,1
208233,4,6,10,-4,8,1
94927,2,0,3,-3,9,1
316070,1,3,3,0,4,1
196216,2,7,3,4,2,0
171351,3,16,10,6,9,1
413801,1,7,0,7,14,1
85179,2,7,10,-3,4,1
253241,3,3,7,-4,11,1
98388,2,0,7,-7,11,1
316857,1,3,0,3,4,0
62924,4,17,10,7,12,0
202282,2,6,0,6,5,0
177923,4,21,23,-2,12,0
19730,2,9,6,3,10,1
209465,4,24,20,4,8,0
43846,3,21,16,5,3,1
272826,2,20,0,20,2,1
42754,1,3,7,-4,3,1
170152,3,7,13,-6,8,1
105059,2,6,14,-8,14,1
406095,3,0,20,-20,11,0
186101,1,0,0,0,15,0
299039,4,16,24,-8,14,0
394417,1,0,3,-3,5,0
206250,2,7,6,1,7,0
369497,1,0,0,0,11,1
148168,2,3,21,-18,16,1
187654,1,7,3,4,16,0
39300,4,10,27,-17,1,0
165397,3,6,17,-11,6,0
104209,1,0,0,0,13,1
173158,2,10,14,-4,9,1
371512,4,24,24,0,12,1
349975,1,0,0,0,2,1
129820,1,7,0,7,7,1
343886,4,26,6,20,17,0
314927,3,0,10,-10,4,1
358346,1,6,0,6,6,0
393690,2,0,0,0,5,1
170874,2,7,0,7,8,0
241038,1,0,0,0,5,0
377254,2,7,3,4,15,1
258151,3,13,13,0,13,1
106556,1,14,0,14,14,0
35607,2,7,3,4,17,0
165110,4,16,24,-8,6,1
64823,1,0,0,0,13,1
67852,2,3,3,0,14,1
399955,3,12,13,-1,8,0
233649,4,23,47,-24,2,1
217935,4,39,28,11,12,0
123351,3,21,14,7,4,0
125234,4,31,21,10,5,0
374269,2,7,10,-3,13,0
378871,2,10,13,-3,15,1
370066,4,31,20,11,12,1
398998,1,0,2,-2,7,0
240441,2,0,7,-7,5,1
143266,4,17,16,1,13,0
400162,1,0,0,0,8,1
235692,2,0,10,-10,3,1
352875,4,14,13,1,3,0
92173,4,3,43,-40,8,1
79418,2,6,0,6,2,0
367225,1,0,0,0,10,1
362238,3,12,17,-5,8,1
265563,1,0,0,0,16,0
347033,4,24,17,7,1,1
271209,4,21,20,1,1,0
391186,4,10,24,-14,4,0
390078,2,7,7,0,3,1
239362,1,0,7,-7,4,0
233154,3,29,3,26,2,0
34359,1,0,0,0,16,0
94642,2,14,19,-5,9,1
10151,1,0,0,0,5,1
60162,1,0,0,0,11,0
286783,4,20,28,-8,8,0
364400,2,34,7,27,9,1
333736,4,21,7,14,12,0
339990,2,14,3,11,15,0
149544,2,14,9,5,16,0
390639,1,0,3,-3,3,0
326090,3,30,3,27,9,1
260246,3,10,3,7,14,1
85751,1,7,7,0,5,1
44420,2,3,0,3,3,0
272907,4,20,17,3,2,0
161364,5,20,19,1,4,0
56550,2,16,7,9,9,0
23526,4,17,17,0,11,0
104162,4,27,27,0,13,0
408777,2,10,19,-9,12,0
231732,2,3,13,-10,1,1
128560,4,21,35,-14,7,1
232153,1,6,0,6,1,0
37298,1,7,0,7,17,0
126629,1,0,0,0,6,1
366551,2,20,7,13,10,1
49331,2,7,10,-3,6,0
154693,1,0,0,0,1,0
26953,4,16,6,10,13,0
273386,4,38,7,31,2,1
374835,2,7,3,4,14,0
392961,3,9,3,6,4,0
20501,3,3,0,3,10,0
341877,4,23,15,8,16,0
253299,4,13,13,0,11,1
141498,2,7,3,4,13,1
251664,2,6,3,3,10,1
35722,1,3,0,3,17,1
117929,2,7,3,4,2,0
213919,1,10,6,4,10,0
142330,3,0,3,-3,13,1
3632,3,20,27,-7,2,0
120708,2,17,0,17,3,0
101769,4,13,10,3,12,0
193234,2,3,7,-4,1,0
378659,5,23,23,0,15,1
110434,2,17,0,17,16,0
83634,1,0,0,0,4,0
384719,3,13,23,-10,1,0
329925,2,7,10,-3,11,1
325541,4,28,19,9,8,1
268562,1,7,3,4,17,1
133019,3,9,14,-5,9,0
38449,4,31,18,13,1,0
389561,4,27,24,3,3,1
139966,2,25,3,22,12,0
42787,2,6,21,-15,3,1
26801,4,13,43,-30,13,1
204071,1,3,7,-4,6,0
314345,3,10,17,-7,3,1
46170,2,7,14,-7,4,1
216640,1,7,3,4,12,0
34864,2,17,7,10,16,1
342418,2,10,3,7,16,0
302424,1,0,0,0,15,0
102126,1,6,0,6,13,1
327002,3,2,10,-8,9,1
15138,1,0,0,0,8,1
329107,4,24,7,17,10,0
177701,2,13,14,-1,12,1
392501,2,3,17,-14,4,0
40750,2,17,14,3,2,0
211178,2,0,10,-10,9,1
195617,1,0,0,0,2,1
389030,2,13,0,13,3,1
88693,4,26,20,6,6,0
128614,2,3,10,-7,7,1
197960,1,0,3,-3,3,0
207465,3,14,14,0,7,1
360664,4,17,34,-17,7,1
288470,1,0,0,0,9,0
327710,3,6,10,-4,10,0
315725,4,17,22,-5,4,1
48367,1,0,10,-10,5,1
214563,2,3,0,3,11,0
190415,3,7,7,0,17,0
132407,2,0,14,-14,9,0
243308,3,7,10,-3,6,1
138200,3,7,9,-2,11,0
168861,2,14,3,11,7,1
259282,2,13,7,6,13,1
334596,4,30,31,-1,13,1
177400,2,17,10,7,11,1
302887,1,0,0,0,16,0
27526,4,23,12,11,13,1
47704,3,3,17,-14,5,1
318455,3,31,7,24,5,0
27063,3,10,6,4,13,1
246464,2,9,0,9,8,0
363835,3,13,17,-4,8,0
360852,1,0,0,0,7,0
196377,2,10,0,10,2,1
176880,4,20,16,4,11,0
25500,1,0,0,0,12,0
114753,1,0,0,0,1,0
264546,2,10,14,-4,16,1
418637,4,21,31,-10,16,0
138120,1,7,3,4,11,1
377470,4,14,13,1,15,1
6273,3,13,17,-4,3,1
169741,1,0,0,0,8,0
188852,2,3,0,3,16,0
185903,3,22,16,6,15,0
215814,4,44,13,31,11,1
217874,3,17,21,-4,12,1
343093,4,12,20,-8,16,1
343123,4,12,20,-8,16,1
143502,3,14,21,-7,14,0
95667,2,10,3,7,10,0
300982,1,0,0,0,15,1
385294,3,7,20,-13,1,1
294602,1,0,0,0,12,1
100082,3,6,6,0,12,1
314593,2,7,0,7,3,0
68467,1,0,0,0,14,0
192563,4,33,17,16,1,0
101691,2,10,0,10,12,1
416188,2,10,19,-9,15,1
231686,4,24,19,5,1,0
61826,2,3,17,-14,12,0
85686,3,24,14,10,5,0
22935,4,3,26,-23,11,1
91282,2,7,0,7,8,0
306785,4,16,33,-17,17,1
181843,2,21,7,14,13,0
305968,1,0,0,0,17,1
285615,4,20,17,3,8,1
239326,4,3,17,-14,4,1
284465,2,14,12,2,7,0
321674,4,30,27,3,7,0
397474,3,13,16,-3,6,0
409356,1,3,3,0,12,1
268665,4,20,20,0,17,0
76055,3,10,16,-6,1,1
65419,2,0,7,-7,13,0
262303,3,10,9,1,15,1
196277,3,21,10,11,2,1
259531,4,44,10,34,13,0
32196,2,14,7,7,15,0
194732,2,0,10,-10,2,0
44358,1,0,0,0,3,1
226047,1,0,0,0,16,1
14744,2,21,0,21,7,1
185308,4,41,22,19,15,0
390788,1,0,7,-7,3,0
381979,3,0,23,-23,17,1
417157,1,0,10,-10,16,1
209755,4,16,6,10,8,1
216326,2,7,13,-6,12,1
193316,4,10,26,-16,1,0
185357,1,0,3,-3,15,0
168936,4,31,13,18,7,0
51315,2,16,17,-1,7,0
166940,4,16,6,10,6,0
83423,4,10,20,-10,4,0
314515,3,21,7,14,3,1
383511,2,14,3,11,17,0
212863,1,0,0,0,10,0
52320,1,3,0,3,7,0
215612,2,14,3,11,11,0
18094,2,3,14,-11,9,0
94332,2,10,7,3,9,1
371926,4,34,17,17,12,0
295856,2,7,14,-7,12,0
200156,3,7,30,-23,4,0
174745,4,9,10,-1,10,1
333979,3,17,10,7,12,1
306182,3,10,3,7,17,0
113815,4,16,24,-8,17,0
123531,3,10,10,0,4,1
179721,2,0,10,-10,12,1
400522,2,7,3,4,8,0
284387,4,28,17,11,7,0
96677,1,0,0,0,10,1
224133,2,0,17,-17,15,1
156188,3,14,10,4,2,1
105446,4,23,31,-8,14,1
388993,4,24,27,-3,3,1
349563,2,3,21,-18,2,0
229671,1,7,7,0,17,1
55159,4,29,17,12,8,0
163658,4,21,36,-15,5,0
203728,1,0,0,0,6,0
132316,4,31,17,14,9,1
61271,3,21,14,7,11,0
155729,3,20,20,0,2,0
239189,4,26,19,7,4,1
257161,1,0,6,-6,12,1
282468,1,0,0,0,6,0
408770,2,10,13,-3,12,0
356029,3,21,10,11,5,0
74858,4,20,20,0,17,0
82726,1,0,3,-3,3,1
204081,1,3,7,-4,6,1
29633,4,14,21,-7,14,1
3498,4,10,30,-20,2,1
57699,4,24,24,0,10,1
234011,2,14,0,14,2,0
142869,1,0,0,0,13,1
339787,4,24,13,11,15,1
36792,2,7,10,-3,17,1
98133,2,21,10,11,11,1
194480,3,16,9,7,2,0
350089,4,30,20,10,2,1
326976,3,2,7,-5,9,1
55985,3,10,20,-10,9,0
220580,4,10,26,-16,13,0
189986,4,16,7,9,17,1
390439,4,14,27,-13,3,0
331976,1,0,0,0,12,1
28921,1,0,0,0,14,1
70809,4,30,27,3,15,0
409389,2,13,3,10,12,1
24764,4,27,34,-7,12,0
1329,1,0,0,0,1,1
199207,2,10,7,3,4,0
366702,2,17,10,7,10,1
71921,3,15,13,2,16,1
235123,3,0,10,-10,2,1
287155,2,10,3,7,8,0
194942,4,14,10,4,2,0
51444,2,10,23,-13,7,0
168330,3,17,24,-7,7,0
188054,1,0,0,0,16,0
321293,3,9,13,-4,6,0
358347,1,6,0,6,6,0
180789,3,10,13,-3,13,0
145055,4,20,6,14,14,0
143027,1,0,0,0,13,0
377509,1,0,0,0,15,1
319217,4,17,17,0,5,1
208317,2,7,24,-17,8,1
313014,3,17,0,17,3,0
17431,4,17,7,10,9,1
243874,2,13,3,10,6,1
333039,2,3,12,-9,12,0
167938,4,21,22,-1,7,1
381185,1,7,3,4,16,1
418160,3,24,3,21,16,0
139773,1,0,0,0,12,0
31768,2,0,17,-17,15,0
361578,4,19,17,2,7,0
139241,2,10,6,4,12,0
54003,1,0,0,0,8,1
364223,2,0,7,-7,9,1
78677,1,10,0,10,2,1
143218,3,10,13,-3,13,0
65815,5,34,33,1,13,0
268305,2,17,3,14,17,1
309234,2,0,7,-7,1,0
375596,2,7,7,0,14,0
350637,4,13,3,10,2,0
42196,2,7,0,7,2,1
81635,1,7,0,7,3,0
67752,3,21,0,21,14,0
318470,4,31,7,24,5,0
259192,4,14,25,-11,13,0
233836,1,7,0,7,2,0
371764,3,17,14,3,12,0
154618,3,21,14,7,1,1
152107,4,13,13,0,17,0
409190,1,0,0,0,12,1
223688,3,13,13,0,15,1
201283,2,14,0,14,5,0
368858,2,24,3,21,11,0
310532,4,23,9,14,2,1
405878,1,7,0,7,11,1
127071,4,31,23,8,6,0
319035,3,7,23,-16,5,1
108141,4,13,42,-29,15,1
19222,4,21,19,2,10,1
415360,4,14,24,-10,15,1
49818,3,14,10,4,6,0
316628,4,9,12,-3,4,1
49561,4,14,3,11,6,1
153926,4,7,12,-5,1,0
360970,4,37,5,32,7,1
144794,4,10,17,-7,14,1
407612,3,10,17,-7,11,1
400948,2,16,7,9,8,0
124629,4,13,17,-4,5,1
25942,1,3,0,3,13,0
46345,3,6,17,-11,4,1
291447,3,14,20,-6,10,1
199386,3,13,10,3,4,0
111480,1,7,0,7,16,1
244503,2,25,3,22,7,0
2612,4,13,27,-14,2,0
88598,2,10,7,3,6,1
171863,1,0,0,0,9,0
226345,4,25,7,18,16,0
78413,2,14,0,14,2,1
419614,3,20,16,4,17,1
241889,3,13,13,0,5,1
183962,3,20,3,17,14,0
10000,1,0,0,0,5,1
213674,2,14,17,-3,10,0
295687,2,0,9,-9,12,1
63989,1,7,3,4,13,1
184149,4,16,14,2,14,0
89800,2,3,0,3,7,0
222099,4,27,17,10,14,1
149956,2,7,3,4,16,1
411861,1,0,0,0,13,1
32691,3,7,3,4,15,0
55029,1,0,0,0,8,1
78824,1,0,0,0,2,0
214992,1,3,0,3,11,0
166087,1,7,0,7,6,1
58005,5,20,20,0,10,0
334764,4,32,11,21,13,0
273437,2,0,0,0,2,0
254635,4,28,20,8,11,0
339288,3,31,0,31,15,0
183308,4,22,20,2,14,0
291976,1,0,0,0,11,0
161721,2,10,3,7,4,0
30812,1,0,6,-6,15,0
251884,3,14,13,1,10,0
103325,1,7,10,-3,13,1
35311,2,13,0,13,16,1
415084,1,0,0,0,15,0
411896,2,14,3,11,13,1
36073,3,31,0,31,17,0
158107,4,25,9,16,3,0
28212,2,10,0,10,13,0
22720,2,3,14,-11,11,1
130044,3,10,27,-17,8,1
2133,3,10,16,-6,1,1
395294,1,0,0,0,5,0
313753,3,28,9,19,3,0
117752,1,0,6,-6,2,1
113656,4,9,13,-4,17,0
145536,4,26,20,6,14,1
68990,3,21,14,7,15,1
315349,2,10,10,0,4,1
331606,3,20,29,-9,11,0
128327,2,0,3,-3,7,0
236325,2,0,23,-23,3,1
379580,2,13,6,7,16,0
338284,4,34,37,-3,14,0
26874,2,10,6,4,13,0
247511,1,3,0,3,8,0
5178,1,0,3,-3,3,1
297000,4,32,14,18,13,0
173985,1,0,0,0,10,1
246058,3,16,13,3,7,0
36623,2,3,3,0,17,0
163143,3,16,22,-6,5,0
359442,2,0,7,-7,6,0
197896,3,11,7,4,3,1
230285,2,16,10,6,17,1
81803,1,0,7,-7,3,0
260530,3,27,0,27,14,0
47680,3,3,17,-14,5,1
368561,3,9,0,9,11,0
51110,1,7,0,7,7,0
24275,4,13,17,-4,12,1
348576,3,28,17,11,2,1
185763,3,23,3,20,15,1
383043,1,3,7,-4,17,1
382224,2,10,3,7,17,0
306050,3,10,13,-3,17,1
408947,3,24,15,9,12,0
289148,2,13,7,6,9,1
3883,2,19,7,12,2,0
114520,3,17,27,-10,1,1
165120,4,17,24,-7,6,1
418305,3,6,14,-8,16,0
164016,2,0,3,-3,5,0
329318,2,6,14,-8,10,0
319124,2,2,0,2,5,1
333216,2,0,7,-7,12,1
103727,4,3,23,-20,13,1
263960,3,23,0,23,15,1
308683,2,7,6,1,1,1
71374,1,0,0,0,16,1
196604,4,27,20,7,2,1
351783,2,10,14,-4,3,1
342402,2,3,3,0,16,0
149684,2,20,0,20,16,0
144400,2,0,10,-10,14,1
13061,4,14,7,7,6,0
76328,2,13,3,10,1,0
179107,2,9,6,3,12,0
245628,4,43,20,23,7,0
213766,1,7,0,7,10,0
250393,4,24,26,-2,9,1
128370,3,7,10,-3,7,0
276478,2,10,7,3,4,1
395311,1,7,0,7,5,1
291696,2,0,3,-3,11,0
379426,2,0,0,0,16,1
25420,3,6,3,3,12,0
223007,4,13,23,-10,14,0
222081,4,27,10,17,14,0
281407,1,0,3,-3,6,0
324116,2,0,7,-7,8,0
30777,4,31,28,3,15,1
138512,4,31,30,1,12,0
390990,3,20,21,-1,4,1
176928,1,7,0,7,11,1
258286,3,21,12,9,13,1
267928,1,0,0,0,17,1
346096,4,10,6,4,1,1
413065,1,13,7,6,14,1
319298,2,10,3,7,6,0
328716,1,7,6,1,10,1
394830,1,0,0,0,5,0
347854,4,16,8,8,1,0
314715,1,0,0,0,4,1
18686,1,0,7,-7,9,0
379855,1,7,0,7,16,0
421549,3,13,3,10,17,1
382411,3,0,21,-21,17,0
100288,1,6,6,0,12,0
77686,3,10,17,-7,1,0
22302,2,0,3,-3,11,0
187274,4,10,6,4,16,0
65983,1,0,0,0,13,0
372195,4,9,16,-7,13,1
191182,1,0,3,-3,17,0
20471,2,0,0,0,10,1
192663,3,13,7,6,1,0
293809,3,17,6,11,12,1
72873,1,0,0,0,16,1
232091,4,0,33,-33,1,1
181046,1,7,0,7,13,0
242796,4,14,31,-17,6,0
86617,4,40,3,37,5,1
183446,4,27,6,21,14,0
137928,4,27,15,12,11,1
383262,3,37,10,27,17,1
85985,3,14,16,-2,5,0
396630,4,23,10,13,6,0
222781,2,10,7,3,14,0
114500,3,17,20,-3,1,1
57603,2,3,3,0,10,1
344938,2,9,7,2,17,1
263890,1,6,0,6,15,0
302244,3,31,13,18,15,0
238649,2,12,14,-2,4,1
155923,4,17,16,1,2,1
24823,2,6,3,3,12,0
306297,2,17,0,17,17,0
81746,4,30,17,13,3,1
57264,1,0,0,0,10,1
43147,1,0,0,0,3,1
230072,4,19,6,13,17,1
278474,2,29,0,29,4,0
40880,2,13,10,3,2,0
36571,4,23,37,-14,17,1
132975,2,0,14,-14,9,1
66556,1,0,0,0,14,0
376820,2,14,7,7,15,1
404433,1,7,0,7,10,1
375261,1,0,0,0,14,0
375168,3,17,10,7,14,0
205097,4,22,27,-5,6,1
32405,3,31,6,25,15,1
269373,3,7,17,-10,1,0
398181,2,7,10,-3,7,1
336627,4,7,7,0,14,1
147337,1,0,0,0,15,0
191057,1,7,0,7,17,0
53734,3,7,3,4,8,0
23829,4,24,7,17,12,1
121074,4,11,31,-20,3,0
161791,3,24,6,18,4,0
100260,4,24,14,10,12,1
296983,4,29,14,15,13,0
64765,4,28,7,21,13,1
262503,4,21,35,-14,15,1
255450,1,7,0,7,12,0
69857,3,21,9,12,15,0
263595,2,7,7,0,15,1
354795,3,13,20,-7,4,0
202857,2,14,0,14,5,0
34248,2,10,6,4,16,1
343841,3,24,3,21,17,0
73250,4,7,16,-9,16,1
55442,3,20,10,10,9,0
197454,3,13,6,7,3,0
334525,2,14,14,0,13,1
323367,2,10,0,10,7,1
234794,2,0,3,-3,2,0
131381,2,7,13,-6,8,0
91615,2,14,7,7,8,0
184254,3,24,7,17,14,1
387824,2,10,7,3,2,0
382679,2,0,6,-6,17,1
120621,4,3,20,-17,3,0
273764,2,7,7,0,2,0
193013,5,20,20,0,1,1
78440,3,17,0,17,2,0
306156,2,7,0,7,17,0
351036,2,7,10,-3,3,0
173704,1,0,0,0,10,0
241134,3,20,10,10,5,0
264785,3,17,23,-6,16,0
199512,2,17,0,17,4,0
239139,2,13,13,0,4,0
100515,3,10,17,-7,12,0
401116,3,27,3,24,8,0
350547,1,7,0,7,2,1
238064,4,13,13,0,4,0
244124,4,20,34,-14,6,0
107721,1,7,0,7,15,1
169653,2,20,10,10,8,1
3070,1,0,0,0,2,0
60790,1,7,3,4,11,1
277010,4,31,20,11,4,1
148073,4,14,10,4,15,0
196579,3,20,12,8,2,0
55667,2,17,14,3,9,0
86630,1,0,0,0,5,0
288527,2,10,28,-18,9,1
170944,4,31,20,11,8,0
65084,4,6,17,-11,13,0
133455,2,14,17,-3,9,1
289801,4,17,10,7,10,1
55095,3,16,3,13,8,1
213055,2,17,0,17,10,0
21852,2,7,0,7,11,1
11966,2,14,7,7,6,1
254347,4,13,27,-14,11,1
417705,4,35,12,23,16,0
44531,1,0,7,-7,3,0
29472,3,10,14,-4,14,0
373014,1,0,0,0,13,0
382478,1,0,0,0,17,0
102786,3,10,3,7,13,1
327919,4,37,24,13,10,0
321711,1,3,3,0,7,1
320509,4,26,24,2,6,1
314816,4,35,7,28,4,0
51216,4,32,25,7,7,0
304167,1,0,0,0,16,1
131249,3,14,17,-3,8,0
376317,1,0,0,0,14,1
28974,2,0,7,-7,14,1
322737,1,3,14,-11,7,0
4040,2,10,14,-4,2,1
250817,3,3,9,-6,10,0
307319,2,14,19,-5,17,1
336665,1,0,0,0,14,0
205993,3,13,10,3,7,1
93915,4,24,6,18,9,0
169433,4,13,31,-18,8,1
24353,2,3,0,3,12,1
317065,3,14,10,4,4,0
128864,4,26,23,3,7,1
322439,1,6,0,6,7,1
258950,1,0,7,-7,13,0
67086,4,10,9,1,14,1
247916,4,17,6,11,8,1
247048,1,0,3,-3,8,0
259898,2,14,10,4,14,0
268565,2,7,3,4,17,1
124995,2,3,3,0,5,0
405971,4,14,7,7,11,1
10581,1,0,7,-7,5,1
339656,4,31,24,7,15,0
416543,4,38,17,21,15,0
358430,3,29,13,16,6,0
27248,4,22,7,15,13,0
273390,4,38,7,31,2,0
16933,3,27,13,14,8,1
370206,4,31,10,21,12,0
308072,2,0,13,-13,1,1
35765,2,3,3,0,17,1
86603,4,40,3,37,5,0
40208,4,34,7,27,2,1
70927,4,15,36,-21,15,0
388146,2,3,6,-3,2,1
82530,4,17,27,-10,3,0
118054,1,0,6,-6,2,1
68070,3,3,10,-7,14,0
356772,1,0,0,0,5,1
110364,4,20,17,3,16,1
112845,2,7,3,4,17,1
92147,3,3,30,-27,8,0
114394,3,34,13,21,1,1
36419,4,34,26,8,17,0
238545,3,16,13,3,4,0
327495,1,0,0,0,10,0
81574,3,17,24,-7,3,0
43703,4,14,17,-3,3,1
368588,3,16,6,10,11,1
279369,2,6,7,-1,5,0
59929,2,3,3,0,11,0
270567,3,13,14,-1,1,1
320698,2,14,17,-3,6,1
385838,4,33,3,30,1,1
394925,3,0,17,-17,5,0
336046,4,16,25,-9,13,0
260210,2,10,3,7,14,1
41575,1,0,0,0,2,0
105631,1,7,0,7,14,0
115054,1,0,0,0,1,1
353724,4,10,17,-7,4,0
325772,2,0,10,-10,9,1
1066,2,7,22,-15,1,0
69843,2,14,9,5,15,1
377714,3,25,7,18,15,0
226514,4,14,20,-6,16,0
168670,1,0,0,0,7,1
320601,3,31,6,25,6,1
393550,2,7,9,-2,5,1
105165,1,7,0,7,14,0
330872,3,13,17,-4,11,0
26457,3,27,16,11,13,0
21337,4,14,17,-3,11,0
142090,2,0,7,-7,13,0
353305,4,38,28,10,4,1
408154,2,6,0,6,12,1
343987,3,16,6,10,17,0
157695,2,10,3,7,2,0
257312,1,3,0,3,13,1
114335,2,14,6,8,1,1
140341,3,17,20,-3,12,0
135537,3,14,6,8,10,0
148612,3,7,9,-2,16,1
216087,4,24,19,5,11,1
195241,3,16,17,-1,2,1
374908,4,14,24,-10,14,0
368261,2,3,3,0,11,0
369731,3,29,23,6,11,0
137177,1,0,0,0,11,1
369588,4,14,3,11,11,1
88125,1,0,0,0,6,0
240611,2,13,7,6,5,1
337811,3,30,6,24,14,0
396772,4,7,20,-13,6,0
408485,3,7,10,-3,12,1
205814,2,14,0,14,7,0
348146,4,24,22,2,1,0
365317,3,17,16,1,9,0
10927,2,6,13,-7,5,0
14021,2,3,14,-11,7,0
335185,3,20,13,7,13,1
38129,4,9,9,0,1,0
328836,4,17,20,-3,10,1
240981,4,21,22,-1,5,1
301803,4,3,34,-31,15,1
287439,1,7,10,-3,9,1
242822,4,21,34,-13,6,1
57438,1,7,0,7,10,0
99296,2,10,0,10,11,1
178757,1,14,7,7,12,1
323908,1,7,0,7,8,1
67338,3,20,6,14,14,1
307484,3,35,13,22,17,1
364972,2,7,3,4,9,0
332642,4,27,13,14,12,0
246484,2,12,0,12,8,0
381177,1,7,0,7,16,0
344355,2,14,0,14,17,0
192480,3,0,17,-17,1,1
242547,1,0,0,0,6,1
110647,4,20,10,10,16,0
59528,4,13,20,-7,11,0
195340,2,3,3,0,2,1
83021,1,0,0,0,4,0
356881,4,25,16,9,5,0
173246,4,20,27,-7,9,1
106346,3,14,19,-5,14,0
7102,2,21,14,7,4,0
108546,3,17,14,3,15,0
328059,4,17,17,0,10,1
127535,4,3,23,-20,6,0
16944,3,27,20,7,8,1
398930,3,10,10,0,7,1
240580,1,3,0,3,5,0
314682,4,14,21,-7,3,1
352593,4,34,23,11,3,1
7878,2,3,14,-11,4,0
398896,2,3,10,-7,7,1
209824,1,10,10,0,8,1
20138,2,3,0,3,10,1
256611,3,21,0,21,12,1
352602,4,34,23,11,3,1
220921,1,0,0,0,14,1
139383,2,14,0,14,12,1
254110,2,0,6,-6,11,1
142976,4,10,13,-3,13,0
211411,1,0,0,0,9,0
83159,4,13,30,-17,4,1
415922,4,10,23,-13,15,0
344757,1,0,0,0,17,1
298334,1,0,0,0,14,0
149336,1,0,0,0,16,1
212380,4,13,17,-4,10,0
204689,1,7,7,0,6,1
390105,3,16,14,2,3,1
52625,1,3,0,3,7,0
67731,2,14,0,14,14,1
178269,1,0,0,0,12,1
20318,2,10,10,0,10,0
48516,1,11,0,11,5,0
342353,1,0,0,0,16,0
171478,2,14,10,4,9,1
355264,2,14,14,0,4,0
45075,4,23,20,3,4,0
270231,2,3,21,-18,1,1
348871,3,6,14,-8,2,0
239034,4,36,18,18,4,0
206319,4,17,6,11,7,0
125876,2,13,10,3,6,0
146553,3,14,24,-10,15,1
256750,3,3,6,-3,12,0
171770,2,6,14,-8,9,1
31998,4,19,13,6,15,0
145652,3,28,7,21,14,1
291868,2,7,7,0,11,0
145180,3,46,0,46,14,0
217183,4,12,16,-4,12,0
183652,2,0,8,-8,14,1
381299,4,31,28,3,16,1
30366,4,10,20,-10,14,1
214826,1,0,0,0,11,0
233631,4,23,41,-18,2,0
20206,3,17,10,7,10,1
382247,2,17,3,14,17,1
61096,2,0,6,-6,11,0
254927,3,30,7,23,12,1
252472,2,7,19,-12,10,0
118389,2,6,10,-4,2,0
279555,3,10,13,-3,5,1
11764,1,0,0,0,6,1
13903,3,21,6,15,7,0
114129,4,24,14,10,17,0
349884,2,3,6,-3,2,1
12790,1,0,3,-3,6,1
359824,1,0,0,0,6,0
322553,1,0,0,0,7,0
71453,3,30,7,23,16,0
108364,2,0,14,-14,15,1
230337,4,19,17,2,17,1
127178,3,13,9,4,6,0
376826,3,14,7,7,15,1
379322,3,9,6,3,16,1
291149,3,18,13,5,10,0
202550,2,7,6,1,5,0
156309,2,16,0,16,2,1
162851,3,6,3,3,5,0
403098,5,34,34,0,9,1
175005,3,13,28,-15,10,1
356348,3,24,0,24,5,0
359198,4,13,21,-8,6,1
119474,3,13,17,-4,3,1
105355,2,16,7,9,14,0
210606,3,13,17,-4,9,1
57829,4,22,10,12,10,0
250599,1,3,0,3,10,0
35929,3,3,0,3,17,1
162139,1,0,0,0,4,0
194579,2,14,0,14,2,1
48622,4,21,27,-6,5,1
381858,4,18,21,-3,17,1
122274,2,6,13,-7,4,1
249575,3,21,13,8,9,0
112122,3,7,20,-13,17,1
264052,1,7,14,-7,15,0
309005,3,0,17,-17,1,0
4872,1,14,0,14,3,0
266427,1,0,0,0,16,0
79414,2,6,0,6,2,0
381697,3,20,14,6,17,0
267796,2,10,7,3,17,0
369762,4,38,43,-5,11,1
374326,4,25,13,12,13,0
168709,2,10,3,7,7,1
129337,1,14,7,7,7,0
167756,4,26,23,3,7,0
386163,2,3,3,0,2,1
312616,1,0,0,0,3,0
729,4,6,24,-18,1,0
329152,1,3,0,3,10,0
197012,3,20,20,0,3,1
372592,2,7,0,7,13,0
11584,4,20,16,4,6,0
349781,4,26,21,5,2,1
12201,1,0,0,0,6,0
95515,2,3,7,-4,10,1
338816,2,10,0,10,15,0
80398,4,27,16,11,2,0
343733,1,0,0,0,17,1
97986,3,17,10,7,11,0
341195,2,10,7,3,16,1
317661,3,9,6,3,5,1
349312,3,21,28,-7,2,1
269162,1,0,0,0,17,0
396218,1,0,0,0,6,0
132794,1,0,0,0,9,1
25935,1,3,0,3,13,1
389115,4,30,7,23,3,1
10450,1,3,0,3,5,0
108632,1,6,0,6,15,0
346142,1,6,0,6,1,1
101318,1,0,0,0,12,0
114318,1,7,6,1,1,1
106258,1,0,0,0,14,0
359484,3,0,14,-14,6,0
321349,4,29,22,7,6,0
312594,4,44,6,38,3,0
201410,1,6,0,6,5,0
62364,1,0,0,0,12,0
74643,2,0,3,-3,17,0
259882,2,14,7,7,14,0
299470,4,10,20,-10,14,0
383734,4,16,27,-11,17,0
406372,2,10,7,3,11,1
28052,2,7,7,0,13,0
282803,2,3,13,-10,6,1
94687,3,24,29,-5,9,0
416880,1,0,0,0,15,0
16343,2,7,7,0,8,1
64554,1,7,0,7,13,0
343534,4,10,10,0,16,0
179193,1,7,0,7,12,1
20263,1,7,0,7,10,0
357299,4,6,19,-13,5,1
217585,2,3,9,-6,12,0
204991,1,9,7,2,6,1
197999,2,0,20,-20,3,0
57154,2,7,0,7,10,0
202410,2,3,3,0,5,0
43242,3,24,10,14,3,1
384131,2,7,17,-10,1,0
121965,2,3,7,-4,4,1
34558,2,7,0,7,16,1
197153,3,27,20,7,3,0
162009,1,14,3,11,4,0
106809,4,33,22,11,14,1
87842,2,10,7,3,6,0
398794,3,14,24,-10,7,1
29895,4,16,23,-7,14,1
183305,4,22,20,2,14,0
160336,3,3,21,-18,4,1
380987,4,9,14,-5,16,0
328056,4,17,17,0,10,1
19506,4,33,17,16,10,1
30957,4,17,24,-7,15,1
62042,4,24,10,14,12,1
21325,4,6,17,-11,11,0
137468,1,0,0,0,11,1
34770,4,20,3,17,16,0
56467,3,0,38,-38,9,0
379864,2,7,0,7,16,1
268964,4,6,36,-30,17,1
301799,4,3,33,-30,15,0
412907,1,0,3,-3,14,1
9549,5,20,20,0,5,1
261057,2,0,14,-14,14,1
420596,2,0,10,-10,17,1
42047,2,19,7,12,2,1
108584,4,26,14,12,15,0
349271,2,7,21,-14,2,1
87868,3,10,12,-2,6,0
361178,1,0,7,-7,7,0
390213,2,0,6,-6,3,1
65412,2,0,7,-7,13,1
147108,2,14,31,-17,15,0
258716,3,3,20,-17,13,1
193533,2,0,0,0,1,0
109189,4,34,14,20,15,0
67759,3,21,0,21,14,1
368011,3,17,21,-4,11,0
83378,2,7,14,-7,4,1
404765,2,10,6,4,10,1
30743,3,24,28,-4,15,1
403064,4,24,24,0,9,1
78361,4,31,35,-4,2,1
259774,3,17,10,7,14,1
259372,4,35,34,1,13,0
419203,4,17,6,11,16,0
65935,3,17,14,3,13,0
94426,1,0,0,0,9,0
200284,2,17,14,3,4,0
360606,3,7,10,-3,7,1
325769,2,0,7,-7,9,0
46447,1,7,0,7,4,1
209214,3,17,7,10,8,0
158952,3,14,15,-1,3,0
252560,4,29,39,-10,10,1
18029,4,22,28,-6,9,0
405921,2,14,0,14,11,1
56278,3,3,17,-14,9,0
119385,1,0,14,-14,3,1
174201,2,3,22,-19,10,0
352899,4,14,16,-2,3,1
256013,4,19,12,7,12,1
277993,2,3,7,-4,4,0
414321,4,21,42,-21,14,0
50841,2,7,14,-7,6,0
52743,4,20,23,-3,7,0
89802,2,3,3,0,7,0
204525,1,0,7,-7,6,1
102975,4,12,31,-19,13,0
151693,4,37,44,-7,17,0
111771,1,3,7,-4,17,0
139209,1,3,6,-3,12,0
369463,4,45,7,38,11,1
273480,3,7,13,-6,2,1
162448,1,7,0,7,4,0
401364,1,10,0,10,8,1
354625,2,3,7,-4,4,1
132907,4,6,21,-15,9,1
188406,2,3,3,0,16,1
175906,4,23,27,-4,11,1
363746,4,26,27,-1,8,1
381354,2,6,0,6,16,1
121140,1,0,10,-10,3,0
23118,1,0,0,0,11,0
91426,1,3,0,3,8,0
131578,4,9,23,-14,8,0
356955,2,10,3,7,5,1
182258,1,7,0,7,14,1
303608,3,28,13,15,16,0
64013,2,17,3,14,13,0
298478,1,7,0,7,14,1
336457,3,10,17,-7,14,0
296723,1,0,0,0,13,1
325093,4,40,38,2,8,0
79989,1,7,0,7,2,0
233663,1,0,0,0,2,1
247115,2,13,6,7,8,1
334307,4,9,14,-5,13,1
338345,2,3,0,3,14,0
34547,2,7,0,7,16,0
143430,1,0,0,0,14,1
177308,4,20,20,0,11,1
62462,4,7,13,-6,12,1
171212,4,6,14,-8,8,1
117197,2,16,10,6,2,0
204685,1,7,7,0,6,1
253174,1,0,0,0,11,1
414156,3,10,20,-10,14,1
368920,4,38,10,28,11,1
416932,3,10,7,3,15,1
312284,4,10,23,-13,2,0
146632,1,0,7,-7,15,1
385218,1,0,3,-3,1,1
106950,3,12,6,6,14,1
164845,1,0,3,-3,6,1
194362,4,23,6,17,2,1
298500,2,10,0,10,14,1
64951,4,10,6,4,13,1
356264,1,0,0,0,5,1
356074,4,27,10,17,5,1
340017,2,14,6,8,15,0
310390,1,0,0,0,2,1
374224,1,0,0,0,13,1
206417,2,10,0,10,7,1
412505,3,24,7,17,14,0
96347,3,3,23,-20,10,0
140906,3,17,10,7,13,1
58369,2,21,0,21,10,0
292486,3,10,12,-2,11,1
126116,4,30,9,21,6,0
221601,3,20,18,2,14,0
31982,4,19,13,6,15,0
318166,3,16,17,-1,5,1
358852,2,3,14,-11,6,1
254221,1,0,0,0,11,1
177634,4,24,20,4,11,0
119278,3,14,3,11,3,1
214686,1,0,0,0,11,1
376363,2,3,0,3,14,1
144905,3,20,7,13,14,0
381918,1,0,7,-7,17,1
296471,3,17,0,17,13,1
300281,2,0,7,-7,14,1
22805,4,13,21,-8,11,0
241401,2,7,28,-21,5,1
410702,2,10,3,7,13,0
109356,1,0,7,-7,16,1
281716,4,31,30,1,6,1
38611,1,0,0,0,1,0
44965,1,0,0,0,4,1
271527,1,0,0,0,2,0
402344,4,26,24,2,9,0
193943,4,31,24,7,1,1
224216,4,0,23,-23,15,0
256696,1,0,3,-3,12,1
152222,3,21,0,21,17,0
116215,4,31,19,12,1,0
194063,4,27,13,14,1,0
415954,4,24,30,-6,15,0
119302,3,14,13,1,3,0
351106,4,29,30,-1,3,1
251416,4,43,14,29,10,1
389002,1,0,0,0,3,0
116701,2,6,10,-4,2,1
63568,2,10,7,3,12,1
334928,4,30,10,20,13,0
135067,2,17,3,14,10,0
114024,1,6,0,6,17,1
9049,3,21,13,8,4,1
178393,4,31,34,-3,12,1
342214,1,3,0,3,16,0
369240,1,13,7,6,11,1
128626,2,3,10,-7,7,0
100377,3,9,20,-11,12,0
169061,3,26,14,12,7,1
302755,1,3,3,0,15,0
200511,4,26,18,8,4,0
17956,2,13,20,-7,9,0
187225,2,0,6,-6,16,1
79514,4,12,27,-15,2,1
351504,2,0,27,-27,3,1
234056,3,20,0,20,2,1
92401,2,10,7,3,8,1
289488,3,13,7,6,10,0
135025,1,14,0,14,10,0
169208,3,10,6,4,7,0
321534,1,0,0,0,7,0
401041,1,0,0,0,8,1
62673,4,24,20,4,12,1
201484,2,19,7,12,5,0
73794,2,6,0,6,17,0
338378,3,10,0,10,14,0
228987,3,14,9,5,17,0
243206,1,0,0,0,6,1
331039,3,45,10,35,11,0
270234,2,3,21,-18,1,1
70663,4,17,22,-5,15,1
276352,2,14,28,-14,3,1
252199,4,23,24,-1,10,1
154438,2,14,7,7,1,1
240355,4,14,23,-9,5,1
378043,3,0,14,-14,15,1
138607,1,3,0,3,12,1
415879,3,7,20,-13,15,1
397940,4,10,17,-7,7,1
340952,3,10,10,0,15,0
203068,3,33,17,16,5,1
33545,3,17,3,14,16,0
360822,4,24,37,-13,7,1
362709,4,3,13,-10,8,0
95151,3,23,17,6,9,0
312172,1,0,0,0,2,0
267491,1,3,14,-11,17,1
329099,3,17,7,10,10,0
73168,1,7,0,7,16,1
386320,1,7,3,4,2,1
97510,2,16,0,16,10,1
420619,2,7,13,-6,17,1
303648,4,31,13,18,16,1
271314,3,6,24,-18,1,1
384462,3,21,0,21,1,1
137032,1,7,0,7,11,1
373458,1,0,0,0,13,1
103498,2,13,0,13,13,1
200277,2,10,14,-4,4,0
397306,3,0,21,-21,6,0
395547,4,21,14,7,6,1
51779,3,3,19,-16,7,1
141024,2,7,7,0,13,0
235993,2,10,0,10,3,0
88095,4,24,3,21,6,0
124090,2,3,21,-18,5,1
60955,2,14,6,8,11,1
353601,4,38,0,38,4,1
261641,1,0,0,0,14,1
188411,2,3,3,0,16,0
384814,2,6,3,3,1,0
211753,1,0,0,0,9,0
92600,3,17,3,14,8,1
234529,4,20,20,0,2,0
34068,1,0,0,0,16,0
194243,1,0,0,0,2,0
16711,4,21,33,-12,8,1
142679,4,20,20,0,13,0
279797,1,7,3,4,5,1
109374,1,3,7,-4,16,0
291879,2,7,10,-3,11,1
3138,2,3,6,-3,2,0
82281,2,3,0,3,3,0
5636,2,0,14,-14,3,1
407206,1,0,3,-3,11,1
135898,5,24,24,0,10,0
101874,2,3,10,-7,12,1
120783,4,23,6,17,3,1
242762,3,14,17,-3,6,0
36983,4,0,32,-32,17,0
189089,4,24,30,-6,16,1
279621,1,0,0,0,5,1
310550,1,0,6,-6,2,1
250279,1,7,0,7,9,0
19076,4,10,6,4,10,0
146584,4,21,31,-10,15,0
368539,2,9,0,9,11,0
177140,4,24,13,11,11,1
408871,1,0,0,0,12,1
71410,2,14,0,14,16,1
332377,4,16,20,-4,12,0
28331,1,0,0,0,14,1
390449,4,14,33,-19,3,1
323414,4,20,0,20,7,1
89824,2,6,3,3,7,0
3,1,0,0,0,1,1
387806,1,10,0,10,2,0
241222,1,0,0,0,5,1
19586,3,14,21,-7,10,0
340505,3,0,34,-34,15,0
179167,4,19,16,3,12,0
215035,2,13,7,6,11,1
251975,2,0,10,-10,10,0
383920,1,0,0,0,1,1
72450,1,7,7,0,16,0
206653,1,0,0,0,7,1
133425,1,14,7,7,9,0
58753,3,10,20,-10,10,0
215202,3,7,16,-9,11,1
176289,2,0,14,-14,11,0
227084,1,0,0,0,16,1
328072,4,17,20,-3,10,0
62699,1,0,0,0,12,0
173333,3,14,27,-13,10,1
139570,3,9,7,2,12,0
332564,1,3,3,0,12,1
367923,1,0,0,0,11,1
94514,3,0,3,-3,9,1
94996,3,6,16,-10,9,1
109994,2,17,10,7,16,1
222024,2,13,3,10,14,1
82435,1,0,7,-7,3,0
210263,1,3,0,3,9,1
232492,2,10,3,7,1,1
73929,2,14,0,14,17,1
413734,3,21,13,8,14,0
358545,2,10,3,7,6,1
243802,4,24,20,4,6,1
183227,2,7,14,-7,14,1
72283,4,27,33,-6,16,1
145587,2,21,0,21,14,0
201966,3,3,0,3,5,1
386904,1,7,7,0,2,0
245843,2,3,17,-14,7,0
277145,4,10,24,-14,4,0
342647,4,22,27,-5,16,1
378907,3,13,23,-10,15,1
90418,2,0,13,-13,7,1
27480,2,17,7,10,13,1
232631,2,0,0,0,1,1
105223,2,7,24,-17,14,0
321304,3,12,19,-7,6,0
277238,3,0,13,-13,4,0
343588,1,12,7,5,17,1
2539,2,10,7,3,2,1
84256,2,0,7,-7,4,1
354218,3,13,10,3,4,1
347651,3,17,10,7,1,0
8969,4,35,27,8,4,1
153548,2,5,14,-9,1,1
236194,3,17,16,1,3,1
348219,2,6,17,-11,1,1
304765,1,0,0,0,16,1
377662,2,16,7,9,15,0
64864,2,7,3,4,13,1
123118,1,0,0,0,4,1
147984,2,0,3,-3,15,1
101493,1,7,0,7,12,1
127987,4,23,27,-4,6,0
77956,2,3,10,-7,1,1
46352,3,6,17,-11,4,0
167224,3,23,17,6,7,0
203266,1,0,0,0,6,0
144556,2,7,16,-9,14,0
289579,2,7,13,-6,10,0
202968,1,7,0,7,5,0
87881,3,13,12,1,6,0
255178,2,7,0,7,12,0
343695,4,18,10,8,17,0
154460,3,14,7,7,1,1
17602,4,20,17,3,9,0
406758,1,0,3,-3,11,1
88860,4,13,16,-3,6,1
390834,2,0,21,-21,3,0
70262,2,7,6,1,15,0
401516,1,0,7,-7,8,0
307828,3,24,21,3,1,0
237131,4,8,33,-25,3,1
351639,2,7,7,0,3,0
351098,4,29,23,6,3,0
222293,1,0,0,0,14,1
395957,2,24,10,14,6,1
295681,2,0,2,-2,12,1
167198,2,23,7,16,7,0
112749,3,10,7,3,17,1
398414,1,0,0,0,7,0
301561,1,7,0,7,15,0
45627,3,13,13,0,4,0
376842,3,21,14,7,15,1
314809,3,28,7,21,4,0
33559,3,17,3,14,16,0
415836,1,0,13,-13,15,1
116958,4,35,13,22,2,0
202183,4,13,14,-1,5,0
314233,4,17,20,-3,3,1
87504,1,7,0,7,6,0
65633,3,6,16,-10,13,0
334624,1,0,0,0,13,1
189560,1,0,0,0,17,1
405462,4,24,10,14,10,0
348638,1,0,3,-3,2,1
115571,3,24,9,15,1,1
327116,2,7,3,4,9,0
135273,4,24,17,7,10,1
158665,3,14,7,7,3,0
107484,3,3,20,-17,15,0
317769,1,0,0,0,5,1
220794,1,0,0,0,14,0
108660,2,27,0,27,15,0
171133,1,3,0,3,8,1
14316,3,2,7,-5,7,1
83079,2,6,20,-14,4,0
371597,3,10,10,0,12,1
18504,4,20,14,6,9,0
282637,2,6,7,-1,6,0
104150,3,24,27,-3,13,1
49646,2,7,7,0,6,0
180014,2,7,20,-13,13,1
135211,2,13,3,10,10,0
370267,2,0,20,-20,12,0
96831,1,0,0,0,10,0
385689,5,27,27,0,1,1
302439,1,0,3,-3,15,1
301516,4,20,15,5,15,0
326316,2,0,10,-10,9,0
227794,4,6,20,-14,16,0
329707,4,40,17,23,11,0
219650,3,10,7,3,13,1
56225,1,3,7,-4,9,1
404279,1,0,3,-3,10,1
221663,1,0,0,0,14,0
405856,1,7,0,7,11,0
131623,1,0,6,-6,8,0
141814,2,10,14,-4,13,0
229014,4,21,16,5,17,1
349924,4,3,12,-9,2,1
162177,2,7,7,0,4,1
322412,4,17,26,-9,7,0
24959,2,10,14,-4,12,1
284812,4,26,20,6,7,1
25393,2,6,0,6,12,0
400859,4,31,19,12,8,0
71637,3,3,31,-28,16,1
18869,3,3,6,-3,9,0
389189,2,21,0,21,3,0
229109,2,16,7,9,17,0
260928,2,0,0,0,14,0
207874,2,7,7,0,8,1
117234,4,23,17,6,2,1
348743,4,30,17,13,2,1
309584,3,16,3,13,1,1
224284,2,9,9,0,15,0
269792,2,10,7,3,1,0
306,1,6,0,6,1,1
63556,1,10,0,10,12,0
122935,4,37,6,31,4,1
196683,2,33,0,33,3,1
143174,1,7,3,4,13,0
387855,2,10,21,-11,2,1
40313,3,6,7,-1,2,1
4120,4,23,28,-5,2,1
415583,2,7,10,-3,15,1
359170,3,7,14,-7,6,1
32835,3,6,7,-1,15,1
133478,3,20,17,3,9,0
1010,1,0,0,0,1,1
415153,2,3,21,-18,15,0
6224,2,13,0,13,3,1
275757,2,16,3,13,3,1
26203,4,0,33,-33,13,1
99894,2,0,3,-3,12,1
389892,1,6,3,3,3,1
64434,2,6,6,0,13,1
352800,2,14,0,14,3,1
137362,2,3,7,-4,11,1
398098,4,24,28,-4,7,1
302951,2,20,6,14,16,0
98505,4,31,24,7,11,0
354937,2,7,3,4,4,1
351363,3,10,7,3,3,1
216459,1,14,0,14,12,1
392074,4,18,33,-15,4,1
100049,2,3,3,0,12,1
137266,3,7,13,-6,11,0
5014,1,0,0,0,3,0
327343,1,0,0,0,9,1
267478,1,0,7,-7,17,1
39844,2,3,0,3,1,1
222207,3,13,10,3,14,0
266448,1,0,9,-9,16,1
76625,2,10,0,10,1,1
279266,3,19,13,6,5,0
357744,4,43,13,30,5,0
231333,3,9,16,-7,1,1
40913,3,16,20,-4,2,0
371360,4,42,10,32,12,0
276979,4,17,20,-3,4,1
130740,1,0,3,-3,8,1
169299,1,0,0,0,8,0
224392,1,0,0,0,15,0
71147,2,19,3,16,16,0
333926,1,0,7,-7,12,0
358150,3,17,6,11,6,0
97198,2,6,6,0,10,1
93694,1,0,0,0,9,0
165268,3,17,14,3,6,0
49121,5,20,20,0,6,0
357,2,14,10,4,1,1
342880,2,16,7,9,16,0
66292,1,0,0,0,14,0
73819,3,6,0,6,17,1
285179,5,6,3,3,7,0
364785,1,0,0,0,9,1
336663,1,0,0,0,14,0
123108,1,0,0,0,4,1
296712,1,0,0,0,13,0
255711,4,3,13,-10,12,0
191642,1,0,3,-3,17,1
264812,4,17,37,-20,16,1
368997,3,10,7,3,11,0
229310,4,24,27,-3,17,1
240842,4,29,10,19,5,1
46825,4,14,39,-25,4,0
167240,4,30,17,13,7,0
77187,1,0,0,0,1,0
303406,2,10,0,10,16,0
253133,4,21,20,1,11,1
414232,2,14,14,0,14,0
362363,3,23,14,9,8,0
329811,3,17,20,-3,11,0
80089,4,24,22,2,2,0
52483,2,3,0,3,7,0
177297,4,17,20,-3,11,1
91412,1,0,0,0,8,1
142498,3,27,10,17,13,0
187877,4,7,23,-16,16,1
49101,4,13,20,-7,6,1
182576,1,0,3,-3,14,0
153617,4,12,14,-2,1,1
389361,3,23,12,11,3,0
143063,2,3,14,-11,13,1
242809,4,14,34,-20,6,1
42397,4,14,19,-5,2,1
180707,1,0,0,0,13,1
395678,3,10,27,-17,6,0
20593,1,0,0,0,10,1
188573,3,10,13,-3,16,0
226694,1,7,3,4,16,0
153077,2,0,10,-10,1,0
372873,1,9,0,9,13,1
127022,3,24,20,4,6,0
418337,4,9,24,-15,16,1
121887,4,0,23,-23,4,0
323951,2,10,10,0,8,0
281284,2,7,6,1,6,0
234570,1,0,0,0,2,1
213345,2,10,6,4,10,0
270660,1,3,0,3,1,1
177616,4,17,20,-3,11,1
316963,4,37,18,19,4,1
43957,2,3,7,-4,3,0
298192,1,0,3,-3,14,1
74439,4,13,20,-7,17,1
382185,1,0,0,0,17,0
88238,4,31,17,14,6,0
9078,4,28,13,15,4,1
280851,2,10,3,7,6,0
185110,3,0,16,-16,15,0
120953,1,2,0,2,3,1
295089,2,7,7,0,12,1
218425,2,10,14,-4,13,1
247658,1,7,0,7,8,0
254722,2,3,3,0,11,1
192139,2,0,6,-6,1,0
200322,4,27,14,13,4,1
275912,3,13,12,1,3,0
287947,3,14,13,1,9,1
243840,1,0,0,0,6,1
328555,1,7,0,7,10,0
133353,3,14,9,5,9,1
52910,1,0,0,0,7,1
130858,4,20,12,8,8,0
125041,4,3,19,-16,5,1
116194,4,20,19,1,1,1
61970,2,3,0,3,12,0
101395,3,12,7,5,12,1
213740,4,38,17,21,10,1
226851,1,0,7,-7,16,1
280041,4,6,20,-14,5,0
139091,2,6,3,3,12,1
38683,3,14,7,7,1,0
24269,4,13,17,-4,12,0
131464,1,0,0,0,8,1
143953,3,0,10,-10,14,1
412969,3,16,12,4,14,0
332942,4,31,3,28,12,1
27038,3,10,3,7,13,0
84472,3,13,10,3,4,0
318937,4,31,34,-3,5,0
49993,3,28,10,18,6,0
400649,2,3,0,3,8,0
398877,2,3,3,0,7,0
202489,4,9,16,-7,5,0
215398,4,24,20,4,11,0
128794,2,10,13,-3,7,1
172444,4,13,49,-36,9,1
91701,4,21,24,-3,8,1
371263,1,0,7,-7,12,1
248524,4,23,20,3,8,0
147223,2,0,21,-21,15,1
259118,2,7,0,7,13,1
169304,1,0,0,0,8,0
352254,3,3,3,0,3,0
409135,4,3,17,-14,12,1
248957,3,20,3,17,9,1
170929,4,28,20,8,8,0
303417,2,10,7,3,16,1
53450,4,10,28,-18,8,0
230539,2,3,7,-4,1,1
301315,2,14,7,7,15,1
243473,4,10,23,-13,6,0
353528,2,10,0,10,4,1
76642,2,10,0,10,1,1
246048,2,10,13,-3,7,1
328723,2,7,6,1,10,0
299537,2,0,3,-3,14,1
57760,2,16,3,13,10,1
365803,4,31,17,14,9,0
108472,1,7,0,7,15,0
264870,1,3,7,-4,16,0
321530,1,0,0,0,7,0
109395,2,3,10,-7,16,1
274828,1,0,0,0,3,0
31004,2,0,3,-3,15,1
371726,2,14,14,0,12,0
135644,2,7,7,0,10,0
28919,1,0,0,0,14,1
413514,1,0,3,-3,14,1
246727,1,3,0,3,8,0
3173,3,13,9,4,2,1
236962,3,38,7,31,3,1
395291,1,0,0,0,5,0
414033,4,10,45,-35,14,1
162715,4,26,24,2,5,1
2285,3,10,10,0,1,0
296855,1,0,0,0,13,1
396874,3,27,10,17,6,0
9760,2,2,7,-5,5,0
202294,3,6,3,3,5,1
53665,1,0,0,0,8,1
117899,1,0,0,0,2,0
345374,2,0,10,-10,17,1
154886,2,6,3,3,1,1
154878,2,6,3,3,1,0
235961,1,7,0,7,3,0
413454,4,17,38,-21,14,0
4761,2,13,0,13,3,1
326963,2,2,7,-5,9,0
362501,2,13,6,7,8,1
168766,4,16,9,7,7,1
123997,4,13,7,6,5,0
303600,3,28,13,15,16,0
333764,1,6,0,6,12,0
421745,4,24,17,7,17,1
202380,1,0,0,0,5,1
312302,1,0,7,-7,3,1
120410,2,19,9,10,3,1
264588,3,10,17,-7,16,1
105601,4,32,28,4,14,0
21797,1,0,0,0,11,0
107904,2,0,3,-3,15,0
91291,2,7,0,7,8,0
212813,4,17,21,-4,10,1
118740,4,27,12,15,2,0
349978,1,3,0,3,2,1
346544,3,24,33,-9,1,0
104759,2,17,16,1,14,1
259031,4,3,16,-13,13,0
7950,4,3,27,-24,4,1
343547,4,10,10,0,16,0
99242,4,31,20,11,11,1
260574,4,30,8,22,14,0
261182,1,13,0,13,14,1
325743,1,0,7,-7,9,1
404686,4,27,32,-5,10,1
164507,3,17,0,17,5,0
65638,4,6,19,-13,13,1
84439,2,6,7,-1,4,1
159598,3,20,12,8,3,1
411886,2,14,0,14,13,0
384061,4,27,30,-3,1,0
240684,4,36,24,12,5,1
36438,1,0,3,-3,17,1
262836,1,7,7,0,15,1
376254,3,10,14,-4,14,0
330166,1,0,0,0,11,0
205333,2,20,0,20,6,1
223194,2,3,3,0,15,0
154495,4,14,17,-3,1,1
374666,1,0,0,0,14,0
227921,3,27,20,7,16,1
381443,4,23,14,9,16,1
141209,3,3,21,-18,13,0
321228,1,0,0,0,6,1
59135,1,0,7,-7,10,1
160203,3,30,7,23,3,1
12657,1,10,0,10,6,1
51778,3,3,19,-16,7,1
263744,2,0,0,0,15,0
49010,2,10,7,3,6,0
345730,3,7,7,0,17,1
269309,1,0,0,0,1,0
344567,4,0,0,0,17,0
411962,4,17,17,0,13,1
147026,4,27,0,27,15,1
367550,2,14,6,8,10,0
258843,2,7,7,0,13,1
50682,1,0,7,-7,6,0
361132,4,23,23,0,7,1
309404,2,0,0,0,1,1
134356,3,22,21,1,10,1
394435,2,7,10,-3,5,0
165339,1,0,0,0,6,0
246711,1,0,0,0,8,1
345043,1,0,0,0,17,0
9740,1,0,7,-7,5,1
415326,3,7,14,-7,15,0
201405,1,6,0,6,5,0
159017,4,33,29,4,3,1
417084,3,27,0,27,15,0
293456,1,0,0,0,11,0
241,3,12,17,-5,1,0
177991,2,7,13,-6,12,1
22879,2,0,13,-13,11,1
351526,3,0,27,-27,3,1
70800,4,30,27,3,15,0
193582,3,0,10,-10,1,0
371519,1,0,0,0,12,1
247838,1,0,3,-3,8,1
125810,4,17,23,-6,5,0
270403,2,10,7,3,1,1
360527,1,0,7,-7,7,1
208720,1,0,0,0,8,0
222388,4,24,10,14,14,1
406966,2,3,13,-10,11,0
278611,2,14,0,14,4,0
23242,4,23,13,10,11,1
340240,4,29,31,-2,15,0
52293,4,36,19,17,7,0
33253,3,10,0,10,16,1
278357,3,17,14,3,4,0
210646,3,13,24,-11,9,0
182650,3,0,6,-6,14,0
286236,2,3,12,-9,8,0
283925,4,31,17,14,7,1
395396,3,28,3,25,5,0
50824,2,7,7,0,6,0
135797,2,7,14,-7,10,1
338173,1,7,14,-7,14,1
35803,3,3,10,-7,17,0
296290,2,0,10,-10,13,1
185183,1,0,0,0,15,0
150069,4,31,12,19,16,0
289230,4,30,19,11,9,0
196261,3,21,10,11,2,0
178315,2,7,3,4,12,1
382109,3,21,3,18,17,0
403327,3,9,0,9,9,1
405928,3,14,0,14,11,1
292224,4,24,17,7,11,0
295836,1,0,7,-7,12,1
370512,4,27,9,18,12,1
397251,1,0,0,0,6,0
251413,4,43,14,29,10,0
77110,3,14,17,-3,1,1
281499,3,10,10,0,6,0
255315,1,7,0,7,12,1
360309,3,0,13,-13,7,1
83725,3,22,20,2,4,0
95047,4,20,23,-3,9,1
175835,2,20,10,10,11,0
343649,3,15,10,5,17,1
359835,1,7,7,0,6,1
396483,4,28,32,-4,6,0
421316,4,28,10,18,17,1
190948,2,9,0,9,17,0
210243,1,0,0,0,9,0
79622,3,14,14,0,2,0
273166,2,17,0,17,2,1
371463,3,14,17,-3,12,1
76338,2,13,3,10,1,1
260381,3,6,7,-1,14,1
374497,1,0,0,0,14,1
376638,1,0,0,0,14,1
118083,1,3,6,-3,2,0
414681,2,3,7,-4,14,0
398127,4,30,42,-12,7,1
143185,2,7,3,4,13,1
265492,3,7,7,0,16,1
282979,2,14,3,11,6,0
185006,4,14,23,-9,15,0
290237,3,17,3,14,10,1
364289,3,3,29,-26,9,1
308176,1,0,0,0,1,0
84138,2,7,0,7,4,1
172763,4,21,18,3,9,0
94151,2,10,7,3,9,0
365156,3,7,28,-21,9,1
119585,2,10,0,10,3,0
152549,4,24,13,11,17,0
215945,3,13,21,-8,11,0
340396,4,17,13,4,15,1
152294,1,0,0,0,17,0
190065,2,17,3,14,17,1
343384,4,6,27,-21,16,1
19644,4,23,28,-5,10,0
230556,2,10,7,3,1,0
206745,4,7,24,-17,7,0
77970,2,3,10,-7,1,1
72066,3,7,10,-3,16,1
163570,2,7,16,-9,5,1
141561,4,34,10,24,13,0
95356,1,7,0,7,10,0
327933,1,0,0,0,10,0
379640,4,26,13,13,16,0
9725,1,0,7,-7,5,1
8492,3,15,3,12,4,0
61346,1,0,0,0,11,1
403340,3,12,0,12,9,1
158774,2,7,3,4,3,0
147523,2,3,0,3,15,1
100309,2,6,7,-1,12,1
140542,1,0,0,0,12,1
28760,1,0,0,0,14,0
258817,2,7,7,0,13,1
87430,3,17,7,10,6,1
149088,2,14,14,0,16,1
107605,2,6,7,-1,15,1
15805,3,0,12,-12,8,0
399125,4,18,36,-18,7,1
211278,1,3,0,3,9,0
20365,3,10,13,-3,10,1
384930,1,0,0,0,1,0
397614,3,6,20,-14,7,0
93333,3,27,3,24,9,0
126278,1,0,0,0,6,0
89934,1,0,7,-7,7,0
92987,2,10,3,7,8,0
366188,4,7,48,-41,10,0
284973,4,16,20,-4,7,1
367984,2,10,14,-4,11,1
258396,2,14,6,8,13,0
67072,4,10,9,1,14,0
167377,4,30,30,0,7,1
406366,2,10,7,3,11,1
355034,4,18,26,-8,4,0
343717,4,18,10,8,17,1
138441,2,7,7,0,12,1
197803,4,21,23,-2,3,0
222332,2,14,3,11,14,1
297216,2,0,6,-6,13,1
184848,4,24,20,4,15,0
277409,3,30,9,21,4,1
111647,2,14,10,4,16,0
299464,4,7,20,-13,14,1
308109,3,13,16,-3,1,0
68339,2,3,7,-4,14,0
297008,1,0,0,0,13,1
386064,3,14,0,14,1,0
200781,4,31,3,28,4,1
7676,1,0,0,0,4,1
184099,2,9,14,-5,14,1
282297,4,28,17,11,6,0
294346,2,10,3,7,12,1
199160,4,14,45,-31,4,0
80496,2,5,3,2,3,1
36166,1,7,7,0,17,0
355404,2,10,10,0,4,0
111053,2,10,0,10,16,0
373736,4,13,21,-8,13,1
195965,3,0,24,-24,2,1
176925,1,7,0,7,11,1
368106,2,7,7,0,11,1
288988,2,16,7,9,9,1
103443,1,0,0,0,13,0
303948,4,14,31,-17,16,0
256931,3,20,21,-1,12,0
303170,4,21,28,-7,16,1
152130,4,13,13,0,17,1
71007,2,10,0,10,16,0
11079,2,10,10,0,5,1
239955,1,0,3,-3,5,1
158440,1,0,0,0,3,0
94788,2,3,6,-3,9,1
412565,4,31,21,10,14,0
273598,2,3,3,0,2,1
168138,2,9,5,4,7,1
404499,3,21,19,2,10,0
227870,2,10,6,4,16,0
341910,4,37,15,22,16,1
75926,3,32,7,25,1,1
32069,2,14,10,4,15,0
143567,5,28,28,0,14,0
79515,4,12,27,-15,2,1
343598,1,15,7,8,17,0
71050,3,20,0,20,16,1
111181,1,7,0,7,16,1
105038,2,0,14,-14,14,1
333320,1,10,7,3,12,1
293895,1,0,14,-14,12,1
326029,1,9,0,9,9,0
184628,2,10,3,7,15,0
249334,2,10,6,4,9,1
21253,2,3,0,3,11,1
267267,3,17,14,3,17,0
187053,2,3,0,3,16,1
129157,4,34,35,-1,7,1
280759,4,14,14,0,5,1
296891,2,10,0,10,13,0
395375,3,28,3,25,5,0
373859,3,27,10,17,13,1
27901,2,0,0,0,13,0
409097,3,3,10,-7,12,0
361104,4,23,16,7,7,1
54102,4,20,3,17,8,1
63296,2,3,0,3,12,0
396021,4,38,20,18,6,1
193502,1,0,0,0,1,0
383364,2,0,6,-6,17,0
271751,3,16,10,6,2,1
188665,1,0,0,0,16,0
363910,1,0,0,0,8,1
200065,4,24,20,4,4,0
283119,2,3,3,0,7,1
379301,2,0,6,-6,16,1
328180,4,14,14,0,10,1
294186,2,0,7,-7,12,1
382556,3,0,10,-10,17,0
304349,3,19,7,12,16,1
404902,2,3,3,0,10,0
225707,4,21,13,8,16,0
9159,2,0,13,-13,5,0
94640,2,14,19,-5,9,1
421389,2,13,20,-7,17,1
86320,4,27,23,4,5,0
201965,3,3,0,3,5,1
20937,1,7,7,0,10,0
111413,3,0,17,-17,16,0
244870,4,7,10,-3,7,0
309106,2,9,3,6,1,0
83955,1,7,0,7,4,0
199239,3,17,21,-4,4,0
264481,4,27,35,-8,15,0
362154,1,0,0,0,8,0
297818,2,14,7,7,13,1
361442,1,0,0,0,7,0
294000,1,0,0,0,12,0
203969,3,10,7,3,6,1
137911,3,24,15,9,11,1
369178,4,19,20,-1,11,1
404615,2,13,10,3,10,0
311061,2,10,3,7,2,1
343566,1,6,0,6,17,1
378031,3,0,7,-7,15,0
419238,4,17,9,8,16,1
229293,3,24,24,0,17,0
140905,3,17,10,7,13,1
15801,3,0,12,-12,8,1
61605,4,35,14,21,11,1
136153,3,10,10,0,10,1
277765,4,17,6,11,4,0
102280,2,10,7,3,13,1
293555,4,13,17,-4,11,0
85039,3,25,16,9,4,0
295898,3,10,17,-7,12,1
212265,1,7,3,4,10,1
205411,4,27,0,27,6,1
322768,2,3,20,-17,7,0
139470,4,27,10,17,12,1
58563,3,10,10,0,10,1
93314,2,24,3,21,9,1
120220,1,7,0,7,3,0
88699,4,26,20,6,6,0
124174,4,22,21,1,5,1
204155,3,10,17,-7,6,1
5051,2,7,0,7,3,1
77980,2,3,10,-7,1,0
122987,2,0,3,-3,4,1
457,1,0,3,-3,1,1
347622,2,17,10,7,1,0
16223,2,3,0,3,8,0
202763,3,16,17,-1,5,0
53610,4,14,22,-8,8,0
158032,2,0,6,-6,3,1
198078,4,10,37,-27,3,1
36766,2,7,7,0,17,0
417100,4,34,0,34,15,1
331784,4,23,27,-4,12,0
293037,2,10,13,-3,11,0
258855,3,14,7,7,13,0
246498,2,19,0,19,8,0
356056,3,24,10,14,5,0
28409,3,13,3,10,14,0
302701,4,23,20,3,15,0
403620,3,24,13,11,9,0
418497,4,24,12,12,16,0
250760,2,3,0,3,10,1
284742,2,6,10,-4,7,0
128082,3,3,6,-3,7,0
240490,3,3,7,-4,5,0
361103,4,23,16,7,7,1
208402,4,23,43,-20,8,0
308719,3,7,13,-6,1,0
326771,2,3,14,-11,9,0
68793,2,6,0,6,15,0
258339,4,41,39,2,13,0
190481,1,7,0,7,17,1
181043,1,7,0,7,13,0
143210,2,10,10,0,13,1
71123,1,12,0,12,16,1
4267,4,20,6,14,2,0
69525,1,0,0,0,15,1
99874,1,0,3,-3,12,0
344840,3,23,10,13,17,0
379463,3,16,0,16,16,0
174197,2,3,16,-13,10,0
267700,3,14,24,-10,17,0
151733,2,7,3,4,17,1
221571,2,20,12,8,14,0
319537,4,13,23,-10,6,1
272855,2,20,6,14,2,0
349425,2,0,7,-7,2,0
98671,1,0,0,0,11,0
306232,4,20,3,17,17,1
60286,4,17,16,1,11,0
158884,1,14,0,14,3,0
272762,4,15,10,5,2,0
307907,1,0,0,0,1,0
92429,3,17,10,7,8,1
265471,2,7,7,0,16,1
260155,1,0,0,0,14,1
16686,4,20,30,-10,8,1
97710,4,9,10,-1,11,0
236553,4,10,9,1,3,0
369528,2,3,0,3,11,1
60258,4,10,16,-6,11,0
629,2,0,3,-3,1,1
70733,2,7,10,-3,15,0
257441,4,23,21,2,13,0
292382,4,12,16,-4,11,0
63493,4,31,13,18,12,0
89586,4,7,33,-26,7,0
123137,2,3,7,-4,4,1
41104,4,3,19,-16,2,1
119482,4,14,17,-3,3,1
402013,3,3,12,-9,9,0
257926,1,0,0,0,13,0
294555,4,24,13,11,12,1
306123,1,0,0,0,17,1
362639,2,0,7,-7,8,1
143090,3,17,17,0,13,0
188151,3,10,10,0,16,0
229152,4,19,7,12,17,1
400288,4,24,9,15,8,1
381148,4,31,28,3,16,0
289961,4,6,6,0,10,0
97993,3,17,10,7,11,1
295510,2,13,7,6,12,1
363842,3,13,17,-4,8,0
398883,2,3,3,0,7,0
333499,2,6,0,6,12,0
271275,2,6,7,-1,1,0
177837,2,14,10,4,12,1
370534,1,0,0,0,12,1
336685,1,0,3,-3,14,1
382269,3,17,3,14,17,0
398490,3,14,9,5,7,1
98365,1,0,0,0,11,0
42867,1,0,0,0,3,0
417213,3,17,17,0,16,0
466,1,0,3,-3,1,1
406972,3,3,20,-17,11,1
321251,1,3,3,0,6,1
114219,3,3,7,-4,1,0
124999,2,3,3,0,5,0
206,2,6,10,-4,1,1
229179,4,19,7,12,17,1
256045,1,0,0,0,12,0
367343,4,6,20,-14,10,1
218863,2,14,3,11,13,1
374214,4,30,31,-1,13,0
341410,4,0,13,-13,16,1
43280,4,24,10,14,3,1
140186,4,13,3,10,12,0
169918,1,7,0,7,8,0
236295,2,0,9,-9,3,1
285906,2,20,0,20,8,0
337103,4,26,15,11,14,1
220646,1,7,0,7,13,0
40728,2,17,7,10,2,0
223634,1,6,3,3,15,1
291188,4,24,29,-5,10,0
91144,2,3,14,-11,8,1
223025,1,7,0,7,14,0
387804,1,10,0,10,2,0
221380,1,0,17,-17,14,1
59093,4,3,23,-20,10,1
118658,2,14,6,8,2,1
312898,4,14,21,-7,3,1
308991,3,0,17,-17,1,0
224733,2,5,0,5,15,0
175909,4,23,27,-4,11,1
76586,1,0,0,0,1,1
220840,3,7,21,-14,14,1
101661,1,3,0,3,12,0
360660,4,17,27,-10,7,0
154545,1,0,0,0,1,1
398440,1,7,0,7,7,0
177744,4,13,17,-4,12,1
146146,4,28,17,11,15,0
256254,2,6,7,-1,12,0
389813,3,17,6,11,3,1
94490,2,0,0,0,9,1
137078,2,14,3,11,11,1
98577,2,7,7,0,11,0
399612,2,3,3,0,8,1
328942,3,9,7,2,10,0
198224,4,16,9,7,3,0
286529,2,3,14,-11,8,1
13568,2,3,0,3,7,0
415609,3,14,13,1,15,0
406246,3,21,24,-3,11,0
253352,1,7,0,7,11,0
177225,2,7,7,0,11,1
279182,1,0,3,-3,5,1
276627,2,14,6,8,4,0
55090,2,16,3,13,8,1
53162,4,19,38,-19,7,0
75784,4,35,26,9,1,1
407716,2,3,0,3,11,0
312967,2,0,0,0,3,0
63900,3,6,21,-15,12,0
14230,4,0,38,-38,7,0
332173,2,3,10,-7,12,0
55463,4,23,10,13,9,0
285011,4,16,27,-11,7,1
246226,3,21,16,5,7,0
293738,1,7,0,7,12,0
268045,4,21,9,12,17,1
47837,3,10,6,4,5,0
168498,4,10,30,-20,7,1
315212,3,17,10,7,4,0
357492,1,0,6,-6,5,1
133181,3,13,17,-4,9,1
320932,4,13,21,-8,6,1
95299,3,10,24,-14,10,1
213972,2,29,7,22,10,0
38554,3,24,6,18,1,1
417803,1,7,0,7,16,1
307192,3,0,10,-10,17,0
393562,2,7,9,-2,5,1
232808,3,16,14,2,2,0
19049,4,7,6,1,10,1
84051,4,30,22,8,4,0
125817,4,17,23,-6,5,1
205011,2,9,7,2,6,0
181365,2,14,7,7,13,0
372429,2,6,7,-1,13,1
327809,1,3,10,-7,10,0
25913,4,38,17,21,12,1
317377,3,7,3,4,5,0
23033,3,7,14,-7,11,1
355962,1,0,7,-7,5,1
34072,2,0,0,0,16,1
251142,4,10,20,-10,10,0
263734,2,0,0,0,15,0
355485,4,23,20,3,4,0
220273,3,20,9,11,13,1
106047,4,24,3,21,14,1
110280,2,0,17,-17,16,1
187283,4,10,6,4,16,0
363358,2,0,10,-10,8,1
111445,4,0,20,-20,16,1
72119,4,17,17,0,16,0
358009,3,24,13,11,6,0
36760,2,6,7,-1,17,1
326703,4,23,13,10,9,0
214282,3,14,10,4,11,0
369998,2,7,7,0,12,1
224960,4,3,16,-13,15,1
68786,2,6,0,6,15,1
80797,2,3,0,3,3,0
308459,4,7,25,-18,1,0
352752,4,24,13,11,3,1
272263,3,9,3,6,2,0
5514,2,10,10,0,3,1
30347,4,10,17,-7,14,1
185313,4,41,22,19,15,0
198785,2,3,6,-3,3,0
23722,1,0,0,0,12,1
59976,3,3,24,-21,11,0
14928,3,14,17,-3,7,0
344112,2,17,3,14,17,1
106309,2,7,9,-2,14,0
362497,2,7,6,1,8,1
369094,1,3,0,3,11,1
267788,1,3,0,3,17,1
369117,2,6,7,-1,11,1
97858,4,14,27,-13,11,0
365431,2,7,18,-11,9,0
74583,4,10,3,7,17,1
238664,3,16,14,2,4,0
53304,4,16,10,6,8,1
129090,3,20,21,-1,7,1
139292,3,20,13,7,12,0
229322,4,24,27,-3,17,0
15103,4,10,26,-16,7,1
297254,3,21,6,15,13,0
394545,1,0,0,0,5,1
134552,1,0,0,0,10,1
283996,2,3,0,3,7,0
146010,1,3,0,3,15,1
253827,1,7,7,0,11,1
41218,4,7,13,-6,2,1
195048,2,7,17,-10,2,0
303806,4,20,17,3,16,1
325925,2,13,7,6,9,0
96794,4,7,17,-10,10,1
216066,3,17,12,5,11,0
13724,2,0,17,-17,7,1
412696,4,30,10,20,14,1
175311,4,22,19,3,10,0
36081,3,31,0,31,17,1
263140,2,3,7,-4,15,0
271707,2,6,9,-3,2,0
175517,2,3,0,3,11,1
139827,2,10,10,0,12,0
172634,1,0,0,0,9,0
18117,2,3,17,-14,9,0
279893,4,24,13,11,5,0
412291,1,0,7,-7,13,1
200552,1,14,7,7,4,0
411193,3,3,23,-20,13,1
221492,4,10,41,-31,14,0
369743,3,38,30,8,11,0
184269,3,31,7,24,14,0
98066,5,24,27,-3,11,0
115520,2,0,3,-3,1,0
338259,4,27,31,-4,14,1
207508,4,28,21,7,7,1
412435,1,0,7,-7,14,1
322910,2,13,0,13,7,0
52841,3,14,37,-23,7,0
183791,2,10,14,-4,14,0
187684,2,7,6,1,16,1
275213,4,17,22,-5,3,0
15690,4,37,17,20,8,1
240222,4,16,12,4,5,1
19907,4,16,21,-5,10,1
373071,3,3,7,-4,13,1
39735,3,9,0,9,1,1
342756,3,7,13,-6,16,0
406783,2,0,17,-17,11,1
314430,1,6,0,6,3,1
406356,2,10,7,3,11,1
195601,4,24,7,17,2,0
54185,2,0,3,-3,8,1
302186,2,21,0,21,15,0
385007,3,24,16,8,1,0
349406,2,0,7,-7,2,0
164707,1,6,0,6,6,0
101868,2,3,10,-7,12,0
198109,1,0,0,0,3,0
191450,4,0,34,-34,17,1
251797,1,0,0,0,10,0
210955,4,33,23,10,9,0
36957,3,0,25,-25,17,0
46020,2,14,7,7,4,0
147189,1,0,0,0,15,0
417365,3,10,10,0,16,1
241427,3,7,35,-28,5,1
68207,2,7,14,-7,14,1
22352,4,0,6,-6,11,0
210695,1,0,0,0,9,1
58899,3,6,24,-18,10,0
60489,2,14,7,7,11,1
260710,4,13,32,-19,14,1
415477,4,23,3,20,15,1
326739,1,0,7,-7,9,1
211276,1,3,0,3,9,0
220453,4,23,21,2,13,1
210505,4,9,21,-12,9,1
305609,4,23,10,13,17,0
1589,4,16,20,-4,1,1
60605,1,0,0,0,11,0
344125,3,20,3,17,17,1
93173,2,0,3,-3,9,1
43876,4,27,16,11,3,1
297757,1,0,0,0,13,1
333701,3,21,0,21,12,0
237423,4,12,17,-5,3,0
397453,3,10,13,-3,6,1
229451,4,13,6,7,17,0
258887,4,20,20,0,13,1
73761,2,3,0,3,17,1
322174,2,0,17,-17,7,0
329887,1,0,7,-7,11,0
58976,1,0,0,0,10,0
255671,3,3,7,-4,12,1
135326,1,7,10,-3,10,0
14850,1,0,0,0,7,0
76420,4,29,12,17,1,0
114297,1,0,6,-6,1,1
80368,3,20,9,11,2,1
400758,1,0,0,0,8,0
232655,2,7,0,7,1,0
41496,3,8,7,1,2,0
66086,3,10,3,7,13,0
261095,3,7,14,-7,14,0
186316,2,26,3,23,15,0
266719,4,49,17,32,16,1
46836,1,7,0,7,5,0
222881,1,0,0,0,14,0
292085,4,22,19,3,11,1
347876,1,0,0,0,1,1
300589,2,0,0,0,15,1
75244,2,7,7,0,17,0
281467,2,6,10,-4,6,1
4152,1,0,3,-3,2,0
291256,2,7,12,-5,10,0
62849,2,3,3,0,12,1
318496,4,34,7,27,5,0
400336,2,3,3,0,8,1
125281,2,3,0,3,5,0
243271,2,7,10,-3,6,1
146226,2,0,16,-16,15,1
165414,3,6,30,-24,6,1
319220,4,17,17,0,5,0
58756,3,10,20,-10,10,0
136807,4,20,10,10,11,0
131710,3,17,22,-5,8,1
184765,2,14,7,7,15,1
353148,4,13,29,-16,3,1
151495,3,35,7,28,17,1
402823,1,0,0,0,9,1
180788,3,10,13,-3,13,0
328919,2,6,7,-1,10,0
244402,3,3,17,-14,7,0
202916,4,28,0,28,5,1
67384,4,30,6,24,14,0
413642,1,0,0,0,14,0
172485,1,0,0,0,9,1
299190,4,17,19,-2,14,0
212157,2,3,17,-14,10,0
201390,4,28,22,6,5,0
361182,1,0,7,-7,7,1
291815,1,0,0,0,11,1
396238,2,0,3,-3,6,0
381478,1,14,0,14,17,0
173674,4,20,22,-2,10,0
75905,3,29,7,22,1,0
312663,2,21,7,14,3,0
157729,2,10,10,0,2,1
118203,1,0,0,0,2,1
47097,4,31,10,21,5,0
301243,4,27,17,10,15,0
256793,4,13,13,0,12,1
308590,3,9,16,-7,1,1
322365,3,14,13,1,7,0
240279,2,7,7,0,5,0
91385,4,21,13,8,8,0
53404,3,3,14,-11,8,0
219454,2,0,7,-7,13,1
312145,4,33,23,10,2,1
388751,2,11,0,11,3,0
65920,3,17,14,3,13,1
395758,1,0,0,0,6,0
222339,3,14,3,11,14,1
37139,4,16,20,-4,17,1
295411,3,10,10,0,12,0
179557,2,0,23,-23,12,1
32080,3,14,13,1,15,0
281866,4,16,7,9,6,0
108240,3,6,0,6,15,0
240725,1,0,7,-7,5,1
278537,4,43,7,36,4,0
410065,1,7,7,0,13,1
195492,2,0,0,0,2,0
220876,4,13,38,-25,14,1
322946,3,13,0,13,7,1
290886,4,24,30,-6,10,1
273740,1,0,7,-7,2,1
92381,2,10,0,10,8,0
69444,3,24,3,21,15,0
379826,1,0,0,0,16,0
69484,4,31,17,14,15,0
124074,2,0,14,-14,5,1
417047,2,17,0,17,15,0
183975,3,22,3,19,14,1
209883,3,16,16,0,8,0
109706,2,10,0,10,16,0
281008,2,14,13,1,6,1
272311,4,12,13,-1,2,1
397010,2,21,3,18,6,0
246919,2,14,7,7,8,1
21975,2,7,3,4,11,1
115449,4,39,14,25,1,1
254009,2,0,12,-12,11,0
35056,3,15,10,5,16,1
282591,4,26,24,2,6,1
156839,4,23,23,0,2,1
204583,2,0,38,-38,6,0
53282,3,3,7,-4,8,0
105826,2,6,3,3,14,1
379440,2,13,0,13,16,0
61985,2,3,0,3,12,0
238811,2,27,0,27,4,1
318335,4,9,19,-10,5,0
237975,2,3,10,-7,4,1
41036,2,3,10,-7,2,1
150244,1,0,0,0,16,0
212996,4,21,7,14,10,1
274740,4,24,12,12,3,0
210182,3,7,14,-7,9,0
287010,2,13,14,-1,8,0
196400,2,17,0,17,2,0
204281,2,0,7,-7,6,0
253823,1,7,7,0,11,1
170868,2,7,0,7,8,0
328238,5,17,17,0,10,1
374655,1,0,0,0,14,0
273175,3,24,0,24,2,0
162266,4,30,20,10,4,0
254031,3,7,13,-6,11,0
19575,2,14,14,0,10,0
204791,4,28,21,7,6,0
416812,4,13,10,3,15,1
67386,4,30,6,24,14,0
255362,2,14,6,8,12,0
317577,1,0,0,0,5,1
36369,3,13,19,-6,17,1
194709,1,0,0,0,2,0
320042,4,49,36,13,6,0
78291,3,3,21,-18,2,1
298255,3,20,13,7,14,1
372916,2,19,0,19,13,1
171608,2,6,3,3,9,1
98312,3,28,27,1,11,1
71088,4,27,3,24,16,1
254443,2,20,0,20,11,0
238986,3,21,12,9,4,0
405656,4,24,28,-4,10,1
35166,2,0,14,-14,16,1
93411,2,3,7,-4,9,1
370842,1,0,0,0,12,1
359224,4,28,28,0,6,0
146489,1,7,0,7,15,1
390847,3,3,28,-25,3,1
401683,2,0,14,-14,8,1
322503,3,15,3,12,7,0
206639,4,10,16,-6,7,1
314999,1,7,0,7,4,1
46600,2,3,0,3,4,0
216329,2,7,13,-6,12,1
120022,4,23,38,-15,3,1
202204,4,13,14,-1,5,0
267048,1,3,0,3,17,0
216436,1,7,0,7,12,1
240050,4,17,20,-3,5,0
9764,2,2,7,-5,5,0
67087,4,10,9,1,14,1
403943,4,20,17,3,10,0
114996,3,13,12,1,1,0
295908,3,13,17,-4,12,1
99791,3,0,14,-14,12,1
211453,2,6,7,-1,9,0
79957,4,13,23,-10,2,0
74441,4,13,20,-7,17,0
220664,2,10,0,10,13,0
285554,2,7,10,-3,8,1
231224,4,10,16,-6,1,0
16831,4,26,31,-5,8,0
18296,3,13,17,-4,9,0
239090,2,7,9,-2,4,0
107827,4,7,23,-16,15,1
163967,4,26,20,6,5,1
86066,1,14,0,14,5,0
319366,4,16,28,-12,6,1
76120,4,13,30,-17,1,0
225054,2,0,14,-14,15,0
107174,2,0,14,-14,15,0
32276,4,27,21,6,15,1
369198,4,22,20,2,11,1
162213,3,13,20,-7,4,1
73809,3,6,0,6,17,1
383124,3,23,14,9,17,1
367699,2,3,6,-3,10,0
160435,1,6,0,6,4,0
109147,3,24,7,17,15,1
11369,2,20,0,20,6,1
278770,2,0,0,0,5,1
157222,2,7,0,7,2,0
192684,4,13,7,6,1,0
25349,1,3,0,3,12,1
62015,3,10,7,3,12,0
136596,3,15,16,-1,11,0
345620,4,24,23,1,17,0
135855,4,7,17,-10,10,1
228497,2,17,7,10,17,1
305918,4,21,21,0,17,1
150618,3,9,16,-7,17,1
337714,4,31,24,7,14,0
138962,3,7,6,1,12,0
34955,4,27,27,0,16,0
172037,2,7,0,7,9,0
168880,3,17,3,14,7,1
252931,2,6,0,6,11,1
304028,2,0,13,-13,16,1
259107,1,0,0,0,13,1
418387,1,14,0,14,16,1
259013,3,3,16,-13,13,0
206017,4,16,17,-1,7,0
357426,3,24,24,0,5,1
337817,3,30,6,24,14,1
327380,2,0,7,-7,9,0
159897,3,31,0,31,3,1
288423,4,19,0,19,9,0
306245,1,0,0,0,17,1
305993,2,3,3,0,17,0
377842,2,17,7,10,15,1
297835,3,14,10,4,13,1
221529,1,13,9,4,14,0
161405,2,7,3,4,4,0
176901,1,0,0,0,11,1
312088,2,24,7,17,2,0
418936,4,27,17,10,16,1
119099,2,7,7,0,3,0
47144,2,3,0,3,5,1
37667,3,30,0,30,17,0
5600,1,0,0,0,3,0
314069,3,16,14,2,3,1
247089,2,10,3,7,8,0
226457,3,7,7,0,16,0
385887,2,0,7,-7,1,1
389994,4,28,25,3,3,1
230899,3,21,10,11,1,1
412317,2,7,7,0,13,1
237144,4,14,40,-26,3,1
390681,2,3,3,0,3,0
235839,2,0,14,-14,3,1
348154,1,6,0,6,1,0
393656,1,0,0,0,5,0
64678,1,14,0,14,13,0
72095,4,10,17,-7,16,0
211710,3,23,16,7,9,1
71245,4,22,26,-4,16,1
145492,4,16,17,-1,14,1
117062,3,0,17,-17,2,0
354477,2,21,28,-7,4,1
135361,2,14,17,-3,10,1
415902,3,10,20,-10,15,1
367930,1,0,7,-7,11,1
132654,1,0,3,-3,9,1
195941,2,0,17,-17,2,0
145021,3,6,3,3,14,1
158091,4,22,9,13,3,1
131270,3,14,17,-3,8,0
238829,3,27,0,27,4,0
2440,4,28,13,15,2,0
292806,4,29,17,12,11,0
255532,3,30,7,23,12,1
415521,1,0,0,0,15,0
313375,1,0,0,0,3,1
273397,4,38,13,25,2,0
362541,4,23,12,11,8,1
74793,2,6,3,3,17,0
935,2,0,0,0,1,0
246090,4,19,13,6,7,0
165912,1,0,6,-6,6,0
63869,2,3,14,-11,12,0
91510,3,19,3,16,8,1
371614,3,10,17,-7,12,1
77402,3,14,21,-7,1,1
341020,1,0,7,-7,15,1
199956,2,10,10,0,4,1
397366,4,10,24,-14,6,1
104273,2,17,0,17,13,0
299754,4,17,6,11,14,0
109717,2,10,0,10,16,0
157751,3,17,10,7,2,0
83952,1,7,0,7,4,1
259003,3,3,16,-13,13,0
416796,3,13,10,3,15,0
347475,2,12,16,-4,1,1
224092,4,17,9,8,15,1
185965,1,3,7,-4,15,0
136016,3,3,10,-7,10,1
300804,4,10,33,-23,15,1
315834,3,3,19,-16,4,1
106860,1,6,0,6,14,1
258009,3,0,28,-28,13,1
219857,4,45,0,45,13,0
366138,2,7,28,-21,10,1
326088,3,30,3,27,9,1
148713,1,10,0,10,16,0
411328,3,10,10,0,13,1
112193,4,27,34,-7,17,0
92594,3,17,3,14,8,0
93896,3,17,6,11,9,1
406690,3,24,0,24,11,0
232268,4,18,12,6,1,1
183571,3,20,17,3,14,0
287976,3,20,13,7,9,0
166958,4,16,9,7,6,1
411697,1,0,0,0,13,0
92475,4,23,10,13,8,0
59322,2,0,6,-6,11,0
94225,4,24,24,0,9,1
169447,1,0,0,0,8,0
287795,2,21,10,11,9,0
299879,3,13,8,5,14,0
59658,3,21,6,15,11,0
240113,1,6,0,6,5,0
39443,3,13,10,3,1,0
60574,4,30,41,-11,11,1
162357,3,10,10,0,4,1
220339,1,0,0,0,13,1
216788,1,0,0,0,12,1
153057,1,0,7,-7,1,0
330191,1,0,0,0,11,1
223988,2,7,6,1,15,1
60349,2,3,7,-4,11,1
403114,1,0,0,0,9,1
47898,4,21,13,8,5,0
270220,2,3,14,-11,1,1
286668,1,10,0,10,8,0
100466,2,7,7,0,12,0
170542,2,14,0,14,8,1
126396,4,20,14,6,6,0
418190,4,24,6,18,16,1
30224,4,13,34,-21,14,1
297221,2,0,6,-6,13,1
296431,2,14,0,14,13,0
401742,4,24,14,10,8,0
207075,4,38,10,28,7,0
67449,2,13,7,6,14,0
38771,2,0,3,-3,1,0
236634,2,3,0,3,3,0
90492,3,0,20,-20,7,1
33424,4,20,20,0,16,0
240269,2,7,7,0,5,1
176516,3,12,17,-5,11,0
355137,3,23,16,7,4,1
386558,4,14,24,-10,2,0
257669,2,0,7,-7,13,0
216815,1,0,7,-7,12,1
173658,4,13,20,-7,10,0
158675,3,14,7,7,3,1
301563,1,7,0,7,15,0
26678,1,0,7,-7,13,1
194629,3,24,7,17,2,0
353493,1,0,0,0,4,1
330214,2,7,7,0,11,0
74607,1,0,0,0,17,1
23837,4,24,7,17,12,1
88223,4,23,17,6,6,1
165,1,3,0,3,1,0
343091,4,12,13,-1,16,0
189047,3,14,17,-3,16,1
192772,2,0,9,-9,1,0
283321,4,10,9,1,7,0
178856,4,27,14,13,12,0
37016,1,3,0,3,17,1
276522,3,19,7,12,4,1
190350,2,7,0,7,17,1
235884,3,0,14,-14,3,1
47783,1,0,0,0,5,0
86486,4,30,24,6,5,1
47033,2,17,0,17,5,0
277514,2,3,7,-4,4,0
195699,3,14,10,4,2,0
397837,1,0,0,0,7,1
291175,4,18,23,-5,10,1
10449,1,3,0,3,5,0
343198,2,3,0,3,16,1
333035,2,3,12,-9,12,1
81848,2,0,21,-21,3,1
359305,2,3,13,-10,6,0
93446,3,3,14,-11,9,1
257796,1,7,0,7,13,0
263738,2,0,0,0,15,1
276516,3,19,7,12,4,0
42221,2,17,0,17,2,1
127085,1,3,0,3,6,0
265247,3,9,6,3,16,1
166079,1,7,0,7,6,1
221166,4,0,23,-23,14,0
7545,1,7,0,7,4,0
105325,1,0,6,-6,14,0
240674,4,36,24,12,5,1
235712,3,3,17,-14,3,1
338167,1,7,7,0,14,0
400424,4,24,10,14,8,0
47198,3,9,3,6,5,0
330123,4,0,13,-13,11,1
164256,4,48,41,7,5,0
343017,2,3,0,3,16,0
269067,3,13,16,-3,17,0
404563,1,0,0,0,10,0
405228,2,7,7,0,10,1
306944,4,6,36,-30,17,0
249485,1,0,3,-3,9,1
134460,2,3,20,-17,10,0
109602,3,22,14,8,16,0
262198,4,31,16,15,15,1
261883,4,6,20,-14,14,0
382202,1,3,3,0,17,0
147889,3,10,31,-21,15,1
142705,1,0,0,0,13,0
407407,2,7,7,0,11,1
256950,4,26,27,-1,12,1
259857,1,7,7,0,14,1
163900,2,16,10,6,5,1
252707,4,6,10,-4,10,1
287706,4,16,13,3,9,0
16796,3,3,24,-21,8,1
405339,4,14,12,2,10,1
255398,3,24,6,18,12,0
91146,2,3,14,-11,8,1
262993,2,7,0,7,15,1
17809,2,10,3,7,9,0
207076,4,38,10,28,7,0
122859,3,10,6,4,4,0
175703,3,23,6,17,11,0
33004,4,12,37,-25,15,0
306515,4,17,17,0,17,0
322673,4,6,9,-3,7,1
386290,1,0,0,0,2,0
137003,5,20,20,0,11,0
152372,2,21,3,18,17,0
253431,3,14,35,-21,11,1
324642,4,19,15,4,8,0
162474,2,7,3,4,4,0
323785,2,6,3,3,8,0
188862,2,3,7,-4,16,1
253043,1,6,0,6,11,1
203223,4,10,17,-7,5,0
15786,3,0,12,-12,8,0
330535,3,7,7,0,11,0
53278,3,3,7,-4,8,1
46111,4,28,21,7,4,0
43980,3,3,14,-11,3,0
223935,1,0,0,0,15,1
179493,1,0,6,-6,12,1
333256,4,6,21,-15,12,1
47803,2,7,6,1,5,1
76176,2,9,13,-4,1,1
233611,3,20,41,-21,2,1
235057,1,0,6,-6,2,0
273575,1,0,3,-3,2,1
95659,2,7,3,4,10,1
371175,2,11,19,-8,12,0
103249,3,3,10,-7,13,1
229184,4,19,7,12,17,0
109095,2,7,0,7,15,0
79642,4,24,14,10,2,0
176688,3,29,12,17,11,0
358873,3,6,21,-15,6,0
323415,4,20,0,20,7,1
317232,3,7,16,-9,5,0
170064,1,0,0,0,8,1
70158,2,20,7,13,15,0
302656,3,17,6,11,15,0
357069,2,6,7,-1,5,0
212694,1,0,0,0,10,0
237977,2,3,10,-7,4,1
22048,4,17,17,0,11,0
205825,3,17,0,17,7,1
223826,2,9,0,9,15,0
239266,2,3,7,-4,4,0
358589,3,20,9,11,6,0
56324,4,3,26,-23,9,0
254474,3,23,10,13,11,0
28529,3,24,7,17,14,0
99689,4,26,3,23,11,1
312323,1,7,14,-7,3,1
25797,1,3,0,3,12,0
107559,1,0,0,0,15,1
98176,4,21,19,2,11,1
249686,2,11,14,-3,9,1
203674,3,14,23,-9,6,1
389008,1,0,0,0,3,1
100695,4,21,24,-3,12,1
345933,4,20,23,-3,17,1
45499,4,27,20,7,4,0
33592,4,17,16,1,16,1
358831,2,0,7,-7,6,1
14045,3,3,21,-18,7,0
203724,1,0,0,0,6,0
78311,3,16,21,-5,2,1
358825,1,0,7,-7,6,1
274883,3,7,13,-6,3,0
136308,3,18,7,11,11,1
259055,4,3,16,-13,13,1
108214,2,6,0,6,15,1
193635,4,14,17,-3,1,0
240595,2,6,7,-1,5,0
39889,3,6,7,-1,1,0
2694,3,6,7,-1,2,1
39438,3,10,10,0,1,1
401331,4,27,24,3,8,1
169170,2,3,6,-3,7,1
417074,3,20,0,20,15,1
63522,4,31,19,12,12,0
49120,5,20,20,0,6,0
31206,3,23,27,-4,15,0
337008,2,10,0,10,14,1
369399,2,17,0,17,11,0
126264,4,28,9,19,6,0
345035,1,0,0,0,17,1
280659,1,0,3,-3,5,0
366730,3,24,10,14,10,1
198357,4,20,14,6,3,1
134040,2,13,3,10,9,1
143575,1,0,0,0,14,0
317499,3,10,17,-7,5,0
356245,4,29,14,15,5,0
218233,1,0,0,0,12,1
113430,2,0,7,-7,17,1
119935,2,6,14,-8,3,1
337125,1,0,0,0,14,1
86918,4,23,29,-6,5,1
105440,4,23,24,-1,14,1
34161,4,10,10,0,16,1
184054,1,0,0,0,14,1
238062,4,13,13,0,4,0
108315,1,0,0,0,15,0
308637,4,34,22,12,1,1
101031,1,0,0,0,12,0
308961,2,0,3,-3,1,1
298825,3,14,9,5,14,1
279630,1,7,0,7,5,1
307976,3,14,6,8,1,0
197913,3,11,7,4,3,1
260269,4,24,3,21,14,0
238470,2,6,0,6,4,0
175056,1,0,0,0,10,1
240878,1,7,0,7,5,0
332753,3,21,9,12,12,0
312722,4,28,14,14,3,1
188115,2,0,10,-10,16,1
86939,1,7,0,7,5,0
336045,4,16,25,-9,13,0
268349,4,20,6,14,17,1
229597,4,30,13,17,17,1
23747,1,0,0,0,12,1
282131,4,23,8,15,6,1
363997,3,6,9,-3,8,0
325417,1,13,0,13,8,1
150571,2,3,10,-7,17,1
294703,3,6,14,-8,12,0
198881,1,0,13,-13,3,1
211671,2,23,3,20,9,0
338987,3,13,3,10,15,1
366364,1,6,0,6,10,0
244498,2,25,3,22,7,0
348023,1,0,7,-7,1,1
355175,4,29,26,3,4,0
181620,4,23,6,17,13,0
47040,3,17,7,10,5,0
178705,4,3,20,-17,12,0
128203,2,14,7,7,7,0
131576,4,9,23,-14,8,0
374564,2,17,13,4,14,1
225092,3,13,14,-1,15,0
326835,3,10,14,-4,9,0
408917,2,17,9,8,12,1
139666,1,0,0,0,12,0
382458,4,0,30,-30,17,0
299961,1,0,7,-7,14,0
309437,3,7,3,4,1,0
308764,4,10,20,-10,1,0
130077,4,17,30,-13,8,0
29139,3,0,19,-19,14,0
329275,4,31,13,18,10,0
334769,4,32,11,21,13,1
384266,2,6,0,6,1,1
308056,1,0,7,-7,1,1
64232,4,38,6,32,13,0
157640,4,22,3,19,2,0
38211,2,3,13,-10,1,0
397865,2,0,3,-3,7,1
49711,4,21,30,-9,6,0
207135,2,7,7,0,7,0
168462,3,0,24,-24,7,0
150936,3,13,7,6,17,0
271873,2,7,10,-3,2,0
280654,1,0,3,-3,5,0
81184,1,0,0,0,3,0
99186,2,10,10,0,11,1
92955,1,3,0,3,8,0
89080,3,13,6,7,6,0
310071,1,0,0,0,2,0
317820,3,9,3,6,5,1
234545,4,20,20,0,2,1
228559,4,20,14,6,17,0
265853,1,0,6,-6,16,1
183767,1,7,14,-7,14,1
275667,4,37,3,34,3,0
261613,4,12,15,-3,14,1
11466,1,6,7,-1,6,0
31575,1,7,3,4,15,0
214531,1,0,0,0,11,0
271568,2,7,13,-6,2,1
112338,1,0,0,0,17,0
168723,3,10,6,4,7,0
44089,2,0,13,-13,3,1
388587,2,14,0,14,3,0
362834,4,7,28,-21,8,1
306981,1,7,0,7,17,0
304067,3,3,20,-17,16,1
408103,4,20,17,3,12,1
419116,1,10,0,10,16,0
289841,1,0,0,0,10,0
163920,3,23,10,13,5,1
73384,3,23,3,20,17,1
361666,3,7,22,-15,7,0
136928,3,0,13,-13,11,1
391537,2,10,21,-11,4,0
257110,4,17,21,-4,12,1
44521,1,0,0,0,3,0
408228,4,20,3,17,12,0
296614,2,3,7,-4,13,1
129266,3,17,13,4,7,0
196435,4,20,13,7,2,0
162079,3,28,13,15,4,1
112691,1,3,0,3,17,1
82903,2,3,3,0,4,1
33868,4,9,41,-32,16,0
29103,2,0,6,-6,14,0
210705,1,7,0,7,9,1
211498,2,25,7,18,9,1
312301,1,0,7,-7,3,1
206929,4,17,23,-6,7,1
335764,4,16,7,9,13,1
366050,4,51,14,37,10,0
415449,3,15,3,12,15,1
23850,4,24,7,17,12,0
355839,2,13,7,6,5,1
254452,3,20,7,13,11,1
116143,2,7,3,4,1,0
319468,2,0,10,-10,6,1
152366,2,14,3,11,17,1
383069,2,17,7,10,17,1
282778,2,0,10,-10,6,1
378808,1,0,0,0,15,1
283997,2,3,0,3,7,0
85458,2,14,3,11,5,0
270517,2,0,7,-7,1,1
105401,3,23,17,6,14,1
302603,1,0,3,-3,15,1
23015,2,0,14,-14,11,1
320600,3,31,6,25,6,1
116894,3,7,10,-3,2,0
196274,3,21,10,11,2,1
299948,4,16,11,5,14,1
252508,3,17,25,-8,10,0
310909,2,3,3,0,2,0
5921,2,7,16,-9,3,0
260709,4,13,31,-18,14,0
403951,4,20,17,3,10,0
190760,1,3,3,0,17,1
221159,4,0,23,-23,14,1
265046,2,10,3,7,16,0
287313,2,3,0,3,8,1
336899,3,7,14,-7,14,0
303094,2,0,14,-14,16,1
189342,3,10,10,0,16,1
324140,3,0,10,-10,8,1
252901,2,6,0,6,11,0
252800,3,6,6,0,11,1
136935,3,3,13,-10,11,0
260476,2,10,0,10,14,1
349596,3,13,28,-15,2,1
107997,4,6,20,-14,15,0
198264,1,3,7,-4,3,1
46003,1,6,7,-1,4,1
382071,1,7,3,4,17,1
7970,4,16,27,-11,4,0
307254,4,10,13,-3,17,0
151754,2,7,6,1,17,1
104637,3,7,3,4,14,0
230334,4,19,17,2,17,1
420586,1,0,10,-10,17,0
27458,2,10,0,10,13,0
264077,2,10,20,-10,15,0
397743,3,9,14,-5,7,0
160015,2,10,23,-13,3,1
272637,1,0,0,0,2,0
184642,2,10,10,0,15,1
148055,3,7,10,-3,15,1
249026,1,7,3,4,9,1
218483,4,31,17,14,13,0
80263,4,35,31,4,2,1
162667,3,16,17,-1,5,1
304618,2,14,7,7,16,1
272953,1,3,0,3,2,1
45062,4,23,13,10,4,0
323810,2,13,9,4,8,0
10031,2,20,0,20,5,1
133237,4,23,20,3,9,1
32229,2,21,14,7,15,0
68798,2,6,7,-1,15,1
103717,4,3,17,-14,13,0
352491,1,0,0,0,3,1
78406,2,14,0,14,2,0
201935,2,0,0,0,5,1
416826,4,19,10,9,15,0
281974,3,21,14,7,6,0
116450,3,6,10,-4,1,1
346723,4,24,13,11,1,1
417215,3,17,17,0,16,0
421003,4,14,28,-14,17,0
32463,1,7,0,7,15,0
228185,2,7,27,-20,17,1
139431,3,24,3,21,12,1
335212,4,36,20,16,13,1
149381,2,6,6,0,16,1
328212,4,14,17,-3,10,0
123766,2,10,3,7,5,0
100511,3,10,17,-7,12,0
349853,2,3,3,0,2,0
322307,2,7,0,7,7,0
102150,2,14,0,14,13,0
81881,3,0,27,-27,3,0
64537,1,0,0,0,13,0
165635,2,0,0,0,6,1
368565,3,9,0,9,11,1
381822,3,7,14,-7,17,0
172605,4,17,24,-7,9,1
284988,4,16,27,-11,7,0
175249,2,15,0,15,10,0
60030,1,0,0,0,11,1
269394,3,7,17,-10,1,1
181826,2,14,7,7,13,0
18807,1,0,0,0,9,1
382528,2,0,3,-3,17,0
340042,3,14,12,2,15,1
154628,3,21,21,0,1,1
313161,3,13,13,0,3,1
284037,3,10,3,7,7,0
233466,3,23,10,13,2,0
2746,4,9,7,2,2,1
81038,5,23,26,-3,3,0
374056,4,24,10,14,13,0
28737,4,10,16,-6,14,1
163376,1,0,6,-6,5,0
412570,4,31,24,7,14,1
147242,2,0,21,-21,15,0
102164,2,14,7,7,13,0
319285,2,10,3,7,6,0
330291,4,31,21,10,11,1
306211,4,20,3,17,17,0
399324,2,14,7,7,7,1
138818,3,3,33,-30,12,0
179703,1,0,0,0,12,0
135047,2,14,3,11,10,0
50330,4,13,23,-10,6,1
182875,1,0,0,0,14,0
308230,2,7,10,-3,1,1
184105,3,16,14,2,14,1
82642,3,12,10,2,3,0
352801,2,14,0,14,3,1
227755,3,3,14,-11,16,1
349092,1,7,0,7,2,1
295383,2,10,10,0,12,1
27340,2,21,10,11,13,1
385962,4,24,21,3,1,0
330053,2,0,3,-3,11,1
115607,4,30,9,21,1,0
245459,4,16,6,10,7,1
348311,1,7,0,7,1,1
393382,2,21,14,7,5,1
75366,1,0,0,0,17,0
245548,2,34,0,34,7,0
305473,4,20,10,10,17,1
208221,4,3,10,-7,8,1
28447,4,13,6,7,14,0
56600,3,19,17,2,9,1
246191,2,14,3,11,7,0
42115,4,27,26,1,2,0
108815,2,0,10,-10,15,0
80371,3,20,9,11,2,1
27935,3,14,10,4,13,1
369703,2,16,17,-1,11,0
142836,4,12,20,-8,13,0
5540,3,16,10,6,3,0
134946,3,7,22,-15,10,1
340021,2,14,9,5,15,0
103124,4,34,7,27,13,0
123564,4,16,17,-1,4,1
311108,4,13,3,10,2,0
35244,4,0,17,-17,16,1
418657,4,28,31,-3,16,0
186561,5,34,36,-2,15,0
81561,3,10,21,-11,3,1
101505,1,10,0,10,12,0
307080,4,24,6,18,17,1
44815,1,0,7,-7,4,1
89939,1,2,7,-5,7,1
306007,2,3,10,-7,17,1
25253,2,14,7,7,12,0
228879,4,9,17,-8,17,0
375696,4,26,20,6,14,1
211314,2,10,3,7,9,0
300598,2,7,0,7,15,1
42227,3,24,0,24,2,0
394836,1,0,7,-7,5,1
158755,2,0,3,-3,3,0
382369,2,0,7,-7,17,0
166663,4,32,20,12,6,0
49191,2,10,0,10,6,1
363850,3,13,26,-13,8,1
289684,4,19,23,-4,10,1
230323,4,19,10,9,17,0
207523,1,0,0,0,7,1
380717,4,7,16,-9,16,1
118703,3,17,6,11,2,0
303072,1,0,7,-7,16,1
344458,1,0,0,0,17,1
140775,3,22,21,1,12,0
166598,2,22,14,8,6,1
153136,3,20,17,3,1,0
257617,1,0,0,0,13,0
411580,2,7,10,-3,13,0
80793,2,3,0,3,3,0
31975,4,16,13,3,15,1
297779,1,7,0,7,13,0
90137,2,3,0,3,7,1
412842,4,28,35,-7,14,1
108080,2,13,21,-8,15,1
229664,1,7,7,0,17,0
42759,1,3,7,-4,3,1
74458,1,0,0,0,17,1
204932,4,13,19,-6,6,0
233879,2,14,6,8,2,0
131633,1,0,13,-13,8,1
280281,3,13,16,-3,5,0
42173,1,7,0,7,2,0
122072,1,0,7,-7,4,1
402238,2,3,3,0,9,0
366168,3,7,45,-38,10,1
172988,2,14,0,14,9,0
240034,3,10,20,-10,5,1
50793,1,0,0,0,6,1
420036,3,23,14,9,17,1
146170,1,0,3,-3,15,0
211151,2,0,10,-10,9,1
253770,4,24,10,14,11,1
218421,2,10,14,-4,13,0
366245,2,7,3,4,10,1
394100,1,0,0,0,5,0
238751,1,0,0,0,4,1
324417,3,14,3,11,8,1
169341,2,3,14,-11,8,1
258657,1,0,0,0,13,1
184392,3,21,6,15,14,1
396866,3,20,10,10,6,1
152639,2,7,6,1,17,1
302416,4,16,19,-3,15,1
114113,4,21,7,14,17,1
313236,1,0,0,0,3,1
315739,1,0,0,0,4,1
43572,4,24,3,21,3,1
269328,1,0,7,-7,1,0
76478,2,0,14,-14,1,0
19186,3,21,13,8,10,0
4476,2,14,12,2,2,0
399406,4,37,10,27,7,1
232974,3,10,3,7,2,0
391090,1,7,7,0,4,0
251790,1,0,0,0,10,1
301012,2,10,3,7,15,1
181345,1,7,0,7,13,1
50001,3,28,10,18,6,1
209469,4,24,20,4,8,0
188492,1,0,0,0,16,1
77790,2,7,14,-7,1,0
46768,3,7,20,-13,4,1
371197,3,11,19,-8,12,1
181439,3,24,24,0,13,1
90925,4,48,7,41,7,1
233037,4,24,17,7,2,1
17965,2,13,21,-8,9,0
229785,4,20,17,3,17,1
287100,1,0,0,0,8,1
99087,4,23,0,23,11,1
403501,4,24,12,12,9,0
280224,1,3,0,3,5,0
232791,3,13,14,-1,2,1
339400,2,0,3,-3,15,1
309698,2,10,6,4,1,1
329123,4,27,7,20,10,0
136901,2,0,13,-13,11,1
272141,4,24,16,8,2,1
357185,4,12,27,-15,5,1
72340,2,0,14,-14,16,0
345751,4,13,7,6,17,1
141842,3,17,14,3,13,0
360931,3,24,3,21,7,0
207400,1,7,0,7,7,0
328834,4,17,20,-3,10,1
183136,4,7,12,-5,14,0
296272,2,0,3,-3,13,0
305166,4,27,10,17,16,0
232877,1,0,0,0,2,0
254947,3,38,7,31,12,0
226665,1,6,0,6,16,1
370604,3,14,14,0,12,1
56654,4,26,24,2,9,0
273865,1,0,0,0,2,1
319744,1,0,0,0,6,1
78576,2,16,10,6,2,0
195629,1,7,0,7,2,0
134786,3,34,10,24,10,0
105930,1,0,0,0,14,1
324894,3,17,13,4,8,0
218937,4,41,27,14,13,1
322033,2,6,0,6,7,1
347954,3,0,21,-21,1,0
196550,3,17,6,11,2,0
63667,4,26,36,-10,12,1
392661,3,13,0,13,4,1
242230,4,30,14,16,6,1
260675,3,10,22,-12,14,0
280542,2,7,3,4,5,1
263113,1,0,7,-7,15,1
54679,4,27,29,-2,8,0
111924,1,0,14,-14,17,0
43944,2,3,7,-4,3,0
382688,3,3,6,-3,17,1
56920,3,34,7,27,9,1
4112,4,23,28,-5,2,0
112347,1,3,0,3,17,1
332973,4,31,3,28,12,1
301600,2,10,3,7,15,0
261720,3,14,7,7,14,0
318737,3,10,23,-13,5,0
377695,2,19,7,12,15,1
405197,1,0,7,-7,10,1
133700,4,32,42,-10,9,0
406304,4,27,35,-8,11,0
94533,3,3,10,-7,9,0
399287,1,7,0,7,7,0
329054,2,3,7,-4,10,0
159745,3,7,10,-3,3,0
39151,4,20,10,10,1,1
364641,1,0,0,0,9,1
163628,3,21,22,-1,5,1
315904,1,0,0,0,4,1
203931,1,3,7,-4,6,0
349435,2,0,14,-14,2,0
74186,1,3,0,3,17,1
261141,4,21,24,-3,14,1
16269,4,19,23,-4,8,0
289888,2,6,3,3,10,1
256493,4,19,31,-12,12,0
55799,2,0,7,-7,9,1
301668,4,10,6,4,15,1
239786,4,20,20,0,4,1
320415,2,14,0,14,6,1
37908,2,3,14,-11,1,1
364046,4,6,24,-18,8,1
125102,1,0,0,0,5,1
236646,2,10,0,10,3,0
279509,2,10,6,4,5,0
226518,4,14,20,-6,16,1
25620,4,36,10,26,12,1
28160,1,0,0,0,13,1
341370,3,0,10,-10,16,0
339859,2,16,0,16,15,1
10175,2,6,3,3,5,0
271234,1,0,0,0,1,0
117355,3,21,0,21,2,0
96658,4,3,17,-14,10,1
322062,3,23,0,23,7,1
218690,1,0,0,0,13,1
82237,4,16,13,3,3,1
385548,2,0,10,-10,1,0
144235,2,9,7,2,14,1
316666,4,12,12,0,4,0
124063,2,0,14,-14,5,1
12062,1,7,0,7,6,0
26626,4,10,6,4,13,0
103080,3,27,7,20,13,0
286399,2,14,0,14,8,1
261288,4,38,0,38,14,0
176421,4,22,28,-6,11,1
166347,4,20,12,8,6,1
89164,1,0,0,0,7,1
291261,2,7,12,-5,10,1
362606,1,0,7,-7,8,1
335187,3,20,13,7,13,1
371450,3,14,14,0,12,1
272334,1,14,0,14,2,0
198613,2,0,7,-7,3,1
2633,1,0,0,0,2,1
338821,2,10,6,4,15,0
333704,3,21,0,21,12,0
16891,2,7,13,-6,8,1
216889,3,13,17,-4,12,1
114416,4,41,20,21,1,0
200843,1,6,0,6,4,1
412992,4,16,12,4,14,0
186850,4,29,20,9,15,1
279601,4,10,16,-6,5,0
130895,1,0,0,0,8,0
261721,3,14,7,7,14,0
24498,1,0,7,-7,12,1
243644,4,23,20,3,6,1
162277,4,30,20,10,4,1
110389,1,0,0,0,16,0
276004,1,3,0,3,3,0
106301,2,7,6,1,14,0
186170,3,16,6,10,15,1
18500,4,17,14,3,9,1
407768,4,10,7,3,11,1
179533,2,0,16,-16,12,0
344143,3,20,3,17,17,0
410743,3,17,6,11,13,1
286984,1,3,7,-4,8,1
134055,3,20,3,17,9,1
243626,4,23,14,9,6,0
382223,2,10,3,7,17,0
286197,1,0,0,0,8,1
257356,2,17,0,17,13,1
394101,1,0,0,0,5,1
239628,4,20,20,0,4,1
126214,3,21,6,15,6,1
377866,3,20,7,13,15,1
19975,2,6,3,3,10,0
221030,4,21,35,-14,14,1
207993,2,14,0,14,8,1
128108,4,10,6,4,7,1
323726,4,39,0,39,8,0
325194,3,13,20,-7,8,0
319199,3,9,17,-8,5,1
91184,3,10,17,-7,8,1
277105,3,10,14,-4,4,0
69603,3,7,17,-10,15,1
319719,4,33,9,24,6,0
265221,3,6,6,0,16,1
253864,2,28,14,14,11,0
135590,4,28,6,22,10,1
175718,3,30,6,24,11,0
367800,1,3,7,-4,10,1
16427,4,24,16,8,8,0
334733,3,25,9,16,13,0
103503,2,13,0,13,13,1
270376,1,3,0,3,1,0
370723,2,9,7,2,12,0
235618,4,27,34,-7,3,1
377414,3,7,13,-6,15,1
150882,2,0,7,-7,17,1
321586,2,10,6,4,7,0
332401,1,0,3,-3,12,1
172186,2,0,0,0,9,0
52083,4,13,13,0,7,1
274038,1,10,0,10,3,0
46785,3,14,27,-13,4,1
29136,2,0,19,-19,14,0
330769,5,9,9,0,11,1
230784,4,9,27,-18,1,1
78168,3,20,3,17,2,1
188751,3,0,20,-20,16,0
378601,3,20,13,7,15,1
128150,1,0,0,0,7,1
39868,2,6,0,6,1,0
230789,4,17,27,-10,1,0
326298,1,0,3,-3,9,0
396135,3,17,23,-6,6,1
276189,2,24,3,21,3,0
390812,2,0,7,-7,3,0
326013,1,9,0,9,9,0
83614,4,10,17,-7,4,1
185714,2,17,3,14,15,0
161792,4,24,6,18,4,0
60924,1,0,3,-3,11,1
406371,2,10,7,3,11,1
16591,1,0,7,-7,8,1
85434,1,7,0,7,5,1
9935,3,3,3,0,5,1
234172,2,10,10,0,2,0
308669,1,0,6,-6,1,1
409281,4,13,13,0,12,0
119164,3,10,7,3,3,1
23521,4,17,17,0,11,0
384550,2,3,28,-25,1,1
206808,1,0,0,0,7,0
92810,1,7,0,7,8,0
144272,3,16,7,9,14,1
309110,2,9,3,6,1,1
282252,3,10,14,-4,6,0
403562,2,10,0,10,9,1
420380,4,20,13,7,17,0
87983,1,3,0,3,6,0
124835,2,0,6,-6,5,1
330171,1,0,0,0,11,1
412599,1,3,0,3,14,0
376084,2,0,3,-3,14,1
2336,1,0,0,0,2,0
409763,4,13,9,4,12,1
341004,1,0,0,0,15,1
204907,3,10,13,-3,6,1
366068,4,51,21,30,10,1
92598,3,17,3,14,8,0
111400,3,0,14,-14,16,1
312167,1,0,0,0,2,1
214063,1,0,0,0,11,1
215990,4,20,42,-22,11,0
57613,2,3,3,0,10,1
411022,2,17,14,3,13,1
156526,4,7,6,1,2,0
295986,1,0,0,0,13,1
398538,4,28,16,12,7,1
576,4,14,33,-19,1,0
65522,4,30,14,16,13,0
164572,1,0,0,0,5,0
150448,2,20,3,17,16,1
114392,3,34,13,21,1,1
363592,4,10,15,-5,8,0
132469,4,8,24,-16,9,0
416990,4,10,17,-7,15,1
264316,4,17,36,-19,15,0
202500,4,9,16,-7,5,0
282179,1,3,0,3,6,0
403733,2,9,3,6,9,1
361005,1,3,2,1,7,0
373248,3,13,16,-3,13,0
365253,2,3,7,-4,9,1
130005,2,0,13,-13,8,1
346386,3,9,13,-4,1,0
309539,2,6,0,6,1,1
135547,3,14,6,8,10,1
305070,2,21,7,14,16,0
294813,2,28,14,14,12,0
214728,2,3,7,-4,11,0
267029,1,0,0,0,17,1
307538,4,38,19,19,17,0
262719,2,14,0,14,15,1
385907,2,3,7,-4,1,0
188994,1,7,0,7,16,0
220064,1,13,0,13,13,0
421239,2,6,7,-1,17,1
225582,1,0,7,-7,16,1
296105,4,9,17,-8,13,1
318461,3,31,7,24,5,1
88020,2,17,0,17,6,1
25727,4,14,10,4,12,1
320769,4,17,23,-6,6,1
119763,2,10,6,4,3,1
210638,3,13,23,-10,9,0
295105,2,7,14,-7,12,0
402891,3,17,6,11,9,1
110327,3,10,17,-7,16,0
229947,1,0,0,0,17,0
207654,4,42,10,32,7,0
113271,2,10,14,-4,17,1
88164,2,14,10,4,6,0
276696,4,23,13,10,4,0
138320,2,20,0,20,11,0
179938,4,33,9,24,13,1
166723,2,7,3,4,6,1
38476,1,0,3,-3,1,1
4865,1,14,0,14,3,1
396173,4,24,23,1,6,0
349633,4,13,28,-15,2,0
12025,4,24,14,10,6,1
224344,4,16,12,4,15,1
250510,3,16,7,9,9,1
175826,2,17,10,7,11,1
310449,2,14,3,11,2,1
171053,3,17,29,-12,8,0
242492,3,12,10,2,6,1
114713,4,15,10,5,1,0
296406,1,7,0,7,13,1
233720,2,13,21,-8,2,0
117117,4,7,27,-20,2,0
176167,2,14,13,1,11,0
13435,2,3,14,-11,7,1
271191,4,14,20,-6,1,1
291642,4,23,13,10,11,0
286940,4,26,19,7,8,1
158742,1,0,0,0,3,0
54108,4,20,3,17,8,0
5793,2,21,7,14,3,1
232468,2,10,0,10,1,0
285496,4,36,15,21,8,0
64311,2,6,10,-4,13,0
98462,3,17,14,3,11,1
61242,2,14,7,7,11,1
2740,4,9,7,2,2,1
67243,4,7,3,4,14,1
9707,4,19,28,-9,5,0
250591,1,0,0,0,10,1
46320,2,3,17,-14,4,1
249407,4,18,15,3,9,1
275907,3,13,12,1,3,0
232710,4,20,3,17,1,0
245344,1,0,0,0,7,1
192313,3,27,10,17,1,0
179014,4,19,3,16,12,1
320201,1,6,0,6,6,1
198577,1,0,0,0,3,1
297848,3,14,16,-2,13,1
17332,1,14,0,14,9,0
124342,4,41,27,14,5,1
274299,4,32,16,16,3,0
326225,3,10,34,-24,9,1
383188,1,14,0,14,17,0
30656,4,24,9,15,14,0
135426,4,28,27,1,10,1
57074,4,7,27,-20,9,1
419702,2,0,3,-3,17,0
374141,2,16,7,9,13,1
296110,1,0,0,0,13,1
298605,4,13,10,3,14,0
92728,3,3,17,-14,8,1
152173,1,7,0,7,17,0
354482,2,21,28,-7,4,1
117769,1,3,6,-3,2,1
105559,3,29,14,15,14,0
30893,3,3,17,-14,15,0
183701,4,22,20,2,14,0
392222,4,10,16,-6,4,1
413549,2,3,10,-7,14,1
140571,1,14,7,7,12,1
333962,2,14,10,4,12,1
408804,3,10,25,-15,12,1
107322,2,3,3,0,15,0
224008,2,14,6,8,15,0
68421,4,3,21,-18,14,0
34449,3,31,3,28,16,1
411988,1,0,0,0,13,0
376514,2,6,3,3,14,0
266016,1,7,0,7,16,0
85975,3,14,14,0,5,0
57568,1,0,0,0,10,1
16244,3,3,3,0,8,1
60619,1,0,3,-3,11,0
226029,5,34,34,0,16,0
142496,3,27,10,17,13,0
222909,2,13,3,10,14,0
98222,1,0,0,0,11,0
143820,3,12,7,5,14,0
47047,3,17,7,10,5,1
185698,2,10,3,7,15,0
72023,2,7,10,-3,16,0
176894,4,20,16,4,11,0
303525,4,37,17,20,16,0
274859,2,0,10,-10,3,1
165554,4,3,28,-25,6,0
367256,2,3,0,3,10,0
376510,2,6,3,3,14,0
102130,1,7,0,7,13,0
118419,3,20,10,10,2,0
362828,3,7,21,-14,8,0
279899,4,24,13,11,5,1
18249,1,0,17,-17,9,1
417584,1,7,0,7,16,0
143314,1,0,10,-10,14,0
25909,4,38,17,21,12,0
42154,1,0,0,0,2,1
187688,2,13,6,7,16,1
247509,1,3,0,3,8,0
324031,4,20,25,-5,8,0
369930,4,16,22,-6,12,1
285745,2,0,10,-10,8,1
303980,4,21,40,-19,16,0
176513,3,12,17,-5,11,0
222166,2,7,10,-3,14,1
354797,3,13,20,-7,4,1
385108,2,0,3,-3,1,1
217875,3,17,21,-4,12,1
209654,1,3,0,3,8,1
80202,3,21,16,5,2,0
226819,1,0,0,0,16,1
348615,4,34,23,11,2,0
325116,1,10,7,3,8,0
255435,4,24,6,18,12,1
148089,4,14,10,4,15,0
267281,3,17,17,0,17,1
89799,2,3,0,3,7,0
21883,3,21,0,21,11,1
310983,4,16,37,-21,2,0
296131,1,10,6,4,13,1
180282,2,6,6,0,13,0
194998,1,7,0,7,2,0
111150,4,31,10,21,16,0
173450,2,0,7,-7,10,1
183329,1,7,0,7,14,0
407195,1,0,0,0,11,0
248530,4,23,20,3,8,0
169261,4,23,6,17,7,0
150920,3,10,7,3,17,0
12197,1,0,0,0,6,0
243422,2,3,17,-14,6,1
374586,3,20,13,7,14,1
377590,4,20,12,8,15,0
36827,3,17,26,-9,17,0
317683,4,16,6,10,5,0
333708,3,21,0,21,12,1
135051,2,14,3,11,10,1
296638,3,3,10,-7,13,1
167391,4,37,33,4,7,1
303191,4,31,28,3,16,0
142253,1,0,0,0,13,1
145040,3,13,6,7,14,1
304747,1,0,0,0,16,0
95961,1,0,0,0,10,1
367364,1,0,7,-7,10,1
158014,2,0,6,-6,3,1
250917,2,3,3,0,10,0
222485,2,6,14,-8,14,1
45055,4,23,13,10,4,0
111707,4,31,16,15,16,0
285610,3,20,17,3,8,1
398938,4,16,10,6,7,0
340847,4,24,19,5,15,0
191300,4,17,17,0,17,0
260378,3,6,0,6,14,0
362378,3,30,14,16,8,0
260633,2,7,13,-6,14,0
76270,4,19,27,-8,1,1
282227,2,3,7,-4,6,1
217610,3,19,9,10,12,0
70769,3,20,24,-4,15,0
200981,1,14,0,14,5,0
204758,3,14,14,0,6,0
179622,4,31,23,8,12,0
126442,1,0,0,0,6,1
1204,2,10,0,10,1,0
60743,4,28,3,25,11,1
140169,4,10,3,7,12,1
56471,4,0,41,-41,9,1
233744,3,13,24,-11,2,0
103323,1,7,10,-3,13,1
41434,1,2,0,2,2,1
523,3,7,13,-6,1,1
19732,3,9,6,3,10,1
81616,4,30,24,6,3,0
14327,3,2,7,-5,7,1
192056,4,31,27,4,1,0
350372,4,24,13,11,2,0
404058,3,10,35,-25,10,1
160791,2,17,7,10,4,0
62534,1,0,0,0,12,1
342221,1,3,0,3,16,1
191557,3,14,24,-10,17,0
126282,1,0,0,0,6,1
381110,4,24,28,-4,16,1
219330,2,16,7,9,13,0
208491,3,37,7,30,8,1
354876,4,33,42,-9,4,1
323278,4,7,24,-17,7,1
361476,2,7,0,7,7,1
311630,2,6,3,3,2,0
335419,2,7,6,1,13,0
223290,4,3,12,-9,15,1
379338,3,10,16,-6,16,0
222224,3,13,17,-4,14,1
79591,2,14,0,14,2,0
247833,1,0,3,-3,8,1
229373,1,3,0,3,17,0
210385,1,0,0,0,9,0
291495,4,21,20,1,10,1
13436,2,3,14,-11,7,0
350788,4,17,3,14,2,0
145027,3,13,3,10,14,0
76386,3,29,6,23,1,0
371928,4,34,17,17,12,0
132582,3,12,32,-20,9,0
48164,4,10,13,-3,5,1
94077,4,6,31,-25,9,1
319786,2,14,7,7,6,1
377983,2,0,7,-7,15,1
10678,4,10,17,-7,5,0
129192,2,7,6,1,7,1
165242,2,17,7,10,6,0
215868,1,0,7,-7,11,1
136629,3,15,16,-1,11,0
373680,2,0,15,-15,13,1
56995,1,0,10,-10,9,1
351944,2,14,13,1,3,0
103423,4,10,23,-13,13,1
295722,3,10,9,1,12,0
151094,4,17,10,7,17,1
47387,4,10,13,-3,5,0
45852,1,7,0,7,4,0
217435,2,9,0,9,12,1
17767,1,0,0,0,9,0
395285,4,10,19,-9,5,1
130287,1,0,0,0,8,1
105489,1,20,0,20,14,0
54137,1,0,0,0,8,0
298855,4,21,9,12,14,1
104169,4,27,27,0,13,0
78849,2,7,0,7,2,1
254963,4,45,7,38,12,1
311998,4,35,17,18,2,1
172350,2,3,13,-10,9,0
280101,2,14,0,14,5,0
119230,1,7,3,4,3,0
41773,2,7,14,-7,2,1
404255,1,0,0,0,10,0
168986,1,9,7,2,7,1
67146,1,0,0,0,14,1
417869,3,13,10,3,16,0
376812,2,14,7,7,15,0
94435,1,0,0,0,9,0
126073,3,20,3,17,6,0
174106,4,8,36,-28,10,1
405648,4,24,28,-4,10,1
273156,2,10,0,10,2,1
251013,4,3,6,-3,10,0
417016,1,3,0,3,15,0
81414,3,10,10,0,3,0
58121,3,10,10,0,10,1
44102,2,0,13,-13,3,0
90205,4,6,3,3,7,1
211077,3,36,0,36,9,1
354263,4,23,17,6,4,0
22012,3,7,17,-10,11,1
337333,2,14,7,7,14,1
79306,2,12,3,9,2,1
17529,2,13,0,13,9,1
394189,3,23,17,6,5,1
151049,3,10,3,7,17,0
170427,2,21,3,18,8,0
413332,4,20,6,14,14,0
141065,4,14,10,4,13,1
42924,2,14,13,1,3,0
41967,4,38,6,32,2,0
353989,1,0,0,0,4,0
34045,1,0,0,0,16,0
220905,1,0,0,0,14,0
369971,1,7,0,7,12,1
192792,2,0,15,-15,1,1
391792,4,10,16,-6,4,1
330832,2,10,17,-7,11,0
94316,2,10,7,3,9,0
334497,1,7,14,-7,13,0
188422,3,3,3,0,16,1
5837,4,27,7,20,3,1
327401,2,0,14,-14,9,1
323848,3,16,23,-7,8,1
301453,2,17,3,14,15,0
373985,2,10,0,10,13,0
242484,3,12,10,2,6,0
351686,3,7,10,-3,3,0
224784,3,8,3,5,15,0
300560,1,0,0,0,15,1
259090,1,0,0,0,13,0
153871,2,7,3,4,1,1
377652,1,9,7,2,15,0
180909,2,10,7,3,13,1
209980,2,0,3,-3,8,0
190610,1,7,0,7,17,0
45360,4,20,16,4,4,0
108697,3,27,13,14,15,1
257245,3,19,23,-4,12,0
418566,2,14,3,11,16,0
334544,2,14,17,-3,13,1
377231,2,7,0,7,15,0
419437,2,10,3,7,16,0
346406,3,9,13,-4,1,1
170650,1,0,0,0,8,1
390502,2,7,0,7,3,1
254171,3,3,12,-9,11,0
177107,3,24,13,11,11,1
118117,2,13,20,-7,2,0
400598,4,13,31,-18,8,0
229081,2,10,6,4,17,0
193906,4,24,10,14,1,1
393278,4,24,26,-2,5,0
323527,3,24,10,14,7,0
321210,4,3,19,-16,6,0
360431,2,10,0,10,7,0
325,1,14,3,11,1,1
221906,3,19,10,9,14,1
281696,4,31,17,14,6,0
151855,1,3,0,3,17,1
63283,2,3,0,3,12,0
417979,2,14,21,-7,16,0
274477,1,0,0,0,3,1
136063,4,6,13,-7,10,0
283171,4,20,9,11,7,1
356749,4,29,31,-2,5,1
310493,4,20,9,11,2,1
60951,2,14,6,8,11,0
69069,1,0,0,0,15,0
214527,1,0,0,0,11,1
109058,4,23,41,-18,15,0
301538,4,20,24,-4,15,0
93389,1,3,0,3,9,0
261355,2,7,14,-7,14,0
412188,2,14,3,11,13,0
114531,4,17,34,-17,1,0
139466,4,27,10,17,12,0
210114,1,0,0,0,9,1
121406,4,7,6,1,3,0
340823,4,24,16,8,15,1
125902,2,13,10,3,6,1
37710,4,37,0,37,17,0
136526,1,0,10,-10,11,0
387626,4,13,6,7,2,0
420375,4,20,13,7,17,1
174353,2,17,0,17,10,0
207770,4,24,13,11,7,0
217727,2,7,7,0,12,1
136783,3,13,10,3,11,0
80667,3,17,19,-2,3,1
142317,3,0,3,-3,13,0
88942,2,26,3,23,6,0
234602,1,10,3,7,2,0
24211,2,10,7,3,12,0
359357,3,3,20,-17,6,1
41822,4,21,14,7,2,0
360165,3,10,6,4,7,1
361126,4,23,23,0,7,1
275025,3,31,10,21,3,0
5260,4,24,30,-6,3,0
412281,1,0,0,0,13,0
112983,2,7,3,4,17,1
259605,2,0,3,-3,13,1
328299,2,3,13,-10,10,0
286274,3,13,13,0,8,0
361601,1,0,0,0,7,0
386355,2,17,6,11,2,0
137696,2,0,13,-13,11,0
418674,1,0,0,0,16,1
366335,4,28,16,12,10,0
381765,1,0,0,0,17,0
416848,4,22,17,5,15,0
64829,1,6,0,6,13,1
278002,2,3,10,-7,4,0
315986,3,0,24,-24,4,0
220221,2,17,0,17,13,1
340051,3,17,12,5,15,1
98815,1,0,0,0,11,0
77080,2,7,17,-10,1,0
272642,1,0,0,0,2,1
336883,2,7,14,-7,14,1
311276,4,9,3,6,2,0
187966,2,6,14,-8,16,1
62374,1,0,7,-7,12,1
410839,1,14,3,11,13,1
265048,2,10,3,7,16,1
353453,4,25,12,13,4,1
142476,3,14,10,4,13,0
129360,2,16,7,9,7,0
390280,4,17,13,4,3,0
249773,4,35,28,7,9,1
147455,4,23,10,13,15,0
40053,3,20,7,13,1,1
266114,4,17,13,4,16,1
85607,1,7,0,7,5,0
77390,3,14,14,0,1,0
320498,4,26,24,2,6,1
290928,2,14,0,14,10,0
6888,4,10,31,-21,3,0
25830,2,16,7,9,12,1
284486,3,14,15,-1,7,1
192743,1,0,3,-3,1,0
185721,2,17,3,14,15,1
353535,2,10,0,10,4,1
95234,2,3,7,-4,10,0
216425,4,24,23,1,12,0
353388,2,13,0,13,4,0
175444,4,20,23,-3,11,0
43473,1,0,0,0,3,0
399447,1,0,10,-10,7,0
202638,4,27,20,7,5,0
337511,3,7,12,-5,14,0
134978,4,7,27,-20,10,0
287001,2,10,14,-4,8,1
2677,2,6,7,-1,2,1
287674,4,9,10,-1,9,0
229327,4,24,33,-9,17,0
251252,3,10,24,-14,10,0
174347,2,17,0,17,10,0
107582,1,6,7,-1,15,0
85398,4,31,10,21,5,0
199235,2,17,21,-4,4,1
115346,5,26,23,3,1,0
80924,2,6,0,6,3,0
74544,3,0,3,-3,17,0
72782,2,20,14,6,16,1
356976,3,17,3,14,5,1
40830,4,32,35,-3,2,1
364353,1,6,0,6,9,1
43333,2,14,7,7,3,0
156662,3,6,7,-1,2,0
200482,4,23,18,5,4,0
185950,4,22,37,-15,15,1
145246,1,0,0,0,14,1
149066,2,7,7,0,16,1
240965,3,21,9,12,5,0
16991,4,27,23,4,8,1
101624,4,13,38,-25,12,1
34614,4,24,7,17,16,1
369252,2,14,7,7,11,0
97959,2,0,10,-10,11,1
198978,4,16,23,-7,3,1
128852,4,20,16,4,7,1
123301,2,14,7,7,4,0
88039,3,24,3,21,6,1
118942,1,0,10,-10,3,1
88432,2,7,0,7,6,0
215330,2,14,10,4,11,0
183800,2,10,21,-11,14,1
287035,3,19,24,-5,8,0
49598,1,0,0,0,6,0
178928,2,6,3,3,12,0
284000,2,3,0,3,7,0
195931,2,0,17,-17,2,0
2557,3,10,10,0,2,1
161508,4,17,6,11,4,1
411921,2,17,10,7,13,1
290905,1,0,0,0,10,1
401630,1,0,0,0,8,1
140979,1,7,0,7,13,0
87895,3,13,15,-2,6,0
262691,1,7,0,7,15,0
75724,2,21,16,5,1,1
353591,3,31,0,31,4,1
110233,1,0,3,-3,16,1
134423,1,0,7,-7,10,1
248851,1,0,0,0,9,1
284974,4,16,20,-4,7,0
331734,2,3,19,-16,12,0
150564,2,3,3,0,17,0
285898,2,13,0,13,8,1
51385,1,0,0,0,7,1
79983,1,6,0,6,2,1
365710,2,10,3,7,9,1
4833,4,34,3,31,3,1
393345,1,7,7,0,5,0
120871,3,14,17,-3,3,0
165094,3,10,24,-14,6,1
14113,1,0,7,-7,7,1
378216,4,41,16,25,15,0
80601,1,0,7,-7,3,0
271331,4,16,24,-8,1,0
361971,4,13,6,7,7,1
261261,3,31,0,31,14,1
111192,1,7,0,7,16,0
36743,1,0,7,-7,17,1
224073,4,14,9,5,15,1
322570,1,0,3,-3,7,1
352866,4,14,13,1,3,1
249767,4,35,28,7,9,0
247546,2,12,10,2,8,1
158135,1,0,0,0,3,0
385278,2,7,6,1,1,0
371510,4,24,24,0,12,0
358947,1,0,0,0,6,0
4242,3,13,6,7,2,1
257246,4,19,23,-4,12,0
196298,4,21,17,4,2,1
133210,4,20,17,3,9,0
405747,3,10,7,3,10,1
212943,3,7,7,0,10,1
389391,4,30,13,17,3,0
21106,2,0,0,0,10,0
60997,3,34,16,18,11,1
134179,2,0,10,-10,10,0
140129,2,10,0,10,12,0
127595,2,3,9,-6,6,0
394186,3,23,17,6,5,1
134644,3,31,23,8,10,0
252769,2,3,6,-3,11,1
253587,3,6,10,-4,11,1
73697,4,20,9,11,17,0
155237,3,28,7,21,1,0
187022,1,0,0,0,16,0
361701,4,10,39,-29,7,1
162837,3,3,3,0,5,1
279165,4,24,23,1,5,1
176612,1,0,3,-3,11,0
157186,1,0,0,0,2,1
206425,2,10,0,10,7,0
325371,4,15,20,-5,8,0
172341,1,0,7,-7,9,1
40521,4,7,20,-13,2,1
142965,4,10,13,-3,13,0
73996,4,37,0,37,17,1
158596,1,7,7,0,3,0
198443,2,10,3,7,3,0
408985,4,31,24,7,12,0
318483,4,31,7,24,5,1
254652,4,31,21,10,11,0
124168,4,22,21,1,5,0
23941,3,16,0,16,12,0
170978,1,7,0,7,8,0
406863,4,19,23,-4,11,1
393827,2,7,17,-10,5,1
2986,2,10,17,-7,2,1
31508,4,3,17,-14,15,1
152945,3,21,17,4,1,0
267169,4,17,10,7,17,1
267976,2,0,6,-6,17,1
14424,2,14,3,11,7,1
263314,2,16,7,9,15,1
53682,2,0,0,0,8,1
85309,2,14,3,11,5,1
327473,4,16,30,-14,9,1
201818,3,13,23,-10,5,1
140799,4,22,30,-8,12,0
148545,1,0,0,0,16,0
383169,4,26,24,2,17,0
215870,1,0,7,-7,11,1
218720,2,0,10,-10,13,0
271323,4,9,24,-15,1,1
306257,1,7,0,7,17,1
306352,4,31,10,21,17,0
197451,3,13,6,7,3,0
341325,1,0,9,-9,16,0
391907,4,23,20,3,4,0
170959,4,38,20,18,8,0
178683,3,3,20,-17,12,1
129204,2,13,6,7,7,1
83616,4,10,17,-7,4,1
137464,4,6,28,-22,11,1
206882,3,10,17,-7,7,0
77665,3,7,10,-3,1,0
86806,1,6,3,3,5,0
176118,1,7,7,0,11,1
177189,1,0,0,0,11,0
112880,3,10,3,7,17,0
66986,1,0,0,0,14,0
101239,3,7,7,0,12,1
172,1,3,0,3,1,0
362142,4,42,23,19,8,1
51054,3,3,20,-17,6,0
306013,2,3,10,-7,17,0
119564,2,7,0,7,3,1
289354,3,28,17,11,9,0
21805,1,0,0,0,11,1
385882,2,0,0,0,1,0
234810,2,0,3,-3,2,0
207119,1,0,0,0,7,1
146556,3,14,24,-10,15,1
13475,3,6,21,-15,7,0
85981,3,14,16,-2,5,0
327831,2,10,10,0,10,1
141463,1,7,0,7,13,0
206912,4,10,20,-10,7,0
288782,1,0,7,-7,9,1
187511,2,3,10,-7,16,1
67879,2,13,3,10,14,0
127128,2,3,9,-6,6,1
218181,3,17,3,14,12,0
165661,2,0,7,-7,6,1
383909,1,0,0,0,1,1
195865,4,27,21,6,2,0
96493,3,17,24,-7,10,1
98448,3,17,7,10,11,0
144186,1,0,7,-7,14,1
165357,2,0,10,-10,6,1
235289,4,24,6,18,3,1
803,3,7,6,1,1,0
387505,1,0,0,0,2,1
301449,2,10,3,7,15,1
323983,3,17,13,4,8,1
215533,4,13,3,10,11,0
16797,3,3,24,-21,8,1
145154,2,29,0,29,14,0
227931,3,27,20,7,16,0
38643,2,0,0,0,1,0
343991,3,16,6,10,17,1
381377,2,13,0,13,16,1
401140,3,34,13,21,8,0
54082,4,10,3,7,8,0
45050,3,23,13,10,4,1
185823,1,0,0,0,15,1
28688,3,3,10,-7,14,0
162462,1,7,3,4,4,1
277422,4,31,9,22,4,1
416967,4,10,17,-7,15,0
2868,3,31,31,0,2,1
392317,2,0,21,-21,4,1
367175,4,29,23,6,10,0
98873,2,7,7,0,11,1
125339,3,24,3,21,5,1
83151,4,13,30,-17,4,0
357024,4,26,10,16,5,1
203635,2,7,10,-3,6,1
413889,4,17,9,8,14,1
294154,1,0,0,0,12,0
112644,4,38,41,-3,17,1
40958,4,16,27,-11,2,1
346661,2,14,6,8,1,0
341580,4,16,17,-1,16,1
314111,4,33,20,13,3,0
31484,3,3,14,-11,15,0
158799,3,17,3,14,3,0
54654,3,14,22,-8,8,0
69347,4,19,9,10,15,0
125024,3,3,6,-3,5,1
121433,1,0,0,0,4,0
251983,2,0,13,-13,10,1
230857,2,7,7,0,1,1
209460,4,24,20,4,8,0
212763,2,10,21,-11,10,0
390865,3,9,28,-19,3,0
27511,3,20,9,11,13,1
387056,1,7,7,0,2,0
34735,3,6,3,3,16,0
376871,4,28,14,14,15,0
128790,2,10,13,-3,7,1
152850,1,0,0,0,1,0
279992,2,3,13,-10,5,1
140848,2,14,0,14,13,0
334147,3,16,7,9,13,1
380637,2,7,7,0,16,1
89515,2,0,3,-3,7,1
112237,2,14,7,7,17,1
192451,2,0,17,-17,1,0
218816,1,0,0,0,13,1
105885,4,19,10,9,14,0
268078,1,0,0,0,17,1
266399,4,36,8,28,16,1
6810,2,3,21,-18,3,1
414453,4,16,23,-7,14,0
319798,2,14,10,4,6,1
141383,3,10,17,-7,13,1
144473,4,17,33,-16,14,0
13059,4,14,7,7,6,1
51525,4,34,31,3,7,0
153206,4,20,20,0,1,0
289222,4,23,13,10,9,1
279915,4,31,13,18,5,0
21439,3,12,14,-2,11,0
207186,3,14,13,1,7,0
318411,2,21,7,14,5,0
200020,3,24,17,7,4,1
53787,5,10,10,0,8,0
387174,4,10,41,-31,2,1
125673,4,28,24,4,5,1
53075,2,13,7,6,7,1
278223,4,30,21,9,4,1
62556,1,3,7,-4,12,1
301015,2,10,3,7,15,1
179919,3,24,9,15,13,0
137127,4,24,6,18,11,1
55297,4,20,10,10,9,0
306810,4,26,36,-10,17,0
125570,2,7,7,0,5,1
315669,3,10,7,3,4,1
199818,2,3,10,-7,4,0
238410,4,17,33,-16,4,0
187258,3,10,6,4,16,0
99879,1,0,3,-3,12,1
128974,3,28,10,18,7,1
149873,3,3,16,-13,16,1
26515,5,30,29,1,13,0
170138,3,7,10,-3,8,0
326847,4,10,17,-7,9,0
408081,4,20,17,3,12,1
203339,3,14,27,-13,6,0
239661,1,0,3,-3,4,1
220237,2,17,6,11,13,1
4998,4,24,17,7,3,0
7605,3,21,3,18,4,1
362329,2,3,7,-4,8,1
140590,2,24,7,17,12,0
403459,2,17,9,8,9,0
147512,1,3,0,3,15,0
284717,1,0,7,-7,7,1
267621,1,0,0,0,17,0
12586,4,3,24,-21,6,0
159768,4,7,13,-6,3,0
199508,2,14,0,14,4,1
161373,1,0,0,0,4,0
116048,4,13,7,6,1,1
315271,5,20,19,1,4,0
111152,4,31,10,21,16,1
276568,1,0,0,0,4,1
152286,4,28,0,28,17,1
86681,2,10,0,10,5,0
398441,1,7,0,7,7,0
34338,4,23,9,14,16,1
96148,2,0,16,-16,10,0
6156,4,7,17,-10,3,0
50949,4,24,27,-3,6,1
17160,1,0,6,-6,9,0
6143,4,7,17,-10,3,1
307115,1,0,0,0,17,1
6250,3,13,7,6,3,0
329523,3,31,13,18,10,0
168607,3,17,13,4,7,0
83912,4,23,23,0,4,0
343694,4,18,10,8,17,0
403708,1,3,3,0,9,1
70418,1,14,14,0,15,0
228794,2,3,14,-11,17,1
387332,1,7,0,7,2,0
325202,4,13,23,-10,8,1
187195,1,0,0,0,16,1
231574,1,7,3,4,1,1
193279,4,3,20,-17,1,0
155685,2,10,13,-3,2,1
266631,2,10,3,7,16,1
122482,4,13,26,-13,4,0
386738,1,0,0,0,2,1
362408,4,30,20,10,8,0
380836,4,9,24,-15,16,1
86937,1,7,0,7,5,0
164756,3,23,14,9,6,1
371907,3,27,10,17,12,0
406724,4,34,6,28,11,0
272623,4,19,9,10,2,0
185816,1,0,0,0,15,0
272223,2,6,0,6,2,0
219634,2,10,0,10,13,0
359625,3,24,0,24,6,0
73766,2,3,0,3,17,0
281155,2,14,7,7,6,1
76856,4,33,7,26,1,1
117398,4,34,10,24,2,0
356721,4,19,16,3,5,1
166277,2,7,3,4,6,0
3891,2,19,7,12,2,0
60959,2,14,6,8,11,1
240926,2,14,6,8,5,1
94940,2,3,6,-3,9,0
163240,2,3,3,0,5,0
236596,1,0,0,0,3,1
178362,3,21,17,4,12,0
32631,1,0,0,0,15,1
262521,4,28,35,-7,15,1
307452,2,21,10,11,17,1
22852,1,0,7,-7,11,0
312205,2,7,14,-7,2,1
201811,3,13,10,3,5,0
179959,1,0,6,-6,13,1
203884,5,37,34,3,6,0
279144,4,21,20,1,5,0
119685,5,20,19,1,3,0
395801,2,0,7,-7,6,1
387169,4,10,41,-31,2,1
35349,3,23,6,17,16,0
5249,3,21,24,-3,3,1
331602,3,20,23,-3,11,0
322937,3,13,0,13,7,0
117685,3,27,13,14,2,1
153423,3,13,17,-4,1,1
202126,3,13,3,10,5,1
105088,3,26,14,12,14,0
407948,4,17,24,-7,11,0
212321,2,10,3,7,10,0
311728,1,0,0,0,2,0
165457,1,0,0,0,6,1
46926,4,20,27,-7,5,1
400707,4,16,10,6,8,1
19168,3,21,10,11,10,0
309107,2,9,3,6,1,0
226433,2,0,7,-7,16,1
24242,3,13,17,-4,12,0
414982,2,10,7,3,15,0
211284,1,3,0,3,9,1
46919,3,20,20,0,5,0
383644,2,0,14,-14,17,1
225088,3,13,14,-1,15,0
53025,4,27,24,3,7,0
188370,2,0,0,0,16,1
329560,4,45,20,25,10,0
327016,4,2,10,-8,9,1
343745,1,7,0,7,17,1
129222,2,14,6,8,7,1
93679,1,0,0,0,9,1
321053,4,16,14,2,6,0
240633,3,20,17,3,5,1
51109,1,7,0,7,7,0
367284,3,3,17,-14,10,1
55941,2,6,0,6,9,1
145429,2,3,14,-11,14,0
49163,2,10,0,10,6,0
298359,2,0,14,-14,14,1
62907,4,16,10,6,12,1
385618,4,6,24,-18,1,1
347665,3,17,17,0,1,1
154775,3,13,16,-3,1,0
388056,4,27,9,18,2,0
9565,5,20,20,0,5,0
74248,3,3,10,-7,17,0
73260,4,14,16,-2,16,0
214929,3,7,19,-12,11,0
101013,4,20,16,4,12,1
317142,1,0,0,0,5,0
309313,4,3,23,-20,1,0
289554,1,0,6,-6,10,1
175587,3,33,7,26,11,0
86369,1,7,0,7,5,0
69791,1,7,0,7,15,1
267756,4,23,34,-11,17,0
347932,3,0,21,-21,1,0
135421,4,28,24,4,10,0
125812,4,17,23,-6,5,1
152677,3,17,6,11,17,1
103599,1,0,0,0,13,1
355656,4,38,17,21,5,0
288765,4,3,13,-10,9,1
409017,4,31,31,0,12,1
317080,3,17,17,0,4,1
180019,2,7,20,-13,13,1
317574,1,0,0,0,5,1
82157,2,10,3,7,3,1
226756,3,7,19,-12,16,0
140174,4,10,3,7,12,1
107295,2,3,0,3,15,1
369700,2,16,17,-1,11,0
373383,3,10,7,3,13,0
413417,2,3,31,-28,14,1
9748,2,0,7,-7,5,1
172914,4,34,24,10,9,1
404085,4,10,49,-39,10,0
203854,4,34,31,3,6,0
154185,3,10,13,-3,1,1
186565,1,0,0,0,15,1
344475,1,0,0,0,17,0
330780,1,0,3,-3,11,0
363712,3,16,13,3,8,0
358946,1,0,0,0,6,0
133009,3,9,14,-5,9,0
224253,1,6,3,3,15,0
214931,4,7,19,-12,11,0
299870,2,13,5,8,14,0
10424,1,0,0,0,5,1
198660,3,13,21,-8,3,1
396673,2,7,7,0,6,0
80273,1,0,0,0,2,0
377360,1,0,0,0,15,1
74400,3,7,10,-3,17,1
139353,1,6,0,6,12,1
45187,3,7,10,-3,4,1
110058,4,48,16,32,16,0
47045,3,17,7,10,5,1
318765,4,17,23,-6,5,0
189869,1,0,0,0,17,0
329184,2,3,6,-3,10,1
58552,2,10,10,0,10,0
11104,3,10,13,-3,5,1
420591,1,0,10,-10,17,0
54484,2,7,7,0,8,1
55665,2,17,14,3,9,0
102724,1,0,0,0,13,0
981,4,0,6,-6,1,1
153414,3,13,10,3,1,1
151703,1,0,0,0,17,1
406673,3,14,0,14,11,1
77927,1,3,0,3,1,0
373010,1,0,0,0,13,1
330606,4,24,7,17,11,0
180182,3,13,0,13,13,0
255176,2,7,0,7,12,0
410707,2,10,3,7,13,1
258464,4,21,21,0,13,1
29337,4,21,10,11,14,0
301585,2,7,3,4,15,1
320635,4,38,18,20,6,0
324189,4,3,17,-14,8,0
355389,2,3,3,0,4,0
266870,5,17,17,0,16,1
156030,3,20,17,3,2,0
246677,4,31,3,28,8,1
419164,2,10,3,7,16,0
398236,4,35,17,18,7,0
77265,3,16,7,9,1,0
315631,2,0,0,0,4,1
225938,3,27,7,20,16,0
289775,3,3,10,-7,10,1
134586,2,17,3,14,10,0
350930,3,6,14,-8,3,0
205477,2,14,3,11,6,1
318019,4,17,13,4,5,1
63108,1,7,3,4,12,0
272377,2,21,0,21,2,1
421039,1,0,0,0,17,1
221863,2,6,0,6,14,1
248407,1,10,0,10,8,0
218415,2,10,14,-4,13,0
3503,4,16,30,-14,2,1
239014,4,29,15,14,4,0
404794,3,17,13,4,10,1
222734,1,3,0,3,14,0
180339,3,12,7,5,13,0
125546,1,0,0,0,5,1
171662,4,19,17,2,9,0
321895,2,14,21,-7,7,1
309446,3,7,6,1,1,1
26832,1,7,0,7,13,0
294097,4,7,24,-17,12,0
256304,4,14,17,-3,12,1
312077,2,17,7,10,2,1
4738,1,10,0,10,3,0
121297,1,0,0,0,3,1
322457,2,12,0,12,7,0
61948,1,0,0,0,12,1
49698,4,14,24,-10,6,1
104697,1,0,0,0,14,1
178086,5,23,23,0,12,1
259338,3,19,27,-8,13,1
69241,1,3,0,3,15,1
3487,4,10,30,-20,2,0
333964,2,14,10,4,12,1
377706,3,25,7,18,15,1
51018,2,0,17,-17,6,1
124221,1,0,14,-14,5,1
295099,2,7,14,-7,12,1
297331,1,3,3,0,13,0
19322,3,14,17,-3,10,1
37301,1,7,0,7,17,0
196373,2,10,0,10,2,0
115549,2,3,3,0,1,0
237410,4,12,14,-2,3,0
375851,4,20,7,13,14,0
89950,2,2,7,-5,7,0
310442,2,14,3,11,2,1
134186,2,0,17,-17,10,0
330949,1,6,7,-1,11,1
66315,2,0,14,-14,14,1
258641,4,13,13,0,13,0
118019,4,20,6,14,2,1
265280,4,9,6,3,16,1
402455,3,21,15,6,9,1
47727,4,6,17,-11,5,0
288342,2,7,0,7,9,0
211115,1,0,0,0,9,1
72777,2,14,14,0,16,1
66267,1,0,0,0,14,0
166149,3,14,12,2,6,1
90457,3,0,13,-13,7,1
196621,4,27,27,0,2,0
271695,1,6,3,3,2,0
86425,3,20,7,13,5,1
64314,2,6,13,-7,13,0
223567,4,17,13,4,15,0
222141,1,0,0,0,14,1
331241,1,0,0,0,11,0
300936,4,17,27,-10,15,0
102452,2,3,3,0,13,1
307628,2,7,7,0,17,1
349672,1,7,6,1,2,0
123813,3,10,3,7,5,1
325807,3,6,10,-4,9,1
50641,4,17,9,8,6,1
201185,3,13,21,-8,5,1
204921,3,13,19,-6,6,0
301197,3,20,14,6,15,0
151046,2,10,3,7,17,0
100296,1,6,7,-1,12,0
367717,3,6,13,-7,10,1
188555,2,3,10,-7,16,0
213314,1,3,0,3,10,0
260315,1,0,0,0,14,0
139154,3,19,6,13,12,1
241033,5,30,30,0,5,0
240585,2,3,0,3,5,0
251738,4,24,3,21,10,1
211905,4,43,23,20,9,0
334885,4,27,10,17,13,0
203318,2,14,24,-10,6,0
340552,4,7,42,-35,15,0
331109,1,0,6,-6,11,1
98744,3,28,6,22,11,0
109775,4,20,0,20,16,1
233243,2,0,3,-3,2,1
136359,4,18,14,4,11,0
149030,1,0,7,-7,16,1
154877,2,6,3,3,1,1
301233,4,27,17,10,15,0
362641,2,0,7,-7,8,1
390968,2,13,7,6,4,0
248644,3,17,10,7,9,0
161223,2,7,3,4,4,0
403746,2,12,10,2,9,1
210268,1,3,0,3,9,0
160284,2,3,0,3,4,1
148622,3,7,9,-2,16,0
114112,4,21,7,14,17,1
123143,2,3,7,-4,4,0
401469,4,27,10,17,8,1
246976,3,20,24,-4,8,0
46643,3,10,0,10,4,0
269902,1,7,0,7,1,0
27447,1,3,0,3,13,0
218581,2,7,17,-10,13,1
155294,4,28,27,1,1,0
49421,4,20,20,0,6,0
249983,2,7,3,4,9,0
280168,3,28,0,28,5,1
328793,3,17,13,4,10,0
96432,2,10,14,-4,10,0
82705,4,19,19,0,3,0
63057,3,16,21,-5,12,0
8540,4,22,10,12,4,0
311272,4,6,3,3,2,1
369475,4,48,7,41,11,0
159502,1,7,0,7,3,1
302810,3,9,20,-11,15,1
86668,2,7,0,7,5,0
359491,3,0,14,-14,6,0
257379,3,17,0,17,13,1
271859,1,0,9,-9,2,0
73842,4,13,7,6,17,0
269047,2,10,13,-3,17,1
132355,1,0,0,0,9,1
361446,1,0,0,0,7,1
338118,4,6,7,-1,14,1
378365,1,0,0,0,15,0
94930,2,3,3,0,9,1
233247,2,0,3,-3,2,0
230006,3,0,6,-6,17,1
188313,4,20,13,7,16,1
128028,1,0,3,-3,7,1
376885,4,28,21,7,15,1
318221,1,0,0,0,5,1
42565,4,10,31,-21,3,1
143883,1,0,0,0,14,1
231733,2,3,13,-10,1,1
153104,2,6,10,-4,1,0
159486,1,0,0,0,3,1
74128,4,23,6,17,17,1
294458,1,0,7,-7,12,1
209907,4,30,16,14,8,1
332016,2,0,3,-3,12,1
81099,2,3,14,-11,3,1
77305,1,0,0,0,1,0
29357,4,21,16,5,14,1
408408,1,0,0,0,12,0
334851,2,16,3,13,13,1
301446,2,10,3,7,15,1
71371,4,10,20,-10,16,0
61200,1,0,0,0,11,1
411057,3,17,17,0,13,1
324841,2,3,3,0,8,0
277597,4,12,14,-2,4,0
326432,1,0,3,-3,9,1
320902,4,3,14,-11,6,0
206389,2,10,0,10,7,0
367634,1,0,0,0,10,1
91863,4,30,13,17,8,0
10243,4,12,10,2,5,1
311419,1,0,0,0,2,0
205668,3,17,12,5,7,0
53071,2,10,7,3,7,1
149393,3,6,20,-14,16,1
260692,4,10,25,-15,14,1
240634,3,20,17,3,5,1
346792,2,3,0,3,1,1
8829,4,32,0,32,4,0
73792,2,6,0,6,17,0
45325,3,17,16,1,4,1
91346,3,14,7,7,8,0
260046,2,3,7,-4,14,0
294947,2,14,7,7,12,0
171065,3,17,30,-13,8,0
48715,2,10,19,-9,5,0
212827,4,24,21,3,10,0
355997,2,14,7,7,5,0
288355,2,7,0,7,9,1
135809,2,7,14,-7,10,1
274778,4,24,23,1,3,0
308324,1,0,0,0,1,0
317799,2,9,3,6,5,0
257499,2,9,10,-1,13,1
23339,3,9,10,-1,11,1
110405,1,7,0,7,16,0
312728,4,31,14,17,3,0
345475,4,9,22,-13,17,1
6559,4,10,6,4,3,0
104648,3,7,3,4,14,0
41602,1,7,0,7,2,1
266815,3,10,14,-4,16,0
225401,4,27,35,-8,15,0
133971,4,16,13,3,9,1
186095,1,0,0,0,15,1
71821,4,38,33,5,16,1
153734,3,2,21,-19,1,1
36284,1,0,0,0,17,1
53547,2,14,9,5,8,1
189670,4,17,6,11,17,0
15047,2,7,26,-19,7,1
68783,2,6,0,6,15,0
272716,3,12,3,9,2,1
384068,1,0,0,0,1,0
322302,1,7,0,7,7,1
312714,3,28,14,14,3,0
397400,1,0,10,-10,6,0
3281,2,3,3,0,2,1
321359,4,29,22,7,6,1
355752,3,7,6,1,5,1
312068,2,17,7,10,2,0
277696,2,7,0,7,4,0
37820,4,14,9,5,1,0
93916,4,24,6,18,9,0
81413,3,10,10,0,3,0
26497,4,30,28,2,13,0
93324,3,24,3,21,9,1
286383,2,7,0,7,8,1
290268,4,17,12,5,10,1
347146,3,16,10,6,1,1
397611,3,6,20,-14,7,0
2870,4,31,31,0,2,0
236186,3,17,16,1,3,0
118051,4,23,20,3,2,1
175785,1,0,0,0,11,1
375783,2,13,0,13,14,1
385891,2,0,7,-7,1,1
74468,1,0,0,0,17,0
10273,1,0,0,0,5,0
328109,2,6,0,6,10,0
144970,1,0,0,0,14,1
346614,1,7,0,7,1,0
214501,4,7,20,-13,11,1
419025,3,7,17,-10,16,0
414157,4,10,20,-10,14,1
231166,3,10,7,3,1,0
399615,2,3,3,0,8,1
133759,2,13,7,6,9,0
117924,1,0,3,-3,2,1
53080,2,19,7,12,7,0
118635,1,7,6,1,2,1
26145,3,0,13,-13,13,0
44726,2,0,12,-12,3,0
328627,3,17,35,-18,10,1
191039,1,0,0,0,17,0
124111,3,3,21,-18,5,1
90360,4,14,32,-18,7,1
103462,1,3,0,3,13,1
4581,1,0,7,-7,2,1
87541,2,17,3,14,6,1
369183,4,19,20,-1,11,1
388248,1,3,0,3,2,0
277914,4,7,20,-13,4,0
296448,2,14,0,14,13,0
90542,1,7,0,7,7,0
340846,4,24,19,5,15,0
279879,3,17,13,4,5,1
42519,3,10,21,-11,3,1
204772,3,21,21,0,6,1
34468,4,38,3,35,16,1
181459,4,31,24,7,13,0
27445,1,3,0,3,13,0
367989,2,17,14,3,11,0
71208,3,19,20,-1,16,0
304183,2,7,7,0,16,1
34784,4,20,3,17,16,0
242190,3,16,7,9,6,1
255140,1,0,0,0,12,1
173611,2,6,13,-7,10,1
96736,2,0,10,-10,10,0
219617,2,3,0,3,13,1
83086,3,6,21,-15,4,0
341618,1,0,0,0,16,1
384885,3,13,22,-9,1,1
304006,1,0,10,-10,16,1
63312,2,10,3,7,12,0
411755,2,0,17,-17,13,1
157304,4,19,3,16,2,0
170958,4,38,20,18,8,0
35586,1,7,0,7,17,1
66491,3,14,17,-3,14,0
237228,3,13,0,13,3,1
282192,1,3,0,3,6,1
99140,1,0,3,-3,11,1
191958,2,0,13,-13,1,1
53023,4,27,24,3,7,0
150693,1,6,3,3,17,0
234120,1,0,0,0,2,1
323909,1,7,0,7,8,1
102803,3,10,3,7,13,0
351975,3,21,14,7,3,0
14221,4,0,38,-38,7,1
408754,2,10,13,-3,12,0
201592,1,0,0,0,5,1
229408,2,3,3,0,17,1
117754,1,0,6,-6,2,1
341696,3,23,13,10,16,1
209546,2,34,17,17,8,0
406090,3,0,20,-20,11,1
368461,4,30,28,2,11,1
391220,1,0,0,0,4,0
99722,1,0,0,0,12,1
244265,3,23,7,16,6,1
332806,4,28,16,12,12,1
187439,4,41,14,27,16,0
103606,1,0,0,0,13,0
313514,1,0,0,0,3,0
36932,2,0,25,-25,17,1
165780,1,0,0,0,6,1
371002,2,7,7,0,12,0
6929,2,0,0,0,3,1
110706,1,0,3,-3,16,0
393426,3,28,24,4,5,0
419455,2,10,6,4,16,0
29949,1,0,0,0,14,0
109442,3,6,13,-7,16,0
269233,3,3,6,-3,17,0
380454,1,0,0,0,16,1
201520,3,31,7,24,5,1
297142,4,31,6,25,13,1
253889,3,38,14,24,11,1
283355,4,10,16,-6,7,1
419071,4,13,20,-7,16,0
3194,4,16,9,7,2,0
217670,1,0,0,0,12,0
239920,4,13,9,4,4,0
300112,1,7,3,4,14,1
172631,1,0,0,0,9,1
409668,2,10,3,7,12,1
76227,3,12,27,-15,1,1
20780,1,7,0,7,10,0
327437,4,3,17,-14,9,0
334778,4,32,11,21,13,0
63745,2,7,15,-8,12,1
240562,1,0,0,0,5,1
173258,1,0,0,0,10,0
53492,1,7,0,7,8,0
230103,1,0,3,-3,17,0
172547,2,7,21,-14,9,0
219027,2,17,0,17,13,0
108545,3,17,14,3,15,0
177352,1,3,0,3,11,1
309195,4,44,9,35,1,1
79920,3,10,16,-6,2,0
201934,2,0,0,0,5,1
295769,4,24,16,8,12,0
223936,1,0,0,0,15,1
256112,2,13,16,-3,12,1
197963,1,0,3,-3,3,0
107160,2,0,14,-14,15,1
41086,4,3,16,-13,2,1
229105,2,13,7,6,17,1
155638,1,0,0,0,2,0
246150,2,7,0,7,7,0
381832,3,7,14,-7,17,1
332721,2,14,6,8,12,1
148777,3,13,13,0,16,0
237679,3,20,7,13,4,0
274956,1,0,0,0,3,1
142384,4,7,6,1,13,1
371277,1,0,10,-10,12,1
349268,2,7,21,-14,2,1
258104,2,13,13,0,13,1
168777,4,16,9,7,7,0
272713,3,12,3,9,2,1
387303,4,6,10,-4,2,1
282528,3,17,10,7,6,0
294088,3,7,24,-17,12,1
23873,1,0,0,0,12,1
45866,2,7,3,4,4,1
119543,1,7,0,7,3,1
318273,2,3,7,-4,5,1
402794,4,30,20,10,9,0
54335,2,7,11,-4,8,0
247427,3,10,9,1,8,1
397921,3,7,9,-2,7,0
311314,1,7,0,7,2,1
252015,3,14,20,-6,10,1
128522,3,21,28,-7,7,1
324235,2,3,0,3,8,1
281112,1,0,0,0,6,1
65442,2,0,14,-14,13,1
350440,2,0,6,-6,2,0
157155,4,19,20,-1,2,1
259935,3,20,10,10,14,0
1860,4,19,10,9,1,0
386886,1,7,0,7,2,1
335924,4,31,21,10,13,1
130057,3,17,30,-13,8,0
331928,4,6,28,-22,12,1
265438,1,0,0,0,16,0
185947,4,22,37,-15,15,1
201248,1,0,0,0,5,1
14130,1,0,14,-14,7,0
85070,4,31,16,15,4,0
128714,4,13,30,-17,7,1
19120,1,7,3,4,10,1
208344,3,17,24,-7,8,0
1252,3,10,13,-3,1,1
161594,2,30,10,20,4,0
43588,4,31,3,28,3,0
84428,2,6,6,0,4,0
236694,3,17,7,10,3,1
166185,4,28,19,9,6,0
42891,2,7,3,4,3,1
78751,3,13,17,-4,2,0
112713,2,3,0,3,17,0
16166,1,0,0,0,8,1
73363,2,13,0,13,17,1
173672,4,19,22,-3,10,1
351458,1,0,0,0,3,0
278176,3,24,14,10,4,1
216500,2,27,8,19,12,0
361883,1,0,0,0,7,1
30594,2,17,0,17,14,1
52971,3,14,17,-3,7,1
297269,4,24,6,18,13,0
45495,3,27,20,7,4,0
342448,3,13,3,10,16,0
98876,2,7,7,0,11,1
336094,1,3,0,3,13,0
316951,4,30,18,12,4,1
51056,3,3,20,-17,6,0
362939,2,21,6,15,8,1
283838,1,7,0,7,7,1
395981,3,24,17,7,6,1
308034,1,0,0,0,1,1
376808,2,14,7,7,15,0
14442,2,24,3,21,7,0
195276,4,23,24,-1,2,0
6217,2,13,0,13,3,0
89000,4,39,10,29,6,0
162977,3,6,3,3,5,1
48809,1,0,0,0,5,1
140328,3,17,20,-3,12,1
261782,1,0,0,0,14,1
89733,4,16,23,-7,7,1
250929,2,3,6,-3,10,1
53427,3,3,28,-25,8,0
49783,2,7,7,0,6,0
5703,4,0,24,-24,3,0
108447,4,13,28,-15,15,0
218506,4,34,17,17,13,0
245983,1,0,0,0,7,0
38935,2,10,0,10,1,1
253488,4,17,44,-27,11,0
13205,4,22,26,-4,6,0
301945,3,14,20,-6,15,1
361655,3,7,22,-15,7,1
53078,2,13,7,6,7,0
225739,1,3,0,3,16,0
363652,2,0,10,-10,8,1
96269,1,0,6,-6,10,0
38015,1,3,0,3,1,0
187188,1,0,0,0,16,0
80045,3,16,3,13,2,1
281504,3,10,10,0,6,0
376576,4,15,6,9,14,0
87073,1,0,0,0,5,1
296571,1,0,0,0,13,0
379497,4,26,3,23,16,1
268246,1,0,0,0,17,1
217427,2,3,0,3,12,1
282582,4,23,24,-1,6,1
25229,1,7,0,7,12,0
277061,2,3,7,-4,4,1
22030,3,14,17,-3,11,0
282040,1,0,0,0,6,1
273419,1,0,0,0,2,0
154198,4,10,13,-3,1,0
399374,3,27,10,17,7,1
105707,3,28,3,25,14,1
370986,1,7,6,1,12,0
25956,2,3,3,0,13,1
265678,4,9,18,-9,16,1
241714,3,7,6,1,5,1
373045,2,0,0,0,13,1
2560,3,10,17,-7,2,1
329081,3,10,7,3,10,1
146461,1,0,0,0,15,0
285070,2,0,0,0,7,1
8380,4,30,10,20,4,1
367053,4,10,38,-28,10,1
301613,2,10,3,7,15,0
366206,1,0,0,0,10,1
166740,2,13,3,10,6,0
240551,5,19,19,0,5,0
269836,3,22,10,12,1,0
378965,1,0,0,0,15,1
2236,2,7,7,0,1,1
170100,2,7,0,7,8,0
211883,4,36,17,19,9,1
67550,1,0,0,0,14,0
154210,4,10,20,-10,1,0
272601,4,16,6,10,2,0
235233,2,15,3,12,3,1
230610,4,16,17,-1,1,0
124594,3,6,17,-11,5,1
382764,1,7,0,7,17,1
243807,4,24,20,4,6,1
266786,3,3,14,-11,16,1
319499,3,10,17,-7,6,0
18338,4,22,17,5,9,1
313281,2,6,7,-1,3,0
137201,2,7,3,4,11,0
144117,3,23,0,23,14,0
112610,4,31,34,-3,17,0
17719,4,17,6,11,9,1
126413,4,33,23,10,6,0
265077,3,13,3,10,16,1
88844,4,13,16,-3,6,1
277580,3,6,14,-8,4,1
186728,1,7,0,7,15,0
26131,2,0,13,-13,13,1
233600,3,20,34,-14,2,0
19132,2,14,3,11,10,0
388773,2,14,0,14,3,0
201396,4,28,29,-1,5,1
297295,4,26,6,20,13,1
347316,3,7,21,-14,1,1
118405,3,13,10,3,2,0
338813,2,10,0,10,15,0
381161,1,0,0,0,16,1
73210,2,7,6,1,16,1
100117,4,16,6,10,12,0
104499,3,14,31,-17,13,0
396979,2,7,3,4,6,0
43075,3,3,10,-7,3,1
365962,1,13,7,6,10,0
169840,3,17,17,0,8,1
111930,2,0,21,-21,17,1
131265,3,14,17,-3,8,0
307527,4,38,19,19,17,0
4063,2,13,21,-8,2,1
9752,2,0,7,-7,5,0
43111,4,6,24,-18,3,0
92113,2,3,17,-14,8,1
74150,4,37,6,31,17,1
272590,4,13,6,7,2,1
131681,2,7,22,-15,8,1
116815,1,0,0,0,2,1
194306,3,10,3,7,2,1
369590,4,14,3,11,11,0
163124,2,16,19,-3,5,0
352991,3,20,10,10,3,0
5192,1,7,3,4,3,0
111551,3,28,10,18,16,0
303085,2,0,14,-14,16,1
271797,4,30,20,10,2,1
38692,3,14,13,1,1,0
409941,2,0,14,-14,12,1
103641,2,0,7,-7,13,0
321869,2,7,14,-7,7,1
333570,4,16,10,6,12,1
154941,4,26,17,9,1,1
31312,2,7,3,4,15,0
181806,1,0,0,0,13,0
336120,2,10,3,7,13,1
294604,1,0,0,0,12,0
418119,2,14,0,14,16,0
179693,1,0,0,0,12,0
231350,3,9,16,-7,1,1
21163,4,0,16,-16,10,0
287689,4,9,13,-4,9,0
184214,2,10,0,10,14,0
332953,4,31,3,28,12,1
331204,4,10,19,-9,11,0
59755,2,6,10,-4,11,1
224702,1,0,0,0,15,0
82502,3,10,20,-10,3,0
183596,1,0,0,0,14,0
385969,4,24,21,3,1,0
15279,4,30,7,23,8,0
122270,2,6,13,-7,4,0
124809,1,0,3,-3,5,0
38899,1,0,0,0,1,1
341899,4,37,15,22,16,0
299007,4,16,12,4,14,0
8987,1,0,0,0,4,0
132110,2,10,0,10,9,0
72658,3,13,3,10,16,0
26749,3,6,17,-11,13,0
118415,3,19,10,9,2,1
134100,4,27,13,14,9,0
107431,1,0,3,-3,15,1
296890,2,10,0,10,13,0
118626,1,7,0,7,2,0
230936,4,31,10,21,1,0
208547,4,47,23,24,8,1
44055,1,0,0,0,3,0
287070,4,26,24,2,8,0
29601,3,14,13,1,14,1
417493,2,24,21,3,16,0
150761,3,13,9,4,17,1
172366,2,10,21,-11,9,0
185693,2,10,3,7,15,1
98419,2,14,7,7,11,1
2466,4,28,20,8,2,0
379063,3,7,6,1,15,1
411829,4,7,34,-27,13,0
297167,1,0,0,0,13,1
218291,2,7,14,-7,12,1
340556,4,7,42,-35,15,0
308685,2,7,6,1,1,0
308662,1,0,6,-6,1,1
300959,4,24,27,-3,15,1
157557,2,2,0,2,2,0
17617,1,0,0,0,9,0
189643,3,10,6,4,17,0
224123,1,0,10,-10,15,1
55263,3,7,10,-3,9,1
293856,4,31,19,12,12,0
323119,4,26,14,12,7,1
288762,4,3,13,-10,9,1
231664,4,17,16,1,1,1
393809,1,0,10,-10,5,1
129319,1,0,0,0,7,0
287130,1,7,3,4,8,1
303013,4,23,16,7,16,0
290382,3,23,10,13,10,0
49125,1,0,0,0,6,0
40383,4,15,10,5,2,1
82613,2,0,10,-10,3,1
7928,3,3,20,-17,4,1
262003,3,17,17,0,14,1
375668,3,17,20,-3,14,1
69787,1,7,0,7,15,0
139403,2,21,0,21,12,0
238720,4,19,17,2,4,0
216244,4,17,20,-3,12,1
393688,2,0,0,0,5,0
363308,4,33,14,19,8,0
406053,2,0,10,-10,11,0
173705,1,0,0,0,10,0
372047,3,13,10,3,13,1
88998,4,39,10,29,6,0
336089,1,3,0,3,13,1
73354,2,13,0,13,17,0
338,2,14,3,11,1,0
32792,1,0,0,0,15,1
185134,4,0,16,-16,15,0
276647,3,17,6,11,4,1
312590,4,44,0,44,3,0
85385,4,31,10,21,5,0
88933,2,23,3,20,6,1
9849,1,0,0,0,5,1
242676,4,16,10,6,6,1
174650,2,6,0,6,10,0
319400,1,0,0,0,6,1
329269,4,31,13,18,10,0
70922,4,15,36,-21,15,1
245884,3,6,30,-24,7,0
317688,4,16,9,7,5,1
401153,4,44,13,31,8,1
383086,2,20,7,13,17,0
379712,2,6,0,6,16,0
210739,2,14,0,14,9,0
347505,3,12,23,-11,1,0
420561,1,0,0,0,17,0
184394,3,21,6,15,14,1
163634,4,21,22,-1,5,0
163018,4,16,3,13,5,1
23820,4,17,7,10,12,1
191570,4,14,24,-10,17,1
135912,5,24,24,0,10,1
327393,2,0,14,-14,9,1
301469,2,20,6,14,15,0
418090,1,7,0,7,16,0
18539,1,3,3,0,9,1
69877,3,24,15,9,15,0
333354,2,17,7,10,12,0
63629,3,13,33,-20,12,1
83263,3,12,10,2,4,1
70659,4,17,22,-5,15,0
390740,4,13,17,-4,3,0
351872,4,27,14,13,3,1
245835,1,3,10,-7,7,0
141594,4,34,18,16,13,1
70515,4,32,23,9,15,1
233183,4,36,18,18,2,1
144814,1,7,0,7,14,1
57299,2,7,0,7,10,0
90349,4,14,29,-15,7,0
260008,1,0,0,0,14,1
77417,4,14,21,-7,1,1
234461,2,17,6,11,2,0
315177,2,7,7,0,4,0
200288,3,17,14,3,4,1
176596,1,0,0,0,11,0
348969,2,14,0,14,2,1
165488,2,0,7,-7,6,1
219346,3,16,10,6,13,0
255359,2,14,3,11,12,0
235429,3,28,17,11,3,0
191651,1,0,3,-3,17,0
225934,2,20,7,13,16,1
176375,4,16,28,-12,11,0
209400,3,14,10,4,8,1
152938,2,14,17,-3,1,1
267307,4,17,17,0,17,0
97279,4,27,20,7,10,0
331183,3,10,13,-3,11,1
318920,4,24,28,-4,5,1
371925,4,33,17,16,12,1
66646,3,7,17,-10,14,1
370974,1,0,0,0,12,1
277153,4,10,27,-17,4,1
412158,2,7,3,4,13,0
250666,3,10,22,-12,10,0
77394,3,14,20,-6,1,0
161210,1,0,3,-3,4,0
56884,2,14,0,14,9,1
241492,1,0,0,0,5,0
383212,2,14,3,11,17,1
254795,3,20,10,10,11,1
332380,4,16,20,-4,12,0
416660,4,34,7,27,15,0
61882,4,20,23,-3,12,1
107213,3,6,31,-25,15,1
239375,1,3,7,-4,4,0
317189,2,7,10,-3,5,1
279807,2,7,3,4,5,0
35630,3,17,3,14,17,0
53840,1,0,0,0,8,1
158918,2,14,9,5,3,1
64003,2,14,3,11,13,1
148031,3,7,3,4,15,1
206235,2,0,3,-3,7,0
402273,2,10,16,-6,9,1
48506,1,11,0,11,5,0
106419,2,13,0,13,14,0
337237,4,16,23,-7,14,0
421461,1,0,0,0,17,0
318134,3,9,10,-1,5,1
11768,1,0,0,0,6,1
44120,3,3,13,-10,3,1
284498,3,17,15,2,7,1
299204,1,0,0,0,14,0
59634,3,14,3,11,11,1
410251,2,7,7,0,13,1
184124,3,16,14,2,14,1
211975,2,3,10,-7,9,0
304351,3,20,7,13,16,0
63836,1,0,0,0,12,0
183103,3,7,3,4,14,0
415628,4,30,13,17,15,0
266832,4,17,14,3,16,0
52946,2,14,14,0,7,1
71920,3,15,13,2,16,1
207312,3,10,14,-4,7,0
113554,1,0,0,0,17,1
304279,1,0,0,0,16,1
186743,1,13,0,13,15,1
161630,3,36,16,20,4,0
111202,2,7,3,4,16,1
55963,2,10,7,3,9,1
331946,1,0,0,0,12,0
299335,4,28,16,12,14,1
118472,4,27,10,17,2,0
417094,4,34,0,34,15,0
100670,3,14,14,0,12,1
42644,2,0,7,-7,3,0
229989,2,0,6,-6,17,1
359753,3,24,15,9,6,0
287392,4,20,3,17,8,0
169552,4,10,35,-25,8,1
43190,2,7,7,0,3,1
173313,2,14,17,-3,10,0
368967,2,7,7,0,11,0
235785,4,20,27,-7,3,1
252582,1,0,0,0,10,1
326188,2,7,24,-17,9,1
137472,1,6,0,6,11,1
178143,1,0,7,-7,12,0
276475,2,10,7,3,4,1
86444,3,27,14,13,5,1
204261,2,0,7,-7,6,1
284242,4,16,26,-10,7,0
338842,3,10,7,3,15,1
369205,4,22,20,2,11,0
246425,1,7,0,7,8,0
76719,4,16,14,2,1,0
268322,3,20,3,17,17,0
116938,4,21,13,8,2,1
154205,4,10,20,-10,1,1
326727,1,0,7,-7,9,1
133515,4,27,20,7,9,1
399270,4,16,30,-14,7,0
214100,2,3,3,0,11,0
142301,2,0,0,0,13,0
7785,4,30,9,21,4,1
13539,1,0,0,0,7,0
63806,4,14,34,-20,12,1
105206,2,7,17,-10,14,1
274416,3,10,17,-7,3,1
231591,2,14,3,11,1,0
10760,2,7,0,7,5,0
30867,2,3,14,-11,15,1
284798,3,26,17,9,7,0
274629,1,0,0,0,3,0
238568,4,16,20,-4,4,1
52443,1,0,0,0,7,1
329482,2,10,0,10,10,0
26115,2,0,10,-10,13,0
115141,3,10,20,-10,1,1
161095,2,3,9,-6,4,0
224119,1,0,7,-7,15,0
358673,1,6,0,6,6,1
229439,3,10,6,4,17,1
103191,2,3,0,3,13,0
269204,2,3,3,0,17,0
272208,2,0,0,0,2,0
218453,3,24,14,10,13,0
127073,4,31,29,2,6,0
189382,4,27,17,10,16,0
405055,1,0,3,-3,10,1
165057,3,10,17,-7,6,1
141625,1,9,7,2,13,1
89714,3,16,20,-4,7,0
112800,4,34,10,24,17,0
124206,1,0,7,-7,5,1
221438,3,3,31,-28,14,1
97219,3,9,6,3,10,1
98683,1,0,3,-3,11,1
343473,2,7,7,0,16,1
388856,1,3,0,3,3,1
256877,2,7,3,4,12,0
31025,2,10,6,4,15,0
282044,1,3,0,3,6,0
32062,2,14,10,4,15,0
366574,3,20,14,6,10,1
385905,2,3,7,-4,1,0
43002,1,0,0,0,3,0
128088,3,3,6,-3,7,1
405480,4,24,16,8,10,1
162544,3,35,10,25,4,0
408333,3,10,7,3,12,0
87231,1,7,13,-6,6,0
121833,2,0,7,-7,4,0
284308,2,3,10,-7,7,1
24434,4,16,7,9,12,1
98398,2,6,7,-1,11,1
369592,4,14,3,11,11,0
93709,2,0,3,-3,9,0
44923,4,14,38,-24,4,0
144081,2,10,0,10,14,1
397853,2,0,0,0,7,0
200647,4,27,28,-1,4,1
156033,3,20,17,3,2,1
115241,2,0,9,-9,1,0
43746,1,7,0,7,3,0
412464,2,10,7,3,14,0
355995,2,14,7,7,5,0
224193,3,0,23,-23,15,1
35850,1,0,0,0,17,1
156025,3,17,17,0,2,1
36533,4,13,20,-7,17,0
334470,4,24,13,11,13,0
329321,2,6,17,-11,10,1
33739,1,0,0,0,16,1
232559,4,26,24,2,1,0
282434,4,10,26,-16,6,1
167380,4,30,30,0,7,1
29510,4,10,14,-4,14,0
144554,2,7,16,-9,14,1
91454,2,9,0,9,8,1
147425,3,23,7,16,15,0
205425,1,0,0,0,6,1
125086,1,0,0,0,5,1
355285,3,14,14,0,4,1
123619,2,0,0,0,4,0
140714,2,6,14,-8,12,0
364947,1,7,0,7,9,1
217662,4,26,23,3,12,0
299103,2,3,3,0,14,0
202144,3,13,3,10,5,1
204268,2,0,7,-7,6,1
330186,1,0,0,0,11,1
281084,4,38,16,22,6,1
331139,2,7,13,-6,11,0
268838,1,0,0,0,17,0
114912,1,0,0,0,1,1
168204,4,29,15,14,7,0
393600,3,7,26,-19,5,1
5034,1,0,0,0,3,1
349404,2,0,7,-7,2,0
327554,3,7,15,-8,10,1
138976,3,14,6,8,12,0
248286,2,14,0,14,8,1
183007,4,10,44,-34,14,1
298870,4,21,15,6,14,0
184044,1,0,0,0,14,0
242708,1,7,0,7,6,0
151468,2,28,7,21,17,0
315756,1,0,0,0,4,0
166077,1,7,0,7,6,1
294726,4,13,20,-7,12,0
29070,1,0,3,-3,14,0
362369,3,23,14,9,8,1
112192,4,27,34,-7,17,0
109918,4,23,13,10,16,0
267242,2,10,14,-4,17,0
371164,2,3,18,-15,12,0
203377,4,21,33,-12,6,0
31101,1,0,0,0,15,0
192326,3,27,17,10,1,0
420459,2,0,21,-21,17,1
397931,3,7,9,-2,7,1
393610,4,7,26,-19,5,0
228490,2,16,7,9,17,1
211369,3,10,10,0,9,0
417668,3,21,6,15,16,1
415014,3,10,20,-10,15,1
102698,4,32,31,1,13,1
138752,1,0,0,0,12,1
146844,3,24,0,24,15,0
147662,2,3,0,3,15,0
64980,1,0,7,-7,13,0
169603,1,3,0,3,8,1
40378,4,15,10,5,2,0
281546,4,20,16,4,6,0
134945,3,7,22,-15,10,1
288876,3,10,24,-14,9,1
98185,4,28,19,9,11,1
103372,3,10,17,-7,13,0
356128,2,7,0,7,5,1
420553,4,10,42,-32,17,1
23182,2,23,6,17,11,1
69370,1,0,0,0,15,0
91201,3,10,17,-7,8,0
134321,2,16,14,2,10,0
233100,2,8,0,8,2,0
70767,3,20,24,-4,15,1
320467,4,17,17,0,6,1
290604,1,7,0,7,10,0
255710,4,3,13,-10,12,1
272424,3,31,10,21,2,1
359665,4,40,7,33,6,0
315884,4,9,26,-17,4,1
229430,3,10,6,4,17,0
241136,3,20,10,10,5,0
376103,3,0,3,-3,14,1
252125,2,7,10,-3,10,0
228053,3,3,3,0,17,0
311164,1,3,0,3,2,0
148738,2,13,3,10,16,0
299413,2,0,20,-20,14,1
206613,4,10,16,-6,7,0
204034,4,16,7,9,6,1
207396,1,7,0,7,7,0
41840,4,28,14,14,2,0
314050,3,9,7,2,3,0
85860,4,20,16,4,5,0
294150,1,0,0,0,12,0
379052,3,7,6,1,15,0
189568,1,0,0,0,17,1
294185,2,0,7,-7,12,1
410286,3,7,16,-9,13,0
198069,4,3,37,-34,3,1
213223,3,10,13,-3,10,0
155887,3,14,13,1,2,1
63089,4,23,42,-19,12,0
317996,3,10,10,0,5,0
280650,1,0,0,0,5,0
318151,3,15,10,5,5,1
323950,2,10,10,0,8,0
172123,4,13,18,-5,9,1
389615,2,10,7,3,3,0
138545,5,31,37,-6,12,1
110407,1,7,0,7,16,1
197412,2,13,3,10,3,1
407551,2,10,3,7,11,0
359592,2,17,0,17,6,1
54565,4,21,18,3,8,1
202276,2,3,0,3,5,1
293616,1,7,0,7,12,0
42311,1,0,9,-9,2,0
113262,2,7,13,-6,17,0
91322,2,7,7,0,8,1
272300,4,12,10,2,2,0
188436,3,3,3,0,16,0
127718,1,0,7,-7,6,1
12183,1,0,0,0,6,0
404340,3,20,6,14,10,0
177292,4,17,20,-3,11,1
326362,3,17,10,7,9,0
90678,4,27,33,-6,7,0
30465,3,24,28,-4,14,1
57977,4,13,17,-4,10,0
49984,3,21,7,14,6,0
349756,4,20,14,6,2,1
302282,4,38,13,25,15,1
120631,4,3,20,-17,3,0
127678,4,30,20,10,6,0
73289,1,0,0,0,17,1
362470,2,0,6,-6,8,1
13199,4,22,26,-4,6,0
215760,2,29,3,26,11,1
353764,5,20,20,0,4,0
55734,4,23,29,-6,9,1
282906,1,0,0,0,6,0
254708,1,3,0,3,11,1
82047,3,17,7,10,3,0
24723,4,20,14,6,12,0
81062,1,0,7,-7,3,1
92051,1,0,0,0,8,1
212458,2,10,0,10,10,0
54896,1,0,0,0,8,1
234330,2,17,0,17,2,1
209017,1,3,0,3,8,0
257122,4,17,21,-4,12,0
64644,4,20,24,-4,13,0
272962,1,3,0,3,2,0
245681,1,3,3,0,7,0
354137,4,22,0,22,4,0
214087,1,3,0,3,11,0
6222,2,13,0,13,3,1
71863,2,9,0,9,16,0
62985,2,6,7,-1,12,0
203332,2,14,27,-13,6,1
335451,3,13,9,4,13,0
47091,4,24,10,14,5,1
229538,2,17,6,11,17,0
285787,3,7,17,-10,8,1
329438,1,0,0,0,10,1
282792,2,0,13,-13,6,0
377242,2,7,3,4,15,1
408508,3,10,10,0,12,1
45897,2,7,3,4,4,1
153731,3,2,21,-19,1,1
41853,1,0,0,0,2,1
51163,2,17,3,14,7,1
129711,2,14,6,8,7,1
15018,2,0,16,-16,7,0
112133,3,7,20,-13,17,0
258022,4,7,35,-28,13,0
371106,4,13,27,-14,12,0
134420,1,0,7,-7,10,1
66382,4,14,27,-13,14,1
94740,1,0,0,0,9,1
402219,1,0,0,0,9,0
79602,3,14,7,7,2,0
389318,2,7,6,1,3,0
163325,4,13,23,-10,5,1
162529,3,35,10,25,4,0
53128,3,19,38,-19,7,1
32455,4,31,6,25,15,0
320897,4,3,14,-11,6,1
340930,3,0,10,-10,15,1
388491,3,3,16,-13,2,1
94867,4,6,13,-7,9,1
229598,4,30,13,17,17,1
405407,2,14,10,4,10,0
233903,3,14,13,1,2,1
220341,1,0,0,0,13,1
335370,4,3,23,-20,13,1
71888,2,12,13,-1,16,1
382225,2,10,3,7,17,0
284749,2,6,10,-4,7,1
340303,1,10,0,10,15,0
36052,2,17,0,17,17,0
98143,3,21,10,11,11,0
399723,1,0,3,-3,8,1
64575,2,10,7,3,13,0
262012,3,24,17,7,14,0
224305,3,9,12,-3,15,1
229878,3,13,14,-1,17,1
209630,1,0,0,0,8,0
228937,2,7,9,-2,17,1
193488,4,33,20,13,1,0
294908,1,0,7,-7,12,0
338553,4,20,31,-11,14,1
153991,2,7,7,0,1,0
80448,1,2,0,2,3,1
104999,1,0,0,0,14,0
38996,3,30,16,14,1,0
36680,4,20,3,17,17,0
1497,2,3,6,-3,1,0
74240,3,3,10,-7,17,0
303867,1,0,7,-7,16,1
274312,4,32,18,14,3,1
211242,4,21,26,-5,9,1
196049,1,3,14,-11,2,0
418805,4,17,24,-7,16,0
202300,3,13,3,10,5,0
226139,3,14,17,-3,16,1
297076,2,21,0,21,13,1
73413,4,30,3,27,17,1
298394,3,7,14,-7,14,1
238437,1,0,0,0,4,1
134504,4,3,33,-30,10,1
76831,4,33,0,33,1,0
309635,1,0,0,0,1,0
88927,2,23,3,20,6,0
83186,1,3,0,3,4,0
207969,1,7,0,7,8,0
83475,1,0,0,0,4,0
255261,4,13,17,-4,12,0
300706,1,7,0,7,15,1
335444,3,13,9,4,13,1
61806,2,0,17,-17,12,1
6579,4,13,6,7,3,1
228176,2,7,20,-13,17,0
377830,2,14,0,14,15,1
169308,1,0,0,0,8,0
188311,4,20,13,7,16,0
334872,3,24,10,14,13,1
370932,4,26,20,6,12,1
11470,1,6,7,-1,6,1
405249,2,7,7,0,10,0
320614,4,31,18,13,6,1
200276,2,10,14,-4,4,0
173397,1,0,0,0,10,0
370638,4,21,14,7,12,0
41689,4,31,13,18,2,0
323167,1,0,0,0,7,0
116800,4,34,26,8,2,0
132726,3,10,17,-7,9,0
185348,1,0,0,0,15,0
67233,4,0,3,-3,14,1
134262,4,10,23,-13,10,0
34720,2,6,3,3,16,1
395905,1,7,0,7,6,0
385936,3,10,20,-10,1,0
258507,1,0,0,0,13,0
50911,4,17,24,-7,6,1
419564,1,13,7,6,17,0
393081,2,7,3,4,4,1
53653,1,0,0,0,8,1
210628,3,13,17,-4,9,1
393900,4,20,20,0,5,1
134685,4,34,31,3,10,1
58417,3,34,10,24,10,1
63194,3,14,23,-9,12,0
39477,4,13,12,1,1,1
405047,1,0,0,0,10,0
274034,1,3,0,3,3,1
64385,1,0,0,0,13,0
65081,4,6,17,-11,13,1
83926,1,0,0,0,4,0
156799,2,20,20,0,2,1
203363,3,21,27,-6,6,0
94334,2,10,7,3,9,1
108179,1,3,0,3,15,0
248973,4,27,3,24,9,0
8505,3,15,10,5,4,1
389373,3,23,13,10,3,1
221498,4,10,41,-31,14,1
192853,4,10,15,-5,1,0
286329,4,25,19,6,8,1
122156,4,24,21,3,4,0
180063,4,28,20,8,13,0
367339,4,6,20,-14,10,0
112443,4,13,13,0,17,0
180560,4,28,32,-4,13,1
107570,1,0,7,-7,15,1
118685,2,14,6,8,2,0
7466,3,29,6,23,4,0
120534,1,0,6,-6,3,0
322284,1,7,0,7,7,0
290047,2,7,6,1,10,1
220546,3,7,20,-13,13,1
47418,5,13,13,0,5,0
319864,4,23,10,13,6,0
307927,2,7,0,7,1,0
11265,3,17,28,-11,6,1
111558,4,35,10,25,16,0
100239,4,17,14,3,12,1
112029,4,35,21,14,17,1
81497,1,0,14,-14,3,1
9429,2,3,0,3,5,0
211359,3,10,10,0,9,1
295167,4,10,21,-11,12,0
273120,1,0,0,0,2,1
172463,4,13,49,-36,9,1
212385,4,13,17,-4,10,1
207769,4,24,13,11,7,0
400455,4,24,10,14,8,0
372175,3,9,13,-4,13,1
359865,2,17,14,3,6,1
20466,2,0,0,0,10,1
71416,2,17,0,17,16,0
413323,4,20,0,20,14,0
384267,2,6,0,6,1,1
26869,2,10,6,4,13,1
295729,3,10,9,1,12,0
142744,2,9,10,-1,13,0
360103,4,10,43,-33,7,0
151100,4,17,10,7,17,1
126544,3,10,6,4,6,0
160463,2,20,7,13,4,0
43735,4,24,17,7,3,1
230136,2,3,22,-19,17,0
401286,3,13,21,-8,8,1
221383,2,0,17,-17,14,1
255705,4,3,10,-7,12,0
243842,1,0,0,0,6,1
358153,3,17,6,11,6,0
337826,4,30,6,24,14,1
370728,2,9,7,2,12,1
147646,1,3,0,3,15,0
260372,3,6,0,6,14,1
332900,3,24,0,24,12,0
73473,2,0,14,-14,17,1
290523,3,14,20,-6,10,1
352493,1,0,0,0,3,1
115337,5,23,23,0,1,1
256775,3,10,13,-3,12,1
202115,2,13,3,10,5,1
118328,4,26,7,19,2,1
147279,3,0,30,-30,15,0
340920,2,0,10,-10,15,1
101817,1,0,0,0,12,1
172928,4,41,24,17,9,0
223191,2,3,0,3,15,0
63378,4,17,3,14,12,0
253849,2,21,14,7,11,0
73999,4,37,0,37,17,1
334411,3,10,10,0,13,0
26711,2,3,7,-4,13,0
126564,3,13,6,7,6,1
179897,3,17,9,8,13,1
324493,1,0,0,0,8,0
150147,2,3,13,-10,16,1
21784,4,31,30,1,11,0
353606,4,38,0,38,4,0
254639,4,28,21,7,11,1
15539,4,23,6,17,8,1
346043,2,3,6,-3,1,0
161272,3,20,3,17,4,1
83643,1,0,0,0,4,0
395392,3,28,3,25,5,1
282420,4,10,26,-16,6,1
235558,3,10,13,-3,3,1
192179,3,3,20,-17,1,1
238432,4,17,36,-19,4,1
67990,1,0,0,0,14,1
5929,2,7,23,-16,3,1
108570,4,17,14,3,15,1
354223,3,13,10,3,4,0
326527,3,38,9,29,9,1
400699,3,16,7,9,8,0
401342,1,0,0,0,8,0
14821,4,45,10,35,7,1
372974,4,28,7,21,13,0
114634,2,3,3,0,1,1
254940,3,38,7,31,12,0
4848,1,0,0,0,3,1
196371,2,10,0,10,2,1
98923,3,7,17,-10,11,0
205965,2,6,10,-4,7,1
114830,3,13,27,-14,1,0
192117,2,0,6,-6,1,0
34273,3,17,9,8,16,1
187051,1,3,0,3,16,1
169062,3,32,14,18,7,1
265932,3,0,16,-16,16,0
142600,2,6,3,3,13,1
229932,4,29,20,9,17,0
321622,3,17,13,4,7,1
295963,1,0,0,0,13,0
329381,3,16,34,-18,10,1
90456,3,0,13,-13,7,1
322644,3,6,6,0,7,0
230060,4,19,6,13,17,1
415211,4,17,31,-14,15,1
110007,3,20,10,10,16,0
46466,2,14,6,8,4,1
193357,1,7,10,-3,1,1
99189,2,10,10,0,11,1
315376,3,16,17,-1,4,0
320591,3,31,6,25,6,1
71120,1,12,0,12,16,1
236418,4,17,23,-6,3,0
275445,2,20,10,10,3,0
367147,3,29,16,13,10,0
399070,3,10,19,-9,7,0
66865,1,0,7,-7,14,1
333574,4,16,16,0,12,1
413905,4,17,9,8,14,1
349654,1,0,0,0,2,1
131563,3,9,23,-14,8,1
303543,1,0,0,0,16,1
202925,4,31,0,31,5,1
292112,1,7,0,7,11,1
144921,4,20,7,13,14,1
204443,3,7,17,-10,6,0
212085,1,0,0,0,10,0
313782,4,31,17,14,3,0
266938,2,13,7,6,17,1
51103,1,0,0,0,7,1
22084,5,24,24,0,11,0
166844,1,0,3,-3,6,1
368150,3,13,14,-1,11,1
258802,1,7,7,0,13,1
277044,1,3,0,3,4,1
168673,1,0,0,0,7,1
401196,1,0,0,0,8,1
216818,2,0,7,-7,12,1
9356,3,28,7,21,5,1
218034,3,21,17,4,12,1
47003,2,13,0,13,5,1
141086,4,14,10,4,13,0
98800,4,34,8,26,11,1
12891,4,13,13,0,6,0
325648,3,17,7,10,9,0
320950,1,0,0,0,6,1
127442,2,3,0,3,6,0
325657,3,24,7,17,9,1
147539,2,6,0,6,15,1
350880,2,0,14,-14,3,1
211863,4,22,10,12,9,1
56679,1,0,0,0,9,0
370607,3,14,14,0,12,0
198863,1,0,6,-6,3,1
151864,1,10,0,10,17,0
97516,2,16,0,16,10,1
323576,4,34,24,10,7,0
295222,2,14,2,12,12,0
55624,1,0,0,0,9,0
77135,4,17,17,0,1,0
73595,1,0,0,0,17,1
82083,4,20,17,3,3,1
173771,3,10,3,7,10,0
218200,3,30,3,27,12,1
24727,4,20,14,6,12,1
186370,4,36,24,12,15,0
266852,4,17,17,0,16,0
261745,4,14,7,7,14,1
83267,3,12,10,2,4,1
181625,4,23,6,17,13,0
293200,2,13,7,6,11,1
237425,4,12,17,-5,3,0
108437,4,13,28,-15,15,0
323193,2,7,0,7,7,0
220272,3,20,9,11,13,1
386646,2,7,13,-6,2,0
337843,4,30,6,24,14,0
115221,1,0,3,-3,1,0
272099,3,17,6,11,2,0
120973,1,5,7,-2,3,0
253633,4,9,17,-8,11,1
266218,3,24,6,18,16,0
238108,5,13,13,0,4,0
409086,2,3,10,-7,12,0
162080,3,28,13,15,4,1
257174,1,0,9,-9,12,1
358307,3,0,20,-20,6,1
297354,2,3,10,-7,13,1
121561,3,22,10,12,4,0
171775,2,13,14,-1,9,0
115347,1,0,0,0,1,1
222796,2,10,10,0,14,0
117127,1,6,0,6,2,0
289265,1,7,7,0,9,0
137152,4,31,6,25,11,0
228615,2,10,14,-4,17,1
54113,4,20,3,17,8,0
6292,4,16,17,-1,3,0
345389,2,0,10,-10,17,1
316840,4,16,10,6,4,1
173596,2,0,13,-13,10,1
117143,1,6,3,3,2,1
195853,4,27,21,6,2,0
309717,3,19,6,13,1,0
36151,1,0,0,0,17,0
46533,4,40,6,34,4,0
390328,1,0,7,-7,3,1
331000,2,33,7,26,11,1
278708,4,24,10,14,4,1
7920,3,3,20,-17,4,0
200371,1,0,6,-6,4,1
153748,3,2,21,-19,1,0
25767,4,17,17,0,12,1
140949,4,23,13,10,13,0
140610,2,31,10,21,12,0
177921,4,21,23,-2,12,0
240760,2,7,7,0,5,0
397081,4,24,16,8,6,0
224273,2,6,9,-3,15,0
296677,4,10,16,-6,13,1
363988,3,3,9,-6,8,1
413169,4,40,45,-5,14,1
254619,3,21,14,7,11,1
3135,2,3,6,-3,2,0
312907,4,21,21,0,3,0
1464,1,0,0,0,1,1
117223,3,23,10,13,2,1
227028,3,10,6,4,16,0
179732,2,3,10,-7,12,0
404488,3,21,19,2,10,1
149354,1,3,0,3,16,0
395423,4,31,3,28,5,0
301253,4,27,20,7,15,1
144617,4,20,22,-2,14,1
384652,1,0,7,-7,1,0
132044,4,3,24,-21,8,0
205300,2,10,0,10,6,0
167500,2,0,3,-3,7,1
135181,1,10,0,10,10,1
401483,4,27,13,14,8,1
383798,2,3,7,-4,1,0
380972,4,9,14,-5,16,0
207486,4,21,14,7,7,0
418470,3,17,3,14,16,0
219624,2,10,0,10,13,0
172868,3,24,10,14,9,1
211621,1,7,3,4,9,0
408414,1,0,0,0,12,1
199070,2,7,14,-7,4,0
161948,4,13,16,-3,4,1
346868,3,23,6,17,1,0
45847,1,0,0,0,4,1
384779,1,0,0,0,1,1
400910,1,6,7,-1,8,1
222327,2,13,3,10,14,1
182841,4,29,20,9,14,1
121824,2,0,7,-7,4,0
229919,4,27,14,13,17,1
292409,1,0,0,0,11,1
1135,4,10,36,-26,1,0
58092,2,10,10,0,10,1
128940,2,22,3,19,7,1
369922,4,16,16,0,12,0
359656,4,37,7,30,6,1
61627,1,0,0,0,12,0
240486,3,3,7,-4,5,0
204419,2,7,10,-3,6,1
32721,3,7,21,-14,15,0
131671,2,7,22,-15,8,0
34773,4,20,3,17,16,0
4568,4,31,29,2,2,0
295039,1,0,0,0,12,0
115733,3,13,13,0,1,0
271279,2,6,7,-1,1,0
110029,3,27,10,17,16,1
163198,4,33,28,5,5,1
43856,4,24,16,8,3,0
228560,4,20,14,6,17,0
346393,3,9,13,-4,1,1
209138,4,9,30,-21,8,0
175389,2,14,3,11,11,1
135478,1,7,0,7,10,1
300712,1,7,0,7,15,1
205302,2,10,0,10,6,1
222505,3,9,14,-5,14,0
84553,1,0,0,0,4,0
285293,3,14,9,5,7,0
72454,1,7,7,0,16,0
368432,3,23,7,16,11,0
132194,1,0,0,0,9,1
349911,3,3,12,-9,2,1
317014,2,0,10,-10,4,0
348945,1,7,0,7,2,0
293774,2,10,3,7,12,0
95257,2,3,10,-7,10,1
246894,1,0,7,-7,8,0
56823,4,17,20,-3,9,1
301269,1,0,0,0,15,0
340084,4,20,15,5,15,0
37834,4,14,9,5,1,0
110339,3,17,17,0,16,0
157189,1,7,0,7,2,0
377788,1,0,0,0,15,1
222929,2,13,13,0,14,1
181574,3,13,3,10,13,1
8680,4,7,10,-3,4,1
346596,1,0,0,0,1,1
216942,1,3,0,3,12,0
40373,4,12,10,2,2,1
97148,4,34,13,21,10,1
278966,3,7,30,-23,5,1
178887,1,0,0,0,12,1
213369,2,10,13,-3,10,1
353623,1,0,0,0,4,1
209553,3,34,20,14,8,1
290238,3,17,3,14,10,1
276665,3,20,6,14,4,1
347887,1,0,0,0,1,0
43340,2,14,7,7,3,0
358456,4,32,27,5,6,1
232483,2,10,3,7,1,0
243452,3,3,17,-14,6,1
280489,1,0,0,0,5,1
381616,1,0,0,0,17,1
254494,4,29,13,16,11,0
7895,2,3,14,-11,4,0
374600,4,20,19,1,14,0
109195,1,0,0,0,15,0
389611,2,10,7,3,3,0
357220,1,0,3,-3,5,0
363726,3,23,13,10,8,0
255676,3,3,7,-4,12,0
296254,1,0,0,0,13,0
230053,4,19,6,13,17,0
237790,1,0,10,-10,4,1
175447,4,20,23,-3,11,0
256668,4,38,14,24,12,0
199007,4,19,26,-7,3,1
80894,1,3,0,3,3,1
304217,3,26,7,19,16,1
34015,4,17,27,-10,16,0
273364,4,35,6,29,2,0
111111,3,24,7,17,16,0
258073,1,6,0,6,13,0
277119,3,10,17,-7,4,0
327816,1,3,10,-7,10,0
359196,4,13,21,-8,6,0
421566,4,16,3,13,17,0
383000,4,10,21,-11,17,0
315672,3,10,13,-3,4,1
20364,3,10,13,-3,10,1
65184,3,3,3,0,13,1
53114,3,19,24,-5,7,0
421479,1,0,0,0,17,0
317115,4,20,20,0,4,1
45267,2,0,0,0,4,1
153602,4,12,14,-2,1,0
417385,3,13,17,-4,16,0
21690,2,10,7,3,11,0
279347,1,0,0,0,5,1
173801,3,17,3,14,10,1
170630,4,47,9,38,8,0
147565,3,9,0,9,15,1
50625,4,10,6,4,6,0
322613,2,3,6,-3,7,1
386431,4,23,17,6,2,0
243188,5,23,22,1,6,0
199683,2,21,7,14,4,0
41712,1,0,0,0,2,0
379955,4,24,6,18,16,1
290809,2,10,7,3,10,1
176813,2,10,7,3,11,0
288308,1,0,0,0,9,1
7492,4,29,6,23,4,1
102799,3,10,3,7,13,0
31356,3,7,3,4,15,0
188000,3,20,14,6,16,1
420475,2,0,28,-28,17,0
363912,1,0,0,0,8,0
240191,4,16,6,10,5,0
162339,2,3,7,-4,4,0
62298,3,21,19,2,12,1
34592,3,17,7,10,16,1
256130,3,14,16,-2,12,1
85624,2,7,0,7,5,1
387979,2,3,3,0,2,1
8078,3,17,7,10,4,0
174296,1,7,0,7,10,1
123077,4,14,21,-7,4,0
260164,1,0,0,0,14,1
295255,3,14,5,9,12,0
309542,2,6,0,6,1,0
100626,2,7,7,0,12,0
53259,3,3,0,3,8,1
359180,3,10,21,-11,6,1
22467,3,24,27,-3,11,1
34840,1,10,0,10,16,1
403898,2,17,14,3,10,0
92384,2,10,0,10,8,0
114892,4,24,40,-16,1,1
49019,2,10,7,3,6,1
101283,4,17,7,10,12,0
284112,1,0,3,-3,7,1
229024,4,23,16,7,17,1
218465,3,24,17,7,13,0
143439,1,7,0,7,14,0
57526,3,21,16,5,10,0
115095,2,3,13,-10,1,1
2274,3,10,10,0,1,0
396510,1,14,7,7,6,0
213872,4,48,7,41,10,0
345297,4,19,17,2,17,0
188622,4,20,19,1,16,0
123375,3,21,24,-3,4,0
112739,3,10,0,10,17,0
338051,2,0,7,-7,14,1
167405,4,37,40,-3,7,1
50817,1,0,7,-7,6,1
107820,4,7,23,-16,15,1
60556,3,30,27,3,11,0
60651,2,7,3,4,11,0
271673,1,0,3,-3,2,1
21536,2,7,7,0,11,0
58594,3,10,17,-7,10,1
215976,4,20,35,-15,11,0
164517,3,23,3,20,5,0
416870,1,0,0,0,15,0
269347,2,7,7,0,1,0
192615,2,3,7,-4,1,1
151848,1,0,0,0,17,1
57092,4,21,27,-6,9,0
278449,2,22,0,22,4,1
89863,3,23,13,10,7,0
159854,2,17,0,17,3,0
38455,1,0,0,0,1,0
340171,2,20,7,13,15,0
215363,4,17,20,-3,11,1
263153,2,3,7,-4,15,0
338030,2,0,0,0,14,0
204387,1,7,3,4,6,0
260809,3,9,12,-3,14,0
223814,2,9,0,9,15,0
103403,4,10,20,-10,13,0
165543,3,3,28,-25,6,1
16776,2,3,14,-11,8,0
159327,4,27,30,-3,3,0
146498,1,7,7,0,15,1
320062,1,0,0,0,6,1
321696,1,0,3,-3,7,1
232981,3,10,3,7,2,0
404799,3,20,13,7,10,0
356041,3,21,10,11,5,1
226426,2,0,7,-7,16,0
125485,3,16,0,16,5,1
339069,1,0,0,0,15,0
138811,2,0,33,-33,12,1
171701,4,26,23,3,9,0
284867,1,0,0,0,7,1
258701,2,0,17,-17,13,0
167012,2,0,14,-14,7,1
114252,4,10,17,-7,1,0
175950,1,0,0,0,11,0
101882,2,6,10,-4,12,0
368069,1,0,0,0,11,1
216575,4,40,11,29,12,1
355099,2,6,13,-7,4,0
97458,1,6,0,6,10,0
65540,1,3,0,3,13,0
152819,4,21,10,11,17,0
282948,2,7,3,4,6,1
287050,3,19,24,-5,8,1
328169,3,6,14,-8,10,1
299984,2,0,14,-14,14,1
65944,4,17,14,3,13,1
17227,3,7,31,-24,9,0
236011,2,10,3,7,3,1
281014,2,17,13,4,6,1
33456,4,23,20,3,16,0
372126,2,9,7,2,13,0
40946,4,16,20,-4,2,0
74686,3,7,17,-10,17,0
326361,3,17,10,7,9,1
192132,2,0,6,-6,1,1
289311,2,21,17,4,9,0
103815,2,9,0,9,13,1
259961,4,20,20,0,14,0
272111,3,17,9,8,2,1
375059,4,28,30,-2,14,1
155844,2,7,10,-3,2,0
331667,1,0,0,0,12,1
244305,1,0,0,0,7,1
366276,3,21,10,11,10,0
217063,4,23,3,20,12,1
271313,3,6,24,-18,1,1
1096,3,10,29,-19,1,1
101858,2,3,3,0,12,0
62231,1,7,7,0,12,1
307560,1,0,0,0,17,0
16513,3,20,13,7,8,0
318272,2,3,7,-4,5,1
214169,4,12,9,3,11,1
980,4,0,6,-6,1,1
204138,3,10,10,0,6,0
44858,2,0,10,-10,4,0
211333,2,10,10,0,9,1
315843,3,9,19,-10,4,0
92738,3,3,17,-14,8,1
309100,2,9,3,6,1,1
115345,5,26,23,3,1,0
312122,4,33,10,23,2,0
138725,4,28,38,-10,12,1
173009,2,14,0,14,9,1
297532,3,14,0,14,13,0
84290,2,7,24,-17,4,0
270426,3,10,7,3,1,1
373505,2,0,10,-10,13,0
350334,3,21,3,18,2,1
62867,2,3,3,0,12,1
63581,2,13,7,6,12,0
299734,3,17,6,11,14,1
324612,4,16,15,1,8,1
192814,3,0,15,-15,1,1
194158,2,3,3,0,1,0
207801,4,30,16,14,7,0
91079,4,9,0,9,7,0
27452,2,3,0,3,13,1
229865,3,13,7,6,17,0
106342,3,14,19,-5,14,1
390248,3,3,6,-3,3,1
139012,4,14,12,2,12,1
391327,4,24,3,21,4,0
278829,3,14,21,-7,5,0
174844,3,13,17,-4,10,1
376087,3,0,3,-3,14,1
297513,2,11,0,11,13,1
301770,3,0,27,-27,15,1
365427,2,7,12,-5,9,0
333276,4,6,21,-15,12,0
368124,2,7,7,0,11,1
272490,1,7,0,7,2,0
227126,2,0,7,-7,16,1
235711,3,3,17,-14,3,1
362959,3,27,9,18,8,0
290878,4,24,21,3,10,0
59753,2,6,10,-4,11,1
196105,3,16,21,-5,2,0
142930,3,3,10,-7,13,0
336289,3,17,3,14,13,1
176083,4,24,16,8,11,1
74197,2,3,0,3,17,0
121921,1,0,7,-7,4,1
301667,4,10,6,4,15,1
331030,3,39,10,29,11,0
307117,1,0,0,0,17,0
310174,3,21,10,11,2,0
54055,3,10,3,7,8,0
50743,3,14,14,0,6,1
44825,1,0,7,-7,4,1
333059,3,10,12,-2,12,0
20403,4,10,13,-3,10,0
112614,4,31,34,-3,17,1
57666,3,17,17,0,10,1
59263,4,28,58,-30,10,1
376314,1,0,0,0,14,1
3350,4,3,6,-3,2,1
413150,4,33,35,-2,14,0
100764,2,6,3,3,12,1
71177,3,19,10,9,16,1
131788,1,0,0,0,8,1
177340,1,3,0,3,11,1
139637,1,0,0,0,12,0
325253,1,0,3,-3,8,1
222744,1,3,0,3,14,0
101708,2,10,0,10,12,0
362283,4,18,24,-6,8,0
20775,1,6,0,6,10,1
17802,2,7,3,4,9,1
315912,1,0,0,0,4,0
79358,4,32,3,29,2,1
66764,2,7,6,1,14,1
399560,4,0,33,-33,7,0
327929,1,0,0,0,10,1
306449,2,3,17,-14,17,0
247729,3,7,6,1,8,0
7170,4,41,24,17,4,0
108332,1,0,7,-7,15,1
111340,1,0,7,-7,16,0
239128,2,13,10,3,4,1
334103,2,10,0,10,13,0
63851,1,3,7,-4,12,0
298984,3,9,9,0,14,0
260662,3,7,22,-15,14,1
33864,4,9,41,-32,16,1
211682,3,23,9,14,9,1
384391,1,14,0,14,1,0
396363,2,20,6,14,6,0
224502,3,15,10,5,15,0
52534,3,16,0,16,7,1
245096,2,14,3,11,7,0
99043,2,9,0,9,11,0
92671,1,0,10,-10,8,1
80997,4,20,17,3,3,0
20730,4,31,20,11,10,1
41423,1,2,0,2,2,0
356130,2,7,0,7,5,1
358185,4,20,17,3,6,1
111055,2,10,0,10,16,1
325102,1,3,0,3,8,0
67669,4,7,35,-28,14,0
123230,4,19,21,-2,4,1
218888,2,21,10,11,13,0
296917,2,13,0,13,13,1
202944,4,31,0,31,5,1
53922,3,14,13,1,8,0
355760,3,7,6,1,5,1
381252,3,17,17,0,16,1
33011,4,12,44,-32,15,1
410279,3,7,13,-6,13,0
30486,4,31,35,-4,14,0
349143,2,20,7,13,2,0
306983,1,7,0,7,17,0
415621,3,23,13,10,15,1
421298,4,19,10,9,17,1
55047,2,13,0,13,8,0
151676,4,23,41,-18,17,1
42327,2,0,9,-9,2,1
82529,4,17,27,-10,3,0
68730,4,34,7,27,15,1
134602,2,24,10,14,10,0
398282,1,3,0,3,7,0
278055,3,10,10,0,4,1
336727,2,10,10,0,14,1
178886,1,0,0,0,12,1
187848,3,7,20,-13,16,1
73748,1,3,0,3,17,0
409883,4,30,8,22,12,0
331598,3,20,23,-3,11,1
137238,3,7,13,-6,11,1
170645,1,0,0,0,8,0
161055,1,0,0,0,4,0
81711,3,17,17,0,3,0
324394,2,7,3,4,8,1
341582,4,16,17,-1,16,1
120308,4,24,13,11,3,1
167843,2,7,13,-6,7,0
193926,4,31,17,14,1,1
321089,1,0,3,-3,6,0
281693,3,31,17,14,6,1
417610,2,14,0,14,16,0
264000,4,30,7,23,15,0
347661,3,17,17,0,1,1
246411,4,26,18,8,7,0
188298,3,17,13,4,16,1
229571,3,27,6,21,17,0
276054,3,13,3,10,3,1
305946,5,21,24,-3,17,1
180641,3,17,6,11,13,1
402054,4,3,26,-23,9,1
258866,3,14,14,0,13,1
155903,4,17,13,4,2,0
291323,4,24,22,2,10,0
364425,3,35,14,21,9,1
353325,4,38,31,7,4,0
340226,3,29,31,-2,15,0
288706,3,0,7,-7,9,0
350869,2,0,7,-7,3,0
398520,4,28,16,12,7,0
35364,4,23,13,10,16,0
346454,1,0,0,0,1,1
360990,1,0,2,-2,7,0
13836,1,0,0,0,7,1
175026,4,20,28,-8,10,0
314498,3,21,0,21,3,0
73467,1,0,14,-14,17,1
372307,3,17,10,7,13,1
366772,4,34,10,24,10,0
229864,3,13,7,6,17,0
385017,4,24,16,8,1,0
258351,1,0,0,0,13,0
296204,3,16,26,-10,13,0
275909,3,13,12,1,3,0
137657,1,0,0,0,11,0
39275,3,3,13,-10,1,0
383295,4,48,17,31,17,0
37699,4,37,0,37,17,0
144326,4,29,7,22,14,1
136134,3,10,10,0,10,1
278275,1,0,0,0,4,1
371386,1,0,7,-7,12,1
102789,3,10,3,7,13,1
258572,2,13,0,13,13,0
125709,1,0,7,-7,5,0
343295,1,0,3,-3,16,0
186191,3,16,13,3,15,1
372881,2,10,0,10,13,1
129155,4,34,35,-1,7,1
228306,1,0,0,0,17,0
197248,1,0,0,0,3,1
152731,1,0,0,0,17,0
343395,4,6,34,-28,16,1
167508,2,0,3,-3,7,0
302644,2,17,6,11,15,1
124275,3,27,17,10,5,0
277314,4,0,16,-16,4,0
205648,2,14,9,5,7,0
283398,2,13,7,6,7,0
260800,2,3,12,-9,14,1
202441,2,6,10,-4,5,1
348800,1,0,7,-7,2,0
66422,1,0,0,0,14,1
115923,4,19,30,-11,1,1
16992,4,27,23,4,8,1
125967,4,16,23,-7,6,1
153192,4,20,20,0,1,1
211037,2,20,0,20,9,1
405702,2,10,0,10,10,0
233755,3,13,24,-11,2,0
307971,3,7,6,1,1,1
60015,1,0,0,0,11,0
280490,1,0,0,0,5,1
230199,4,3,32,-29,17,0
6644,2,0,10,-10,3,1
344300,4,19,13,6,17,0
344195,1,0,3,-3,17,0
94793,2,3,6,-3,9,0
258897,4,20,26,-6,13,1
384110,2,0,17,-17,1,0
99252,4,31,20,11,11,1
399407,4,37,10,27,7,1
336086,1,3,0,3,13,0
170272,2,0,12,-12,8,1
169300,1,0,0,0,8,0
19720,2,6,6,0,10,1
50345,4,13,23,-10,6,0
265546,4,17,13,4,16,0
359974,1,0,6,-6,7,0
365518,1,0,0,0,9,1
267686,3,14,24,-10,17,0
8096,4,24,19,5,4,0
264456,4,20,28,-8,15,0
89832,2,6,6,0,7,0
174792,2,13,13,0,10,0
115419,3,26,7,19,1,0
401697,2,9,14,-5,8,1
37271,4,13,21,-8,17,0
201257,1,0,0,0,5,1
267164,4,17,10,7,17,0
420841,4,17,20,-3,17,1
308932,1,0,0,0,1,0
225931,2,20,7,13,16,1
376924,1,3,3,0,15,1
164917,2,0,6,-6,6,0
167870,2,13,16,-3,7,1
143468,2,14,13,1,14,0
49148,1,3,0,3,6,1
220550,3,10,20,-10,13,0
323877,4,16,30,-14,8,0
42522,3,10,21,-11,3,1
259701,1,3,7,-4,14,1
142992,4,10,20,-10,13,1
405533,1,0,7,-7,10,0
120735,3,23,0,23,3,0
257249,4,19,23,-4,12,0
107298,2,3,0,3,15,0
70076,4,31,17,14,15,0
228845,3,6,17,-11,17,0
99479,2,3,10,-7,11,1
145770,2,10,10,0,15,0
370165,3,17,3,14,12,0
206788,1,0,0,0,7,0
135208,2,10,3,7,10,1
234632,2,20,17,3,2,0
205196,3,14,13,1,6,1
323485,2,3,10,-7,7,1
356715,3,19,16,3,5,1
307831,3,24,21,3,1,1
306575,2,0,17,-17,17,1
331440,2,6,7,-1,11,1
130200,3,3,19,-16,8,1
378306,3,9,3,6,15,0
352335,1,0,0,0,3,1
351246,4,28,17,11,3,1
233948,4,24,13,11,2,0
186419,1,3,7,-4,15,1
27116,1,0,0,0,13,0
140487,3,21,26,-5,12,1
395208,2,10,10,0,5,0
59100,4,10,23,-13,10,0
66408,4,21,30,-9,14,1
66242,4,38,3,35,13,1
196258,3,21,10,11,2,0
396328,1,0,0,0,6,1
77284,4,19,10,9,1,1
7961,4,9,27,-18,4,1
362030,1,0,7,-7,8,1
315191,2,10,10,0,4,0
24212,2,10,7,3,12,0
295353,1,3,0,3,12,0
227081,4,20,12,8,16,1
374050,4,24,10,14,13,0
92061,1,3,0,3,8,0
361609,1,0,3,-3,7,1
199218,2,10,14,-4,4,1
264029,1,7,0,7,15,0
371545,1,3,0,3,12,0
142661,4,20,13,7,13,0
252832,4,9,13,-4,11,1
92846,2,21,0,21,8,1
28567,4,33,7,26,14,1
357741,4,43,13,30,5,0
145325,3,28,12,16,14,1
164679,4,21,27,-6,5,1
118147,3,23,27,-4,2,1
101912,3,6,13,-7,12,1
121024,2,11,21,-10,3,1
89304,5,15,15,0,7,1
282378,3,10,13,-3,6,0
22123,1,3,6,-3,11,1
283443,3,20,7,13,7,0
29089,1,0,6,-6,14,0
102738,1,3,0,3,13,0
192981,4,17,17,0,1,0
75644,4,13,6,7,17,0
339059,1,0,0,0,15,0
181704,2,7,7,0,13,1
23525,4,17,17,0,11,0
317346,2,0,0,0,5,1
298648,2,3,0,3,14,1
212189,3,3,24,-21,10,1
206251,3,7,6,1,7,1
354348,2,35,3,32,4,1
300681,4,24,3,21,15,1
5001,4,24,17,7,3,1
48745,3,10,19,-9,5,0
147635,1,0,0,0,15,1
241121,3,19,10,9,5,1
249321,1,3,0,3,9,1
242995,5,34,34,0,6,1
113676,4,9,13,-4,17,1
414425,3,7,23,-16,14,1
301906,2,8,13,-5,15,1
75235,2,7,7,0,17,1
294477,2,7,10,-3,12,0
327587,3,10,15,-5,10,1
327977,2,7,0,7,10,1
257524,3,19,10,9,13,1
315645,2,3,7,-4,4,1
297161,1,0,0,0,13,0
366532,2,13,7,6,10,1
81000,4,20,17,3,3,0
192632,2,3,7,-4,1,1
55351,1,7,0,7,9,0
185266,3,24,9,15,15,0
267324,4,17,17,0,17,0
285451,3,33,8,25,8,1
27799,3,14,14,0,13,1
161683,1,7,0,7,4,0
149937,1,7,0,7,16,0
358598,3,27,9,18,6,0
325175,3,13,14,-1,8,0
189187,2,24,0,24,16,0
178982,3,12,3,9,12,1
199521,2,17,0,17,4,0
47306,2,0,7,-7,5,1
179370,2,3,6,-3,12,1
158976,3,21,29,-8,3,0
76128,1,0,0,0,1,0
106276,2,0,3,-3,14,0
119242,2,7,3,4,3,1
59931,2,3,9,-6,11,0
134366,4,29,21,8,10,0
330981,2,23,7,16,11,1
375081,1,0,0,0,14,1
10171,2,6,3,3,5,1
70506,4,30,23,7,15,1
365419,2,7,12,-5,9,0
18808,1,0,0,0,9,1
343528,4,10,10,0,16,0
97288,4,27,20,7,10,1
26049,4,13,19,-6,13,0
73669,3,13,6,7,17,1
119713,1,7,0,7,3,0
11543,3,6,10,-4,6,0
340411,4,24,13,11,15,1
204094,2,3,7,-4,6,1
293369,2,7,7,0,11,0
404956,3,6,13,-7,10,0
324300,3,18,7,11,8,1
82501,3,10,17,-7,3,0
88165,2,14,10,4,6,0
373967,2,7,0,7,13,1
273781,2,7,7,0,2,1
324929,4,23,23,0,8,1
292887,2,7,0,7,11,0
78176,3,27,3,24,2,0
250534,4,16,14,2,9,1
132326,4,31,17,14,9,1
152225,3,21,0,21,17,0
74319,1,0,0,0,17,0
334518,2,14,14,0,13,0
29705,2,10,0,10,14,0
96519,4,17,24,-7,10,0
390312,4,24,20,4,3,0
348577,3,28,17,11,2,1
330202,2,7,0,7,11,0
190581,4,20,20,0,17,0
180884,1,0,0,0,13,1
288107,3,13,7,6,9,0
262111,2,14,3,11,15,0
418114,2,14,0,14,16,0
89608,1,0,0,0,7,1
350195,3,19,0,19,2,0
318067,1,2,0,2,5,0
395559,4,28,14,14,6,1
208754,2,3,6,-3,8,0
313826,1,7,3,4,3,0
255004,1,0,9,-9,12,1
135339,2,7,10,-3,10,1
70598,2,10,10,0,15,0
319060,4,20,32,-12,5,1
193120,3,13,6,7,1,1
365410,2,7,12,-5,9,1
323274,4,7,17,-10,7,0
197866,2,11,7,4,3,0
179903,3,24,9,15,13,1
169501,2,0,28,-28,8,0
125797,3,14,23,-9,5,0
302168,1,14,0,14,15,0
331069,4,52,24,28,11,1
190392,3,7,0,7,17,0
31156,2,10,13,-3,15,1
205542,4,14,24,-10,6,0
50250,2,10,14,-4,6,1
406210,2,7,10,-3,11,1
25159,3,20,3,17,12,0
133878,2,3,6,-3,9,0
68402,4,3,21,-18,14,1
37088,3,13,17,-4,17,1
407745,3,10,0,10,11,0
21500,1,0,0,0,11,0
328019,3,17,9,8,10,1
102334,3,13,10,3,13,0
49452,5,20,20,0,6,1
169823,3,16,17,-1,8,1
355683,1,7,0,7,5,1
293745,1,7,0,7,12,0
73629,2,3,0,3,17,1
286446,3,17,3,14,8,0
260016,1,0,0,0,14,0
208645,3,6,6,0,8,1
7633,4,28,3,25,4,1
189777,2,17,6,11,17,0
27757,2,14,7,7,13,0
338964,2,13,0,13,15,0
223736,4,37,13,24,15,1
14495,3,27,16,11,7,0
398862,1,3,0,3,7,0
343237,3,16,0,16,16,0
162250,4,23,20,3,4,0
112869,2,10,3,7,17,0
82916,2,3,3,0,4,1
15476,2,9,0,9,8,1
56892,2,27,0,27,9,0
421202,1,3,0,3,17,1
13364,4,7,34,-27,7,1
405046,1,0,0,0,10,0
131144,4,27,12,15,8,1
221734,3,10,7,3,14,1
245987,1,0,0,0,7,0
301628,3,10,3,7,15,0
52794,2,0,29,-29,7,0
300499,3,23,3,20,14,0
81831,1,0,21,-21,3,0
54312,1,7,2,5,8,0
182198,3,33,7,26,13,0
141305,1,0,7,-7,13,0
356175,2,19,0,19,5,1
209110,3,9,27,-18,8,0
312815,2,7,0,7,3,1
61753,4,24,45,-21,12,1
16126,4,40,17,23,8,0
239318,4,3,17,-14,4,0
300117,1,7,3,4,14,1
69320,4,19,3,16,15,1
3778,3,20,10,10,2,1
134484,3,3,29,-26,10,0
268931,3,6,33,-27,17,0
75552,1,7,0,7,17,1
236922,2,26,0,26,3,1
60648,2,7,3,4,11,1
43321,1,14,7,7,3,0
288869,3,10,24,-14,9,0
224990,4,10,22,-12,15,1
270846,2,9,7,2,1,0
292046,3,15,12,3,11,0
19697,2,3,6,-3,10,1
348541,3,28,14,14,2,1
345230,2,7,14,-7,17,1
315351,2,10,10,0,4,1
218572,2,7,17,-10,13,0
259128,2,14,0,14,13,0
205318,2,17,0,17,6,0
291475,4,21,20,1,10,0
263627,2,17,10,7,15,0
75796,4,42,26,16,1,1
257140,5,24,24,0,12,0
65537,1,3,0,3,13,0
398536,4,28,16,12,7,1
93617,3,13,6,7,9,1
410072,1,14,7,7,13,1
347777,2,7,0,7,1,1
270910,4,19,20,-1,1,1
243879,2,16,3,13,6,0
373425,4,10,17,-7,13,1
397728,2,9,14,-5,7,0
311416,1,0,0,0,2,1
371068,3,13,20,-7,12,1
331467,3,9,15,-6,11,1
128524,3,21,28,-7,7,0
411624,3,14,28,-14,13,1
406252,3,21,24,-3,11,0
107864,1,0,0,0,15,0
49260,4,17,10,7,6,1
349947,4,18,12,6,2,0
70911,3,15,33,-18,15,1
331217,4,17,20,-3,11,0
27682,4,14,30,-16,13,1
150709,2,6,6,0,17,1
309556,2,13,0,13,1,0
8846,1,0,0,0,4,1
320260,2,14,7,7,6,0
199381,3,7,10,-3,4,0
345383,2,0,10,-10,17,1
374131,2,13,7,6,13,1
377182,4,16,17,-1,15,0
13087,4,21,14,7,6,0
317869,4,15,10,5,5,1
275062,4,34,20,14,3,0
217784,4,10,13,-3,12,1
252073,4,14,30,-16,10,1
199242,3,17,21,-4,4,0
347412,1,0,0,0,1,1
312908,4,21,21,0,3,0
186817,3,29,7,22,15,0
4986,4,24,17,7,3,0
368206,4,24,21,3,11,0
140903,3,17,10,7,13,1
96787,4,7,10,-3,10,0
152735,1,0,0,0,17,1
283141,3,6,9,-3,7,1
409789,1,7,0,7,12,1
105042,2,0,14,-14,14,0
4383,3,7,7,0,2,0
80081,4,24,21,3,2,0
12020,4,24,14,10,6,1
282655,2,6,10,-4,6,0
210438,2,9,7,2,9,0
329794,3,17,20,-3,11,1
140036,4,28,10,18,12,0
243337,4,14,30,-16,6,1
321570,2,10,6,4,7,0
252644,3,6,3,3,10,0
36989,4,0,32,-32,17,0
217785,4,10,13,-3,12,1
37498,2,7,7,0,17,0
52983,3,21,17,4,7,0
384787,1,6,0,6,1,0
121328,2,0,0,0,3,0
355352,1,0,0,0,4,1
401652,1,0,7,-7,8,0
48563,2,14,14,0,5,0
179887,3,17,9,8,13,0
275199,4,17,16,1,3,0
86204,4,34,10,24,5,1
36692,4,20,10,10,17,1
320054,1,0,0,0,6,1
272218,2,0,0,0,2,0
242118,1,13,0,13,6,0
97803,2,7,10,-3,11,1
181234,2,0,0,0,13,0
243922,3,19,6,13,6,0
69359,1,0,0,0,15,0
403734,2,9,3,6,9,1
197469,3,13,9,4,3,0
402130,2,12,0,12,9,1
79392,1,3,0,3,2,0
311847,4,20,27,-7,2,0
395617,2,7,10,-3,6,1
87503,1,6,0,6,6,1
405746,3,10,7,3,10,1
373427,4,10,17,-7,13,1
401921,1,0,0,0,9,0
84606,3,13,10,3,4,1
40178,3,20,7,13,2,0
193907,4,30,10,20,1,1
379329,3,10,13,-3,16,1
96503,4,17,24,-7,10,0
306256,1,7,0,7,17,1
420446,2,0,14,-14,17,0
132705,2,3,10,-7,9,1
414623,4,28,12,16,14,0
95787,1,3,3,0,10,0
19498,4,27,17,10,10,0
174667,2,9,6,3,10,0
341817,2,10,9,1,16,1
106862,1,6,0,6,14,1
182930,2,6,30,-24,14,1
20902,4,31,23,8,10,0
37290,1,0,0,0,17,1
346528,3,24,33,-9,1,0
18299,3,13,17,-4,9,1
47364,3,3,13,-10,5,0
217988,2,14,10,4,12,1
407082,2,0,13,-13,11,1
3817,4,23,10,13,2,0
373453,4,17,20,-3,13,1
65025,3,0,17,-17,13,0
204485,4,10,24,-14,6,1
94148,2,10,7,3,9,0
230477,4,28,14,14,1,0
280656,1,0,3,-3,5,1
360929,3,24,3,21,7,1
21281,3,3,14,-11,11,0
162140,1,0,0,0,4,1
942,2,0,3,-3,1,0
34003,4,10,27,-17,16,1
295030,4,31,24,7,12,0
391707,2,3,3,0,4,0
419942,4,19,18,1,17,0
53013,4,27,24,3,7,1
16785,3,3,17,-14,8,0
303820,4,20,17,3,16,0
131504,2,3,6,-3,8,1
98429,2,14,7,7,11,1
290461,1,7,0,7,10,0
56273,3,3,17,-14,9,1
227570,2,21,0,21,16,0
344280,3,14,13,1,17,0
62135,2,7,7,0,12,1
196998,3,20,17,3,3,1
249528,2,14,3,11,9,0
132721,3,10,17,-7,9,0
243889,2,16,6,10,6,1
30780,4,31,34,-3,15,0
91868,4,30,13,17,8,0
170417,2,14,3,11,8,1
150132,2,3,13,-10,16,1
271219,4,21,23,-2,1,1
399988,4,12,13,-1,8,0
414582,3,21,9,12,14,1
22662,4,30,17,13,11,0
193554,2,0,7,-7,1,0
421046,1,3,0,3,17,0
344313,4,19,13,6,17,1
400966,3,19,7,12,8,0
283213,1,7,0,7,7,0
341808,2,3,9,-6,16,1
181289,4,3,20,-17,13,1
354836,4,30,28,2,4,0
272888,3,20,17,3,2,1
295803,5,27,27,0,12,1
167484,2,0,0,0,7,0
216355,3,14,13,1,12,0
127638,3,24,9,15,6,0
173735,2,0,3,-3,10,1
285577,3,7,10,-3,8,1
356302,2,17,0,17,5,0
46802,4,14,33,-19,4,1
296494,3,20,3,17,13,1
336710,2,3,3,0,14,0
9948,3,3,3,0,5,1
298786,2,13,6,7,14,1
17918,1,0,7,-7,9,1
250982,3,3,6,-3,10,0
38959,2,23,3,20,1,1
416664,4,34,7,27,15,1
402385,2,0,7,-7,9,1
236438,1,0,0,0,3,1
454,1,0,0,0,1,0
328252,1,0,0,0,10,1
411498,4,13,17,-4,13,0
385347,4,17,31,-14,1,1
214167,4,12,9,3,11,1
297248,3,21,6,15,13,0
248271,1,7,0,7,8,1
205486,2,14,3,11,6,0
19987,2,6,3,3,10,1
129764,4,17,24,-7,7,0
35564,1,7,0,7,17,1
144982,1,0,0,0,14,0
410098,2,14,7,7,13,0
96463,3,10,17,-7,10,0
294534,3,17,13,4,12,1
213406,3,10,34,-24,10,1
95867,4,13,20,-7,10,0
390909,4,15,31,-16,3,1
216876,3,10,14,-4,12,1
41666,3,24,7,17,2,1
49372,3,7,17,-10,6,1
84298,3,7,27,-20,4,1
214390,2,0,7,-7,11,0
237079,2,0,26,-26,3,1
118244,2,9,7,2,2,0
95620,4,12,13,-1,10,0
288972,2,16,7,9,9,1
341528,3,6,7,-1,16,0
418886,3,13,10,3,16,0
228784,2,3,7,-4,17,0
343593,1,15,7,8,17,0
293469,1,0,3,-3,11,0
154492,4,14,10,4,1,0
296174,2,13,13,0,13,0
382786,2,14,0,14,17,0
120518,1,0,0,0,3,0
112930,4,19,6,13,17,0
106285,2,0,6,-6,14,0
255174,2,7,0,7,12,1
114389,3,34,13,21,1,0
316805,4,16,7,9,4,0
67286,1,7,0,7,14,1
225384,4,24,28,-4,15,0
275320,3,10,16,-6,3,1
416751,2,7,6,1,15,0
255846,4,17,0,17,12,1
263091,4,10,13,-3,15,0
180717,1,0,0,0,13,1
418086,1,0,0,0,16,1
194416,2,6,0,6,2,0
154416,2,7,0,7,1,0
185587,3,10,20,-10,15,0
276552,4,22,7,15,4,1
401730,4,17,14,3,8,1
287586,1,0,3,-3,9,1
120620,4,3,20,-17,3,0
205503,3,14,10,4,6,0
411192,3,0,23,-23,13,1
382489,1,0,0,0,17,1
328799,3,17,13,4,10,1
310356,4,29,0,29,2,0
8776,2,6,0,6,4,0
140545,1,0,0,0,12,1
359334,3,3,13,-10,6,1
408738,1,9,7,2,12,1
267455,1,0,0,0,17,0
194390,1,0,0,0,2,0
82155,2,10,3,7,3,1
166900,2,10,6,4,6,0
116319,3,24,13,11,1,1
307465,2,28,13,15,17,1
145248,1,7,6,1,14,0
241478,4,10,42,-32,5,1
368926,1,0,0,0,11,0
395246,3,10,13,-3,5,0
322601,2,3,3,0,7,0
377415,3,7,13,-6,15,1
390530,2,10,7,3,3,1
350860,2,0,6,-6,3,0
84454,3,6,10,-4,4,1
128391,4,13,13,0,7,1
243477,4,10,23,-13,6,0
362544,4,26,12,14,8,1
75547,1,7,0,7,17,0
416084,4,21,12,9,15,0
195502,2,0,0,0,2,1
174598,4,13,21,-8,10,1
118746,4,27,12,15,2,0
1287,4,24,16,8,1,0
4168,1,7,3,4,2,0
419153,2,10,3,7,16,0
330470,1,0,7,-7,11,1
28936,1,0,6,-6,14,0
272251,3,6,3,3,2,1
365435,2,7,19,-12,9,1
396423,3,20,18,2,6,1
239562,2,13,3,10,4,0
181909,4,21,35,-14,13,1
108698,3,27,13,14,15,1
292159,2,21,0,21,11,0
379541,1,7,3,4,16,0
183280,3,13,20,-7,14,1
228543,4,20,14,6,17,1
149097,3,14,17,-3,16,1
280848,2,10,3,7,6,1
187226,2,0,6,-6,16,1
275055,4,34,20,14,3,0
294036,2,7,7,0,12,0
148194,3,13,21,-8,16,1
303093,2,0,14,-14,16,1
396415,3,20,18,2,6,0
339030,4,20,3,17,15,0
135721,4,17,29,-12,10,1
14841,1,0,0,0,7,1
179273,3,26,3,23,12,1
5712,4,0,24,-24,3,1
379172,2,6,10,-4,16,1
347164,3,23,17,6,1,1
356925,2,3,0,3,5,0
172994,2,14,0,14,9,1
242998,5,34,34,0,6,0
242442,2,0,7,-7,6,0
416098,4,21,13,8,15,0
405267,2,14,7,7,10,1
138279,1,10,0,10,11,0
108964,2,16,14,2,15,0
242044,3,7,9,-2,5,1
385405,2,14,7,7,1,1
329140,4,27,7,20,10,1
48883,3,9,0,9,5,1
401552,2,14,14,0,8,1
304613,2,14,7,7,16,0
100304,2,6,7,-1,12,1
316155,4,24,26,-2,4,0
336640,5,7,7,0,14,1
327511,1,0,7,-7,10,1
78533,1,0,7,-7,2,1
152475,2,10,7,3,17,1
242907,3,21,13,8,6,1
323621,2,7,0,7,8,1
255920,2,3,3,0,12,1
64241,4,38,13,25,13,0
55154,4,29,17,12,8,1
140273,2,7,6,1,12,1
383345,1,0,0,0,17,0
227498,4,19,17,2,16,1
28237,3,17,0,17,13,1
317999,3,10,10,0,5,0
326670,3,16,6,10,9,0
13025,3,14,7,7,6,0
36524,3,10,20,-10,17,1
356042,3,21,10,11,5,1
174751,1,6,0,6,10,0
237877,3,7,27,-20,4,1
374368,1,7,0,7,14,0
154585,2,14,7,7,1,1
19025,3,7,6,1,10,0
92634,4,20,10,10,8,0
94912,1,0,3,-3,9,1
377594,4,20,12,8,15,1
316972,4,43,18,25,4,1
9928,3,3,3,0,5,1
163715,1,0,6,-6,5,0
398599,2,0,0,0,7,0
358338,4,3,27,-24,6,0
414052,4,10,45,-35,14,0
326887,1,0,0,0,9,0
67611,3,0,32,-32,14,1
363056,1,0,0,0,8,0
365441,3,10,19,-9,9,0
54355,2,14,19,-5,8,1
290209,2,17,0,17,10,0
298136,4,3,41,-38,13,1
355903,3,27,10,17,5,0
181241,2,0,0,0,13,0
336221,1,0,0,0,13,0
313592,3,12,23,-11,3,0
49275,4,20,17,3,6,1
140041,4,28,10,18,12,0
160412,1,0,0,0,4,1
320762,3,17,23,-6,6,1
227938,3,27,27,0,16,1
201239,4,30,24,6,5,0
403955,4,20,17,3,10,0
300266,1,0,7,-7,14,1
245820,1,0,7,-7,7,0
67083,4,10,9,1,14,1
178526,3,16,13,3,12,1
25951,1,3,3,0,13,0
360221,4,20,13,7,7,0
4802,3,27,0,27,3,0
135652,2,7,7,0,10,0
56863,2,0,0,0,9,1
41506,3,15,7,8,2,0
230239,1,6,0,6,17,0
193871,3,24,7,17,1,1
245784,4,23,20,3,7,1
157834,1,6,9,-3,3,0
150358,4,27,7,20,16,1
406194,1,7,3,4,11,0
400743,4,16,17,-1,8,1
334858,3,16,3,13,13,1
217218,4,12,22,-10,12,0
413511,1,0,0,0,14,0
134223,3,3,23,-20,10,0
63413,1,7,3,4,12,0
84218,4,17,10,7,4,0
263591,1,7,7,0,15,0
148381,4,14,6,8,16,1
268004,3,14,9,5,17,0
261246,3,28,0,28,14,1
236083,4,44,10,34,3,1
132189,1,0,0,0,9,0
325551,1,0,0,0,9,0
372712,1,0,0,0,13,0
313066,4,20,0,20,3,1
415229,1,0,0,0,15,0
308681,2,7,6,1,1,1
239288,3,3,7,-4,4,0
390058,2,7,7,0,3,1
197857,2,8,7,1,3,1
151487,3,35,7,28,17,0
172421,3,13,42,-29,9,1
158289,1,6,0,6,3,0
227786,3,3,14,-11,16,1
20534,4,3,0,3,10,1
255973,3,9,12,-3,12,1
332051,3,10,9,1,12,1
9544,4,13,20,-7,5,1
202813,1,0,0,0,5,1
416463,2,14,10,4,15,1
198997,4,19,23,-4,3,0
145141,2,23,0,23,14,1
414353,1,7,3,4,14,1
341177,2,3,0,3,16,1
262362,1,0,0,0,15,1
102800,3,10,3,7,13,0
365992,2,23,7,16,10,1
263228,4,17,20,-3,15,1
302146,4,41,48,-7,15,0
348296,4,16,46,-30,1,0
134173,2,0,10,-10,10,1
108342,1,0,7,-7,15,0
80571,4,16,10,6,3,1
281949,2,14,14,0,6,0
43569,4,24,3,21,3,1
284067,4,13,10,3,7,1
275852,1,3,0,3,3,1
212070,4,24,40,-16,9,1
155771,4,30,30,0,2,0
265839,4,20,19,1,16,0
211033,2,20,0,20,9,0
349138,2,13,7,6,2,1
364784,1,0,0,0,9,1
279769,4,30,13,17,5,1
224309,3,9,12,-3,15,0
50823,1,7,7,0,6,0
178970,3,12,3,9,12,1
405612,3,21,20,1,10,0
82548,4,17,27,-10,3,1
90204,4,6,3,3,7,1
209063,2,3,10,-7,8,0
170488,4,21,10,11,8,1
306908,3,6,23,-17,17,1
201345,3,28,13,15,5,1
306897,2,6,13,-7,17,0
152354,2,14,3,11,17,0
37245,3,13,14,-1,17,0
61519,2,7,7,0,11,0
276711,4,30,27,3,4,1
183796,2,10,21,-11,14,1
129626,4,16,23,-7,7,1
161691,1,7,0,7,4,1
150227,4,6,26,-20,16,0
142389,1,0,0,0,13,1
186930,2,7,6,1,15,0
345570,3,13,20,-7,17,1
172423,3,13,42,-29,9,0
227523,4,26,17,9,16,0
115226,2,0,3,-3,1,1
107434,1,0,3,-3,15,0
221926,3,19,16,3,14,0
416739,2,6,0,6,15,1
239884,3,13,3,10,4,1
230143,2,3,23,-20,17,0
161324,4,20,13,7,4,1
58629,4,13,17,-4,10,0
391918,4,23,27,-4,4,1
125506,4,30,7,23,5,0
266180,2,20,0,20,16,1
187749,4,16,20,-4,16,0
287420,1,0,0,0,9,1
178176,2,0,10,-10,12,0
312529,2,23,0,23,3,0
162706,4,23,24,-1,5,1
323257,4,7,10,-3,7,0
373646,1,0,9,-9,13,0
150316,3,24,7,17,16,1
133071,4,15,14,1,9,0
333244,3,6,14,-8,12,0
324322,4,31,7,24,8,1
275225,4,17,29,-12,3,1
221425,2,3,24,-21,14,0
298331,1,0,0,0,14,0
363451,4,28,35,-7,8,0
290226,3,17,3,14,10,0
92693,2,3,10,-7,8,1
134027,2,13,3,10,9,0
43401,4,21,24,-3,3,1
322170,2,0,17,-17,7,1
333747,4,21,14,7,12,1
250619,2,3,0,3,10,1
126196,2,14,6,8,6,1
138653,3,3,28,-25,12,1
223970,1,0,6,-6,15,1
14374,4,9,17,-8,7,0
351886,4,27,14,13,3,0
224415,1,0,3,-3,15,0
219267,1,0,0,0,13,1
371701,2,7,13,-6,12,0
50706,2,7,7,0,6,0
38162,1,3,0,3,1,0
253061,2,14,0,14,11,0
194451,2,9,0,9,2,0
59921,2,3,3,0,11,1
139606,4,9,14,-5,12,1
269582,4,24,31,-7,1,1
235162,4,7,10,-3,2,0
174585,4,13,14,-1,10,0
66236,4,38,3,35,13,0
332840,1,0,0,0,12,1
256075,1,0,3,-3,12,0
419577,2,13,7,6,17,1
145955,3,7,21,-14,15,1
86756,4,27,14,13,5,0
351042,2,7,13,-6,3,1
358208,1,0,0,0,6,0
256140,3,24,16,8,12,1
257979,2,0,14,-14,13,1
38504,2,10,3,7,1,0
155043,2,6,12,-6,1,1
258809,2,7,7,0,13,1
13947,4,24,20,4,7,0
341290,4,23,16,7,16,1
164501,3,17,0,17,5,0
60737,4,28,3,25,11,0
400089,3,17,15,2,8,1
3853,1,13,0,13,2,0
178621,2,3,3,0,12,0
48835,2,3,0,3,5,0
144347,1,0,0,0,14,0
242784,3,14,24,-10,6,0
13908,3,21,7,14,7,1
165266,3,17,14,3,6,0
34871,2,17,7,10,16,1
358359,1,6,7,-1,6,1
372358,4,24,17,7,13,1
247693,2,7,6,1,8,1
98245,2,7,17,-10,11,1
310841,1,0,0,0,2,0
90445,2,0,13,-13,7,1
234369,3,17,10,7,2,1
74352,2,7,3,4,17,1
213440,4,10,41,-31,10,1
150794,4,20,9,11,17,1
150567,2,3,10,-7,17,1
394633,3,17,14,3,5,1
214060,1,0,0,0,11,1
249565,3,14,13,1,9,1
76574,4,7,41,-34,1,0
318595,3,10,10,0,5,1
116017,3,13,0,13,1,0
293149,1,0,0,0,11,0
216377,3,14,16,-2,12,0
221312,4,6,32,-26,14,0
240593,2,3,7,-4,5,1
309963,2,3,3,0,2,1
32919,1,0,7,-7,15,1
42868,1,0,0,0,3,0
405247,2,7,7,0,10,1
122624,4,27,7,20,4,0
183099,3,7,3,4,14,0
54628,2,14,19,-5,8,1
199429,4,16,10,6,4,0
165776,1,0,0,0,6,1
411736,2,0,10,-10,13,1
11987,3,23,14,9,6,1
185320,4,41,30,11,15,1
224824,4,11,10,1,15,0
339397,2,0,3,-3,15,1
212466,2,10,3,7,10,0
240439,2,0,7,-7,5,1
179928,4,33,9,24,13,0
351912,1,0,7,-7,3,1
32479,1,7,3,4,15,1
385807,3,30,3,27,1,0
256421,3,9,21,-12,12,0
81187,1,0,0,0,3,1
227370,4,27,37,-10,16,0
384352,4,16,10,6,1,0
410091,2,14,7,7,13,0
190449,4,14,13,1,17,1
376831,3,21,7,14,15,0
98827,1,7,0,7,11,1
241664,1,0,0,0,5,0
310973,4,9,30,-21,2,0
215008,2,10,0,10,11,1
282319,1,7,0,7,6,0
17707,3,14,6,8,9,1
264655,5,20,20,0,16,1
295957,4,13,27,-14,12,1
170202,1,0,0,0,8,0
316516,1,0,0,0,4,1
24335,1,3,0,3,12,0
363267,3,24,7,17,8,0
154421,2,7,0,7,1,1
172552,3,7,21,-14,9,0
421109,2,20,10,10,17,1
196609,4,27,20,7,2,1
195783,2,10,7,3,2,1
128836,4,20,13,7,7,0
255818,3,17,0,17,12,0
207600,3,28,10,18,7,0
286565,2,10,21,-11,8,0
266973,3,19,10,9,17,0
62034,4,17,7,10,12,0
353788,5,26,23,3,4,1
328612,3,17,28,-11,10,0
387673,2,0,7,-7,2,0
226459,3,7,7,0,16,0
172278,4,24,13,11,9,0
96084,4,16,21,-5,10,1
349877,2,3,3,0,2,0
23297,2,3,10,-7,11,0
270520,2,0,7,-7,1,1
106891,2,9,3,6,14,0
167090,4,16,34,-18,7,1
120269,3,17,6,11,3,1
321776,3,18,9,9,7,0
169657,3,20,10,10,8,0
143900,1,0,0,0,14,0
319750,1,0,0,0,6,1
224808,4,11,10,1,15,0
41131,1,0,0,0,2,1
104897,2,3,3,0,14,0
327620,4,10,22,-12,10,0
49159,1,3,0,3,6,1
359055,4,10,13,-3,6,1
180015,2,7,20,-13,13,1
254587,2,7,14,-7,11,1
339068,1,0,0,0,15,0
222282,1,0,0,0,14,0
118550,2,17,3,14,2,1
126122,4,30,9,21,6,1
212218,4,3,24,-21,10,0
413537,2,0,10,-10,14,1
133144,2,10,10,0,9,0
143113,4,24,24,0,13,0
51620,3,21,13,8,7,0
350734,2,7,0,7,2,1
128529,3,21,28,-7,7,0
406281,4,21,35,-14,11,1
269082,3,13,16,-3,17,1
22035,3,14,17,-3,11,1
236565,4,16,9,7,3,1
236446,1,7,0,7,3,0
220814,2,7,7,0,14,0
161102,2,3,16,-13,4,1
198052,4,3,30,-27,3,1
332786,4,28,9,19,12,1
236537,3,10,9,1,3,1
50734,3,14,14,0,6,1
48962,1,0,0,0,6,1
1031,1,7,0,7,1,0
398762,2,14,17,-3,7,1
200256,2,3,7,-4,4,1
137426,3,6,21,-15,11,1
257923,1,0,0,0,13,1
219394,4,30,20,10,13,0
172253,4,20,13,7,9,1
21314,4,6,14,-8,11,0
278451,2,22,0,22,4,0
115616,4,30,9,21,1,0
418218,4,38,6,32,16,1
180265,1,3,0,3,13,0
378036,3,0,7,-7,15,1
207049,3,35,3,32,7,0
341617,1,0,0,0,16,1
25550,2,17,7,10,12,0
29920,4,23,26,-3,14,0
311787,3,10,20,-10,2,0
248060,4,34,13,21,8,0
205715,4,20,19,1,7,1
59055,3,3,10,-7,10,0
245020,4,14,27,-13,7,1
343032,2,6,0,6,16,0
381089,3,24,14,10,16,0
86894,4,9,26,-17,5,0
118105,2,6,13,-7,2,0
68222,3,10,14,-4,14,1
52189,2,6,3,3,7,1
407812,1,0,0,0,11,1
277274,3,0,13,-13,4,0
36699,4,20,10,10,17,1
311379,3,28,13,15,2,0
309029,4,0,20,-20,1,0
117939,2,7,6,1,2,1
401565,3,17,14,3,8,1
62403,2,0,10,-10,12,0
108442,4,13,28,-15,15,0
268186,4,12,17,-5,17,1
266253,4,38,19,19,16,0
317482,2,10,10,0,5,1
3612,3,20,21,-1,2,1
36370,3,13,19,-6,17,1
410783,4,22,6,16,13,0
279151,4,21,23,-2,5,0
8789,3,6,0,6,4,0
263652,3,20,10,10,15,0
177192,1,0,0,0,11,1
24139,4,24,14,10,12,0
344194,1,0,0,0,17,0
335848,2,21,7,14,13,1
142848,4,12,20,-8,13,0
281746,1,0,0,0,6,0
1168,1,0,0,0,1,0
326711,4,23,13,10,9,0
213549,3,10,14,-4,10,0
58663,1,0,0,0,10,1
113749,3,3,17,-14,17,1
91119,1,0,0,0,8,0
399554,4,0,33,-33,7,1
61073,1,0,0,0,11,0
330452,4,20,20,0,11,0
103559,4,33,0,33,13,0
101684,2,10,0,10,12,0
125068,4,3,32,-29,5,0
133441,2,14,14,0,9,1
237252,3,20,0,20,3,1
200356,4,33,14,19,4,0
203986,3,13,7,6,6,0
365433,2,7,19,-12,9,1
158969,3,14,28,-14,3,0
329578,1,7,0,7,11,1
412739,1,0,7,-7,14,1
117903,1,0,0,0,2,0
38789,2,3,10,-7,1,0
192972,3,17,17,0,1,0
164711,1,6,0,6,6,0
119486,4,14,17,-3,3,0
347764,2,7,0,7,1,1
194114,1,0,0,0,1,1
360684,1,0,0,0,7,0
188195,4,24,13,11,16,0
272518,2,7,3,4,2,0
334553,3,21,17,4,13,1
334467,4,17,13,4,13,1
102773,2,10,3,7,13,1
280084,1,7,0,7,5,0
113559,2,0,0,0,17,0
113839,1,0,0,0,17,0
103260,4,3,10,-7,13,1
401084,2,21,3,18,8,1
88250,1,0,0,0,6,1
78538,2,3,7,-4,2,0
384771,4,26,40,-14,1,0
306033,3,10,10,0,17,1
272213,2,0,0,0,2,1
96578,2,3,3,0,10,1
188752,3,0,20,-20,16,1
149131,3,17,24,-7,16,1
57260,1,0,0,0,10,0
235309,4,25,6,19,3,0
31902,2,6,7,-1,15,0
108942,1,13,7,6,15,1
193972,1,14,0,14,1,1
65086,4,6,17,-11,13,0
285340,4,27,9,18,7,1
35240,4,0,17,-17,16,1
238122,1,0,0,0,4,0
102876,1,0,7,-7,13,1
123385,4,21,27,-6,4,1
60492,2,14,7,7,11,1
161093,2,3,9,-6,4,1
396066,1,10,3,7,6,1
420826,3,10,10,0,17,0
50802,1,0,7,-7,6,1
27211,3,19,7,12,13,1
269036,2,10,6,4,17,0
94649,2,17,19,-2,9,0
328158,3,6,14,-8,10,0
136509,4,20,20,0,11,0
408566,1,7,0,7,12,1
378844,2,7,3,4,15,0
354281,1,7,0,7,4,0
369964,1,7,0,7,12,0
66582,1,0,14,-14,14,1
227422,2,7,7,0,16,0
264583,3,10,17,-7,16,0
303084,2,0,13,-13,16,0
138764,1,0,0,0,12,0
74734,4,14,17,-3,17,0
242081,4,20,16,4,5,0
98789,4,34,8,26,11,1
58743,3,10,17,-7,10,0
377485,1,0,0,0,15,1
9512,4,13,10,3,5,0
5599,1,0,0,0,3,0
365915,4,14,21,-7,9,0
770,2,0,0,0,1,0
135256,3,16,9,7,10,0
81866,2,0,24,-24,3,1
280443,3,19,24,-5,5,0
218307,2,17,14,3,12,0
154273,2,6,7,-1,1,0
165506,2,0,13,-13,6,0
414897,4,35,7,28,15,0
93117,1,0,0,0,9,0
83980,2,17,0,17,4,1
338145,1,0,0,0,14,1
287448,2,7,10,-3,9,0
120359,1,0,6,-6,3,1
92047,4,30,26,4,8,1
225829,4,24,14,10,16,0
343406,4,6,34,-28,16,1
267946,2,0,0,0,17,0
378448,3,17,0,17,15,0
330579,4,21,7,14,11,0
166860,1,0,3,-3,6,1
208246,4,13,10,3,8,0
327036,4,8,10,-2,9,0
308363,2,0,6,-6,1,1
246360,3,17,10,7,7,1
160265,1,3,0,3,4,0
232776,2,13,0,13,2,0
159408,3,13,20,-7,3,1
182387,4,24,20,4,14,0
139635,4,9,17,-8,12,1
106442,2,16,0,16,14,1
146841,3,24,0,24,15,0
280896,4,19,3,16,6,1
229294,3,24,24,0,17,0
349673,1,7,7,0,2,1
219281,1,10,0,10,13,0
290025,2,7,0,7,10,0
249949,1,0,0,0,9,1
234583,1,10,0,10,2,0
83094,3,6,21,-15,4,0
45863,2,7,3,4,4,0
59944,2,3,16,-13,11,0
328931,3,9,7,2,10,1
166930,4,13,6,7,6,1
46374,4,6,17,-11,4,0
415036,4,10,27,-17,15,0
416618,2,21,7,14,15,0
76360,3,16,3,13,1,0
125785,3,7,17,-10,5,0
199919,1,0,7,-7,4,0
164279,1,6,0,6,5,0
216725,3,27,6,21,12,0
125373,4,38,3,35,5,1
3156,3,10,9,1,2,1
238198,2,3,16,-13,4,1
53793,5,10,10,0,8,1
352058,1,3,6,-3,3,0
212464,2,10,0,10,10,0
125123,2,7,7,0,5,1
90737,2,14,7,7,7,1
193898,4,24,10,14,1,0
193643,1,0,0,0,1,1
159895,3,31,0,31,3,0
330699,3,6,3,3,11,1
21035,4,21,31,-10,10,0
195743,1,0,0,0,2,0
385234,1,0,3,-3,1,0
201160,2,6,21,-15,5,0
255490,2,10,7,3,12,1
308998,3,0,17,-17,1,1
290600,1,7,0,7,10,0
49000,2,10,7,3,6,1
412200,3,14,3,11,13,1
418268,2,6,0,6,16,1
77471,1,0,7,-7,1,1
234255,4,20,17,3,2,0
340862,1,0,0,0,15,0
239890,3,13,3,10,4,1
133739,2,0,0,0,9,0
290042,2,7,6,1,10,0
77680,3,7,17,-10,1,1
42488,2,3,12,-9,3,0
251260,3,10,24,-14,10,1
159161,4,31,7,24,3,0
412385,4,34,24,10,13,0
74036,1,0,0,0,17,1
21758,4,31,17,14,11,0
408245,4,20,3,17,12,1
148305,2,7,3,4,16,1
166216,4,35,19,16,6,1
351462,1,0,7,-7,3,1
324566,3,13,9,4,8,0
31755,2,0,17,-17,15,1
308087,2,6,13,-7,1,1
405781,4,18,21,-3,10,0
283156,3,13,9,4,7,1
391873,3,13,13,0,4,1
239721,3,10,10,0,4,0
243450,3,3,17,-14,6,0
57094,4,21,27,-6,9,1
70886,2,7,17,-10,15,1
210109,1,0,0,0,9,0
264079,2,10,20,-10,15,0
315414,4,16,30,-14,4,1
245802,1,0,0,0,7,1
348512,2,21,7,14,2,1
170588,3,34,6,28,8,0
206864,3,3,10,-7,7,0
267476,1,0,7,-7,17,1
23959,3,16,3,13,12,0
112662,1,0,0,0,17,0
20261,1,6,0,6,10,1
17820,2,10,10,0,9,1
62529,5,16,16,0,12,0
56557,2,16,14,2,9,1
18,1,0,0,0,1,0
155310,1,7,0,7,2,0
281906,1,7,0,7,6,0
42922,2,14,13,1,3,0
269231,3,3,6,-3,17,1
14962,4,17,24,-7,7,0
302681,3,17,20,-3,15,1
360972,4,37,5,32,7,1
244997,3,0,27,-27,7,1
235864,2,0,14,-14,3,1
298357,2,0,14,-14,14,1
292810,4,29,17,12,11,0
8904,2,14,0,14,4,1
5366,2,13,7,6,3,0
379251,1,0,3,-3,16,1
215761,2,29,3,26,11,0
187736,4,16,20,-4,16,0
6163,4,7,26,-19,3,0
69530,1,0,0,0,15,0
170607,3,34,9,25,8,1
97055,2,19,3,16,10,0
137322,1,0,0,0,11,0
281045,3,17,13,4,6,0
5411,4,20,16,4,3,1
64079,4,27,24,3,13,0
264695,1,7,6,1,16,0
407058,1,0,3,-3,11,1
29940,1,0,0,0,14,1
67491,3,36,7,29,14,0
162912,1,0,0,0,5,1
110675,4,23,10,13,16,0
400684,3,9,7,2,8,1
173058,3,24,6,18,9,0
191235,2,7,17,-10,17,0
288225,2,3,14,-11,9,0
71367,4,10,20,-10,16,0
417273,4,20,23,-3,16,1
377413,3,7,13,-6,15,1
232018,2,0,10,-10,1,0
180994,4,31,31,0,13,1
177337,1,3,0,3,11,1
311433,1,0,3,-3,2,1
263413,1,0,13,-13,15,1
228606,1,10,14,-4,17,0
285195,5,6,6,0,7,0
291689,2,0,3,-3,11,0
202548,1,7,6,1,5,0
148516,4,24,10,14,16,1
239231,1,0,7,-7,4,0
161785,3,24,6,18,4,1
163165,4,22,28,-6,5,1
354385,3,45,3,42,4,0
344795,2,7,7,0,17,1
251217,2,10,17,-7,10,0
8982,1,0,0,0,4,0
406373,2,10,7,3,11,1
93856,2,14,0,14,9,0
140598,2,24,7,17,12,0
173217,4,20,24,-4,9,0
80758,1,3,0,3,3,0
45448,2,21,7,14,4,0
116482,4,6,19,-13,1,1
190635,2,14,7,7,17,1
324794,1,0,0,0,8,0
357843,2,6,24,-18,6,0
355526,1,7,0,7,5,0
202953,4,31,0,31,5,0
71727,2,10,13,-3,16,0
261247,3,28,0,28,14,1
235749,4,10,27,-17,3,1
10190,2,6,3,3,5,0
249260,3,26,14,12,9,0
59989,4,3,30,-27,11,0
396858,2,17,10,7,6,1
115153,3,10,27,-17,1,1
398886,2,3,3,0,7,0
196659,2,26,0,26,3,1
158090,3,22,9,13,3,1
221360,1,0,10,-10,14,1
397550,1,6,7,-1,7,0
77469,1,0,6,-6,1,0
319867,4,23,10,13,6,1
351332,2,7,7,0,3,0
201436,1,9,0,9,5,1
405857,1,7,0,7,11,0
295029,4,31,24,7,12,0
145412,1,0,7,-7,14,0
326878,4,10,20,-10,9,0
213654,2,7,14,-7,10,1
154347,4,27,24,3,1,1
357890,4,13,34,-21,6,1
188943,4,26,13,13,16,0
57179,3,10,0,10,10,0
356020,2,21,10,11,5,0
289653,4,13,20,-7,10,0
355169,4,26,26,0,4,1
280142,3,21,0,21,5,0
120952,1,2,0,2,3,1
165062,3,10,17,-7,6,0
295237,2,14,5,9,12,1
40542,1,7,0,7,2,0
204369,1,0,3,-3,6,1
332383,4,16,20,-4,12,0
13658,4,19,17,2,7,1
221155,3,0,23,-23,14,1
299452,3,7,20,-13,14,0
27271,1,7,0,7,13,0
164567,1,0,0,0,5,1
367086,1,7,0,7,10,1
368873,3,24,3,21,11,1
237706,4,20,14,6,4,0
358591,3,20,9,11,6,1
243096,3,7,9,-2,6,0
20319,2,10,10,0,10,0
259120,2,7,0,7,13,1
13987,1,0,0,0,7,1
17613,1,0,0,0,9,1
374864,3,14,3,11,14,0
5077,2,13,0,13,3,1
325309,2,9,10,-1,8,0
300900,3,10,10,0,15,0
176554,4,19,17,2,11,1
84035,3,27,15,12,4,1
228067,3,3,3,0,17,1
94828,3,6,11,-5,9,0
110231,1,0,3,-3,16,1
101514,2,10,7,3,12,0
294816,2,28,14,14,12,0
103317,1,7,3,4,13,0
152921,2,14,14,0,1,1
385714,1,0,0,0,1,1
76112,4,13,30,-17,1,0
94230,4,24,24,0,9,0
408186,3,13,0,13,12,0
10910,2,6,7,-1,5,1
29933,1,0,0,0,14,0
239272,2,3,7,-4,4,0
129104,3,20,28,-8,7,1
40528,1,0,0,0,2,1
20533,4,3,0,3,10,1
360230,4,20,19,1,7,1
156892,1,0,3,-3,2,0
20260,1,0,0,0,10,1
59190,2,14,35,-21,10,0
260995,4,10,3,7,14,1
251388,3,27,14,13,10,1
69989,2,21,3,18,15,1
368335,4,19,19,0,11,0
91275,1,7,0,7,8,1
34497,4,48,10,38,16,0
219402,4,30,27,3,13,1
35058,3,15,10,5,16,1
114064,2,14,0,14,17,1
243427,2,3,17,-14,6,0
320613,4,31,18,13,6,1
40055,3,20,7,13,1,0
211253,4,29,26,3,9,0
338718,4,27,17,10,14,1
48168,4,10,13,-3,5,0
15884,1,0,7,-7,8,1
65723,2,7,16,-9,13,1
408549,4,10,16,-6,12,0
265423,4,14,26,-12,16,1
109927,4,23,13,10,16,0
121670,2,7,7,0,4,0
255623,2,0,7,-7,12,1
104379,4,45,38,7,13,1
68604,5,28,28,0,14,0
125697,1,0,0,0,5,0
191540,3,14,21,-7,17,1
366410,3,26,7,19,10,0
179733,2,3,10,-7,12,0
171603,2,3,3,0,9,1
153610,4,12,14,-2,1,1
413070,2,20,14,6,14,1
123645,3,7,9,-2,4,0
365965,1,13,7,6,10,0
85777,2,13,7,6,5,0
83573,3,0,17,-17,4,1
229374,1,3,0,3,17,0
169038,3,26,14,12,7,0
229499,1,3,0,3,17,0
320301,3,14,21,-7,6,0
275461,3,20,17,3,3,1
320580,3,24,0,24,6,1
212882,1,0,0,0,10,0
367780,1,0,0,0,10,1
345113,3,12,3,9,17,1
181864,2,21,14,7,13,1
64034,2,17,10,7,13,1
339824,1,7,0,7,15,1
2538,2,10,7,3,2,1
51044,3,0,20,-20,6,1
187376,2,20,7,13,16,0
54476,2,6,7,-1,8,1
224842,4,11,16,-5,15,0
389768,2,10,3,7,3,0
138684,3,6,28,-22,12,1
329452,1,0,0,0,10,1
237087,3,0,26,-26,3,0
109988,2,17,7,10,16,0
294428,4,19,12,7,12,0
418608,3,14,17,-3,16,0
159579,3,20,6,14,3,0
245121,2,17,6,11,7,0
190098,3,20,3,17,17,1
319877,4,23,10,13,6,0
188178,4,17,13,4,16,1
57816,3,19,10,9,10,0
389461,2,10,0,10,3,0
7423,2,13,3,10,4,1
1652,2,0,0,0,1,0
218182,3,17,3,14,12,0
110322,3,3,17,-14,16,1
200686,1,0,0,0,4,1
295649,1,0,0,0,12,1
130655,3,7,35,-28,8,1
165898,4,6,19,-13,6,0
156762,1,7,7,0,2,1
376851,3,21,14,7,15,1
381737,4,32,31,1,17,0
131133,4,27,9,18,8,0
154029,3,10,21,-11,1,1
142663,4,20,13,7,13,0
333507,2,13,0,13,12,0
289491,3,13,7,6,10,1
173956,4,20,19,1,10,1
14906,3,14,10,4,7,1
36954,3,0,25,-25,17,0
357766,1,0,0,0,6,0
328069,4,17,17,0,10,0
278365,3,17,21,-4,4,1
241623,4,6,30,-24,5,1
168660,1,0,0,0,7,1
234294,1,10,0,10,2,1
174614,1,3,0,3,10,0
286457,4,17,10,7,8,0
307054,3,17,0,17,17,1
301203,3,20,14,6,15,1
82197,3,16,3,13,3,1
174327,2,10,0,10,10,1
189879,1,0,7,-7,17,1
129972,1,0,3,-3,8,1
396477,4,28,32,-4,6,1
337160,2,3,0,3,14,0
123476,2,0,0,0,4,0
284764,2,26,10,16,7,0
313714,2,14,3,11,3,0
227745,2,3,14,-11,16,1
39987,2,7,7,0,1,0
305446,4,20,3,17,17,0
279543,3,10,6,4,5,0
304705,4,21,7,14,16,0
132223,1,7,0,7,9,0
418020,3,21,35,-14,16,0
105931,1,0,0,0,14,1
363256,3,24,7,17,8,1
291545,2,3,3,0,11,1
421300,4,19,10,9,17,1
338107,4,6,7,-1,14,0
60006,4,3,31,-28,11,0
212530,4,13,16,-3,10,1
94035,2,6,21,-15,9,0
276913,2,14,0,14,4,0
282777,2,0,10,-10,6,1
407096,2,0,13,-13,11,0
165829,3,6,9,-3,6,1
50767,4,21,21,0,6,1
92716,2,3,17,-14,8,1
304767,1,0,0,0,16,0
178249,4,6,13,-7,12,1
153299,3,2,10,-8,1,0
26976,1,0,0,0,13,1
45971,4,17,3,14,4,1
272547,2,13,3,10,2,0
227082,4,20,12,8,16,1
154847,1,3,0,3,1,0
410739,3,17,6,11,13,0
309707,3,16,6,10,1,1
5522,2,13,10,3,3,1
332686,1,7,0,7,12,0
45643,3,13,13,0,4,1
13684,1,0,0,0,7,0
18352,4,25,20,5,9,0
85383,4,31,10,21,5,0
11366,2,17,0,17,6,1
342958,4,37,17,20,16,0
395269,4,10,16,-6,5,1
263866,1,0,0,0,15,0
355370,1,3,3,0,4,0
75481,4,31,7,24,17,0
362675,3,3,10,-7,8,0
71739,2,16,20,-4,16,1
60580,4,30,41,-11,11,1
333344,2,10,7,3,12,1
254086,1,0,0,0,11,0
222220,3,13,10,3,14,0
303626,3,28,13,15,16,0
73024,2,0,3,-3,16,1
172902,3,27,24,3,9,0
46996,2,7,0,7,5,0
287071,4,26,24,2,8,0
267438,4,20,24,-4,17,1
214801,4,10,27,-17,11,1
408346,3,13,7,6,12,1
174628,1,3,0,3,10,0
157535,1,0,0,0,2,1
334602,4,30,31,-1,13,1
199633,1,0,0,0,4,1
265450,1,0,7,-7,16,1
333051,2,10,12,-2,12,0
126149,1,0,3,-3,6,0
77052,2,7,7,0,1,0
134884,1,7,7,0,10,1
237164,1,0,0,0,3,0
135399,3,28,17,11,10,1
245967,4,21,37,-16,7,1
26405,2,10,3,7,13,0
383129,3,23,14,9,17,0
283757,3,11,3,8,7,1
348491,2,14,0,14,2,1
92294,3,20,0,20,8,1
51453,2,10,24,-14,7,1
56650,4,26,24,2,9,1
30863,2,3,14,-11,15,0
391356,4,24,3,21,4,1
109338,4,20,3,17,15,1
332021,2,3,3,0,12,0
231540,5,33,29,4,1,0
285854,4,14,30,-16,8,1
224192,3,0,23,-23,15,1
304358,3,20,7,13,16,0
368314,4,9,19,-10,11,1
355536,1,7,0,7,5,1
364121,2,17,3,14,9,1
136603,3,15,16,-1,11,0
283345,4,10,16,-6,7,0
221415,2,3,24,-21,14,1
68935,1,0,7,-7,15,1
137281,4,7,27,-20,11,1
152215,2,20,0,20,17,1
368769,4,21,22,-1,11,0
285338,4,24,9,15,7,1
127272,1,3,7,-4,6,1
182412,1,0,0,0,14,1
107289,2,3,0,3,15,0
254667,4,31,28,3,11,0
101725,3,10,7,3,12,1
392459,1,0,3,-3,4,0
280979,1,6,3,3,6,1
277089,2,10,14,-4,4,0
194380,1,0,0,0,2,1
103845,3,19,0,19,13,1
357363,1,7,7,0,5,1
315233,3,20,10,10,4,0
175096,2,7,10,-3,10,1
366186,4,7,48,-41,10,0
184406,3,24,6,18,14,0
134531,4,3,36,-33,10,1
285666,5,27,27,0,8,0
219965,3,6,14,-8,13,0
382763,1,7,0,7,17,1
303249,1,9,0,9,16,1
245766,4,16,17,-1,7,0
390571,3,17,20,-3,3,0
115705,3,10,3,7,1,1
178537,4,16,13,3,12,0
35367,4,23,16,7,16,1
396607,4,20,10,10,6,1
175345,1,7,0,7,11,0
148836,4,16,23,-7,16,1
9777,3,2,10,-8,5,0
195344,2,3,3,0,2,1
71779,3,38,30,8,16,0
46043,2,14,14,0,4,1
236523,3,10,9,1,3,1
30105,1,3,0,3,14,0
151370,3,31,14,17,17,1
90030,4,5,21,-16,7,1
124207,1,0,7,-7,5,1
166686,1,0,0,0,6,1
58243,2,7,10,-3,10,1
212193,3,3,24,-21,10,1
336715,2,3,3,0,14,1
419412,1,3,0,3,16,0
214912,3,7,12,-5,11,1
147890,3,10,31,-21,15,1
401855,3,7,21,-14,9,1
334139,3,16,7,9,13,0
347435,1,3,13,-10,1,0
337081,4,26,0,26,14,1
242686,4,16,10,6,6,1
171780,2,19,14,5,9,1
193787,1,0,0,0,1,0
367863,3,20,17,3,10,1
5594,4,26,10,16,3,1
335992,2,13,15,-2,13,0
160051,3,13,26,-13,3,1
203590,1,0,0,0,6,0
258979,2,0,16,-16,13,1
89919,1,0,0,0,7,1
222776,2,10,7,3,14,1
214813,4,10,27,-17,11,0
396005,4,31,20,11,6,1
108719,3,37,13,24,15,1
37603,1,7,0,7,17,1
84530,1,0,0,0,4,1
387666,2,0,7,-7,2,1
281894,4,16,17,-1,6,0
164886,2,0,3,-3,6,1
53183,4,33,41,-8,7,1
17971,2,13,21,-8,9,0
7622,3,28,3,25,4,0
63633,3,13,33,-20,12,0
24619,1,0,0,0,12,1
324710,2,7,7,0,8,0
154230,4,10,23,-13,1,1
7951,4,9,27,-18,4,1
384058,4,20,30,-10,1,1
387353,1,14,0,14,2,0
19563,2,7,14,-7,10,1
414739,3,3,17,-14,14,1
70037,4,31,10,21,15,0
25331,4,42,14,28,12,0
339107,2,10,0,10,15,0
227662,4,42,7,35,16,1
410459,3,9,20,-11,13,1
184340,1,0,6,-6,14,1
340889,2,0,9,-9,15,0
218748,2,0,13,-13,13,1
383780,1,3,0,3,1,1
342261,3,13,0,13,16,1
167791,1,0,6,-6,7,1
18634,4,20,17,3,9,0
296492,3,20,3,17,13,1
45911,3,10,3,7,4,1
208667,4,6,6,0,8,0
335043,4,16,13,3,13,0
235351,1,7,0,7,3,1
269680,3,10,6,4,1,0
14671,4,33,14,19,7,0
166443,3,17,7,10,6,0
246759,2,3,3,0,8,0
164730,2,13,7,6,6,0
9866,1,0,0,0,5,0
284341,3,6,10,-4,7,1
274724,3,17,12,5,3,0
324730,3,16,7,9,8,1
230424,3,14,3,11,1,1
360358,4,7,20,-13,7,1
329572,1,6,0,6,11,1
264438,3,10,28,-18,15,0
408903,2,17,6,11,12,0
381370,2,13,0,13,16,1
69025,4,24,17,7,15,0
23717,1,0,0,0,12,0
36504,3,10,13,-3,17,1
139505,1,3,0,3,12,1
47151,2,3,0,3,5,1
370658,4,21,14,7,12,1
215565,1,0,0,0,11,1
204052,1,0,0,0,6,0
109428,3,6,10,-4,16,0
81192,1,0,0,0,3,1
408935,3,17,15,2,12,0
49689,3,14,21,-7,6,0
284672,4,14,27,-13,7,1
5169,1,0,0,0,3,0
35167,2,0,14,-14,16,1
11189,1,0,7,-7,6,1
87897,3,13,15,-2,6,0
260484,2,10,0,10,14,1
109881,3,20,0,20,16,0
22479,3,31,27,4,11,0
85058,3,31,16,15,4,1
138525,4,31,30,1,12,0
295625,1,0,0,0,12,1
306199,3,16,3,13,17,1
59342,3,0,6,-6,11,0
66768,2,10,6,4,14,1
50921,4,17,24,-7,6,0
359982,1,0,13,-13,7,1
396058,1,10,0,10,6,0
80350,2,13,6,7,2,1
264697,1,7,6,1,16,0
165418,4,6,36,-30,6,1
175749,4,40,13,27,11,0
240610,2,13,7,6,5,1
326379,4,20,10,10,9,0
356742,4,29,24,5,5,1
386277,4,14,20,-6,2,1
43860,4,24,16,8,3,0
233942,4,24,13,11,2,0
83693,2,22,17,5,4,0
84419,2,6,0,6,4,0
69832,2,14,3,11,15,1
189153,2,21,0,21,16,1
213279,4,17,27,-10,10,1
285933,3,23,7,16,8,1
161733,2,17,3,14,4,0
293342,1,7,0,7,11,0
127322,3,10,17,-7,6,1
264966,4,23,17,6,16,1
344927,2,3,7,-4,17,0
316353,1,0,0,0,4,1
415938,4,16,30,-14,15,1
138355,4,27,7,20,11,1
262024,3,24,24,0,14,0
86000,4,14,19,-5,5,0
384040,4,20,23,-3,1,0
82158,2,13,3,10,3,1
339258,2,21,0,21,15,1
299337,4,28,16,12,14,1
285600,3,19,10,9,8,1
128042,2,3,3,0,7,0
210732,2,14,0,14,9,0
143138,4,37,27,10,13,0
150370,4,30,7,23,16,1
340983,4,17,17,0,15,0
361000,1,0,2,-2,7,1
226533,1,0,0,0,16,0
141635,2,10,7,3,13,1
404222,4,12,9,3,10,1
217263,1,0,0,0,12,0
407882,2,6,10,-4,11,1
211017,2,17,0,17,9,0
366446,3,34,10,24,10,0
288778,4,10,13,-3,9,0
421848,3,0,13,-13,17,1
379348,3,10,16,-6,16,0
161759,3,24,6,18,4,1
18419,2,0,7,-7,9,1
245865,2,3,23,-20,7,1
30575,2,10,0,10,14,1
342911,3,23,17,6,16,0
234442,2,10,3,7,2,0
165612,1,0,0,0,6,0
248147,2,3,3,0,8,0
343027,2,3,0,3,16,1
144726,3,3,0,3,14,0
104433,1,0,7,-7,13,0
112729,2,10,0,10,17,0
134465,2,3,20,-17,10,1
150150,2,3,13,-10,16,1
73077,3,7,10,-3,16,0
301452,2,17,3,14,15,0
162293,1,0,0,0,4,1
178359,3,21,17,4,12,1
372962,4,25,7,18,13,1
66388,4,21,27,-6,14,0
2139,4,10,16,-6,1,1
231425,2,7,6,1,1,0
328698,1,0,0,0,10,1
277655,1,0,0,0,4,1
397796,4,24,14,10,7,0
34131,3,3,3,0,16,1
413368,1,0,13,-13,14,1
115196,1,0,0,0,1,1
18071,1,0,7,-7,9,0
140131,2,10,0,10,12,0
221202,1,0,0,0,14,0
374555,2,17,13,4,14,1
183941,2,7,3,4,14,1
362448,1,0,3,-3,8,0
154217,4,10,23,-13,1,1
234212,3,20,10,10,2,1
232053,3,0,24,-24,1,0
235964,1,7,0,7,3,0
335559,2,6,0,6,13,0
155596,4,23,17,6,2,1
30371,4,10,20,-10,14,1
28466,1,7,0,7,14,1
78680,1,10,0,10,2,0
118687,3,14,6,8,2,1
256475,4,19,24,-5,12,0
111214,2,7,3,4,16,0
264991,4,32,17,15,16,0
28499,2,24,0,24,14,0
322929,2,13,0,13,7,0
210372,4,22,17,5,9,0
104796,3,27,26,1,14,0
29333,4,21,10,11,14,1
370694,1,0,7,-7,12,1
227224,4,16,17,-1,16,0
158368,3,16,17,-1,3,0
267672,2,7,24,-17,17,0
7475,3,29,6,23,4,1
72547,4,19,24,-5,16,0
19878,3,13,21,-8,10,1
133687,4,32,35,-3,9,0
103339,2,7,17,-10,13,1
146509,2,7,7,0,15,1
13529,1,0,0,0,7,0
289097,1,0,0,0,9,1
54433,4,33,25,8,8,0
280691,2,0,3,-3,5,1
291646,4,23,20,3,11,1
129375,2,16,7,9,7,1
79439,2,9,7,2,2,0
53611,4,14,22,-8,8,0
169989,3,21,10,11,8,1
61045,4,34,19,15,11,1
389453,1,3,0,3,3,1
326385,4,20,10,10,9,1
36107,3,44,0,44,17,1
283614,3,13,20,-7,7,1
139846,3,13,17,-4,12,1
401593,4,17,17,0,8,0
60552,3,30,27,3,11,1
379655,4,26,13,13,16,0
185123,3,0,16,-16,15,1
272640,1,0,0,0,2,0
358082,1,7,0,7,6,1
417641,2,21,3,18,16,0
47529,3,30,6,24,5,0
36521,3,10,20,-10,17,1
305528,2,6,0,6,17,1
222673,3,14,24,-10,14,0
399131,4,25,36,-11,7,0
240041,3,17,20,-3,5,0
222635,2,7,7,0,14,1
164020,2,0,3,-3,5,1
247719,2,7,6,1,8,0
404971,3,6,13,-7,10,1
118763,1,7,0,7,2,0
228034,2,3,0,3,17,0
207618,3,35,10,25,7,1
28690,3,3,10,-7,14,0
26528,1,3,0,3,13,0
84540,1,0,0,0,4,1
355780,4,10,9,1,5,1
34017,4,17,27,-10,16,1
6345,1,0,3,-3,3,0
204003,4,13,7,6,6,1
115792,1,0,0,0,1,0
194722,2,0,3,-3,2,0
205281,1,3,0,3,6,1
139117,2,9,6,3,12,0
177775,4,13,17,-4,12,0
188173,4,17,10,7,16,0
329542,4,38,14,24,10,1
371832,1,7,10,-3,12,0
404571,1,0,7,-7,10,1
376718,4,6,0,6,14,0
295238,2,14,5,9,12,1
107344,3,10,6,4,15,0
405635,4,24,28,-4,10,0
418910,4,20,17,3,16,0
374486,4,32,7,25,14,0
163521,1,7,3,4,5,1
65529,1,0,0,0,13,1
161526,1,0,0,0,4,1
175166,4,35,17,18,10,1
148131,1,0,7,-7,16,1
227375,1,0,0,0,16,1
148095,4,14,10,4,15,0
115446,3,39,14,25,1,1
324162,4,3,10,-7,8,1
22692,1,3,0,3,11,0
143872,1,0,0,0,14,0
270734,3,6,3,3,1,0
34800,4,20,6,14,16,0
101158,4,19,27,-8,12,1
232855,4,16,17,-1,2,1
156348,3,24,0,24,2,0
120129,3,10,3,7,3,0
54288,1,0,2,-2,8,1
253590,3,6,10,-4,11,1
293329,1,0,0,0,11,1
140238,5,13,16,-3,12,0
59804,3,12,13,-1,11,0
191359,2,0,17,-17,17,1
277405,3,24,9,15,4,1
99942,3,10,9,1,12,1
250100,1,0,0,0,9,0
197355,4,30,10,20,3,0
166184,4,28,19,9,6,0
119111,2,7,7,0,3,1
156920,2,7,10,-3,2,0
34475,4,41,3,38,16,1
261525,2,9,0,9,14,1
298013,4,37,7,30,13,1
395254,3,10,13,-3,5,0
101152,4,19,27,-8,12,1
119544,1,7,0,7,3,1
49015,2,10,7,3,6,1
406024,1,0,3,-3,11,1
388964,4,17,27,-10,3,1
270153,4,24,19,5,1,1
107372,4,19,6,13,15,1
220788,1,0,0,0,14,1
129407,3,16,13,3,7,1
22652,4,29,10,19,11,1
23520,4,17,17,0,11,0
375904,2,14,3,11,14,0
407956,4,17,24,-7,11,1
159262,3,17,24,-7,3,1
22417,2,10,24,-14,11,1
16548,4,30,13,17,8,0
276147,1,7,0,7,3,1
381530,3,14,13,1,17,1
288646,1,0,0,0,9,0
38872,4,10,13,-3,1,0
43620,1,0,3,-3,3,1
305108,2,21,10,11,16,0
397373,4,17,24,-7,6,1
317380,3,7,3,4,5,0
349658,1,0,0,0,2,1
372678,4,21,17,4,13,0
91531,4,19,10,9,8,0
92241,2,7,0,7,8,0
250062,4,17,13,4,9,1
265946,3,0,30,-30,16,1
266842,4,17,17,0,16,1
63104,1,7,3,4,12,1
19434,2,17,14,3,10,0
321912,3,14,21,-7,7,0
74120,3,23,6,17,17,1
187706,3,16,6,10,16,0
230765,4,9,27,-18,1,0
344107,2,17,3,14,17,0
94900,1,0,0,0,9,0
262995,2,7,0,7,15,1
72542,4,16,24,-8,16,1
302925,2,13,3,10,16,0
296918,2,13,0,13,13,1
295896,3,10,14,-4,12,0
89700,3,9,17,-8,7,0
127338,3,10,20,-10,6,1
275492,3,20,17,3,3,0
196852,3,3,20,-17,3,1
18059,4,36,28,8,9,0
40146,2,13,7,6,2,0
28526,3,24,7,17,14,0
396013,4,37,20,17,6,1
193328,1,0,0,0,1,1
394937,4,7,17,-10,5,0
393335,1,7,7,0,5,1
283641,4,23,20,3,7,0
257789,1,0,0,0,13,1
279856,3,17,13,4,5,0
92182,4,10,43,-33,8,0
37080,3,13,14,-1,17,0
149745,4,48,0,48,16,1
334188,1,0,0,0,13,0
84432,2,6,7,-1,4,1
329928,2,7,10,-3,11,0
61394,2,13,3,10,11,0
97060,2,19,3,16,10,0
90215,4,6,3,3,7,1
261054,2,0,14,-14,14,1
145793,3,13,10,3,15,1
284014,2,3,0,3,7,0
380100,4,35,23,12,16,0
10435,1,0,0,0,5,1
115427,3,32,7,25,1,1
414813,1,7,0,7,15,0
55266,3,13,10,3,9,0
87926,4,19,15,4,6,1
44886,3,7,24,-17,4,1
377803,1,7,0,7,15,0
165722,4,14,7,7,6,0
198592,2,0,0,0,3,0
95544,2,6,7,-1,10,0
203691,4,14,23,-9,6,0
238745,1,0,0,0,4,1
346802,2,10,3,7,1,1
333659,2,7,0,7,12,1
14713,1,7,0,7,7,1
204350,4,3,17,-14,6,1
381494,2,14,0,14,17,0
388510,4,3,23,-20,2,1
59464,2,3,10,-7,11,0
340844,4,24,19,5,15,0
206084,2,20,3,17,7,1
45005,2,10,10,0,4,0
163269,2,6,6,0,5,1
276367,3,17,35,-18,3,1
308377,2,0,6,-6,1,0
418765,3,7,21,-14,16,1
80879,1,0,0,0,3,1
241448,4,10,35,-25,5,0
342733,2,0,7,-7,16,1
277397,3,24,9,15,4,0
74221,2,3,7,-4,17,1
109072,1,0,0,0,15,0
10104,4,41,7,34,5,1
62346,4,24,22,2,12,1
72281,4,27,33,-6,16,1
351435,4,20,16,4,3,0
72935,3,17,7,10,16,0
361723,1,0,0,0,7,0
290474,1,7,0,7,10,1
88784,3,13,10,3,6,1
287676,4,9,13,-4,9,0
352437,3,35,24,11,3,1
397973,4,10,27,-17,7,1
149134,4,17,24,-7,16,0
380070,3,35,20,15,16,0
413770,4,24,16,8,14,1
285556,2,7,10,-3,8,1
159580,3,20,6,14,3,0
389616,2,10,7,3,3,0
417789,1,7,0,7,16,0
230434,3,21,3,18,1,0
213768,1,7,0,7,10,1
278348,3,17,14,3,4,0
16101,3,33,7,26,8,1
260759,2,3,3,0,14,0
4889,2,14,6,8,3,0
89588,4,7,40,-33,7,1
420814,3,10,10,0,17,0
192969,3,17,17,0,1,0
300801,4,10,33,-23,15,1
268076,1,0,0,0,17,1
94082,4,6,31,-25,9,0
179168,4,19,16,3,12,0
337034,2,16,0,16,14,1
183797,2,10,21,-11,14,1
20927,1,7,7,0,10,1
276527,3,19,7,12,4,1
73962,3,30,0,30,17,0
243113,3,7,9,-2,6,0
301582,2,7,3,4,15,1
157208,1,7,0,7,2,0
233330,4,13,23,-10,2,1
254866,1,0,0,0,12,1
367349,1,0,0,0,10,0
98743,3,28,6,22,11,0
60060,2,7,3,4,11,1
15244,4,16,7,9,8,1
199901,4,17,24,-7,4,0
268711,1,0,0,0,17,0
278915,2,7,16,-9,5,0
91350,3,14,7,7,8,1
132349,1,0,0,0,9,0
145487,3,16,17,-1,14,0
263911,2,9,0,9,15,1
320028,4,43,36,7,6,1
224555,1,0,0,0,15,1
67394,4,30,13,17,14,1
26034,4,10,19,-9,13,0
161013,4,16,7,9,4,1
66517,3,28,24,4,14,1
122608,3,27,7,20,4,1
171277,2,0,0,0,9,0
374133,2,16,7,9,13,1
180066,4,28,20,8,13,0
14336,3,2,7,-5,7,1
98244,2,7,17,-10,11,1
332060,4,10,9,1,12,1
391749,3,10,10,0,4,0
213975,2,29,7,22,10,0
133477,3,20,17,3,9,0
50059,1,0,0,0,6,0
419579,2,13,7,6,17,1
383313,4,48,32,16,17,1
207558,2,14,0,14,7,0
247813,1,0,0,0,8,0
322941,3,13,0,13,7,0
206060,1,7,3,4,7,1
157717,2,10,3,7,2,1
127299,2,10,14,-4,6,0
320664,1,7,7,0,6,0
332678,1,0,0,0,12,1
261637,1,0,0,0,14,1
290376,3,16,10,6,10,1
339196,4,30,13,17,15,0
366883,4,3,13,-10,10,1
17429,4,17,7,10,9,1
356292,1,13,0,13,5,1
197791,4,21,20,1,3,0
30661,4,24,9,15,14,1
54566,4,27,18,9,8,1
385117,2,7,10,-3,1,1
374657,1,0,0,0,14,1
165216,2,7,7,0,6,0
251702,2,14,3,11,10,1
69654,1,0,0,0,15,0
325137,2,13,7,6,8,0
38201,2,3,7,-4,1,1
339891,3,23,0,23,15,1
112679,1,3,0,3,17,1
381229,2,14,10,4,16,0
366586,4,20,14,6,10,1
347625,2,17,10,7,1,0
25908,4,38,17,21,12,0
369579,3,14,0,14,11,0
163636,4,21,22,-1,5,0
412513,3,24,7,17,14,0
400517,2,7,3,4,8,0
419953,1,0,0,0,17,0
53342,1,3,0,3,8,0
121201,3,14,20,-6,3,1
225576,1,0,0,0,16,0
217276,2,0,7,-7,12,1
281905,1,7,0,7,6,0
167637,2,7,13,-6,7,1
334918,4,30,10,20,13,0
6469,1,0,0,0,3,0
35277,1,3,0,3,16,0
78464,4,24,0,24,2,1
158486,2,3,7,-4,3,0
90423,2,0,13,-13,7,0
16058,2,16,0,16,8,0
219018,2,14,0,14,13,1
122689,2,7,3,4,4,1
202281,2,6,0,6,5,0
191049,1,0,0,0,17,1
38748,1,0,0,0,1,0
163879,2,6,10,-4,5,1
383222,2,21,3,18,17,0
348754,4,31,17,14,2,0
334125,3,16,7,9,13,0
234341,3,17,0,17,2,0
338946,2,6,0,6,15,0
192717,1,0,0,0,1,0
386793,2,10,7,3,2,0
46835,1,7,0,7,5,0
288251,3,10,28,-18,9,1
411218,4,11,23,-12,13,1
101568,3,13,30,-17,12,0
2903,4,31,34,-3,2,0
172062,2,7,3,4,9,1
216654,2,14,6,8,12,0
402208,4,22,14,8,9,1
100454,1,0,7,-7,12,1
52551,3,16,7,9,7,1
44310,4,24,20,4,3,0
75289,3,7,23,-16,17,0
20409,4,10,16,-6,10,1
57287,1,0,0,0,10,0
143647,3,13,10,3,14,1
209466,4,24,20,4,8,0
408332,3,9,7,2,12,1
191457,4,7,34,-27,17,0
273372,4,35,7,28,2,1
236636,2,3,0,3,3,1
243888,2,16,6,10,6,1
9025,2,7,7,0,4,1
366847,2,3,3,0,10,0
407760,3,10,7,3,11,1
84271,2,7,14,-7,4,0
107043,2,17,0,17,15,0
142109,2,0,7,-7,13,0
368381,2,14,0,14,11,1
293593,1,0,0,0,12,1
94159,2,10,7,3,9,1
245916,3,6,37,-31,7,1
380595,4,21,27,-6,16,1
259320,3,13,19,-6,13,0
34305,3,20,9,11,16,1
193203,2,3,0,3,1,0
405328,4,14,12,2,10,1
274523,2,14,9,5,3,1
242137,2,13,7,6,6,0
231296,2,3,3,0,1,1
179360,1,0,6,-6,12,1
42693,4,7,13,-6,3,1
357408,3,17,17,0,5,1
190374,2,7,0,7,17,1
127328,3,10,17,-7,6,0
184092,2,9,14,-5,14,1
84316,3,14,27,-13,4,1
122535,1,7,0,7,4,1
6339,1,0,3,-3,3,1
98574,2,7,7,0,11,0
370088,4,31,23,8,12,1
359512,4,0,21,-21,6,0
182837,4,29,20,9,14,1
205970,3,6,10,-4,7,0
304586,1,0,0,0,16,1
283263,2,10,9,1,7,0
129005,4,35,13,22,7,1
180953,3,17,14,3,13,0
232338,2,6,12,-6,1,0
180238,4,22,20,2,13,1
43221,3,14,10,4,3,1
39246,2,3,3,0,1,0
171063,3,17,30,-13,8,0
308577,3,9,9,0,1,0
304538,4,10,21,-11,16,1
6896,1,0,0,0,3,1
11612,1,7,0,7,6,0
174869,4,19,17,2,10,1
360285,2,0,12,-12,7,0
91147,2,3,14,-11,8,1
316906,2,9,8,1,4,0
74293,4,10,30,-20,17,1
328410,1,0,0,0,10,1
51011,2,0,14,-14,6,0
26739,3,6,14,-8,13,1
201093,4,41,10,31,5,0
230257,2,6,10,-4,17,1
138586,1,0,0,0,12,1
219164,2,0,3,-3,13,0
373298,1,0,0,0,13,1
264807,4,17,29,-12,16,0
223651,2,6,3,3,15,1
412626,2,3,3,0,14,1
130699,4,7,45,-38,8,1
170973,1,7,0,7,8,0
232265,4,18,12,6,1,0
224009,2,14,6,8,15,0
224718,1,3,0,3,15,0
112784,4,20,10,10,17,1
32298,4,30,36,-6,15,1
245679,1,3,3,0,7,0
35601,2,7,3,4,17,1
59106,4,10,29,-19,10,1
287450,2,7,10,-3,9,0
124360,1,0,0,0,5,1
292602,2,9,16,-7,11,0
92057,1,3,0,3,8,0
152324,1,7,0,7,17,0
46947,4,20,33,-13,5,1
217884,3,17,21,-4,12,1
79138,2,0,0,0,2,0
29475,4,10,14,-4,14,1
263691,4,30,13,17,15,0
28640,1,0,0,0,14,0
195244,3,16,17,-1,2,1
96183,3,0,16,-16,10,1
378428,2,7,0,7,15,1
351889,4,27,14,13,3,1
337148,2,3,0,3,14,1
126546,3,10,6,4,6,1
178245,4,6,10,-4,12,0
284878,1,0,0,0,7,0
373709,3,13,18,-5,13,0
254596,3,7,14,-7,11,0
184351,2,7,6,1,14,0
9415,1,0,0,0,5,0
106299,2,7,6,1,14,0
306213,4,20,3,17,17,0
188429,3,3,3,0,16,0
283086,1,3,0,3,7,1
24667,2,17,0,17,12,0
419223,4,17,9,8,16,1
404352,3,20,6,14,10,0
259529,4,44,10,34,13,0
230404,2,7,0,7,1,1
79299,2,12,3,9,2,1
137660,1,0,0,0,11,0
326492,2,30,9,21,9,1
162726,4,26,24,2,5,1
223282,4,3,9,-6,15,0
78437,3,17,0,17,2,0
324387,2,7,3,4,8,0
206840,2,0,7,-7,7,1
256985,1,0,6,-6,12,0
211402,4,10,13,-3,9,1
282645,2,6,10,-4,6,1
99357,3,23,10,13,11,1
335997,3,13,18,-5,13,1
152301,1,0,0,0,17,1
324563,3,13,9,4,8,0
81750,4,31,17,14,3,0
390922,1,0,0,0,4,1
174274,1,0,0,0,10,0
197744,3,14,10,4,3,0
72660,3,13,3,10,16,0
255912,1,3,3,0,12,0
361644,2,0,21,-21,7,0
245358,1,9,0,9,7,0
296699,4,10,16,-6,13,1
273565,1,0,0,0,2,0
292090,4,25,19,6,11,1
261546,3,12,7,5,14,0
248931,3,17,3,14,9,1
112364,1,10,0,10,17,0
13689,1,0,0,0,7,0
57618,2,3,3,0,10,1
121723,3,21,21,0,4,0
232210,3,9,12,-3,1,1
325783,2,0,10,-10,9,0
198187,3,10,6,4,3,0
23712,4,12,33,-21,12,0
39113,2,13,7,6,1,0
280834,2,10,0,10,6,0
388054,4,20,9,11,2,1
117890,4,18,20,-2,2,0
33893,1,0,3,-3,16,1
132387,2,0,0,0,9,0
150454,2,27,3,24,16,0
223702,3,20,13,7,15,1
21029,4,21,31,-10,10,0
129522,1,3,7,-4,7,0
180816,4,10,20,-10,13,1
75891,2,21,7,14,1,1
184153,4,16,14,2,14,0
113505,4,3,7,-4,17,1
57349,3,14,3,11,10,0
221071,1,0,0,0,14,0
335404,1,0,3,-3,13,1
142440,2,7,10,-3,13,0
302540,4,3,13,-10,15,0
360495,4,17,6,11,7,0
392797,2,17,3,14,4,1
312035,1,7,7,0,2,1
170335,4,0,15,-15,8,0
122432,2,6,26,-20,4,1
248353,4,29,10,19,8,1
95217,1,3,0,3,10,0
144304,4,26,7,19,14,1
235548,3,10,13,-3,3,0
421343,1,3,3,0,17,0
143272,4,17,16,1,13,1
246117,1,0,0,0,7,0
21400,2,6,7,-1,11,0
288716,3,0,7,-7,9,0
272265,3,9,3,6,2,0
54035,2,3,0,3,8,1
354718,1,0,0,0,4,0
331707,2,0,13,-13,12,1
286498,1,3,0,3,8,0
30391,1,0,13,-13,14,1
224151,2,0,20,-20,15,1
365588,2,35,14,21,9,0
304772,2,0,0,0,16,1
156600,2,0,0,0,2,1
101698,2,10,0,10,12,0
361240,3,14,20,-6,7,0
236913,2,26,0,26,3,0
131317,1,0,0,0,8,0
300965,4,24,27,-3,15,1
42478,2,0,12,-12,3,1
190495,2,7,0,7,17,1
125562,1,6,7,-1,5,1
113474,3,3,7,-4,17,0
274086,3,10,0,10,3,1
35317,2,13,0,13,16,1
239098,2,7,10,-3,4,1
174306,1,10,0,10,10,0
298545,3,13,0,13,14,0
399149,1,0,3,-3,7,0
78687,1,10,0,10,2,1
190298,4,7,17,-10,17,0
257865,3,13,12,1,13,0
248719,2,3,7,-4,9,1
272247,3,6,3,3,2,0
45147,2,7,7,0,4,0
127777,2,10,21,-11,6,0
356000,2,14,7,7,5,0
154864,1,3,3,0,1,1
50290,3,13,16,-3,6,1
148523,4,24,10,14,16,0
144557,2,7,16,-9,14,0
47558,3,37,6,31,5,0
126891,4,17,6,11,6,0
134971,4,7,25,-18,10,0
188763,3,0,20,-20,16,0
16879,1,7,7,0,8,0
77346,2,7,7,0,1,0
67569,1,0,7,-7,14,1
157718,2,10,3,7,2,0
228409,4,10,20,-10,17,1
104851,1,0,3,-3,14,0
289549,1,0,6,-6,10,1
54617,2,7,6,1,8,1
414512,2,7,3,4,14,1
315616,1,0,0,0,4,1
291600,3,23,3,20,11,0
260816,3,22,12,10,14,0
57303,2,7,0,7,10,0
269620,2,3,0,3,1,0
168381,1,0,0,0,7,0
368599,4,16,6,10,11,0
356676,2,19,10,9,5,0
160003,2,3,23,-20,3,1
155054,2,6,19,-13,1,1
392579,1,0,0,0,4,1
359971,1,0,6,-6,7,0
403155,2,10,14,-4,9,1
23143,1,6,0,6,11,1
192968,3,17,17,0,1,0
262826,1,0,7,-7,15,1
308467,4,7,25,-18,1,1
341106,4,14,17,-3,15,1
287062,4,26,24,2,8,0
114836,3,13,30,-17,1,1
184103,2,15,14,1,14,1
137297,4,13,27,-14,11,1
23626,2,7,10,-3,12,0
349900,3,3,6,-3,2,0
83004,4,20,19,1,4,1
270956,1,0,7,-7,1,0
97667,3,3,3,0,11,0
51428,2,3,10,-7,7,0
17229,3,7,31,-24,9,0
164208,3,20,28,-8,5,0
169100,4,36,30,6,7,1
400573,4,13,24,-11,8,0
197169,3,27,27,0,3,1
273680,4,22,13,9,2,1
379599,3,16,13,3,16,1
312151,4,33,23,10,2,1
181519,1,3,0,3,13,0
409753,4,13,9,4,12,1
343798,2,14,3,11,17,1
16433,4,24,16,8,8,1
241533,2,3,3,0,5,0
19005,2,7,0,7,10,0
411371,4,20,10,10,13,0
292680,4,22,16,6,11,0
246604,2,7,3,4,8,1
89923,1,0,0,0,7,0
401529,2,6,14,-8,8,1
300832,4,13,33,-20,15,1
259173,3,14,19,-5,13,1
20936,1,7,7,0,10,0
313936,4,28,29,-1,3,0
403224,4,24,17,7,9,0
408938,3,17,15,2,12,0
350038,3,13,10,3,2,1
391322,3,24,3,21,4,0
269673,3,10,3,7,1,0
127228,5,16,16,0,6,0
62873,2,3,3,0,12,1
140821,1,7,0,7,13,0
354134,4,22,0,22,4,0
96402,1,0,7,-7,10,1
185774,4,25,3,22,15,0
393765,4,7,14,-7,5,1
328266,1,3,0,3,10,0
195442,4,24,10,14,2,1
382574,4,0,17,-17,17,1
217386,4,21,13,8,12,0
419584,2,20,7,13,17,0
283569,2,6,17,-11,7,0
44354,1,0,0,0,3,0
232755,2,0,0,0,2,0
61496,1,0,7,-7,11,1
33282,3,23,0,23,16,0
384769,4,19,40,-21,1,1
130974,3,10,24,-14,8,0
285384,2,10,0,10,8,0
113789,4,13,17,-4,17,0
338036,2,0,0,0,14,0
152811,4,14,10,4,17,1
39277,3,3,13,-10,1,0
247854,2,10,3,7,8,1
163400,2,0,6,-6,5,1
203999,3,13,7,6,6,1
147644,1,3,0,3,15,0
121193,2,14,19,-5,3,0
406720,4,34,0,34,11,0
359754,3,24,16,8,6,1
375568,1,0,0,0,14,0
405058,1,0,3,-3,10,0
238880,4,41,14,27,4,1
255639,2,3,7,-4,12,1
146237,3,3,16,-13,15,0
375165,3,17,10,7,14,0
142993,4,10,20,-10,13,1
148881,1,3,6,-3,16,0
259370,4,35,34,1,13,0
333274,4,6,21,-15,12,0
314539,4,24,10,14,3,1
299116,2,3,10,-7,14,1
237919,4,14,27,-13,4,1
71044,3,20,0,20,16,1
37506,3,7,7,0,17,1
175922,4,29,27,2,11,1
265644,3,6,15,-9,16,1
295508,2,7,7,0,12,1
180888,1,6,0,6,13,1
254490,4,23,13,10,11,1
361305,1,0,0,0,7,0
169279,4,23,6,17,7,0
410774,4,22,6,16,13,1
421263,3,16,7,9,17,0
97159,1,0,0,0,10,0
220956,2,7,7,0,14,1
404886,1,0,3,-3,10,1
222459,2,3,7,-4,14,1
286352,1,0,0,0,8,0
124646,1,0,0,0,5,1
25996,3,10,16,-6,13,1
365284,2,10,13,-3,9,1
315391,3,16,17,-1,4,0
88609,2,13,7,6,6,1
267091,2,3,3,0,17,0
41310,2,7,3,4,2,1
293124,4,10,30,-20,11,1
222233,4,13,24,-11,14,1
340967,4,10,17,-7,15,1
240591,2,3,7,-4,5,1
205958,2,6,3,3,7,0
349300,3,21,21,0,2,0
18356,4,25,20,5,9,1
112954,1,0,0,0,17,1
110514,4,20,13,7,16,1
15315,1,7,0,7,8,0
385158,3,14,17,-3,1,0
138170,2,7,9,-2,11,0
333159,1,0,0,0,12,0
221833,1,0,0,0,14,0
169470,1,0,7,-7,8,0
291525,1,3,0,3,11,0
311224,3,6,0,6,2,1
280429,3,16,17,-1,5,0
7586,2,14,3,11,4,1
72966,4,31,13,18,16,0
401852,3,7,21,-14,9,1
94204,3,23,14,9,9,1
236238,4,27,22,5,3,0
99088,4,23,0,23,11,1
300695,1,0,0,0,15,1
42184,1,7,0,7,2,0
131995,3,0,17,-17,8,1
231220,4,10,16,-6,1,0
184702,4,17,24,-7,15,0
166220,1,0,0,0,6,0
354470,2,21,21,0,4,0
364854,2,6,14,-8,9,0
108998,3,16,27,-11,15,0
245274,2,9,3,6,7,1
15226,3,13,7,6,8,1
238094,5,13,13,0,4,0
329534,3,38,14,24,10,0
92389,2,10,0,10,8,1
295955,4,13,27,-14,12,1
254588,2,7,14,-7,11,1
144872,2,14,7,7,14,1
218803,4,3,19,-16,13,0
330415,3,13,20,-7,11,1
227615,3,28,0,28,16,0
383053,1,10,7,3,17,1
268981,1,0,0,0,17,0
254085,1,0,0,0,11,0
402320,4,23,18,5,9,0
411437,2,7,17,-10,13,1
50239,2,7,14,-7,6,1
403467,2,17,12,5,9,1
172460,4,13,49,-36,9,1
420082,4,31,21,10,17,0
140332,3,17,20,-3,12,0
252926,2,6,0,6,11,0
139304,4,20,13,7,12,0
245774,4,16,20,-4,7,1
210013,3,7,3,4,8,0
126560,3,13,6,7,6,0
224584,2,6,7,-1,15,1
127753,2,7,14,-7,6,0
350738,2,7,0,7,2,1
334705,3,15,3,12,13,1
355100,2,6,13,-7,4,0
8037,2,10,7,3,4,1
3526,4,17,30,-13,2,0
129554,2,3,17,-14,7,1
75176,4,13,6,7,17,1
287207,4,13,20,-7,8,0
320686,1,14,17,-3,6,1
333422,4,23,13,10,12,1
410750,3,17,6,11,13,0
315848,3,9,19,-10,4,1
219300,2,10,7,3,13,1
335102,1,3,0,3,13,0
360299,2,0,13,-13,7,0
168116,2,9,2,7,7,0
36756,1,0,7,-7,17,1
282298,4,28,17,11,6,0
331015,3,39,7,32,11,0
166361,1,0,0,0,6,1
151929,3,20,17,3,17,0
180191,3,16,7,9,13,0
390177,1,0,0,0,3,0
118570,3,17,3,14,2,1
404088,4,10,49,-39,10,1
320965,1,7,0,7,6,0
113329,3,19,31,-12,17,0
96015,3,13,7,6,10,1
100241,4,17,14,3,12,0
345415,3,0,10,-10,17,0
262527,4,35,35,0,15,0
22081,5,24,24,0,11,0
34108,2,3,0,3,16,1
414058,4,10,45,-35,14,0
331979,1,0,0,0,12,0
222710,4,14,24,-10,14,1
74701,3,7,17,-10,17,1
345999,1,0,3,-3,1,1
90609,3,17,20,-3,7,1
23318,2,6,10,-4,11,1
8851,1,7,0,7,4,0
93459,3,3,28,-25,9,1
389743,1,10,0,10,3,0
244376,3,0,17,-17,7,0
299074,1,3,0,3,14,0
249772,4,35,28,7,9,1
394994,1,0,7,-7,5,1
385444,3,28,10,18,1,0
191269,3,7,17,-10,17,1
22175,3,10,15,-5,11,1
84081,4,30,32,-2,4,1
99695,4,26,3,23,11,1
349296,2,19,21,-2,2,1
385623,4,6,24,-18,1,1
44672,1,0,0,0,3,1
346046,2,3,6,-3,1,1
306111,1,0,0,0,17,1
208710,1,0,0,0,8,1
122469,3,13,26,-13,4,0
168832,2,14,0,14,7,1
221623,4,20,21,-1,14,0
408240,4,20,3,17,12,1
125240,4,31,21,10,5,0
212990,4,21,7,14,10,0
197128,2,20,20,0,3,1
242233,4,30,14,16,6,0
142359,4,7,3,4,13,0
213958,2,23,7,16,10,0
42862,1,0,0,0,3,0
205077,4,19,20,-1,6,1
101722,3,10,7,3,12,1
341908,4,37,15,22,16,1
335715,2,10,7,3,13,1
53529,2,7,6,1,8,0
260914,2,0,0,0,14,1
359446,2,0,14,-14,6,1
326241,3,10,47,-37,9,0
172416,3,13,42,-29,9,0
84048,4,30,22,8,4,0
313466,3,17,14,3,3,1
224391,1,0,0,0,15,0
145824,4,13,33,-20,15,1
366447,3,34,10,24,10,0
160324,3,3,14,-11,4,0
198799,3,3,9,-6,3,0
209083,3,3,20,-17,8,1
126688,2,7,13,-6,6,1
100941,2,10,3,7,12,1
213045,2,17,0,17,10,1
9340,3,21,7,14,5,1
412022,1,7,0,7,13,1
316301,3,10,16,-6,4,0
114625,2,3,3,0,1,1
294119,4,14,27,-13,12,1
106062,4,24,3,21,14,0
95250,2,3,10,-7,10,0
321585,2,10,6,4,7,0
303445,3,19,7,12,16,0
408876,1,7,0,7,12,0
227453,2,13,7,6,16,0
247603,4,19,23,-4,8,0
368717,3,7,16,-9,11,1
344821,2,20,10,10,17,1
17768,1,0,0,0,9,0
4105,3,23,28,-5,2,0
353063,1,7,6,1,3,0
347394,5,21,21,0,1,0
209189,2,7,7,0,8,0
146466,1,0,0,0,15,1
193448,4,23,20,3,1,1
283978,1,0,0,0,7,0
227103,1,0,0,0,16,1
384440,3,21,0,21,1,1
5483,2,3,3,0,3,0
51363,4,19,20,-1,7,1
103990,4,13,13,0,13,0
42849,4,6,37,-31,3,1
6476,1,0,0,0,3,0
29032,4,17,10,7,14,1
70283,2,7,10,-3,15,1
79234,4,23,13,10,2,1
273526,4,21,27,-6,2,0
414035,4,10,45,-35,14,0
213630,1,7,7,0,10,1
17452,1,0,0,0,9,1
243457,3,3,23,-20,6,1
362618,2,0,7,-7,8,0
376203,2,10,7,3,14,0
374337,4,28,13,15,13,1
385006,3,24,16,8,1,1
308549,2,6,9,-3,1,0
391438,3,10,17,-7,4,0
150037,4,24,6,18,16,0
355047,4,18,33,-15,4,0
104255,2,9,0,9,13,1
117853,4,9,20,-11,2,1
12472,4,13,9,4,6,0
168453,3,0,24,-24,7,0
384828,2,6,10,-4,1,0
48653,1,0,0,0,5,1
275316,3,10,8,2,3,0
265676,4,9,18,-9,16,1
57740,1,9,0,9,10,1
59621,2,14,3,11,11,0
251727,3,24,3,21,10,0
147956,1,0,0,0,15,1
252299,2,0,13,-13,10,0
93443,3,3,14,-11,9,1
79610,3,14,7,7,2,1
339103,2,10,0,10,15,0
111217,2,7,3,4,16,1
203292,1,0,17,-17,6,0
240720,1,0,0,0,5,0
69946,1,14,0,14,15,0
410069,1,7,7,0,13,1
182512,3,28,14,14,14,0
30437,2,16,22,-6,14,1
135204,2,10,3,7,10,1
71211,4,19,20,-1,16,0
280879,3,16,3,13,6,1
401806,2,7,7,0,9,1
252703,4,6,10,-4,10,0
61755,4,24,45,-21,12,1
421213,2,6,6,0,17,0
45680,4,16,13,3,4,1
241626,4,6,30,-24,5,1
374780,4,16,39,-23,14,0
215709,1,3,0,3,11,1
320560,2,24,0,24,6,1
141155,1,3,13,-10,13,0
250916,2,3,3,0,10,1
146721,4,14,32,-18,15,0
282138,4,23,8,15,6,1
314486,2,14,0,14,3,1
374852,2,7,3,4,14,1
302616,2,10,3,7,15,0
213237,3,10,16,-6,10,0
20446,1,0,0,0,10,0
367864,3,20,17,3,10,1
124368,1,0,0,0,5,1
203406,4,27,33,-6,6,0
43119,4,6,27,-21,3,0
289348,3,28,17,11,9,0
354096,3,19,0,19,4,1
151327,2,7,14,-7,17,0
316577,2,3,6,-3,4,1
359413,1,0,0,0,6,0
64788,4,31,7,24,13,1
237995,2,10,10,0,4,0
241881,3,13,13,0,5,0
398692,1,0,0,0,7,0
107506,4,3,23,-20,15,0
95478,1,0,0,0,10,1
358331,4,3,27,-24,6,0
147544,2,6,0,6,15,1
363702,3,8,10,-2,8,0
194231,4,18,17,1,1,1
31450,2,3,7,-4,15,0
269750,1,7,0,7,1,1
17344,2,14,0,14,9,1
113576,2,3,0,3,17,1
352818,2,14,0,14,3,0
415346,4,14,21,-7,15,1
352053,1,3,0,3,3,0
244557,4,25,16,9,7,0
222401,4,24,10,14,14,0
47455,1,3,0,3,5,0
347736,1,0,0,0,1,0
97089,3,31,6,25,10,0
378296,3,9,3,6,15,0
361721,1,0,0,0,7,0
256220,1,6,0,6,12,0
292633,3,22,16,6,11,0
210418,2,9,6,3,9,0
146279,4,10,30,-20,15,0
144288,3,19,7,12,14,1
78972,1,0,7,-7,2,1
205601,1,7,0,7,7,0
135071,2,17,3,14,10,0
56731,2,0,10,-10,9,0
14092,4,3,31,-28,7,0
142641,3,13,13,0,13,1
217910,4,25,28,-3,12,0
254003,2,0,6,-6,11,0
168187,4,29,12,17,7,0
308371,2,0,6,-6,1,0
162129,4,51,20,31,4,1
328401,1,0,0,0,10,0
325123,1,10,7,3,8,0
161331,4,20,19,1,4,1
177061,1,3,3,0,11,1
354034,2,13,0,13,4,1
117293,1,0,0,0,2,1
316256,2,7,16,-9,4,0
355759,3,7,6,1,5,1
76573,4,7,41,-34,1,0
354653,3,10,7,3,4,0
392827,3,17,13,4,4,1
88169,2,14,10,4,6,0
411152,2,0,20,-20,13,1
303831,4,20,17,3,16,0
202547,1,7,6,1,5,1
65342,4,6,21,-15,13,0
81239,2,7,7,0,3,1
231769,3,10,20,-10,1,1
258939,1,0,7,-7,13,0
308108,3,13,16,-3,1,0
336287,2,17,3,14,13,0
253223,2,0,7,-7,11,0
306386,1,0,3,-3,17,0
243783,4,24,17,7,6,0
141075,4,14,10,4,13,0
54481,2,7,7,0,8,0
351033,2,7,10,-3,3,0
229846,2,6,0,6,17,1
241991,2,7,0,7,5,0
98155,3,21,13,8,11,1
169868,4,27,17,10,8,0
375626,2,17,17,0,14,0
16521,3,23,13,10,8,1
391549,2,10,21,-11,4,0
177404,2,17,10,7,11,1
72721,1,0,0,0,16,1
193374,2,7,17,-10,1,1
33018,4,12,44,-32,15,0
226331,4,22,7,15,16,0
81999,2,7,0,7,3,0
220471,4,26,21,5,13,1
303036,4,23,19,4,16,0
85005,2,25,7,18,4,0
275825,4,16,3,13,3,0
319891,1,0,0,0,6,0
247376,1,3,0,3,8,1
66428,1,0,7,-7,14,1
364628,4,21,37,-16,9,0
71253,1,0,0,0,16,1
116105,1,0,0,0,1,1
350288,2,14,0,14,2,1
184555,4,42,14,28,14,0
404781,2,10,13,-3,10,1
174712,4,9,7,2,10,0
402439,3,21,12,9,9,0
400459,1,0,0,0,8,1
231968,4,14,41,-27,1,0
304915,2,7,3,4,16,0
139852,3,13,17,-4,12,1
55396,2,13,7,6,9,0
61767,1,0,0,0,12,0
183684,3,0,14,-14,14,1
226346,4,25,7,18,16,0
128550,4,21,35,-14,7,1
417040,2,10,0,10,15,1
107076,3,33,0,33,15,1
27461,2,10,0,10,13,0
373931,1,0,0,0,13,1
59180,2,14,35,-21,10,0
92493,4,25,17,8,8,0
352353,1,14,0,14,3,0
224432,2,6,10,-4,15,1
300827,4,13,33,-20,15,1
284952,3,10,14,-4,7,1
168119,2,9,2,7,7,0
189504,4,17,0,17,17,1
386428,4,23,17,6,2,0
290629,2,21,0,21,10,0
26120,2,0,13,-13,13,1
325422,1,13,0,13,8,1
84691,1,3,7,-4,4,1
140017,4,28,10,18,12,0
337784,2,23,6,17,14,1
295598,4,31,32,-1,12,0
399390,4,30,10,20,7,1
101051,1,0,3,-3,12,0
57883,1,3,3,0,10,0
25132,2,17,0,17,12,0
297774,1,7,0,7,13,0
114580,1,3,0,3,1,0
143016,1,0,0,0,13,0
399996,4,12,13,-1,8,1
175047,4,20,28,-8,10,0
134341,3,16,21,-5,10,1
14714,1,7,0,7,7,1
365830,1,0,0,0,9,1
230485,4,28,14,14,1,1
412825,3,21,27,-6,14,0
89171,1,0,0,0,7,0
306980,1,7,0,7,17,0
67112,1,0,0,0,14,1
404018,2,3,21,-18,10,1
186065,4,31,48,-17,15,1
212715,1,0,14,-14,10,1
232191,2,9,3,6,1,0
26860,2,10,3,7,13,1
288731,3,0,7,-7,9,0
154366,4,34,24,10,1,0
411791,3,0,34,-34,13,1
39653,1,0,0,0,1,0
294105,4,7,27,-20,12,1
157580,2,5,0,5,2,1
75945,4,32,7,25,1,1
300814,4,10,33,-23,15,1
245704,2,3,10,-7,7,1
35451,2,7,7,0,17,1
338146,1,0,0,0,14,1
288581,3,23,31,-8,9,1
33835,3,3,31,-28,16,0
405592,3,14,17,-3,10,0
383,3,28,10,18,1,0
376271,4,10,14,-4,14,1
243519,1,0,0,0,6,1
249487,1,6,3,3,9,1
40742,2,17,14,3,2,1
332949,4,31,3,28,12,0
224352,4,16,12,4,15,0
177982,2,7,6,1,12,1
327453,4,10,27,-17,9,1
76141,1,9,3,6,1,0
227619,3,28,0,28,16,1
185169,4,0,23,-23,15,1
388521,4,3,23,-20,2,1
336237,1,3,0,3,13,1
239380,1,3,7,-4,4,1
139359,1,7,0,7,12,1
148033,3,7,3,4,15,1
131185,1,0,0,0,8,0
355349,1,0,0,0,4,1
343579,1,12,0,12,17,1
134970,4,7,25,-18,10,0
269035,2,10,3,7,17,0
252967,3,9,10,-1,11,0
56337,4,3,33,-30,9,1
219845,3,38,0,38,13,0
398952,4,23,13,10,7,0
127683,4,36,26,10,6,1
114249,4,10,17,-7,1,0
406719,4,34,0,34,11,0
232457,2,3,0,3,1,1
377497,1,0,0,0,15,1
334150,3,16,7,9,13,1
178163,2,0,7,-7,12,0
250665,3,10,22,-12,10,0
104419,1,0,0,0,13,0
334904,4,27,10,17,13,0
178194,2,3,10,-7,12,1
361386,3,17,7,10,7,0
305543,2,6,0,6,17,0
320229,2,14,0,14,6,0
26537,1,3,3,0,13,0
265592,2,0,8,-8,16,1
139148,3,18,6,12,12,1
260665,3,10,22,-12,14,0
152837,4,21,18,3,17,0
107445,2,0,3,-3,15,0
10625,2,7,10,-3,5,0
252529,4,29,25,4,10,0
107951,3,6,6,0,15,0
112927,4,19,6,13,17,1
62025,3,17,7,10,12,0
161461,3,7,3,4,4,1
401156,4,44,13,31,8,0
27132,1,0,0,0,13,1
105357,2,16,7,9,14,0
318104,2,9,7,2,5,0
392101,1,0,0,0,4,1
198931,2,13,16,-3,3,0
311251,3,6,0,6,2,0
164228,3,27,38,-11,5,1
414648,1,0,0,0,14,0
35881,2,0,0,0,17,0
420763,2,0,3,-3,17,0
219741,1,7,0,7,13,0
102677,4,29,28,1,13,1
71757,3,24,23,1,16,0
126847,2,10,6,4,6,0
61862,3,13,23,-10,12,1
333042,2,3,12,-9,12,0
190632,2,14,7,7,17,1
114502,3,17,20,-3,1,1
310929,3,3,9,-6,2,1
187285,4,10,6,4,16,0
150719,2,6,6,0,17,0
254164,3,3,12,-9,11,1
419406,1,3,0,3,16,1
39368,1,0,0,0,1,1
294952,2,14,7,7,12,1
157948,4,16,22,-6,3,0
187074,2,10,0,10,16,0
93535,1,0,0,0,9,1
146355,2,3,3,0,15,1
357504,2,7,6,1,5,0
24579,4,10,16,-6,12,0
335929,1,0,0,0,13,0
105495,1,20,7,13,14,1
185038,1,0,3,-3,15,1
421020,4,14,35,-21,17,1
323319,1,0,0,0,7,0
99082,4,23,0,23,11,0
302504,3,3,10,-7,15,0
249654,1,3,7,-4,9,0
331589,2,17,23,-6,11,1
35791,3,3,10,-7,17,1
113057,4,16,16,0,17,1
396203,1,0,0,0,6,0
201700,4,24,20,4,5,1
217180,3,12,16,-4,12,0
168599,3,14,13,1,7,1
116179,3,14,13,1,1,0
233734,2,13,24,-11,2,1
119908,1,6,7,-1,3,0
27812,3,14,14,0,13,0
316962,4,37,18,19,4,1
119825,4,24,16,8,3,0
114244,4,10,17,-7,1,1
355150,3,26,22,4,4,0
367057,4,10,38,-28,10,0
376565,3,15,6,9,14,1
124557,2,6,7,-1,5,1
227406,1,0,7,-7,16,1
18754,3,13,10,3,9,1
348188,2,6,10,-4,1,1
67674,4,7,35,-28,14,0
322056,2,20,0,20,7,0
260575,4,30,8,22,14,0
281345,3,21,13,8,6,1
382849,3,28,3,25,17,0
264682,1,7,0,7,16,1
158647,2,14,7,7,3,0
60571,4,30,41,-11,11,1
152413,4,35,3,32,17,1
58809,4,18,36,-18,10,1
365654,4,45,35,10,9,1
278757,2,0,0,0,5,1
142209,5,11,13,-2,13,0
62582,2,6,10,-4,12,1
191985,2,7,20,-13,1,1
371514,4,24,24,0,12,1
147922,4,31,37,-6,15,0
43743,1,0,0,0,3,1
133241,4,23,20,3,9,0
335755,3,10,7,3,13,0
156054,4,20,24,-4,2,0
65399,1,0,7,-7,13,1
307798,3,17,14,3,1,0
363561,3,3,12,-9,8,0
412061,3,21,0,21,13,1
261171,1,0,0,0,14,1
296311,2,3,13,-10,13,1
270247,2,3,21,-18,1,1
337877,1,10,0,10,14,0
21462,4,12,14,-2,11,1
98413,2,14,7,7,11,0
285959,3,29,7,22,8,0
101247,3,7,7,0,12,1
160899,1,0,0,0,4,1
59081,3,3,17,-14,10,0
22098,1,0,0,0,11,1
366732,3,24,10,14,10,1
25601,4,27,10,17,12,1
43941,2,3,7,-4,3,0
253473,4,17,38,-21,11,0
364466,4,42,28,14,9,0
365069,1,0,0,0,9,1
417085,3,27,0,27,15,0
108524,2,14,14,0,15,1
271868,2,0,10,-10,2,1
108158,4,20,42,-22,15,1
40309,3,6,0,6,2,0
54370,3,14,19,-5,8,1
24374,2,9,0,9,12,1
332391,1,0,0,0,12,0
285793,3,7,17,-10,8,0
307450,2,21,10,11,17,1
254408,1,13,0,13,11,0
272457,4,31,24,7,2,1
171119,1,0,0,0,8,1
250438,1,7,0,7,9,0
104322,3,38,21,17,13,0
37242,3,10,14,-4,17,1
51616,2,14,13,1,7,1
340925,2,0,10,-10,15,1
256297,3,14,17,-3,12,1
148827,4,16,23,-7,16,1
370738,2,12,7,5,12,1
220090,2,19,3,16,13,0
128570,4,28,35,-7,7,0
99851,1,0,0,0,12,1
89138,4,23,6,17,6,1
282915,1,7,0,7,6,0
240933,2,14,6,8,5,0
129523,2,3,7,-4,7,0
40414,1,0,7,-7,2,0
412803,2,21,24,-3,14,0
213437,4,10,41,-31,10,0
393930,5,23,23,0,5,0
92774,4,12,17,-5,8,0
187369,2,20,7,13,16,0
30268,2,3,7,-4,14,0
128895,1,0,3,-3,7,0
90514,4,0,26,-26,7,1
393160,4,27,3,24,4,0
174346,2,17,0,17,10,0
216735,4,27,9,18,12,0
356360,3,24,8,16,5,1
53137,3,19,38,-19,7,1
134178,2,0,10,-10,10,0
145808,3,13,10,3,15,0
40835,1,0,0,0,2,0
51220,4,32,25,7,7,0
145028,3,13,3,10,14,0
79492,4,12,17,-5,2,1
174571,4,13,14,-1,10,0
121291,1,0,0,0,3,0
136342,4,18,14,4,11,1
14337,3,2,7,-5,7,1
352976,3,13,3,10,3,0
285131,4,3,0,3,7,0
68682,3,17,0,17,15,0
128879,1,0,0,0,7,0
128668,3,6,17,-11,7,1
148181,3,6,21,-15,16,1
150686,1,0,3,-3,17,1
118046,4,20,19,1,2,0
375044,4,28,27,1,14,1
3376,4,10,13,-3,2,0
194769,3,0,16,-16,2,1
247850,2,10,3,7,8,0
192655,3,10,7,3,1,1
154068,1,0,0,0,1,1
292938,4,10,0,10,11,0
110607,2,17,7,10,16,0
303158,4,21,28,-7,16,0
220254,2,17,9,8,13,1
51086,4,3,23,-20,6,0
5944,3,14,23,-9,3,1
223668,2,13,6,7,15,0
272751,4,15,10,5,2,1
61185,4,0,21,-21,11,1
58200,1,0,0,0,10,0
105318,1,0,0,0,14,0
375463,2,16,7,9,14,0
294366,3,16,3,13,12,0
156037,3,20,17,3,2,0
258133,3,13,13,0,13,1
386683,3,17,13,4,2,1
22249,1,0,0,0,11,0
390055,2,7,0,7,3,0
257495,2,9,3,6,13,0
247142,3,20,6,14,8,0
96590,2,3,3,0,10,1
322180,2,0,17,-17,7,0
336959,4,21,21,0,14,0
51988,1,0,7,-7,7,1
63433,2,14,10,4,12,1
287037,3,19,24,-5,8,0
252659,3,6,3,3,10,0
152070,3,3,7,-4,17,1
367125,2,21,13,8,10,1
163965,4,26,20,6,5,1
413277,3,17,0,17,14,1
379776,3,9,17,-8,16,0
385375,1,0,7,-7,1,1
263852,4,14,24,-10,15,0
347817,3,10,0,10,1,1
194974,4,14,22,-8,2,0
32267,4,24,14,10,15,0
182422,1,7,0,7,14,0
305897,4,14,14,0,17,0
161809,4,30,13,17,4,1
79667,5,24,24,0,2,1
39202,1,0,0,0,1,0
199665,2,7,7,0,4,1
421710,3,17,10,7,17,0
418627,3,21,31,-10,16,1
173804,3,17,3,14,10,0
62307,3,21,19,2,12,0
339713,2,13,6,7,15,1
182856,4,36,20,16,14,0
87669,2,0,14,-14,6,1
375271,1,0,0,0,14,0
158848,4,23,3,20,3,0
186658,3,24,3,21,15,1
69735,3,16,7,9,15,1
253802,1,0,0,0,11,1
270465,4,10,7,3,1,1
354805,3,13,28,-15,4,1
328049,4,17,17,0,10,0
210565,2,6,7,-1,9,1
303295,2,20,0,20,16,1
52791,2,0,23,-23,7,0
11505,2,6,7,-1,6,0
228069,3,3,3,0,17,1
166722,2,7,3,4,6,1
120761,4,23,6,17,3,1
352350,1,7,0,7,3,1
43772,1,14,0,14,3,0
30793,4,31,35,-4,15,0
232999,3,10,10,0,2,1
397818,1,0,0,0,7,1
47450,1,3,0,3,5,1
267427,4,17,17,0,17,0
45821,4,16,14,2,4,0
223297,4,6,12,-6,15,1
394251,4,53,32,21,5,0
148992,4,13,12,1,16,1
419311,2,0,17,-17,16,1
45744,2,10,7,3,4,0
165650,2,0,7,-7,6,1
135394,3,28,17,11,10,0
326312,1,0,10,-10,9,0
325776,2,0,10,-10,9,1
14185,3,0,24,-24,7,0
187093,3,10,0,10,16,1
387204,1,0,7,-7,2,1
119920,1,6,14,-8,3,0
269961,3,16,13,3,1,1
418655,4,28,31,-3,16,0
60126,4,27,19,8,11,0
158191,2,10,0,10,3,1
85065,4,31,16,15,4,1
245406,2,9,3,6,7,0
36863,4,24,42,-18,17,1
119580,2,10,0,10,3,0
151997,1,0,0,0,17,0
398771,3,14,17,-3,7,0
338106,4,6,7,-1,14,1
199539,2,20,3,17,4,0
213318,1,3,3,0,10,1
200052,4,24,20,4,4,0
312132,4,33,16,17,2,1
220964,2,7,7,0,14,1
168707,2,10,3,7,7,1
215461,2,7,3,4,11,1
225221,3,3,7,-4,15,1
413721,3,21,13,8,14,0
133881,2,3,6,-3,9,0
226048,1,0,0,0,16,1
86115,2,28,3,25,5,0
229636,4,46,13,33,17,0
330293,4,31,21,10,11,1
86680,2,10,0,10,5,0
248894,2,14,0,14,9,1
29815,1,3,3,0,14,1
247690,2,7,6,1,8,1
387098,2,10,21,-11,2,1
305830,2,0,14,-14,17,1
208528,4,44,15,29,8,1
346667,2,14,6,8,1,0
31059,3,10,13,-3,15,1
311162,1,3,0,3,2,0
412156,2,7,3,4,13,0
90852,1,21,0,21,7,0
247440,3,13,9,4,8,0
73834,4,13,0,13,17,0
136022,3,6,10,-4,10,0
216865,3,10,14,-4,12,0
67638,3,7,35,-28,14,0
9998,4,3,6,-3,5,1
307772,2,17,7,10,1,0
390751,4,13,20,-7,3,0
235448,4,28,25,3,3,0
195412,4,24,3,21,2,1
327948,1,0,0,0,10,0
115412,2,23,7,16,1,1
279015,4,13,33,-20,5,0
41334,2,14,9,5,2,0
376515,2,6,3,3,14,0
384852,2,6,12,-6,1,1
328083,1,0,0,0,10,1
25725,3,14,10,4,12,1
255260,4,13,17,-4,12,0
114639,2,3,3,0,1,0
291098,2,12,13,-1,10,1
210710,1,14,0,14,9,0
150613,3,3,16,-13,17,0
57149,2,6,0,6,10,1
68880,4,6,20,-14,15,0
414276,3,21,21,0,14,0
176342,3,16,14,2,11,1
55357,1,7,0,7,9,0
116640,4,23,3,20,2,1
130298,1,7,0,7,8,0
61449,4,16,17,-1,11,0
274419,3,10,17,-7,3,0
134615,3,24,17,7,10,1
239038,4,36,21,15,4,0
37947,3,10,14,-4,1,1
54392,3,24,19,5,8,1
136437,2,10,7,3,11,1
201666,3,10,19,-9,5,0
123277,1,7,0,7,4,0
317971,3,10,10,0,5,0
324392,2,7,3,4,8,1
356318,2,17,0,17,5,0
135948,1,0,3,-3,10,0
143066,2,3,14,-11,13,1
256706,2,0,3,-3,12,0
392930,2,6,3,3,4,0
110265,2,0,10,-10,16,0
394842,1,0,7,-7,5,0
27193,3,16,7,9,13,1
28766,1,0,0,0,14,0
284895,1,0,7,-7,7,0
266138,4,17,13,4,16,0
311265,4,6,3,3,2,1
44374,1,0,0,0,3,1
314526,4,24,7,17,3,1
221327,4,6,35,-29,14,1
290527,3,14,20,-6,10,1
2407,3,21,13,8,2,1
79787,4,20,14,6,2,1
239874,3,13,3,10,4,0
293256,3,23,7,16,11,1
313426,2,13,7,6,3,1
189200,3,24,3,21,16,1
207921,4,28,14,14,8,1
310904,2,3,3,0,2,0
201860,4,28,30,-2,5,1
409154,4,3,17,-14,12,1
251799,1,0,0,0,10,0
355048,4,18,33,-15,4,0
103063,2,21,7,14,13,1
333825,3,14,21,-7,12,1
92909,4,34,7,27,8,0
115100,2,3,13,-10,1,0
301618,2,10,3,7,15,1
119612,3,10,9,1,3,1
71103,1,0,0,0,16,1
383626,1,0,7,-7,17,0
272954,1,3,0,3,2,1
248714,1,3,0,3,9,0
341810,2,3,9,-6,16,1
393063,2,0,3,-3,4,0
415522,1,0,0,0,15,1
418325,3,9,21,-12,16,0
319034,3,7,23,-16,5,1
251639,1,3,0,3,10,0
24438,4,16,7,9,12,0
6760,1,0,0,0,3,0
23725,1,0,0,0,12,1
293315,1,0,0,0,11,0
108758,1,0,0,0,15,0
262686,1,6,0,6,15,1
45000,2,10,3,7,4,0
126617,4,23,23,0,6,0
255049,2,3,18,-15,12,0
49310,1,7,3,4,6,0
145318,3,28,12,16,14,0
299362,1,0,7,-7,14,1
308841,3,10,10,0,1,1
180473,2,14,13,1,13,0
294027,2,7,7,0,12,1
139446,3,24,10,14,12,1
17219,3,7,31,-24,9,1
16495,2,13,7,6,8,0
342819,1,7,0,7,16,0
126400,4,20,17,3,6,0
55975,3,10,20,-10,9,1
393475,4,34,27,7,5,0
302182,1,20,0,20,15,1
227546,1,0,0,0,16,1
49530,3,7,3,4,6,0
48627,4,21,27,-6,5,1
370402,1,7,0,7,12,0
286556,2,10,21,-11,8,1
394127,1,7,7,0,5,0
276675,3,23,6,17,4,0
22551,1,3,3,0,11,1
320704,2,14,17,-3,6,0
245299,3,9,3,6,7,1
250059,4,17,13,4,9,1
255387,3,24,6,18,12,1
260685,4,10,25,-15,14,1
354063,2,13,0,13,4,1
279690,2,23,3,20,5,0
397584,2,6,20,-14,7,0
397133,2,3,0,3,6,0
178625,2,3,3,0,12,0
227685,1,0,0,0,16,1
389331,2,14,6,8,3,1
187900,4,7,23,-16,16,1
179870,2,10,9,1,13,0
271260,2,6,0,6,1,0
224182,3,0,20,-20,15,0
57437,1,7,0,7,10,0
331060,4,52,17,35,11,0
330256,3,17,21,-4,11,1
259743,2,10,10,0,14,1
116481,4,6,19,-13,1,1
293820,3,17,6,11,12,0
258010,3,0,28,-28,13,0
186298,2,16,3,13,15,1
254572,2,7,7,0,11,0
163956,4,26,13,13,5,0
115442,3,39,14,25,1,1
358211,1,0,0,0,6,0
407240,2,0,9,-9,11,0
4362,3,7,7,0,2,1
390642,1,0,3,-3,3,1
193297,4,10,23,-13,1,0
381113,4,24,28,-4,16,0
84822,1,0,0,0,4,1
26791,4,13,40,-27,13,1
131798,1,7,0,7,8,0
399831,4,11,27,-16,8,1
27432,1,3,0,3,13,1
265514,3,14,10,4,16,0
265684,4,12,18,-6,16,0
73900,1,13,0,13,17,1
39575,3,14,6,8,1,0
145795,3,13,10,3,15,0
200785,4,31,10,21,4,1
193340,1,7,0,7,1,0
62180,4,10,17,-7,12,1
258185,4,13,13,0,13,1
297340,2,3,10,-7,13,0
367471,4,36,24,12,10,0
300888,2,10,7,3,15,0
20994,3,14,24,-10,10,0
310221,4,24,10,14,2,0
54604,1,7,6,1,8,0
357488,1,0,3,-3,5,0
177675,2,10,7,3,12,0
64124,1,0,0,0,13,1
13378,4,7,34,-27,7,1
59523,4,13,20,-7,11,1
330399,3,10,20,-10,11,1
240722,1,0,0,0,5,0
188695,2,0,17,-17,16,1
76262,4,12,27,-15,1,1
264633,4,20,17,3,16,0
39369,1,0,0,0,1,0
82770,2,6,6,0,3,1
253023,1,0,0,0,11,0
260936,2,0,0,0,14,1
98769,3,34,6,28,11,0
184444,4,31,13,18,14,1
341201,2,10,7,3,16,1
245469,4,23,6,17,7,0
367397,2,10,14,-4,10,1
37874,1,0,0,0,1,0
235532,2,3,13,-10,3,1
98754,3,34,6,28,11,0
163180,4,30,28,2,5,0
166338,4,20,9,11,6,0
359125,2,7,0,7,6,0
188586,3,10,13,-3,16,0
348150,4,24,22,2,1,1
254383,1,0,0,0,11,1
374304,3,14,13,1,13,0
107424,1,0,3,-3,15,1
237377,3,12,14,-2,3,0
254128,2,3,9,-6,11,1
15924,2,6,7,-1,8,1
28883,4,23,10,13,14,0
346989,3,7,3,4,1,0
21084,1,0,0,0,10,1
186162,2,16,6,10,15,1
295232,2,14,5,9,12,1
126998,3,17,10,7,6,0
378717,2,14,7,7,15,0
260459,1,7,0,7,14,1
18237,1,0,14,-14,9,1
203190,3,7,17,-10,5,1
390908,4,15,31,-16,3,1
124167,4,22,21,1,5,0
276594,1,7,3,4,4,0
242834,1,0,0,0,6,1
383594,4,24,24,0,17,0
138143,1,7,9,-2,11,0
164691,4,28,27,1,5,0
150809,4,20,9,11,17,1
262428,2,7,7,0,15,1
185440,4,17,10,7,15,0
380988,4,9,14,-5,16,0
33116,3,10,21,-11,16,0
353455,4,25,12,13,4,0
181611,4,23,6,17,13,0
113907,3,10,3,7,17,1
247500,1,0,0,0,8,1
22946,4,3,26,-23,11,0
185130,3,0,16,-16,15,0
399648,3,13,6,7,8,1
83620,4,10,17,-7,4,0
220334,1,0,0,0,13,1
95694,3,10,6,4,10,0
339745,3,21,6,15,15,0
338322,1,3,0,3,14,0
408354,3,19,7,12,12,1
270366,1,0,0,0,1,1
129268,4,17,13,4,7,0
160345,3,3,21,-18,4,1
96808,4,7,17,-10,10,0
356535,4,9,6,3,5,1
221117,2,0,6,-6,14,1
96648,4,3,10,-7,10,0
191282,4,10,17,-7,17,1
110256,1,0,3,-3,16,0
276256,4,31,17,14,3,0
209564,3,41,20,21,8,0
152175,1,7,0,7,17,0
343595,1,15,7,8,17,0
375532,4,33,14,19,14,0
95775,1,3,0,3,10,0
272811,1,20,0,20,2,1
64740,3,21,0,21,13,1
388084,1,0,0,0,2,1
356339,2,24,0,24,5,0
68386,3,3,14,-11,14,0
320566,2,24,0,24,6,0
387123,3,10,24,-14,2,0
416683,4,37,7,30,15,0
42517,3,10,21,-11,3,1
7011,4,13,7,6,3,1
313825,1,7,0,7,3,0
350321,2,21,3,18,2,0
150473,3,27,6,21,16,1
34626,4,24,10,14,16,1
5697,4,0,24,-24,3,1
196667,2,27,0,27,3,1
357568,3,13,13,0,5,0
286291,3,16,16,0,8,0
130812,3,13,12,1,8,0
142210,5,11,13,-2,13,0
207522,1,0,0,0,7,1
320888,3,3,14,-11,6,0
57186,3,13,0,13,10,0
194572,2,14,0,14,2,0
196907,4,10,22,-12,3,1
330896,4,16,24,-8,11,0
330570,4,14,7,7,11,0
17937,1,7,14,-7,9,1
231651,3,14,13,1,1,1
408447,2,0,0,0,12,0
183499,1,0,0,0,14,1
408042,3,10,10,0,12,1
74962,2,17,10,7,17,0
389327,2,14,6,8,3,0
204933,4,13,19,-6,6,0
371229,4,22,19,3,12,0
191333,1,0,6,-6,17,0
242449,2,0,7,-7,6,1
326240,3,10,41,-31,9,0
308330,1,0,0,0,1,0
145646,3,28,7,21,14,0
37333,2,7,0,7,17,1
14604,2,9,7,2,7,1
26993,1,10,0,10,13,1
108907,5,17,17,0,15,0
338552,4,20,31,-11,14,1
172815,1,0,0,0,9,0
345018,4,22,23,-1,17,1
37429,4,24,0,24,17,1
286527,2,3,14,-11,8,1
271309,3,6,24,-18,1,1
49004,2,10,7,3,6,1
115376,1,7,0,7,1,1
102308,2,10,10,0,13,1
308611,4,15,16,-1,1,1
309654,1,0,3,-3,1,1
19513,4,39,17,22,10,0
238041,4,10,13,-3,4,1
185151,4,0,23,-23,15,1
281161,2,14,13,1,6,1
14673,4,33,14,19,7,0
118527,2,17,0,17,2,0
51664,4,27,20,7,7,1
380277,4,29,16,13,16,0
205329,2,20,0,20,6,0
345812,1,0,7,-7,17,0
131774,1,0,0,0,8,1
98200,4,35,26,9,11,0
54860,4,23,3,20,8,1
418404,2,14,0,14,16,0
415491,4,23,3,20,15,1
39936,4,9,10,-1,1,1
128329,2,0,3,-3,7,0
219132,1,0,3,-3,13,0
31157,2,16,13,3,15,1
86024,4,22,22,0,5,1
232244,4,15,12,3,1,1
406979,3,3,20,-17,11,1
27431,1,3,0,3,13,1
262492,4,14,35,-21,15,1
129913,4,13,0,13,7,1
293999,1,0,0,0,12,1
287252,4,23,23,0,8,1
57958,4,13,17,-4,10,1
302610,2,3,3,0,15,1
330639,2,0,0,0,11,1
349470,3,6,20,-14,2,0
29755,3,34,3,31,14,1
195551,3,6,7,-1,2,0
339668,1,0,0,0,15,1
321354,4,29,22,7,6,0
327913,4,37,24,13,10,0
325207,4,13,23,-10,8,0
376797,2,14,7,7,15,1
142178,4,2,10,-8,13,1
78263,2,0,13,-13,2,0
339019,4,20,3,17,15,1
386693,4,17,13,4,2,0
362340,2,10,7,3,8,1
53317,4,24,10,14,8,0
67505,3,39,14,25,14,0
50098,2,0,14,-14,6,0
35936,3,3,0,3,17,0
6475,1,0,0,0,3,0
15522,4,23,6,17,8,0
337636,2,14,10,4,14,0
87095,2,7,0,7,5,0
107399,4,26,13,13,15,0
116629,4,16,3,13,2,1
373903,4,43,16,27,13,0
344542,3,0,0,0,17,1
154351,4,27,24,3,1,0
395667,3,7,27,-20,6,1
186156,2,13,6,7,15,0
72904,2,10,7,3,16,0
88971,3,36,10,26,6,1
233120,2,22,3,19,2,1
10668,4,10,17,-7,5,0
315641,2,3,6,-3,4,0
100554,4,20,20,0,12,1
279875,3,17,13,4,5,1
74813,2,13,6,7,17,0
146327,1,0,3,-3,15,1
3440,2,3,16,-13,2,0
346325,1,0,3,-3,1,1
242011,2,7,3,4,5,1
97054,2,19,3,16,10,0
133481,3,20,17,3,9,1
268131,2,3,7,-4,17,1
359425,1,0,0,0,6,0
8330,2,16,3,13,4,0
161575,2,22,10,12,4,1
246447,2,7,0,7,8,0
250547,4,19,14,5,9,1
148407,1,0,0,0,16,0
126888,4,17,6,11,6,0
89964,2,2,13,-11,7,0
186759,2,20,0,20,15,1
239357,1,0,7,-7,4,1
310745,2,3,3,0,2,1
94967,2,6,6,0,9,0
154262,1,3,7,-4,1,1
380953,3,9,7,2,16,0
93763,3,3,16,-13,9,1
121606,4,22,16,6,4,0
326917,1,2,0,2,9,0
230870,2,7,10,-3,1,1
400658,2,3,0,3,8,1
247002,4,20,24,-4,8,0
253786,4,24,17,7,11,0
166853,1,0,3,-3,6,0
377731,3,32,7,25,15,1
45316,3,10,10,0,4,0
417989,3,14,28,-14,16,1
270135,3,24,13,11,1,1
271109,1,0,7,-7,1,0
276071,3,20,3,17,3,1
88493,3,13,14,-1,6,1
159136,4,31,7,24,3,0
109749,3,13,0,13,16,0
42872,1,0,3,-3,3,1
390971,2,13,7,6,4,0
357589,4,13,13,0,5,1
147234,2,0,21,-21,15,0
24230,3,10,16,-6,12,0
352396,2,28,7,21,3,1
186307,2,19,3,16,15,1
404555,4,34,27,7,10,0
377005,4,15,19,-4,15,1
128008,1,0,0,0,7,1
152183,2,7,0,7,17,1
118834,2,20,0,20,2,0
103334,2,7,17,-10,13,1
200375,1,0,6,-6,4,1
267157,4,10,10,0,17,0
331878,3,0,3,-3,12,0
3227,1,0,0,0,2,1
245926,4,13,37,-24,7,0
95378,1,14,0,14,10,0
298443,4,13,24,-11,14,0
55186,1,7,0,7,9,0
146253,3,3,30,-27,15,0
206806,1,0,0,0,7,0
29126,2,0,16,-16,14,1
272499,1,7,0,7,2,0
227717,2,0,0,0,16,1
391375,1,6,3,3,4,1
387127,3,10,31,-21,2,1
358693,2,7,7,0,6,0
9449,2,10,0,10,5,1
140486,3,21,26,-5,12,1
154899,2,13,10,3,1,1
82670,4,12,13,-1,3,1
61642,1,0,3,-3,12,0
256450,3,12,21,-9,12,0
134116,4,27,13,14,9,1
229362,1,0,0,0,17,1
190802,2,13,3,10,17,1
302998,4,20,16,4,16,0
82755,2,6,6,0,3,1
140753,3,15,14,1,12,0
214354,1,0,0,0,11,0
259517,4,35,10,25,13,1
40314,3,6,7,-1,2,1
167268,4,30,23,7,7,1
370466,3,13,6,7,12,0
50769,4,21,21,0,6,1
130911,1,0,7,-7,8,0
289204,3,20,10,10,9,0
15858,4,8,19,-11,8,0
184612,1,7,3,4,15,1
389765,2,10,3,7,3,0
172225,3,7,13,-6,9,1
337968,4,23,0,23,14,1
166850,1,0,3,-3,6,0
102043,3,21,3,18,12,0
344509,2,0,0,0,17,0
191897,4,29,16,13,1,1
309261,2,0,10,-10,1,0
307922,2,6,0,6,1,1
34049,1,0,0,0,16,1
230289,3,19,10,9,17,0
250571,1,0,0,0,10,1
164301,1,13,0,13,5,0
310835,4,27,13,14,2,0
155711,3,10,20,-10,2,1
97238,3,12,6,6,10,0
378042,3,0,13,-13,15,0
111932,2,0,21,-21,17,1
18904,4,9,13,-4,9,1
76906,2,6,13,-7,1,1
47824,2,7,6,1,5,1
374819,2,7,0,7,14,1
185206,2,7,3,4,15,1
215989,4,20,42,-22,11,0
388207,4,6,13,-7,2,1
328635,3,20,35,-15,10,0
27940,3,14,10,4,13,0
80266,1,0,0,0,2,1
216223,3,17,10,7,12,1
11944,2,0,0,0,6,1
107544,4,3,23,-20,15,1
149155,4,17,31,-14,16,0
183117,3,7,6,1,14,1
27512,3,23,9,14,13,1
44196,1,7,0,7,3,0
243691,1,7,3,4,6,0
292187,3,21,14,7,11,1
256896,2,14,10,4,12,0
351612,1,0,7,-7,3,0
3148,3,10,9,1,2,0
335817,1,7,7,0,13,1
256993,1,0,7,-7,12,0
131584,4,9,23,-14,8,0
411676,4,37,28,9,13,1
83324,1,0,7,-7,4,1
190783,2,12,3,9,17,1
49835,3,21,10,11,6,0
83818,2,10,3,7,4,0
177370,2,10,7,3,11,1
216124,1,0,0,0,12,1
66273,1,0,0,0,14,0
374866,3,14,3,11,14,0
32511,2,14,3,11,15,1
189987,4,16,7,9,17,1
126411,4,33,17,16,6,0
335501,1,0,0,0,13,0
11313,1,7,0,7,6,0
269148,5,16,16,0,17,0
307724,1,7,0,7,1,0
42229,3,24,0,24,2,0
96724,2,0,10,-10,10,0
255672,3,3,7,-4,12,1
217261,1,0,0,0,12,1
323354,2,10,0,10,7,1
155551,3,23,3,20,2,0
211734,4,29,16,13,9,1
360277,2,0,6,-6,7,0
52368,2,6,17,-11,7,0
82710,1,0,0,0,3,0
408051,3,10,10,0,12,0
152051,2,3,7,-4,17,0
328414,1,0,0,0,10,1
73969,3,30,0,30,17,1
22924,4,3,23,-20,11,1
412276,1,0,0,0,13,1
279763,4,30,12,18,5,0
391771,4,10,13,-3,4,0
91493,3,19,0,19,8,0
339481,4,10,26,-16,15,1
103078,3,27,7,20,13,0
277122,3,10,17,-7,4,0
40863,1,6,3,3,2,0
200623,3,27,21,6,4,1
147808,1,0,7,-7,15,1
244675,3,7,23,-16,7,0
67593,2,0,20,-20,14,0
357012,4,26,3,23,5,0
240975,4,21,16,5,5,0
292152,2,21,0,21,11,1
30959,4,17,24,-7,15,0
290123,4,21,15,6,10,1
20762,1,0,0,0,10,1
135422,4,28,24,4,10,0
157254,3,10,3,7,2,1
161452,3,7,3,4,4,1
357595,4,16,13,3,5,0
86430,3,20,7,13,5,1
18695,1,0,7,-7,9,0
225435,1,0,0,0,15,0
369483,4,48,7,41,11,0
28997,3,7,7,0,14,0
92913,4,34,7,27,8,0
419929,4,16,18,-2,17,0
132423,3,0,21,-21,9,1
245839,2,3,16,-13,7,0
287743,1,14,0,14,9,0
33258,3,10,0,10,16,1
198117,1,0,3,-3,3,1
136569,2,9,13,-4,11,0
249179,1,9,0,9,9,0
231562,1,7,0,7,1,0
124152,4,19,21,-2,5,1
374004,3,10,7,3,13,1
296771,2,7,0,7,13,1
248163,2,6,10,-4,8,0
107815,4,7,20,-13,15,0
254545,1,0,0,0,11,1
24127,4,14,14,0,12,0
180876,1,0,0,0,13,1
173186,3,20,17,3,9,1
272546,2,13,3,10,2,0
26336,4,19,21,-2,13,1
150273,1,14,6,8,16,0
261689,2,14,0,14,14,1
44695,2,0,9,-9,3,1
163810,4,17,19,-2,5,1
142098,2,0,7,-7,13,1
356863,4,16,16,0,5,0
421257,3,16,7,9,17,0
351001,1,0,7,-7,3,1
300009,2,0,20,-20,14,1
38812,3,3,10,-7,1,0
3791,4,20,10,10,2,1
17788,1,7,3,4,9,1
53772,5,10,10,0,8,0
170522,1,7,0,7,8,0
337905,2,10,0,10,14,1
240258,1,7,7,0,5,1
121146,1,0,10,-10,3,0
402433,3,21,12,9,9,1
209987,2,0,3,-3,8,1
22408,1,3,24,-21,11,1
54307,1,6,2,4,8,1
61324,4,31,28,3,11,0
270269,3,3,21,-18,1,0
186158,2,13,6,7,15,1
30836,2,0,14,-14,15,0
50943,4,24,27,-3,6,1
342414,2,10,3,7,16,1
321264,2,6,10,-4,6,1
7424,2,19,3,16,4,1
414686,2,3,10,-7,14,1
329380,3,16,34,-18,10,1
403864,2,10,0,10,10,0
24986,3,16,14,2,12,1
291649,4,23,20,3,11,1
181247,2,0,3,-3,13,1
84754,3,10,24,-14,4,1
107112,4,40,6,34,15,1
414433,3,13,23,-10,14,1
251205,2,10,10,0,10,0
24330,1,0,0,0,12,1
315942,2,0,7,-7,4,1
212765,3,10,21,-11,10,0
289645,3,10,20,-10,10,1
44652,4,23,24,-1,3,0
346281,4,40,3,37,1,1
193091,2,13,6,7,1,0
388914,2,10,20,-10,3,0
51061,3,3,20,-17,6,0
134383,4,29,24,5,10,1
289990,1,0,0,0,10,0
70971,1,0,0,0,16,0
209872,3,16,16,0,8,1
302921,2,13,3,10,16,1
212872,1,0,0,0,10,0
234445,2,10,3,7,2,0
50621,4,10,6,4,6,1
161512,4,17,6,11,4,0
208044,3,21,3,18,8,0
99146,1,3,3,0,11,0
339795,4,24,13,11,15,0
115441,3,39,14,25,1,1
315425,4,23,30,-7,4,1
46742,2,7,3,4,4,1
155874,3,7,13,-6,2,1
194668,4,34,7,27,2,0
264851,1,0,0,0,16,0
45465,3,27,14,13,4,0
71551,1,3,0,3,16,1
8363,3,23,3,20,4,1
71960,4,25,16,9,16,0
233893,3,14,6,8,2,0
195977,3,0,27,-27,2,1
13876,2,14,0,14,7,0
233863,2,7,3,4,2,0
218673,4,10,33,-23,13,0
221190,4,0,23,-23,14,1
284384,4,27,17,10,7,1
61692,3,17,10,7,12,0
254752,2,3,3,0,11,1
141207,3,3,21,-18,13,1
261316,1,0,0,0,14,0
206990,2,21,0,21,7,0
400728,4,16,17,-1,8,1
259647,4,9,6,3,13,1
94429,1,0,0,0,9,1
198670,4,15,21,-6,3,0
4970,4,24,17,7,3,0
30462,3,24,28,-4,14,0
180259,1,3,0,3,13,1
170625,4,47,9,38,8,1
2219,2,7,0,7,1,0
92465,4,23,10,13,8,0
227577,2,21,0,21,16,1
39541,2,0,3,-3,1,1
131049,1,7,0,7,8,0
120421,3,19,9,10,3,1
313962,1,0,0,0,3,1
94677,3,17,29,-12,9,1
267684,2,13,24,-11,17,1
119170,4,10,7,3,3,1
351581,4,0,27,-27,3,1
267899,4,29,24,5,17,0
331088,1,0,0,0,11,0
73456,1,0,7,-7,17,0
215180,2,7,9,-2,11,0
356356,3,24,8,16,5,1
9199,3,3,23,-20,5,1
56205,1,3,0,3,9,0
95430,3,28,7,21,10,1
420292,2,7,0,7,17,1
406442,4,31,7,24,11,0
388657,4,17,0,17,3,0
297412,4,23,24,-1,13,1
391904,3,23,20,3,4,0
22163,3,10,9,1,11,1
413988,2,3,21,-18,14,0
217946,4,39,36,3,12,1
73167,1,7,0,7,16,1
123127,1,3,0,3,4,0
153738,3,2,21,-19,1,0
162687,3,23,24,-1,5,0
205099,4,22,27,-5,6,0
342891,3,16,14,2,16,0
348218,2,6,17,-11,1,1
332406,1,6,3,3,12,1
46875,2,13,3,10,5,0
28917,1,0,0,0,14,0
27186,2,13,7,6,13,1
122081,1,0,7,-7,4,0
136499,4,20,13,7,11,0
252939,3,9,0,9,11,0
420000,2,3,7,-4,17,0
118837,3,20,7,13,2,1
4673,4,19,13,6,2,1
366605,4,26,14,12,10,1
324024,4,20,25,-5,8,1
171593,2,3,3,0,9,0
39886,3,6,7,-1,1,1
405655,4,24,28,-4,10,1
354647,3,10,7,3,4,0
9358,3,28,7,21,5,1
49380,3,10,17,-7,6,0
114474,2,10,10,0,1,0
80922,2,6,0,6,3,0
38928,2,10,0,10,1,1
99277,1,7,0,7,11,1
314747,2,14,0,14,4,0
389710,1,0,0,0,3,0
364866,3,6,14,-8,9,0
103493,2,13,0,13,13,0
90612,3,17,20,-3,7,0
156259,5,24,23,1,2,1
402682,1,0,0,0,9,1
62773,3,17,0,17,12,1
323441,1,0,0,0,7,0
116578,2,9,0,9,2,1
61622,1,0,0,0,12,1
185140,4,0,23,-23,15,1
313808,1,0,0,0,3,0
109764,4,13,0,13,16,0
364682,2,3,0,3,9,1
362059,2,14,7,7,8,0
326245,3,10,48,-38,9,1
63491,3,31,13,18,12,0
144446,3,10,26,-16,14,0
241206,1,0,0,0,5,1
72688,4,20,10,10,16,0
102564,1,2,0,2,13,1
185577,3,10,20,-10,15,1
168565,2,7,10,-3,7,1
135869,4,21,17,4,10,0
363277,3,24,7,17,8,0
59409,1,0,0,0,11,1
113750,3,3,17,-14,17,0
336078,1,0,0,0,13,1
7204,1,0,0,0,4,0
293786,2,16,3,13,12,1
171898,2,7,7,0,9,0
291289,3,14,19,-5,10,1
391102,1,7,14,-7,4,1
329927,2,7,10,-3,11,0
295929,4,13,24,-11,12,1
61748,4,24,38,-14,12,0
211794,2,0,7,-7,9,1
210066,4,17,17,0,8,1
85954,2,7,14,-7,5,1
140904,3,17,10,7,13,1
154216,4,10,23,-13,1,1
305346,1,7,0,7,17,0
17108,3,23,10,13,9,1
278428,1,15,0,15,4,0
20650,2,7,14,-7,10,0
284556,1,7,0,7,7,0
375778,2,13,0,13,14,1
215689,4,14,6,8,11,1
253410,3,14,28,-14,11,0
270821,2,6,0,6,1,0
342856,2,16,0,16,16,0
242956,4,24,31,-7,6,1
180011,2,7,13,-6,13,0
142573,1,0,3,-3,13,1
113814,4,16,24,-8,17,0
42542,4,10,21,-11,3,0
87174,4,21,10,11,5,0
339764,3,24,6,18,15,1
211006,2,7,0,7,9,1
67379,4,30,6,24,14,1
352988,3,20,10,10,3,0
70164,3,20,7,13,15,1
221796,4,13,28,-15,14,1
82015,2,7,0,7,3,1
298759,1,7,6,1,14,0
57282,1,0,0,0,10,1
138026,2,22,17,5,11,0
403100,5,34,34,0,9,1
175064,1,0,0,0,10,0
79355,4,32,3,29,2,0
219737,1,6,0,6,13,1
127422,1,0,0,0,6,1
334389,2,7,10,-3,13,0
181612,4,23,6,17,13,0
366509,1,7,7,0,10,1
300810,4,10,33,-23,15,0
366587,4,20,14,6,10,1
332823,1,0,0,0,12,1
188273,3,14,10,4,16,1
132552,2,2,29,-27,9,0
278013,2,3,10,-7,4,1
290664,2,35,16,19,10,1
192041,4,24,27,-3,1,0
207032,3,28,3,25,7,1
170347,4,6,15,-9,8,0
76858,4,33,7,26,1,1
165808,2,3,6,-3,6,1
283548,2,6,7,-1,7,0
349013,3,14,7,7,2,1
395097,4,16,31,-15,5,1
374185,4,23,21,2,13,0
346836,3,10,3,7,1,0
103054,2,21,0,21,13,0
126680,2,7,6,1,6,1
351782,2,10,14,-4,3,1
194863,1,0,7,-7,2,0
252899,2,6,0,6,11,0
336127,2,10,3,7,13,0
228677,3,16,23,-7,17,1
369091,1,3,0,3,11,1
203024,2,14,3,11,5,1
411096,1,0,0,0,13,0
355538,2,7,0,7,5,1
116561,2,3,0,3,2,0
79273,2,9,3,6,2,1
33152,4,10,42,-32,16,0
115595,4,27,9,18,1,1
385233,1,0,3,-3,1,0
301039,2,17,3,14,15,0
15953,3,12,14,-2,8,1
409602,4,42,20,22,12,0
239451,3,9,17,-8,4,1
22640,3,23,10,13,11,1
208696,1,0,0,0,8,1
178867,4,27,21,6,12,1
331461,3,9,7,2,11,0
175078,1,7,3,4,10,0
291351,1,0,0,0,10,1
172527,2,0,7,-7,9,1
381865,4,25,21,4,17,0
259375,4,35,34,1,13,0
298206,2,7,3,4,14,0
82687,4,12,13,-1,3,1
134983,4,7,27,-20,10,1
112168,4,13,27,-14,17,1
339774,4,24,6,18,15,1
381244,3,17,10,7,16,1
230957,1,0,0,0,1,1
127983,4,23,27,-4,6,1
58099,2,10,10,0,10,1
41315,2,14,9,5,2,0
156238,4,22,23,-1,2,1
197413,2,13,3,10,3,1
311007,1,7,0,7,2,0
331490,4,9,23,-14,11,0
355259,2,14,14,0,4,0
412203,3,14,3,11,13,0
45371,4,20,16,4,4,1
370822,4,32,17,15,12,1
305828,2,0,14,-14,17,1
299010,4,16,18,-2,14,1
413345,1,0,0,0,14,1
324716,2,13,7,6,8,0
301959,4,17,20,-3,15,1
105232,3,7,24,-17,14,1
322198,3,0,20,-20,7,1
352687,2,17,3,14,3,1
410764,3,22,6,16,13,0
303733,2,14,10,4,16,1
294337,2,10,3,7,12,1
29311,3,21,7,14,14,0
14877,2,7,0,7,7,1
318614,3,10,13,-3,5,1
320900,4,3,14,-11,6,0
360298,2,0,13,-13,7,0
39394,2,0,3,-3,1,1
343707,4,18,10,8,17,1
33178,1,7,0,7,16,1
2397,2,14,13,1,2,1
176056,4,24,0,24,11,0
324608,4,16,9,7,8,0
93386,1,0,0,0,9,1
363611,4,18,15,3,8,0
331119,2,7,13,-6,11,1
93769,4,3,16,-13,9,0
411376,4,20,13,7,13,0
355085,2,6,13,-7,4,0
331429,2,6,7,-1,11,0
26647,4,24,20,4,13,0
274013,1,0,0,0,3,1
132464,4,0,24,-24,9,1
257791,1,0,0,0,13,1
355023,4,10,26,-16,4,1
187094,3,10,0,10,16,1
381271,4,24,17,7,16,0
122769,4,10,27,-17,4,1
27402,4,24,10,14,13,1
231058,4,24,8,16,1,1
884,1,0,0,0,1,1
36810,3,10,17,-7,17,1
256284,3,12,17,-5,12,1
341079,3,7,17,-10,15,0
140312,2,14,13,1,12,1
128773,2,7,10,-3,7,1
83740,4,22,23,-1,4,1
170084,2,7,0,7,8,1
39075,1,6,0,6,1,0
94859,4,6,13,-7,9,0
257089,4,7,21,-14,12,1
192455,2,0,17,-17,1,1
181522,1,3,0,3,13,0
90662,4,27,33,-6,7,0
119032,4,7,33,-26,3,1
201148,2,6,21,-15,5,1
415996,2,7,0,7,15,0
40768,3,17,21,-4,2,0
264287,3,10,23,-13,15,1
271488,4,14,0,14,1,1
111909,1,0,7,-7,17,0
12252,3,0,3,-3,6,1
263920,2,16,0,16,15,1
67024,2,0,0,0,14,1
388553,1,7,0,7,3,0
35027,2,9,3,6,16,1
198120,1,0,3,-3,3,1
87813,1,3,0,3,6,1
76266,4,19,27,-8,1,0
397333,3,0,24,-24,6,1
227060,4,17,9,8,16,1
334549,2,21,17,4,13,0
189556,1,0,0,0,17,1
420500,3,3,35,-32,17,0
314206,3,14,20,-6,3,0
55179,1,0,0,0,9,1
36056,2,17,0,17,17,1
204313,3,0,10,-10,6,0
184593,1,7,0,7,15,0
74617,1,0,0,0,17,0
400294,4,31,9,22,8,0
342400,2,3,3,0,16,1
31806,3,13,17,-4,15,1
128047,2,3,6,-3,7,1
210684,4,20,31,-11,9,0
155190,2,7,7,0,1,1
131014,4,17,30,-13,8,1
75862,2,14,7,7,1,1
224612,2,9,7,2,15,0
90363,4,14,32,-18,7,1
380858,4,9,31,-22,16,1
347669,3,20,17,3,1,0
223383,2,7,18,-11,15,0
61389,2,13,3,10,11,1
49109,5,20,20,0,6,0
202593,3,21,13,8,5,1
319603,1,3,3,0,6,1
119976,3,16,24,-8,3,1
258713,2,0,20,-20,13,1
179856,2,3,9,-6,13,0
38814,3,3,10,-7,1,0
216932,1,0,0,0,12,0
172000,4,21,28,-7,9,1
135249,3,13,3,10,10,1
263759,2,0,7,-7,15,1
78887,3,17,7,10,2,0
160587,1,0,0,0,4,1
114518,3,17,26,-9,1,0
284272,1,3,0,3,7,0
182541,4,35,21,14,14,1
379508,4,26,10,16,16,0
69178,4,17,17,0,15,0
259634,3,6,6,0,13,1
69197,4,20,17,3,15,0
372787,3,3,0,3,13,0
270598,4,20,14,6,1,0
306512,4,17,17,0,17,0
297734,4,24,20,4,13,0
409936,2,0,14,-14,12,1
208990,1,0,0,0,8,0
309343,1,0,0,0,1,1
68776,2,6,0,6,15,1
394760,2,14,0,14,5,1
306789,4,19,33,-14,17,0
37668,3,30,0,30,17,0
363484,1,0,0,0,8,0
65285,2,3,14,-11,13,0
408262,1,0,0,0,12,0
282278,4,25,14,11,6,0
105312,1,0,0,0,14,1
76941,3,14,13,1,1,1
243049,2,0,9,-9,6,1
378955,4,23,30,-7,15,0
153438,3,20,17,3,1,1
170578,2,28,6,22,8,0
42371,3,13,9,4,2,1
239778,4,20,13,7,4,0
2929,1,7,7,0,2,1
103568,4,33,0,33,13,0
45709,1,0,0,0,4,1
392437,4,40,54,-14,4,1
274994,2,21,3,18,3,1
373019,1,0,0,0,13,1
317813,2,9,3,6,5,0
421733,4,23,17,6,17,1
373097,3,3,21,-18,13,1
293554,3,13,17,-4,11,0
133893,2,3,6,-3,9,1
339567,2,10,7,3,15,1
111040,1,7,0,7,16,1
166675,4,32,20,12,6,0
209734,3,9,6,3,8,0
95898,4,20,23,-3,10,0
329279,4,31,19,12,10,0
373320,1,0,0,0,13,0
28959,2,0,7,-7,14,0
326585,1,3,0,3,9,0
212830,4,24,21,3,10,0
347883,1,0,0,0,1,0
360815,4,24,37,-13,7,1
3445,2,3,23,-20,2,1
349193,4,27,14,13,2,0
17600,4,20,17,3,9,1
398494,3,20,9,11,7,1
110936,3,7,10,-3,16,1
369768,4,45,43,2,11,0
174040,2,0,19,-19,10,0
106407,1,7,0,7,14,1
236173,3,10,16,-6,3,1
218980,1,7,0,7,13,1
326956,2,2,7,-5,9,1
347310,3,7,21,-14,1,1
269889,1,0,0,0,1,1
378429,2,7,0,7,15,1
190232,2,7,7,0,17,0
369667,1,13,7,6,11,1
69385,1,7,0,7,15,0
29336,4,21,10,11,14,0
410698,2,10,3,7,13,0
341804,2,3,9,-6,16,1
330406,3,10,20,-10,11,1
339152,3,17,13,4,15,1
5822,3,27,7,20,3,0
375272,1,0,0,0,14,1
386903,1,7,7,0,2,0
237179,1,3,0,3,3,0
91008,2,3,0,3,7,1
226836,1,0,0,0,16,0
253275,3,3,13,-10,11,1
111710,4,31,16,15,16,1
315518,3,7,3,4,4,0
29300,3,21,7,14,14,0
301544,4,20,24,-4,15,0
310063,4,9,13,-4,2,1
123014,3,0,13,-13,4,1
246545,4,29,7,22,8,1
269608,1,0,0,0,1,1
22695,1,3,0,3,11,1
263301,2,10,0,10,15,0
295273,3,14,5,9,12,1
147430,3,23,10,13,15,1
418829,1,0,3,-3,16,1
389733,1,3,0,3,3,1
23079,4,10,17,-7,11,1
373240,3,6,16,-10,13,1
205007,2,9,7,2,6,0
9839,4,20,17,3,5,1
115009,4,13,12,1,1,0
314683,4,17,21,-4,3,1
171755,2,3,7,-4,9,1
127222,4,16,16,0,6,0
181078,2,10,7,3,13,0
161089,2,3,9,-6,4,1
26186,4,0,33,-33,13,0
228733,4,26,33,-7,17,1
42038,2,13,7,6,2,0
281645,2,21,10,11,6,1
241190,4,23,10,13,5,1
15209,3,13,0,13,8,0
168603,3,14,13,1,7,1
411039,3,17,14,3,13,0
349883,2,3,6,-3,2,1
47012,2,17,0,17,5,0
143121,4,24,27,-3,13,1
311149,1,0,0,0,2,1
350615,3,13,0,13,2,1
216023,2,7,12,-5,11,1
144805,1,0,0,0,14,1
195588,4,21,7,14,2,1
153185,4,20,20,0,1,0
222807,3,10,10,0,14,0
70012,3,24,9,15,15,0
154963,4,29,24,5,1,0
363569,4,3,12,-9,8,0
158967,3,14,22,-8,3,0
185459,4,17,13,4,15,0
381237,3,14,10,4,16,1
4845,1,0,0,0,3,1
221366,1,0,16,-16,14,0
175284,3,15,10,5,10,1
323544,4,24,17,7,7,1
45275,2,0,0,0,4,0
8695,4,17,10,7,4,0
181167,4,24,21,3,13,0
292044,3,15,12,3,11,0
390215,2,0,6,-6,3,0
240275,2,7,7,0,5,0
86106,2,28,3,25,5,0
43022,1,0,0,0,3,1
381118,4,24,28,-4,16,0
5536,3,16,10,6,3,1
12195,1,0,0,0,6,0
191813,2,10,7,3,1,0
91068,4,9,0,9,7,0
71648,3,3,31,-28,16,0
27037,3,10,3,7,13,0
291787,4,9,23,-14,11,1
258660,1,0,0,0,13,1
244971,2,0,20,-20,7,1
369175,4,19,14,5,11,0
191811,2,10,7,3,1,0
165995,3,17,21,-4,6,1
117392,4,34,3,31,2,0
289717,1,0,7,-7,10,1
288672,2,0,7,-7,9,1
341243,3,16,10,6,16,0
81299,4,10,14,-4,3,0
63047,3,16,21,-5,12,1
286792,4,20,31,-11,8,1
256212,1,0,0,0,12,1
309141,3,26,3,23,1,0
231950,4,14,41,-27,1,1
369571,3,14,0,14,11,1
170513,1,0,0,0,8,1
357336,1,0,0,0,5,0
376991,3,15,16,-1,15,0
408525,4,10,13,-3,12,1
214065,1,0,0,0,11,1
208022,2,21,0,21,8,1
159920,3,38,10,28,3,0
197272,2,0,0,0,3,0
288582,3,23,31,-8,9,1
349729,3,17,7,10,2,1
53976,4,37,25,12,8,0
355208,1,0,14,-14,4,1
72662,3,13,3,10,16,0
202604,3,21,13,8,5,1
417771,5,35,35,0,16,1
329895,1,0,7,-7,11,0
35744,2,3,0,3,17,0
51784,4,9,19,-10,7,1
275467,3,20,17,3,3,1
266064,2,10,3,7,16,1
223745,4,40,13,27,15,0
69041,4,27,24,3,15,0
221265,2,0,19,-19,14,0
55491,1,10,0,10,9,0
351725,4,21,17,4,3,0
188214,1,0,0,0,16,0
194596,2,21,0,21,2,1
219936,2,6,0,6,13,0
4378,3,7,7,0,2,1
247181,4,27,6,21,8,1
266620,2,10,0,10,16,0
38887,4,10,15,-5,1,1
206395,2,10,0,10,7,1
277006,4,31,20,11,4,0
203827,4,17,24,-7,6,1
115879,3,7,16,-9,1,0
172548,2,7,21,-14,9,0
141546,3,27,10,17,13,0
21319,4,6,14,-8,11,0
184570,4,42,21,21,14,1
248854,1,0,0,0,9,1
323,1,14,3,11,1,1
229700,2,13,7,6,17,0
177538,2,7,0,7,11,0
235121,3,0,10,-10,2,1
388726,1,8,0,8,3,0
142235,1,0,0,0,13,0
399854,1,0,0,0,8,0
215577,1,7,0,7,11,1
2720,4,9,7,2,2,0
281890,4,16,17,-1,6,1
156813,3,23,20,3,2,0
299981,1,0,7,-7,14,0
257733,4,3,24,-21,13,1
371870,2,21,10,11,12,0
87530,2,17,0,17,6,0
56289,3,3,20,-17,9,1
366131,2,7,21,-14,10,0
327505,1,0,7,-7,10,1
374993,2,21,27,-6,14,1
44456,3,17,9,8,3,1
348390,3,13,13,0,1,1
354245,4,20,17,3,4,1
267555,3,27,21,6,17,0
339771,4,24,6,18,15,0
162533,3,35,10,25,4,1
114644,2,3,3,0,1,0
164731,2,13,13,0,6,0
171941,3,14,7,7,9,0
382299,4,20,3,17,17,1
267866,3,26,17,9,17,1
310107,2,7,0,7,2,1
26472,4,30,19,11,13,0
312550,3,30,0,30,3,0
44333,4,24,23,1,3,0
347850,4,16,8,8,1,1
420455,2,0,20,-20,17,1
226172,4,28,35,-7,16,1
62063,4,26,10,16,12,0
17926,1,7,7,0,9,0
72390,4,17,23,-6,16,0
219092,4,45,13,32,13,0
97725,4,9,13,-4,11,0
390961,2,13,7,6,4,1
189703,4,20,6,14,17,0
74657,2,0,9,-9,17,0
163498,1,0,0,0,5,0
148969,3,13,12,1,16,0
43018,1,0,0,0,3,0
84883,3,27,17,10,4,1
221829,1,0,0,0,14,0
45702,1,0,0,0,4,0
183098,2,7,3,4,14,1
96413,1,0,7,-7,10,0
204360,4,3,17,-14,6,1
292371,4,12,16,-4,11,0
42082,4,27,17,10,2,1
398034,2,14,14,0,7,0
148628,3,7,9,-2,16,1
104585,2,7,3,4,14,0
92191,4,10,43,-33,8,0
175754,4,40,21,19,11,1
69334,4,19,3,16,15,0
74056,2,3,0,3,17,1
45296,2,7,7,0,4,0
288813,2,10,14,-4,9,0
387993,2,3,3,0,2,0
117857,4,9,20,-11,2,1
401024,4,29,15,14,8,1
953,3,0,3,-3,1,0
106263,1,0,3,-3,14,1
325462,2,16,3,13,8,1
87699,2,0,20,-20,6,1
254049,4,14,20,-6,11,1
314706,4,17,28,-11,3,1
183290,4,22,20,2,14,0
372159,2,9,7,2,13,0
171762,2,6,7,-1,9,0
15666,3,34,10,24,8,0
209486,1,7,3,4,8,0
153705,2,2,21,-19,1,1
218857,2,14,3,11,13,0
125631,3,14,24,-10,5,0
109896,3,23,0,23,16,0
298332,1,0,0,0,14,0
26743,3,6,14,-8,13,0
314775,2,21,0,21,4,0
240932,2,14,6,8,5,0
420768,2,0,3,-3,17,0
112004,3,28,21,7,17,0
323758,1,6,3,3,8,1
155196,2,14,7,7,1,0
6225,2,13,0,13,3,1
4280,4,27,6,21,2,1
377351,1,0,0,0,15,1
49606,1,0,0,0,6,0
238431,4,17,36,-19,4,1
211012,2,14,0,14,9,1
84436,2,6,7,-1,4,0
386924,2,7,14,-7,2,0
201315,2,28,3,25,5,0
10264,4,13,10,3,5,0
313870,2,14,19,-5,3,1
73536,3,3,38,-35,17,1
83243,3,9,7,2,4,0
205815,2,14,0,14,7,0
323031,2,7,7,0,7,1
380615,1,7,0,7,16,0
102968,4,12,31,-19,13,0
12260,3,3,3,0,6,0
322290,1,7,0,7,7,0
256694,1,0,3,-3,12,0
58678,1,7,7,0,10,1
293384,3,13,10,3,11,1
317983,3,10,10,0,5,1
64004,2,14,3,11,13,1
410590,3,17,7,10,13,0
157442,3,9,17,-8,2,1
223521,2,7,10,-3,15,0
205956,2,6,3,3,7,1
369546,2,11,0,11,11,1
280141,3,21,0,21,5,0
231175,3,10,7,3,1,0
308962,2,0,3,-3,1,1
76975,4,17,13,4,1,1
119598,3,10,9,1,3,0
323420,4,23,0,23,7,0
165976,2,10,14,-4,6,1
234504,3,20,20,0,2,0
278361,3,17,14,3,4,0
252638,2,6,3,3,10,0
34178,4,10,10,0,16,1
153758,3,2,21,-19,1,0
163258,2,6,6,0,5,0
299197,4,17,22,-5,14,1
108590,4,26,14,12,15,0
144435,3,3,19,-16,14,0
383517,2,14,10,4,17,0
82065,4,17,10,7,3,1
310121,2,13,0,13,2,1
15479,2,9,0,9,8,1
62393,2,0,10,-10,12,1
124759,4,3,9,-6,5,1
46726,2,7,0,7,4,0
280400,2,6,7,-1,5,1
44624,4,20,21,-1,3,0
7821,4,37,17,20,4,1
60719,4,28,3,25,11,0
43165,1,0,7,-7,3,1
12485,1,0,0,0,6,0
236227,4,27,22,5,3,1
246271,4,27,16,11,7,0
265847,1,0,0,0,16,1
400735,4,16,17,-1,8,0
251163,1,0,0,0,10,1
359967,1,0,6,-6,7,1
227665,4,42,7,35,16,0
102626,2,12,6,6,13,1
19219,4,21,19,2,10,1
93451,3,3,14,-11,9,0
392047,3,10,17,-7,4,0
409430,4,34,3,31,12,0
114699,4,6,10,-4,1,1
274881,3,7,13,-6,3,0
286433,3,14,3,11,8,1
139862,4,19,17,2,12,1
51249,4,39,32,7,7,0
68308,1,3,0,3,14,1
107636,3,13,20,-7,15,1
31143,2,3,13,-10,15,1
221687,1,3,0,3,14,1
128246,4,20,7,13,7,1
170166,4,10,20,-10,8,1
190847,3,16,10,6,17,1
196356,1,10,0,10,2,0
275047,3,34,17,17,3,0
221128,3,0,6,-6,14,0
90150,2,3,0,3,7,1
299770,4,17,14,3,14,1
246388,4,26,10,16,7,1
268373,4,29,6,23,17,0
194198,4,6,17,-11,1,1
235734,3,3,20,-17,3,1
354722,1,0,0,0,4,1
247222,1,13,7,6,8,1
364355,1,7,0,7,9,0
60171,1,0,0,0,11,1
36013,1,7,0,7,17,0
286684,2,10,7,3,8,1
87568,3,17,3,14,6,1
41140,1,0,0,0,2,0
63248,1,0,0,0,12,0
46484,3,27,6,21,4,1
225017,1,0,0,0,15,1
76000,1,7,13,-6,1,0
351765,1,10,14,-4,3,0
487,2,7,6,1,1,0
219264,4,25,10,15,13,0
197570,2,12,0,12,3,0
4857,1,7,0,7,3,1
99777,3,0,7,-7,12,0
390071,2,7,7,0,3,1
105742,4,35,10,25,14,1
127607,2,3,9,-6,6,1
333691,3,14,0,14,12,1
92490,4,23,17,6,8,1
280314,4,16,22,-6,5,1
102484,3,24,3,21,13,0
196848,3,3,13,-10,3,0
148720,1,10,3,7,16,0
100130,1,0,0,0,12,1
101248,3,7,7,0,12,1
156369,3,37,7,30,2,1
78852,2,7,0,7,2,1
212513,4,13,13,0,10,0
402580,2,10,7,3,9,0
124464,4,16,14,2,5,0
100795,2,6,3,3,12,1
164980,4,17,19,-2,6,0
264721,2,7,13,-6,16,0
387324,4,13,10,3,2,1
73800,3,6,0,6,17,1
160839,3,34,17,17,4,1
278486,3,36,0,36,4,0
165833,3,6,9,-3,6,1
399156,1,0,3,-3,7,1
145078,4,20,13,7,14,1
105795,1,3,3,0,14,0
136656,4,22,19,3,11,0
169952,2,7,7,0,8,0
293580,4,27,20,7,11,0
419461,2,10,6,4,16,1
238809,2,26,0,26,4,1
12155,4,20,21,-1,6,0
240177,3,16,3,13,5,0
356095,4,34,16,18,5,0
271638,4,23,30,-7,2,1
148109,1,0,0,0,16,0
111156,4,31,10,21,16,0
158883,1,14,0,14,3,0
61668,2,7,3,4,12,1
242365,4,34,13,21,6,1
325470,3,16,3,13,8,1
120358,1,0,6,-6,3,1
348708,3,24,10,14,2,0
205408,4,27,0,27,6,0
7851,1,3,7,-4,4,0
39348,1,0,0,0,1,1
300192,3,28,3,25,14,0
314924,3,0,3,-3,4,0
7384,1,0,0,0,4,1
386244,4,12,17,-5,2,1
110793,3,6,10,-4,16,0
41743,2,0,0,0,2,0
47160,2,6,0,6,5,1
264097,2,13,27,-14,15,1
37685,4,30,0,30,17,0
291242,2,7,6,1,10,0
42130,5,27,27,0,2,0
199027,1,0,0,0,4,0
355799,1,0,0,0,5,1
294529,3,17,13,4,12,0
219475,2,0,21,-21,13,1
70592,2,7,10,-3,15,1
231160,2,10,0,10,1,0
87855,2,10,9,1,6,1
299487,4,10,23,-13,14,0
255060,3,3,21,-18,12,1
335296,2,3,9,-6,13,1
277146,4,10,24,-14,4,1
235152,4,0,10,-10,2,1
107964,3,6,13,-7,15,1
111045,1,7,0,7,16,1
88868,1,0,0,0,6,0
128682,4,6,17,-11,7,0
205338,2,20,0,20,6,0
282334,1,7,0,7,6,0
397072,4,24,16,8,6,1
67207,3,0,3,-3,14,0
9895,2,0,3,-3,5,1
140473,3,14,26,-12,12,1
22101,1,3,0,3,11,1
294759,1,0,7,-7,12,1
63282,2,3,0,3,12,0
58853,1,3,6,-3,10,0
110319,3,3,17,-14,16,1
5131,4,13,7,6,3,1
313563,2,3,17,-14,3,1
280339,4,19,22,-3,5,0
379158,2,6,3,3,16,0
256834,1,0,0,0,12,1
47856,3,10,12,-2,5,0
308564,2,6,9,-3,1,1
326068,3,16,3,13,9,0
280275,2,13,13,0,5,0
391200,4,10,24,-14,4,1
27667,4,7,27,-20,13,1
293866,4,31,26,5,12,1
179891,3,17,9,8,13,1
36848,4,24,35,-11,17,1
415798,4,27,24,3,15,0
405384,1,6,7,-1,10,1
21742,3,24,14,10,11,0
16898,2,13,13,0,8,1
357931,1,0,6,-6,6,1
168784,4,16,16,0,7,1
211930,1,0,3,-3,9,1
67432,1,7,7,0,14,1
44549,2,0,13,-13,3,0
368567,3,9,0,9,11,1
267875,4,26,23,3,17,0
386967,3,7,21,-14,2,0
275255,1,10,0,10,3,0
22990,1,0,7,-7,11,0
409886,4,30,8,22,12,1
398860,1,3,0,3,7,0
295424,3,10,13,-3,12,1
126577,4,16,6,10,6,0
419060,4,10,20,-10,16,0
205017,2,9,10,-1,6,1
313141,2,7,10,-3,3,1
189434,2,7,0,7,17,1
299765,4,17,12,5,14,0
299391,2,0,13,-13,14,1
75705,1,21,7,14,1,0
288924,4,26,31,-5,9,0
283987,2,0,0,0,7,1
4217,2,10,6,4,2,1
349393,1,0,0,0,2,1
60402,3,20,7,13,11,0
218963,1,0,0,0,13,1
190515,2,10,6,4,17,0
405610,3,21,20,1,10,0
86098,2,28,3,25,5,0
384619,4,10,52,-42,1,0
217852,2,10,14,-4,12,0
356150,2,10,0,10,5,1
106754,2,17,15,2,14,0
146250,3,3,30,-27,15,1
124198,1,0,0,0,5,0
6370,2,0,13,-13,3,1
271611,3,23,20,3,2,0
46119,1,0,0,0,4,1
73099,4,13,10,3,16,0
105130,4,33,14,19,14,0
386288,4,14,20,-6,2,0
134935,3,7,16,-9,10,0
179201,1,7,0,7,12,0
166921,3,13,6,7,6,0
124492,1,0,0,0,5,0
317913,1,7,0,7,5,1
220968,2,14,7,7,14,0
115164,4,10,27,-17,1,1
185921,4,22,16,6,15,0
83808,1,7,0,7,4,0
169922,1,7,0,7,8,1
159451,4,20,23,-3,3,0
119634,4,17,12,5,3,1
45710,1,0,0,0,4,1
381885,4,32,28,4,17,1
99061,3,16,0,16,11,0
206671,1,0,7,-7,7,1
241342,1,0,0,0,5,1
180908,1,10,7,3,13,1
24971,2,10,14,-4,12,1
246021,2,7,6,1,7,1
116291,2,17,10,7,1,1
402815,1,0,0,0,9,0
41636,2,17,0,17,2,1
371,2,28,10,18,1,0
402391,2,7,7,0,9,0
252443,2,0,5,-5,10,0
284420,1,0,6,-6,7,1
293175,2,6,6,0,11,0
11420,4,26,0,26,6,1
199546,2,20,10,10,4,1
176896,4,20,16,4,11,0
219694,4,13,14,-1,13,0
43394,4,21,17,4,3,0
309896,4,24,21,3,1,0
353358,1,3,0,3,4,1
389233,3,28,7,21,3,0
3722,2,10,0,10,2,0
126874,3,17,6,11,6,0
57009,2,6,10,-4,9,1
337402,4,21,14,7,14,1
997,4,0,6,-6,1,1
155472,1,0,0,0,2,1
299235,1,3,0,3,14,1
23192,3,23,6,17,11,0
162489,2,14,3,11,4,0
193561,2,0,7,-7,1,0
194319,3,10,6,4,2,1
200926,4,40,7,33,4,0
275190,4,14,16,-2,3,1
394226,4,33,25,8,5,1
9547,4,20,20,0,5,0
85365,3,28,10,18,5,1
66950,4,18,7,11,14,1
230280,2,16,10,6,17,1
81890,3,0,30,-30,3,0
325642,3,17,7,10,9,1
60733,4,28,3,25,11,0
250866,4,10,12,-2,10,0
413326,4,20,0,20,14,0
72997,1,0,0,0,16,0
400386,3,24,10,14,8,0
86143,3,28,10,18,5,1
314106,4,33,20,13,3,1
284687,4,17,27,-10,7,0
238908,1,0,0,0,4,1
355094,2,6,13,-7,4,0
152933,2,14,14,0,1,0
233068,1,0,0,0,2,0
342751,3,7,7,0,16,0
134824,4,48,17,31,10,0
7502,4,29,6,23,4,0
230101,1,0,3,-3,17,0
301179,2,13,14,-1,15,1
30295,2,3,10,-7,14,0
399432,1,0,6,-6,7,0
119127,2,10,7,3,3,1
333180,2,0,7,-7,12,1
233697,2,7,21,-14,2,1
415711,2,7,10,-3,15,1
217470,3,9,3,6,12,0
136268,2,15,7,8,11,0
287090,4,26,32,-6,8,1
95552,2,6,10,-4,10,1
69633,4,14,17,-3,15,1
21986,2,7,3,4,11,0
152557,4,24,14,10,17,0
49063,3,10,13,-3,6,0
5915,2,0,16,-16,3,1
290306,1,0,0,0,10,1
226804,4,14,23,-9,16,1
153680,1,2,14,-12,1,1
411618,3,14,21,-7,13,0
416381,4,16,13,3,15,1
283817,1,0,0,0,7,1
120020,4,23,38,-15,3,1
96180,3,0,16,-16,10,1
215526,4,13,3,10,11,1
176456,1,0,10,-10,11,1
377677,2,19,7,12,15,0
2188,1,0,0,0,1,0
223937,1,0,0,0,15,1
268148,2,6,14,-8,17,1
302002,1,6,0,6,15,1
193775,4,16,27,-11,1,1
315966,2,0,21,-21,4,1
117182,2,16,10,6,2,1
185187,1,0,0,0,15,1
73767,2,3,0,3,17,1
284168,3,6,20,-14,7,1
293533,3,10,10,0,11,0
183911,1,7,3,4,14,1
138630,2,3,14,-11,12,1
191676,2,7,10,-3,17,0
296655,3,3,16,-13,13,1
271432,2,14,0,14,1,0
411029,2,17,14,3,13,0
150538,1,0,3,-3,17,0
337578,1,7,0,7,14,0
88875,1,7,0,7,6,0
391893,3,16,20,-4,4,0
122257,2,3,13,-10,4,1
58952,4,20,32,-12,10,0
304432,1,0,0,0,16,0
279683,2,23,3,20,5,1
203160,2,0,10,-10,5,1
194379,1,0,0,0,2,1
405280,3,14,7,7,10,1
271372,1,0,0,0,1,1
120864,2,14,14,0,3,0
304639,2,14,7,7,16,0
291125,2,15,13,2,10,0
198759,2,3,3,0,3,0
112917,4,16,6,10,17,0
372080,4,13,10,3,13,1
153977,2,7,7,0,1,0
100300,1,6,7,-1,12,0
209641,1,3,0,3,8,0
188362,1,0,0,0,16,1
364273,3,3,26,-23,9,1
216846,2,7,14,-7,12,1
73476,2,3,14,-11,17,0
136127,2,10,10,0,10,0
139214,1,3,6,-3,12,1
269641,2,3,0,3,1,1
103239,3,3,7,-4,13,0
288121,3,16,7,9,9,0
101161,4,19,27,-8,12,1
197298,2,14,0,14,3,1
265775,3,10,3,7,16,1
61460,4,24,17,7,11,0
334164,4,23,14,9,13,1
47590,4,49,6,43,5,0
249893,3,12,20,-8,9,0
213605,1,0,0,0,10,0
252934,2,6,0,6,11,1
156053,4,20,24,-4,2,0
108149,4,20,42,-22,15,0
187638,1,0,3,-3,16,1
86077,1,21,0,21,5,1
57817,4,19,10,9,10,0
336410,2,3,3,0,14,1
10375,3,10,38,-28,5,1
266048,2,10,3,7,16,1
288029,1,0,0,0,9,1
405478,4,24,16,8,10,0
278277,1,7,0,7,4,0
106693,1,0,2,-2,14,0
78102,1,7,3,4,2,0
101889,3,6,13,-7,12,0
334586,4,27,24,3,13,1
352483,1,0,0,0,3,0
280892,3,19,3,16,6,0
376423,4,16,9,7,14,1
105975,2,17,0,17,14,0
297052,2,14,0,14,13,1
318360,4,9,29,-20,5,1
389374,3,23,13,10,3,1
166597,2,22,14,8,6,1
120276,3,17,6,11,3,0
323495,2,3,10,-7,7,1
37782,2,7,9,-2,1,1
283240,2,10,0,10,7,0
3856,1,13,0,13,2,0
389474,2,10,0,10,3,1
50995,2,0,7,-7,6,0
252148,2,10,10,0,10,1
242015,3,7,3,4,5,1
363376,2,7,10,-3,8,1
110540,1,0,0,0,16,1
378782,4,14,10,4,15,1
168513,4,17,30,-13,7,0
91862,4,30,13,17,8,0
218913,3,34,23,11,13,0
315258,4,20,16,4,4,1
147832,2,3,7,-4,15,0
320015,4,43,30,13,6,1
214358,1,0,0,0,11,0
347410,1,0,0,0,1,1
294690,3,6,14,-8,12,1
371827,1,0,10,-10,12,1
2759,1,0,0,0,2,0
288954,1,9,0,9,9,0
282370,2,7,13,-6,6,1
63000,2,6,14,-8,12,1
185149,4,0,23,-23,15,0
194113,1,0,0,0,1,1
216941,1,3,0,3,12,0
305016,4,24,27,-3,16,1
391936,4,30,27,3,4,0
16226,2,3,3,0,8,1
76833,4,33,0,33,1,0
334343,1,0,3,-3,13,1
223537,3,10,10,0,15,0
384166,3,21,20,1,1,1
237560,4,37,14,23,3,1
51010,2,0,14,-14,6,0
27048,3,10,3,7,13,0
105833,2,13,3,10,14,0
179047,1,3,0,3,12,0
270430,3,10,7,3,1,0
85476,2,14,3,11,5,1
221283,3,0,29,-29,14,0
36657,3,13,3,10,17,0
348061,2,0,10,-10,1,1
348137,4,24,22,2,1,0
228204,3,10,27,-17,17,1
306508,4,17,17,0,17,0
182579,1,0,3,-3,14,1
186564,1,0,0,0,15,1
124636,4,13,17,-4,5,0
149890,4,6,16,-10,16,1
353584,3,31,0,31,4,1
131825,2,7,7,0,8,1
332682,1,0,0,0,12,1
262382,1,0,0,0,15,0
49645,2,7,7,0,6,0
155107,3,12,33,-21,1,1
403262,1,0,0,0,9,1
28598,4,33,7,26,14,0
246740,1,3,3,0,8,0
253810,1,0,0,0,11,1
97998,3,17,10,7,11,0
121785,1,0,0,0,4,0
36184,2,10,14,-4,17,0
142445,2,7,10,-3,13,0
148398,1,0,0,0,16,1
28836,2,10,7,3,14,1
42743,1,3,0,3,3,1
10472,2,3,0,3,5,0
73033,2,0,10,-10,16,1
249886,3,9,20,-11,9,1
74553,3,0,3,-3,17,1
6778,2,3,0,3,3,1
134343,3,16,21,-5,10,1
34616,4,24,7,17,16,1
64669,1,7,0,7,13,1
40876,2,6,10,-4,2,1
120370,1,9,6,3,3,0
131149,4,27,12,15,8,0
37027,1,10,0,10,17,0
46393,4,6,17,-11,4,1
51354,4,19,20,-1,7,0
333606,1,0,0,0,12,1
318294,3,6,7,-1,5,1
141424,4,13,20,-7,13,0
365092,1,0,7,-7,9,0
13968,1,0,0,0,7,1
163986,1,0,0,0,5,1
143062,2,3,14,-11,13,1
177996,3,7,13,-6,12,0
389157,1,7,0,7,3,0
58072,2,7,10,-3,10,0
87851,2,10,9,1,6,1
410666,1,0,3,-3,13,1
338772,1,6,0,6,15,1
408689,4,34,17,17,12,1
328386,4,10,47,-37,10,0
341455,1,0,0,0,16,0
418647,4,28,31,-3,16,0
103983,3,6,13,-7,13,0
99010,1,6,0,6,11,0
149699,2,20,0,20,16,0
152144,1,0,0,0,17,1
419531,4,10,23,-13,16,1
150884,2,0,7,-7,17,1
81253,3,10,7,3,3,1
146910,4,41,0,41,15,0
48939,4,22,13,9,5,0
249323,1,10,0,10,9,0
85892,1,7,7,0,5,0
211296,1,3,0,3,9,0
264917,2,17,14,3,16,0
303046,4,23,19,4,16,1
23748,1,0,0,0,12,1
210416,2,9,0,9,9,0
382207,1,3,3,0,17,1
411837,4,7,34,-27,13,1
258000,3,0,28,-28,13,1
54418,4,33,25,8,8,1
130056,3,17,30,-13,8,0
306011,2,3,10,-7,17,0
27341,2,21,10,11,13,1
251295,4,13,37,-24,10,1
164346,3,20,0,20,5,1
376678,2,3,0,3,14,1
382767,1,7,0,7,17,0
56314,4,3,26,-23,9,0
171425,1,0,0,0,9,0
141785,1,7,7,0,13,1
314745,2,14,0,14,4,0
314372,4,10,17,-7,3,1
366616,4,26,14,12,10,0
15372,3,10,9,1,8,1
32672,2,7,0,7,15,1
393488,1,0,0,0,5,0
283267,2,10,9,1,7,0
128050,2,3,6,-3,7,1
228625,2,10,14,-4,17,1
137434,4,6,21,-15,11,0
52760,1,0,0,0,7,0
265961,3,0,33,-33,16,1
260865,4,36,15,21,14,1
146989,3,17,0,17,15,1
157889,2,6,15,-9,3,0
63130,2,7,10,-3,12,0
406891,4,27,23,4,11,0
166919,3,13,6,7,6,0
215198,3,7,9,-2,11,1
182808,3,19,10,9,14,1
28141,4,30,10,20,13,0
337289,1,0,7,-7,14,1
260079,3,6,14,-8,14,0
82998,4,20,19,1,4,0
7538,1,7,0,7,4,0
7782,3,30,9,21,4,0
317874,4,15,10,5,5,1
337255,4,16,23,-7,14,1
189248,4,53,11,42,16,0
66441,1,0,7,-7,14,1
77713,4,17,24,-7,1,0
268341,3,20,3,17,17,0
9692,4,12,28,-16,5,1
240798,3,17,10,7,5,0
329499,2,10,7,3,10,1
420937,2,7,14,-7,17,1
361007,1,3,2,1,7,1
166944,4,16,9,7,6,1
319596,1,3,0,3,6,0
355510,1,0,0,0,5,1
63286,2,3,0,3,12,0
277340,1,7,0,7,4,0
149557,3,14,16,-2,16,1
79684,1,0,0,0,2,1
249284,4,33,14,19,9,0
32876,4,12,7,5,15,0
54850,4,23,0,23,8,0
81324,1,0,0,0,3,0
219283,1,10,0,10,13,0
222715,4,14,24,-10,14,0
199005,4,19,26,-7,3,1
89235,3,6,0,6,7,0
258870,3,20,14,6,13,1
133675,4,24,35,-11,9,1
374166,3,23,7,16,13,0
115574,3,24,9,15,1,1
408682,4,31,17,14,12,1
293308,1,0,0,0,11,0
272309,4,12,13,-1,2,1
165402,3,6,30,-24,6,1
224922,2,3,9,-6,15,0
233164,3,29,3,26,2,1
59394,4,0,16,-16,11,0
341062,2,7,17,-10,15,0
144977,1,0,0,0,14,0
8790,3,6,0,6,4,1
290022,2,7,0,7,10,1
394270,1,0,0,0,5,1
269289,4,13,19,-6,17,0
4876,1,14,0,14,3,1
110738,2,3,3,0,16,0
332241,4,10,16,-6,12,1
77072,2,7,17,-10,1,1
190804,2,13,3,10,17,1
233028,4,24,10,14,2,0
332787,4,28,9,19,12,0
350614,3,10,0,10,2,1
99883,2,0,3,-3,12,1
246407,4,26,18,8,7,0
418100,1,14,0,14,16,0
198164,3,10,3,7,3,1
370742,2,12,7,5,12,0
327902,4,30,24,6,10,0
322919,2,13,0,13,7,0
317692,4,23,9,14,5,0
89836,2,6,6,0,7,1
161622,3,30,16,14,4,1
228719,4,19,30,-11,17,1
252628,2,6,3,3,10,1
9687,4,12,28,-16,5,1
76248,4,12,27,-15,1,1
121257,4,21,30,-9,3,1
34345,4,23,9,14,16,1
81729,3,17,17,0,3,1
130582,1,0,0,0,8,1
178344,3,14,17,-3,12,1
170726,3,21,6,15,8,1
123910,2,0,0,0,5,1
134128,1,0,0,0,10,1
32556,3,20,13,7,15,1
267839,3,26,14,12,17,0
68839,3,6,17,-11,15,1
318943,1,0,0,0,5,0
114475,2,10,10,0,1,0
113575,2,0,0,0,17,1
3003,3,13,31,-18,2,0
257133,4,24,21,3,12,0
33863,4,9,41,-32,16,1
272198,2,0,0,0,2,0
410439,3,9,17,-8,13,0
124876,3,9,6,3,5,1
195909,2,0,14,-14,2,1
370881,2,10,10,0,12,1
72700,4,27,13,14,16,0
128535,4,21,28,-7,7,0
385104,2,0,3,-3,1,1
279556,3,10,13,-3,5,1
245946,4,21,37,-16,7,0
335762,4,10,7,3,13,1
276198,3,24,3,21,3,0
135188,1,10,0,10,10,0
108040,1,3,7,-4,15,1
229931,4,29,20,9,17,1
106422,2,13,0,13,14,0
88133,1,0,3,-3,6,1
346468,1,7,7,0,1,1
193657,1,0,6,-6,1,1
28940,1,0,7,-7,14,1
81876,2,0,24,-24,3,0
211709,3,23,16,7,9,1
269945,2,13,10,3,1,1
374713,2,0,30,-30,14,0
239457,3,12,17,-5,4,0
156059,4,20,24,-4,2,1
349754,4,20,13,7,2,0
215275,1,0,0,0,11,1
106384,1,0,0,0,14,1
77886,4,17,37,-20,1,0
306706,2,3,3,0,17,1
336238,1,3,0,3,13,1
73417,4,30,3,27,17,1
361629,2,0,12,-12,7,0
164336,2,20,0,20,5,0
305558,3,13,0,13,17,0
254187,4,3,18,-15,11,0
335761,4,10,7,3,13,1
220118,3,26,6,20,13,0
210198,3,7,21,-14,9,0
115613,4,30,9,21,1,0
375618,2,14,17,-3,14,1
91312,2,7,7,0,8,0
234690,4,30,20,10,2,0
421233,2,6,7,-1,17,1
5445,4,20,23,-3,3,1
17019,1,0,0,0,9,1
76117,4,13,30,-17,1,1
44782,4,13,19,-6,3,1
206970,1,14,0,14,7,0
144196,1,0,7,-7,14,0
207290,2,0,14,-14,7,1
319655,3,24,3,21,6,0
189092,4,24,30,-6,16,1
692,3,0,17,-17,1,0
140217,5,13,13,0,12,0
173342,3,21,27,-6,10,1
50388,2,0,7,-7,6,1
129138,4,34,28,6,7,1
25971,2,10,6,4,13,0
93448,3,3,14,-11,9,1
136264,2,15,7,8,11,0
272903,4,20,17,3,2,1
205706,4,20,19,1,7,1
407528,2,3,0,3,11,1
102525,4,31,10,21,13,1
360266,2,0,6,-6,7,0
216376,3,14,16,-2,12,0
137681,1,0,13,-13,11,1
353065,1,7,6,1,3,0
387499,1,0,0,0,2,1
80546,4,8,10,-2,3,1
89129,4,23,6,17,6,0
14943,4,14,24,-10,7,1
340943,3,7,10,-3,15,1
417179,2,3,10,-7,16,0
354775,2,13,17,-4,4,0
348452,1,0,0,0,2,0
306177,3,10,3,7,17,1
163309,3,13,16,-3,5,0
294853,3,42,21,21,12,0
302538,4,3,13,-10,15,1
194683,4,41,10,31,2,0
34549,2,7,0,7,16,0
126399,4,20,14,6,6,0
59511,3,6,20,-14,11,0
275211,4,17,22,-5,3,0
152517,3,17,7,10,17,0
189716,1,0,3,-3,17,1
222089,4,27,17,10,14,0
399004,1,7,9,-2,7,0
240506,3,6,7,-1,5,0
383591,4,24,21,3,17,0
169301,1,0,0,0,8,0
246000,1,0,3,-3,7,0
7711,2,10,0,10,4,0
368961,2,7,7,0,11,1
362468,2,0,6,-6,8,0
348975,2,14,0,14,2,1
277287,4,0,16,-16,4,0
3540,1,0,6,-6,2,0
27414,4,27,17,10,13,0
356996,3,20,3,17,5,0
122222,1,3,7,-4,4,1
265917,2,0,16,-16,16,0
260934,2,0,0,0,14,1
129675,1,0,3,-3,7,1
101855,2,3,3,0,12,0
142403,1,7,0,7,13,0
182986,4,10,44,-34,14,0
367799,1,3,6,-3,10,0
119938,2,6,14,-8,3,1
361703,4,10,39,-29,7,0
67127,1,0,0,0,14,0
9146,1,0,13,-13,5,1
91047,3,9,0,9,7,0
269017,2,7,3,4,17,0
312607,1,0,0,0,3,1
77448,4,27,21,6,1,0
415632,4,30,13,17,15,0
194186,3,6,17,-11,1,1
68254,4,20,20,0,14,1
158192,2,10,0,10,3,1
141655,2,20,14,6,13,0
139467,4,27,10,17,12,1
178486,2,16,3,13,12,1
402679,1,0,0,0,9,0
49865,4,21,17,4,6,0
171976,4,14,21,-7,9,1
268719,2,0,3,-3,17,1
59794,3,12,10,2,11,0
269038,2,10,6,4,17,1
399610,2,3,3,0,8,1
213118,4,20,6,14,10,1
300498,3,23,3,20,14,0
372971,4,28,7,21,13,0
306226,4,20,3,17,17,1
238699,3,16,17,-1,4,1
155574,3,23,3,20,2,0
86821,2,9,6,3,5,0
348429,4,13,23,-10,1,0
173278,1,7,10,-3,10,1
53291,4,3,10,-7,8,1
247053,1,0,3,-3,8,1
312400,3,20,27,-7,3,0
7315,4,20,19,1,4,1
263551,4,20,29,-9,15,0
339029,4,20,3,17,15,0
244390,3,0,17,-17,7,0
50906,3,17,24,-7,6,0
102174,2,14,7,7,13,1
394484,3,7,18,-11,5,1
80300,1,7,6,1,2,0
407205,1,0,3,-3,11,1
143215,2,10,10,0,13,0
141347,2,3,17,-14,13,1
218732,2,0,10,-10,13,0
233897,3,14,6,8,2,0
162081,3,28,13,15,4,1
358057,4,34,29,5,6,0
314293,1,0,14,-14,3,1
277625,4,27,21,6,4,0
323854,4,16,23,-7,8,0
239341,4,3,17,-14,4,0
288144,4,19,7,12,9,1
305510,1,6,0,6,17,0
141467,1,7,0,7,13,1
190251,3,7,14,-7,17,1
328745,2,14,6,8,10,0
6731,4,3,23,-20,3,1
112589,3,24,19,5,17,0
199335,1,0,0,0,4,0
124732,3,3,3,0,5,0
384021,3,13,23,-10,1,1
319844,4,20,10,10,6,1
50092,2,0,14,-14,6,0
378641,4,23,23,0,15,1
342757,3,7,14,-7,16,1
387649,1,0,7,-7,2,1
103123,4,34,7,27,13,1
397233,4,16,0,16,6,0
51064,4,3,23,-20,6,1
307065,3,24,0,24,17,0
54161,1,0,3,-3,8,1
235279,3,18,6,12,3,1
399285,1,0,0,0,7,1
347903,2,0,7,-7,1,0
181525,1,3,0,3,13,1
32529,2,17,3,14,15,1
112657,1,0,0,0,17,1
76946,3,14,13,1,1,1
76232,4,12,27,-15,1,0
79036,3,10,7,3,2,0
326500,2,31,9,22,9,1
50267,2,10,14,-4,6,1
113358,4,26,38,-12,17,0
355074,1,0,6,-6,4,0
218006,2,21,10,11,12,1
330138,4,0,13,-13,11,1
209270,4,34,7,27,8,0
174506,2,7,7,0,10,1
281423,1,0,10,-10,6,0
217678,1,6,0,6,12,1
310607,2,13,27,-14,2,1
399776,3,0,24,-24,8,1
126707,3,7,13,-6,6,0
386740,1,0,0,0,2,0
132043,4,3,24,-21,8,0
179260,3,26,3,23,12,0
199730,4,35,10,25,4,0
277224,2,0,13,-13,4,0
407677,1,0,0,0,11,1
78988,2,3,7,-4,2,0
240385,5,24,23,1,5,0
119063,1,0,7,-7,3,1
159498,1,7,0,7,3,0
193990,2,14,0,14,1,0
72633,2,13,0,13,16,0
6638,1,0,10,-10,3,0
184807,3,17,20,-3,15,1
82008,2,7,0,7,3,1
345982,1,0,0,0,1,1
64908,4,10,3,7,13,0
183537,2,7,10,-3,14,1
173098,4,24,27,-3,9,1
62863,2,3,3,0,12,1
73233,3,7,16,-9,16,1
160978,3,10,7,3,4,1
74365,2,7,3,4,17,0
218176,3,14,3,11,12,1
361065,3,16,9,7,7,1
150155,2,3,13,-10,16,1
387479,4,21,16,5,2,1
147675,2,10,0,10,15,0
64772,4,28,7,21,13,1
145076,4,20,13,7,14,0
117771,2,3,6,-3,2,1
338153,1,7,0,7,14,0
96786,4,7,10,-3,10,0
2327,4,20,23,-3,1,0
268581,2,7,3,4,17,0
225157,1,0,0,0,15,1
314629,3,7,7,0,3,0
226276,2,16,0,16,16,1
64130,1,0,0,0,13,0
272573,3,13,3,10,2,0
296179,2,13,19,-6,13,1
414703,2,3,17,-14,14,1
34889,3,20,10,10,16,1
219107,1,0,0,0,13,0
206345,1,0,0,0,7,1
354944,2,7,3,4,4,0
144800,4,10,17,-7,14,1
340202,3,23,21,2,15,0
418834,1,0,3,-3,16,1
217877,3,17,21,-4,12,1
343682,3,15,10,5,17,1
17893,4,24,17,7,9,1
283272,2,10,9,1,7,1
242944,4,24,23,1,6,0
117038,2,0,17,-17,2,0
129044,1,0,7,-7,7,1
391463,4,10,20,-10,4,0
244317,1,0,0,0,7,0
176961,2,10,3,7,11,1
405201,1,0,7,-7,10,1
17420,4,17,7,10,9,1
153810,1,0,0,0,1,1
181010,4,31,34,-3,13,0
120711,2,17,0,17,3,0
266458,2,0,9,-9,16,0
188655,1,0,0,0,16,0
210681,4,20,31,-11,9,0
175065,1,0,0,0,10,0
149782,1,3,0,3,16,0
311052,2,10,3,7,2,0
132311,4,31,17,14,9,0
109516,1,0,0,0,16,0
208760,2,3,6,-3,8,0
12712,3,45,0,45,6,1
1645,1,0,0,0,1,0
283670,1,0,0,0,7,0
289498,3,13,7,6,10,1
406149,4,3,29,-26,11,0
50996,2,0,7,-7,6,0
155770,4,30,30,0,2,1
237387,3,12,14,-2,3,0
48611,4,21,27,-6,5,0
58286,3,20,13,7,10,0
30040,3,33,0,33,14,0
280214,1,0,0,0,5,1
227095,1,0,0,0,16,1
384587,3,10,42,-32,1,0
74249,3,3,10,-7,17,1
62315,4,21,19,2,12,1
294338,2,10,3,7,12,1
142204,5,11,13,-2,13,1
230709,2,6,27,-21,1,1
191547,3,14,21,-7,17,0
312015,1,0,0,0,2,1
20399,4,10,13,-3,10,0
401013,4,22,15,7,8,1
73265,4,14,16,-2,16,0
377313,4,24,14,10,15,0
84615,3,20,10,10,4,0
274180,1,3,0,3,3,1
271032,3,18,27,-9,1,0
111992,3,17,21,-4,17,1
94582,4,20,17,3,9,0
300152,2,21,3,18,14,0
256202,1,0,0,0,12,1
221911,3,19,10,9,14,0
293004,1,3,6,-3,11,0
62383,1,0,7,-7,12,0
416326,2,13,3,10,15,1
49564,4,14,3,11,6,1
222074,3,20,10,10,14,1
133136,2,7,10,-3,9,1
141604,1,0,0,0,13,1
387586,3,6,3,3,2,1
94795,2,3,6,-3,9,0
5302,1,0,0,0,3,1
140932,4,20,13,7,13,0
349061,4,17,17,0,2,1
103886,1,0,0,0,13,0
384324,3,16,3,13,1,1
47780,1,0,0,0,5,1
123089,5,21,21,0,4,1
69508,1,0,0,0,15,1
263868,1,0,0,0,15,1
69631,4,14,17,-3,15,1
16702,4,21,33,-12,8,1
74688,3,7,17,-10,17,1
334609,4,30,31,-1,13,1
207762,3,24,13,11,7,1
28956,2,0,7,-7,14,0
157796,4,20,10,10,2,1
274003,4,13,29,-16,2,0
73198,2,7,0,7,16,0
84300,3,7,27,-20,4,1
262299,3,10,9,1,15,0
283785,4,18,3,15,7,1
167116,4,22,34,-12,7,1
388910,2,10,17,-7,3,1
357155,4,6,14,-8,5,1
168311,3,10,21,-11,7,1
358117,2,17,0,17,6,0
202434,2,3,10,-7,5,1
340158,2,20,7,13,15,0
151123,1,0,0,0,17,0
370786,3,19,17,2,12,1
209580,3,41,27,14,8,0
418400,2,14,0,14,16,1
117249,4,30,24,6,2,1
277217,2,0,10,-10,4,0
167999,2,3,14,-11,7,0
370281,2,0,28,-28,12,1
138218,3,10,12,-2,11,0
283739,2,8,3,5,7,1
253563,3,6,10,-4,11,0
85054,3,31,16,15,4,1
49921,1,14,0,14,6,1
403212,4,24,17,7,9,0
227291,2,10,20,-10,16,1
201949,2,0,0,0,5,0
139776,1,0,0,0,12,0
208466,2,17,0,17,8,0
339226,1,7,0,7,15,0
123562,4,16,17,-1,4,1
99005,1,3,0,3,11,1
303291,2,20,0,20,16,0
402326,4,23,24,-1,9,1
346632,2,7,3,4,1,1
179464,4,19,20,-1,12,1
199441,4,19,17,2,4,1
410357,1,0,0,0,13,0
204035,4,16,7,9,6,1
218948,4,48,27,21,13,1
74175,1,3,0,3,17,1
360616,3,7,16,-9,7,0
65621,3,6,16,-10,13,1
50190,4,6,31,-25,6,1
123750,2,7,3,4,5,1
396101,2,17,9,8,6,0
67429,1,7,7,0,14,1
409304,4,13,16,-3,12,1
129956,1,0,0,0,8,1
123030,3,7,13,-6,4,1
135914,5,24,24,0,10,0
216595,4,43,18,25,12,0
321317,3,15,19,-4,6,1
101920,4,6,13,-7,12,0
228739,4,26,33,-7,17,0
341680,2,17,13,4,16,1
370158,3,17,3,14,12,1
334072,1,0,0,0,13,1
58345,1,7,0,7,10,0
320955,1,0,0,0,6,1
113351,4,26,38,-12,17,1
237649,2,3,7,-4,4,0
307843,4,27,28,-1,1,1
366570,3,20,14,6,10,1
89391,2,10,20,-10,7,1
34691,2,3,3,0,16,1
109118,2,10,7,3,15,1
390699,3,6,9,-3,3,0
288912,4,19,31,-12,9,1
184304,4,37,14,23,14,0
290112,4,13,15,-2,10,1
388639,3,17,0,17,3,0
231364,4,9,16,-7,1,0
194678,4,34,10,24,2,1
98252,2,7,23,-16,11,0
75779,3,35,26,9,1,1
27580,1,7,0,7,13,0
421576,4,16,6,10,17,1
355855,2,13,7,6,5,0
293949,3,7,21,-14,12,1
146707,3,7,32,-25,15,1
129861,2,10,0,10,7,0
40567,2,10,7,3,2,1
185512,1,3,3,0,15,0
280538,2,7,0,7,5,0
101462,4,25,13,12,12,0
343450,2,7,7,0,16,1
271096,1,0,7,-7,1,1
55832,3,7,7,0,9,1
123667,3,7,22,-15,4,1
118688,3,14,6,8,2,1
347048,4,27,17,10,1,0
5110,3,13,7,6,3,1
36205,2,10,17,-7,17,1
14636,3,17,7,10,7,0
153570,3,12,14,-2,1,1
343256,4,22,0,22,16,1
129166,1,0,0,0,7,1
19510,4,33,17,16,10,0
397254,1,0,7,-7,6,1
193632,4,14,17,-3,1,0
10951,3,9,21,-12,5,0
299631,4,20,16,4,14,0
269611,1,3,0,3,1,0
240614,2,20,7,13,5,0
400157,4,27,23,4,8,0
208586,1,3,0,3,8,1
118547,2,17,3,14,2,0
293784,2,10,3,7,12,1
259544,1,0,0,0,13,1
128244,4,20,7,13,7,0
126770,4,19,20,-1,6,1
375360,3,14,17,-3,14,0
217669,4,26,23,3,12,1
326562,4,51,22,29,9,1
243977,1,0,0,0,6,1
256684,1,0,0,0,12,0
30475,3,31,35,-4,14,0
60335,1,3,0,3,11,1
265933,3,0,22,-22,16,0
420703,4,21,19,2,17,0
309481,4,17,9,8,1,1
365674,1,7,0,7,9,0
17039,1,7,0,7,9,0
155827,2,7,10,-3,2,0
286471,4,20,10,10,8,0
65603,3,6,9,-3,13,0
28072,2,14,10,4,13,1
155357,2,10,3,7,2,0
328009,3,17,3,14,10,0
140147,3,10,3,7,12,0
313471,4,17,14,3,3,0
8060,3,17,7,10,4,1
295197,1,7,0,7,12,0
405963,4,14,7,7,11,1
405774,4,10,21,-11,10,1
231509,4,23,20,3,1,0
51351,4,19,20,-1,7,1
108655,2,20,0,20,15,0
77027,1,6,7,-1,1,1
210726,2,14,0,14,9,0
160597,1,0,0,0,4,1
45224,4,14,10,4,4,1
69962,2,21,0,21,15,0
398637,3,0,0,0,7,0
338485,2,14,0,14,14,0
111110,3,24,7,17,16,0
175689,2,23,6,17,11,0
137827,1,0,6,-6,11,1
257616,1,0,0,0,13,0
370368,4,20,35,-15,12,1
192702,4,19,7,12,1,0
203753,2,7,7,0,6,0
40174,3,13,7,6,2,1
125510,4,30,7,23,5,0
411906,2,17,3,14,13,0
332052,3,10,9,1,12,1
154976,4,35,24,11,1,0
23936,3,16,0,16,12,1
333724,4,21,7,14,12,1
69768,4,19,10,9,15,0
106718,2,7,11,-4,14,0
267439,4,20,24,-4,17,0
167991,2,3,14,-11,7,1
229573,3,27,6,21,17,0
244776,1,0,0,0,7,0
246639,2,24,3,21,8,0
109911,4,23,7,16,16,1
297015,1,7,0,7,13,0
332469,3,16,6,10,12,1
409390,2,13,3,10,12,1
32489,1,7,3,4,15,1
353517,2,3,0,3,4,1
217163,3,9,16,-7,12,0
277485,1,0,0,0,4,1
187730,4,16,20,-4,16,1
132590,3,12,32,-20,9,0
417168,2,3,10,-7,16,1
231672,4,24,16,8,1,0
87621,4,17,13,4,6,1
107667,4,13,30,-17,15,1
299045,4,16,25,-9,14,1
135103,3,24,6,18,10,0
203497,3,21,3,18,6,0
355295,3,14,14,0,4,0
141671,2,23,14,9,13,1
362576,4,33,12,21,8,0
251331,1,13,7,6,10,1
223983,2,7,6,1,15,0
32287,4,27,28,-1,15,1
87920,4,19,15,4,6,0
52558,3,19,7,12,7,1
51012,2,0,14,-14,6,0
386270,4,14,17,-3,2,0
421041,1,0,0,0,17,1
387622,4,13,6,7,2,0
17734,4,17,6,11,9,1
228202,3,10,27,-17,17,1
247202,1,0,0,0,8,0
411182,3,0,23,-23,13,0
264495,1,0,0,0,16,0
84451,3,6,10,-4,4,1
337277,1,0,0,0,14,0
29704,2,10,0,10,14,0
391832,2,10,3,7,4,1
42283,4,37,7,30,2,0
382061,1,7,0,7,17,0
309825,2,7,7,0,1,1
356238,4,29,7,22,5,0
350666,4,20,10,10,2,0
129307,4,17,13,4,7,0
320340,4,17,24,-7,6,1
124591,3,6,17,-11,5,0
280558,2,14,6,8,5,0
226846,1,0,0,0,16,0
260528,3,27,0,27,14,0
414026,4,10,38,-28,14,0
18838,2,3,0,3,9,1
53264,3,3,0,3,8,0
152832,4,21,18,3,17,1
182376,4,24,20,4,14,1
274134,4,27,0,27,3,1
236342,3,7,23,-16,3,1
171660,3,19,17,2,9,0
370380,1,0,0,0,12,0
299382,1,0,13,-13,14,1
402091,1,3,0,3,9,1
358075,1,7,0,7,6,0
135702,3,17,10,7,10,0
6433,4,9,20,-11,3,1
178817,3,24,14,10,12,0
161333,4,20,19,1,4,1
358906,3,6,35,-29,6,1
83978,2,14,0,14,4,1
32100,3,21,13,8,15,0
222488,2,6,14,-8,14,0
269553,4,21,31,-10,1,1
110261,2,0,10,-10,16,1
236423,1,0,0,0,3,1
152936,2,14,14,0,1,0
116809,4,41,33,8,2,0
44973,1,3,0,3,4,0
275744,2,16,0,16,3,0
105863,3,16,10,6,14,1
360482,4,17,0,17,7,0
4293,4,27,6,21,2,0
418906,4,13,17,-4,16,1
116498,4,6,22,-16,1,1
233260,2,0,3,-3,2,0
128131,4,13,6,7,7,1
8313,2,0,0,0,4,1
232059,3,0,24,-24,1,1
355515,1,7,0,7,5,0
38416,4,24,16,8,1,1
286996,2,10,7,3,8,0
295691,2,0,9,-9,12,1
270740,3,6,3,3,1,1
133292,2,7,0,7,9,0
258407,2,14,13,1,13,1
395587,1,0,3,-3,6,1
273421,1,0,0,0,2,0
337291,1,0,7,-7,14,1
10584,1,0,7,-7,5,0
152560,4,24,14,10,17,0
80557,4,8,10,-2,3,1
140845,1,7,0,7,13,1
165920,1,0,7,-7,6,1
335384,1,0,0,0,13,0
320374,1,7,0,7,6,1
217310,2,0,7,-7,12,0
31106,1,0,0,0,15,0
243988,1,7,0,7,6,0
218000,2,21,10,11,12,0
237632,1,3,7,-4,4,1
93186,3,0,3,-3,9,0
5713,4,0,24,-24,3,1
222239,4,13,24,-11,14,0
40482,3,7,17,-10,2,0
235419,3,28,17,11,3,1
123584,1,0,0,0,4,1
22606,3,23,3,20,11,0
163316,4,13,16,-3,5,0
333919,1,0,7,-7,12,0
111867,4,16,10,6,17,0
99067,3,23,0,23,11,0
203107,4,42,17,25,5,1
267814,2,13,14,-1,17,0
182253,1,7,0,7,14,0
8809,3,19,0,19,4,0
153578,3,12,14,-2,1,0
293545,3,10,17,-7,11,1
29169,4,3,19,-16,14,0
338290,4,34,37,-3,14,0
383963,2,0,10,-10,1,1
189192,3,24,3,21,16,1
345807,1,0,7,-7,17,1
352994,3,20,10,10,3,1
220469,4,26,21,5,13,0
244549,3,25,13,12,7,0
153067,1,0,10,-10,1,1
14895,2,7,7,0,7,1
371235,4,22,19,3,12,0
125250,1,0,0,0,5,1
244144,1,0,0,0,6,0
203550,4,31,3,28,6,0
263001,2,7,0,7,15,0
225329,2,7,21,-14,15,1
344230,2,7,10,-3,17,1
114467,2,3,10,-7,1,1
239135,2,13,10,3,4,0
281040,3,17,13,4,6,1
217598,2,6,9,-3,12,1
191620,5,27,24,3,17,0
270784,1,0,0,0,1,1
187671,2,7,3,4,16,0
151374,4,31,14,17,17,1
365377,1,0,0,0,9,1
255624,2,0,7,-7,12,1
248164,2,6,10,-4,8,0
338003,1,0,0,0,14,1
199397,3,13,10,3,4,1
78021,3,9,16,-7,1,1
260524,3,27,0,27,14,1
97908,1,0,0,0,11,0
386825,3,13,14,-1,2,0
254212,4,3,31,-28,11,0
304574,4,31,31,0,16,0
232028,2,0,10,-10,1,0
397686,1,3,0,3,7,0
228325,2,0,7,-7,17,1
278871,4,21,31,-10,5,0
251249,3,10,24,-14,10,0
263983,4,23,7,16,15,1
225022,1,0,0,0,15,0
60493,2,20,7,13,11,1
174084,3,0,36,-36,10,1
336010,3,13,18,-5,13,1
31873,1,6,0,6,15,0
361525,3,10,7,3,7,1
96453,2,10,14,-4,10,0
140523,4,21,29,-8,12,1
159583,3,20,9,11,3,0
8278,1,0,0,0,4,1
183607,1,0,0,0,14,1
385540,2,0,3,-3,1,1
414656,1,0,0,0,14,1
410875,2,14,12,2,13,1
335258,2,0,3,-3,13,0
385403,2,14,7,7,1,1
277013,4,31,20,11,4,1
46355,3,6,17,-11,4,1
419346,4,3,17,-14,16,0
87479,4,26,17,9,6,0
47492,2,10,3,7,5,1
8071,3,17,7,10,4,1
293587,4,27,20,7,11,1
154873,2,3,3,0,1,1
8819,4,32,0,32,4,0
161273,3,20,3,17,4,1
166705,2,7,3,4,6,1
389887,1,6,3,3,3,0
271484,4,14,0,14,1,1
98206,1,0,0,0,11,1
26850,1,10,0,10,13,1
282330,1,7,0,7,6,0
158013,2,0,6,-6,3,0
122856,2,10,6,4,4,1
2508,2,3,0,3,2,0
124027,1,0,0,0,5,0
151395,4,34,14,20,17,0
257873,3,16,12,4,13,0
110249,1,0,3,-3,16,1
393769,4,7,14,-7,5,0
287634,3,3,10,-7,9,0
65954,4,24,21,3,13,0
33982,3,10,27,-17,16,0
128019,1,0,0,0,7,0
329738,1,3,0,3,11,0
20676,3,10,17,-7,10,1
322894,2,6,0,6,7,0
48839,2,3,0,3,5,1
305155,4,24,10,14,16,1
37437,1,0,0,0,17,0
105882,4,19,10,9,14,1
330082,2,0,3,-3,11,0
45268,2,0,0,0,4,1
326471,2,17,6,11,9,1
202310,3,13,3,10,5,0
106491,4,29,9,20,14,1
234499,3,20,20,0,2,0
252606,2,3,0,3,10,0
326823,3,10,14,-4,9,0
131930,1,0,0,0,8,1
153293,3,2,10,-8,1,0
246265,4,24,16,8,7,0
193876,3,24,7,17,1,1
314839,4,35,14,21,4,0
242192,3,16,7,9,6,1
26479,4,30,19,11,13,0
337555,4,7,33,-26,14,1
165917,1,0,7,-7,6,0
275342,4,10,16,-6,3,0
142484,3,14,10,4,13,1
416995,1,0,0,0,15,0
356198,3,19,0,19,5,1
41994,1,0,0,0,2,1
294832,3,35,21,14,12,0
321656,4,20,20,0,7,0
303437,2,16,7,9,16,1
370153,2,17,3,14,12,1
79914,3,3,16,-13,2,1
353757,4,20,17,3,4,0
85489,2,14,9,5,5,1
76685,4,16,7,9,1,0
49648,2,7,7,0,6,0
13484,3,6,27,-21,7,1
268759,2,24,3,21,17,0
142509,4,27,13,14,13,1
367605,4,28,12,16,10,1
411090,4,17,17,0,13,1
218282,2,7,14,-7,12,1
417231,3,17,20,-3,16,1
305216,1,14,7,7,16,0
265283,4,16,6,10,16,1
379444,2,13,0,13,16,1
39222,1,3,0,3,1,0
368579,3,9,0,9,11,1
412951,2,16,9,7,14,1
184809,3,17,20,-3,15,1
90735,2,14,7,7,7,0
349983,1,3,0,3,2,0
145352,4,42,26,16,14,0
247196,1,0,0,0,8,1
285224,1,0,3,-3,7,1
83467,4,10,23,-13,4,0
59473,2,3,17,-14,11,1
159447,4,20,23,-3,3,1
381085,3,17,14,3,16,1
335226,1,0,0,0,13,1
107422,1,0,3,-3,15,1
311877,1,7,0,7,2,0
370801,4,26,17,9,12,0
236638,2,3,0,3,3,1
36587,1,3,0,3,17,0
350058,3,20,13,7,2,0
109490,4,12,16,-4,16,1
105644,1,7,3,4,14,1
32817,2,6,7,-1,15,1
342929,4,23,17,6,16,1
72344,2,0,14,-14,16,0
90574,2,14,7,7,7,0
8472,2,15,3,12,4,1
1177,1,3,0,3,1,1
221878,2,6,7,-1,14,1
337272,4,16,26,-10,14,1
120453,4,19,19,0,3,0
151281,1,7,0,7,17,0
365395,2,7,6,1,9,1
113504,4,3,7,-4,17,0
278082,4,13,10,3,4,0
126306,1,0,7,-7,6,1
12248,2,0,3,-3,6,1
75178,4,13,6,7,17,1
400339,2,9,3,6,8,1
262018,3,24,24,0,14,0
293802,3,17,6,11,12,0
100529,4,17,20,-3,12,1
372896,2,16,0,16,13,0
249971,1,0,3,-3,9,1
211207,3,14,16,-2,9,0
347532,4,20,37,-17,1,1
330858,3,13,17,-4,11,1
337760,2,19,6,13,14,1
108512,2,14,7,7,15,0
358719,3,14,14,0,6,1
275764,3,16,3,13,3,1
409247,3,13,6,7,12,0
392871,4,17,23,-6,4,1
17007,4,34,23,11,8,0
223072,2,24,7,17,14,0
51837,1,0,0,0,7,0
356733,4,26,24,2,5,1
177205,1,0,0,0,11,1
359384,4,13,20,-7,6,0
390871,3,9,28,-19,3,1
350809,4,23,10,13,2,1
122447,3,6,26,-20,4,1
300126,2,7,3,4,14,1
275309,3,10,8,2,3,0
307120,1,0,0,0,17,0
353326,4,38,31,7,4,0
286153,4,24,24,0,8,1
263054,3,10,3,7,15,0
268173,3,9,17,-8,17,1
386918,2,7,14,-7,2,0
115481,4,45,28,17,1,1
317949,2,10,3,7,5,0
138689,3,12,28,-16,12,1
313832,1,7,3,4,3,0
205772,1,7,0,7,7,0
312429,4,26,41,-15,3,1
51304,2,9,10,-1,7,1
389623,2,10,7,3,3,0
170159,4,7,13,-6,8,1
302301,1,7,0,7,15,0
403601,2,17,10,7,9,0
107459,2,0,17,-17,15,1
141374,3,10,17,-7,13,0
379524,1,0,3,-3,16,0
225911,2,14,0,14,16,0
71817,4,38,33,5,16,1
351953,2,21,14,7,3,0
116344,4,40,13,27,1,1
187415,3,34,7,27,16,1
136374,1,0,0,0,11,1
135042,1,14,3,11,10,1
22541,1,3,0,3,11,1
90627,3,17,27,-10,7,0
173649,4,10,20,-10,10,1
281650,2,24,10,14,6,1
75383,1,7,0,7,17,0
33409,3,20,17,3,16,0
411215,4,11,23,-12,13,1
291307,3,21,22,-1,10,1
283645,4,23,20,3,7,0
252714,4,6,10,-4,10,1
21242,2,3,0,3,11,1
105185,1,7,0,7,14,1
70719,2,7,10,-3,15,1
266988,4,19,17,2,17,0
85605,1,7,0,7,5,0
54393,3,24,19,5,8,1
217995,2,14,10,4,12,1
258179,4,13,13,0,13,0
361878,1,0,0,0,7,1
168574,2,7,10,-3,7,1
21090,1,0,0,0,10,0
196568,3,17,6,11,2,1
180154,2,10,0,10,13,0
81334,1,0,0,0,3,0
305554,2,6,0,6,17,1
161003,3,16,7,9,4,0
314382,4,10,17,-7,3,0
160319,3,3,14,-11,4,1
316579,2,6,6,0,4,1
5049,2,7,0,7,3,1
352718,4,17,6,11,3,1
264402,2,3,21,-18,15,1
128699,4,13,20,-7,7,0
402692,2,3,0,3,9,1
141281,4,10,24,-14,13,0
318492,4,31,7,24,5,1
171264,1,0,0,0,9,0
178230,4,6,10,-4,12,0
368566,3,9,0,9,11,1
331679,1,0,0,0,12,0
12533,2,3,17,-14,6,1
317192,2,7,10,-3,5,0
291761,4,3,17,-14,11,1
197815,1,6,0,6,3,0
342695,2,0,0,0,16,0
25600,4,27,10,17,12,1
308874,4,10,13,-3,1,1
343508,3,7,10,-3,16,0
274227,2,17,0,17,3,0
18339,4,22,17,5,9,1
232341,3,6,12,-6,1,0
52776,1,0,20,-20,7,0
85927,2,7,14,-7,5,0
31135,1,3,10,-7,15,0
208335,2,17,24,-7,8,1
328023,3,17,9,8,10,0
24260,4,13,17,-4,12,0
94064,3,6,28,-22,9,1
334990,2,16,7,9,13,0
104360,3,45,31,14,13,0
318815,1,7,0,7,5,0
320026,4,43,30,13,6,0
226256,2,6,0,6,16,1
370861,2,3,3,0,12,1
398735,2,14,17,-3,7,0
295701,2,3,9,-6,12,0
156240,4,24,23,1,2,0
43101,4,3,17,-14,3,1
265192,2,6,3,3,16,0
310876,2,3,3,0,2,1
292180,3,21,7,14,11,0
309153,3,35,3,32,1,0
30725,3,17,21,-4,15,0
234805,2,0,3,-3,2,0
41645,3,17,0,17,2,0
156938,2,7,10,-3,2,0
119266,2,7,3,4,3,1
41811,3,19,14,5,2,1
86351,4,27,30,-3,5,1
389310,2,6,6,0,3,1
29619,4,14,21,-7,14,1
147787,1,0,7,-7,15,1
129206,2,14,6,8,7,0
209911,4,30,16,14,8,1
81612,4,30,24,6,3,0
180714,1,0,0,0,13,0
139106,2,9,6,3,12,1
76547,4,7,40,-33,1,0
231828,4,33,20,13,1,0
375902,2,14,3,11,14,0
341213,2,13,7,6,16,1
3344,4,3,6,-3,2,0
9269,1,7,0,7,5,1
66216,3,24,3,21,13,1
166321,4,10,9,1,6,1
113914,3,10,3,7,17,0
309615,4,16,3,13,1,1
268120,2,3,7,-4,17,1
53963,4,20,25,-5,8,1
25686,2,13,7,6,12,1
180858,5,20,20,0,13,1
384772,4,26,40,-14,1,0
10853,4,21,21,0,5,0
301240,4,27,17,10,15,0
380288,4,29,23,6,16,0
343871,4,26,6,20,17,1
244248,3,16,7,9,6,1
259000,3,3,16,-13,13,0
202302,3,13,3,10,5,0
395777,2,0,0,0,6,0
288207,2,3,7,-4,9,0
112911,3,16,6,10,17,1
365494,4,10,25,-15,9,1
81382,2,7,7,0,3,0
4428,4,14,14,0,2,1
43315,1,13,7,6,3,1
377438,4,7,13,-6,15,0
75427,2,10,7,3,17,1
225341,2,10,21,-11,15,0
245236,1,3,0,3,7,0
212468,3,10,3,7,10,0
222208,3,13,10,3,14,0
301868,1,0,0,0,15,0
160339,3,3,21,-18,4,0
7399,1,3,0,3,4,0
133399,1,0,7,-7,9,1
406124,4,3,26,-23,11,1
208838,4,12,25,-13,8,1
291147,3,18,13,5,10,0
76716,4,16,14,2,1,0
206747,4,7,24,-17,7,0
80676,4,17,26,-9,3,1
160626,2,7,0,7,4,0
113537,1,0,0,0,17,1
179154,4,12,13,-1,12,0
355297,3,14,17,-3,4,0
139131,3,12,6,6,12,0
391154,3,7,24,-17,4,1
95153,3,23,17,6,9,0
156248,4,24,23,1,2,1
362415,4,30,20,10,8,0
79740,2,17,7,10,2,0
100095,4,13,6,7,12,0
269190,2,3,3,0,17,1
11248,3,17,21,-4,6,0
388023,3,6,6,0,2,1
58953,4,20,32,-12,10,0
277288,4,0,16,-16,4,0
379088,4,7,12,-5,15,0
413579,3,9,17,-8,14,0
360187,3,17,13,4,7,1
218444,2,17,14,3,13,1
407202,1,0,0,0,11,0
229780,4,20,17,3,17,1
296419,1,7,0,7,13,1
172136,4,13,18,-5,9,1
348749,4,31,17,14,2,1
252877,1,0,0,0,11,1
148313,2,7,3,4,16,1
320933,4,13,21,-8,6,1
273505,3,14,13,1,2,0
27427,1,3,0,3,13,0
295000,4,31,14,17,12,0
98282,3,14,27,-13,11,0
329991,4,7,10,-3,11,0
210245,1,0,0,0,9,1
240076,4,20,27,-7,5,1
197055,1,0,0,0,3,0
217149,3,3,9,-6,12,0
45022,3,13,10,3,4,1
420669,3,21,16,5,17,0
363865,4,13,26,-13,8,0
407512,1,3,0,3,11,0
322668,4,6,9,-3,7,0
81594,4,17,24,-7,3,0
322375,3,14,16,-2,7,0
158607,2,7,7,0,3,0
109351,1,0,7,-7,16,1
148866,1,0,0,0,16,1
305786,1,0,0,0,17,0
414874,3,21,7,14,15,0
229863,3,13,7,6,17,0
323600,1,6,0,6,8,1
133964,4,16,13,3,9,1
334328,1,0,0,0,13,0
323789,2,6,3,3,8,1
359435,1,0,7,-7,6,1
7912,3,3,20,-17,4,0
328776,3,17,13,4,10,1
266559,4,10,22,-12,16,1
259782,4,20,10,10,14,0
391369,1,0,3,-3,4,1
345457,4,3,22,-19,17,1
376949,2,3,13,-10,15,1
294349,2,10,3,7,12,1
192262,2,10,3,7,1,0
314779,2,21,0,21,4,0
127534,4,3,23,-20,6,0
135411,4,28,17,11,10,0
110816,4,6,10,-4,16,1
361350,2,3,0,3,7,0
61946,1,0,0,0,12,1
47708,3,3,17,-14,5,1
393095,3,10,3,7,4,1
91124,1,0,7,-7,8,1
158413,4,16,27,-11,3,1
99704,1,0,0,0,12,1
178758,1,14,7,7,12,1
14165,2,0,21,-21,7,0
283582,2,12,17,-5,7,1
47921,1,0,0,0,5,1
323170,1,0,0,0,7,0
333717,4,21,0,21,12,0
57466,2,14,3,11,10,0
156058,4,20,24,-4,2,1
134457,2,3,20,-17,10,1
127622,3,17,9,8,6,1
170532,1,14,0,14,8,0
216928,1,0,0,0,12,1
35994,4,6,27,-21,17,0
257132,4,24,21,3,12,0
3318,3,3,6,-3,2,1
193302,4,10,23,-13,1,0
347771,2,7,0,7,1,0
127237,5,16,16,0,6,0
373041,2,0,0,0,13,1
31142,2,3,13,-10,15,1
6701,3,3,20,-17,3,0
202884,3,21,0,21,5,0
41795,3,10,14,-4,2,1
323997,3,17,16,1,8,1
203450,2,7,3,4,6,0
165668,2,7,7,0,6,0
158747,1,0,0,0,3,0
415359,4,14,24,-10,15,0
80163,2,7,7,0,2,0
303858,1,0,6,-6,16,0
318063,1,2,0,2,5,1
190467,1,7,0,7,17,0
326040,2,9,0,9,9,1
15075,3,10,26,-16,7,0
111448,4,0,20,-20,16,1
115943,1,0,0,0,1,0
104313,2,31,21,10,13,1
71798,4,38,33,5,16,0
161182,4,3,36,-33,4,1
60281,4,17,16,1,11,0
250248,1,0,0,0,9,0
109615,4,25,14,11,16,0
13097,1,0,0,0,6,1
104476,2,14,16,-2,13,0
392527,3,3,20,-17,4,1
118421,3,20,10,10,2,0
42523,3,10,21,-11,3,1
364396,2,28,7,21,9,1
62629,3,9,17,-8,12,0
380434,4,10,24,-14,16,1
373787,1,0,0,0,13,0
172262,4,21,13,8,9,1
320777,4,17,23,-6,6,1
143763,2,3,0,3,14,0
101518,2,10,13,-3,12,0
268482,3,23,9,14,17,1
167337,2,16,16,0,7,1
265271,4,9,6,3,16,0
396259,2,3,3,0,6,0
166882,2,7,3,4,6,1
204900,3,10,13,-3,6,0
391334,4,24,3,21,4,0
329871,1,0,0,0,11,0
420593,1,0,10,-10,17,0
279270,3,19,13,6,5,0
395478,2,7,0,7,6,1
74457,1,0,0,0,17,1
282025,4,31,28,3,6,0
112931,4,19,6,13,17,0
406119,4,0,26,-26,11,1
410804,4,22,6,16,13,0
189103,4,31,30,1,16,0
392057,4,10,24,-14,4,1
158229,3,31,0,31,3,0
247038,1,0,0,0,8,0
102055,3,21,10,11,12,1
304644,2,14,7,7,16,1
50068,1,0,7,-7,6,1
279710,3,23,6,17,5,0
157347,1,0,0,0,2,1
415831,1,0,13,-13,15,1
191445,4,0,34,-34,17,0
258345,4,41,39,2,13,1
277917,4,7,20,-13,4,0
94633,2,14,19,-5,9,1
226727,2,7,6,1,16,0
372203,4,9,16,-7,13,0
381425,4,23,7,16,16,0
291810,1,0,0,0,11,0
9471,3,10,3,7,5,1
388298,2,10,3,7,2,0
338169,1,7,7,0,14,0
421451,4,38,20,18,17,1
295978,1,0,0,0,13,0
303377,1,6,0,6,16,1
220337,1,0,0,0,13,1
58705,2,7,10,-3,10,1
256264,2,6,10,-4,12,0
256064,1,0,3,-3,12,1
229278,3,24,21,3,17,1
324538,2,7,9,-2,8,1
267346,1,0,7,-7,17,1
152797,3,7,7,0,17,1
90233,1,0,0,0,7,0
409139,4,3,17,-14,12,0
32609,1,0,0,0,15,1
172633,1,0,0,0,9,1
335779,4,24,14,10,13,0
369773,4,45,43,2,11,1
109642,4,37,14,23,16,1
58181,1,0,0,0,10,1
266120,4,17,13,4,16,0
76065,3,10,16,-6,1,0
47519,2,23,6,17,5,1
283114,2,3,0,3,7,0
153888,3,7,3,4,1,1
24666,2,17,0,17,12,0
102478,3,17,3,14,13,1
131510,2,3,6,-3,8,1
41749,2,0,7,-7,2,1
416640,3,31,7,24,15,0
247055,1,0,3,-3,8,1
58695,1,7,7,0,10,0
399856,1,0,0,0,8,0
251240,3,10,24,-14,10,1
335283,2,3,6,-3,13,1
6899,1,0,0,0,3,1
78996,2,3,7,-4,2,0
164008,1,0,3,-3,5,0
74613,1,0,0,0,17,0
12036,4,27,14,13,6,1
98947,4,7,17,-10,11,0
244647,2,0,17,-17,7,1
415370,4,21,24,-3,15,0
390034,1,0,0,0,3,1
375551,4,33,14,19,14,1
107447,2,0,10,-10,15,1
303080,1,0,7,-7,16,1
350021,2,13,7,6,2,0
205227,4,20,13,7,6,1
356320,2,17,0,17,5,0
239637,4,23,20,3,4,0
170743,3,24,6,18,8,0
226102,2,7,14,-7,16,1
311467,2,10,3,7,2,0
355416,2,10,10,0,4,1
21024,4,14,31,-17,10,1
209007,1,3,0,3,8,0
155758,4,27,23,4,2,0
184503,2,14,14,0,14,1
311911,2,14,7,7,2,1
29488,4,10,14,-4,14,1
246818,4,10,20,-10,8,0
7437,2,20,3,17,4,0
193262,3,3,17,-14,1,0
143723,4,19,17,2,14,0
378597,3,17,13,4,15,1
196775,1,0,6,-6,3,0
238029,3,10,13,-3,4,1
212969,3,14,7,7,10,1
146154,1,0,0,0,15,0
199837,3,3,17,-14,4,0
281952,2,14,14,0,6,0
238327,2,3,9,-6,4,0
249293,4,33,17,16,9,1
302915,1,13,0,13,16,0
365020,3,17,6,11,9,1
421472,1,0,0,0,17,1
30418,2,10,13,-3,14,0
379597,3,16,13,3,16,1
420218,4,3,10,-7,17,1
231517,4,23,29,-6,1,1
121454,1,0,0,0,4,1
385115,2,7,9,-2,1,0
197949,1,0,0,0,3,0
330116,3,0,13,-13,11,1
158849,4,23,3,20,3,0
122904,4,34,6,28,4,0
249675,2,11,7,4,9,0
86210,1,0,7,-7,5,1
312672,2,28,7,21,3,0
290368,2,13,3,10,10,1
279717,3,23,6,17,5,1
227007,2,10,6,4,16,0
167216,3,23,17,6,7,1
141002,2,7,0,7,13,0
2935,1,7,7,0,2,0
136344,4,18,14,4,11,1
133628,3,10,14,-4,9,1
51111,1,7,0,7,7,0
130161,2,0,16,-16,8,1
408480,3,7,3,4,12,0
284438,2,7,9,-2,7,0
268398,1,7,0,7,17,0
384922,4,13,43,-30,1,0
320609,4,31,6,25,6,0
61475,1,0,0,0,11,0
2572,3,10,17,-7,2,1
282506,2,14,3,11,6,1
84178,3,10,7,3,4,0
301763,2,0,24,-24,15,0
377229,2,7,0,7,15,0
290482,2,14,0,14,10,0
398902,3,10,10,0,7,1
346509,2,17,30,-13,1,1
336063,4,16,31,-15,13,1
214142,3,3,6,-3,11,0
255901,1,3,0,3,12,0
335411,2,7,3,4,13,0
144909,3,20,7,13,14,0
131023,4,17,30,-13,8,1
10606,2,0,10,-10,5,0
288151,4,19,7,12,9,0
367418,3,17,14,3,10,1
340046,3,17,12,5,15,1
197695,2,7,3,4,3,1
13215,4,22,26,-4,6,1
113684,1,0,7,-7,17,1
91611,2,7,7,0,8,1
82257,1,0,0,0,3,0
204941,4,13,27,-14,6,0
272663,1,9,0,9,2,0
251079,2,10,14,-4,10,0
233950,4,24,13,11,2,0
38277,4,13,14,-1,1,1
76335,2,13,3,10,1,1
215065,3,13,7,6,11,1
25795,1,0,0,0,12,1
27044,3,10,3,7,13,1
353288,3,31,20,11,4,0
420372,4,20,13,7,17,1
380488,1,0,14,-14,16,1
228636,2,13,14,-1,17,1
1881,4,22,16,6,1,0
412196,3,14,3,11,13,0
366640,1,7,0,7,10,0
15099,4,10,26,-16,7,0
172367,2,10,21,-11,9,0
17639,1,7,3,4,9,1
303355,4,41,3,38,16,0
88713,1,0,0,0,6,1
273690,4,22,13,9,2,0
70060,4,31,17,14,15,1
335461,3,13,9,4,13,0
58161,4,23,17,6,10,1
106340,3,14,19,-5,14,1
236667,2,10,7,3,3,1
234163,2,3,7,-4,2,0
13741,2,0,17,-17,7,1
44027,4,3,28,-25,3,1
56855,1,0,0,0,9,0
338304,1,0,0,0,14,0
416861,1,0,0,0,15,1
343838,3,24,3,21,17,1
26220,1,0,7,-7,13,1
232622,2,0,0,0,1,0
191237,2,7,17,-10,17,0
71946,4,22,13,9,16,0
365207,4,14,38,-24,9,1
201533,4,32,14,18,5,1
261421,4,10,24,-14,14,1
201946,2,0,0,0,5,0
115529,2,0,3,-3,1,1
30979,1,0,0,0,15,0
112920,4,16,6,10,17,0
199978,2,17,10,7,4,0
224138,2,0,20,-20,15,0
337943,3,19,0,19,14,1
359872,2,20,20,0,6,0
248962,4,20,3,17,9,1
81899,3,0,30,-30,3,1
190322,1,0,0,0,17,0
363761,4,29,27,2,8,1
200240,1,0,0,0,4,1
91472,2,12,0,12,8,0
190807,2,13,3,10,17,1
183966,3,20,3,17,14,1
349834,1,0,3,-3,2,1
157836,1,6,9,-3,3,0
8023,2,9,7,2,4,1
278298,2,14,0,14,4,0
297239,3,14,6,8,13,0
372410,1,6,7,-1,13,1
326147,1,0,7,-7,9,1
182210,4,33,7,26,13,0
96205,3,3,19,-16,10,1
94223,4,24,24,0,9,1
178085,5,23,23,0,12,1
380341,2,7,7,0,16,1
313188,3,20,16,4,3,1
136239,1,9,7,2,11,1
165610,1,0,0,0,6,0
184292,4,34,14,20,14,0
266014,1,7,0,7,16,0
172309,5,24,23,1,9,1
306878,2,0,13,-13,17,1
351024,2,7,7,0,3,0
151671,4,23,40,-17,17,0
401039,1,0,0,0,8,1
321956,4,28,28,0,7,0
255699,4,3,10,-7,12,0
46861,2,10,3,7,5,1
413012,4,16,18,-2,14,1
351723,4,21,17,4,3,0
184154,4,16,14,2,14,0
231543,5,33,29,4,1,0
92267,2,10,0,10,8,0
213571,4,10,14,-4,10,1
237681,3,20,7,13,4,0
347909,2,0,13,-13,1,0
283461,3,23,14,9,7,1
394090,4,22,23,-1,5,1
330420,4,13,20,-7,11,1
403093,5,34,34,0,9,1
18028,4,22,28,-6,9,0
382332,1,0,0,0,17,1
56119,2,17,14,3,9,1
315589,1,0,0,0,4,1
274587,4,24,26,-2,3,1
4205,2,10,6,4,2,0
323320,1,0,0,0,7,0
11057,2,10,7,3,5,1
393321,1,0,0,0,5,1
120855,2,7,14,-7,3,1
335566,2,6,7,-1,13,1
169816,3,3,17,-14,8,1
333699,3,21,0,21,12,1
74934,2,10,6,4,17,0
148564,1,0,0,0,16,0
175450,4,20,23,-3,11,1
113015,3,10,13,-3,17,1
395385,3,28,3,25,5,1
162021,2,14,6,8,4,0
252905,2,6,0,6,11,0
136529,1,0,10,-10,11,1
46140,1,7,7,0,4,0
50120,2,0,17,-17,6,1
376052,2,0,0,0,14,0
96784,4,7,10,-3,10,0
259071,1,0,0,0,13,0
329149,1,0,0,0,10,1
181031,1,7,0,7,13,0
285620,4,20,17,3,8,0
139779,1,0,0,0,12,0
60811,2,10,13,-3,11,0
170074,1,0,0,0,8,1
207933,4,35,21,14,8,1
39235,2,3,3,0,1,0
321576,2,10,6,4,7,0
367189,4,29,23,6,10,1
84176,3,10,7,3,4,0
345826,1,0,7,-7,17,1
206579,3,10,13,-3,7,1
320519,1,7,0,7,6,0
288376,2,7,0,7,9,1
146506,2,7,7,0,15,0
178105,5,26,26,0,12,1
107462,2,0,17,-17,15,1
133844,1,0,0,0,9,1
338917,1,3,0,3,15,0
77034,1,7,7,0,1,1
260441,1,0,0,0,14,1
348112,4,10,19,-9,1,0
299258,2,17,0,17,14,1
3664,4,20,28,-8,2,0
37702,4,37,0,37,17,1
345908,3,17,23,-6,17,0
284462,2,7,12,-5,7,1
241487,1,0,0,0,5,1
123148,2,3,7,-4,4,0
98657,4,14,10,4,11,0
292908,3,7,0,7,11,1
203851,4,31,31,0,6,1
149042,1,0,7,-7,16,0
169549,3,10,34,-24,8,0
136687,1,0,7,-7,11,0
23082,4,10,17,-7,11,0
369664,1,13,0,13,11,0
364733,3,6,3,3,9,0
6762,1,0,0,0,3,0
241905,4,20,20,0,5,1
3153,3,10,9,1,2,1
272628,4,19,12,7,2,1
414954,1,7,7,0,15,1
68357,2,3,13,-10,14,0
266890,1,0,0,0,17,0
163391,2,0,6,-6,5,1
257073,3,7,14,-7,12,1
171214,4,9,14,-5,8,0
407250,2,7,16,-9,11,0
35911,2,3,0,3,17,0
367572,3,14,9,5,10,1
392329,2,7,21,-14,4,1
240137,2,13,3,10,5,1
44052,1,0,0,0,3,0
306349,4,24,10,14,17,1
412692,4,30,10,20,14,1
78031,4,12,16,-4,1,0
235013,4,16,17,-1,2,1
34187,4,17,10,7,16,0
46161,2,7,14,-7,4,0
334852,3,16,3,13,13,1
128828,3,13,13,0,7,1
326927,2,2,0,2,9,0
81342,1,0,7,-7,3,0
397854,2,0,0,0,7,0
403778,3,12,16,-4,9,1
238051,4,13,13,0,4,1
338675,3,13,10,3,14,0
37406,4,24,0,24,17,1
380574,4,21,27,-6,16,1
123135,2,3,7,-4,4,1
372251,1,10,0,10,13,0
268385,1,0,0,0,17,1
369466,4,45,7,38,11,1
183221,2,7,13,-6,14,0
250008,2,10,6,4,9,1
128995,4,35,10,25,7,0
298211,2,7,3,4,14,1
79812,4,28,21,7,2,1
393944,1,0,0,0,5,1
72990,1,0,0,0,16,0
86359,1,0,0,0,5,0
296779,2,7,0,7,13,0
232715,4,20,3,17,1,0
68681,3,17,0,17,15,0
181447,4,24,24,0,13,0
162286,1,0,0,0,4,1
259329,3,13,20,-7,13,0
159815,1,0,0,0,3,1
78327,4,24,21,3,2,0
391143,2,7,24,-17,4,0
328643,3,20,35,-15,10,1
121523,3,9,7,2,4,1
164792,4,26,21,5,6,1
18515,4,20,21,-1,9,1
261684,2,14,0,14,14,0
272862,2,20,7,13,2,0
174820,2,13,17,-4,10,1
94299,2,3,0,3,9,0
418767,3,14,21,-7,16,0
273151,2,10,0,10,2,0
19390,1,0,7,-7,10,1
394035,3,9,13,-4,5,0
52134,1,0,0,0,7,1
53115,3,19,24,-5,7,0
399085,3,10,26,-16,7,0
202650,4,34,20,14,5,0
221508,1,6,0,6,14,0
137675,1,0,13,-13,11,1
65099,1,0,0,0,13,0
144766,4,3,17,-14,14,1
245114,2,14,6,8,7,1
343396,4,6,34,-28,16,1
234941,2,10,3,7,2,1
99131,1,0,0,0,11,0
386968,3,7,21,-14,2,0
409949,2,3,14,-11,12,0
36406,4,20,26,-6,17,1
417841,2,10,0,10,16,0
261530,3,12,0,12,14,0
414428,3,7,23,-16,14,0
146044,2,10,0,10,15,0
356145,2,10,0,10,5,0
214973,1,0,0,0,11,1
399538,4,0,33,-33,7,1
157679,1,0,3,-3,2,1
320073,1,3,0,3,6,1
51926,3,13,10,3,7,1
111641,2,14,10,4,16,1
411631,3,20,28,-8,13,0
59286,1,0,0,0,11,0
13310,3,7,20,-13,7,0
363332,1,0,0,0,8,0
342725,2,0,7,-7,16,0
132020,4,3,24,-21,8,0
5398,3,13,13,0,3,0
155019,1,6,12,-6,1,0
31016,2,3,3,0,15,0
87101,2,7,0,7,5,0
72164,1,3,3,0,16,0
108121,4,13,35,-22,15,0
361435,4,17,24,-7,7,1
330113,3,0,13,-13,11,1
171609,2,6,3,3,9,0
19748,3,9,9,0,10,0
84101,1,0,0,0,4,1
271108,1,0,7,-7,1,0
152329,2,7,3,4,17,1
317936,2,7,3,4,5,1
121680,2,14,7,7,4,1
394856,1,0,14,-14,5,0
70993,2,3,0,3,16,1
361096,4,23,9,14,7,0
413811,1,14,0,14,14,0
303457,3,19,10,9,16,1
221377,1,0,17,-17,14,0
120893,3,21,24,-3,3,0
309908,4,24,21,3,1,0
26602,3,10,6,4,13,1
48016,3,10,24,-14,5,0
357037,1,0,0,0,5,1
156934,2,7,10,-3,2,0
207832,1,0,0,0,8,1
51718,2,0,10,-10,7,0
177149,4,37,13,24,11,1
165329,1,0,0,0,6,1
263607,2,14,7,7,15,0
47669,2,3,17,-14,5,0
74838,3,20,13,7,17,0
153456,4,20,17,3,1,0
338208,2,14,21,-7,14,0
186646,3,24,3,21,15,1
87086,1,0,0,0,5,0
214032,4,43,7,36,10,0
259900,2,14,10,4,14,0
87651,1,0,0,0,6,0
137394,2,3,21,-18,11,1
31251,1,0,0,0,15,0
190109,3,27,3,24,17,0
377418,3,7,13,-6,15,1
151443,2,21,0,21,17,0
171390,4,16,20,-4,9,1
339653,4,31,24,7,15,0
307392,4,23,25,-2,17,0
23674,4,7,27,-20,12,0
96446,2,10,14,-4,10,0
330184,1,0,0,0,11,1
7061,1,7,7,0,4,0
292712,1,7,7,0,11,1
230328,4,19,10,9,17,0
205847,3,20,0,20,7,0
215882,1,3,7,-4,11,1
386002,1,0,0,0,1,1
24618,4,17,26,-9,12,0
286794,4,20,31,-11,8,1
84011,3,20,3,17,4,1
76273,4,19,27,-8,1,1
221326,4,6,35,-29,14,1
154733,2,3,10,-7,1,1
333634,1,0,0,0,12,0
24246,3,13,17,-4,12,1
170503,4,21,18,3,8,1
289515,4,21,7,14,10,1
164925,3,0,6,-6,6,1
35300,2,6,0,6,16,1
224570,1,3,7,-4,15,1
359356,3,3,20,-17,6,0
125455,2,13,0,13,5,0
200043,4,24,20,4,4,0
212518,4,13,16,-3,10,0
157058,1,0,0,0,2,1
278859,4,14,31,-17,5,1
318353,4,9,22,-13,5,1
181211,2,0,0,0,13,1
118159,4,31,27,4,2,0
157547,2,0,0,0,2,1
372963,4,25,7,18,13,1
68480,2,0,7,-7,14,0
267691,3,14,24,-10,17,1
397954,4,10,17,-7,7,0
366696,2,17,10,7,10,1
198895,1,3,13,-10,3,0
2761,1,0,0,0,2,0
120331,4,24,13,11,3,0
258253,2,7,6,1,13,1
52180,2,0,3,-3,7,1
283002,3,14,3,11,6,1
22655,4,30,16,14,11,0
300463,2,16,0,16,14,1
62794,4,17,0,17,12,1
42380,3,14,9,5,2,0
111428,4,0,20,-20,16,0
76027,2,10,13,-3,1,0
279452,4,16,30,-14,5,1
167995,2,3,14,-11,7,0
290031,2,7,3,4,10,1
112977,2,7,0,7,17,0
83865,3,23,3,20,4,0
408309,2,0,7,-7,12,1
413595,3,9,17,-8,14,1
109999,2,17,10,7,16,1
368620,4,16,13,3,11,1
333914,1,0,7,-7,12,0
121012,2,8,21,-13,3,0
207534,1,7,0,7,7,0
119923,2,6,14,-8,3,0
327262,3,9,13,-4,9,1
369948,1,6,0,6,12,1
239633,4,20,20,0,4,1
144747,3,3,7,-4,14,0
391120,2,7,17,-10,4,1
146504,2,7,7,0,15,0
239575,3,13,10,3,4,1
230411,2,14,0,14,1,0
147187,1,0,0,0,15,0
19943,1,0,0,0,10,0
158825,3,20,3,17,3,0
87661,1,0,7,-7,6,0
390757,4,13,20,-7,3,1
310868,1,3,3,0,2,1
300148,2,21,3,18,14,0
401819,2,7,14,-7,9,1
331803,4,23,30,-7,12,1
202687,1,0,7,-7,5,1
415807,4,27,37,-10,15,1
231238,4,10,16,-6,1,0
57218,4,20,7,13,10,0
268285,2,10,3,7,17,1
370303,3,7,35,-28,12,0
24092,3,7,7,0,12,0
46672,4,10,3,7,4,0
27041,3,10,3,7,13,1
311964,3,35,10,25,2,0
251782,1,0,0,0,10,0
207966,1,7,0,7,8,0
70723,2,7,10,-3,15,1
44286,3,17,20,-3,3,1
159315,4,27,24,3,3,1
255213,3,13,14,-1,12,0
359271,1,0,6,-6,6,0
185797,4,25,3,22,15,0
345888,2,10,17,-7,17,0
338318,1,3,0,3,14,0
415619,3,23,13,10,15,1
253070,2,14,0,14,11,0
249290,4,33,17,16,9,1
126875,3,17,6,11,6,0
237805,2,0,10,-10,4,0
227456,2,13,7,6,16,0
396671,2,7,7,0,6,0
387983,2,3,3,0,2,1
132292,3,24,7,17,9,0
268357,4,20,6,14,17,0
83905,4,23,17,6,4,0
236884,1,12,0,12,3,1
382535,3,0,10,-10,17,0
364896,4,13,20,-7,9,0
319930,2,23,7,16,6,0
65697,1,0,10,-10,13,1
105650,1,7,3,4,14,0
369072,1,0,0,0,11,1
407645,4,10,17,-7,11,1
188077,1,0,3,-3,16,0
229208,1,0,0,0,17,1
6880,4,10,31,-21,3,1
314047,2,9,7,2,3,1
381607,1,0,0,0,17,1
371882,3,24,10,14,12,1
287595,1,0,3,-3,9,1
117265,4,33,24,9,2,0
250284,2,7,0,7,9,1
256874,2,7,3,4,12,0
198492,3,17,3,14,3,0
8147,1,0,7,-7,4,0
306314,2,23,7,16,17,1
116976,1,0,0,0,2,0
80865,4,6,13,-7,3,0
62121,2,7,7,0,12,1
129917,4,13,0,13,7,1
403791,4,15,22,-7,9,0
87684,2,0,17,-17,6,1
112597,3,31,26,5,17,0
11512,3,6,10,-4,6,1
417808,2,7,0,7,16,1
276166,2,17,0,17,3,0
194523,4,26,10,16,2,1
266125,4,17,13,4,16,1
18188,4,20,20,0,9,1
12028,4,27,14,13,6,0
102325,3,13,10,3,13,1
125529,4,30,7,23,5,0
46235,4,14,31,-17,4,1
63394,1,0,0,0,12,0
122670,1,0,3,-3,4,1
379828,1,0,0,0,16,1
255355,2,14,3,11,12,0
202768,4,16,17,-1,5,1
409676,2,10,3,7,12,0
139141,3,12,6,6,12,1
63780,3,14,24,-10,12,1
227829,4,6,35,-29,16,1
92881,3,24,0,24,8,1
412975,3,16,12,4,14,1
353961,5,31,31,0,4,1
121402,4,7,6,1,3,0
175987,2,14,0,14,11,0
156044,3,20,24,-4,2,1
336531,2,0,0,0,14,0
127385,4,17,23,-6,6,1
377755,4,39,7,32,15,0
142406,1,7,0,7,13,0
357714,3,33,13,20,5,0
114067,2,21,0,21,17,0
412903,1,0,0,0,14,0
339106,2,10,0,10,15,0
91181,3,10,17,-7,8,1
339227,1,7,0,7,15,0
103636,2,0,7,-7,13,0
260495,2,13,0,13,14,1
20398,4,10,13,-3,10,0
27399,4,24,10,14,13,1
253158,4,21,23,-2,11,1
29885,3,16,23,-7,14,0
250669,3,10,22,-12,10,1
171916,2,7,7,0,9,1
175852,2,20,24,-4,11,0
308820,2,3,3,0,1,0
210246,1,0,0,0,9,1
293415,4,22,17,5,11,1
231603,2,14,10,4,1,1
12059,1,7,0,7,6,0
124574,3,6,14,-8,5,1
201507,3,25,7,18,5,1
223717,3,37,13,24,15,0
278021,2,10,10,0,4,0
77630,2,0,7,-7,1,0
144999,2,3,3,0,14,0
367497,1,0,0,0,10,0
217186,4,12,16,-4,12,0
5294,4,24,31,-7,3,0
140019,4,28,10,18,12,0
366542,2,20,7,13,10,0
310547,1,0,0,0,2,0
237307,1,0,0,0,3,0
407590,3,10,17,-7,11,1
177704,2,13,14,-1,12,0
333107,4,20,24,-4,12,1
203412,1,0,0,0,6,0
177066,1,3,3,0,11,0
15077,3,10,26,-16,7,0
58174,4,29,17,12,10,1
114427,4,41,20,21,1,0
89444,4,17,20,-3,7,1
406175,1,7,0,7,11,0
321292,3,9,13,-4,6,0
393894,4,20,17,3,5,0
304225,3,33,7,26,16,0
347176,4,23,17,6,1,0
38682,3,14,7,7,1,0
384032,4,20,23,-3,1,0
217980,2,14,3,11,12,0
53625,4,14,22,-8,8,1
70624,3,17,17,0,15,1
144500,1,0,0,0,14,0
345734,3,10,7,3,17,0
19330,3,14,17,-3,10,0
36002,1,0,0,0,17,1
126508,2,0,6,-6,6,1
302063,2,13,24,-11,15,1
407333,4,23,26,-3,11,1
110990,4,7,20,-13,16,1
287424,1,7,0,7,9,0
130636,2,7,21,-14,8,1
103007,1,0,0,0,13,0
215523,4,13,3,10,11,1
53302,4,10,10,0,8,1
33953,2,0,27,-27,16,1
232736,1,0,0,0,2,1
412780,2,14,10,4,14,0
162231,3,20,20,0,4,1
248757,2,27,7,20,9,0
315448,1,0,0,0,4,0
267511,2,13,14,-1,17,0
66766,2,7,6,1,14,1
239369,1,0,7,-7,4,1
268682,4,27,20,7,17,1
148038,3,7,3,4,15,0
206426,3,10,0,10,7,0
368455,4,30,21,9,11,0
100269,1,0,0,0,12,1
375537,4,33,14,19,14,0
353541,2,17,0,17,4,0
264439,3,10,28,-18,15,1
25373,2,6,0,6,12,0
261406,3,10,17,-7,14,0
370740,2,12,7,5,12,1
79150,2,3,0,3,2,0
280884,3,16,3,13,6,1
143848,4,12,7,5,14,1
316051,1,3,0,3,4,0
260790,2,3,6,-3,14,1
178615,2,3,3,0,12,1
167471,2,0,0,0,7,0
117144,1,6,3,3,2,1
408946,3,24,15,9,12,0
122715,2,7,17,-10,4,1
28994,3,7,7,0,14,0
379202,3,9,13,-4,16,1
37075,3,13,14,-1,17,1
73290,1,0,0,0,17,1
177644,1,0,0,0,12,1
307112,4,24,6,18,17,1
395351,2,14,3,11,5,1
317319,2,0,0,0,5,0
44802,1,0,0,0,4,0
2821,2,21,24,-3,2,1
354769,2,6,17,-11,4,1
178943,2,6,3,3,12,1
13091,4,21,14,7,6,0
271772,3,30,10,20,2,0
160253,1,0,0,0,4,0
241442,4,7,35,-28,5,1
256617,3,21,0,21,12,0
100792,2,6,3,3,12,1
36322,2,7,7,0,17,0
74184,1,3,0,3,17,0
343481,2,7,7,0,16,1
281047,3,17,13,4,6,0
264614,4,12,17,-5,16,0
388040,3,20,6,14,2,0
312416,4,26,34,-8,3,0
42003,1,3,0,3,2,1
347190,4,23,24,-1,1,0
36584,1,3,0,3,17,0
217754,3,10,7,3,12,1
296769,2,7,0,7,13,0
281777,2,3,0,3,6,0
208848,1,0,0,0,8,1
332320,3,13,6,7,12,0
9983,4,3,3,0,5,1
121818,2,0,7,-7,4,1
202071,1,0,0,0,5,0
69396,2,7,3,4,15,1
85418,1,0,0,0,5,0
92950,1,0,0,0,8,1
290945,2,17,7,10,10,0
356731,4,26,24,2,5,1
233646,4,23,41,-18,2,0
411808,3,0,34,-34,13,0
103235,3,3,7,-4,13,0
41198,3,0,7,-7,2,1
198422,2,3,3,0,3,1
153549,2,5,14,-9,1,1
67558,1,0,0,0,14,0
69483,4,31,17,14,15,0
129879,3,13,0,13,7,1
152970,3,35,17,18,1,1
261083,2,0,14,-14,14,1
187368,2,20,7,13,16,0
7906,3,3,17,-14,4,0
62140,3,7,7,0,12,0
107818,4,7,23,-16,15,1
72019,2,0,10,-10,16,1
380756,1,3,7,-4,16,1
86348,4,27,30,-3,5,1
338774,1,7,0,7,15,0
30148,2,10,10,0,14,0
68182,2,7,7,0,14,0
153571,3,12,14,-2,1,1
415846,2,7,13,-6,15,0
330779,1,0,0,0,11,0
313812,1,0,0,0,3,1
28297,4,27,14,13,13,0
320700,2,14,17,-3,6,1
355881,3,13,10,3,5,1
383442,4,13,12,1,17,1
355546,2,14,0,14,5,0
192219,4,3,33,-30,1,1
297827,3,14,7,7,13,0
162620,1,0,10,-10,5,1
291854,2,0,7,-7,11,0
233300,3,7,17,-10,2,0
318887,3,21,15,6,5,0
211327,2,10,3,7,9,1
308124,3,13,19,-6,1,1
294030,2,7,7,0,12,0
361657,3,7,22,-15,7,1
173825,4,20,3,17,10,0
89018,1,0,0,0,6,1
194087,1,0,0,0,1,1
148984,4,13,12,1,16,1
307066,3,24,6,18,17,0
161192,1,0,0,0,4,1
206037,1,0,0,0,7,0
191873,3,22,10,12,1,1
11600,5,20,19,1,6,1
390677,2,3,3,0,3,1
215548,4,13,6,7,11,1
18019,4,16,21,-5,9,0
85051,3,31,16,15,4,0
295145,4,10,14,-4,12,0
213840,3,45,0,45,10,0
372329,3,24,17,7,13,1
187799,1,7,0,7,16,0
87771,4,6,20,-14,6,1
33412,3,20,20,0,16,1
135991,2,3,10,-7,10,1
258801,1,7,7,0,13,1
184673,3,10,24,-14,15,0
197839,1,6,0,6,3,0
264502,1,0,7,-7,16,1
264493,1,0,0,0,16,0
62680,1,0,0,0,12,1
231593,2,14,3,11,1,0
112636,4,38,34,4,17,0
398727,2,0,17,-17,7,1
91986,3,13,23,-10,8,1
323464,1,0,3,-3,7,0
159592,3,20,12,8,3,1
196664,2,27,0,27,3,0
414908,4,41,13,28,15,1
65895,2,7,14,-7,13,1
412905,1,0,3,-3,14,0
143794,2,3,0,3,14,1
403335,3,12,0,12,9,0
43558,3,24,3,21,3,0
52642,2,3,7,-4,7,0
391300,3,17,3,14,4,1
372990,1,0,0,0,13,0
351375,3,10,10,0,3,0
144644,4,26,22,4,14,1
114317,1,7,6,1,1,1
179242,2,23,3,20,12,1
252128,2,7,10,-3,10,1
177817,2,6,3,3,12,1
21273,2,3,7,-4,11,0
330453,4,20,20,0,11,0
397407,2,0,10,-10,6,0
286442,3,17,3,14,8,0
184581,4,45,21,24,14,0
16821,4,20,24,-4,8,0
156552,4,14,6,8,2,0
53804,5,10,10,0,8,0
278898,1,0,7,-7,5,1
270524,2,3,7,-4,1,0
389481,2,13,0,13,3,0
358190,4,20,17,3,6,1
188972,1,0,0,0,16,0
207581,2,21,3,18,7,0
391362,1,0,0,0,4,0
324521,2,7,7,0,8,0
236413,4,17,23,-6,3,0
117000,1,0,3,-3,2,1
55815,2,0,7,-7,9,0
315131,1,0,0,0,4,0
247504,1,3,0,3,8,0
31072,4,13,13,0,15,1
385322,4,14,20,-6,1,0
327439,4,3,20,-17,9,0
380604,1,0,0,0,16,1
345387,2,0,10,-10,17,1
280197,4,28,7,21,5,0
360485,4,17,6,11,7,0
388819,4,14,14,0,3,0
421296,4,19,10,9,17,1
255685,3,3,7,-4,12,0
255192,2,7,7,0,12,1
222813,3,10,13,-3,14,1
297922,2,10,0,10,13,1
219676,3,10,14,-4,13,1
143487,2,14,21,-7,14,0
216531,3,34,11,23,12,0
204526,1,0,7,-7,6,1
351270,4,28,17,11,3,0
190881,4,27,17,10,17,0
290822,3,10,14,-4,10,1
114430,4,41,20,21,1,0
111914,1,0,13,-13,17,0
78654,4,30,13,17,2,0
361970,4,13,6,7,7,1
109832,2,10,0,10,16,1
105470,1,6,0,6,14,1
148819,4,13,23,-10,16,1
134908,2,7,16,-9,10,0
387920,4,10,28,-18,2,0
341537,3,6,10,-4,16,1
263365,4,31,10,21,15,0
384528,1,0,14,-14,1,0
273727,1,0,0,0,2,1
111974,3,14,21,-7,17,1
89640,1,3,3,0,7,0
219154,2,0,3,-3,13,0
336824,1,0,0,0,14,0
288662,2,0,7,-7,9,1
418576,2,14,3,11,16,0
349479,4,6,20,-14,2,1
279319,4,29,23,6,5,0
229128,3,19,7,12,17,0
181039,1,7,0,7,13,1
85730,1,0,0,0,5,1
367277,2,3,10,-7,10,1
409604,4,42,20,22,12,0
334669,2,8,3,5,13,1
268644,4,14,13,1,17,1
234061,3,20,0,20,2,0
324436,3,14,6,8,8,1
192607,2,3,7,-4,1,0
227236,1,0,3,-3,16,0
119880,5,24,24,0,3,0
250306,2,7,7,0,9,1
242157,2,13,7,6,6,1
56288,3,3,20,-17,9,1
83872,3,23,10,13,4,0
407786,4,10,7,3,11,1
104944,3,3,9,-6,14,1
92414,2,17,10,7,8,0
264278,3,10,17,-7,15,0
338343,2,3,0,3,14,1
358839,2,3,7,-4,6,0
130992,4,10,30,-20,8,1
114676,3,3,10,-7,1,1
35669,4,23,10,13,17,0
84030,3,27,15,12,4,1
167234,4,29,17,12,7,1
395264,4,10,13,-3,5,0
121095,4,18,31,-13,3,1
221782,4,13,21,-8,14,1
291454,3,14,20,-6,10,0
396124,3,17,23,-6,6,0
352538,2,20,13,7,3,1
213943,2,16,7,9,10,1
319960,2,30,10,20,6,0
339828,1,7,0,7,15,1
200582,2,14,14,0,4,1
236001,2,10,3,7,3,1
346740,4,27,13,14,1,0
1687,3,14,0,14,1,1
410378,1,0,7,-7,13,1
307839,4,27,21,6,1,0
361946,3,10,3,7,7,1
87314,4,24,24,0,6,1
153162,3,20,17,3,1,1
99162,2,3,3,0,11,0
300635,3,10,3,7,15,0
392808,3,17,6,11,4,0
124938,1,0,0,0,5,0
83468,1,0,0,0,4,1
12345,1,0,0,0,6,0
312190,2,7,7,0,2,0
392886,1,0,0,0,4,0
159181,1,7,0,7,3,0
227594,2,28,0,28,16,1
222979,3,13,13,0,14,1
372694,4,21,17,4,13,1
399790,3,8,24,-16,8,1
59988,4,3,24,-21,11,0
147931,4,31,38,-7,15,0
294076,3,7,21,-14,12,0
356423,1,0,0,0,5,0
255390,3,24,6,18,12,0
3665,4,20,28,-8,2,0
302426,1,0,0,0,15,0
332868,2,14,0,14,12,0
420526,3,10,42,-32,17,0
3669,4,20,31,-11,2,1
98406,2,7,7,0,11,1
241239,2,3,0,3,5,1
179321,4,36,11,25,12,1
315970,3,0,21,-21,4,0
91814,3,17,0,17,8,1
302779,2,3,13,-10,15,1
314707,4,17,28,-11,3,1
152611,2,0,3,-3,17,0
404928,2,3,10,-7,10,1
79448,3,9,14,-5,2,0
106888,2,9,3,6,14,0
290174,1,3,0,3,10,0
320240,2,14,0,14,6,0
410418,2,6,17,-11,13,1
234927,1,10,3,7,2,1
250987,3,3,6,-3,10,1
382741,4,9,20,-11,17,1
214367,1,0,7,-7,11,1
241467,4,10,42,-32,5,1
194660,4,31,7,24,2,1
318584,2,10,10,0,5,0
375825,4,20,7,13,14,0
357822,2,6,14,-8,6,1
89347,1,3,6,-3,7,1
166099,2,14,0,14,6,0
210192,3,7,21,-14,9,1
222061,3,20,10,10,14,0
246489,2,12,0,12,8,1
261716,3,14,7,7,14,1
123403,4,28,27,1,4,0
52843,3,14,37,-23,7,0
16764,2,3,14,-11,8,0
265870,1,0,9,-9,16,1
317940,2,10,3,7,5,0
100565,4,20,20,0,12,1
67027,2,7,0,7,14,0
67076,4,10,9,1,14,1
134567,1,10,0,10,10,0
360116,1,0,3,-3,7,0
314881,2,0,0,0,4,1
303694,1,0,7,-7,16,1
155005,1,6,10,-4,1,1
383802,2,3,7,-4,1,1
139128,3,12,6,6,12,0
373411,4,10,17,-7,13,1
277496,1,0,0,0,4,0
192948,3,7,17,-10,1,1
365757,3,17,17,0,9,1
380232,3,13,16,-3,16,1
299353,4,28,16,12,14,1
240108,1,6,0,6,5,0
62131,2,7,7,0,12,0
304655,3,14,7,7,16,1
176169,2,14,14,0,11,1
93668,1,0,0,0,9,0
280838,2,10,3,7,6,1
342925,4,23,17,6,16,1
238506,2,13,0,13,4,0
59539,4,13,35,-22,11,1
189443,2,7,0,7,17,1
132906,4,6,21,-15,9,1
214010,3,36,7,29,10,1
121441,1,0,0,0,4,1
275315,3,10,8,2,3,0
164665,4,14,27,-13,5,1
123782,2,10,3,7,5,1
125172,3,17,7,10,5,1
53927,3,14,13,1,8,1
296835,4,21,7,14,13,0
378370,1,0,0,0,15,0
403233,4,24,17,7,9,0
161585,2,30,10,20,4,0
77536,3,20,14,6,1,0
408674,4,31,17,14,12,0
398618,2,0,0,0,7,0
97086,3,31,6,25,10,0
101297,4,17,20,-3,12,1
125953,4,16,19,-3,6,0
294863,4,42,21,21,12,1
381522,2,14,7,7,17,1
358028,4,24,22,2,6,1
274555,3,21,16,5,3,1
138401,1,7,0,7,12,0
286856,2,9,7,2,8,0
366398,2,26,0,26,10,0
308875,4,10,13,-3,1,1
237490,2,14,7,7,3,1
20889,4,28,23,5,10,1
154930,3,26,10,16,1,0
295808,5,27,27,0,12,1
259083,1,0,0,0,13,1
119074,1,0,7,-7,3,1
23975,4,16,6,10,12,1
409365,2,9,3,6,12,1
130876,4,20,15,5,8,1
90649,4,20,33,-13,7,1
341789,1,0,3,-3,16,1
89655,2,6,10,-4,7,0
298947,2,6,9,-3,14,0
72102,4,10,17,-7,16,1
300535,4,29,20,9,14,1
49435,5,20,20,0,6,0
270167,4,34,27,7,1,0
314471,2,7,0,7,3,1
307938,2,7,3,4,1,1
355768,4,10,6,4,5,0
395731,4,26,37,-11,6,0
321340,4,22,19,3,6,0
384348,4,16,10,6,1,0
289864,1,0,3,-3,10,0
64215,4,38,6,32,13,0
30604,3,17,0,17,14,0
199904,4,17,24,-7,4,0
234944,2,10,3,7,2,1
321528,1,0,0,0,7,0
370070,4,31,20,11,12,0
1531,2,6,13,-7,1,1
92805,1,0,0,0,8,1
79762,3,20,7,13,2,0
391473,4,10,30,-20,4,1
393824,2,7,17,-10,5,1
249127,4,28,28,0,9,1
395126,4,24,34,-10,5,1
198038,3,0,30,-30,3,1
320862,2,3,14,-11,6,1
365905,3,14,21,-7,9,1
253688,2,3,3,0,11,1
313258,1,3,0,3,3,0
407558,2,10,6,4,11,0
349708,2,14,7,7,2,0
388236,1,0,0,0,2,1
369753,4,38,30,8,11,1
313756,3,28,10,18,3,1
115711,3,10,3,7,1,0
185784,4,25,3,22,15,0
287587,1,0,3,-3,9,1
11012,4,9,31,-22,5,0
54763,2,3,0,3,8,1
38017,1,3,0,3,1,1
68779,2,6,0,6,15,1
366582,3,20,14,6,10,0
21961,1,7,0,7,11,0
318469,4,31,7,24,5,0
171702,4,26,23,3,9,0
125977,4,23,23,0,6,0
313413,2,7,0,7,3,0
374087,1,7,0,7,13,0
360151,2,10,6,4,7,0
12946,5,13,16,-3,6,0
350060,3,20,13,7,2,0
91281,2,7,0,7,8,0
375349,3,7,17,-10,14,1
32918,1,0,6,-6,15,0
27627,2,7,10,-3,13,0
381272,4,24,17,7,16,0
225291,1,0,7,-7,15,0
344351,2,7,0,7,17,0
3888,2,19,7,12,2,1
99670,4,26,3,23,11,1
118184,4,31,27,4,2,0
32066,2,14,10,4,15,0
47101,4,31,10,21,5,1
224577,2,6,7,-1,15,0
205026,2,9,10,-1,6,0
121748,4,21,42,-21,4,1
350220,4,27,0,27,2,0
319978,3,36,10,26,6,1
208351,3,17,27,-10,8,1
40182,3,20,7,13,2,1
60598,4,30,48,-18,11,1
110921,2,7,10,-3,16,1
380581,4,21,27,-6,16,0
120405,2,16,9,7,3,1
349904,3,3,6,-3,2,0
377882,3,20,10,10,15,0
322558,1,0,3,-3,7,1
287132,2,10,3,7,8,1
132597,3,12,35,-23,9,0
221560,2,20,12,8,14,1
92957,1,3,0,3,8,0
280700,2,0,3,-3,5,0
305266,3,27,21,6,16,1
166071,1,7,0,7,6,0
80065,3,17,12,5,2,0
121354,3,7,0,7,3,0
136587,2,12,13,-1,11,0
176235,4,14,27,-13,11,1
246657,3,31,3,28,8,0
356107,1,0,0,0,5,1
337171,2,3,3,0,14,1
171362,4,16,17,-1,9,1
347218,1,0,0,0,1,1
41797,3,10,14,-4,2,1
130312,2,7,0,7,8,0
342782,4,7,14,-7,16,0
362668,3,3,7,-4,8,0
364419,3,35,14,21,9,0
164104,4,12,6,6,5,1
135431,4,28,27,1,10,1
193128,4,13,6,7,1,1
140191,4,13,10,3,12,1
242515,4,15,13,2,6,1
27421,1,0,0,0,13,1
418718,2,0,7,-7,16,0
390378,2,7,19,-12,3,0
210755,3,21,10,11,9,1
68517,2,0,21,-21,14,1
364580,3,15,34,-19,9,0
258132,3,13,13,0,13,1
192760,2,0,9,-9,1,1
112155,4,10,27,-17,17,1
380023,2,14,6,8,16,0
311775,2,10,19,-9,2,0
312165,1,0,0,0,2,0
268326,3,20,3,17,17,1
318481,4,31,7,24,5,1
171726,1,0,0,0,9,1
138091,4,55,24,31,11,1
281397,1,0,0,0,6,0
125606,2,14,16,-2,5,0
387486,1,0,0,0,2,0
235587,4,27,13,14,3,1
214479,4,7,17,-10,11,0
81108,2,10,14,-4,3,1
67475,3,36,7,29,14,0
293404,3,16,10,6,11,1
292713,1,7,7,0,11,1
86034,4,25,28,-3,5,0
379788,4,9,24,-15,16,1
367747,4,13,20,-7,10,1
88828,4,13,13,0,6,1
56664,1,0,0,0,9,1
392497,2,3,17,-14,4,0
358218,1,0,0,0,6,0
351825,3,20,14,6,3,1
97621,1,3,0,3,11,0
65844,1,0,0,0,13,0
310910,2,3,3,0,2,0
248867,1,7,0,7,9,1
418482,4,24,6,18,16,0
82621,2,3,10,-7,3,0
241439,4,7,35,-28,5,1
235632,1,0,0,0,3,0
19865,2,10,21,-11,10,1
292452,2,3,6,-3,11,1
290900,1,0,0,0,10,1
416327,2,13,3,10,15,1
401180,4,51,13,38,8,1
139211,1,3,6,-3,12,0
322498,3,15,3,12,7,1
348077,3,0,16,-16,1,0
315474,1,0,0,0,4,0
32359,2,14,0,14,15,1
321165,3,3,16,-13,6,0
262215,1,0,0,0,15,1
109135,3,24,7,17,15,0
65074,4,6,17,-11,13,0
393112,3,24,3,21,4,0
184336,1,0,6,-6,14,1
413339,4,20,7,13,14,0
227890,2,17,6,11,16,1
235098,2,0,7,-7,2,0
383356,2,0,6,-6,17,1
19601,3,17,21,-4,10,0
169199,2,10,6,4,7,0
321070,4,16,14,2,6,0
200209,4,14,37,-23,4,0
365120,2,0,14,-14,9,1
41262,1,0,0,0,2,0
99968,4,17,16,1,12,0
120834,2,7,14,-7,3,1
404250,4,19,16,3,10,0
208081,4,21,19,2,8,1
76068,3,10,23,-13,1,1
328809,4,17,13,4,10,0
154755,3,10,10,0,1,1
23729,1,0,0,0,12,0
233506,4,26,10,16,2,0
305197,1,7,0,7,16,0
62593,2,6,10,-4,12,0
51838,1,0,0,0,7,0
110112,2,0,10,-10,16,1
82973,4,13,16,-3,4,0
67873,2,6,3,3,14,1
64049,3,20,10,10,13,0
385033,4,24,16,8,1,0
294852,3,42,21,21,12,0
308557,2,6,9,-3,1,0
413402,2,3,24,-21,14,1
98370,1,0,6,-6,11,0
107514,4,3,23,-20,15,0
89272,4,12,0,12,7,1
70793,4,23,27,-4,15,1
349087,1,7,0,7,2,0
281608,2,21,0,21,6,0
98021,4,17,17,0,11,0
150608,3,3,16,-13,17,1
56426,2,0,34,-34,9,0
68572,4,13,28,-15,14,1
114812,3,13,20,-7,1,0
360786,3,24,30,-6,7,1
342665,1,0,0,0,16,0
106609,3,34,0,34,14,1
303844,1,0,0,0,16,0
372187,3,9,13,-4,13,0
291365,1,7,7,0,10,1
325493,3,19,6,13,8,0
94373,3,17,14,3,9,0
26308,3,19,21,-2,13,0
254654,4,31,21,10,11,0
93044,3,13,9,4,8,0
61239,2,14,7,7,11,1
45947,4,17,3,14,4,1
16024,1,7,0,7,8,1
220362,1,6,0,6,13,0
263428,2,3,13,-10,15,0
303997,1,0,7,-7,16,1
21373,1,0,7,-7,11,1
199251,3,17,24,-7,4,1
229038,4,23,16,7,17,0
251510,2,16,13,3,10,0
292839,1,0,0,0,11,1
257741,4,3,24,-21,13,1
87389,2,7,7,0,6,0
364482,4,42,28,14,9,1
230281,2,16,10,6,17,1
275753,2,16,3,13,3,1
179235,2,23,3,20,12,0
139229,1,3,6,-3,12,0
52556,3,16,7,9,7,1
87744,4,6,20,-14,6,1
217407,1,3,0,3,12,0
49227,3,17,3,14,6,0
246317,2,7,3,4,7,0
181934,4,28,35,-7,13,1
109612,4,25,14,11,16,0
317846,3,9,10,-1,5,1
226309,3,19,7,12,16,0
107893,2,0,3,-3,15,1
333466,1,3,0,3,12,1
251958,1,0,7,-7,10,0
57262,1,0,0,0,10,0
187227,2,0,6,-6,16,1
203909,1,0,7,-7,6,1
144088,2,13,0,13,14,0
401249,2,7,14,-7,8,0
386795,2,10,7,3,2,0
4754,2,10,0,10,3,1
284596,2,14,7,7,7,1
178864,4,27,21,6,12,1
47322,2,0,10,-10,5,1
364347,1,0,0,0,9,1
102610,2,5,6,-1,13,1
368350,1,7,0,7,11,0
91392,4,21,14,7,8,1
120415,3,19,9,10,3,1
145160,2,29,0,29,14,1
135966,2,3,3,0,10,0
83525,2,0,7,-7,4,1
101569,3,13,31,-18,12,1
243830,1,0,0,0,6,1
178809,3,24,14,10,12,0
395858,4,10,17,-7,6,0
77574,4,27,14,13,1,0
222528,4,17,14,3,14,0
193752,4,10,27,-17,1,0
196909,4,10,22,-12,3,1
56292,3,3,20,-17,9,1
120470,4,26,27,-1,3,0
219725,4,13,14,-1,13,1
332608,3,20,6,14,12,1
85346,3,21,3,18,5,1
369220,1,0,7,-7,11,1
329232,3,17,13,4,10,0
65481,3,23,14,9,13,0
416491,3,21,17,4,15,0
186406,1,3,0,3,15,0
38674,3,7,7,0,1,1
39472,4,13,12,1,1,1
112092,2,7,14,-7,17,0
388381,4,24,20,4,2,0
413459,4,17,38,-21,14,1
273605,2,10,3,7,2,1
348505,2,21,6,15,2,0
114177,2,0,0,0,1,1
260431,4,20,14,6,14,1
352278,3,3,6,-3,3,0
87906,3,13,15,-2,6,0
6086,2,7,10,-3,3,0
418706,2,0,7,-7,16,0
223368,2,0,12,-12,15,1
175654,2,3,0,3,11,0
296868,1,3,0,3,13,0
121612,1,0,0,0,4,1
156728,4,17,23,-6,2,1
90057,4,18,21,-3,7,0
149350,1,3,0,3,16,0
295174,4,10,21,-11,12,1
39315,4,17,27,-10,1,0
355038,4,18,26,-8,4,0
107130,1,0,0,0,15,1
34257,2,10,6,4,16,0
23184,2,23,6,17,11,1
411094,1,0,0,0,13,0
208829,4,6,22,-16,8,0
66855,1,0,7,-7,14,0
162744,4,35,24,11,5,0
79975,1,0,0,0,2,1
246724,1,0,0,0,8,1
36742,1,0,7,-7,17,1
221574,2,20,15,5,14,0
78493,4,24,0,24,2,1
33923,2,0,24,-24,16,1
370195,4,24,10,14,12,1
420381,4,20,13,7,17,0
63277,1,0,0,0,12,1
369013,3,13,7,6,11,0
420410,1,0,0,0,17,0
23237,4,23,13,10,11,1
346009,2,0,3,-3,1,1
404833,4,20,20,0,10,1
318748,3,10,23,-13,5,1
380136,5,38,38,0,16,0
51919,3,13,10,3,7,0
236257,1,0,0,0,3,0
166527,1,0,0,0,6,1
108549,3,17,14,3,15,1
7904,3,3,17,-14,4,0
99899,2,0,3,-3,12,1
186694,4,27,9,18,15,0
8612,2,7,10,-3,4,1
364569,3,15,21,-6,9,0
187414,3,34,7,27,16,1
135209,2,10,3,7,10,1
361975,4,13,6,7,7,1
377545,2,7,9,-2,15,1
155650,1,3,3,0,2,0
280658,1,0,3,-3,5,1
222498,3,6,14,-8,14,1
313160,3,13,13,0,3,1
301018,2,10,3,7,15,0
3182,4,13,9,4,2,1
381276,4,24,17,7,16,0
378917,4,13,30,-17,15,0
97239,3,12,6,6,10,0
68108,4,3,10,-7,14,0
391089,1,7,7,0,4,0
393848,2,10,17,-7,5,1
95337,4,17,24,-7,10,0
215934,3,10,21,-11,11,1
408093,4,20,17,3,12,0
33733,4,35,7,28,16,0
376772,1,7,0,7,15,0
321009,3,10,7,3,6,1
174168,2,0,6,-6,10,1
321055,4,16,14,2,6,0
218313,3,17,14,3,12,0
38346,2,7,6,1,1,0
347982,4,0,24,-24,1,1
6844,3,10,21,-11,3,0
289471,2,3,7,-4,10,1
388323,3,16,6,10,2,1
123133,1,3,6,-3,4,0
154451,2,14,7,7,1,0
73039,2,6,10,-4,16,1
60403,3,20,7,13,11,0
53820,1,0,0,0,8,1
359090,1,0,0,0,6,1
279439,4,16,30,-14,5,0
327514,2,6,7,-1,10,1
248021,3,27,6,21,8,1
252851,4,16,13,3,11,1
76047,3,10,16,-6,1,1
62344,4,24,22,2,12,0
112910,3,16,6,10,17,1
202702,2,3,7,-4,5,0
78419,2,14,0,14,2,1
365203,4,14,38,-24,9,1
144863,2,14,0,14,14,0
226060,1,0,7,-7,16,1
212404,1,0,0,0,10,1
241424,3,7,35,-28,5,1
114601,1,3,0,3,1,0
270669,2,3,0,3,1,1
95309,4,17,24,-7,10,0
5284,4,24,31,-7,3,1
271737,2,13,10,3,2,0
47991,3,3,24,-21,5,0
243689,1,7,0,7,6,0
179298,4,33,3,30,12,0
76825,4,33,0,33,1,1
185855,2,9,3,6,15,0
164978,4,17,19,-2,6,0
72140,1,0,3,-3,16,1
53448,4,10,28,-18,8,0
258157,3,13,13,0,13,0
377181,4,16,17,-1,15,0
375198,4,17,17,0,14,0
415112,2,0,14,-14,15,1
215853,1,0,0,0,11,1
52554,3,16,7,9,7,1
319917,1,13,7,6,6,1
237222,2,6,0,6,3,1
242788,3,14,31,-17,6,1
82461,2,7,14,-7,3,0
20858,3,21,9,12,10,1
122667,1,0,0,0,4,0
75497,4,31,7,24,17,0
142177,4,2,10,-8,13,1
171412,5,19,20,-1,9,1
23637,2,7,13,-6,12,1
203010,2,14,0,14,5,0
31659,4,24,9,15,15,0
239274,2,3,7,-4,4,0
153268,2,2,0,2,1,0
336977,1,3,0,3,14,1
295627,1,0,0,0,12,1
95971,1,0,0,0,10,1
110778,3,3,3,0,16,0
30532,1,0,0,0,14,0
141346,2,3,17,-14,13,0
414420,3,7,20,-13,14,0
153040,1,0,0,0,1,0
158592,1,6,7,-1,3,1
345403,2,0,10,-10,17,0
326443,1,7,3,4,9,0
405356,4,17,12,5,10,0
39258,2,3,10,-7,1,1
331746,3,10,27,-17,12,1
382022,4,7,33,-26,17,1
117009,2,0,10,-10,2,1
256845,1,0,0,0,12,0
12764,4,59,0,59,6,1
277879,3,7,17,-10,4,0
338516,3,20,14,6,14,1
341403,4,0,13,-13,16,0
58403,2,34,7,27,10,1
391458,4,10,20,-10,4,0
200074,1,0,0,0,4,1
300711,1,7,0,7,15,1
233877,2,13,6,7,2,1
223606,1,6,0,6,15,0
171136,2,3,0,3,8,0
177961,2,7,3,4,12,0
59556,1,0,0,0,11,0
103435,4,17,23,-6,13,1
69780,1,0,0,0,15,1
15841,4,8,12,-4,8,0
190412,3,7,7,0,17,0
3520,4,17,30,-13,2,1
323104,4,26,14,12,7,0
113998,5,20,20,0,17,1
417062,2,17,0,17,15,1
405771,3,10,21,-11,10,1
210016,3,7,3,4,8,0
54983,4,12,3,9,8,1
46348,3,6,17,-11,4,0
260114,4,6,28,-22,14,0
286839,1,3,7,-4,8,0
371170,2,3,19,-16,12,1
377372,2,0,0,0,15,0
408528,4,10,13,-3,12,0
421840,3,0,13,-13,17,0
379479,3,23,0,23,16,0
187030,1,0,0,0,16,1
252412,1,0,0,0,10,0
413956,2,3,7,-4,14,1
190987,3,12,3,9,17,1
166985,1,0,7,-7,7,1
16320,1,7,0,7,8,1
154736,2,3,10,-7,1,1
353378,2,6,0,6,4,1
94738,1,0,0,0,9,0
145623,3,21,0,21,14,0
329111,4,24,7,17,10,1
385036,4,24,16,8,1,0
276668,3,23,6,17,4,1
44896,3,7,38,-31,4,1
392002,2,0,7,-7,4,0
12327,1,0,0,0,6,1
409841,2,20,0,20,12,0
222690,4,14,24,-10,14,1
413080,2,20,14,6,14,1
51527,4,34,31,3,7,0
344069,1,3,3,0,17,1
199470,1,0,0,0,4,1
63481,3,28,13,15,12,1
109521,1,0,7,-7,16,1
317892,1,0,0,0,5,1
397984,1,0,0,0,7,1
314408,4,10,17,-7,3,0
61694,3,17,10,7,12,0
102774,2,10,3,7,13,1
61933,1,0,0,0,12,1
85430,1,7,0,7,5,0
273365,4,35,7,28,2,1
346841,3,10,3,7,1,1
346145,1,7,0,7,1,0
318330,4,9,19,-10,5,0
126388,3,13,14,-1,6,1
408910,2,17,6,11,12,0
170016,4,28,17,11,8,1
10731,1,7,0,7,5,0
76042,2,10,13,-3,1,0
214055,4,43,21,22,10,0
222335,2,14,3,11,14,1
1003,4,0,6,-6,1,1
352059,1,3,7,-4,3,1
291211,1,7,0,7,10,0
44261,2,17,13,4,3,1
376381,3,9,0,9,14,0
4104,3,23,28,-5,2,0
400839,3,24,19,5,8,1
207336,3,13,21,-8,7,1
50936,4,24,27,-3,6,0
383814,2,3,7,-4,1,0
385578,2,3,17,-14,1,0
104674,4,7,3,4,14,0
25972,2,10,6,4,13,0
323172,2,0,0,0,7,1
270436,3,10,7,3,1,1
41584,1,0,0,0,2,1
263514,4,20,23,-3,15,0
276921,2,14,7,7,4,0
252807,3,9,6,3,11,1
46639,3,3,0,3,4,1
359563,1,3,0,3,6,1
288923,4,26,31,-5,9,0
95558,3,9,10,-1,10,0
42937,3,24,23,1,3,1
66040,2,7,0,7,13,0
81835,2,0,21,-21,3,0
380601,1,0,0,0,16,1
349127,2,7,0,7,2,0
294384,3,16,3,13,12,0
412833,3,21,35,-14,14,1
183158,4,7,12,-5,14,1
58902,3,6,25,-19,10,1
99016,2,6,0,6,11,1
126533,3,7,6,1,6,1
164201,3,20,28,-8,5,0
23106,4,17,17,0,11,1
158446,1,0,7,-7,3,1
404827,4,20,20,0,10,1
224277,2,6,9,-3,15,1
186570,1,6,0,6,15,1
70543,1,0,7,-7,15,1
418065,5,35,35,0,16,0
296879,1,10,0,10,13,0
220153,4,26,13,13,13,0
27299,2,7,3,4,13,1
242009,2,7,3,4,5,1
98373,1,0,7,-7,11,1
306837,1,0,3,-3,17,1
10350,2,10,35,-25,5,1
294525,3,17,13,4,12,1
181495,5,31,31,0,13,1
153711,2,2,21,-19,1,0
315069,3,30,14,16,4,1
407780,4,10,7,3,11,1
348613,4,34,23,11,2,0
105328,1,0,7,-7,14,1
75043,1,0,0,0,17,0
177009,4,26,13,13,11,0
319720,4,33,15,18,6,0
75476,4,31,7,24,17,1
155929,4,17,16,1,2,1
290224,3,17,3,14,10,0
11305,1,0,0,0,6,1
228744,4,26,33,-7,17,0
168338,4,24,24,0,7,0
56060,1,0,0,0,9,1
407503,1,3,0,3,11,1
1496,2,3,6,-3,1,0
73474,2,3,14,-11,17,1
20568,4,17,0,17,10,0
290842,3,17,21,-4,10,1
57862,1,0,0,0,10,1
95942,1,0,0,0,10,0
60014,1,0,0,0,11,0
358209,1,0,0,0,6,0
257751,4,3,27,-24,13,1
152311,1,7,0,7,17,0
405919,2,14,0,14,11,0
33903,1,0,3,-3,16,0
75130,3,7,6,1,17,0
35208,4,0,14,-14,16,1
410046,4,6,45,-39,12,0
103279,4,3,10,-7,13,1
68164,1,7,7,0,14,0
111699,3,31,13,18,16,0
56320,4,3,26,-23,9,1
76243,4,12,27,-15,1,1
265536,4,14,13,1,16,1
22503,4,31,29,2,11,0
78936,4,20,17,3,2,0
295449,4,17,13,4,12,0
131575,4,9,23,-14,8,1
235242,2,15,3,12,3,0
73578,1,0,0,0,17,0
56027,4,10,23,-13,9,0
166547,1,3,0,3,6,0
71744,2,17,20,-3,16,0
329157,1,3,0,3,10,0
86226,1,0,10,-10,5,1
298207,2,7,3,4,14,0
256233,2,6,7,-1,12,1
229673,2,7,7,0,17,1
85111,1,0,0,0,4,0
219963,3,6,14,-8,13,1
372156,2,9,7,2,13,0
404414,1,0,0,0,10,1
407952,4,17,24,-7,11,0
215184,2,7,9,-2,11,1
291799,4,9,23,-14,11,1
112239,2,14,7,7,17,1
37572,4,13,17,-4,17,1
253433,3,14,35,-21,11,1
149427,3,13,27,-14,16,1
157636,4,22,3,19,2,1
228207,3,10,27,-17,17,1
202089,2,13,0,13,5,1
353067,1,7,6,1,3,0
22522,4,31,37,-6,11,1
126003,1,0,0,0,6,0
58478,4,48,23,25,10,0
113250,1,7,7,0,17,1
305097,2,21,10,11,16,0
399364,3,27,7,20,7,0
309320,4,3,23,-20,1,1
389082,3,20,0,20,3,1
365714,2,10,3,7,9,0
293732,1,0,0,0,12,1
333638,1,0,0,0,12,1
215590,2,14,3,11,11,1
315789,2,0,6,-6,4,1
221673,1,3,0,3,14,1
78928,4,20,17,3,2,1
17195,2,7,21,-14,9,1
81748,4,31,17,14,3,0
261539,3,12,7,5,14,1
281237,4,27,19,8,6,0
258018,4,7,35,-28,13,0
16403,4,21,13,8,8,0
196696,2,33,0,33,3,1
154915,3,19,10,9,1,0
240740,2,0,7,-7,5,1
100508,3,7,17,-10,12,1
123091,5,21,21,0,4,1
371505,4,17,24,-7,12,1
39954,4,9,10,-1,1,0
345963,4,27,23,4,17,0
144862,2,14,0,14,14,0
182402,4,24,20,4,14,1
10718,5,20,17,3,5,1
401754,4,27,14,13,8,0
86742,3,24,14,10,5,0
321427,2,14,17,-3,7,0
178998,4,19,3,16,12,0
92942,1,0,0,0,8,1
76402,4,29,12,17,1,1
247040,1,0,3,-3,8,0
60953,2,14,6,8,11,1
406454,1,0,3,-3,11,1
84931,4,48,17,31,4,0
204020,4,16,7,9,6,0
191874,3,22,10,12,1,1
39270,3,3,13,-10,1,0
104432,1,0,7,-7,13,1
234211,3,20,10,10,2,1
151061,3,10,10,0,17,1
219313,2,13,7,6,13,0
286784,4,20,28,-8,8,0
221254,2,0,16,-16,14,0
126961,2,3,10,-7,6,1
355322,4,14,20,-6,4,0
224341,4,16,12,4,15,0
115798,1,0,0,0,1,1
105450,4,23,31,-8,14,1
217331,3,7,10,-3,12,1
93471,3,3,28,-25,9,1
29067,1,0,3,-3,14,1
70412,1,7,14,-7,15,1
404976,3,9,13,-4,10,0
191277,4,10,17,-7,17,0
367373,1,7,14,-7,10,1
151528,4,35,7,28,17,1
194450,2,9,0,9,2,0
349891,3,3,6,-3,2,1
363460,4,28,42,-14,8,1
80885,1,0,0,0,3,1
311287,4,9,3,6,2,0
252172,3,20,10,10,10,1
375710,1,0,0,0,14,1
60071,2,7,3,4,11,0
365397,2,7,6,1,9,0
226793,4,14,20,-6,16,0
110492,3,20,6,14,16,1
95930,5,23,26,-3,10,0
104753,2,17,16,1,14,1
323733,4,39,0,39,8,1
296016,2,3,7,-4,13,1
126504,2,0,6,-6,6,1
107595,2,6,7,-1,15,1
386523,3,7,21,-14,2,1
35288,2,6,0,6,16,1
326913,1,2,0,2,9,1
13428,2,3,14,-11,7,0
331688,1,0,13,-13,12,1
213283,4,17,27,-10,10,0
79145,2,0,0,0,2,1
361047,2,16,2,14,7,1
349203,4,27,14,13,2,0
218430,2,10,14,-4,13,1
205326,2,17,0,17,6,1
19577,2,14,14,0,10,0
85227,4,17,17,0,4,0
86774,4,30,21,9,5,0
24390,3,13,0,13,12,1
179408,3,6,13,-7,12,1
348244,3,16,36,-20,1,1
82944,3,3,16,-13,4,1
325285,2,3,3,0,8,1
341614,1,0,0,0,16,1
55132,4,26,10,16,8,0
378115,1,14,0,14,15,1
305529,2,6,0,6,17,1
165662,2,0,7,-7,6,1
343964,3,16,6,10,17,1
262636,3,26,10,16,15,1
111752,1,0,0,0,17,1
110187,4,23,30,-7,16,1
280357,1,0,0,0,5,1
94145,2,3,7,-4,9,1
403936,4,20,17,3,10,1
101384,2,6,7,-1,12,1
224166,3,0,20,-20,15,1
315279,5,20,19,1,4,1
75420,2,10,7,3,17,0
61999,3,10,7,3,12,0
392707,4,16,0,16,4,0
337385,4,21,14,7,14,1
195919,2,0,17,-17,2,1
348435,4,13,23,-10,1,0
60915,1,0,0,0,11,0
171148,2,3,0,3,8,1
115147,3,10,20,-10,1,0
140575,1,17,7,10,12,0
94722,4,38,43,-5,9,0
190311,4,7,20,-13,17,1
260511,2,27,0,27,14,0
284819,4,29,20,9,7,0
63428,2,14,3,11,12,0
317615,2,3,3,0,5,0
217531,1,0,0,0,12,1
368030,4,17,21,-4,11,1
320362,1,7,0,7,6,1
76585,1,0,0,0,1,1
392714,4,16,6,10,4,0
341389,3,0,10,-10,16,0
242703,1,7,0,7,6,1
307002,2,7,0,7,17,1
379652,4,26,13,13,16,1
276499,3,16,7,9,4,0
410346,4,13,26,-13,13,1
410497,4,15,26,-11,13,1
244201,2,13,7,6,6,0
71146,2,19,3,16,16,0
253991,2,0,6,-6,11,1
78239,1,0,0,0,2,1
224523,4,18,10,8,15,0
82030,3,10,7,3,3,1
227076,4,20,9,11,16,0
121197,3,14,20,-6,3,1
64030,2,17,10,7,13,1
378038,3,0,7,-7,15,0
45994,1,0,6,-6,4,0
13736,2,0,17,-17,7,1
90422,2,0,13,-13,7,0
29068,1,0,3,-3,14,0
369002,3,10,7,3,11,1
151796,3,21,16,5,17,0
156773,2,14,7,7,2,1
328885,2,3,0,3,10,0
3205,4,16,9,7,2,0
402369,1,0,7,-7,9,0
211951,2,0,3,-3,9,0
2604,4,10,27,-17,2,1
87344,1,0,0,0,6,1
70181,3,30,14,16,15,0
271050,4,21,28,-7,1,1
139583,3,9,14,-5,12,1
140639,3,37,10,27,12,1
358609,4,27,9,18,6,0
209638,1,0,0,0,8,1
86136,3,28,3,25,5,0
94944,2,3,6,-3,9,1
367672,2,0,3,-3,10,1
153633,4,15,14,1,1,0
199052,2,0,13,-13,4,0
341648,2,10,3,7,16,0
324233,2,3,0,3,8,0
312523,2,20,0,20,3,1
277334,1,6,0,6,4,1
408724,1,3,7,-4,12,1
362707,4,3,13,-10,8,0
271557,2,7,6,1,2,0
112295,3,38,17,21,17,0
67212,3,0,3,-3,14,1
365234,1,0,7,-7,9,1
324858,2,10,10,0,8,0
348847,2,3,14,-11,2,0
59997,4,3,31,-28,11,1
21030,4,21,31,-10,10,0
215265,4,10,16,-6,11,1
220663,2,10,0,10,13,0
394065,4,9,16,-7,5,0
257908,4,16,19,-3,13,1
222890,1,0,0,0,14,0
219011,2,14,0,14,13,1
107938,3,6,3,3,15,0
25274,3,27,7,20,12,0
65790,4,27,25,2,13,0
124343,1,0,0,0,5,0
367481,4,36,31,5,10,1
154834,1,0,0,0,1,1
25533,2,14,7,7,12,1
329892,1,0,7,-7,11,1
412497,3,24,7,17,14,0
101411,3,15,7,8,12,0
104967,4,10,16,-6,14,0
417804,1,7,0,7,16,1
382395,2,0,20,-20,17,0
417005,1,0,0,0,15,1
131474,1,0,3,-3,8,0
405497,4,24,16,8,10,0
54229,3,0,3,-3,8,1
180264,1,3,0,3,13,0
265069,2,13,3,10,16,1
341131,4,21,24,-3,15,0
199042,1,0,7,-7,4,1
76581,1,0,0,0,1,1
157274,3,13,3,10,2,1
366246,2,7,3,4,10,1
202879,2,21,0,21,5,1
51288,2,6,3,3,7,1
10234,4,6,10,-4,5,0
119415,2,0,14,-14,3,1
75714,2,21,7,14,1,0
324713,2,13,7,6,8,0
354965,2,7,9,-2,4,1
53695,2,0,0,0,8,1
305304,4,42,21,21,16,0
296888,2,10,0,10,13,0
200532,1,0,0,0,4,1
329754,1,10,0,10,11,1
416594,2,7,6,1,15,0
272416,3,31,3,28,2,0
252288,2,0,13,-13,10,0
297770,1,7,0,7,13,1
311843,4,20,20,0,2,0
28683,3,3,10,-7,14,0
329071,2,10,7,3,10,0
234362,3,17,10,7,2,0
415925,4,10,23,-13,15,0
159324,4,27,24,3,3,0
366965,2,0,17,-17,10,1
409848,3,23,0,23,12,1
165292,4,17,21,-4,6,0
43370,3,14,14,0,3,0
314327,2,7,17,-10,3,1
88185,3,14,10,4,6,0
271148,2,7,10,-3,1,0
354875,4,33,42,-9,4,1
335156,3,20,0,20,13,0
259394,1,0,0,0,13,1
363547,3,3,5,-2,8,1
256441,3,12,21,-9,12,0
48166,4,10,13,-3,5,0
155317,1,7,0,7,2,0
358187,4,20,17,3,6,1
139527,2,6,0,6,12,0
339318,4,38,7,31,15,0
215174,2,7,9,-2,11,1
19632,4,17,28,-11,10,1
360669,4,17,37,-20,7,0
1661,2,0,0,0,1,1
375427,1,0,7,-7,14,1
175980,1,7,0,7,11,1
230398,2,7,0,7,1,0
181065,2,7,7,0,13,1
329186,2,3,6,-3,10,0
414485,1,0,0,0,14,0
124676,1,0,3,-3,5,1
358086,1,7,0,7,6,1
342697,2,0,0,0,16,0
407218,1,0,3,-3,11,0
252465,2,0,19,-19,10,1
411582,2,7,13,-6,13,0
160728,4,10,10,0,4,1
364420,3,35,14,21,9,0
276150,1,10,0,10,3,1
293937,3,7,21,-14,12,0
288491,1,3,0,3,9,0
261107,3,7,21,-14,14,1
255334,2,14,0,14,12,0
212402,1,0,0,0,10,1
344970,3,10,14,-4,17,0
78057,4,12,23,-11,1,1
348197,2,6,10,-4,1,0
382926,2,0,7,-7,17,0
189138,1,14,0,14,16,1
132851,3,3,14,-11,9,1
350496,4,10,19,-9,2,0
271895,2,7,13,-6,2,1
272756,4,15,10,5,2,1
233372,1,0,0,0,2,1
189941,3,6,7,-1,17,1
283620,4,13,20,-7,7,1
90843,1,14,0,14,7,1
311344,2,14,7,7,2,0
395837,3,3,17,-14,6,1
86482,4,30,24,6,5,0
98276,2,14,24,-10,11,0
402645,4,23,23,0,9,1
19703,2,3,6,-3,10,0
329085,3,10,7,3,10,1
259187,4,14,25,-11,13,0
250557,4,19,20,-1,9,0
211002,2,7,0,7,9,1
272633,1,0,0,0,2,0
328924,2,6,7,-1,10,1
303064,1,0,0,0,16,0
126054,2,7,3,4,6,0
182721,4,27,26,1,14,1
208004,2,14,0,14,8,1
57137,1,0,0,0,10,1
268953,4,6,36,-30,17,0
386251,4,14,17,-3,2,1
44718,2,0,12,-12,3,1
324921,4,23,23,0,8,0
182665,3,0,12,-12,14,0
79680,1,0,0,0,2,1
206801,1,0,0,0,7,0
411725,2,0,3,-3,13,0
162335,2,3,7,-4,4,0
31022,2,3,6,-3,15,1
263649,3,20,10,10,15,0
261729,3,14,7,7,14,0
341806,2,3,9,-6,16,1
19557,2,7,7,0,10,0
311755,2,6,13,-7,2,1
140632,3,31,10,21,12,0
132839,2,3,7,-4,9,0
339172,4,23,13,10,15,1
339712,2,7,6,1,15,1
86833,2,9,13,-4,5,0
185338,1,0,0,0,15,0
420782,2,3,3,0,17,0
113448,3,0,7,-7,17,1
111725,4,37,16,21,16,1
169273,4,23,6,17,7,0
174276,1,0,0,0,10,0
215662,4,14,6,8,11,1
303237,1,0,0,0,16,1
20474,2,0,0,0,10,0
93419,2,3,14,-11,9,1
356459,2,0,3,-3,5,0
215706,1,3,0,3,11,0
76204,3,12,20,-8,1,0
175934,4,37,27,10,11,0
21017,3,14,24,-10,10,1
164916,2,0,3,-3,6,1
352964,2,13,3,10,3,1
317526,3,10,27,-17,5,0
191217,2,0,17,-17,17,1
385654,4,16,24,-8,1,1
60731,4,28,3,25,11,0
152341,2,7,3,4,17,0
363401,3,14,13,1,8,1
360986,1,0,2,-2,7,1
319774,2,7,7,0,6,1
388897,2,10,14,-4,3,1
306539,1,0,0,0,17,0
262848,2,7,20,-13,15,1
49485,2,0,3,-3,6,1
154252,1,0,7,-7,1,1
30082,1,0,0,0,14,0
364634,1,0,0,0,9,1
25676,2,7,7,0,12,0
367577,3,14,9,5,10,0
63542,1,7,0,7,12,0
148579,2,0,6,-6,16,1
81390,2,7,7,0,3,0
361332,2,0,0,0,7,1
95593,4,12,10,2,10,1
215572,1,7,0,7,11,1
417848,2,10,3,7,16,0
352916,1,3,0,3,3,1
13124,2,10,7,3,6,0
213668,2,14,14,0,10,0
393436,4,28,24,4,5,1
76966,3,17,13,4,1,0
337094,4,26,7,19,14,0
374890,3,14,11,3,14,0
134168,2,0,10,-10,10,1
150786,4,20,9,11,17,0
19234,1,0,0,0,10,0
411579,2,7,10,-3,13,0
76712,4,16,14,2,1,1
368475,4,37,35,2,11,1
24209,2,10,7,3,12,0
266528,4,10,15,-5,16,0
287768,2,14,10,4,9,1
151255,4,24,26,-2,17,1
218016,3,21,10,11,12,1
269489,2,10,10,0,1,1
145226,4,56,0,56,14,0
179619,4,31,23,8,12,0
243086,3,0,9,-9,6,1
298601,4,13,10,3,14,0
58414,3,34,10,24,10,1
166553,1,6,0,6,6,1
398269,1,0,0,0,7,1
89492,1,0,0,0,7,0
235751,4,10,27,-17,3,1
117541,4,17,17,0,2,0
267560,3,27,21,6,17,1
273077,4,9,3,6,2,1
295054,1,0,0,0,12,0
246431,1,7,0,7,8,0
293494,2,10,3,7,11,0
202437,2,3,10,-7,5,1
341915,1,0,0,0,16,0
314159,2,7,7,0,3,0
247369,1,3,0,3,8,0
48326,4,22,13,9,5,1
20809,2,14,0,14,10,0
414149,3,10,13,-3,14,0
200198,4,14,37,-23,4,0
118533,2,17,0,17,2,0
24294,4,13,17,-4,12,1
242310,2,10,10,0,6,0
134413,1,0,0,0,10,1
326497,2,31,9,22,9,1
392862,4,17,20,-3,4,0
272181,1,0,0,0,2,1
142096,2,0,7,-7,13,1
209311,1,0,0,0,8,0
97973,2,7,10,-3,11,1
276365,3,17,35,-18,3,1
149683,2,20,0,20,16,0
346907,4,23,16,7,1,1
72959,4,31,7,24,16,0
65201,4,3,10,-7,13,1
355678,1,6,0,6,5,1
360758,2,17,21,-4,7,0
303443,3,19,7,12,16,0
123957,3,10,0,10,5,1
133424,1,13,7,6,9,1
405078,2,0,3,-3,10,1
239760,4,13,13,0,4,1
219499,2,3,21,-18,13,1
412558,4,31,21,10,14,1
121559,3,16,10,6,4,0
46738,2,7,3,4,4,1
308949,1,0,3,-3,1,0
34937,4,27,24,3,16,0
167086,4,16,31,-15,7,0
100930,2,7,3,4,12,1
265621,3,6,15,-9,16,1
342446,3,13,3,10,16,1
100875,1,0,0,0,12,0
403909,3,20,14,6,10,0
396376,2,20,9,11,6,0
186962,3,7,12,-5,15,1
384568,2,3,35,-32,1,0
201039,3,34,0,34,5,0
229977,2,0,3,-3,17,0
265733,1,3,0,3,16,1
302085,3,20,24,-4,15,0
23277,1,0,3,-3,11,0
182277,2,14,0,14,14,0
271648,4,23,37,-14,2,1
397554,1,6,10,-4,7,1
63199,3,14,23,-9,12,0
327818,2,3,10,-7,10,0
49968,2,21,0,21,6,0
217704,2,7,0,7,12,0
396583,3,17,10,7,6,0
180492,3,14,20,-6,13,1
281107,1,0,0,0,6,0
185282,3,27,16,11,15,0
289726,2,0,7,-7,10,0
123458,1,0,0,0,4,1
329886,1,0,7,-7,11,0
137102,3,17,6,11,11,1
225807,3,17,14,3,16,0
80726,4,40,33,7,3,1
61300,4,31,14,17,11,0
32677,2,7,0,7,15,1
98071,1,0,0,0,11,0
353286,3,31,20,11,4,0
24900,4,16,6,10,12,1
342531,1,3,6,-3,16,1
90863,2,28,0,28,7,0
190363,2,7,0,7,17,0
358354,1,6,7,-1,6,1
345317,4,22,24,-2,17,0
311557,1,0,0,0,2,1
394021,3,6,13,-7,5,1
45374,4,20,16,4,4,1
193312,4,10,26,-16,1,0
127856,4,23,42,-19,6,0
170090,2,7,0,7,8,1
141015,2,7,0,7,13,0
153005,4,42,23,19,1,0
365751,3,17,17,0,9,1
309304,3,0,23,-23,1,1
78267,2,0,14,-14,2,1
303077,1,0,7,-7,16,1
199875,4,10,24,-14,4,0
165557,4,3,28,-25,6,0
147485,1,0,0,0,15,0
155490,1,7,0,7,2,0
297430,4,30,24,6,13,1
295711,3,3,9,-6,12,1
385525,1,0,0,0,1,1
70728,2,7,10,-3,15,0
367552,2,14,6,8,10,0
68089,3,3,10,-7,14,1
370599,3,14,14,0,12,0
278637,3,14,3,11,4,1
230407,2,7,0,7,1,1
294187,2,0,7,-7,12,1
257547,4,19,10,9,13,1
219551,4,21,21,0,13,0
85546,4,17,19,-2,5,0
46707,1,0,0,0,4,1
271732,2,13,10,3,2,1
19787,4,12,15,-3,10,0
198047,3,3,30,-27,3,0
33827,3,0,31,-31,16,1
102005,2,7,3,4,12,1
101483,1,7,0,7,12,0
60879,4,17,26,-9,11,1
359241,5,28,28,0,6,1
351220,3,28,10,18,3,0
26060,1,0,0,0,13,1
248986,4,27,3,24,9,0
313524,1,0,7,-7,3,1
192591,1,3,7,-4,1,1
124245,2,7,17,-10,5,1
48174,4,10,13,-3,5,0
153651,1,0,0,0,1,0
382363,1,0,7,-7,17,0
117515,3,17,17,0,2,0
26813,4,13,43,-30,13,0
186138,2,3,3,0,15,1
127807,3,10,28,-18,6,0
274478,1,6,0,6,3,1
419091,1,0,0,0,16,1
106300,2,7,6,1,14,0
383167,4,26,24,2,17,0
215384,4,24,20,4,11,0
158645,2,14,7,7,3,1
211285,1,3,0,3,9,0
147863,3,3,17,-14,15,1
275060,4,34,20,14,3,1
151713,1,7,0,7,17,0
404012,2,3,14,-11,10,0
219209,3,13,3,10,13,0
274738,4,24,12,12,3,0
401888,4,14,28,-14,9,1
415774,4,21,17,4,15,0
50471,4,17,10,7,6,0
213434,4,10,41,-31,10,0
85900,1,7,7,0,5,0
254097,1,0,0,0,11,0
19750,3,9,12,-3,10,1
189811,3,17,17,0,17,1
338784,1,7,0,7,15,0
84884,3,27,17,10,4,1
292851,1,7,0,7,11,0
297617,1,6,0,6,13,1
343657,3,15,10,5,17,0
339958,1,7,0,7,15,0
140352,4,17,26,-9,12,0
71723,2,10,13,-3,16,1
115276,3,14,9,5,1,0
228883,4,9,17,-8,17,0
258045,4,7,38,-31,13,1
143236,3,10,13,-3,13,0
52912,1,0,0,0,7,0
119225,1,0,3,-3,3,1
86035,4,25,29,-4,5,1
196671,2,27,0,27,3,1
198393,1,3,0,3,3,1
54098,4,17,3,14,8,1
224717,1,3,0,3,15,1
296857,1,0,0,0,13,1
294151,1,0,0,0,12,0
235274,3,18,6,12,3,0
161016,4,16,7,9,4,1
295491,1,0,0,0,12,1
322126,1,0,0,0,7,0
171228,4,9,14,-5,8,0
222051,3,20,10,10,14,1
212930,2,7,7,0,10,0
122898,3,31,6,25,4,1
182076,4,17,21,-4,13,0
178519,3,16,13,3,12,1
385717,1,0,0,0,1,1
63884,2,3,21,-18,12,1
268789,3,31,10,21,17,1
338889,4,13,25,-12,15,1
65367,4,13,28,-15,13,1
316011,4,0,31,-31,4,1
406686,3,21,0,21,11,1
163756,3,0,12,-12,5,1
241168,4,20,10,10,5,0
412448,2,6,7,-1,14,1
193772,4,10,27,-17,1,1
74020,4,37,7,30,17,1
349141,2,20,7,13,2,0
154129,2,0,6,-6,1,1
278494,3,36,0,36,4,1
335845,2,21,7,14,13,0
241443,4,7,35,-28,5,1
107205,3,6,28,-22,15,0
166248,1,0,3,-3,6,0
71141,2,18,3,15,16,1
363610,4,16,15,1,8,1
116950,4,28,13,15,2,1
117690,3,27,13,14,2,0
62109,2,7,7,0,12,1
151312,2,7,14,-7,17,1
128808,3,13,13,0,7,1
319696,4,33,9,24,6,0
151153,2,3,10,-7,17,0
87404,2,10,7,3,6,1
301246,4,27,17,10,15,0
93929,4,24,9,15,9,0
207872,2,7,7,0,8,1
353479,1,0,0,0,4,0
169616,2,6,0,6,8,1
288823,2,10,17,-7,9,1
24037,1,0,0,0,12,0
346752,4,27,20,7,1,1
418417,2,14,3,11,16,1
319333,3,13,21,-8,6,0
273315,2,21,0,21,2,0
15797,3,0,12,-12,8,0
268426,2,14,3,11,17,1
52994,3,27,24,3,7,1
251928,4,20,19,1,10,0
239708,2,7,10,-3,4,1
156639,2,3,0,3,2,0
195122,4,7,29,-22,2,0
303017,4,23,16,7,16,0
318468,3,31,7,24,5,0
202750,3,13,17,-4,5,1
148538,4,24,10,14,16,1
114595,1,3,0,3,1,1
187757,4,16,20,-4,16,0
326669,3,16,6,10,9,0
228687,3,16,23,-7,17,1
377391,2,7,13,-6,15,1
194173,3,6,10,-4,1,1
113435,2,0,7,-7,17,1
211986,2,3,13,-10,9,1
170208,1,0,0,0,8,1
126405,4,20,17,3,6,1
236506,3,7,9,-2,3,0
269493,2,10,10,0,1,1
304431,1,0,0,0,16,0
77800,2,7,14,-7,1,1
87894,3,13,15,-2,6,0
386974,3,7,21,-14,2,1
286500,1,3,0,3,8,0
156383,4,38,14,24,2,1
333470,1,3,0,3,12,1
108289,4,12,7,5,15,1
325948,3,16,7,9,9,0
254042,3,14,13,1,11,0
85246,4,17,17,0,4,1
185184,1,0,0,0,15,0
252782,2,3,6,-3,11,0
104718,1,0,6,-6,14,1
401805,1,7,6,1,9,0
25195,4,20,3,17,12,0
371690,1,0,7,-7,12,1
416578,1,0,0,0,15,1
327292,3,16,20,-4,9,0
134436,2,0,20,-20,10,1
235353,1,13,0,13,3,1
120052,1,3,0,3,3,0
1498,2,3,6,-3,1,0
87493,1,0,0,0,6,0
70789,4,23,27,-4,15,0
29512,1,0,0,0,14,1
134017,2,6,0,6,9,0
381013,1,0,0,0,16,0
12080,2,7,0,7,6,0
344942,2,10,7,3,17,0
227623,3,28,0,28,16,1
373226,3,3,13,-10,13,1
8843,4,32,0,32,4,1
176416,4,22,28,-6,11,0
374546,2,17,13,4,14,1
325547,1,0,0,0,9,1
255764,2,0,0,0,12,1
81015,4,20,20,0,3,0
334129,3,16,7,9,13,1
257187,2,3,9,-6,12,0
183130,3,7,6,1,14,1
298958,2,6,9,-3,14,1
171364,4,16,17,-1,9,0
344678,2,3,20,-17,17,1
225715,1,0,0,0,16,0
126115,4,30,9,21,6,0
169608,1,6,0,6,8,0
117003,1,0,3,-3,2,0
137713,2,7,19,-12,11,0
412839,3,28,35,-7,14,1
214045,4,43,14,29,10,0
196960,2,14,0,14,3,1
338592,4,36,38,-2,14,1
106611,3,34,0,34,14,0
283133,3,6,9,-3,7,1
157084,2,10,7,3,2,0
85924,2,7,14,-7,5,0
225821,3,24,14,10,16,0
338551,4,20,31,-11,14,1
52773,1,0,20,-20,7,0
262996,2,7,0,7,15,1
53079,2,13,7,6,7,0
323615,1,7,0,7,8,0
17242,3,7,34,-27,9,0
346211,2,20,0,20,1,1
35198,3,0,14,-14,16,0
410474,4,9,23,-14,13,1
157769,4,17,10,7,2,1
227780,3,3,14,-11,16,1
354419,1,0,0,0,4,1
280330,4,19,22,-3,5,0
184840,3,24,20,4,15,1
8148,1,0,7,-7,4,0
232735,1,0,0,0,2,1
242960,4,24,31,-7,6,1
378639,4,23,23,0,15,0
361304,1,0,0,0,7,0
322623,3,3,6,-3,7,0
346794,2,10,0,10,1,0
363219,2,14,7,7,8,0
263898,2,6,0,6,15,1
302913,1,13,0,13,16,0
325506,4,19,13,6,8,1
202531,1,0,3,-3,5,1
387167,4,10,41,-31,2,1
300759,2,7,13,-6,15,1
24306,4,13,17,-4,12,1
375281,1,0,0,0,14,1
189362,4,13,10,3,16,1
72879,1,0,0,0,16,0
126588,4,16,13,3,6,0
303891,2,0,17,-17,16,1
123759,2,7,3,4,5,1
241643,1,0,0,0,5,0
120665,1,3,0,3,3,1
349997,2,3,7,-4,2,1
331988,2,0,0,0,12,0
134974,4,7,25,-18,10,1
180570,1,0,0,0,13,1
387552,2,3,3,0,2,1
281833,3,10,0,10,6,1
164994,1,0,3,-3,6,1
365857,2,7,7,0,9,1
392322,2,7,21,-14,4,0
401367,1,10,0,10,8,0
316367,1,7,0,7,4,0
420519,3,3,42,-39,17,1
246341,3,14,10,4,7,0
64904,3,10,3,7,13,0
207279,2,0,7,-7,7,1
357398,2,17,17,0,5,0
320676,1,14,10,4,6,1
253523,2,0,7,-7,11,1
216947,1,3,0,3,12,0
74627,1,0,3,-3,17,1
314614,2,7,0,7,3,1
192372,4,27,27,0,1,1
152290,4,28,0,28,17,1
132553,2,2,29,-27,9,0
193719,3,3,27,-24,1,0
218663,4,10,33,-23,13,0
321689,1,0,3,-3,7,0
297986,3,30,7,23,13,0
164974,4,10,19,-9,6,1
307808,3,17,21,-4,1,1
290404,3,26,10,16,10,1
400052,2,14,3,11,8,0
274483,1,7,0,7,3,0
271020,3,18,21,-3,1,0
411344,3,17,10,7,13,0
274536,2,21,16,5,3,1
160535,3,23,14,9,4,0
269263,4,3,19,-16,17,1
216924,4,21,24,-3,12,0
416124,1,0,0,0,15,0
316089,2,17,6,11,4,0
337065,3,19,0,19,14,0
90069,1,0,0,0,7,0
233329,4,13,23,-10,2,1
236952,3,36,7,29,3,1
145878,1,0,0,0,15,0
6382,2,0,13,-13,3,0
25696,3,14,7,7,12,0
112105,2,7,17,-10,17,1
139396,2,21,0,21,12,0
325227,4,19,26,-7,8,1
154383,4,34,24,10,1,0
358351,1,6,7,-1,6,1
140034,4,28,10,18,12,0
219911,1,3,0,3,13,1
179466,4,21,20,1,12,0
163287,3,13,13,0,5,1
397018,3,21,6,15,6,0
9344,3,28,7,21,5,0
199393,3,13,10,3,4,1
286372,2,0,0,0,8,1
7156,4,34,21,13,4,0
319601,1,3,3,0,6,1
60385,3,13,7,6,11,1
291298,3,21,19,2,10,0
197916,4,11,7,4,3,1
398158,1,7,3,4,7,1
313306,3,6,24,-18,3,1
298886,4,21,23,-2,14,0
20458,1,0,0,0,10,1
396717,3,7,14,-7,6,1
39700,2,3,0,3,1,0
286106,3,10,17,-7,8,1
231967,4,14,41,-27,1,0
386574,4,20,31,-11,2,1
301435,1,9,3,6,15,1
403736,2,9,3,6,9,1
325850,4,13,20,-7,9,1
233009,4,17,10,7,2,1
44348,4,24,23,1,3,0
383155,4,26,17,9,17,0
329306,1,6,14,-8,10,0
121172,2,7,13,-6,3,0
2854,3,31,24,7,2,0
251251,3,10,24,-14,10,0
343702,4,18,10,8,17,0
287875,4,28,23,5,9,0
254762,3,10,3,7,11,0
181904,4,21,35,-14,13,1
360316,3,0,20,-20,7,1
307681,4,14,23,-9,17,1
153950,1,7,0,7,1,0
288736,4,0,7,-7,9,0
276931,2,14,14,0,4,1
91847,4,24,13,11,8,1
373571,4,16,33,-17,13,1
393712,3,0,7,-7,5,0
72460,2,7,10,-3,16,1
401964,2,0,9,-9,9,1
86540,2,20,3,17,5,0
175959,1,0,0,0,11,0
158585,1,0,0,0,3,0
370774,3,19,10,9,12,0
175920,4,23,27,-4,11,1
29207,4,3,26,-23,14,0
381311,4,38,31,7,16,1
99650,3,23,3,20,11,0
417124,4,34,7,27,15,1
353399,3,16,0,16,4,1
122107,2,10,14,-4,4,0
385366,1,0,0,0,1,0
270704,2,3,3,0,1,1
187748,4,16,20,-4,16,1
211409,4,10,13,-3,9,1
235735,3,3,20,-17,3,1
392909,1,0,3,-3,4,1
139063,1,6,0,6,12,0
272509,2,7,3,4,2,1
152576,1,0,0,0,17,1
171527,4,17,10,7,9,1
363449,4,28,35,-7,8,1
237245,3,19,0,19,3,1
190091,2,20,3,17,17,1
201292,2,14,3,11,5,1
169334,2,3,14,-11,8,1
125217,4,31,14,17,5,0
399086,3,10,26,-16,7,0
377761,4,39,7,32,15,0
60766,1,0,0,0,11,0
163995,1,0,0,0,5,0
326950,2,2,0,2,9,0
44884,3,7,17,-10,4,0
18157,3,13,17,-4,9,0
202875,2,21,0,21,5,0
261543,3,12,7,5,14,0
64083,4,27,24,3,13,1
274077,3,10,0,10,3,1
258634,4,13,13,0,13,1
193851,2,24,0,24,1,0
241156,4,20,10,10,5,1
89529,2,0,10,-10,7,0
285499,4,36,15,21,8,0
116819,1,0,0,0,2,1
406651,2,7,0,7,11,1
375512,3,33,7,26,14,1
131726,4,24,22,2,8,0
20220,4,24,10,14,10,0
68790,2,6,0,6,15,0
304377,3,28,21,7,16,1
184909,1,0,7,-7,15,0
317114,4,20,20,0,4,1
382659,2,0,0,0,17,1
84840,1,6,3,3,4,1
131211,2,7,17,-10,8,1
60742,4,28,3,25,11,1
366857,3,3,6,-3,10,0
215236,4,10,16,-6,11,1
203110,1,0,0,0,5,0
204458,3,7,24,-17,6,0
125838,1,0,0,0,6,1
234997,3,16,17,-1,2,1
379666,1,0,0,0,16,1
296491,3,20,3,17,13,1
193437,3,20,20,0,1,1
400765,1,7,0,7,8,1
122106,2,10,14,-4,4,0
107129,4,40,13,27,15,1
143712,4,19,17,2,14,1
250037,3,17,13,4,9,0
347959,3,0,21,-21,1,1
245746,3,16,10,6,7,0
78409,2,14,0,14,2,1
307061,3,24,0,24,17,1
103168,1,0,0,0,13,0
304505,3,3,14,-11,16,1
287917,2,7,10,-3,9,1
127963,4,23,13,10,6,0
10161,2,0,0,0,5,0
324572,3,13,9,4,8,1
402908,4,17,9,8,9,0
139159,4,19,6,13,12,0
145087,4,27,13,14,14,1
190482,1,7,0,7,17,1
141534,3,24,10,14,13,0
62712,2,0,0,0,12,1
206492,4,27,0,27,7,0
248967,4,27,3,24,9,0
263810,4,7,24,-17,15,1
32988,3,6,24,-18,15,0
407552,2,10,3,7,11,0
171386,4,16,20,-4,9,1
405329,4,14,12,2,10,1
383199,1,14,0,14,17,1
196681,2,33,0,33,3,1
29343,4,21,10,11,14,0
184568,4,42,21,21,14,1
311825,4,17,20,-3,2,1
241474,4,10,42,-32,5,1
198071,4,9,37,-28,3,1
295344,1,3,0,3,12,1
291865,2,7,7,0,11,0
297089,3,24,0,24,13,1
18274,2,7,17,-10,9,1
174128,1,0,0,0,10,1
29400,1,0,7,-7,14,0
88738,1,3,3,0,6,0
177714,3,13,14,-1,12,1
34841,2,10,0,10,16,0
230154,3,3,23,-20,17,0
192310,3,27,10,17,1,1
61147,3,0,7,-7,11,0
136372,1,0,0,0,11,0
183583,3,20,24,-4,14,1
182686,4,11,19,-8,14,0
287182,3,10,13,-3,8,0
102313,3,13,10,3,13,0
196237,2,14,10,4,2,1
164144,1,7,0,7,5,1
321328,3,15,19,-4,6,1
291674,1,0,0,0,11,0
415117,2,0,14,-14,15,0
223768,1,0,0,0,15,0
219121,1,0,0,0,13,0
124964,2,3,3,0,5,1
326908,1,2,0,2,9,1
403418,1,7,0,7,9,0
300698,1,0,0,0,15,1
5871,1,0,0,0,3,1
367129,2,21,13,8,10,1
307717,1,0,0,0,1,1
328467,3,3,3,0,10,1
416957,4,10,10,0,15,0
15966,3,12,14,-2,8,0
300588,2,0,0,0,15,1
401835,2,7,14,-7,9,0
199908,1,0,0,0,4,1
235015,4,16,17,-1,2,1
311766,2,7,13,-6,2,1
267987,2,7,6,1,17,0
133662,4,17,35,-18,9,1
163375,1,0,3,-3,5,0
372200,4,9,16,-7,13,0
158962,3,14,22,-8,3,1
79137,2,0,0,0,2,0
88846,4,13,16,-3,6,1
72566,4,19,31,-12,16,1
404987,4,9,20,-11,10,1
255550,4,30,7,23,12,0
168844,2,14,0,14,7,0
10843,4,21,14,7,5,0
99372,4,23,10,13,11,1
139196,1,0,6,-6,12,1
106587,2,31,0,31,14,0
156617,2,3,0,3,2,1
10642,3,7,17,-10,5,1
305506,1,6,0,6,17,1
81801,1,0,7,-7,3,0
191398,3,0,31,-31,17,1
278714,1,0,0,0,5,0
124459,4,9,14,-5,5,1
49149,1,3,0,3,6,0
272845,2,20,0,20,2,1
58784,4,10,29,-19,10,1
353396,2,16,0,16,4,0
309851,3,14,7,7,1,1
79253,1,9,0,9,2,0
352449,4,38,24,14,3,0
277933,4,7,27,-20,4,0
8896,2,14,0,14,4,1
234501,3,20,20,0,2,0
152228,3,21,0,21,17,0
200254,2,3,7,-4,4,1
2888,4,31,31,0,2,1
300629,3,10,3,7,15,1
6340,1,0,3,-3,3,1
5053,2,7,0,7,3,1
62804,4,17,0,17,12,1
15913,2,6,7,-1,8,0
110040,4,47,10,37,16,1
318441,3,21,7,14,5,1
81564,3,16,21,-5,3,1
338348,2,3,0,3,14,0
374991,2,21,27,-6,14,1
248327,3,17,10,7,8,1
95349,4,17,24,-7,10,1
150514,4,41,6,35,16,0
100227,3,17,7,10,12,0
299607,4,13,10,3,14,0
417793,1,7,0,7,16,0
61531,2,14,7,7,11,1
308775,4,18,20,-2,1,0
43516,2,7,3,4,3,1
275780,3,16,3,13,3,0
414260,3,21,21,0,14,1
234906,1,0,0,0,2,1
295791,5,27,24,3,12,1
378515,1,0,0,0,15,0
116144,2,7,3,4,1,0
159073,2,17,0,17,3,1
5455,1,0,0,0,3,0
184332,1,0,3,-3,14,0
720,4,6,24,-18,1,1
132145,3,10,3,7,9,0
419415,1,3,0,3,16,0
335889,3,28,14,14,13,1
302855,4,12,23,-11,15,0
187146,4,16,0,16,16,0
394472,3,7,18,-11,5,1
232049,3,0,24,-24,1,1
18557,2,3,10,-7,9,1
195123,4,7,29,-22,2,0
103863,4,26,0,26,13,0
291795,4,9,23,-14,11,1
236716,4,30,7,23,3,0
396620,4,23,10,13,6,1
413335,4,20,7,13,14,1
224168,3,0,20,-20,15,0
348540,3,28,14,14,2,1
1088,3,10,29,-19,1,0
302381,3,16,13,3,15,1
164514,3,17,3,14,5,1
186547,4,27,33,-6,15,1
122829,2,10,3,7,4,1
50175,4,0,24,-24,6,1
29023,4,14,10,4,14,1
97373,3,9,13,-4,10,0
102735,1,3,0,3,13,0
283252,2,10,0,10,7,0
164508,3,17,0,17,5,0
263987,4,23,7,16,15,0
166001,3,17,21,-4,6,1
30341,4,10,10,0,14,0
198572,1,0,0,0,3,1
420395,4,20,20,0,17,1
79060,4,13,14,-1,2,0
232521,3,20,10,10,1,0
165294,4,17,24,-7,6,0
193503,1,0,0,0,1,0
145306,2,14,12,2,14,1
88067,3,24,3,21,6,1
63596,2,13,20,-7,12,1
264018,1,0,0,0,15,1
142522,4,30,13,17,13,1
133335,3,14,6,8,9,0
260529,3,27,0,27,14,0
258106,2,13,13,0,13,0
143307,1,0,10,-10,14,1
133030,3,9,14,-5,9,1
336617,4,7,0,7,14,0
379761,3,9,17,-8,16,0
347699,4,27,24,3,1,1
41784,3,10,14,-4,2,0
267206,1,3,0,3,17,0
299451,3,7,20,-13,14,0
326388,4,20,10,10,9,0
217185,4,12,16,-4,12,0
96096,1,0,6,-6,10,1
243155,4,20,22,-2,6,1
30945,4,17,24,-7,15,0
354338,2,35,3,32,4,0
9387,4,31,14,17,5,1
386167,2,3,3,0,2,1
237951,1,3,0,3,4,1
163689,1,0,6,-6,5,1
66895,2,6,7,-1,14,1
45582,2,7,13,-6,4,0
279967,2,3,10,-7,5,0
337832,4,30,6,24,14,0
176957,2,10,3,7,11,0
158626,2,7,7,0,3,1
134162,1,0,3,-3,10,0
283986,2,0,0,0,7,1
281170,2,14,13,1,6,1
403258,1,0,0,0,9,1
117906,1,0,0,0,2,0
309506,1,0,0,0,1,1
21827,1,0,0,0,11,0
14368,4,9,17,-8,7,0
347352,4,14,21,-7,1,1
124873,3,9,6,3,5,1
255877,4,20,14,6,12,1
262757,3,28,3,25,15,0
88662,3,20,13,7,6,1
334485,1,0,14,-14,13,1
279840,2,14,13,1,5,0
304247,4,33,14,19,16,1
417828,2,10,0,10,16,0
64217,4,38,6,32,13,0
296019,2,3,7,-4,13,1
401844,3,7,21,-14,9,0
285661,5,27,27,0,8,0
420230,4,3,13,-10,17,1
386239,3,12,17,-5,2,0
418677,1,0,0,0,16,0
246908,2,14,7,7,8,0
209193,2,7,7,0,8,0
216905,4,13,24,-11,12,1
305431,3,20,3,17,17,0
31531,4,3,17,-14,15,0
190940,2,9,0,9,17,0
90881,2,31,0,31,7,0
396664,1,7,7,0,6,1
266843,4,17,17,0,16,1
332234,4,10,16,-6,12,1
305795,1,0,0,0,17,0
111123,4,31,10,21,16,0
57843,4,22,10,12,10,0
199011,4,19,26,-7,3,1
371411,1,7,7,0,12,1
51756,3,3,19,-16,7,0
115367,1,6,0,6,1,1
130116,1,0,0,0,8,0
94432,1,0,0,0,9,1
170563,2,20,3,17,8,1
175106,2,14,10,4,10,1
74123,3,23,6,17,17,0
170795,4,27,13,14,8,1
354105,4,19,0,19,4,1
202356,4,20,13,7,5,1
261395,3,10,17,-7,14,1
232675,3,7,0,7,1,1
151878,2,13,0,13,17,0
93659,4,23,13,10,9,0
248153,2,3,10,-7,8,1
311702,4,12,9,3,2,0
103470,1,6,0,6,13,1
29683,1,0,0,0,14,1
125304,2,10,3,7,5,1
353734,4,13,17,-4,4,1
62525,5,16,16,0,12,0
309201,1,0,0,0,1,0
290606,1,7,0,7,10,1
158873,1,0,0,0,3,1
346642,2,14,3,11,1,0
290419,4,28,10,18,10,1
16021,1,7,0,7,8,0
357569,3,13,13,0,5,0
54744,1,3,0,3,8,0
261103,3,7,21,-14,14,1
83858,3,20,3,17,4,0
272130,4,23,9,14,2,1
68537,3,7,28,-21,14,1
2787,1,14,7,7,2,0
239154,3,13,13,0,4,0
309139,3,26,3,23,1,0
151881,2,13,0,13,17,0
251024,4,3,6,-3,10,1
397270,1,0,14,-14,6,1
104431,1,0,7,-7,13,1
328188,4,14,14,0,10,0
140080,1,0,0,0,12,0
364387,2,21,7,14,9,1
354336,2,35,3,32,4,0
335438,2,13,9,4,13,0
57471,2,14,10,4,10,1
220126,3,26,13,13,13,1
121208,3,21,20,1,3,0
322137,1,0,7,-7,7,1
247033,1,0,0,0,8,0
34861,2,17,7,10,16,1
258856,3,14,13,1,13,0
413747,4,24,16,8,14,0
346541,3,24,33,-9,1,1
285477,4,36,8,28,8,0
130203,3,3,19,-16,8,0
319574,1,0,0,0,6,1
97468,1,6,0,6,10,1
362849,4,14,28,-14,8,1
90093,1,0,0,0,7,0
208096,4,21,19,2,8,0
164494,3,17,0,17,5,0
398143,1,0,3,-3,7,1
253872,2,28,14,14,11,1
324415,3,14,3,11,8,0
217056,4,23,3,20,12,0
405849,1,0,0,0,11,1
267094,2,3,3,0,17,1
375132,2,7,10,-3,14,1
404953,3,6,13,-7,10,1
383460,1,0,0,0,17,1
201739,1,0,0,0,5,1
418822,1,0,3,-3,16,1
336872,2,7,14,-7,14,1
332978,1,0,0,0,12,0
223452,1,0,0,0,15,1
152782,3,7,7,0,17,0
223911,4,30,6,24,15,0
12082,2,7,6,1,6,0
216402,4,21,23,-2,12,0
149781,1,3,0,3,16,0
74629,1,0,3,-3,17,1
412273,1,0,0,0,13,1
396057,1,10,0,10,6,0
10200,3,6,3,3,5,1
77054,2,7,10,-3,1,1
121092,4,18,31,-13,3,1
281402,1,0,0,0,6,0
145359,4,45,26,19,14,0
373213,2,3,13,-10,13,1
306884,2,3,13,-10,17,1
15605,2,14,10,4,8,1
370687,1,0,0,0,12,0
391064,4,27,34,-7,4,0
353935,4,23,28,-5,4,0
215604,2,14,3,11,11,1
219820,3,38,0,38,13,1
141227,3,3,24,-21,13,1
57653,3,17,10,7,10,0
345849,2,0,7,-7,17,0
404003,1,0,14,-14,10,1
339821,1,7,0,7,15,0
167187,2,23,7,16,7,0
382852,3,28,3,25,17,1
13770,3,7,20,-13,7,1
376212,2,10,7,3,14,1
124064,2,0,14,-14,5,1
299525,1,0,3,-3,14,1
306381,1,0,0,0,17,0
116581,2,10,0,10,2,0
187704,3,16,6,10,16,1
324917,4,17,23,-6,8,1
148944,3,10,12,-2,16,0
99405,1,0,0,0,11,0
331749,3,10,27,-17,12,1
359661,4,37,7,30,6,1
301617,2,10,3,7,15,1
251509,2,16,13,3,10,1
262196,4,31,16,15,15,0
31017,2,3,6,-3,15,0
860,4,14,12,2,1,1
91196,3,10,17,-7,8,1
35624,2,7,3,4,17,1
200438,2,13,18,-5,4,0
344225,2,7,3,4,17,0
90518,4,0,26,-26,7,0
408868,1,0,0,0,12,1
218091,1,0,0,0,12,0
401522,1,0,14,-14,8,1
188857,2,3,7,-4,16,1
274505,1,14,6,8,3,1
13632,3,13,10,3,7,1
21608,4,7,31,-24,11,0
187367,2,20,7,13,16,0
235603,4,27,13,14,3,0
41212,3,7,13,-6,2,0
402575,2,10,7,3,9,0
52107,4,13,19,-6,7,1
107175,2,0,14,-14,15,0
351992,3,28,21,7,3,1
277249,3,0,13,-13,4,1
341751,4,29,13,16,16,1
365788,4,17,17,0,9,1
162022,2,14,6,8,4,0
146689,3,7,29,-22,15,1
47715,3,6,17,-11,5,0
294272,4,28,21,7,12,0
34848,2,10,0,10,16,0
6190,1,7,0,7,3,0
31621,3,17,6,11,15,1
6117,3,7,10,-3,3,1
186525,4,17,33,-16,15,1
250997,4,3,6,-3,10,0
409357,1,3,3,0,12,1
415950,4,24,30,-6,15,0
58726,2,10,17,-7,10,0
250839,4,3,12,-9,10,1
202735,3,13,10,3,5,1
215371,4,24,20,4,11,0
258955,1,0,13,-13,13,1
223675,2,13,6,7,15,0
412056,2,21,0,21,13,1
263509,4,20,23,-3,15,0
114612,2,3,3,0,1,0
169360,2,6,14,-8,8,1
176368,3,16,28,-12,11,1
193572,3,0,10,-10,1,1
44188,4,13,27,-14,3,1
130094,4,17,36,-19,8,1
402787,4,30,14,16,9,0
126167,2,7,3,4,6,1
324349,1,0,0,0,8,1
55584,3,24,7,17,9,1
46779,3,14,20,-6,4,0
374077,1,0,0,0,13,0
242896,2,21,13,8,6,0
287111,1,0,0,0,8,0
340336,2,17,7,10,15,0
29975,2,14,0,14,14,1
36078,3,31,0,31,17,1
264487,1,0,0,0,16,1
173135,2,10,7,3,9,1
196439,4,20,21,-1,2,1
177901,4,21,23,-2,12,1
79715,2,10,7,3,2,0
240267,1,7,7,0,5,1
306619,3,7,20,-13,17,1
282539,3,17,17,0,6,1
1873,4,19,10,9,1,1
64413,1,0,3,-3,13,0
378078,4,0,17,-17,15,1
376628,1,0,0,0,14,0
281293,2,14,6,8,6,0
86453,3,30,14,16,5,1
195420,4,24,3,21,2,0
227276,2,3,20,-17,16,1
216046,2,10,12,-2,11,0
52599,4,22,10,12,7,0
349653,1,0,0,0,2,1
385662,4,24,24,0,1,0
83997,2,17,3,14,4,0
345559,3,7,20,-13,17,1
109078,1,0,0,0,15,1
210300,2,6,10,-4,9,1
243647,4,23,20,3,6,1
15230,3,16,7,9,8,1
206669,1,0,7,-7,7,1
179376,2,3,12,-9,12,0
208080,4,21,19,2,8,1
337762,2,20,6,14,14,0
72422,1,7,0,7,16,0
6687,3,3,20,-17,3,0
385551,2,0,10,-10,1,0
174600,4,13,21,-8,10,1
296794,3,7,0,7,13,0
175394,2,17,3,14,11,0
170790,4,27,13,14,8,0
309353,1,0,0,0,1,0
391679,2,0,3,-3,4,0
288819,2,10,14,-4,9,0
137983,1,7,14,-7,11,1
285503,4,36,15,21,8,0
37826,4,14,9,5,1,1
80709,4,32,33,-1,3,1
37611,2,7,0,7,17,1
142921,2,3,10,-7,13,1
20423,4,10,16,-6,10,1
303138,3,7,21,-14,16,1
93877,2,14,3,11,9,1
305552,2,6,0,6,17,1
39734,3,9,0,9,1,1
97886,4,21,27,-6,11,0
235882,3,0,14,-14,3,1
221526,1,6,9,-3,14,1
252775,2,3,6,-3,11,1
213281,4,17,27,-10,10,0
102336,3,13,13,0,13,1
44294,3,17,20,-3,3,0
134797,3,41,17,24,10,0
55259,3,7,10,-3,9,1
411465,2,10,17,-7,13,1
344376,2,21,14,7,17,0
61332,1,0,0,0,11,0
752,1,0,0,0,1,0
345380,2,0,10,-10,17,0
82878,1,0,0,0,4,1
337916,2,10,0,10,14,1
232337,2,6,9,-3,1,0
356712,3,19,16,3,5,1
261503,2,6,0,6,14,1
198923,2,6,16,-10,3,1
171000,2,7,7,0,8,0
144709,2,3,0,3,14,1
160457,2,13,7,6,4,0
159279,3,23,24,-1,3,1
19802,4,12,18,-6,10,0
234346,3,17,3,14,2,0
266337,2,10,0,10,16,0
418889,3,13,10,3,16,0
137317,1,0,0,0,11,1
68174,2,7,7,0,14,0
155027,1,6,12,-6,1,1
197003,3,20,17,3,3,0
178774,2,21,7,14,12,1
176918,1,6,0,6,11,1
302077,3,20,24,-4,15,1
77777,2,7,14,-7,1,1
3601,2,20,21,-1,2,1
81028,4,23,23,0,3,0
290127,4,21,15,6,10,0
419039,3,7,20,-13,16,1
236886,1,12,0,12,3,1
266085,3,17,10,7,16,1
229274,3,24,21,3,17,1
7293,4,17,13,4,4,1
360980,1,0,0,0,7,0
231572,1,7,3,4,1,1
97370,2,9,13,-4,10,1
32809,2,6,0,6,15,1
418963,1,7,7,0,16,1
231292,2,3,3,0,1,0
420944,2,7,14,-7,17,0
347242,1,0,0,0,1,1
146595,4,21,38,-17,15,0
231170,3,10,7,3,1,0
247223,1,14,7,7,8,0
338745,4,27,17,10,14,1
38704,4,17,14,3,1,0
366294,3,28,10,18,10,1
340465,1,0,13,-13,15,0
174272,1,0,0,0,10,1
164391,4,30,3,27,5,1
174091,3,8,36,-28,10,1
303595,2,21,13,8,16,1
146708,3,7,32,-25,15,1
80487,2,5,3,2,3,0
167972,2,0,14,-14,7,1
366610,4,26,14,12,10,0
169407,4,6,28,-22,8,0
184437,4,31,6,25,14,0
74303,4,10,30,-20,17,0
34780,4,20,3,17,16,1
114900,4,31,40,-9,1,0
287607,2,3,3,0,9,0
27348,3,24,10,14,13,0
114086,3,21,0,21,17,0
203636,2,7,10,-3,6,0
261991,2,17,17,0,14,1
33083,2,3,14,-11,16,1
208153,2,0,0,0,8,1
341777,1,0,0,0,16,0
279033,4,13,33,-20,5,1
362339,2,10,7,3,8,1
170281,2,0,12,-12,8,0
106295,2,7,6,1,14,0
152395,3,28,3,25,17,1
137509,2,7,14,-7,11,1
58683,1,7,7,0,10,1
322619,3,3,6,-3,7,1
121546,3,16,10,6,4,1
204179,4,24,17,7,6,0
166946,4,16,9,7,6,1
133429,1,14,7,7,9,0
231601,2,14,9,5,1,0
211813,2,14,7,7,9,0
273225,4,40,7,33,2,0
283652,4,23,20,3,7,0
391676,2,0,3,-3,4,0
86578,3,30,3,27,5,0
58342,1,7,0,7,10,0
215890,2,3,7,-4,11,0
119259,2,7,3,4,3,1
118382,2,6,10,-4,2,1
7026,4,19,7,12,3,0
107361,3,16,6,10,15,1
39843,2,3,0,3,1,1
76529,3,7,27,-20,1,1
392702,4,16,0,16,4,0
119563,2,7,0,7,3,1
89750,4,16,23,-7,7,1
170713,2,21,6,15,8,1
45640,3,13,13,0,4,1
24905,4,16,6,10,12,0
396911,4,27,27,0,6,1
299127,2,3,13,-10,14,1
140213,5,13,13,0,12,1
236695,3,17,7,10,3,1
347911,2,0,14,-14,1,1
150927,3,10,7,3,17,1
97409,4,15,23,-8,10,1
80859,4,6,3,3,3,0
248175,3,6,10,-4,8,1
420865,4,17,34,-17,17,1
17838,2,16,10,6,9,1
219734,1,0,0,0,13,1
194865,1,0,7,-7,2,0
407117,2,7,20,-13,11,1
409890,4,30,8,22,12,1
401718,3,10,14,-4,8,1
26560,2,10,3,7,13,0
357728,3,40,13,27,5,0
267059,1,3,0,3,17,1
399624,2,6,3,3,8,0
98561,2,0,7,-7,11,0
353968,5,34,31,3,4,0
83756,4,25,23,2,4,1
361249,3,14,26,-12,7,1
337487,2,7,12,-5,14,0
116708,2,6,10,-4,2,0
103513,2,13,0,13,13,1
198908,2,3,16,-13,3,1
100496,2,7,10,-3,12,0
219714,4,13,14,-1,13,0
139121,2,9,6,3,12,1
196689,2,33,0,33,3,0
46037,2,14,14,0,4,1
83869,3,23,10,13,4,1
242588,2,3,0,3,6,1
102389,4,16,27,-11,13,1
379028,2,7,6,1,15,1
189619,2,10,3,7,17,1
57818,4,19,10,9,10,0
394710,1,14,0,14,5,0
416168,2,10,9,1,15,0
141923,1,7,0,7,13,1
323408,4,20,0,20,7,1
331669,1,0,0,0,12,0
280235,1,3,7,-4,5,1
331904,3,0,16,-16,12,1
1621,1,0,0,0,1,0
164495,3,17,0,17,5,0
71181,3,19,10,9,16,0
7210,1,0,0,0,4,0
370921,4,20,17,3,12,0
276789,2,17,10,7,4,0
171559,1,0,0,0,9,0
326800,2,3,14,-11,9,1
149379,2,6,6,0,16,1
185399,2,7,10,-3,15,0
178313,2,7,3,4,12,1
15395,4,10,24,-14,8,1
46625,3,3,0,3,4,1
375164,3,17,10,7,14,1
51767,3,3,19,-16,7,0
113150,2,41,7,34,17,1
1223,2,10,6,4,1,1
238694,3,16,17,-1,4,0
201352,3,28,13,15,5,0
289437,2,0,0,0,10,1
280478,4,34,31,3,5,0
412176,2,14,3,11,13,0
420063,4,24,14,10,17,0
292803,4,29,17,12,11,1
378697,1,7,7,0,15,1
416090,4,21,13,8,15,0
24148,4,31,14,17,12,0
77143,4,17,17,0,1,1
145822,4,13,26,-13,15,0
72405,4,17,23,-6,16,1
208029,3,21,0,21,8,0
81966,1,0,0,0,3,0
45086,4,23,20,3,4,1
271855,1,0,3,-3,2,0
202347,4,20,13,7,5,1
100587,1,0,0,0,12,1
401973,2,3,9,-6,9,0
195594,4,24,7,17,2,0
220856,3,7,28,-21,14,0
287244,4,22,23,-1,8,1
70218,4,30,30,0,15,0
102474,2,10,3,7,13,1
414034,4,10,45,-35,14,1
330844,2,10,17,-7,11,1
209123,4,9,30,-21,8,0
372483,3,23,14,9,13,0
150517,4,41,6,35,16,0
11941,2,0,0,0,6,1
124738,3,3,3,0,5,0
345598,4,14,23,-9,17,1
104788,3,20,26,-6,14,1
313329,4,13,24,-11,3,0
102905,2,6,14,-8,13,0
77227,2,9,0,9,1,1
385004,3,24,16,8,1,1
354955,2,7,6,1,4,1
269676,3,10,3,7,1,0
158768,2,0,3,-3,3,1
64696,2,14,0,14,13,1
245141,3,17,15,2,7,0
77568,4,20,14,6,1,1
91911,1,0,3,-3,8,1
267358,2,0,7,-7,17,1
162814,2,3,0,3,5,1
7547,1,7,0,7,4,1
53146,4,19,38,-19,7,0
17466,1,0,0,0,9,1
298378,2,7,14,-7,14,1
18010,3,16,21,-5,9,1
327186,4,28,17,11,9,1
410222,1,7,0,7,13,0
217990,2,14,10,4,12,1
329890,1,0,7,-7,11,1
28133,4,27,10,17,13,1
7681,1,0,0,0,4,1
15334,2,7,3,4,8,0
121697,3,20,7,13,4,1
72811,3,24,17,7,16,1
132287,3,24,7,17,9,0
195145,1,0,0,0,2,1
92481,4,23,10,13,8,0
278766,2,0,0,0,5,0
293716,4,10,13,-3,12,1
380675,3,7,7,0,16,1
132475,4,8,31,-23,9,1
366800,1,0,0,0,10,1
347500,3,12,23,-11,1,1
121764,4,28,52,-24,4,0
184004,4,22,10,12,14,1
281067,4,24,16,8,6,1
402683,1,0,0,0,9,1
287463,2,7,13,-6,9,0
38546,3,24,6,18,1,0
165527,3,3,21,-18,6,1
44360,1,0,0,0,3,0
376922,1,0,3,-3,15,1
287981,4,20,13,7,9,0
393588,3,7,26,-19,5,1
419379,4,3,26,-23,16,1
29760,3,41,3,38,14,0
310907,2,3,3,0,2,0
234210,3,20,10,10,2,1
51227,4,32,25,7,7,1
172779,4,21,18,3,9,1
271298,3,6,17,-11,1,1
80575,4,16,10,6,3,0
403085,4,34,33,1,9,0
284044,3,10,3,7,7,0
328327,3,3,17,-14,10,0
209202,2,7,7,0,8,1
360626,3,7,20,-13,7,1
170664,1,0,0,0,8,1
124901,4,9,13,-4,5,0
418499,4,24,12,12,16,0
197690,1,7,3,4,3,1
252209,4,23,24,-1,10,0
95983,2,0,0,0,10,1
197661,1,0,0,0,3,0
167108,4,22,34,-12,7,0
327420,3,3,17,-14,9,0
132760,4,20,24,-4,9,1
212609,2,7,17,-10,10,0
389927,2,18,10,8,3,1
41124,1,0,0,0,2,1
390689,2,6,3,3,3,1
152767,2,7,7,0,17,0
54001,1,0,0,0,8,1
395382,3,28,3,25,5,1
161123,2,3,19,-16,4,0
312974,2,0,0,0,3,1
173820,4,17,3,14,10,1
164438,1,7,0,7,5,1
347675,4,20,23,-3,1,0
292540,4,17,19,-2,11,1
128032,1,0,3,-3,7,1
83204,2,3,7,-4,4,0
184517,2,17,14,3,14,1
233203,4,43,18,25,2,1
167071,3,13,31,-18,7,0
92722,3,3,17,-14,8,1
177415,3,17,10,7,11,0
27154,2,0,7,-7,13,0
414759,4,10,17,-7,14,0
221653,5,23,24,-1,14,0
421818,2,0,10,-10,17,0
116710,2,6,10,-4,2,1
27854,4,17,17,0,13,0
172029,1,0,0,0,9,1
75065,1,0,0,0,17,1
371606,3,10,17,-7,12,1
379689,1,3,0,3,16,1
272084,3,10,6,4,2,0
411411,1,0,7,-7,13,1
248306,2,17,7,10,8,1
328145,3,6,7,-1,10,0
168793,1,0,0,0,7,0
264733,2,10,13,-3,16,0
78649,4,30,13,17,2,0
206606,4,10,13,-3,7,0
245221,1,0,0,0,7,1
338229,3,14,24,-10,14,1
95255,2,3,10,-7,10,1
290240,3,17,3,14,10,1
97397,3,9,16,-7,10,0
146876,3,31,0,31,15,0
135018,1,7,0,7,10,0
317894,1,0,0,0,5,1
213316,1,3,3,0,10,1
151871,1,10,0,10,17,1
323737,1,0,0,0,8,0
200187,4,7,37,-30,4,0
160832,3,34,17,17,4,0
6546,3,3,3,0,3,0
24526,2,7,7,0,12,1
39126,3,13,10,3,1,1
255574,4,30,7,23,12,1
353036,1,0,0,0,3,0
43053,2,3,7,-4,3,1
408352,3,19,7,12,12,0
172078,3,10,3,7,9,1
221593,3,20,18,2,14,1
368008,3,17,21,-4,11,1
7396,1,3,0,3,4,0
128661,3,6,10,-4,7,0
335520,1,0,0,0,13,1
405039,1,0,0,0,10,1
313735,2,21,3,18,3,0
75049,1,0,0,0,17,0
53899,3,7,13,-6,8,1
72246,4,24,17,7,16,1
225029,1,0,0,0,15,0
382080,2,14,3,11,17,1
109708,2,10,0,10,16,0
382312,4,20,3,17,17,1
356211,4,28,7,21,5,1
263382,4,37,17,20,15,1
70378,4,18,33,-15,15,1
280788,1,0,0,0,6,1
88727,1,3,0,3,6,0
42416,4,14,19,-5,2,0
20223,4,24,10,14,10,1
293288,4,26,7,19,11,0
1727,4,28,0,28,1,1
126309,2,0,7,-7,6,1
65850,1,0,7,-7,13,1
364915,4,16,23,-7,9,1
22133,2,9,6,3,11,1
34771,4,20,3,17,16,0
30635,4,17,9,8,14,1
113629,3,6,13,-7,17,1
240950,3,14,9,5,5,1
408975,4,31,24,7,12,0
209178,1,0,7,-7,8,1
134295,1,7,7,0,10,0
334745,4,25,9,16,13,1
182271,2,7,0,7,14,1
378912,3,13,30,-17,15,1
293796,2,17,3,14,12,0
138248,4,10,12,-2,11,0
304774,2,0,0,0,16,0
104424,1,0,0,0,13,0
174267,4,10,33,-23,10,1
6874,4,10,31,-21,3,1
28811,2,3,0,3,14,1
293541,3,10,17,-7,11,1
98564,2,0,7,-7,11,1
142160,4,2,7,-5,13,0
266189,2,21,0,21,16,1
159214,2,14,14,0,3,0
99133,1,0,0,0,11,0
94879,4,13,13,0,9,1
41710,1,0,0,0,2,0
380789,2,9,21,-12,16,1
8897,2,14,0,14,4,1
290163,1,3,0,3,10,0
57450,1,7,0,7,10,0
258193,4,20,19,1,13,0
69272,2,13,0,13,15,0
162513,3,21,10,11,4,1
413386,2,0,21,-21,14,1
199245,3,17,21,-4,4,0
157059,1,0,0,0,2,0
151045,2,9,3,6,17,1
15503,3,16,6,10,8,0
108999,3,16,27,-11,15,0
410219,1,7,0,7,13,1
325981,4,22,7,15,9,1
174497,2,7,7,0,10,0
71257,1,0,0,0,16,0
329390,4,16,34,-18,10,0
246773,2,3,6,-3,8,0
31587,2,7,3,4,15,1
113507,4,3,7,-4,17,1
155505,2,14,0,14,2,0
316783,3,13,7,6,4,1
386819,3,10,14,-4,2,1
288968,2,16,0,16,9,0
414465,4,16,23,-7,14,0
121473,2,0,0,0,4,1
252732,1,0,3,-3,11,1
270193,1,3,0,3,1,0
273545,4,21,35,-14,2,1
58961,4,20,32,-12,10,1
39002,4,30,17,13,1,1
114877,4,16,33,-17,1,1
87015,3,14,15,-1,5,0
413673,2,7,6,1,14,0
45785,3,13,14,-1,4,1
52828,2,0,37,-37,7,1
256455,3,12,24,-12,12,1
153255,2,2,0,2,1,0
136407,2,3,7,-4,11,1
320195,1,0,0,0,6,1
270159,4,27,25,2,1,0
353101,2,7,22,-15,3,1
163952,4,26,13,13,5,1
347129,2,13,10,3,1,1
315763,1,0,3,-3,4,0
113874,2,7,3,4,17,0
228310,1,0,6,-6,17,0
227949,4,27,27,0,16,0
300926,3,10,20,-10,15,0
20060,4,19,16,3,10,0
193037,1,0,0,0,1,1
97462,1,6,0,6,10,1
362967,3,27,9,18,8,0
285841,4,14,27,-13,8,0
385453,3,28,10,18,1,1
252249,1,0,7,-7,10,1
254449,2,20,7,13,11,1
179997,2,7,13,-6,13,1
97302,1,0,0,0,10,0
19310,3,14,17,-3,10,1
74173,1,3,0,3,17,1
343431,1,0,0,0,16,1
384632,4,10,59,-49,1,0
349742,3,20,7,13,2,1
94769,2,3,3,0,9,1
296365,4,13,25,-12,13,0
282893,5,23,23,0,6,0
200568,2,14,7,7,4,0
309335,4,3,23,-20,1,0
401706,3,10,14,-4,8,1
287404,4,20,10,10,8,1
57162,2,7,0,7,10,1
114813,3,13,20,-7,1,0
382072,1,7,3,4,17,1
59590,2,7,3,4,11,0
72703,4,27,13,14,16,1
249560,3,14,10,4,9,0
100614,2,0,7,-7,12,1
178171,2,0,7,-7,12,0
78173,3,20,3,17,2,1
238236,3,3,16,-13,4,0
369746,3,38,30,8,11,0
64986,2,0,7,-7,13,0
293094,4,10,20,-10,11,0
99633,3,10,3,7,11,1
359456,2,0,14,-14,6,0
132086,1,7,0,7,9,0
25435,4,13,10,3,12,0
267226,2,10,7,3,17,0
314184,2,7,20,-13,3,1
418118,2,14,0,14,16,0
186970,4,10,12,-2,15,0
145395,1,0,0,0,14,0
207038,3,35,3,32,7,0
299719,3,17,3,14,14,0
99062,3,16,0,16,11,0
262187,4,31,13,18,15,0
203358,3,21,27,-6,6,0
223631,1,6,3,3,15,1
161569,2,9,10,-1,4,0
319291,2,10,3,7,6,0
239559,2,13,0,13,4,0
333596,4,24,23,1,12,1
263594,2,7,7,0,15,0
215291,1,7,0,7,11,0
403099,5,34,34,0,9,1
354252,4,20,17,3,4,1
225008,1,0,0,0,15,1
408455,2,6,3,3,12,1
113249,1,7,7,0,17,1
46090,4,21,14,7,4,0
215552,4,13,6,7,11,1
391274,2,14,0,14,4,0
364887,3,13,20,-7,9,0
364606,4,21,37,-16,9,0
46775,3,14,20,-6,4,0
44258,2,17,13,4,3,1
147449,4,23,10,13,15,0
360781,3,24,24,0,7,1
156385,4,38,14,24,2,1
193625,4,7,17,-10,1,1
309168,4,35,3,32,1,1
125662,4,21,24,-3,5,1
155870,3,7,10,-3,2,0
306477,3,10,17,-7,17,1
301417,1,0,0,0,15,1
363790,1,7,7,0,8,1
410709,2,10,3,7,13,1
402655,1,0,0,0,9,1
49114,5,20,20,0,6,1
383340,1,0,0,0,17,0
62543,1,0,0,0,12,1
122084,1,0,7,-7,4,1
268921,3,6,30,-24,17,0
334613,4,38,31,7,13,0
320253,2,14,7,7,6,1
156008,2,10,14,-4,2,1
39319,4,17,27,-10,1,1
224601,2,6,7,-1,15,1
366530,2,13,7,6,10,0
416784,3,10,10,0,15,0
215618,2,14,3,11,11,1
299742,3,17,6,11,14,0
66477,2,7,10,-3,14,0
129870,3,10,0,10,7,1
168903,3,17,6,11,7,0
329797,3,17,20,-3,11,0
102500,3,31,3,28,13,0
386940,2,7,21,-14,2,0
127910,2,10,0,10,6,1
403139,2,7,7,0,9,1
175675,2,16,3,13,11,0
2140,4,10,16,-6,1,1
144972,1,0,0,0,14,1
59224,3,21,51,-30,10,0
233978,1,7,0,7,2,1
288242,3,10,21,-11,9,0
248520,4,23,20,3,8,0
308760,4,10,20,-10,1,0
7993,1,3,0,3,4,0
28749,4,10,16,-6,14,0
217902,3,17,28,-11,12,1
318099,2,9,7,2,5,1
252533,4,29,25,4,10,0
260433,4,20,14,6,14,1
293244,3,23,7,16,11,0
125675,4,28,24,4,5,1
277627,4,27,27,0,4,0
378881,3,13,13,0,15,0
124015,4,13,14,-1,5,1
321426,2,14,17,-3,7,0
197052,4,30,33,-3,3,0
368931,1,0,0,0,11,0
118829,2,20,0,20,2,0
51975,1,0,0,0,7,1
33901,1,0,3,-3,16,0
232658,3,7,0,7,1,0
234185,2,10,10,0,2,0
90557,1,7,7,0,7,0
230708,2,6,27,-21,1,0
81480,1,0,0,0,3,0
341850,3,13,15,-2,16,1
239262,2,0,7,-7,4,1
323325,1,0,0,0,7,0
297308,1,0,0,0,13,0
171583,1,3,0,3,9,0
93601,3,6,6,0,9,1
335379,1,0,0,0,13,0
259695,1,3,0,3,14,0
154275,2,6,13,-7,1,0
72107,4,10,17,-7,16,0
85302,2,7,3,4,5,1
354626,2,3,7,-4,4,1
347296,3,6,7,-1,1,1
343840,3,24,3,21,17,0
268912,2,6,30,-24,17,1
101730,3,13,7,6,12,0
263814,4,7,24,-17,15,0
185772,4,25,3,22,15,0
277540,2,3,14,-11,4,1
122974,2,0,3,-3,4,1
183010,4,10,44,-34,14,0
49357,3,7,10,-3,6,1
361511,3,7,7,0,7,1
391731,3,3,10,-7,4,1
225623,2,0,10,-10,16,1
323665,3,20,0,20,8,1
1568,4,16,13,3,1,0
72078,3,10,10,0,16,0
75375,1,0,0,0,17,0
141871,4,24,20,4,13,0
173369,4,31,27,4,10,1
100878,1,0,0,0,12,1
130926,2,0,14,-14,8,1
356606,5,9,9,0,5,1
165801,2,3,3,0,6,0
380021,2,14,0,14,16,0
399601,2,3,0,3,8,0
414130,3,10,13,-3,14,1
26889,2,10,6,4,13,0
255835,3,17,0,17,12,1
346342,2,3,6,-3,1,0
93403,1,3,7,-4,9,1
4304,1,0,0,0,2,0
260862,4,36,15,21,14,1
48986,1,3,7,-4,6,0
21299,3,3,14,-11,11,1
187889,4,7,23,-16,16,0
27958,3,21,17,4,13,0
15317,2,7,0,7,8,0
156568,1,0,0,0,2,0
86944,1,7,0,7,5,1
10676,4,10,17,-7,5,0
321626,3,17,13,4,7,0
360890,2,14,0,14,7,1
249911,4,12,20,-8,9,0
100924,2,7,3,4,12,0
421673,2,17,7,10,17,0
151598,2,0,10,-10,17,1
241370,2,7,7,0,5,1
372721,1,0,0,0,13,0
83626,4,10,17,-7,4,1
327992,2,10,0,10,10,1
125517,4,30,7,23,5,0
202484,4,9,16,-7,5,1
11124,4,17,20,-3,5,1
261214,2,21,0,21,14,0
201276,2,13,0,13,5,1
170881,3,7,7,0,8,1
364892,4,13,20,-7,9,1
238367,3,10,16,-6,4,1
238188,2,3,16,-13,4,1
265334,2,7,7,0,16,1
327935,1,0,0,0,10,0
128376,3,7,13,-6,7,1
373394,3,10,7,3,13,0
374123,2,13,7,6,13,1
94622,2,7,19,-12,9,1
64787,4,31,7,24,13,1
418025,4,27,35,-8,16,1
153270,2,2,7,-5,1,1
416501,3,28,17,11,15,0
391444,3,10,17,-7,4,0
401278,3,13,14,-1,8,1
117,4,7,10,-3,1,0
179323,4,39,11,28,12,0
54957,3,3,3,0,8,1
317693,4,23,9,14,5,0
382492,1,0,0,0,17,1
116199,4,22,19,3,1,1
158102,4,22,9,13,3,1
420129,2,0,0,0,17,0
343499,3,7,10,-3,16,0
70444,2,14,17,-3,15,0
110737,2,3,3,0,16,0
98145,3,21,10,11,11,0
191908,4,36,16,20,1,0
249465,5,21,18,3,9,1
325690,4,34,13,21,9,0
353745,4,20,17,3,4,0
398619,2,0,0,0,7,0
293719,4,10,13,-3,12,1
146530,2,7,10,-3,15,1
256504,1,0,0,0,12,1
334537,2,14,17,-3,13,1
201132,1,6,14,-8,5,0
275198,4,17,16,1,3,0
34034,4,20,27,-7,16,1
343751,1,7,0,7,17,0
176007,2,17,0,17,11,0
29155,3,0,19,-19,14,1
174957,2,6,14,-8,10,1
331877,3,0,3,-3,12,0
187957,2,6,7,-1,16,0
208108,1,0,0,0,8,0
253318,4,13,13,0,11,1
35504,3,27,7,20,17,1
39048,1,0,0,0,1,1
126322,2,7,7,0,6,1
396282,3,3,6,-3,6,1
254602,3,14,14,0,11,0
395090,3,10,31,-21,5,0
146661,2,7,23,-16,15,0
303536,1,0,0,0,16,0
53464,4,10,35,-25,8,1
233660,1,0,0,0,2,1
349808,5,29,29,0,2,1
128667,3,6,17,-11,7,1
46501,3,27,6,21,4,1
246782,3,3,13,-10,8,0
269452,1,0,0,0,1,0
260282,4,24,3,21,14,1
257346,2,17,0,17,13,0
171960,3,14,14,0,9,1
337648,3,14,13,1,14,1
167668,2,10,20,-10,7,0
148287,2,7,0,7,16,0
311705,4,12,9,3,2,1
64400,1,0,3,-3,13,1
168620,4,17,16,1,7,1
239448,3,9,17,-8,4,1
339604,3,24,14,10,15,1
216652,2,14,6,8,12,0
190950,2,9,0,9,17,0
410872,2,14,12,2,13,1
190611,1,7,6,1,17,0
247968,1,0,3,-3,8,1
350642,4,13,3,10,2,1
237860,3,7,27,-20,4,0
338361,2,3,0,3,14,0
240415,1,0,0,0,5,0
88973,3,36,10,26,6,1
186039,3,24,34,-10,15,1
323920,1,7,7,0,8,1
420861,4,17,34,-17,17,1
219396,4,30,20,10,13,0
153914,4,7,12,-5,1,1
156197,3,14,10,4,2,1
151531,4,42,7,35,17,0
414779,4,17,17,0,14,0
243774,3,17,17,0,6,1
300034,3,0,27,-27,14,1
55091,3,16,3,13,8,1
128861,4,20,16,4,7,0
170728,3,21,6,15,8,0
200459,3,20,18,2,4,0
124614,4,13,17,-4,5,0
362598,1,0,0,0,8,0
257832,2,7,6,1,13,1
84824,1,0,0,0,4,0
111449,4,0,20,-20,16,0
391469,4,10,27,-17,4,0
210459,3,9,14,-5,9,1
261828,2,6,10,-4,14,1
89048,2,6,6,0,6,0
313839,1,7,3,4,3,0
205823,3,17,0,17,7,1
48170,4,10,13,-3,5,0
284267,1,0,0,0,7,1
72893,1,3,7,-4,16,0
365776,3,17,17,0,9,0
401668,2,0,14,-14,8,0
108439,4,13,28,-15,15,0
391232,1,0,0,0,4,1
157523,1,0,0,0,2,1
372070,4,13,10,3,13,1
56,2,0,0,0,1,0
126740,4,13,13,0,6,0
10238,4,6,10,-4,5,1
104661,4,7,3,4,14,1
393116,3,24,3,21,4,0
361315,1,0,0,0,7,1
94058,3,6,21,-15,9,0
358747,3,14,17,-3,6,0
97591,4,44,7,37,10,1
335159,3,20,6,14,13,0
212951,3,7,7,0,10,1
308616,4,21,16,5,1,0
213662,2,13,14,-1,10,1
73427,4,30,3,27,17,1
277183,1,0,0,0,4,0
333222,3,3,7,-4,12,1
366725,3,24,10,14,10,0
28357,2,3,0,3,14,1
198306,2,6,14,-8,3,0
235699,2,0,10,-10,3,1
307194,3,0,10,-10,17,0
263248,4,17,23,-6,15,1
298642,2,3,0,3,14,1
197766,4,21,17,4,3,0
34936,4,27,24,3,16,0
222717,4,14,24,-10,14,0
73623,2,0,0,0,17,1
369726,3,29,23,6,11,0
318402,2,21,6,15,5,0
420897,1,0,0,0,17,1
89984,2,2,14,-12,7,1
130276,1,0,0,0,8,0
358707,2,7,7,0,6,0
364340,4,9,39,-30,9,0
98403,2,7,7,0,11,1
267967,2,0,3,-3,17,0
73780,2,6,0,6,17,0
268189,4,12,17,-5,17,0
156567,1,0,0,0,2,0
43838,3,21,16,5,3,1
133620,3,10,7,3,9,0
105308,1,0,0,0,14,0
134350,3,16,21,-5,10,0
394800,4,24,6,18,5,1
22760,3,3,21,-18,11,0
252524,4,23,25,-2,10,0
1408,3,16,0,16,1,1
71017,2,10,0,10,16,1
321288,2,9,13,-4,6,0
420964,3,7,20,-13,17,0
289747,2,0,10,-10,10,0
339664,1,0,0,0,15,1
301482,3,20,9,11,15,0
41200,3,0,13,-13,2,1
69422,2,17,3,14,15,0
170760,4,24,6,18,8,0
55719,4,23,21,2,9,0
292416,1,3,0,3,11,0
327379,2,0,7,-7,9,0
349332,4,28,35,-7,2,0
284292,2,3,3,0,7,0
54419,4,33,25,8,8,1
360055,3,3,33,-30,7,1
382427,3,0,21,-21,17,0
339538,2,7,7,0,15,1
190952,2,9,0,9,17,1
409330,1,0,0,0,12,0
144440,3,3,26,-23,14,1
280312,4,16,22,-6,5,0
70852,2,7,10,-3,15,0
102495,3,24,3,21,13,1
97072,2,19,6,13,10,1
263693,4,30,13,17,15,1
206983,2,21,0,21,7,1
307111,4,24,6,18,17,1
216653,2,14,6,8,12,0
370536,1,0,0,0,12,1
110761,2,3,3,0,16,1
324094,2,0,7,-7,8,1
371823,1,0,10,-10,12,1
374539,2,14,6,8,14,1
197940,4,18,7,11,3,1
132132,3,10,3,7,9,1
233336,4,19,23,-4,2,0
14638,3,17,7,10,7,0
160670,3,10,0,10,4,0
161483,4,10,6,4,4,1
339617,3,24,17,7,15,0
77647,2,0,7,-7,1,0
61311,4,31,21,10,11,0
274865,2,0,10,-10,3,1
287301,1,3,0,3,8,1
299279,2,23,6,17,14,0
72192,2,10,10,0,16,1
233724,2,13,21,-8,2,0
202963,1,6,0,6,5,1
144185,1,0,7,-7,14,1
418126,2,14,3,11,16,1
213456,1,0,0,0,10,0
69020,4,24,17,7,15,0
317253,4,7,16,-9,5,1
56820,4,17,20,-3,9,1
214289,3,14,10,4,11,1
307969,3,7,6,1,1,0
60774,1,7,0,7,11,0
404791,3,17,13,4,10,1
158570,4,13,17,-4,3,1
228515,3,20,7,13,17,0
30983,1,0,3,-3,15,1
302802,2,9,13,-4,15,0
63844,1,0,7,-7,12,1
298025,4,40,7,33,13,0
51136,2,10,3,7,7,0
225360,3,10,21,-11,15,1
201832,3,20,23,-3,5,0
84820,1,0,0,0,4,1
319530,4,13,17,-4,6,1
142479,3,14,10,4,13,1
350030,2,13,7,6,2,0
262461,3,7,28,-21,15,1
270316,4,17,27,-10,1,1
118841,3,20,7,13,2,1
339445,3,10,17,-7,15,0
268529,1,7,0,7,17,0
239785,4,20,20,0,4,1
172596,4,17,24,-7,9,0
346780,1,0,0,0,1,1
374957,1,7,6,1,14,1
312589,4,44,0,44,3,0
281840,3,10,0,10,6,1
254028,3,7,13,-6,11,0
295717,3,3,9,-6,12,1
340326,2,17,7,10,15,0
287240,4,16,23,-7,8,1
395697,4,18,34,-16,6,0
113818,4,16,24,-8,17,1
151462,2,28,7,21,17,0
386034,2,7,0,7,1,1
145983,4,13,21,-8,15,0
12384,2,10,3,7,6,0
77478,1,0,7,-7,1,1
289465,2,3,7,-4,10,1
69101,2,7,7,0,15,0
387708,3,0,13,-13,2,0
245377,2,9,3,6,7,1
289632,3,10,13,-3,10,0
249968,1,0,3,-3,9,0
69108,2,7,7,0,15,1
293319,1,0,0,0,11,1
325771,2,0,10,-10,9,0
386817,3,10,14,-4,2,1
285482,4,36,8,28,8,0
386130,1,0,0,0,2,0
2710,3,9,7,2,2,0
186739,1,7,0,7,15,1
288284,4,10,35,-25,9,1
273646,3,13,6,7,2,0
336346,4,20,13,7,13,0
328619,3,17,35,-18,10,1
226112,2,7,14,-7,16,0
336563,2,7,0,7,14,0
219538,3,15,21,-6,13,0
395193,2,10,10,0,5,0
157369,1,3,0,3,2,1
275643,3,27,3,24,3,0
216882,3,13,14,-1,12,0
381054,2,14,6,8,16,1
169585,1,0,0,0,8,1
139824,2,10,10,0,12,0
150572,2,3,10,-7,17,1
41161,2,0,7,-7,2,1
373055,2,0,6,-6,13,0
157072,2,3,7,-4,2,1
234801,2,0,3,-3,2,0
323112,4,26,14,12,7,0
400219,2,10,6,4,8,1
391708,2,3,9,-6,4,0
15860,4,8,19,-11,8,0
322096,4,26,0,26,7,0
297799,2,14,7,7,13,1
79078,4,19,21,-2,2,0
302528,3,3,13,-10,15,0
91725,1,0,0,0,8,0
350222,4,27,0,27,2,0
133975,4,16,13,3,9,1
305462,4,20,10,10,17,1
397006,2,14,3,11,6,1
341178,2,3,0,3,16,1
194823,4,10,26,-16,2,0
32337,1,14,0,14,15,0
145290,2,14,9,5,14,1
168703,2,10,3,7,7,0
199072,2,7,14,-7,4,0
206473,4,24,0,24,7,0
55707,3,23,21,2,9,1
235313,4,25,6,19,3,0
377015,4,15,19,-4,15,1
186543,4,24,33,-9,15,1
361417,4,17,21,-4,7,1
122289,3,6,19,-13,4,0
190534,3,10,13,-3,17,1
74620,1,0,0,0,17,0
154744,2,3,10,-7,1,1
126994,3,17,10,7,6,0
361292,1,0,0,0,7,0
96258,1,0,6,-6,10,0
306769,3,16,27,-11,17,1
141304,1,0,7,-7,13,0
241068,1,7,0,7,5,1
317603,2,3,3,0,5,1
181379,2,14,7,7,13,1
87542,2,17,3,14,6,1
179509,1,0,16,-16,12,0
243115,3,7,12,-5,6,0
87436,3,20,7,13,6,0
344527,2,0,0,0,17,0
182682,4,11,19,-8,14,0
222236,4,13,24,-11,14,1
231459,3,10,9,1,1,1
146142,4,28,17,11,15,1
337217,3,16,16,0,14,1
222889,1,0,0,0,14,0
408224,4,13,3,10,12,1
171640,3,19,16,3,9,0
195849,4,27,21,6,2,0
38443,4,31,18,13,1,1
251540,3,16,13,3,10,0
222299,1,7,0,7,14,0
128461,1,14,7,7,7,1
28980,2,6,7,-1,14,1
108180,1,3,0,3,15,0
288818,2,10,14,-4,9,0
411440,2,7,17,-10,13,1
289102,1,3,0,3,9,0
378149,2,21,6,15,15,0
151484,2,34,7,27,17,1
322589,2,3,3,0,7,0
215728,1,16,0,16,11,0
409705,3,10,6,4,12,0
234426,1,7,3,4,2,1
204292,3,0,10,-10,6,0
320879,3,3,14,-11,6,1
113319,3,16,31,-15,17,1
367501,1,0,0,0,10,0
334169,4,23,14,9,13,1
287066,4,26,24,2,8,1
83800,1,0,0,0,4,1
128454,1,14,0,14,7,0
9040,2,14,13,1,4,1
9561,5,20,20,0,5,1
12218,2,0,0,0,6,1
116467,3,6,16,-10,1,1
107436,1,0,3,-3,15,0
52229,3,7,16,-9,7,0
213493,2,0,7,-7,10,1
59115,4,18,36,-18,10,1
110682,4,23,16,7,16,0
40161,2,13,7,6,2,0
3480,3,3,30,-27,2,1
45728,2,7,7,0,4,0
273059,4,9,3,6,2,1
359975,1,0,6,-6,7,0
419043,3,7,20,-13,16,0
234486,3,20,13,7,2,0
258385,2,14,6,8,13,0
409771,1,0,0,0,12,0
268511,4,23,9,14,17,0
317125,1,0,0,0,5,1
75380,1,7,0,7,17,0
96323,3,3,16,-13,10,1
348558,3,28,17,11,2,0
383557,3,21,13,8,17,0
103656,2,0,7,-7,13,0
335062,4,19,20,-1,13,0
26677,1,0,7,-7,13,1
177693,2,13,14,-1,12,1
407446,3,14,10,4,11,0
239515,1,3,0,3,4,0
321052,4,16,14,2,6,1
19548,2,0,7,-7,10,1
327839,2,10,10,0,10,0
270046,1,0,3,-3,1,1
345706,2,7,0,7,17,0
277996,2,3,10,-7,4,1
270888,4,19,13,6,1,0
247651,1,0,0,0,8,1
286815,1,3,0,3,8,0
224257,1,6,6,0,15,1
6949,2,0,0,0,3,1
71996,1,0,10,-10,16,0
234312,2,10,0,10,2,1
158421,4,16,27,-11,3,1
97022,2,13,0,13,10,1
211330,2,10,3,7,9,0
99989,4,17,19,-2,12,1
421773,1,0,0,0,17,1
76865,1,0,0,0,1,0
413001,4,16,15,1,14,1
156796,2,20,13,7,2,0
116925,3,21,10,11,2,1
392834,3,17,20,-3,4,1
121278,4,28,30,-2,3,1
16698,4,21,30,-9,8,0
97153,1,0,0,0,10,0
221387,2,3,17,-14,14,0
44444,3,17,7,10,3,0
409603,4,42,20,22,12,0
408144,2,3,0,3,12,1
39226,2,3,3,0,1,0
117471,2,7,14,-7,2,0
200502,4,26,18,8,4,0
420752,2,0,3,-3,17,1
136741,2,13,10,3,11,0
289280,2,14,14,0,9,0
120838,2,7,14,-7,3,0
256572,2,7,0,7,12,0
351055,2,14,13,1,3,0
71238,4,22,26,-4,16,1
3035,4,20,40,-20,2,0
229963,1,0,3,-3,17,0
318439,3,21,7,14,5,1
117492,3,7,17,-10,2,0
291470,4,21,20,1,10,0
35873,1,0,0,0,17,0
160781,1,10,7,3,4,0
270348,1,0,0,0,1,1
312322,1,7,14,-7,3,1
296077,4,9,14,-5,13,1
204531,1,0,7,-7,6,0
389425,4,33,22,11,3,0
354161,1,0,0,0,4,1
219231,4,16,3,13,13,0
378976,1,0,0,0,15,0
294638,2,0,0,0,12,0
68756,1,0,0,0,15,1
4804,3,27,0,27,3,0
356337,2,17,0,17,5,1
126761,4,19,13,6,6,0
288323,1,0,0,0,9,0
401578,3,17,14,3,8,0
90573,2,14,7,7,7,0
177275,3,14,17,-3,11,0
184228,2,17,0,17,14,0
147694,2,10,3,7,15,0
147271,3,0,24,-24,15,1
25027,4,16,21,-5,12,0
144856,2,14,0,14,14,1
15004,1,0,7,-7,7,1
171298,2,0,3,-3,9,1
168359,4,24,24,0,7,0
346761,1,0,0,0,1,1
149689,2,20,0,20,16,1
378962,4,23,30,-7,15,1
405018,4,9,23,-14,10,0
219333,2,16,7,9,13,0
30176,3,13,17,-4,14,0
243796,4,24,20,4,6,0
279770,4,30,13,17,5,1
199791,2,3,3,0,4,0
42261,4,30,7,23,2,1
111196,1,7,0,7,16,0
113071,4,16,16,0,17,0
227023,3,10,6,4,16,1
63163,2,14,10,4,12,0
232363,3,13,15,-2,1,0
49346,2,7,10,-3,6,1
314788,3,21,7,14,4,0
306778,4,16,33,-17,17,1
44586,3,10,14,-4,3,1
245135,3,17,15,2,7,0
280860,3,10,3,7,6,1
250159,2,17,0,17,9,1
207200,4,14,20,-6,7,1
216435,1,7,0,7,12,1
235139,3,0,10,-10,2,0
414142,3,10,13,-3,14,0
143639,2,13,10,3,14,0
309607,4,16,3,13,1,1
299151,3,10,16,-6,14,1
303184,4,24,28,-4,16,1
33503,2,14,0,14,16,1
7341,5,20,19,1,4,1
144255,2,9,7,2,14,1
394389,4,31,17,14,5,0
415785,4,21,24,-3,15,1
314792,3,21,7,14,4,1
14567,1,0,7,-7,7,0
208473,2,17,7,10,8,1
55485,1,0,0,0,9,1
17816,2,10,10,0,9,1
79485,4,12,14,-2,2,0
117248,4,30,24,6,2,1
268247,1,0,0,0,17,1
395313,1,7,0,7,5,1
273246,4,40,7,33,2,0
165300,4,17,24,-7,6,0
18344,4,25,17,8,9,0
177627,4,24,20,4,11,0
172131,4,13,18,-5,9,0
290934,2,14,7,7,10,1
286674,1,10,0,10,8,0
338266,4,34,31,3,14,0
172254,4,21,13,8,9,0
213567,4,10,14,-4,10,0
209267,4,34,7,27,8,0
174083,3,0,36,-36,10,1
296913,2,13,0,13,13,1
384513,1,0,0,0,1,0
157626,4,22,3,19,2,0
40419,2,0,7,-7,2,0
349166,3,27,7,20,2,1
398946,4,16,13,3,7,1
30170,3,10,17,-7,14,1
229937,1,0,0,0,17,0
395734,4,26,37,-11,6,1
109557,2,3,7,-4,16,0
146064,2,13,3,10,15,1
235952,1,0,0,0,3,0
188353,1,0,0,0,16,1
336408,2,3,3,0,14,1
101579,3,13,31,-18,12,0
290122,4,21,15,6,10,0
66949,4,18,7,11,14,0
331014,3,39,7,32,11,0
369391,1,10,0,10,11,1
225797,3,10,14,-4,16,1
82077,4,20,10,10,3,0
109156,3,31,7,24,15,0
199737,4,35,10,25,4,1
168323,3,17,24,-7,7,0
250706,4,17,22,-5,10,0
130821,3,13,12,1,8,1
118287,3,12,7,5,2,1
368250,2,3,3,0,11,1
140872,2,17,0,17,13,0
25154,3,20,3,17,12,0
124295,3,34,20,14,5,0
288831,2,10,17,-7,9,0
288201,1,3,7,-4,9,1
62981,2,6,7,-1,12,0
374234,1,7,0,7,13,1
209511,2,20,10,10,8,1
372653,3,14,9,5,13,0
404096,4,10,49,-39,10,1
248349,4,29,10,19,8,0
218609,3,7,23,-16,13,0
347150,3,16,10,6,1,1
409102,3,3,10,-7,12,1
289861,1,0,3,-3,10,0
388624,3,14,0,14,3,0
252448,2,0,5,-5,10,0
4969,4,24,17,7,3,0
335071,5,19,20,-1,13,1
376624,1,0,0,0,14,1
176581,5,19,20,-1,11,0
191214,2,0,17,-17,17,0
404892,1,3,3,0,10,1
417613,2,14,0,14,16,0
289673,4,13,23,-10,10,0
164135,1,0,0,0,5,1
390624,1,0,0,0,3,0
331459,3,9,7,2,11,0
103594,1,0,0,0,13,1
349503,4,12,20,-8,2,0
289459,2,3,7,-4,10,0
19884,3,13,21,-8,10,1
236847,4,6,9,-3,3,0
358475,4,38,27,11,6,0
310153,3,21,7,14,2,1
85693,4,24,21,3,5,1
87360,1,7,0,7,6,0
362670,3,3,7,-4,8,0
197923,4,18,7,11,3,0
198495,3,17,3,14,3,0
229758,4,20,17,3,17,1
417451,1,3,7,-4,16,1
92346,1,0,0,0,8,1
55394,2,13,7,6,9,1
195514,2,3,0,3,2,0
99465,2,0,3,-3,11,0
18741,3,6,10,-4,9,1
407761,3,10,7,3,11,1
357645,1,6,0,6,5,0
105149,4,39,14,25,14,1
228010,1,0,0,0,17,1
79897,3,3,16,-13,2,1
173211,4,20,24,-4,9,1
297634,1,7,0,7,13,0
265187,2,6,3,3,16,0
107640,3,13,20,-7,15,0
331010,3,36,7,29,11,1
16751,2,3,7,-4,8,0
50301,3,13,16,-3,6,0
411853,1,0,0,0,13,0
396763,4,7,20,-13,6,0
393198,1,7,6,1,5,0
112019,4,35,21,14,17,0
285809,3,13,24,-11,8,1
115031,4,20,19,1,1,0
246877,1,0,0,0,8,0
379411,1,0,0,0,16,0
215150,1,7,3,4,11,1
23666,3,7,20,-13,12,0
327746,4,6,16,-10,10,1
410017,4,6,42,-36,12,0
159565,3,17,6,11,3,1
153707,2,2,21,-19,1,1
327833,2,10,10,0,10,1
318018,4,17,13,4,5,1
288249,3,10,28,-18,9,1
148367,4,14,6,8,16,0
287494,3,14,20,-6,9,0
301565,1,7,0,7,15,0
98793,4,34,8,26,11,0
263880,1,6,0,6,15,0
322079,3,26,0,26,7,1
271093,1,0,6,-6,1,0
138140,1,7,9,-2,11,0
144232,2,9,7,2,14,0
299472,4,10,20,-10,14,0
368937,1,0,7,-7,11,1
183522,2,7,3,4,14,1
140150,3,10,3,7,12,1
122223,1,3,7,-4,4,1
160168,2,24,7,17,3,1
274907,3,14,16,-2,3,1
177239,2,7,10,-3,11,1
104176,4,27,27,0,13,0
103159,1,0,0,0,13,1
330089,3,0,12,-12,11,0
420962,3,7,14,-7,17,0
90525,4,0,26,-26,7,0
317746,1,0,0,0,5,0
206101,3,20,6,14,7,0
397017,3,21,6,15,6,0
19452,3,17,14,3,10,0
295085,2,7,0,7,12,0
69847,2,14,9,5,15,1
249610,4,28,16,12,9,0
253447,4,14,38,-24,11,0
331825,1,0,0,0,12,1
74998,3,27,17,10,17,0
339063,1,0,0,0,15,1
130447,1,3,0,3,8,0
390420,4,7,27,-20,3,1
333754,1,0,0,0,12,1
311990,4,35,17,18,2,0
208963,4,20,14,6,8,1
205754,1,0,0,0,7,1
176360,3,16,21,-5,11,1
215512,3,13,3,10,11,0
183829,3,27,21,6,14,0
23491,3,14,14,0,11,0
414848,2,21,7,14,15,0
78255,2,0,6,-6,2,0
336786,4,10,10,0,14,0
136332,4,18,7,11,11,0
336035,4,16,25,-9,13,1
386234,3,12,17,-5,2,0
98136,3,21,10,11,11,1
244434,4,3,20,-17,7,0
55325,4,20,17,3,9,1
24924,1,3,7,-4,12,0
255287,4,13,17,-4,12,1
202392,1,3,0,3,5,1
354054,2,13,0,13,4,0
346583,4,38,47,-9,1,1
326000,1,0,0,0,9,1
299544,2,0,3,-3,14,1
323232,3,7,10,-3,7,1
160251,1,0,0,0,4,0
264414,3,3,21,-18,15,0
336263,2,10,0,10,13,0
169901,1,0,0,0,8,0
44954,1,0,0,0,4,1
314595,2,7,0,7,3,1
103731,4,3,23,-20,13,1
260177,1,7,0,7,14,0
218598,2,7,20,-13,13,0
212643,3,7,31,-24,10,1
408940,3,17,15,2,12,1
90619,3,17,27,-10,7,1
29152,3,0,19,-19,14,1
45279,2,0,7,-7,4,1
96370,4,9,30,-21,10,1
41848,4,28,14,14,2,1
119816,3,24,13,11,3,0
204982,1,9,0,9,6,0
296924,3,19,0,19,13,1
292471,3,10,9,1,11,0
293875,1,0,0,0,12,0
294138,4,21,27,-6,12,1
130124,1,0,3,-3,8,0
416534,4,38,17,21,15,0
216409,4,21,23,-2,12,1
404143,2,6,0,6,10,0
69718,3,10,7,3,15,1
205613,1,7,3,4,7,0
79173,3,10,10,0,2,1
233073,1,0,0,0,2,0
72960,4,31,7,24,16,0
121899,4,0,32,-32,4,0
360769,3,24,21,3,7,0
83361,2,7,14,-7,4,0
334626,1,0,0,0,13,1
279984,2,3,10,-7,5,0
68932,1,0,7,-7,15,1
246795,3,3,13,-10,8,0
304651,2,14,7,7,16,1
163659,4,21,36,-15,5,0
134342,3,16,21,-5,10,1
335539,2,0,0,0,13,1
357480,1,0,3,-3,5,1
173769,3,10,3,7,10,0
131849,3,17,7,10,8,1
306368,4,37,10,27,17,0
14923,3,14,17,-3,7,0
13353,4,7,27,-20,7,0
157690,2,7,3,4,2,1
196635,1,7,0,7,3,1
311481,2,10,3,7,2,0
41869,1,7,0,7,2,0
412684,3,30,10,20,14,1
80021,2,7,3,4,2,1
343567,1,6,0,6,17,0
39919,4,6,10,-4,1,1
401802,1,7,0,7,9,0
56972,1,0,7,-7,9,1
173016,2,14,3,11,9,1
398430,1,0,0,0,7,1
6858,4,10,28,-18,3,0
163834,4,17,25,-8,5,1
334709,3,18,3,15,13,1
251722,3,24,3,21,10,0
202129,3,13,3,10,5,1
31126,1,3,10,-7,15,1
366326,4,28,10,18,10,0
162941,2,3,0,3,5,1
176393,4,19,28,-9,11,1
347999,4,6,24,-18,1,0
106882,2,9,3,6,14,1
28003,4,30,23,7,13,0
313528,1,0,7,-7,3,1
311639,3,6,6,0,2,0
181873,3,21,20,1,13,0
143194,2,7,3,4,13,0
279867,3,17,13,4,5,0
367338,4,6,20,-14,10,0
333010,2,3,3,0,12,0
104123,3,17,20,-3,13,0
208210,4,3,10,-7,8,0
229506,1,3,0,3,17,1
10643,3,7,17,-10,5,1
341158,1,0,0,0,16,1
153986,2,7,7,0,1,1
15301,1,0,0,0,8,0
198831,4,13,23,-10,3,0
221868,2,6,0,6,14,0
165692,3,7,7,0,6,0
382837,3,21,3,18,17,1
289836,4,23,23,0,10,1
313864,2,14,13,1,3,0
204457,3,7,24,-17,6,1
255948,2,6,6,0,12,0
230378,1,0,0,0,1,0
234204,3,20,10,10,2,0
307050,3,17,0,17,17,1
191542,3,14,21,-7,17,1
165870,4,6,19,-13,6,1
222198,3,13,10,3,14,1
129966,1,0,0,0,8,0
87189,4,21,13,8,5,1
165651,2,0,7,-7,6,1
376444,4,23,23,0,14,1
48688,2,7,10,-3,5,0
75548,1,7,0,7,17,0
162527,3,35,10,25,4,0
156663,3,6,7,-1,2,0
297946,2,17,7,10,13,1
208208,4,3,10,-7,8,0
94613,1,7,13,-6,9,1
63656,4,20,36,-16,12,1
312256,4,10,17,-7,2,0
71680,1,0,0,0,16,1
125323,3,17,3,14,5,1
311842,4,20,20,0,2,0
140012,4,28,10,18,12,1
203506,3,21,3,18,6,0
208315,2,7,24,-17,8,1
211101,4,37,0,37,9,1
397478,3,13,19,-6,6,1
350236,4,27,0,27,2,1
304164,1,0,0,0,16,1
81212,1,0,7,-7,3,0
183867,4,43,28,15,14,1
236252,1,0,0,0,3,1
356119,1,7,0,7,5,0
277735,3,7,3,4,4,0
177081,2,10,10,0,11,1
102815,3,10,3,7,13,0
327612,4,10,22,-12,10,1
274446,4,10,17,-7,3,0
404080,4,10,49,-39,10,0
37188,2,3,7,-4,17,0
404986,4,9,19,-10,10,0
348797,1,0,7,-7,2,1
336179,4,17,3,14,13,0
273189,3,24,7,17,2,1
258154,3,13,13,0,13,1
306038,3,10,10,0,17,0
8155,1,0,7,-7,4,1
218028,3,21,10,11,12,1
183553,3,7,10,-3,14,0
295274,3,14,5,9,12,1
363752,4,26,27,-1,8,1
242284,2,7,7,0,6,1
234686,3,30,20,10,2,0
113364,1,0,0,0,17,0
350587,2,10,0,10,2,1
367153,3,29,16,13,10,0
144184,1,0,7,-7,14,1
319046,4,13,23,-10,5,0
82631,3,12,10,2,3,1
118240,2,9,7,2,2,1
286,4,12,34,-22,1,1
298951,2,6,9,-3,14,0
19501,4,33,17,16,10,0
140396,1,0,0,0,12,1
158834,4,20,3,17,3,0
401916,1,0,0,0,9,0
177467,4,24,10,14,11,1
496,2,7,6,1,1,0
355827,1,6,0,6,5,1
257629,1,0,7,-7,13,0
228283,1,0,0,0,17,1
224794,3,8,10,-2,15,1
3863,1,16,0,16,2,0
34296,3,20,9,11,16,0
233599,3,20,34,-14,2,0
366457,4,34,10,24,10,1
363378,2,14,10,4,8,0
97234,3,12,6,6,10,0
394181,3,23,17,6,5,0
247221,1,7,7,0,8,1
104485,3,14,24,-10,13,0
393875,3,13,17,-4,5,1
206311,4,10,6,4,7,0
257350,2,17,0,17,13,0
252986,4,16,13,3,11,0
418457,3,17,3,14,16,0
287647,3,3,10,-7,9,1
343569,1,6,0,6,17,0
234159,2,3,7,-4,2,0
308062,1,0,7,-7,1,0
284637,3,14,17,-3,7,0
242594,2,3,0,3,6,1
238941,2,14,6,8,4,1
362977,3,27,16,11,8,0
10504,2,20,0,20,5,0
376707,3,3,0,3,14,0
268812,4,37,10,27,17,1
112153,3,10,27,-17,17,1
319581,1,3,0,3,6,1
294041,2,7,14,-7,12,0
387402,2,21,10,11,2,1
136043,4,6,10,-4,10,0
69143,3,14,17,-3,15,1
367718,3,6,13,-7,10,0
69426,3,24,3,21,15,0
243610,3,20,14,6,6,1
248410,1,10,0,10,8,1
59217,3,21,45,-24,10,0
53469,4,10,35,-25,8,1
13384,1,0,0,0,7,0
394103,1,0,0,0,5,1
67766,3,21,0,21,14,1
168663,1,0,0,0,7,0
318855,2,21,6,15,5,0
268021,3,21,9,12,17,0
216299,1,7,0,7,12,0
299513,1,0,0,0,14,0
419162,2,10,3,7,16,0
63533,1,0,0,0,12,1
253032,1,0,0,0,11,1
50264,2,10,14,-4,6,1
134236,3,3,23,-20,10,0
157025,4,13,13,0,2,0
100876,1,0,0,0,12,1
104052,1,7,0,7,13,1
192136,2,0,6,-6,1,0
236918,2,26,0,26,3,0
368242,2,3,3,0,11,1
365221,1,0,0,0,9,0
256532,1,0,0,0,12,1
329557,4,45,14,31,10,0
11126,4,17,20,-3,5,1
268392,1,6,0,6,17,1
245442,3,9,6,3,7,1
46650,4,10,0,10,4,0
27289,1,7,3,4,13,0
186448,2,10,10,0,15,0
402529,1,7,0,7,9,0
11548,3,6,10,-4,6,1
89720,4,16,20,-4,7,1
412754,1,0,10,-10,14,1
314886,2,0,0,0,4,0
164928,3,0,6,-6,6,1
203648,3,7,13,-6,6,0
272460,4,31,24,7,2,1
113924,3,16,10,6,17,1
22136,2,10,6,4,11,0
226582,2,3,3,0,16,1
409198,1,3,0,3,12,0
347152,3,22,10,12,1,1
168038,3,6,17,-11,7,0
47291,1,0,7,-7,5,1
410520,1,7,0,7,13,0
85685,3,24,14,10,5,0
307262,1,0,0,0,17,0
299588,3,13,9,4,14,0
131618,1,0,3,-3,8,1
125826,4,17,23,-6,5,1
260604,1,0,7,-7,14,0
265944,3,0,29,-29,16,0
329309,1,6,14,-8,10,0
195926,2,0,17,-17,2,0
322878,1,6,0,6,7,1
82864,1,0,0,0,4,0
14738,2,21,0,21,7,1
268801,4,31,10,21,17,0
217205,4,12,19,-7,12,0
27303,2,7,3,4,13,1
135777,1,0,13,-13,10,0
69802,1,7,0,7,15,0
68331,2,3,7,-4,14,1
56588,3,19,17,2,9,0
306165,2,7,3,4,17,1
354941,2,7,3,4,4,1
310425,2,14,3,11,2,1
236967,3,38,7,31,3,1
116573,2,3,0,3,2,1
192951,3,7,17,-10,1,1
77968,2,3,10,-7,1,1
268871,2,6,10,-4,17,0
89348,1,3,6,-3,7,0
117708,4,34,20,14,2,0
162146,1,0,0,0,4,0
255400,3,24,6,18,12,0
220447,4,23,21,2,13,1
255386,3,21,6,15,12,1
97111,3,34,6,28,10,1
102425,1,3,0,3,13,0
291259,2,7,12,-5,10,0
338496,2,17,7,10,14,1
25345,1,0,0,0,12,1
103236,3,3,7,-4,13,0
380108,4,35,30,5,16,1
392699,4,16,0,16,4,0
393025,1,0,0,0,4,0
145735,2,0,10,-10,15,0
312587,4,44,0,44,3,0
43904,1,0,0,0,3,0
241574,3,3,20,-17,5,1
228958,2,14,9,5,17,0
269014,2,7,3,4,17,0
12974,1,0,0,0,6,1
251294,4,13,36,-23,10,0
36255,4,17,27,-10,17,0
359630,3,24,7,17,6,1
118516,2,17,0,17,2,0
131983,2,0,17,-17,8,1
315009,1,14,0,14,4,0
136133,3,10,10,0,10,1
132385,2,0,0,0,9,0
100861,4,19,22,-3,12,1
26393,2,10,0,10,13,0
10488,2,6,0,6,5,0
317121,1,0,0,0,5,0
351871,4,27,14,13,3,1
282973,2,14,3,11,6,1
353762,5,20,20,0,4,0
252426,1,0,0,0,10,0
311749,2,0,10,-10,2,0
279034,1,0,0,0,5,1
149980,2,14,3,11,16,0
162787,2,0,0,0,5,0
163336,4,22,23,-1,5,0
133574,2,3,0,3,9,0
59130,4,26,39,-13,10,1
123102,5,21,21,0,4,1
349171,3,27,7,20,2,0
86866,3,9,23,-14,5,0
119177,4,13,7,6,3,1
295447,4,17,13,4,12,0
134953,3,7,22,-15,10,1
392567,4,10,26,-16,4,0
111716,4,37,16,21,16,0
418131,2,14,3,11,16,1
31844,4,23,31,-8,15,1
307678,4,14,17,-3,17,0
193938,4,31,24,7,1,0
287324,2,6,0,6,8,1
279570,3,10,16,-6,5,1
251328,1,7,7,0,10,1
19024,3,7,3,4,10,0
293646,2,10,7,3,12,1
127323,3,10,17,-7,6,1
295702,3,3,9,-6,12,0
341731,4,26,13,13,16,1
12968,1,0,0,0,6,0
357206,1,0,0,0,5,1
269240,3,3,13,-10,17,1
319367,4,16,28,-12,6,1
150647,4,10,22,-12,17,1
141603,1,0,0,0,13,0
323787,2,6,3,3,8,0
53721,3,7,0,7,8,0
68251,4,20,20,0,14,0
68123,4,6,10,-4,14,0
405433,3,14,10,4,10,1
46250,4,21,31,-10,4,1
310788,3,6,10,-4,2,1
135778,1,0,14,-14,10,1
64866,2,7,3,4,13,1
210364,4,22,17,5,9,1
37944,3,10,14,-4,1,1
150054,4,31,6,25,16,0
325722,1,0,7,-7,9,1
103666,2,0,10,-10,13,0
61445,4,16,17,-1,11,0
282799,2,0,13,-13,6,1
145721,1,0,10,-10,15,0
173624,3,7,20,-13,10,1
127573,1,0,6,-6,6,0
267327,1,0,0,0,17,0
373492,1,0,10,-10,13,1
343421,1,0,0,0,16,0
51250,4,39,32,7,7,0
186500,4,17,20,-3,15,1
170075,1,0,0,0,8,1
30476,3,31,35,-4,14,1
152008,1,0,0,0,17,1
121903,4,0,33,-33,4,1
326281,1,0,0,0,9,0
261179,1,7,0,7,14,0
182181,3,33,7,26,13,0
179400,2,6,13,-7,12,0
392672,3,16,0,16,4,0
232739,1,0,0,0,2,0
41913,2,14,6,8,2,1
138995,4,14,9,5,12,1
341225,3,13,7,6,16,1
144910,3,20,7,13,14,0
183835,3,27,21,6,14,1
254568,2,6,7,-1,11,1
75974,1,6,0,6,1,1
404557,4,34,27,7,10,0
193182,1,0,0,0,1,1
19546,2,0,7,-7,10,1
141700,3,23,21,2,13,1
51370,4,22,20,2,7,0
255752,1,0,0,0,12,0
340261,4,29,34,-5,15,1
266391,3,36,8,28,16,0
127545,4,3,26,-23,6,1
108831,3,7,10,-3,15,1
89886,4,30,13,17,7,0
174319,2,10,0,10,10,1
194466,3,16,3,13,2,0
386504,2,7,7,0,2,0
132305,3,24,14,10,9,0
62415,2,0,10,-10,12,1
221333,4,6,35,-29,14,0
320849,2,3,11,-8,6,0
361301,1,0,0,0,7,0
271595,3,16,20,-4,2,1
132629,4,20,49,-29,9,0
120072,1,3,0,3,3,1
7031,4,19,7,12,3,0
234953,2,10,3,7,2,1
239647,1,0,0,0,4,1
44885,3,7,23,-16,4,0
402517,1,0,0,0,9,0
115365,1,0,0,0,1,1
383647,2,0,14,-14,17,1
92581,3,17,3,14,8,1
273043,3,6,3,3,2,1
84844,1,13,3,10,4,1
321153,2,3,16,-13,6,1
416068,4,21,6,15,15,1
375050,4,28,27,1,14,0
212192,3,3,24,-21,10,1
38847,4,3,10,-7,1,1
416894,2,3,7,-4,15,0
155327,1,10,0,10,2,0
315163,2,7,7,0,4,1
407679,1,0,0,0,11,1
308477,4,7,28,-21,1,1
89448,4,24,20,4,7,0
222178,2,10,10,0,14,1
200081,1,7,0,7,4,0
30181,3,13,17,-4,14,1
161524,1,0,0,0,4,1
403586,2,17,7,10,9,1
246325,2,7,10,-3,7,1
6074,2,7,7,0,3,0
88982,4,39,10,29,6,0
192833,3,7,15,-8,1,0
215342,3,14,13,1,11,1
262291,3,10,9,1,15,0
234487,3,20,13,7,2,0
70055,4,31,10,21,15,0
304546,4,18,27,-9,16,0
69932,1,0,0,0,15,1
264455,4,20,28,-8,15,0
277216,2,0,10,-10,4,0
150109,1,0,6,-6,16,0
292377,4,12,16,-4,11,1
83403,3,10,17,-7,4,0
259415,1,3,3,0,13,1
105696,3,28,3,25,14,1
57840,4,22,10,12,10,0
290389,3,23,10,13,10,1
3837,1,0,0,0,2,1
128698,4,13,20,-7,7,0
24210,2,10,7,3,12,0
68312,1,3,0,3,14,1
60361,2,10,7,3,11,0
51078,4,3,23,-20,6,1
149476,4,13,27,-14,16,1
201584,1,0,0,0,5,1
264554,2,10,14,-4,16,0
64032,2,17,10,7,13,1
287840,4,28,17,11,9,0
263533,4,20,26,-6,15,0
187552,3,13,16,-3,16,0
183068,2,7,0,7,14,0
211186,2,0,10,-10,9,1
114782,2,7,10,-3,1,0
388481,3,3,16,-13,2,1
283047,4,28,3,25,6,1
99388,4,23,10,13,11,0
196395,2,17,0,17,2,0
159103,3,24,0,24,3,0
324885,3,10,13,-3,8,1
3306,3,3,3,0,2,0
265641,3,6,15,-9,16,1
319461,2,0,10,-10,6,0
297752,4,31,23,8,13,0
294387,3,16,3,13,12,0
290258,4,17,3,14,10,0
269624,2,3,0,3,1,0
88052,3,24,3,21,6,1
262876,2,7,23,-16,15,0
315290,5,20,19,1,4,1
169244,4,17,6,11,7,1
132143,3,10,3,7,9,0
21220,1,3,0,3,11,0
236396,4,14,23,-9,3,0
354898,5,41,42,-1,4,1
387419,3,21,10,11,2,0
48526,2,11,0,11,5,1
95394,2,21,7,14,10,1
147096,2,7,31,-24,15,1
5229,2,21,17,4,3,0
140365,4,17,26,-9,12,0
55176,1,0,0,0,9,1
328639,3,20,35,-15,10,1
404334,3,13,6,7,10,0
158806,3,17,3,14,3,1
373807,2,13,0,13,13,0
145745,2,7,10,-3,15,0
108481,1,7,7,0,15,1
159203,2,7,14,-7,3,1
355645,4,38,17,21,5,0
327644,1,0,0,0,10,0
292165,2,21,7,14,11,1
259353,4,28,27,1,13,0
287279,1,0,0,0,8,0
78071,1,0,0,0,2,1
324615,4,16,15,1,8,1
201518,3,25,7,18,5,0
257672,2,0,7,-7,13,1
146352,2,3,3,0,15,1
133052,4,12,14,-2,9,0
16855,4,26,38,-12,8,0
347182,4,23,24,-1,1,1
358125,2,17,6,11,6,1
243282,3,7,10,-3,6,1
229730,3,13,17,-4,17,0
328841,4,23,20,3,10,1
125207,4,31,14,17,5,1
114404,4,34,13,21,1,0
351049,2,14,13,1,3,0
420284,2,7,0,7,17,1
211765,1,0,6,-6,9,0
301116,1,0,0,0,15,1
231299,2,3,3,0,1,0
46880,2,13,6,7,5,1
158529,3,10,16,-6,3,0
398767,3,14,17,-3,7,1
69361,1,0,0,0,15,1
229276,3,24,21,3,17,1
419035,3,7,20,-13,16,0
26882,2,10,6,4,13,1
134419,1,0,7,-7,10,1
95807,2,6,3,3,10,1
418413,2,14,3,11,16,1
415857,2,7,20,-13,15,0
306081,4,17,13,4,17,1
336797,4,10,17,-7,14,0
186515,4,17,20,-3,15,0
139471,4,27,10,17,12,1
5127,4,13,7,6,3,0
34493,4,48,10,38,16,1
349443,2,0,20,-20,2,1
365348,4,17,19,-2,9,0
68997,3,21,14,7,15,1
149953,1,7,3,4,16,1
46221,3,14,21,-7,4,0
231796,3,20,20,0,1,0
360325,3,0,20,-20,7,0
243083,2,0,9,-9,6,1
261524,2,9,0,9,14,1
223171,1,0,0,0,15,1
248674,4,31,10,21,9,1
291720,2,0,6,-6,11,0
41472,2,5,7,-2,2,0
392189,3,10,13,-3,4,0
139636,1,0,0,0,12,0
395012,2,0,14,-14,5,0
164834,1,0,3,-3,6,1
307748,1,7,7,0,1,1
230700,2,6,26,-20,1,0
11917,1,0,0,0,6,0
349220,1,0,0,0,2,1
278043,3,10,10,0,4,0
268439,2,14,3,11,17,0
365268,2,3,13,-10,9,1
92082,2,3,7,-4,8,0
148268,1,0,0,0,16,1
327770,4,16,23,-7,10,0
298928,2,0,6,-6,14,1
291678,1,0,3,-3,11,0
211459,2,12,7,5,9,1
94916,1,0,3,-3,9,0
399528,3,0,26,-26,7,0
132060,4,3,24,-21,8,1
212502,4,10,13,-3,10,1
343611,2,15,7,8,17,0
41125,1,0,0,0,2,1
311942,3,27,10,17,2,1
154283,2,6,14,-8,1,0
391684,2,0,3,-3,4,1
166214,4,35,19,16,6,0
103561,4,33,0,33,13,0
168527,1,0,0,0,7,0
391950,4,30,34,-4,4,1
323102,4,26,14,12,7,0
169853,4,20,17,3,8,0
326658,3,16,6,10,9,0
198312,2,6,14,-8,3,1
193272,3,3,20,-17,1,1
358110,2,14,0,14,6,1
381915,1,0,7,-7,17,1
129673,1,0,3,-3,7,1
16121,4,40,17,23,8,0
236066,3,37,10,27,3,1
136045,4,6,10,-4,10,0
177554,2,10,0,10,11,1
333313,1,7,0,7,12,1
297675,2,7,6,1,13,1
247595,3,16,23,-7,8,1
83439,4,10,23,-13,4,1
24833,3,13,3,10,12,1
74764,1,3,0,3,17,0
296846,4,21,13,8,13,0
256461,4,12,24,-12,12,1
174024,2,0,13,-13,10,1
130787,2,13,3,10,8,1
313888,3,21,19,2,3,1
105301,4,10,26,-16,14,0
69,2,7,0,7,1,0
328761,2,14,13,1,10,1
153811,1,0,0,0,1,1
119594,3,10,9,1,3,1
48149,3,10,13,-3,5,1
177891,4,21,23,-2,12,1
176165,2,14,7,7,11,0
146608,1,0,0,0,15,0
369406,2,17,7,10,11,1
322000,1,3,0,3,7,0
333002,1,3,3,0,12,1
188745,3,0,17,-17,16,0
370655,4,21,14,7,12,1
244152,1,0,7,-7,6,0
355741,3,7,6,1,5,1
299558,2,3,3,0,14,1
96372,4,9,30,-21,10,0
396448,4,20,25,-5,6,1
115795,1,0,0,0,1,1
23826,4,24,7,17,12,1
199960,2,10,10,0,4,1
51512,4,34,24,10,7,0
387502,1,0,0,0,2,1
14838,1,0,0,0,7,0
114038,2,7,0,7,17,1
55992,3,10,20,-10,9,1
122534,1,7,0,7,4,1
218428,2,10,14,-4,13,1
98169,4,21,19,2,11,1
400055,2,14,3,11,8,0
68625,1,7,0,7,15,1
207815,1,0,0,0,8,1
242093,1,0,0,0,6,1
45617,3,10,13,-3,4,1
49391,4,10,20,-10,6,1
366637,1,0,0,0,10,1
347818,3,10,0,10,1,1
140818,1,7,0,7,13,0
116968,4,35,13,22,2,1
91592,1,0,7,-7,8,0
386125,4,24,16,8,1,1
200066,4,24,20,4,4,0
121286,1,0,0,0,3,1
310950,3,3,23,-20,2,1
108848,3,7,10,-3,15,0
33385,2,13,10,3,16,1
132749,4,20,17,3,9,0
51174,2,24,3,21,7,0
355917,4,34,17,17,5,0
377846,2,20,7,13,15,0
151210,3,10,20,-10,17,1
37043,2,10,0,10,17,1
121765,4,28,52,-24,4,1
279028,4,13,33,-20,5,0
133175,3,13,17,-4,9,0
202465,3,6,10,-4,5,1
212841,5,24,24,0,10,1
322367,3,14,13,1,7,0
210081,5,17,17,0,8,0
152278,4,28,0,28,17,0
369757,4,38,37,1,11,1
252179,3,20,17,3,10,1
405385,1,7,7,0,10,0
271647,4,23,37,-14,2,1
148273,1,6,0,6,16,1
211270,1,0,0,0,9,1
81805,1,0,7,-7,3,0
271746,3,16,10,6,2,0
122301,3,6,19,-13,4,1
200828,1,0,0,0,4,1
408722,1,3,7,-4,12,1
34869,2,17,7,10,16,1
58508,1,0,3,-3,10,0
53893,2,7,10,-3,8,0
71270,1,7,0,7,16,0
296774,2,7,0,7,13,1
263127,1,0,7,-7,15,0
236145,2,0,10,-10,3,1
415703,2,7,3,4,15,0
18445,3,7,7,0,9,1
377281,3,14,6,8,15,0
52387,3,9,17,-8,7,0
219711,4,13,14,-1,13,0
131801,1,7,0,7,8,1
396919,4,27,27,0,6,1
230548,2,9,7,2,1,1
295026,4,31,24,7,12,1
144693,2,0,0,0,14,1
241982,2,7,0,7,5,1
40561,2,7,0,7,2,1
413502,1,0,0,0,14,1
302675,3,17,13,4,15,0
196487,1,0,3,-3,2,1
18976,2,0,0,0,10,0
386678,3,17,13,4,2,0
219098,4,45,13,32,13,0
107343,3,10,6,4,15,0
174939,2,3,7,-4,10,0
170533,1,14,0,14,8,0
197214,4,37,34,3,3,0
123337,2,21,14,7,4,1
196362,2,10,0,10,2,1
124592,3,6,17,-11,5,0
258330,4,41,39,2,13,1
316253,2,7,13,-6,4,0
267,4,12,24,-12,1,1
324124,3,0,10,-10,8,1
4312,1,0,7,-7,2,1
386725,4,17,19,-2,2,0
221548,2,20,12,8,14,0
295806,5,27,27,0,12,1
180969,3,23,21,2,13,1
374687,2,0,9,-9,14,1
280519,1,7,0,7,5,1
260643,2,7,13,-6,14,1
215543,4,13,3,10,11,0
108936,1,13,7,6,15,0
377823,2,14,0,14,15,0
185713,2,17,3,14,15,0
234782,2,0,3,-3,2,0
405553,2,0,14,-14,10,0
203811,3,17,24,-7,6,1
257740,4,3,24,-21,13,1
400456,4,24,10,14,8,0
277701,2,7,0,7,4,0
139444,3,24,3,21,12,0
100811,3,9,6,3,12,1
184955,3,7,17,-10,15,0
123103,5,21,21,0,4,1
233721,2,13,21,-8,2,0
268352,4,20,6,14,17,1
224911,2,0,9,-9,15,1
250629,2,3,9,-6,10,1
297994,3,30,7,23,13,1
401396,2,17,7,10,8,1
144103,3,16,0,16,14,0
65276,2,3,14,-11,13,0
356139,2,10,0,10,5,0
7111,2,21,21,0,4,1
420830,3,10,16,-6,17,0
361122,4,23,16,7,7,1
393100,3,10,3,7,4,1
262754,3,21,3,18,15,0
266153,1,7,0,7,16,0
405817,5,24,24,0,10,0
253517,1,0,7,-7,11,0
369296,3,14,17,-3,11,1
192257,2,10,3,7,1,1
81165,4,16,22,-6,3,0
362678,3,3,10,-7,8,1
3852,1,13,0,13,2,0
41663,3,24,7,17,2,0
377971,2,0,7,-7,15,0
114228,3,3,14,-11,1,1
57482,2,14,10,4,10,1
74179,1,3,0,3,17,0
164238,4,41,38,3,5,0
28177,1,3,0,3,13,0
22357,4,0,6,-6,11,1
149571,3,14,16,-2,16,0
58087,2,10,10,0,10,0
343544,4,10,10,0,16,1
63,2,0,0,0,1,1
158941,2,14,12,2,3,0
31299,2,7,3,4,15,1
2299,4,13,10,3,1,0
82812,3,12,16,-4,3,0
133499,3,27,20,7,9,1
327695,2,3,10,-7,10,0
30491,4,31,35,-4,14,0
176198,3,14,24,-10,11,1
54447,1,0,0,0,8,0
192582,1,3,0,3,1,0
332415,1,7,3,4,12,0
392397,4,27,44,-17,4,0
375707,1,0,0,0,14,1
354508,3,27,28,-1,4,0
395972,3,24,10,14,6,0
262604,3,23,3,20,15,1
237968,2,3,3,0,4,0
336370,1,0,0,0,14,0
419182,3,10,6,4,16,0
187602,4,13,30,-17,16,1
22356,4,0,6,-6,11,0
63403,1,0,0,0,12,0
12671,2,16,0,16,6,1
36704,4,23,10,13,17,0
136080,1,0,7,-7,10,1
81333,1,0,0,0,3,0
160006,2,3,23,-20,3,1
68763,1,3,0,3,15,1
81884,3,0,27,-27,3,0
150783,4,20,9,11,17,0
358600,3,27,9,18,6,0
112726,2,10,0,10,17,0
382151,4,30,3,27,17,0
231726,1,3,7,-4,1,0
404881,1,0,0,0,10,0
212626,3,7,24,-17,10,0
327381,2,0,7,-7,9,0
112922,4,16,6,10,17,1
5549,3,16,10,6,3,1
332824,1,0,0,0,12,1
4798,3,27,0,27,3,0
138005,2,19,14,5,11,0
44398,2,3,0,3,3,0
17987,3,16,21,-5,9,0
94443,1,0,0,0,9,1
109581,3,16,14,2,16,1
180329,3,12,7,5,13,0
110267,2,0,10,-10,16,0
352370,2,21,7,14,3,0
80007,2,7,0,7,2,0
315443,1,0,0,0,4,0
290253,3,17,3,14,10,1
58714,2,10,17,-7,10,1
116847,2,7,7,0,2,1
371421,2,7,7,0,12,1
397023,3,21,6,15,6,0
260876,4,50,15,35,14,0
253335,1,7,0,7,11,0
232671,3,7,0,7,1,1
273784,2,7,7,0,2,1
319643,2,24,3,21,6,1
16376,3,21,10,11,8,0
265256,4,9,6,3,16,1
312436,4,33,41,-8,3,1
115889,3,7,23,-16,1,1
57251,4,26,21,5,10,1
41160,2,0,7,-7,2,1
214189,4,19,9,10,11,0
325626,3,10,7,3,9,0
127887,1,10,0,10,6,1
174630,1,3,0,3,10,0
278271,1,0,0,0,4,1
19903,3,13,21,-8,10,1
208978,4,20,24,-4,8,1
312515,2,20,0,20,3,1
286313,4,22,16,6,8,0
411764,2,0,17,-17,13,0
233310,3,7,20,-13,2,0
384892,4,13,22,-9,1,0
339650,4,31,17,14,15,0
135499,2,7,6,1,10,0
107078,3,33,0,33,15,1
333098,4,17,18,-1,12,1
1448,4,19,7,12,1,1
17214,2,7,28,-21,9,0
405042,1,0,0,0,10,1
12844,2,13,3,10,6,0
318826,1,7,6,1,5,1
336853,2,7,7,0,14,0
401694,2,3,14,-11,8,1
243900,3,16,6,10,6,0
350123,1,0,0,0,2,1
178879,4,41,21,20,12,1
89892,4,30,20,10,7,1
396159,4,24,23,1,6,1
46903,3,13,20,-7,5,0
114216,3,3,7,-4,1,0
44230,1,10,10,0,3,0
415874,2,7,20,-13,15,1
212259,1,7,0,7,10,0
234338,3,17,0,17,2,1
298992,3,9,12,-3,14,1
68840,3,6,17,-11,15,1
327594,4,10,15,-5,10,0
90229,1,0,0,0,7,1
41026,2,3,10,-7,2,1
179386,2,6,13,-7,12,0
346733,4,27,13,14,1,1
31076,4,13,13,0,15,1
241636,1,0,0,0,5,1
130248,4,3,26,-23,8,1
224268,2,6,9,-3,15,0
411717,1,0,3,-3,13,0
219892,1,0,0,0,13,0
238330,2,3,9,-6,4,0
403652,4,30,20,10,9,1
96754,3,0,10,-10,10,1
381782,2,0,0,0,17,0
339806,4,24,13,11,15,0
249830,2,6,10,-4,9,1
4814,4,27,3,24,3,1
166334,4,20,9,11,6,0
96386,4,9,37,-28,10,0
222702,4,14,24,-10,14,0
64911,4,10,6,4,13,0
325655,3,24,7,17,9,0
201421,1,6,0,6,5,1
16481,2,10,0,10,8,1
42062,3,20,7,13,2,0
348331,2,7,7,0,1,1
30985,1,0,3,-3,15,1
271659,4,30,37,-7,2,0
99020,2,6,0,6,11,1
219103,4,45,19,26,13,0
408032,2,10,7,3,12,0
124290,3,27,17,10,5,1
157094,2,10,14,-4,2,1
276655,3,20,6,14,4,1
135163,1,0,0,0,10,1
196786,1,0,7,-7,3,1
152548,4,24,7,17,17,0
338682,3,20,10,10,14,0
402367,1,0,7,-7,9,1
145100,1,3,0,3,14,0
386186,2,6,3,3,2,0
21896,3,28,3,25,11,1
162899,1,0,0,0,5,0
152939,3,14,17,-3,1,1
184814,3,17,20,-3,15,1
379121,1,0,3,-3,16,1
348371,2,10,10,0,1,1
352995,3,20,10,10,3,1
122468,3,13,26,-13,4,0
412356,3,17,17,0,13,1
105209,2,7,17,-10,14,1
190752,1,3,0,3,17,0
145080,4,20,13,7,14,1
39659,1,0,0,0,1,1
8875,2,14,0,14,4,1
182194,3,33,7,26,13,0
202337,4,13,6,7,5,1
224956,4,3,16,-13,15,1
353391,2,13,0,13,4,1
244375,3,0,17,-17,7,0
418344,4,15,24,-9,16,1
232958,2,10,3,7,2,0
323006,1,0,0,0,7,1
181542,2,6,0,6,13,0
307574,1,0,0,0,17,0
24980,2,13,14,-1,12,0
346865,3,23,6,17,1,0
5125,4,13,7,6,3,1
30554,2,10,0,10,14,0
262117,2,14,3,11,15,1
418110,1,14,0,14,16,1
281944,2,7,14,-7,6,1
349481,4,6,20,-14,2,1
168747,3,10,6,4,7,1
309878,4,24,7,17,1,0
152780,3,7,7,0,17,0
214605,3,3,9,-6,11,0
417998,3,14,28,-14,16,0
283128,2,3,3,0,7,1
72860,4,45,17,28,16,0
340256,4,29,34,-5,15,1
116212,4,25,19,6,1,1
66009,1,0,0,0,13,1
19760,3,9,12,-3,10,1
29743,3,27,3,24,14,0
147618,4,15,0,15,15,0
260299,1,0,0,0,14,1
248725,2,10,7,3,9,0
76772,2,24,0,24,1,0
151172,2,3,10,-7,17,1
119895,1,6,7,-1,3,0
382733,4,9,20,-11,17,1
39507,4,13,19,-6,1,1
56516,1,10,0,10,9,1
306001,2,3,10,-7,17,0
408976,4,31,24,7,12,1
63388,4,17,10,7,12,1
257093,4,7,21,-14,12,1
41690,4,31,14,17,2,1
409474,1,0,0,0,12,0
243033,1,0,0,0,6,0
255036,2,3,9,-6,12,0
390202,1,0,6,-6,3,1
82790,3,9,9,0,3,1
107859,1,0,0,0,15,1
84170,3,10,7,3,4,1
50359,1,0,0,0,6,0
183510,1,7,3,4,14,1
349,2,14,10,4,1,0
209245,3,20,7,13,8,0
190979,3,12,3,9,17,1
28245,3,17,0,17,13,1
226548,1,0,0,0,16,1
330734,4,6,6,0,11,0
204482,4,10,24,-14,6,0
297497,2,5,0,5,13,0
36926,2,0,16,-16,17,0
280295,3,16,16,0,5,0
45889,2,7,3,4,4,0
226409,2,0,7,-7,16,1
137510,2,7,14,-7,11,1
337925,3,13,0,13,14,0
357709,3,26,13,13,5,1
84752,3,10,24,-14,4,1
58140,3,20,16,4,10,0
141338,2,3,7,-4,13,0
90977,1,0,0,0,7,0
413974,2,3,14,-11,14,1
259390,1,0,0,0,13,0
285613,4,20,17,3,8,1
16348,2,7,7,0,8,1
221491,4,9,41,-32,14,1
264159,4,27,27,0,15,0
383604,1,0,0,0,17,1
328730,2,7,6,1,10,1
189033,2,14,7,7,16,0
415219,4,17,31,-14,15,0
118007,4,20,6,14,2,1
55211,2,7,0,7,9,1
146682,2,7,26,-19,15,0
161645,4,39,16,23,4,1
417162,1,0,10,-10,16,1
19836,1,10,7,3,10,0
114039,2,7,0,7,17,1
100419,4,12,20,-8,12,1
36722,1,0,0,0,17,1
64178,3,31,6,25,13,0
240890,1,7,3,4,5,1
393878,3,13,17,-4,5,1
289738,2,0,10,-10,10,0
351124,4,37,37,0,3,1
7535,1,0,0,0,4,1
407633,4,10,17,-7,11,0
396551,2,17,7,10,6,1
166572,2,8,7,1,6,0
55292,4,13,10,3,9,1
95460,4,34,7,27,10,1
234525,4,20,20,0,2,0
261872,3,6,20,-14,14,0
240993,4,21,22,-1,5,1
109258,2,6,0,6,15,1
306021,2,3,10,-7,17,1
392954,3,9,3,6,4,1
167768,5,26,26,0,7,0
190912,1,6,0,6,17,0
239097,2,7,10,-3,4,1
89458,4,24,20,4,7,1
238730,4,19,20,-1,4,0
202329,4,13,3,10,5,0
100278,1,6,0,6,12,1
203899,5,37,37,0,6,1
406852,4,7,23,-16,11,1
345654,1,7,0,7,17,1
297977,3,30,7,23,13,1
217216,4,12,19,-7,12,0
350037,3,13,10,3,2,1
307603,2,0,7,-7,17,1
33234,2,10,0,10,16,0
333965,2,14,10,4,12,1
344314,4,22,13,9,17,1
39159,4,20,10,10,1,0
12666,2,10,0,10,6,1
310991,1,0,0,0,2,1
335084,1,0,0,0,13,1
141324,2,3,7,-4,13,0
284733,1,6,7,-1,7,0
200690,1,6,0,6,4,1
57462,2,14,3,11,10,0
283524,1,6,0,6,7,0
420616,2,7,10,-3,17,0
403660,4,30,20,10,9,1
134522,4,3,36,-33,10,0
180322,2,9,7,2,13,1
165356,2,0,10,-10,6,1
82250,1,0,0,0,3,1
305281,3,34,21,13,16,1
367454,4,26,21,5,10,0
229258,2,10,14,-4,17,1
101838,1,3,0,3,12,1
194246,1,0,0,0,2,0
149177,5,31,31,0,16,1
239433,3,9,10,-1,4,0
324104,2,0,7,-7,8,0
242650,4,13,0,13,6,0
146192,2,0,3,-3,15,0
184077,2,6,7,-1,14,1
185590,3,10,20,-10,15,0
22248,1,0,0,0,11,0
188579,3,10,13,-3,16,1
356830,3,0,13,-13,5,0
280692,2,0,3,-3,5,1
225010,1,0,0,0,15,0
405851,1,0,0,0,11,1
331646,4,23,33,-10,11,1
180582,1,0,3,-3,13,1
389657,3,24,10,14,3,0
314163,2,7,14,-7,3,1
272920,4,20,20,0,2,0
225126,4,16,14,2,15,0
366901,4,3,16,-13,10,1
192092,1,0,3,-3,1,0
365642,4,38,35,3,9,0
21354,4,17,24,-7,11,0
79594,2,14,7,7,2,1
402417,2,14,7,7,9,1
17074,2,20,3,17,9,0
63805,4,14,34,-20,12,0
72685,4,20,10,10,16,0
169104,4,36,30,6,7,1
306084,4,17,13,4,17,1
399204,3,13,13,0,7,1
94293,1,3,0,3,9,1
8756,2,0,0,0,4,1
340353,3,17,10,7,15,1
92782,4,12,26,-14,8,1
30837,2,0,14,-14,15,0
200971,1,13,0,13,5,1
348072,2,0,16,-16,1,1
390214,2,0,6,-6,3,1
351687,3,7,10,-3,3,0
236777,2,0,9,-9,3,0
161380,1,0,0,0,4,1
249546,3,14,10,4,9,0
344563,3,0,0,0,17,0
74257,3,10,10,0,17,0
197108,2,13,17,-4,3,1
211518,3,26,14,12,9,1
87916,4,19,15,4,6,0
66801,4,10,6,4,14,0
132220,1,7,0,7,9,0
377618,1,0,0,0,15,1
235916,4,10,14,-4,3,0
138028,2,22,17,5,11,0
166641,4,22,20,2,6,1
138332,3,27,0,27,11,0
138261,1,0,0,0,11,1
120212,1,7,0,7,3,1
144293,4,25,7,18,14,1
3373,4,10,13,-3,2,1
255110,4,14,31,-17,12,0
26238,2,0,14,-14,13,1
361696,4,10,38,-28,7,0
31765,2,0,17,-17,15,0
372060,4,13,10,3,13,1
281421,1,0,10,-10,6,0
412918,2,6,3,3,14,1
372570,1,7,0,7,13,0
190972,3,12,0,12,17,1
326430,1,0,3,-3,9,1
16665,3,14,27,-13,8,0
297093,3,24,0,24,13,0
359606,2,24,0,24,6,0
394648,4,17,21,-4,5,0
233996,1,14,0,14,2,1
263009,2,10,0,10,15,0
297258,3,21,6,15,13,1
112896,3,13,6,7,17,1
240834,4,29,10,19,5,1
229692,2,10,7,3,17,1
402109,2,6,0,6,9,1
13331,3,7,27,-20,7,1
140832,1,7,0,7,13,0
154581,2,14,7,7,1,0
191971,2,0,13,-13,1,1
108639,1,6,0,6,15,1
392251,4,10,16,-6,4,1
369218,1,0,7,-7,11,1
372101,1,3,0,3,13,0
191135,4,28,27,1,17,1
161562,2,6,10,-4,4,1
169176,2,10,6,4,7,0
210100,1,0,0,0,9,1
26257,2,7,14,-7,13,0
342938,4,37,17,20,16,0
383389,3,3,9,-6,17,1
379241,4,19,16,3,16,1
329582,1,10,0,10,11,0
234516,4,20,20,0,2,0
72121,4,17,17,0,16,0
126024,1,7,0,7,6,0
212991,4,21,7,14,10,0
24463,1,0,0,0,12,0
404905,2,3,3,0,10,0
207711,2,0,10,-10,7,0
302404,4,16,16,0,15,0
142166,4,2,7,-5,13,0
318139,3,9,10,-1,5,0
144082,2,13,0,13,14,1
241813,1,3,3,0,5,1
75374,1,0,0,0,17,0
186630,2,24,3,21,15,0
394727,2,14,0,14,5,1
316979,1,0,0,0,4,0
34928,4,27,24,3,16,0
150426,2,20,0,20,16,0
364193,1,0,0,0,9,1
89527,2,0,10,-10,7,1
65687,1,0,7,-7,13,0
280167,3,28,0,28,5,1
162966,2,6,0,6,5,0
258587,3,13,10,3,13,1
356146,2,10,0,10,5,0
420201,4,3,10,-7,17,1
250469,2,13,7,6,9,1
254095,1,0,0,0,11,0
259018,3,3,16,-13,13,0
56773,3,14,13,1,9,0
412447,2,0,7,-7,14,1
266952,3,16,7,9,17,1
240956,3,21,9,12,5,0
396161,4,24,23,1,6,0
367867,3,20,17,3,10,0
8300,1,0,0,0,4,0
106250,1,0,0,0,14,1
197496,4,20,9,11,3,0
258825,2,7,7,0,13,1
356962,2,17,3,14,5,0
189222,3,33,3,30,16,0
126394,4,20,14,6,6,0
292947,4,10,0,10,11,0
49833,3,21,10,11,6,0
161712,2,10,3,7,4,1
215316,2,14,7,7,11,0
386546,4,14,24,-10,2,0
281411,1,0,3,-3,6,0
416203,3,10,22,-12,15,0
382018,4,7,30,-23,17,0
83379,2,7,14,-7,4,1
167713,3,23,20,3,7,1
6360,2,0,13,-13,3,0
409829,2,10,0,10,12,1
323702,4,26,0,26,8,0
416329,2,13,3,10,15,1
42238,3,24,7,17,2,1
181687,2,0,7,-7,13,1
116604,3,13,3,10,2,1
318597,3,10,10,0,5,1
88251,1,0,0,0,6,1
341477,1,0,7,-7,16,1
4139,4,26,31,-5,2,1
150356,3,27,7,20,16,1
364032,4,6,18,-12,8,1
221818,1,0,0,0,14,1
28311,1,0,0,0,14,1
301218,4,20,14,6,15,0
60834,3,10,16,-6,11,1
20972,2,14,24,-10,10,1
290968,2,20,10,10,10,1
301236,4,27,17,10,15,1
17283,4,21,41,-20,9,1
131325,1,0,0,0,8,0
60194,2,3,7,-4,11,1
315547,3,7,14,-7,4,1
322986,4,20,0,20,7,0
339043,4,20,10,10,15,0
167679,2,10,20,-10,7,0
89363,2,3,13,-10,7,1
320520,1,7,0,7,6,0
51595,2,7,10,-3,7,1
239342,4,3,17,-14,4,0
196217,2,7,3,4,2,0
354741,1,6,0,6,4,0
204022,4,16,7,9,6,1
181801,1,0,0,0,13,1
359144,2,7,0,7,6,0
100752,1,6,0,6,12,1
358556,2,10,3,7,6,1
207369,4,13,21,-8,7,0
319141,2,2,0,2,5,1
362643,2,0,7,-7,8,1
414746,4,10,17,-7,14,1
176200,3,14,24,-10,11,1
24572,3,10,16,-6,12,1
3586,2,20,14,6,2,0
141264,4,10,24,-14,13,1
269896,1,0,0,0,1,1
141843,3,17,14,3,13,1
86491,4,30,24,6,5,1
159131,4,31,7,24,3,0
84153,2,10,0,10,4,0
364534,2,3,14,-11,9,1
53324,4,24,16,8,8,0
69933,1,0,0,0,15,1
187084,2,10,0,10,16,1
301738,2,0,10,-10,15,0
299594,3,13,10,3,14,1
10362,3,10,35,-25,5,0
186580,1,7,0,7,15,1
12318,4,6,9,-3,6,0
349597,3,13,28,-15,2,1
409967,2,6,21,-15,12,0
419125,2,10,0,10,16,0
401864,3,14,27,-13,9,0
301694,1,0,0,0,15,0
38672,3,7,7,0,1,1
363094,2,7,3,4,8,1
100158,1,7,0,7,12,1
211833,3,22,10,12,9,1
180562,4,28,32,-4,13,1
178994,4,19,3,16,12,1
105021,1,0,7,-7,14,0
313084,1,0,0,0,3,1
286022,1,0,0,0,8,1
156993,4,7,13,-6,2,0
397226,4,16,0,16,6,1
19993,2,9,3,6,10,0
307182,2,0,10,-10,17,1
346282,4,46,3,43,1,1
24289,4,13,17,-4,12,0
366554,2,20,7,13,10,1
41170,2,0,7,-7,2,0
135693,3,14,10,4,10,1
302192,2,21,7,14,15,1
104773,3,20,19,1,14,0
127934,3,23,0,23,6,0
190211,2,7,0,7,17,0
258506,1,0,0,0,13,0
137628,5,37,34,3,11,0
343331,2,0,10,-10,16,0
58754,3,10,20,-10,10,0
56216,1,3,0,3,9,0
402441,3,21,12,9,9,0
27932,3,14,10,4,13,1
350603,2,10,0,10,2,0
110831,4,12,13,-1,16,1
219557,4,21,21,0,13,1
145379,4,52,26,26,14,0
114865,4,16,33,-17,1,1
249145,4,28,28,0,9,1
230877,2,7,10,-3,1,1
235998,2,10,0,10,3,0
102609,2,5,6,-1,13,1
407257,2,7,16,-9,11,1
266797,3,10,14,-4,16,0
393242,3,14,13,1,5,0
239384,1,3,7,-4,4,1
306178,3,10,3,7,17,1
293617,1,7,0,7,12,0
189814,3,17,17,0,17,1
338540,3,20,24,-4,14,0
69352,4,19,12,7,15,1
71536,1,0,0,0,16,1
107189,2,0,21,-21,15,0
71825,1,0,0,0,16,1
214947,4,7,26,-19,11,0
400473,1,0,0,0,8,0
287447,1,7,10,-3,9,0
32275,4,24,21,3,15,1
323288,4,7,24,-17,7,1
261033,1,0,6,-6,14,0
403729,2,9,3,6,9,1
329897,1,0,7,-7,11,0
364914,4,13,23,-10,9,1
312443,4,39,41,-2,3,1
236874,1,6,0,6,3,0
366920,4,3,16,-13,10,0
107071,3,33,0,33,15,1
261070,2,0,14,-14,14,1
147761,4,24,24,0,15,0
167877,3,14,16,-2,7,1
187754,4,16,20,-4,16,0
277732,3,7,3,4,4,0
409418,3,34,3,31,12,0
40973,4,19,27,-8,2,0
235151,4,0,10,-10,2,1
225174,2,3,7,-4,15,1
276465,2,10,7,3,4,0
314252,4,17,23,-6,3,1
344426,4,28,24,4,17,1
116560,2,3,0,3,2,0
301035,2,16,3,13,15,1
119699,5,20,19,1,3,1
368637,1,0,0,0,11,0
149298,4,13,27,-14,16,1
360095,4,10,43,-33,7,1
209965,1,0,3,-3,8,0
197715,2,7,10,-3,3,1
44376,1,0,0,0,3,1
367182,4,29,23,6,10,0
212383,4,13,17,-4,10,1
160306,2,3,7,-4,4,0
375615,2,14,17,-3,14,0
88709,1,0,0,0,6,0
245521,1,21,0,21,7,0
250601,1,3,0,3,10,0
60239,3,10,13,-3,11,1
416457,2,14,7,7,15,0
274562,3,21,22,-1,3,0
223615,1,6,0,6,15,1
39669,1,3,0,3,1,0
206533,2,0,3,-3,7,0
35682,4,23,10,13,17,0
383599,4,24,24,0,17,1
258714,2,0,20,-20,13,1
149010,4,13,19,-6,16,1
9974,4,3,3,0,5,0
263329,3,24,7,17,15,0
118899,4,27,14,13,2,0
187344,1,7,7,0,16,1
113176,3,41,7,34,17,0
335542,2,0,0,0,13,1
21399,2,6,7,-1,11,0
370716,2,3,7,-4,12,0
195269,4,23,24,-1,2,1
52338,2,3,3,0,7,0
318617,3,10,13,-3,5,1
221726,2,10,0,10,14,0
310918,3,3,6,-3,2,0
66814,4,13,6,7,14,1
368285,3,6,6,0,11,1
346223,3,26,0,26,1,0
130688,4,7,38,-31,8,1
206450,3,17,0,17,7,0
132762,4,20,24,-4,9,0
69910,4,27,16,11,15,0
421318,4,28,10,18,17,0
152411,4,35,3,32,17,1
208358,3,17,27,-10,8,1
310558,1,3,6,-3,2,0
244958,2,0,20,-20,7,0
348830,2,3,14,-11,2,1
147307,4,7,31,-24,15,1
97503,2,16,0,16,10,0
136744,2,13,10,3,11,1
228748,4,26,33,-7,17,0
415516,1,0,0,0,15,0
119195,4,16,7,9,3,0
36374,3,13,19,-6,17,1
13372,4,7,34,-27,7,0
237586,4,38,22,16,3,0
385735,2,7,0,7,1,1
71469,3,30,7,23,16,0
302142,4,34,48,-14,15,1
42226,3,24,0,24,2,0
100020,1,3,0,3,12,0
216187,2,14,3,11,12,0
188243,2,14,7,7,16,0
133716,1,0,0,0,9,0
76226,3,12,27,-15,1,1
224777,3,5,3,2,15,1
41287,1,0,3,-3,2,1
130825,3,13,12,1,8,0
32845,3,6,7,-1,15,1
181650,4,23,6,17,13,0
413124,3,30,35,-5,14,1
305814,1,0,7,-7,17,1
371688,1,0,6,-6,12,0
86621,4,47,3,44,5,0
12609,4,3,24,-21,6,0
69204,4,20,17,3,15,0
418590,2,14,10,4,16,1
328765,3,17,13,4,10,1
24803,2,6,0,6,12,0
334118,2,16,7,9,13,1
243912,3,16,6,10,6,1
196923,1,0,0,0,3,1
105776,1,0,0,0,14,0
155594,4,23,17,6,2,1
222348,3,21,3,18,14,1
144612,4,20,19,1,14,0
118474,4,27,10,17,2,0
375768,2,13,0,13,14,1
66725,1,0,3,-3,14,1
39991,2,7,7,0,1,1
334116,2,16,7,9,13,1
96959,4,22,10,12,10,1
245464,4,22,6,16,7,1
71823,1,0,0,0,16,1
16760,2,3,14,-11,8,1
244711,4,21,26,-5,7,1
214077,1,3,0,3,11,0
263111,1,0,7,-7,15,1
159878,2,23,0,23,3,1
279016,4,13,33,-20,5,0
112149,3,10,20,-10,17,0
41992,1,0,0,0,2,1
95280,3,10,23,-13,10,0
301903,2,6,13,-7,15,0
314005,2,0,0,0,3,1
192103,1,0,3,-3,1,1
345691,2,7,0,7,17,1
285555,2,7,10,-3,8,1
259217,4,21,32,-11,13,1
15258,4,23,7,16,8,0
139911,1,0,3,-3,12,1
416109,4,21,13,8,15,1
233413,2,14,0,14,2,0
391166,3,10,24,-14,4,1
117001,1,0,3,-3,2,1
111747,1,0,0,0,17,0
122399,2,0,17,-17,4,1
184735,1,0,0,0,15,1
17576,4,13,17,-4,9,0
3246,1,0,0,0,2,1
55052,2,13,3,10,8,0
130258,4,9,29,-20,8,0
397527,1,0,0,0,7,1
200333,4,30,14,16,4,1
364697,2,6,0,6,9,0
184495,2,14,7,7,14,0
174111,4,8,36,-28,10,0
331780,4,23,27,-4,12,0
28831,2,10,7,3,14,1
97011,1,10,0,10,10,0
326125,4,30,10,20,9,1
234926,1,10,3,7,2,1
402898,3,17,9,8,9,0
85472,2,14,3,11,5,0
245168,4,17,28,-11,7,1
67892,3,16,3,13,14,1
249535,2,14,3,11,9,0
144419,3,3,13,-10,14,0
309847,3,14,7,7,1,0
213891,4,54,14,40,10,1
43414,4,21,24,-3,3,1
89213,2,3,0,3,7,1
254142,2,3,9,-6,11,0
110107,1,0,3,-3,16,0
223760,1,0,0,0,15,1
90710,1,7,0,7,7,0
202862,2,14,0,14,5,0
131160,4,27,12,15,8,1
383044,1,3,7,-4,17,1
72937,3,17,7,10,16,1
396226,1,0,3,-3,6,1
111799,2,3,7,-4,17,0
93983,1,0,7,-7,9,0
397772,4,17,14,3,7,1
265519,4,14,10,4,16,0
71685,1,0,0,0,16,1
27729,1,0,7,-7,13,1
200603,3,24,14,10,4,1
623,1,0,3,-3,1,0
222351,3,21,3,18,14,0
214182,4,19,9,10,11,1
118501,1,14,0,14,2,0
318525,1,0,0,0,5,0
39621,4,27,6,21,1,0
233431,2,17,3,14,2,0
284431,1,0,9,-9,7,1
362289,1,0,0,0,8,1
13597,2,9,7,2,7,1
16131,4,40,17,23,8,1
270172,4,34,27,7,1,0
227164,3,10,7,3,16,1
377515,2,0,0,0,15,0
76734,1,0,0,0,1,1
187505,2,3,10,-7,16,0
155901,4,17,13,4,2,0
311316,1,7,0,7,2,1
302017,1,7,3,4,15,0
381815,2,0,14,-14,17,1
34739,3,6,3,3,16,1
87705,3,3,20,-17,6,1
60903,4,17,34,-17,11,1
352822,2,14,3,11,3,1
306679,1,0,0,0,17,1
181744,3,7,7,0,13,0
194818,4,10,26,-16,2,1
283142,3,6,9,-3,7,1
14012,2,3,14,-11,7,1
42223,2,24,0,24,2,0
66213,3,24,3,21,13,0
239464,4,15,17,-2,4,1
16209,2,3,0,3,8,1
267347,1,0,7,-7,17,1
248578,1,7,0,7,9,0
404954,3,6,13,-7,10,1
178630,2,3,3,0,12,0
419133,2,10,3,7,16,1
336262,2,10,0,10,13,0
139278,3,13,13,0,12,1
39885,3,6,7,-1,1,1
402402,2,7,7,0,9,1
352783,1,7,0,7,3,0
133103,1,0,0,0,9,0
350010,2,10,7,3,2,1
104821,4,27,33,-6,14,0
103201,2,3,0,3,13,1
201036,3,27,0,27,5,1
392023,3,7,10,-3,4,1
200173,3,7,37,-30,4,0
331618,3,23,30,-7,11,1
389844,4,24,6,18,3,0
283196,4,26,9,17,7,1
335213,4,37,20,17,13,0
302001,1,0,0,0,15,1
351617,1,0,7,-7,3,1
388106,1,3,0,3,2,0
348611,4,31,23,8,2,1
319270,1,3,3,0,6,0
251253,3,10,24,-14,10,0
35738,2,3,0,3,17,1
385958,4,24,21,3,1,0
274033,1,3,0,3,3,1
356248,4,29,14,15,5,1
227609,3,28,0,28,16,1
311767,2,7,13,-6,2,1
70721,2,7,10,-3,15,1
93157,2,0,0,0,9,0
14136,2,0,14,-14,7,1
255935,2,6,3,3,12,0
245092,1,14,3,11,7,0
311110,4,13,3,10,2,0
412319,2,7,14,-7,13,1
133756,2,13,7,6,9,0
265194,2,6,3,3,16,1
101416,3,15,7,8,12,0
343164,1,3,0,3,16,1
4155,1,0,3,-3,2,1
222735,1,3,0,3,14,0
210167,3,0,14,-14,9,1
114669,3,3,10,-7,1,0
339782,4,24,6,18,15,0
284442,2,7,9,-2,7,0
49965,2,21,0,21,6,1
380438,4,10,24,-14,16,1
33706,4,28,0,28,16,1
13133,2,10,7,3,6,0
176474,2,0,10,-10,11,1
133334,3,14,6,8,9,0
119073,1,0,7,-7,3,1
281213,4,24,16,8,6,1
135021,1,7,0,7,10,1
217552,1,3,0,3,12,0
232035,2,0,17,-17,1,1
284008,2,3,0,3,7,1
419052,3,7,20,-13,16,1
298431,4,7,21,-14,14,0
29667,1,0,0,0,14,0
129591,3,13,20,-7,7,1
197897,3,11,7,4,3,1
74336,1,0,3,-3,17,1
160538,4,23,14,9,4,1
52960,2,14,17,-3,7,1
321401,2,14,10,4,7,1
336307,3,17,10,7,13,1
79530,1,0,0,0,2,0
384818,2,6,3,3,1,0
26390,1,10,0,10,13,0
247254,2,21,14,7,8,1
362952,2,27,6,21,8,0
324650,1,0,0,0,8,0
8342,2,16,3,13,4,1
270767,4,6,10,-4,1,1
124134,3,13,21,-8,5,0
159377,2,7,10,-3,3,0
62340,4,21,22,-1,12,1
401510,1,0,7,-7,8,1
227142,2,7,7,0,16,1
56979,1,0,7,-7,9,0
53761,4,10,3,7,8,0
65677,1,0,6,-6,13,0
304268,4,33,22,11,16,0
309755,4,26,12,14,1,1
318756,3,10,23,-13,5,1
74526,3,0,3,-3,17,0
207067,4,38,9,29,7,0
188603,4,20,13,7,16,1
108106,3,13,35,-22,15,0
397541,1,6,0,6,7,0
404663,4,20,22,-2,10,0
372136,2,9,7,2,13,1
151920,3,20,10,10,17,0
211756,1,0,0,0,9,0
407237,2,0,9,-9,11,0
400776,1,14,0,14,8,0
321324,3,15,19,-4,6,1
47662,2,3,17,-14,5,0
77905,4,24,38,-14,1,1
414925,4,42,21,21,15,1
56352,4,3,33,-30,9,1
32215,2,14,7,7,15,0
113182,3,41,16,25,17,1
404034,2,3,28,-25,10,1
20258,1,0,0,0,10,1
56529,2,13,0,13,9,0
406958,2,3,13,-10,11,0
404618,2,13,13,0,10,1
131932,1,0,0,0,8,1
394383,4,31,17,14,5,1
263172,2,3,14,-11,15,1
249021,1,7,3,4,9,1
288338,2,7,0,7,9,1
208686,4,9,6,3,8,0
76754,1,17,0,17,1,0
25396,2,6,3,3,12,1
1313,1,0,0,0,1,1
407984,1,0,0,0,12,1
187272,4,10,6,4,16,0
112709,2,3,0,3,17,0
283631,4,20,20,0,7,0
278062,4,13,10,3,4,1
169821,3,10,17,-7,8,1
166365,1,0,0,0,6,1
60753,4,28,3,25,11,1
371929,4,34,17,17,12,0
174389,3,17,3,14,10,1
277348,1,14,0,14,4,0
102470,2,10,3,7,13,1
37068,2,13,13,0,17,0
277490,1,0,0,0,4,1
231729,2,3,7,-4,1,0
134633,3,31,17,14,10,0
246257,4,24,16,8,7,1
220586,4,10,26,-16,13,1
83560,3,0,17,-17,4,0
336938,4,14,21,-7,14,1
207883,3,14,7,7,8,1
304842,4,3,3,0,16,1
163743,2,0,9,-9,5,1
43418,4,21,24,-3,3,1
26763,3,6,27,-21,13,1
205863,4,20,0,20,7,0
105904,4,19,13,6,14,1
29762,3,41,3,38,14,0
208826,4,6,22,-16,8,0
65782,4,27,25,2,13,0
232810,3,16,14,2,2,1
91171,2,9,14,-5,8,1
313025,3,17,0,17,3,1
334519,2,14,14,0,13,0
125731,2,7,7,0,5,1
385900,2,3,7,-4,1,0
71498,4,33,14,19,16,0
234974,3,13,3,10,2,0
385064,1,0,0,0,1,0
194901,2,7,10,-3,2,0
53202,1,0,0,0,8,1
219112,1,0,0,0,13,1
177953,2,7,3,4,12,1
292569,1,6,6,0,11,0
15173,2,3,0,3,8,1
281281,1,7,6,1,6,0
55291,4,13,10,3,9,1
196458,4,20,28,-8,2,1
316644,4,12,12,0,4,1
143585,1,0,3,-3,14,0
370194,4,24,10,14,12,1
331315,3,0,24,-24,11,0
254926,3,24,7,17,12,1
123665,3,7,22,-15,4,1
254279,2,6,9,-3,11,1
229401,2,3,0,3,17,0
419576,2,13,7,6,17,1
304707,4,21,7,14,16,0
45506,4,27,26,1,4,0
66561,1,0,7,-7,14,1
84429,2,6,7,-1,4,1
176793,2,3,7,-4,11,1
225436,1,0,0,0,15,0
336124,2,10,3,7,13,1
343965,3,16,6,10,17,1
54339,2,7,12,-5,8,1
184158,4,16,17,-1,14,1
44982,2,3,0,3,4,1
314542,4,27,10,17,3,0
117489,3,7,17,-10,2,0
356961,2,17,3,14,5,0
297621,1,7,0,7,13,0
243299,3,7,10,-3,6,0
305732,3,9,10,-1,17,1
120389,2,16,6,10,3,0
259997,4,23,20,3,14,0
222342,3,20,3,17,14,1
363918,1,0,0,0,8,0
261405,3,10,17,-7,14,0
270054,1,3,3,0,1,0
299747,4,17,6,11,14,1
268537,1,7,0,7,17,0
350577,2,10,0,10,2,0
161758,3,24,6,18,4,0
347072,1,0,0,0,1,0
301521,4,20,18,2,15,1
399160,2,0,3,-3,7,1
66217,3,24,3,21,13,1
170875,2,7,0,7,8,0
416888,2,0,7,-7,15,1
295137,4,7,14,-7,12,1
127464,2,3,10,-7,6,0
196792,1,0,7,-7,3,0
232111,4,13,33,-20,1,1
300343,3,3,7,-4,14,0
20747,4,31,20,11,10,1
193693,2,3,20,-17,1,1
213833,3,42,0,42,10,0
395011,2,0,14,-14,5,0
420567,1,0,0,0,17,0
297387,3,9,17,-8,13,0
228457,1,3,0,3,17,0
8021,2,3,7,-4,4,1
301054,3,17,9,8,15,0
180532,4,21,20,1,13,0
290470,1,7,0,7,10,1
95270,3,3,17,-14,10,1
204524,1,0,7,-7,6,1
91098,4,12,7,5,7,1
392500,2,3,17,-14,4,0
197300,3,14,0,14,3,0
300091,4,14,40,-26,14,0
141764,4,33,28,5,13,0
300344,3,3,7,-4,14,0
337274,4,16,26,-10,14,0
162467,1,7,3,4,4,1
13070,4,14,13,1,6,0
227427,2,7,7,0,16,1
21344,4,14,24,-10,11,1
217220,4,12,22,-10,12,1
313653,4,25,30,-5,3,1
352085,2,3,10,-7,3,0
7696,1,10,0,10,4,1
277508,2,0,7,-7,4,1
327117,2,7,3,4,9,0
326781,2,3,14,-11,9,0
166146,3,14,12,2,6,1
295816,5,27,30,-3,12,0
4715,1,0,0,0,3,1
249810,1,3,3,0,9,1
312582,4,44,0,44,3,1
292687,4,22,16,6,11,1
374675,1,0,6,-6,14,1
32960,2,0,24,-24,15,1
408198,3,13,3,10,12,1
417967,2,14,21,-7,16,1
242982,5,34,34,0,6,1
128354,3,7,3,4,7,1
155885,3,14,13,1,2,0
395597,1,0,3,-3,6,0
61424,3,16,3,13,11,0
414315,4,21,42,-21,14,1
250458,2,7,0,7,9,1
94781,2,3,3,0,9,0
365026,3,17,6,11,9,0
133396,1,0,0,0,9,0
351558,4,0,27,-27,3,1
316806,4,16,7,9,4,0
106924,3,12,3,9,14,0
76525,3,7,20,-13,1,0
131205,2,7,10,-3,8,1
98412,2,14,7,7,11,0
76842,4,33,7,26,1,1
123761,2,10,3,7,5,0
67150,2,0,0,0,14,0
176638,2,14,12,2,11,0
321518,4,24,30,-6,7,1
126493,2,0,6,-6,6,1
73897,1,7,0,7,17,1
114890,4,24,40,-16,1,1
193386,2,7,17,-10,1,1
297193,2,0,0,0,13,1
87435,3,20,7,13,6,0
163007,3,16,3,13,5,0
221590,3,20,18,2,14,1
299159,3,10,16,-6,14,0
57419,4,14,6,8,10,0
239408,2,6,10,-4,4,1
221423,2,3,24,-21,14,0
206877,3,3,17,-14,7,1
55952,2,10,7,3,9,1
173568,1,0,10,-10,10,1
188704,2,0,17,-17,16,0
197105,2,7,17,-10,3,1
381812,2,0,14,-14,17,1
48471,4,20,27,-7,5,1
56219,1,3,0,3,9,0
262267,2,3,9,-6,15,1
417332,2,10,3,7,16,0
7151,4,34,21,13,4,0
6209,2,10,0,10,3,1
20483,2,0,0,0,10,1
75695,1,14,0,14,1,0
367659,1,0,3,-3,10,0
137479,1,7,0,7,11,1
404977,3,9,13,-4,10,0
160828,3,27,17,10,4,0
248536,5,23,23,0,8,0
350211,3,27,0,27,2,0
12663,2,10,0,10,6,0
1062,2,7,22,-15,1,0
86715,3,17,14,3,5,0
114863,4,16,33,-17,1,0
376402,4,9,6,3,14,0
250333,3,7,7,0,9,0
137301,4,13,27,-14,11,0
348979,2,14,0,14,2,1
357489,1,0,3,-3,5,0
183893,1,0,0,0,14,1
217854,2,10,14,-4,12,0
345478,4,9,22,-13,17,1
220544,3,7,20,-13,13,0
139339,4,20,13,7,12,1
413248,2,10,0,10,14,0
173531,4,13,27,-14,10,0
158840,4,20,3,17,3,1
192492,3,7,17,-10,1,1
241306,4,13,7,6,5,0
90096,1,0,0,0,7,0
221356,1,0,7,-7,14,0
202336,4,13,6,7,5,1
147898,4,17,31,-14,15,0
194249,1,0,0,0,2,1
33041,1,0,0,0,16,1
145452,3,9,14,-5,14,1
184112,3,16,14,2,14,0
279064,1,14,0,14,5,0
227897,2,20,6,14,16,0
84468,3,13,10,3,4,1
386360,2,17,6,11,2,1
34186,4,17,10,7,16,0
105936,1,7,0,7,14,0
311637,2,6,6,0,2,1
20910,1,0,0,0,10,0
8169,1,0,7,-7,4,0
139783,1,0,3,-3,12,0
379881,2,14,0,14,16,0
373934,1,0,0,0,13,1
215220,3,10,16,-6,11,0
214578,2,3,3,0,11,1
411613,3,14,21,-7,13,0
22587,2,13,3,10,11,1
272515,2,7,3,4,2,0
114366,3,24,13,11,1,1
338583,4,35,38,-3,14,1
137638,5,37,37,0,11,1
107208,3,6,31,-25,15,1
415778,4,21,17,4,15,0
217444,2,9,0,9,12,1
166097,2,14,0,14,6,0
63343,3,17,3,14,12,1
240702,1,0,0,0,5,0
165677,3,7,7,0,6,0
362235,3,12,17,-5,8,0
337702,4,24,21,3,14,0
185239,2,17,6,11,15,0
7094,2,21,14,7,4,1
108741,4,44,19,25,15,1
78164,3,20,3,17,2,0
255609,1,0,7,-7,12,0
421142,3,30,16,14,17,1
256305,4,14,17,-3,12,1
388842,4,21,17,4,3,0
117628,2,6,10,-4,2,0
299311,3,26,10,16,14,1
275385,1,0,0,0,3,0
240086,1,0,0,0,5,0
347254,2,0,0,0,1,0
352385,2,28,7,21,3,0
26670,1,0,0,0,13,0
238862,4,41,6,35,4,0
407766,3,10,7,3,11,1
202721,2,6,10,-4,5,1
419583,2,20,7,13,17,0
222801,3,10,10,0,14,1
13547,1,0,0,0,7,1
30816,1,0,7,-7,15,1
321406,2,14,10,4,7,1
170019,4,28,17,11,8,0
168914,4,17,6,11,7,0
59131,4,26,39,-13,10,1
76448,1,0,7,-7,1,0
108602,4,26,21,5,15,0
324185,4,3,17,-14,8,0
281460,2,0,10,-10,6,1
82306,2,3,10,-7,3,0
34790,4,20,3,17,16,0
86659,1,7,0,7,5,1
145728,1,0,10,-10,15,1
99786,3,0,7,-7,12,0
412963,3,16,12,4,14,1
408573,1,7,0,7,12,0
36226,3,10,17,-7,17,0
106148,3,0,0,0,14,1
145215,4,49,0,49,14,0
202201,4,13,14,-1,5,1
256088,2,0,10,-10,12,0
263353,4,24,10,14,15,1
224022,3,14,6,8,15,0
141420,4,10,20,-10,13,1
44389,2,0,0,0,3,1
198080,4,10,37,-27,3,1
258877,4,20,14,6,13,1
276042,2,13,3,10,3,0
190408,3,7,7,0,17,0
247274,3,28,28,0,8,1
258214,1,0,0,0,13,1
323504,2,10,10,0,7,1
214021,3,36,7,29,10,0
33396,3,20,10,10,16,0
148461,2,14,3,11,16,0
115245,2,0,9,-9,1,1
228160,1,7,17,-10,17,1
331087,1,0,0,0,11,0
320952,1,0,0,0,6,1
225075,3,10,14,-4,15,1
179799,4,6,27,-21,12,0
268589,2,7,6,1,17,1
5801,2,24,7,17,3,0
132494,1,0,0,0,9,0
34201,1,7,0,7,16,1
58030,5,20,20,0,10,1
61525,2,13,7,6,11,1
257707,3,3,10,-7,13,0
15708,1,0,0,0,8,1
148005,2,7,3,4,15,1
304017,2,0,13,-13,16,1
273738,1,0,7,-7,2,1
367596,3,28,12,16,10,0
248498,4,23,6,17,8,0
296811,3,7,7,0,13,1
108896,4,17,17,0,15,1
20669,2,10,17,-7,10,1
46782,3,14,20,-6,4,0
43056,2,3,7,-4,3,0
236447,1,7,0,7,3,0
379899,3,14,3,11,16,0
133163,2,10,17,-7,9,1
312357,2,10,17,-7,3,1
130014,2,7,13,-6,8,1
205294,1,10,0,10,6,0
23325,2,6,10,-4,11,1
19744,3,9,9,0,10,0
62120,2,7,7,0,12,1
409078,2,3,10,-7,12,0
310564,1,3,13,-10,2,1
388843,4,21,17,4,3,0
227198,4,13,17,-4,16,1
49194,2,10,0,10,6,1
179836,1,0,0,0,13,1
108465,1,0,0,0,15,0
348485,1,14,0,14,2,1
299736,3,17,6,11,14,1
59111,4,18,29,-11,10,0
419486,3,10,9,1,16,1
210472,3,9,14,-5,9,0
3023,4,20,34,-14,2,0
320624,4,31,18,13,6,1
60554,3,30,27,3,11,1
227866,2,7,6,1,16,1
314258,4,17,23,-6,3,1
8465,2,15,0,15,4,0
297741,4,24,23,1,13,1
347494,3,12,22,-10,1,0
240451,2,3,7,-4,5,1
218772,3,0,16,-16,13,1
323668,3,20,0,20,8,1
37870,1,0,0,0,1,0
18553,2,3,3,0,9,0
46503,3,27,6,21,4,1
353508,1,3,0,3,4,1
347440,1,3,13,-10,1,1
263378,4,31,17,14,15,1
393403,3,21,17,4,5,0
315152,1,7,7,0,4,1
266886,1,0,0,0,17,0
381736,4,32,31,1,17,0
115264,3,7,9,-2,1,0
122119,2,17,14,3,4,0
407390,2,0,7,-7,11,1
352833,3,14,3,11,3,0
203042,3,20,3,17,5,1
96723,2,0,10,-10,10,0
333652,2,6,0,6,12,1
217127,2,0,9,-9,12,1
42961,4,31,23,8,3,0
172706,2,14,3,11,9,0
311922,2,21,7,14,2,0
115060,1,3,0,3,1,1
96235,4,3,28,-25,10,0
405496,4,24,16,8,10,0
268367,4,20,6,14,17,1
346898,4,23,16,7,1,0
58886,2,3,18,-15,10,1
322129,1,0,0,0,7,0
6787,2,3,0,3,3,0
168634,4,17,16,1,7,0
420672,3,21,16,5,17,0
220493,1,0,7,-7,13,0
79652,4,24,21,3,2,1
335420,2,7,6,1,13,0
324744,3,19,7,12,8,1
369802,1,0,0,0,12,1
77452,1,0,0,0,1,1
203244,4,10,24,-14,5,1
270515,2,0,7,-7,1,1
419200,4,17,6,11,16,0
254258,2,6,6,0,11,0
363646,1,0,7,-7,8,0
300367,4,10,7,3,14,1
82367,4,13,10,3,3,1
97356,2,2,6,-4,10,1
183774,2,10,14,-4,14,0
194759,2,0,13,-13,2,0
203009,2,14,0,14,5,0
43074,3,3,10,-7,3,1
131336,1,7,0,7,8,0
418163,3,24,3,21,16,0
141386,3,10,17,-7,13,0
133988,1,0,0,0,9,0
56008,4,10,23,-13,9,1
218995,2,14,0,14,13,1
367042,4,10,38,-28,10,1
29350,4,21,16,5,14,1
354386,4,45,3,42,4,0
329690,4,30,17,13,11,1
1524,2,3,13,-10,1,1
184613,1,7,3,4,15,1
174659,2,9,0,9,10,1
128068,2,3,6,-3,7,0
404510,3,24,27,-3,10,1
107037,2,17,0,17,15,1
71243,4,22,26,-4,16,1
418796,4,14,24,-10,16,1
287785,2,21,10,11,9,0
148446,2,7,3,4,16,0
47911,1,0,0,0,5,1
243619,3,20,14,6,6,1
305080,2,21,7,14,16,1
229548,2,17,6,11,17,0
212753,2,10,21,-11,10,0
162062,3,21,13,8,4,1
297362,2,6,10,-4,13,0
57253,4,26,21,5,10,0
158781,2,7,3,4,3,1
176708,3,29,19,10,11,0
201670,3,10,20,-10,5,1
33304,4,23,3,20,16,1
177962,2,7,3,4,12,0
287713,5,16,16,0,9,0
200842,1,0,0,0,4,1
316539,1,0,3,-3,4,1
233617,3,23,41,-18,2,0
219985,3,13,27,-14,13,0
260024,1,0,7,-7,14,1
133897,2,3,6,-3,9,0
182340,3,24,10,14,14,0
35108,1,0,0,0,16,1
320209,1,7,0,7,6,0
18415,2,0,7,-7,9,1
218688,1,0,0,0,13,1
126955,2,3,7,-4,6,0
407729,2,10,0,10,11,0
295525,2,17,7,10,12,0
392910,1,0,3,-3,4,1
252944,3,9,0,9,11,0
201209,4,20,24,-4,5,1
175093,2,7,10,-3,10,1
164371,3,23,3,20,5,0
419725,2,3,10,-7,17,0
412959,3,16,9,7,14,0
39289,3,3,20,-17,1,1
333165,1,0,0,0,12,0
90526,4,0,26,-26,7,0
88170,2,14,10,4,6,0
301693,1,0,0,0,15,0
14763,3,31,3,28,7,0
143891,1,0,0,0,14,0
395569,4,35,14,21,6,1
1110,3,10,36,-26,1,1
205247,4,23,13,10,6,0
57272,1,0,0,0,10,0
411738,2,0,10,-10,13,0
280020,3,3,20,-17,5,1
53678,2,0,0,0,8,0
392775,2,14,3,11,4,0
182705,4,14,19,-5,14,0
34546,2,6,0,6,16,1
133941,3,6,6,0,9,1
283258,2,10,9,1,7,1
344369,2,21,7,14,17,0
228652,2,13,14,-1,17,1
279230,2,13,13,0,5,1
91980,3,13,23,-10,8,1
155109,4,13,33,-20,1,0
217940,4,39,28,11,12,0
405517,1,0,0,0,10,1
338066,2,0,7,-7,14,0
204893,3,3,13,-10,6,1
361325,2,0,0,0,7,0
145733,2,0,10,-10,15,1
250556,4,19,14,5,9,0
321953,4,27,28,-1,7,1
421387,2,13,20,-7,17,1
357507,2,7,6,1,5,0
324924,4,23,23,0,8,0
174896,4,26,24,2,10,0
70047,4,31,10,21,15,0
277398,3,24,9,15,4,0
298817,2,14,9,5,14,1
260170,1,7,0,7,14,0
377667,2,16,7,9,15,1
89600,4,7,40,-33,7,0
238254,4,10,16,-6,4,0
158795,2,14,3,11,3,1
207220,4,20,20,0,7,1
238728,4,19,17,2,4,0
172531,2,0,7,-7,9,0
86205,1,0,0,0,5,1
28194,2,3,0,3,13,1
14079,4,3,31,-28,7,0
128303,1,0,0,0,7,0
10537,3,34,0,34,5,0
290885,4,24,24,0,10,1
54846,4,22,0,22,8,1
244256,3,23,7,16,6,1
172071,2,10,3,7,9,0
38479,1,6,3,3,1,1
53983,1,0,0,0,8,1
159048,1,10,0,10,3,0
383079,2,20,7,13,17,0
53587,3,14,15,-1,8,1
187738,4,16,20,-4,16,0
264810,4,17,29,-12,16,0
210697,1,7,0,7,9,0
178904,1,0,3,-3,12,1
98362,1,0,0,0,11,1
389856,4,24,6,18,3,1
403438,2,14,6,8,9,1
325684,4,34,7,27,9,0
186971,4,10,12,-2,15,0
136427,2,10,7,3,11,1
29347,4,21,16,5,14,0
209529,2,34,10,24,8,0
293145,1,0,0,0,11,0
83443,4,10,23,-13,4,0
307571,1,0,0,0,17,1
401312,4,20,24,-4,8,1
236008,2,10,3,7,3,1
154634,3,21,21,0,1,1
11043,1,7,7,0,5,1
239613,4,20,10,10,4,0
153314,4,2,10,-8,1,0
147186,1,0,0,0,15,0
203322,2,14,24,-10,6,0
30676,1,3,0,3,15,0
368827,2,7,0,7,11,1
219653,3,10,7,3,13,1
209562,3,41,20,21,8,0
347660,3,17,17,0,1,1
418867,2,7,10,-3,16,1
22266,2,0,0,0,11,0
331576,2,17,20,-3,11,0
415786,4,24,24,0,15,1
96431,2,10,14,-4,10,1
322999,1,0,0,0,7,1
29759,3,40,3,37,14,1
33255,3,10,0,10,16,1
234878,4,3,12,-9,2,0
38484,1,7,3,4,1,1
364160,4,31,3,28,9,0
9847,1,0,0,0,5,1
250695,4,10,22,-12,10,1
42241,3,30,7,23,2,0
293087,4,10,19,-9,11,0
61840,3,12,20,-8,12,1
242359,4,34,13,21,6,0
95111,2,9,10,-1,9,0
27049,3,10,3,7,13,0
406536,3,14,23,-9,11,0
142161,4,2,7,-5,13,0
254905,2,17,7,10,12,1
215578,1,13,0,13,11,1
126027,2,7,0,7,6,0
50387,2,0,7,-7,6,1
271034,3,18,28,-10,1,1
295548,3,23,7,16,12,0
252051,4,14,20,-6,10,0
343617,2,15,7,8,17,1
119965,3,9,24,-15,3,1
241397,2,7,28,-21,5,1
210200,3,7,21,-14,9,1
365995,2,23,7,16,10,0
83774,4,32,23,9,4,0
34366,1,0,0,0,16,0
128984,3,28,10,18,7,1
92729,3,3,17,-14,8,0
180777,3,7,13,-6,13,1
340058,4,17,12,5,15,0
331895,3,0,9,-9,12,1
182897,1,0,16,-16,14,0
178736,4,11,26,-15,12,0
36044,2,10,0,10,17,1
8207,2,0,10,-10,4,0
202220,1,3,0,3,5,1
24578,4,10,16,-6,12,0
264886,2,10,7,3,16,0
225466,2,0,7,-7,15,1
336615,4,7,0,7,14,0
316563,2,3,6,-3,4,1
68232,3,19,14,5,14,1
298921,1,0,6,-6,14,0
403723,2,9,3,6,9,0
160758,1,3,0,3,4,1
195766,1,3,7,-4,2,1
92516,1,7,0,7,8,1
57022,2,7,10,-3,9,0
94475,2,0,0,0,9,0
248937,3,20,3,17,9,0
233690,1,7,14,-7,2,1
151027,2,3,0,3,17,0
341077,3,7,17,-10,15,0
205118,1,0,0,0,6,1
143089,3,17,17,0,13,0
188886,3,10,10,0,16,1
114479,2,10,17,-7,1,1
162703,4,23,24,-1,5,1
199554,3,20,10,10,4,1
324983,2,13,14,-1,8,0
157713,2,10,3,7,2,0
360008,2,3,26,-23,7,0
298470,1,0,0,0,14,1
248751,2,20,7,13,9,1
115678,2,3,3,0,1,1
227246,1,3,10,-7,16,0
298912,1,0,6,-6,14,1
47554,3,37,6,31,5,0
194398,1,0,0,0,2,1
207659,4,42,10,32,7,0
317776,1,9,0,9,5,0
307493,3,35,13,22,17,1
73482,2,3,14,-11,17,0
159248,3,17,24,-7,3,0
292039,3,15,12,3,11,1
305952,1,0,0,0,17,0
393215,2,13,6,7,5,1
32586,4,27,13,14,15,0
166780,3,20,16,4,6,0
226978,1,3,3,0,16,1
29994,2,17,0,17,14,1
367378,2,7,14,-7,10,1
340730,1,0,0,0,15,0
374760,4,14,39,-25,14,1
273424,1,0,0,0,2,0
279975,2,3,10,-7,5,0
291492,4,21,20,1,10,1
211158,2,0,10,-10,9,0
173501,3,3,20,-17,10,1
209710,3,9,6,3,8,1
181530,1,3,0,3,13,1
392995,4,12,10,2,4,1
196871,4,10,20,-10,3,1
411889,2,14,0,14,13,0
149535,2,14,9,5,16,1
213383,3,10,20,-10,10,0
16722,1,0,0,0,8,1
152344,2,7,3,4,17,1
208927,3,14,6,8,8,0
402181,4,19,14,5,9,1
210032,3,10,10,0,8,1
399744,2,0,10,-10,8,0
219110,1,0,0,0,13,0
373906,4,43,16,27,13,0
385132,2,14,10,4,1,0
284852,4,29,30,-1,7,1
136067,1,0,0,0,10,0
96937,3,22,7,15,10,0
24158,1,0,0,0,12,1
176999,4,20,6,14,11,0
7883,2,3,14,-11,4,0
312775,1,0,0,0,3,0
232143,1,3,0,3,1,0
223667,2,13,6,7,15,1
351415,4,13,16,-3,3,1
396603,4,20,10,10,6,1
71315,3,10,20,-10,16,1
385081,1,0,0,0,1,0
192914,2,7,7,0,1,1
333200,2,0,7,-7,12,1
14401,1,0,0,0,7,0
263118,1,0,7,-7,15,0
329461,2,3,0,3,10,0
284169,3,6,20,-14,7,1
206233,2,0,3,-3,7,0
32786,1,0,0,0,15,0
64993,2,0,7,-7,13,0
29852,2,6,16,-10,14,1
303720,2,13,10,3,16,1
117822,3,9,6,3,2,1
332202,3,10,16,-6,12,0
179855,2,3,9,-6,13,1
204494,4,17,24,-7,6,0
196726,3,47,0,47,3,1
397265,1,0,14,-14,6,1
40623,3,31,7,24,2,1
81430,4,10,13,-3,3,0
120167,4,19,6,13,3,0
302632,2,17,3,14,15,0
73852,4,13,7,6,17,1
358993,2,10,0,10,6,1
209040,2,3,0,3,8,0
252746,1,0,3,-3,11,1
332161,2,0,10,-10,12,0
407806,4,17,7,10,11,1
211403,4,10,13,-3,9,1
383661,2,6,14,-8,17,1
352300,4,6,6,0,3,0
271156,3,7,10,-3,1,0
238760,1,7,0,7,4,0
34369,1,0,0,0,16,1
263832,4,7,24,-17,15,0
285404,2,24,0,24,8,0
43178,2,7,7,0,3,0
269534,3,13,24,-11,1,0
236143,2,0,10,-10,3,1
80555,4,8,10,-2,3,0
59579,1,0,3,-3,11,1
118377,2,6,7,-1,2,0
384684,2,10,17,-7,1,0
281037,3,17,13,4,6,0
81705,2,14,17,-3,3,1
215213,3,10,16,-6,11,0
401728,3,17,14,3,8,0
232367,3,13,15,-2,1,1
96997,1,7,0,7,10,0
276846,4,26,20,6,4,0
125634,3,14,24,-10,5,0
400228,2,10,6,4,8,1
226052,1,0,0,0,16,0
144189,1,0,7,-7,14,0
19489,4,24,17,7,10,1
40070,4,20,14,6,1,0
257625,1,0,7,-7,13,1
339017,4,20,3,17,15,1
356704,3,19,16,3,5,1
324605,4,16,9,7,8,1
239834,2,7,0,7,4,0
233059,1,0,0,0,2,1
139549,2,6,0,6,12,0
235116,2,0,10,-10,2,0
331389,1,3,0,3,11,0
287967,3,17,13,4,9,1
16029,1,13,0,13,8,0
103244,3,3,10,-7,13,0
57930,3,13,17,-4,10,0
286883,2,9,7,2,8,1
59986,4,3,24,-21,11,0
123606,1,0,0,0,4,0
156264,1,0,0,0,2,1
137682,1,0,13,-13,11,1
218606,3,7,23,-16,13,1
105250,3,7,24,-17,14,1
225049,2,0,14,-14,15,1
74103,3,16,6,10,17,1
280209,1,0,0,0,5,1
401908,4,25,28,-3,9,0
54848,4,23,0,23,8,0
24714,3,20,14,6,12,0
118563,3,17,3,14,2,1
95248,2,3,10,-7,10,0
351879,4,27,14,13,3,0
56949,4,43,7,36,9,1
88649,3,20,10,10,6,0
369801,4,52,50,2,11,1
414499,1,0,3,-3,14,1
309080,1,9,0,9,1,0
376531,2,6,6,0,14,0
405459,3,24,10,14,10,0
231191,3,10,7,3,1,1
359552,1,0,0,0,6,1
98072,1,0,0,0,11,0
87122,2,7,10,-3,5,1
168783,4,16,15,1,7,0
161964,4,13,23,-10,4,1
191061,2,7,0,7,17,0
307573,1,0,0,0,17,0
89140,4,23,6,17,6,1
112572,2,24,19,5,17,1
373642,1,0,9,-9,13,0
156836,3,23,23,0,2,1
156637,2,3,0,3,2,0
273524,4,21,21,0,2,0
248628,3,14,10,4,9,0
200714,2,7,0,7,4,0
363440,4,28,28,0,8,1
9970,4,3,3,0,5,0
18845,2,3,6,-3,9,1
418874,3,10,10,0,16,1
323030,2,7,7,0,7,1
206623,4,10,16,-6,7,1
270044,1,0,3,-3,1,1
409626,1,0,0,0,12,0
182296,2,14,0,14,14,0
333774,1,6,7,-1,12,1
13075,4,14,14,0,6,1
116621,3,13,3,10,2,0
328846,4,24,20,4,10,0
396729,3,7,14,-7,6,0
234987,3,13,10,3,2,0
220270,3,20,9,11,13,0
327058,1,0,0,0,9,1
279003,4,13,30,-17,5,0
119379,1,0,7,-7,3,1
88920,2,16,3,13,6,1
318459,3,31,7,24,5,0
301321,2,14,7,7,15,1
323189,2,7,0,7,7,0
99882,2,0,3,-3,12,1
128415,4,14,16,-2,7,1
360258,1,0,6,-6,7,1
101103,3,10,10,0,12,0
341125,4,14,24,-10,15,1
215680,4,14,6,8,11,1
109852,2,17,0,17,16,0
101665,1,3,0,3,12,0
355826,1,6,0,6,5,1
4176,1,7,3,4,2,0
203982,3,10,7,3,6,1
331362,4,8,33,-25,11,1
244518,2,25,13,12,7,0
78403,2,14,0,14,2,0
158000,1,0,3,-3,3,0
378792,4,14,10,4,15,1
155821,2,7,10,-3,2,1
177922,4,21,23,-2,12,0
160605,1,7,0,7,4,1
259641,4,9,6,3,13,0
152090,3,6,10,-4,17,1
307810,3,17,21,-4,1,1
323312,1,0,0,0,7,1
114217,3,3,7,-4,1,0
258803,1,7,7,0,13,1
210560,1,6,7,-1,9,0
386613,2,7,7,0,2,0
145854,1,0,0,0,15,1
238954,2,14,9,5,4,1
226049,1,0,0,0,16,1
338172,1,7,14,-7,14,1
144707,2,3,0,3,14,0
16405,4,21,16,5,8,1
350268,1,7,0,7,2,0
272365,2,21,0,21,2,1
103907,1,0,0,0,13,1
128971,3,28,3,25,7,0
99986,4,17,19,-2,12,1
9635,2,12,21,-9,5,0
98528,1,0,0,0,11,1
388954,4,17,27,-10,3,1
177175,4,40,20,20,11,1
195273,4,23,24,-1,2,0
142549,1,0,0,0,13,1
412830,3,21,35,-14,14,1
400286,4,24,9,15,8,0
8393,4,30,10,20,4,1
372093,1,3,0,3,13,1
293627,2,7,7,0,12,1
201048,3,34,0,34,5,1
217354,4,21,10,11,12,1
94296,2,3,0,3,9,0
406152,4,3,29,-26,11,1
91463,2,9,0,9,8,0
143713,4,19,17,2,14,0
357712,3,33,13,20,5,0
402095,2,3,0,3,9,1
367433,3,20,14,6,10,0
23645,3,7,13,-6,12,1
400801,2,14,13,1,8,1
85348,3,21,3,18,5,1
98461,3,17,14,3,11,0
279076,2,14,7,7,5,1
237997,2,10,10,0,4,0
92947,1,0,0,0,8,1
401899,4,23,28,-5,9,1
131197,1,0,3,-3,8,1
47527,3,30,6,24,5,0
243084,3,0,9,-9,6,1
201808,3,13,10,3,5,0
28442,4,13,6,7,14,0
311270,4,6,3,3,2,1
336620,4,7,0,7,14,0
45840,1,0,0,0,4,1
336611,4,7,0,7,14,0
185861,2,9,3,6,15,0
309412,2,0,0,0,1,0
113076,4,16,23,-7,17,1
294327,2,10,3,7,12,1
384900,4,13,29,-16,1,0
76912,2,7,13,-6,1,1
341203,2,13,7,6,16,0
7491,4,29,6,23,4,1
239347,4,3,17,-14,4,0
344508,2,0,0,0,17,0
239820,1,0,0,0,4,0
64624,4,20,17,3,13,1
19764,4,9,12,-3,10,1
105070,2,19,14,5,14,1
214787,4,10,20,-10,11,0
195295,4,23,24,-1,2,1
24724,4,20,14,6,12,0
270083,2,17,10,7,1,0
38349,2,7,6,1,1,0
2187,1,0,0,0,1,0
106368,4,21,19,2,14,0
119903,1,6,7,-1,3,0
83422,4,10,20,-10,4,0
232563,4,26,24,2,1,0
200464,3,20,18,2,4,1
404360,3,20,6,14,10,0
41191,3,0,7,-7,2,0
366491,1,7,0,7,10,0
418304,3,6,14,-8,16,0
309797,1,0,0,0,1,1
281248,4,27,19,8,6,1
34147,3,10,3,7,16,1
82829,4,12,16,-4,3,1
340577,1,0,0,0,15,1
212566,1,7,3,4,10,0
93477,4,3,28,-25,9,0
19505,4,33,17,16,10,1
70086,1,0,0,0,15,1
143496,2,14,21,-7,14,0
267237,2,10,14,-4,17,0
379928,3,21,6,15,16,1
151225,3,17,23,-6,17,1
345928,4,20,23,-3,17,0
62122,2,7,7,0,12,1
383133,3,23,14,9,17,0
173081,4,24,19,5,9,0
231202,4,10,7,3,1,0
377750,4,39,7,32,15,0
78167,3,20,3,17,2,1
92374,1,7,0,7,8,1
15062,3,10,26,-16,7,0
356759,1,0,0,0,5,0
408960,3,31,18,13,12,0
235695,2,0,10,-10,3,1
224184,3,0,20,-20,15,0
327479,1,0,0,0,10,0
85565,4,17,22,-5,5,1
156590,1,0,0,0,2,1
73134,4,13,17,-4,16,0
69990,2,21,3,18,15,1
313030,3,17,0,17,3,1
390760,4,13,20,-7,3,1
117178,2,13,10,3,2,1
207551,2,14,0,14,7,1
177085,2,16,10,6,11,1
159386,2,7,13,-6,3,1
397362,4,10,24,-14,6,1
202178,4,13,14,-1,5,0
358532,1,10,3,7,6,0
264936,3,20,17,3,16,1
137337,1,3,0,3,11,0
46198,2,14,14,0,4,0
250781,2,3,0,3,10,0
208799,3,6,15,-9,8,0
412950,2,16,9,7,14,0
325721,1,0,7,-7,9,1
318966,1,0,3,-3,5,0
194396,1,0,0,0,2,1
151771,2,14,6,8,17,0
388451,2,0,13,-13,2,1
155750,4,20,23,-3,2,1
272438,4,31,17,14,2,1
290957,2,17,10,7,10,0
191384,2,0,24,-24,17,0
370976,1,0,0,0,12,1
418314,3,6,21,-15,16,1
4755,2,10,0,10,3,1
47663,2,3,17,-14,5,0
256261,2,6,10,-4,12,1
182466,2,7,0,7,14,1
223932,4,30,12,18,15,0
184294,4,34,14,20,14,1
256620,3,21,6,15,12,0
97549,3,30,7,23,10,0
258938,1,0,7,-7,13,0
153487,1,0,0,0,1,0
323039,2,14,7,7,7,0
214721,2,3,7,-4,11,1
302672,3,17,13,4,15,0
417791,1,7,0,7,16,0
126754,4,13,13,0,6,0
272023,2,7,3,4,2,1
240223,4,16,12,4,5,1
24586,4,10,23,-13,12,0
101403,3,12,7,5,12,1
199193,1,7,7,0,4,1
407783,4,10,7,3,11,0
390574,3,17,21,-4,3,1
192018,3,17,20,-3,1,1
180059,4,28,20,8,13,1
368394,2,14,7,7,11,1
246692,4,38,3,35,8,0
142847,4,12,20,-8,13,1
9612,2,6,14,-8,5,1
208214,4,3,10,-7,8,0
358312,3,0,20,-20,6,0
184024,4,29,10,19,14,0
346378,3,9,13,-4,1,0
372836,4,6,0,6,13,1
84402,1,3,0,3,4,1
64719,3,21,0,21,13,0
235261,3,15,6,9,3,1
199535,2,20,3,17,4,0
337260,4,16,26,-10,14,0
348876,3,6,14,-8,2,1
110340,3,17,17,0,16,0
278134,2,7,7,0,4,0
187269,3,10,6,4,16,0
368596,4,16,6,10,11,1
304211,3,19,7,12,16,1
180894,1,7,0,7,13,0
396933,4,34,33,1,6,1
50298,3,13,16,-3,6,1
301127,1,7,0,7,15,1
171424,1,0,0,0,9,1
43362,3,14,14,0,3,1
412374,4,33,17,16,13,1
261697,2,14,0,14,14,0
167628,1,7,13,-6,7,1
141372,3,10,17,-7,13,0
111050,2,10,0,10,16,0
415980,1,6,0,6,15,1
399873,1,0,0,0,8,0
416615,2,20,7,13,15,1
2343,1,0,3,-3,2,1
309881,4,24,7,17,1,1
147743,4,17,24,-7,15,1
317881,4,15,10,5,5,0
262403,2,7,7,0,15,1
109580,3,16,14,2,16,1
293989,4,7,28,-21,12,0
15107,4,10,26,-16,7,1
347138,3,16,10,6,1,1
226915,3,3,10,-7,16,0
228826,3,6,17,-11,17,0
154702,1,0,0,0,1,1
302777,2,3,13,-10,15,0
96989,1,0,0,0,10,0
54144,1,0,0,0,8,0
117106,4,7,24,-17,2,0
306212,4,20,3,17,17,0
225152,1,0,0,0,15,1
22923,4,3,23,-20,11,1
39489,4,13,19,-6,1,1
149050,1,0,7,-7,16,0
26090,1,0,10,-10,13,0
408782,3,10,19,-9,12,0
259582,2,0,0,0,13,0
225511,3,0,21,-21,15,0
274458,4,10,17,-7,3,0
175118,2,21,10,11,10,1
52869,4,14,58,-44,7,1
307096,4,24,6,18,17,0
150680,1,0,3,-3,17,0
308057,1,0,7,-7,1,0
93300,2,21,3,18,9,0
418151,3,21,3,18,16,1
208579,1,3,0,3,8,1
407318,4,23,19,4,11,0
86825,2,9,12,-3,5,0
215963,4,20,28,-8,11,0
303401,1,10,0,10,16,0
114452,1,0,7,-7,1,1
394311,2,10,10,0,5,1
323700,4,20,0,20,8,0
338467,1,7,0,7,14,1
131455,4,20,22,-2,8,1
299785,4,17,17,0,14,0
103028,1,0,0,0,13,0
295122,3,7,14,-7,12,0
325973,4,22,7,15,9,1
195061,2,7,23,-16,2,1
232389,4,13,22,-9,1,1
347698,4,27,24,3,1,0
70112,1,10,0,10,15,0
95059,1,0,0,0,9,0
306135,2,0,0,0,17,0
399501,3,0,24,-24,7,0
371950,1,0,0,0,13,1
266691,4,39,10,29,16,0
285442,3,27,8,19,8,1
262573,2,13,0,13,15,0
305884,3,7,14,-7,17,1
28815,2,10,0,10,14,0
356974,3,17,3,14,5,1
181306,4,3,20,-17,13,0
170403,2,14,3,11,8,1
350719,2,7,0,7,2,1
226857,2,0,7,-7,16,0
228746,4,26,33,-7,17,0
410367,1,0,7,-7,13,1
377491,1,0,0,0,15,0
39926,4,9,10,-1,1,0
43458,1,0,0,0,3,0
115361,1,0,0,0,1,1
50182,4,6,24,-18,6,0
35968,4,3,7,-4,17,0
152670,3,17,6,11,17,1
331743,3,10,20,-10,12,0
170774,4,27,6,21,8,0
317028,2,0,10,-10,4,0
408104,1,0,0,0,12,0
142158,3,2,7,-5,13,0
364272,3,0,26,-26,9,1
95031,4,20,16,4,9,1
59221,3,21,45,-24,10,0
117615,2,6,10,-4,2,1
309998,3,6,10,-4,2,1
251943,1,0,7,-7,10,1
256345,1,0,0,0,12,1
326911,1,2,0,2,9,1
413272,3,17,0,17,14,1
55009,4,20,10,10,8,1
142157,3,2,7,-5,13,0
412820,3,21,27,-6,14,1
346603,1,7,0,7,1,1
172691,2,14,3,11,9,1
282111,3,16,8,8,6,0
165664,2,6,7,-1,6,1
320314,4,14,24,-10,6,1
293407,3,16,10,6,11,1
222584,1,0,0,0,14,1
4461,1,7,9,-2,2,0
48544,2,11,7,4,5,0
234880,4,3,18,-15,2,0
111895,1,0,0,0,17,0
346105,4,10,12,-2,1,0
271872,2,7,10,-3,2,0
190631,2,14,7,7,17,1
25589,3,27,10,17,12,1
243705,2,14,3,11,6,0
218979,1,7,0,7,13,1
202108,2,13,3,10,5,1
392861,4,17,20,-3,4,0
73255,4,7,16,-9,16,1
159582,3,20,6,14,3,0
225619,2,0,7,-7,16,0
281883,4,16,16,0,6,0
199551,3,20,10,10,4,0
166912,3,13,6,7,6,0
115063,1,3,0,3,1,0
361113,4,23,16,7,7,0
85506,3,14,9,5,5,0
309887,4,24,13,11,1,0
281072,4,37,16,21,6,1
169676,3,20,17,3,8,1
313913,3,28,26,2,3,0
382911,2,0,7,-7,17,0
16541,4,30,13,17,8,1
272290,4,12,10,2,2,1
366213,1,0,0,0,10,0
192782,2,0,15,-15,1,0
193732,3,3,27,-24,1,1
126018,1,0,0,0,6,0
9693,4,18,28,-10,5,1
389938,2,25,10,15,3,0
317091,4,17,17,0,4,1
117088,3,7,24,-17,2,0
176527,3,12,17,-5,11,1
339245,2,20,0,20,15,1
191389,2,0,31,-31,17,1
307588,1,0,0,0,17,1
253969,1,0,0,0,11,0
341105,4,14,17,-3,15,1
48150,3,10,13,-3,5,1
118731,4,20,12,8,2,1
325548,1,0,0,0,9,1
376980,3,15,16,-1,15,0
91795,2,10,0,10,8,1
254430,2,20,0,20,11,1
287590,1,0,3,-3,9,0
336132,2,10,3,7,13,0
57895,2,10,3,7,10,0
354640,2,10,7,3,4,1
54221,3,0,3,-3,8,0
409515,2,7,0,7,12,0
162334,2,3,7,-4,4,0
332532,1,0,0,0,12,0
345168,4,15,9,6,17,0
159101,3,24,0,24,3,0
156851,4,23,23,0,2,0
23006,2,0,14,-14,11,1
387795,1,3,0,3,2,0
414619,4,28,12,16,14,0
345571,3,14,20,-6,17,0
284250,4,16,33,-17,7,0
262104,2,14,3,11,15,0
330061,2,0,3,-3,11,0
342872,2,16,7,9,16,1
263265,1,0,0,0,15,1
249416,4,18,15,3,9,0
291937,4,24,17,7,11,1
336900,3,7,14,-7,14,0
326185,2,7,24,-17,9,1
394524,4,10,25,-15,5,0
53704,2,7,0,7,8,0
403843,1,0,0,0,10,1
269462,1,3,3,0,1,0
386283,4,14,20,-6,2,1
187243,3,7,6,1,16,0
94584,4,20,17,3,9,0
250561,4,19,22,-3,9,1
341652,2,10,3,7,16,0
384022,3,13,23,-10,1,0
386000,1,0,0,0,1,1
161377,1,0,0,0,4,0
309083,1,9,0,9,1,0
278751,1,0,0,0,5,0
384246,1,6,0,6,1,1
361285,4,21,32,-11,7,1
322194,2,0,20,-20,7,0
203046,3,20,9,11,5,0
354173,2,3,7,-4,4,1
163324,4,13,23,-10,5,1
283913,3,31,17,14,7,0
255470,1,7,0,7,12,1
259424,1,6,3,3,13,0
93974,1,0,7,-7,9,0
315477,1,0,0,0,4,0
260754,1,3,3,0,14,0
214466,3,7,17,-10,11,0
124014,4,13,14,-1,5,1
43115,4,6,24,-18,3,0
318283,2,3,7,-4,5,1
267601,4,30,34,-4,17,0
325009,2,20,21,-1,8,0
184728,1,0,0,0,15,1
12119,3,7,7,0,6,0
106585,2,31,0,31,14,0
331430,2,6,7,-1,11,1
89154,1,0,0,0,7,1
350610,3,10,0,10,2,1
49245,4,17,10,7,6,0
27114,1,0,0,0,13,0
299112,2,3,10,-7,14,1
42577,4,10,31,-21,3,1
122928,4,37,6,31,4,0
221280,3,0,29,-29,14,1
53482,1,0,0,0,8,1
259847,1,7,7,0,14,1
37106,3,13,17,-4,17,1
26610,3,10,6,4,13,1
23782,2,10,0,10,12,1
336929,4,14,21,-7,14,0
24364,2,3,0,3,12,1
43511,2,7,3,4,3,0
8573,1,0,0,0,4,0
48237,2,0,10,-10,5,1
32596,4,27,13,14,15,0
82064,4,17,10,7,3,1
223021,1,0,0,0,14,1
29248,2,14,0,14,14,0
22138,2,10,6,4,11,0
199051,2,0,7,-7,4,0
5604,1,0,0,0,3,0
253107,3,21,7,14,11,0
14542,4,34,45,-11,7,1
403762,3,12,13,-1,9,0
399436,1,0,7,-7,7,0
132532,1,2,26,-24,9,0
393182,1,0,3,-3,5,0
113239,1,7,0,7,17,0
171945,3,14,7,7,9,0
225240,4,16,7,9,15,1
18141,3,13,17,-4,9,0
379949,4,24,6,18,16,0
243629,4,23,14,9,6,0
241120,3,13,10,3,5,1
349304,3,21,28,-7,2,1
393760,4,7,14,-7,5,1
219524,3,9,21,-12,13,0
119228,1,7,3,4,3,0
116864,2,7,7,0,2,0
410971,1,0,7,-7,13,1
304056,2,3,20,-17,16,0
247704,2,7,6,1,8,0
67888,2,13,3,10,14,1
148322,3,14,3,11,16,0
55070,2,13,3,10,8,1
114180,2,0,0,0,1,1
391436,3,10,17,-7,4,1
40658,4,34,7,27,2,1
161558,2,6,10,-4,4,1
305599,4,20,10,10,17,1
301488,3,20,12,8,15,0
195039,2,7,17,-10,2,1
2963,2,7,10,-3,2,1
86989,3,14,6,8,5,1
261849,3,6,20,-14,14,0
305433,3,20,3,17,17,0
20043,3,19,9,10,10,1
304900,1,7,0,7,16,0
404874,1,0,0,0,10,0
380578,4,21,27,-6,16,1
253215,2,0,7,-7,11,0
365513,4,17,25,-8,9,1
346732,4,27,13,14,1,1
278376,4,17,21,-4,4,0
389253,4,31,7,24,3,0
234514,4,20,20,0,2,0
396754,4,7,20,-13,6,0
326049,2,9,0,9,9,0
255785,2,10,0,10,12,0
216679,2,21,6,15,12,0
230920,4,24,10,14,1,1
216333,2,7,13,-6,12,0
202777,4,16,17,-1,5,1
352705,3,17,3,14,3,0
16023,1,7,0,7,8,1
277200,2,0,10,-10,4,0
355544,2,14,0,14,5,0
309560,2,13,0,13,1,1
71870,2,9,6,3,16,1
301713,1,0,3,-3,15,0
74143,4,36,6,30,17,1
29732,3,20,3,17,14,1
59203,2,14,45,-31,10,1
101007,4,19,16,3,12,1
326836,3,10,14,-4,9,0
304086,3,6,20,-14,16,0
297765,1,7,0,7,13,0
213791,2,28,0,28,10,0
239316,4,3,17,-14,4,1
279846,3,14,13,1,5,1
132159,4,17,6,11,9,0
207568,2,14,3,11,7,1
76482,2,0,14,-14,1,0
296006,2,3,0,3,13,0
159273,3,17,24,-7,3,1
21533,2,7,7,0,11,1
398961,4,23,20,3,7,1
343989,3,16,6,10,17,1
347058,4,27,17,10,1,0
275363,4,10,22,-12,3,1
309274,2,0,10,-10,1,0
167588,4,3,17,-14,7,1
214083,1,3,0,3,11,0
321081,1,0,0,0,6,0
8345,3,16,3,13,4,1
182777,2,10,3,7,14,1
153221,1,2,0,2,1,0
1983,3,10,9,1,1,0
382451,4,0,24,-24,17,1
30531,1,0,0,0,14,0
37916,2,10,14,-4,1,0
258732,3,3,27,-24,13,1
47274,1,0,0,0,5,0
11907,1,0,0,0,6,1
66307,2,0,7,-7,14,0
279806,2,7,3,4,5,0
249900,3,12,20,-8,9,1
99769,2,0,7,-7,12,1
40985,1,3,7,-4,2,1
17011,4,34,26,8,8,0
35256,1,0,0,0,16,1
345951,4,27,23,4,17,0
369404,2,17,7,10,11,1
140630,3,31,10,21,12,0
357341,1,0,0,0,5,0
281806,2,10,0,10,6,1
51858,1,6,7,-1,7,1
41778,2,7,14,-7,2,1
246295,1,7,3,4,7,0
75581,2,7,3,4,17,1
88892,1,9,0,9,6,1
150662,4,17,22,-5,17,1
395276,4,10,16,-6,5,0
264725,2,7,13,-6,16,1
83751,4,25,23,2,4,0
335720,2,10,7,3,13,1
72245,4,24,17,7,16,1
373079,3,3,7,-4,13,0
321024,3,10,7,3,6,0
412171,2,13,3,10,13,1
106742,2,14,12,2,14,0
322370,3,14,13,1,7,0
20614,1,0,0,0,10,1
9728,1,0,7,-7,5,1
151600,2,0,10,-10,17,1
160393,4,11,35,-24,4,1
193430,3,20,20,0,1,1
233040,4,24,17,7,2,0
286039,1,3,0,3,8,0
190709,4,42,17,25,17,0
365974,1,19,7,12,10,1
264850,1,0,0,0,16,0
388341,3,17,12,5,2,0
205646,2,13,9,4,7,1
34059,1,0,0,0,16,0
78391,1,7,0,7,2,0
137959,1,0,0,0,11,0
236620,1,0,0,0,3,1
200307,3,27,14,13,4,0
372918,2,22,0,22,13,1
238765,1,7,0,7,4,1
193284,4,3,23,-20,1,0
89819,2,6,3,3,7,0
179190,1,7,0,7,12,0
73258,4,7,16,-9,16,1
416822,4,19,10,9,15,0
332975,1,0,0,0,12,0
360981,1,0,0,0,7,0
171915,2,7,7,0,9,1
206966,1,13,0,13,7,1
2347,1,0,3,-3,2,0
194861,1,0,7,-7,2,0
239932,1,0,0,0,5,1
151,5,10,10,0,1,1
342483,4,20,3,17,16,0
397183,3,6,0,6,6,0
289086,4,41,35,6,9,1
203100,4,42,17,25,5,1
140837,1,7,0,7,13,1
77385,3,7,14,-7,1,0
146481,1,7,0,7,15,1
231448,2,10,6,4,1,1
328071,4,17,17,0,10,0
98594,3,7,7,0,11,1
233583,2,17,27,-10,2,1
210728,2,14,0,14,9,0
281488,3,7,10,-3,6,1
71935,4,15,13,2,16,0
368016,3,17,21,-4,11,1
330181,1,0,0,0,11,1
344301,4,19,13,6,17,0
384414,2,14,0,14,1,1
375946,3,17,12,5,14,0
20638,2,0,7,-7,10,0
298473,1,6,0,6,14,1
115614,4,30,9,21,1,0
309907,4,24,21,3,1,0
120858,2,7,14,-7,3,1
138806,2,0,33,-33,12,1
230826,1,0,0,0,1,0
23323,2,6,10,-4,11,1
57053,3,7,20,-13,9,1
46803,4,14,33,-19,4,1
16374,3,21,10,11,8,1
217658,4,26,23,3,12,1
4713,1,0,0,0,3,0
54186,2,0,3,-3,8,1
353876,3,10,21,-11,4,0
180794,3,10,20,-10,13,1
172046,2,7,0,7,9,0
2499,1,3,0,3,2,0
10242,4,6,10,-4,5,1
304045,2,3,20,-17,16,1
294362,2,13,3,10,12,1
211351,3,10,10,0,9,1
330243,3,17,14,3,11,1
355930,4,34,17,17,5,1
35974,4,6,7,-1,17,0
25086,1,3,0,3,12,0
415431,2,12,0,12,15,0
339753,3,24,6,18,15,1
67504,3,39,14,25,14,0
62730,2,13,0,13,12,1
50520,1,0,0,0,6,0
382512,2,0,3,-3,17,0
308435,3,7,25,-18,1,1
371350,4,42,10,32,12,0
304343,2,10,7,3,16,1
398926,3,10,10,0,7,1
412785,2,14,17,-3,14,1
306293,2,17,0,17,17,0
233158,3,29,3,26,2,0
254859,1,0,0,0,12,0
396971,2,7,3,4,6,1
220278,3,20,9,11,13,1
142693,1,0,0,0,13,0
381520,2,14,0,14,17,0
400505,2,7,3,4,8,1
241926,4,23,20,3,5,0
145387,4,52,26,26,14,1
354272,4,23,24,-1,4,1
134912,2,7,16,-9,10,0
180712,1,0,0,0,13,0
73970,3,30,0,30,17,1
63025,3,16,21,-5,12,0
184199,1,7,0,7,14,1
223808,2,6,0,6,15,1
284015,2,3,0,3,7,0
386890,1,7,0,7,2,0
289899,2,6,3,3,10,1
70385,1,0,0,0,15,0
139872,4,23,17,6,12,1
64648,4,20,24,-4,13,0
221289,3,6,29,-23,14,0
66278,1,0,0,0,14,1
258658,1,0,0,0,13,1
409913,1,0,0,0,12,0
53084,2,19,7,12,7,0
302715,4,26,20,6,15,0
382975,3,9,13,-4,17,1
103704,4,3,17,-14,13,0
125568,1,7,7,0,5,0
235340,1,0,0,0,3,1
86090,2,28,0,28,5,1
336311,3,20,10,10,13,1
226791,4,13,20,-7,16,1
234262,4,20,24,-4,2,1
351766,1,10,14,-4,3,0
294790,2,7,14,-7,12,1
382148,4,27,3,24,17,1
44617,3,20,21,-1,3,0
253900,3,38,14,24,11,1
359077,4,10,13,-3,6,1
396163,4,24,23,1,6,0
127304,2,10,14,-4,6,0
178001,3,7,13,-6,12,1
156816,3,23,20,3,2,0
143616,2,10,3,7,14,0
174393,4,17,3,14,10,0
344483,1,0,0,0,17,0
354819,3,20,28,-8,4,1
384002,3,10,16,-6,1,0
54958,3,3,3,0,8,1
366051,4,51,14,37,10,0
284804,3,26,20,6,7,1
326031,2,9,0,9,9,0
178658,3,3,13,-10,12,0
226704,2,7,3,4,16,0
98248,2,7,17,-10,11,0
221249,2,0,16,-16,14,0
363180,4,24,10,14,8,0
221693,1,10,0,10,14,0
128554,4,21,35,-14,7,1
192559,4,33,17,16,1,0
168732,3,10,6,4,7,0
125466,3,13,0,13,5,1
294006,1,0,0,0,12,1
209549,2,34,20,14,8,0
205969,3,6,10,-4,7,0
215134,1,6,0,6,11,1
388731,2,8,0,8,3,1
250926,2,3,6,-3,10,1
285668,5,27,27,0,8,1
55813,2,0,7,-7,9,0
9814,4,12,17,-5,5,0
289548,1,0,6,-6,10,1
356756,1,0,0,0,5,0
384503,4,28,6,22,1,0
303951,4,14,34,-20,16,0
209191,2,7,7,0,8,0
347853,4,16,8,8,1,1
145046,3,13,6,7,14,1
48140,3,10,6,4,5,0
322013,2,3,0,3,7,1
221021,4,21,20,1,14,0
210292,2,6,7,-1,9,0
5994,4,17,29,-12,3,1
329441,1,0,0,0,10,0
53741,4,7,3,4,8,1
161707,1,10,0,10,4,0
147493,1,0,0,0,15,1
10822,3,21,7,14,5,1
33205,2,7,0,7,16,1
76665,3,10,0,10,1,1
180826,4,17,20,-3,13,0
41467,2,5,7,-2,2,1
7935,4,3,20,-17,4,0
256260,2,6,10,-4,12,1
299303,3,26,7,19,14,0
61316,4,31,28,3,11,1
218213,4,30,3,27,12,1
369552,2,14,0,14,11,0
8323,2,9,3,6,4,1
73323,1,13,0,13,17,1
305406,3,20,3,17,17,1
223574,4,17,13,4,15,1
265006,1,0,0,0,16,1
155417,3,13,10,3,2,1
104269,2,17,0,17,13,0
270907,4,19,20,-1,1,1
306317,3,24,10,14,17,0
267845,3,26,14,12,17,0
182546,4,42,21,21,14,0
235911,4,10,14,-4,3,0
151992,4,37,34,3,17,1
4279,4,27,6,21,2,1
78445,3,17,0,17,2,1
280555,2,14,3,11,5,0
342989,1,0,0,0,16,1
104044,1,7,0,7,13,0
288155,4,19,14,5,9,1
114164,1,0,0,0,1,0
22545,1,3,0,3,11,0
48163,4,10,13,-3,5,1
403409,1,6,0,6,9,1
123035,3,7,13,-6,4,0
118342,1,0,0,0,2,1
194793,3,10,23,-13,2,1
117354,3,21,0,21,2,0
353589,3,31,0,31,4,1
88334,3,14,7,7,6,0
278362,3,17,14,3,4,0
107092,3,40,6,34,15,0
113841,1,0,0,0,17,0
63091,4,23,42,-19,12,0
92750,3,3,17,-14,8,1
128926,2,15,3,12,7,1
337829,4,30,6,24,14,0
21372,1,0,7,-7,11,1
332465,3,16,6,10,12,1
167142,1,6,0,6,7,1
39672,1,3,0,3,1,0
245164,4,17,25,-8,7,0
371927,4,34,17,17,12,0
4961,4,21,17,4,3,0
37541,3,10,10,0,17,1
413435,3,10,38,-28,14,0
338628,1,6,0,6,14,0
58794,4,18,29,-11,10,0
26342,4,19,21,-2,13,0
191963,2,0,13,-13,1,1
77482,1,0,7,-7,1,0
28877,4,23,10,13,14,1
62103,2,7,7,0,12,0
373259,4,13,16,-3,13,1
195389,3,17,3,14,2,0
47995,3,3,24,-21,5,1
368355,1,7,0,7,11,0
266791,3,3,14,-11,16,1
80673,3,17,19,-2,3,0
151917,3,20,10,10,17,0
173869,1,6,7,-1,10,1
282128,4,23,8,15,6,1
167742,4,26,23,3,7,0
166784,4,20,16,4,6,1
402116,2,12,0,12,9,0
323254,4,7,10,-3,7,0
161431,2,7,3,4,4,1
218576,2,7,17,-10,13,1
29524,1,0,7,-7,14,0
334144,3,16,7,9,13,1
157149,4,19,20,-1,2,0
245710,2,10,10,0,7,0
54025,2,3,0,3,8,0
322877,1,6,0,6,7,1
194816,4,10,26,-16,2,1
273128,2,7,0,7,2,0
182490,3,14,0,14,14,1
156564,1,0,0,0,2,0
229407,2,3,3,0,17,1
194236,1,0,0,0,2,0
307185,3,0,10,-10,17,0
148682,4,10,9,1,16,0
79080,4,19,21,-2,2,1
323515,3,17,10,7,7,1
167861,2,7,16,-9,7,1
78494,4,24,0,24,2,1
319260,1,0,3,-3,6,1
266773,2,0,14,-14,16,0
374784,1,0,0,0,14,1
195202,2,10,3,7,2,0
316182,4,30,32,-2,4,0
383696,3,9,24,-15,17,1
163276,2,12,6,6,5,1
114787,2,7,17,-10,1,1
124410,2,6,0,6,5,0
111591,4,35,21,14,16,1
133469,3,20,17,3,9,1
370671,4,24,14,10,12,0
219511,3,3,21,-18,13,1
28462,1,7,0,7,14,1
331046,4,45,16,29,11,0
43628,1,7,3,4,3,0
226646,4,10,13,-3,16,1
305657,1,3,7,-4,17,0
62620,3,9,17,-8,12,1
35591,2,7,0,7,17,0
199128,3,14,31,-17,4,0
132491,1,0,0,0,9,0
77810,2,7,14,-7,1,0
96380,4,9,37,-28,10,0
353216,1,6,7,-1,4,1
137610,4,34,34,0,11,1
309965,2,3,3,0,2,1
213846,3,45,7,38,10,1
177992,2,7,13,-6,12,1
238930,1,7,3,4,4,1
46624,3,3,0,3,4,1
55881,4,19,14,5,9,0
262142,3,21,3,18,15,0
377568,3,17,9,8,15,0
198974,4,16,23,-7,3,0
93650,4,23,13,10,9,1
262818,1,0,0,0,15,0
51036,3,0,17,-17,6,0
87835,2,10,7,3,6,1
288176,1,3,0,3,9,0
105071,2,19,14,5,14,1
112517,1,3,9,-6,17,1
96400,1,0,0,0,10,0
76085,4,13,23,-10,1,1
347664,3,17,17,0,1,0
6081,2,7,10,-3,3,1
99264,1,7,0,7,11,0
86817,2,6,6,0,5,1
317809,2,9,3,6,5,1
253664,1,0,0,0,11,1
156992,4,7,13,-6,2,0
44711,2,0,9,-9,3,0
170731,3,21,6,15,8,1
322241,4,0,27,-27,7,1
92771,4,12,17,-5,8,0
45563,2,0,13,-13,4,1
326984,3,2,10,-8,9,0
108702,3,34,13,21,15,0
268166,3,9,14,-5,17,0
50717,2,7,7,0,6,0
261511,2,9,0,9,14,1
421829,2,0,13,-13,17,1
102020,2,7,3,4,12,1
316942,3,30,18,12,4,0
392273,1,0,7,-7,4,1
327167,4,21,17,4,9,1
289920,3,6,3,3,10,0
200893,3,17,0,17,4,1
217465,3,9,3,6,12,1
210201,3,7,21,-14,9,1
235380,2,14,7,7,3,1
369136,2,13,7,6,11,1
365144,3,7,21,-14,9,0
69163,4,14,17,-3,15,1
163770,3,7,12,-5,5,1
131075,2,10,6,4,8,1
242246,4,30,21,9,6,1
25094,2,3,0,3,12,0
361551,4,13,10,3,7,1
52267,4,20,19,1,7,0
162228,3,20,20,0,4,0
145681,4,42,7,35,14,1
162626,2,3,10,-7,5,0
1048,2,7,9,-2,1,1
375545,4,33,14,19,14,1
236722,4,30,7,23,3,0
229110,2,16,7,9,17,0
331632,4,23,30,-7,11,1
59007,2,0,10,-10,10,1
179203,1,7,0,7,12,0
7556,2,7,0,7,4,0
75038,4,34,17,17,17,0
195278,4,23,24,-1,2,0
181833,2,20,7,13,13,1
79061,4,13,20,-7,2,0
191664,2,0,10,-10,17,0
67228,4,0,3,-3,14,1
400994,3,22,7,15,8,0
342300,4,20,3,17,16,1
311170,1,3,0,3,2,1
93279,2,14,3,11,9,0
279424,3,16,24,-8,5,0
245095,2,14,3,11,7,0
262121,2,14,3,11,15,1
136967,4,17,13,4,11,1
338995,3,20,3,17,15,0
48864,2,6,0,6,5,1
12870,3,13,6,7,6,1
79856,1,3,6,-3,2,0
397791,4,24,14,10,7,0
382149,4,27,3,24,17,1
137230,2,7,10,-3,11,0
209246,3,20,7,13,8,1
181991,2,14,7,7,13,1
337753,2,13,0,13,14,0
140099,2,0,0,0,12,1
118725,4,20,9,11,2,0
227260,2,3,13,-10,16,0
291996,2,6,3,3,11,0
298338,1,0,6,-6,14,0
318409,2,21,7,14,5,1
64006,2,14,3,11,13,1
1224,2,10,6,4,1,1
402412,2,14,7,7,9,0
328434,2,3,0,3,10,1
142606,2,6,3,3,13,1
353478,4,31,12,19,4,0
271036,3,18,28,-10,1,1
128212,3,20,7,13,7,0
142252,1,0,0,0,13,1
10703,4,17,17,0,5,1
28869,3,23,7,16,14,0
63823,4,14,34,-20,12,0
85351,3,21,3,18,5,1
176910,1,0,0,0,11,0
349825,1,0,0,0,2,1
381015,1,0,0,0,16,0
805,3,7,6,1,1,0
226354,4,25,7,18,16,0
34485,4,41,3,38,16,1
243448,3,3,17,-14,6,0
289068,4,41,28,13,9,0
303511,4,37,17,20,16,1
262151,3,21,6,15,15,1
114357,2,24,13,11,1,0
240053,4,17,20,-3,5,0
322606,2,3,6,-3,7,1
351751,1,7,7,0,3,0
83497,1,0,7,-7,4,1
369927,4,16,22,-6,12,1
79312,3,15,3,12,2,0
169731,1,0,0,0,8,0
136163,3,10,10,0,10,1
53781,5,10,10,0,8,1
62511,5,16,16,0,12,0
69355,1,0,0,0,15,1
127755,2,7,14,-7,6,0
298557,3,13,0,13,14,0
402472,4,24,15,9,9,0
298453,4,13,27,-14,14,1
313368,1,0,0,0,3,1
154247,1,0,7,-7,1,1
165308,4,17,30,-13,6,0
178051,4,13,23,-10,12,1
130994,4,10,30,-20,8,1
215250,4,10,16,-6,11,1
398474,2,7,6,1,7,1
267482,1,0,7,-7,17,1
234345,3,17,0,17,2,0
3733,2,10,3,7,2,1
392937,2,6,3,3,4,0
247587,3,16,16,0,8,1
270893,4,19,13,6,1,1
95716,3,13,9,4,10,1
44100,2,0,13,-13,3,0
330282,4,24,21,3,11,0
19034,3,7,6,1,10,0
15624,2,14,10,4,8,1
116102,1,0,0,0,1,1
366935,1,0,7,-7,10,0
76855,4,33,7,26,1,1
255650,2,3,7,-4,12,0
324014,4,20,22,-2,8,0
26074,1,0,3,-3,13,0
308713,2,7,13,-6,1,1
207661,4,42,16,26,7,0
64565,2,7,7,0,13,1
4477,2,14,12,2,2,0
154795,4,21,23,-2,1,0
106529,1,7,0,7,14,0
253643,1,0,0,0,11,1
163151,3,16,25,-9,5,1
29932,1,0,0,0,14,0
382141,4,27,3,24,17,0
63280,2,0,0,0,12,1
293810,3,17,6,11,12,1
121553,3,16,10,6,4,1
129940,4,13,0,13,7,0
371535,1,0,0,0,12,1
260045,2,3,7,-4,14,0
27046,3,10,3,7,13,0
102414,1,3,0,3,13,0
41255,4,10,13,-3,2,1
23173,2,23,0,23,11,0
354056,2,13,0,13,4,0
35939,3,3,0,3,17,0
79621,3,14,14,0,2,0
411953,3,17,10,7,13,1
135028,1,14,0,14,10,0
169589,1,0,0,0,8,1
86653,1,7,0,7,5,0
83338,1,0,7,-7,4,0
58711,2,10,16,-6,10,0
364874,3,6,20,-14,9,1
51470,3,27,24,3,7,0
105964,2,10,0,10,14,1
119664,4,17,12,5,3,0
173364,4,31,27,4,10,0
111247,3,10,10,0,16,1
287838,3,28,17,11,9,0
122387,1,0,17,-17,4,1
116725,2,13,17,-4,2,0
133997,1,0,0,0,9,1
174886,4,26,23,3,10,0
240234,4,16,18,-2,5,1
102318,3,13,10,3,13,1
76697,4,16,7,9,1,0
202904,3,28,0,28,5,1
219257,4,22,10,12,13,0
247522,1,6,3,3,8,0
58624,4,13,17,-4,10,1
288465,4,19,14,5,9,1
197625,4,26,0,26,3,0
84646,4,23,16,7,4,1
3229,1,0,0,0,2,0
87839,2,10,7,3,6,0
141736,4,33,21,12,13,0
417802,1,7,0,7,16,0
127370,4,10,23,-13,6,0
124559,2,6,7,-1,5,1
222445,1,3,7,-4,14,0
127669,4,30,20,10,6,1
365945,4,14,28,-14,9,1
69461,4,24,10,14,15,0
157577,2,5,0,5,2,1
69383,1,7,0,7,15,0
169207,3,10,6,4,7,0
214068,1,0,0,0,11,1
276186,2,24,3,21,3,0
325283,2,3,3,0,8,1
204799,4,28,24,4,6,0
417574,1,0,0,0,16,1
152480,2,10,7,3,17,1
81918,4,7,30,-23,3,1
379627,3,26,13,13,16,0
131784,1,0,0,0,8,0
237448,1,0,0,0,3,0
366662,1,14,3,11,10,1
339799,4,24,13,11,15,0
328444,2,3,0,3,10,0
48191,4,10,19,-9,5,1
262652,4,26,10,16,15,1
80980,3,20,10,10,3,0
63031,3,16,21,-5,12,1
307011,2,10,0,10,17,1
153174,4,20,17,3,1,0
112392,2,10,13,-3,17,0
410414,2,6,10,-4,13,0
321014,3,10,7,3,6,1
126624,5,23,23,0,6,0
167556,4,3,10,-7,7,0
51366,4,19,20,-1,7,1
88539,4,26,14,12,6,0
105956,2,10,0,10,14,1
88770,2,13,3,10,6,0
343639,2,15,7,8,17,0
153665,1,2,7,-5,1,0
331559,2,7,20,-13,11,1
67196,3,0,3,-3,14,1
116888,2,7,7,0,2,0
114902,4,31,40,-9,1,0
235819,1,0,7,-7,3,1
4394,3,7,14,-7,2,0
14068,4,3,24,-21,7,0
212659,4,7,31,-24,10,1
17103,3,23,3,20,9,0
328878,1,3,0,3,10,1
291667,1,0,0,0,11,0
128417,4,14,16,-2,7,1
349641,4,13,31,-18,2,1
163078,1,0,12,-12,5,0
321072,4,16,17,-1,6,0
223994,2,7,6,1,15,1
224270,2,6,9,-3,15,0
24831,3,13,3,10,12,1
281399,1,0,0,0,6,0
411680,4,37,28,9,13,0
374064,4,24,10,14,13,1
143963,3,7,10,-3,14,0
90502,4,0,26,-26,7,1
276603,2,7,3,4,4,0
220634,1,0,0,0,13,0
412794,2,14,24,-10,14,1
118347,1,0,0,0,2,1
334359,2,0,3,-3,13,1
37741,1,7,0,7,1,1
27003,2,10,0,10,13,1
155307,1,0,0,0,2,1
410811,1,0,0,0,13,1
45622,3,10,13,-3,4,1
221666,1,0,0,0,14,1
217830,1,3,7,-4,12,1
230209,4,3,32,-29,17,1
150798,4,20,9,11,17,0
95592,4,12,10,2,10,1
32407,3,31,6,25,15,1
232823,3,16,17,-1,2,1
219067,3,31,13,18,13,1
264560,2,10,17,-7,16,1
298354,2,0,7,-7,14,0
54417,4,33,25,8,8,0
64353,4,19,27,-8,13,1
199555,3,20,10,10,4,1
235085,2,0,7,-7,2,0
406107,3,0,26,-26,11,1
291867,2,7,7,0,11,0
297906,1,10,0,10,13,0
135235,3,13,3,10,10,1
141997,3,10,14,-4,13,1
174749,1,6,0,6,10,0
131427,4,7,19,-12,8,1
418103,1,14,0,14,16,0
161237,2,7,3,4,4,1
241742,4,7,9,-2,5,0
49482,1,0,3,-3,6,1
158943,2,14,12,2,3,0
41189,3,0,7,-7,2,0
389516,3,20,10,10,3,0
280452,3,27,24,3,5,0
328811,4,17,13,4,10,0
379402,1,0,0,0,16,0
138040,3,22,17,5,11,1
220143,3,26,13,13,13,1
302686,4,20,20,0,15,1
248836,4,37,29,8,9,1
299872,2,13,5,8,14,0
306061,3,17,13,4,17,1
267253,2,16,14,2,17,1
311532,4,17,13,4,2,0
403092,4,34,34,0,9,1
122366,1,0,0,0,4,0
48833,2,3,0,3,5,1
254711,1,3,0,3,11,0
350177,2,11,0,11,2,1
395251,3,10,13,-3,5,1
52471,1,3,0,3,7,1
48459,4,20,20,0,5,0
263592,2,7,7,0,15,0
121358,3,7,0,7,3,0
59248,4,27,58,-31,10,1
335448,3,13,9,4,13,1
18828,1,3,0,3,9,1
336009,3,13,18,-5,13,1
2113,3,10,13,-3,1,1
600,1,0,0,0,1,0
247676,1,7,3,4,8,0
383900,4,3,10,-7,1,1
99757,2,0,0,0,12,1
152441,1,7,0,7,17,0
173859,1,6,7,-1,10,0
234092,4,20,14,6,2,1
272348,2,14,0,14,2,1
127978,4,23,27,-4,6,1
41398,4,14,15,-1,2,0
399654,3,16,6,10,8,0
292156,2,21,0,21,11,0
70248,1,7,0,7,15,0
254632,4,28,14,14,11,0
135762,1,0,7,-7,10,1
184303,4,37,14,23,14,0
219114,1,0,0,0,13,1
182865,4,36,27,9,14,1
114330,2,14,6,8,1,0
213330,2,3,6,-3,10,0
210078,5,17,17,0,8,0
102581,1,2,6,-4,13,1
303487,4,25,10,15,16,1
348711,3,24,10,14,2,0
39596,3,27,6,21,1,0
283434,3,20,7,13,7,0
364832,2,3,14,-11,9,1
296194,3,16,26,-10,13,1
162158,1,7,0,7,4,1
22758,3,3,21,-18,11,0
89782,1,3,0,3,7,0
386963,3,7,21,-14,2,1
80811,3,3,0,3,3,1
315924,1,0,0,0,4,0
264014,4,30,14,16,15,1
352120,3,6,20,-14,3,1
166913,3,13,6,7,6,0
168920,4,23,6,17,7,1
294430,4,19,12,7,12,0
399194,2,10,13,-3,7,1
115526,2,0,3,-3,1,1
106413,2,13,0,13,14,0
357252,2,3,9,-6,5,0
109957,1,7,0,7,16,1
63848,1,3,7,-4,12,0
193729,3,3,27,-24,1,1
347726,1,0,0,0,1,1
396398,2,20,12,8,6,0
74867,4,20,20,0,17,1
223495,2,7,3,4,15,0
70309,3,10,17,-7,15,0
216754,4,27,9,18,12,1
35620,2,7,3,4,17,1
147619,4,15,0,15,15,0
205304,2,10,0,10,6,1
89875,4,23,13,10,7,1
38892,1,0,0,0,1,0
380451,4,10,24,-14,16,1
255444,1,0,0,0,12,1
301986,4,27,20,7,15,0
185690,2,7,3,4,15,1
342630,4,22,27,-5,16,1
281273,1,7,3,4,6,0
350093,4,30,20,10,2,0
369225,1,7,7,0,11,0
170254,2,0,9,-9,8,1
302498,3,3,10,-7,15,1
154425,2,14,0,14,1,0
308508,1,0,9,-9,1,0
241868,3,13,6,7,5,0
125142,2,14,7,7,5,0
348083,3,0,16,-16,1,0
161220,1,0,3,-3,4,1
50510,1,0,0,0,6,0
24917,1,0,7,-7,12,1
231646,3,14,13,1,1,0
172961,1,7,0,7,9,1
263033,3,10,3,7,15,1
370023,3,10,7,3,12,0
412768,2,14,10,4,14,1
107680,4,13,30,-17,15,0
229759,4,20,17,3,17,1
181354,1,14,0,14,13,0
363052,1,0,0,0,8,1
101924,4,6,13,-7,12,1
14376,4,9,20,-11,7,0
270460,4,10,7,3,1,1
381909,1,0,0,0,17,0
297133,4,31,6,25,13,1
307170,2,0,10,-10,17,0
5572,4,19,10,9,3,0
56338,4,3,33,-30,9,1
81326,1,0,0,0,3,0
280201,4,28,13,15,5,0
369879,3,7,9,-2,12,0
324319,4,25,7,18,8,1
334003,3,17,13,4,12,0
340332,2,17,7,10,15,0
39849,2,6,0,6,1,1
273550,4,28,35,-7,2,0
138324,3,20,0,20,11,0
280145,3,21,0,21,5,0
171453,2,7,3,4,9,1
172743,3,21,10,11,9,0
100,3,7,7,0,1,0
348314,1,7,0,7,1,1
84877,2,26,17,9,4,1
30881,2,3,14,-11,15,0
409774,1,7,0,7,12,0
371649,4,24,17,7,12,0
175267,3,15,7,8,10,0
151328,2,7,14,-7,17,0
105315,1,0,0,0,14,1
58566,3,10,10,0,10,1
40963,4,16,27,-11,2,0
13890,2,21,0,21,7,0
13395,1,0,7,-7,7,1
179722,2,0,10,-10,12,1
75534,1,7,0,7,17,1
272620,4,19,9,10,2,0
167614,1,7,0,7,7,0
143581,1,0,0,0,14,0
314636,3,7,7,0,3,0
17,1,0,0,0,1,0
304078,3,6,20,-14,16,0
223316,4,6,12,-6,15,1
140851,2,14,0,14,13,0
334716,3,18,3,15,13,0
372356,4,24,17,7,13,1
276510,3,16,7,9,4,1
208818,4,6,22,-16,8,1
10529,3,27,0,27,5,1
348591,4,28,17,11,2,0
201747,1,3,0,3,5,0
252661,3,6,3,3,10,0
43177,2,7,7,0,3,0
105775,1,0,0,0,14,1
102551,1,0,0,0,13,1
299218,1,3,0,3,14,0
183632,2,0,6,-6,14,0
144717,2,3,0,3,14,1
91714,1,0,0,0,8,1
182590,1,0,3,-3,14,0
38726,4,24,17,7,1,1
418333,4,9,21,-12,16,0
30616,3,17,0,17,14,0
402677,1,0,0,0,9,0
128393,4,14,13,1,7,0
266417,4,36,8,28,16,0
45533,1,0,0,0,4,1
112521,1,9,9,0,17,1
394432,2,7,10,-3,5,0
320067,1,3,0,3,6,0
15263,4,23,7,16,8,1
153500,1,0,0,0,1,0
407217,1,0,3,-3,11,0
76601,1,7,0,7,1,1
399814,4,11,24,-13,8,0
127563,1,0,3,-3,6,0
293664,3,10,7,3,12,0
40824,4,24,35,-11,2,1
361960,3,10,6,4,7,1
127196,4,13,16,-3,6,0
47739,4,6,17,-11,5,0
214760,3,3,13,-10,11,1
69653,1,0,0,0,15,0
206525,1,0,0,0,7,0
91410,1,0,0,0,8,1
264843,4,24,37,-13,16,0
210170,3,0,14,-14,9,1
52351,2,3,10,-7,7,0
385503,1,0,0,0,1,0
138034,3,22,17,5,11,1
131127,3,27,9,18,8,1
199700,3,21,7,14,4,1
273720,1,0,0,0,2,1
400604,1,0,0,0,8,0
105640,1,7,3,4,14,0
133554,1,0,0,0,9,0
394405,1,0,3,-3,5,1
178686,3,3,20,-17,12,0
83618,4,10,17,-7,4,0
370455,2,13,6,7,12,0
60995,3,34,16,18,11,1
121145,1,0,10,-10,3,0
40710,2,7,7,0,2,1
124626,4,13,17,-4,5,1
294343,2,10,3,7,12,0
94749,1,3,0,3,9,0
39189,1,0,0,0,1,0
92055,1,0,0,0,8,1
228919,1,7,9,-2,17,1
157407,2,9,7,2,2,0
336315,3,20,10,10,13,0
162504,2,14,10,4,4,1
248187,3,9,10,-1,8,1
195030,2,7,10,-3,2,0
312459,1,0,0,0,3,1
232,3,12,16,-4,1,0
279264,3,16,13,3,5,1
284698,4,17,34,-17,7,0
224396,1,0,0,0,15,1
417156,1,0,10,-10,16,1
383526,2,14,13,1,17,0
19839,2,10,7,3,10,0
140977,1,7,0,7,13,0
102940,3,12,24,-12,13,1
343918,1,7,0,7,17,0
94459,2,0,0,0,9,0
217171,3,9,16,-7,12,1
164804,4,26,21,5,6,0
20348,2,10,13,-3,10,0
213037,2,17,0,17,10,0
85984,3,14,16,-2,5,0
178494,2,16,3,13,12,0
69304,3,16,3,13,15,1
137080,2,14,3,11,11,0
258082,2,6,6,0,13,1
116339,4,40,13,27,1,0
207854,2,7,0,7,8,0
21336,4,14,17,-3,11,0
284782,3,26,17,9,7,0
273078,4,9,3,6,2,1
113856,1,7,0,7,17,0
354335,2,34,3,31,4,1
411384,4,20,13,7,13,1
393368,2,21,7,14,5,0
205087,4,22,20,2,6,0
243640,4,23,14,9,6,0
229413,3,3,3,0,17,0
199482,1,0,0,0,4,1
399552,4,0,33,-33,7,1
214046,4,43,14,29,10,0
220885,4,21,38,-17,14,1
82554,4,17,27,-10,3,0
51473,3,27,24,3,7,0
299602,4,13,10,3,14,0
25639,1,0,0,0,12,1
220622,4,16,29,-13,13,0
40391,1,0,0,0,2,1
137373,2,3,14,-11,11,1
403267,1,0,0,0,9,1
241362,2,7,6,1,5,0
336628,4,7,7,0,14,0
304825,3,3,3,0,16,0
192243,1,3,3,0,1,0
106204,4,0,10,-10,14,0
262391,1,0,7,-7,15,1
357948,2,7,6,1,6,1
402147,3,12,0,12,9,1
13762,3,0,20,-20,7,1
313502,4,17,17,0,3,1
418761,3,7,21,-14,16,1
138460,3,21,14,7,12,0
106687,1,0,0,0,14,0
296323,3,6,13,-7,13,0
219516,3,9,21,-12,13,0
351312,1,7,0,7,3,1
399084,3,10,26,-16,7,0
43374,3,14,14,0,3,0
32750,4,7,24,-17,15,1
281697,4,31,23,8,6,0
194880,2,0,10,-10,2,0
149348,1,3,0,3,16,0
350102,4,30,26,4,2,0
383628,1,0,7,-7,17,0
51494,4,34,24,10,7,0
307692,4,17,23,-6,17,0
52969,2,14,17,-3,7,0
247248,2,21,14,7,8,1
17775,1,7,3,4,9,0
347347,4,7,21,-14,1,1
18813,1,0,0,0,9,1
251085,2,10,14,-4,10,1
382483,1,0,0,0,17,1
405227,2,7,7,0,10,1
345436,3,0,19,-19,17,1
298743,4,22,27,-5,14,1
346265,4,40,3,37,1,0
407530,2,10,0,10,11,0
149910,4,6,23,-17,16,1
285640,4,27,24,3,8,1
5389,3,13,13,0,3,1
41082,4,3,16,-13,2,0
15969,3,12,14,-2,8,0
153350,1,0,0,0,1,1
344293,4,16,13,3,17,1
30724,3,17,21,-4,15,0
288521,2,3,20,-17,9,0
334863,3,24,3,21,13,0
21208,1,0,0,0,11,1
415147,2,3,21,-18,15,1
400603,1,0,0,0,8,0
409315,4,16,16,0,12,0
194464,3,9,0,9,2,0
224798,3,11,10,1,15,0
23704,4,12,33,-21,12,1
44228,1,10,10,0,3,0
273591,1,3,3,0,2,0
354177,2,3,7,-4,4,1
326256,4,10,48,-38,9,1
267006,4,19,17,2,17,1
354298,1,7,0,7,4,1
143155,1,0,0,0,13,0
54261,4,0,3,-3,8,0
372758,2,0,0,0,13,1
139231,2,3,6,-3,12,0
387125,3,10,31,-21,2,1
125833,4,17,23,-6,5,0
262280,2,9,9,0,15,1
165370,2,3,10,-7,6,0
32110,3,21,13,8,15,1
272458,4,31,24,7,2,1
82385,4,13,10,3,3,1
137901,3,24,8,16,11,0
352502,1,7,6,1,3,1
87475,4,20,17,3,6,1
23144,1,6,0,6,11,1
61382,2,7,3,4,11,1
273626,2,10,6,4,2,1
294641,2,0,0,0,12,0
379739,2,9,7,2,16,1
135554,3,14,6,8,10,0
103324,1,7,10,-3,13,1
251337,2,14,7,7,10,1
71089,4,27,3,24,16,0
149319,4,20,27,-7,16,1
90592,2,14,10,4,7,1
324365,1,7,0,7,8,1
305890,4,14,14,0,17,0
380990,4,9,14,-5,16,0
357403,2,17,17,0,5,0
58612,4,10,17,-7,10,1
287343,2,13,3,10,8,1
277395,3,17,9,8,4,1
266374,3,30,0,30,16,0
351360,2,10,7,3,3,1
170502,4,21,16,5,8,0
129542,2,3,14,-11,7,1
150554,2,3,3,0,17,0
31579,2,7,3,4,15,0
64455,2,14,13,1,13,0
159199,2,7,14,-7,3,1
333756,1,0,0,0,12,1
104711,1,0,6,-6,14,1
284071,4,13,10,3,7,1
241072,1,7,0,7,5,0
218828,1,0,3,-3,13,0
415858,2,7,20,-13,15,0
133659,4,17,35,-18,9,1
8225,3,3,10,-7,4,1
261206,2,21,0,21,14,0
420447,2,0,14,-14,17,1
332745,2,21,9,12,12,0
282622,1,3,7,-4,6,1
179018,4,19,3,16,12,1
280715,3,0,6,-6,5,1
7404,1,3,3,0,4,1
418584,2,14,3,11,16,1
134098,4,27,13,14,9,0
240514,4,6,7,-1,5,1
96022,3,13,7,6,10,0
74980,3,20,17,3,17,0
125271,1,3,0,3,5,1
274718,3,10,12,-2,3,0
257313,1,3,0,3,13,1
177045,1,3,0,3,11,0
361448,1,0,0,0,7,1
352336,1,6,0,6,3,1
76637,2,10,0,10,1,0
385557,2,0,10,-10,1,0
101156,4,19,27,-8,12,1
239297,3,3,7,-4,4,0
283225,1,10,0,10,7,0
157936,4,9,15,-6,3,0
312282,4,10,23,-13,2,1
355183,4,29,26,3,4,1
377467,4,14,13,1,15,0
401,3,31,17,14,1,1
406294,4,27,35,-8,11,1
420784,2,3,3,0,17,0
265286,4,16,6,10,16,1
73023,2,0,3,-3,16,1
175923,4,30,27,3,11,0
110879,1,7,0,7,16,1
89012,1,0,0,0,6,1
191273,4,7,17,-10,17,1
39929,4,9,10,-1,1,0
311273,4,6,3,3,2,1
298739,4,22,27,-5,14,1
248204,4,12,10,2,8,0
358316,4,0,26,-26,6,0
104227,1,3,0,3,13,0
100548,4,20,20,0,12,0
294511,2,17,10,7,12,1
8289,1,0,0,0,4,1
46963,4,26,36,-10,5,0
235840,2,0,14,-14,3,1
44878,3,7,17,-10,4,0
120954,1,2,0,2,3,1
344067,1,0,3,-3,17,1
305570,3,13,7,6,17,1
33305,4,23,3,20,16,1
285018,1,0,0,0,7,1
191042,1,0,0,0,17,0
359488,3,0,14,-14,6,0
343356,3,0,20,-20,16,1
313151,2,10,10,0,3,0
116689,1,6,3,3,2,0
207047,3,35,3,32,7,0
166168,3,27,19,8,6,1
418221,1,0,0,0,16,1
296988,4,29,14,15,13,0
260092,3,6,21,-15,14,1
192354,4,27,27,0,1,1
304251,4,33,14,19,16,0
72603,1,7,0,7,16,1
416341,3,16,3,13,15,1
96113,1,0,13,-13,10,1
83879,3,23,17,6,4,1
97141,4,34,6,28,10,0
154649,4,24,21,3,1,0
262084,1,7,0,7,15,0
208750,2,3,6,-3,8,0
77060,2,7,16,-9,1,0
238371,3,10,23,-13,4,1
87113,2,7,3,4,5,0
345957,4,27,23,4,17,0
16435,1,0,0,0,8,1
80114,4,24,22,2,2,0
320288,3,14,21,-7,6,1
31547,1,0,0,0,15,0
352241,2,3,3,0,3,0
311943,3,28,10,18,2,0
222671,3,14,24,-10,14,0
171398,5,19,20,-1,9,1
189889,1,0,7,-7,17,0
270196,1,3,6,-3,1,0
351218,3,28,10,18,3,0
284447,2,7,12,-5,7,1
235014,4,16,17,-1,2,1
256008,4,19,12,7,12,1
155653,1,3,3,0,2,0
230917,4,24,10,14,1,0
248396,1,10,0,10,8,0
59939,2,3,10,-7,11,0
273288,2,14,0,14,2,1
115285,3,14,12,2,1,1
62353,4,24,22,2,12,0
106734,2,14,12,2,14,0
317593,1,3,0,3,5,0
325674,4,31,7,24,9,0
71160,2,19,10,9,16,1
415552,2,0,0,0,15,0
4960,4,21,17,4,3,0
418656,4,28,31,-3,16,0
165350,1,0,7,-7,6,0
30911,3,3,24,-21,15,0
16300,4,25,29,-4,8,1
301118,1,7,0,7,15,0
5017,1,0,0,0,3,0
95784,1,3,3,0,10,1
13695,1,0,7,-7,7,1
379437,2,13,0,13,16,0
109722,2,10,0,10,16,0
88371,4,24,10,14,6,1
253102,3,21,7,14,11,1
124276,3,27,17,10,5,0
299832,1,3,0,3,14,1
170069,1,0,0,0,8,0
145523,4,26,17,9,14,1
285563,2,7,10,-3,8,1
146338,1,3,3,0,15,1
64741,3,21,0,21,13,1
149660,2,17,0,17,16,0
305930,5,21,21,0,17,0
225315,2,0,21,-21,15,1
348896,4,9,21,-12,2,1
346415,4,9,13,-4,1,0
398516,3,28,16,12,7,0
367171,3,29,23,6,10,1
31496,3,3,17,-14,15,1
398462,2,7,3,4,7,1
6262,3,13,14,-1,3,0
94249,4,24,30,-6,9,0
112686,1,3,0,3,17,0
418084,1,0,0,0,16,1
254843,1,0,0,0,12,0
378745,3,14,7,7,15,1
410567,2,10,7,3,13,1
295010,4,31,21,10,12,0
330375,2,7,20,-13,11,1
350503,4,10,19,-9,2,1
200042,4,24,20,4,4,1
303254,1,10,0,10,16,0
402435,3,21,12,9,9,1
57231,4,20,14,6,10,1
198505,4,17,5,12,3,0
322183,2,0,20,-20,7,1
177552,2,7,0,7,11,1
399354,3,27,7,20,7,1
157192,1,7,0,7,2,0
201488,3,19,7,12,5,1
9476,3,10,3,7,5,0
239583,3,20,10,10,4,0
239953,1,0,3,-3,5,1
280153,3,28,0,28,5,0
360524,1,0,7,-7,7,1
122952,1,0,0,0,4,0
210554,1,0,7,-7,9,1
355866,2,13,10,3,5,1
411900,2,14,3,11,13,1
242978,4,34,31,3,6,0
127944,3,23,7,16,6,1
102133,1,7,0,7,13,1
196560,3,17,6,11,2,0
303381,1,7,0,7,16,0
70115,1,10,0,10,15,1
343905,1,7,0,7,17,1
124408,2,6,0,6,5,0
38044,2,3,0,3,1,1
309653,1,0,3,-3,1,1
228505,3,20,7,13,17,0
142857,1,0,0,0,13,1
128865,4,27,23,4,7,0
374205,4,30,28,2,13,0
21795,5,31,31,0,11,1
46126,1,0,0,0,4,0
312051,2,7,7,0,2,1
372824,4,6,0,6,13,1
154525,1,0,0,0,1,1
163043,4,22,3,19,5,0
252972,3,9,10,-1,11,0
204366,1,0,3,-3,6,0
231149,2,3,0,3,1,1
9713,1,0,7,-7,5,1
421019,4,14,35,-21,17,1
267351,1,0,7,-7,17,0
73437,4,30,9,21,17,0
176825,3,10,10,0,11,0
279534,2,10,6,4,5,0
294478,2,7,10,-3,12,1
127168,3,10,9,1,6,1
284207,4,9,23,-14,7,0
113602,3,6,3,3,17,0
62877,3,10,3,7,12,0
209036,2,3,0,3,8,0
393438,4,28,24,4,5,1
360586,2,7,10,-3,7,1
227257,2,3,10,-7,16,0
237563,4,38,14,24,3,0
72890,1,0,7,-7,16,1
194744,2,0,10,-10,2,1
339240,2,14,0,14,15,1
18617,3,17,17,0,9,1
153522,1,2,7,-5,1,1
146395,3,10,3,7,15,1
285073,2,0,0,0,7,1
233531,1,0,7,-7,2,1
59274,1,0,0,0,11,1
9150,2,0,13,-13,5,1
81778,4,34,24,10,3,0
375392,4,14,24,-10,14,0
205235,4,23,13,10,6,1
130769,2,7,3,4,8,0
144194,1,0,7,-7,14,0
80431,1,0,0,0,3,1
294756,1,0,7,-7,12,1
168207,4,29,15,14,7,1
329955,3,7,10,-3,11,0
198549,5,20,20,0,3,1
335502,1,0,0,0,13,0
135386,3,21,17,4,10,1
45047,3,23,10,13,4,0
34652,4,31,10,21,16,1
134363,3,23,21,2,10,0
263737,2,0,0,0,15,1
318379,1,7,0,7,5,0
55996,3,10,20,-10,9,0
1879,4,22,10,12,1,0
183780,2,10,14,-4,14,1
200390,1,3,6,-3,4,0
378548,2,7,6,1,15,1
28846,3,16,7,9,14,1
186892,2,7,0,7,15,0
351292,1,0,0,0,3,0
76010,2,7,13,-6,1,1
277160,4,17,27,-10,4,0
364873,3,6,20,-14,9,1
153078,2,0,10,-10,1,1
158811,3,17,3,14,3,1
313711,2,13,3,10,3,1
248726,2,10,7,3,9,0
413909,4,17,9,8,14,1
366649,1,7,3,4,10,1
230108,2,0,10,-10,17,1
35427,1,6,0,6,17,1
131926,1,0,0,0,8,0
362407,4,30,20,10,8,0
55738,4,23,29,-6,9,1
284379,4,21,17,4,7,0
227530,4,26,17,9,16,0
208500,3,44,7,37,8,0
70521,4,39,23,16,15,0
205257,4,23,20,3,6,1
376745,4,20,0,20,14,0
235080,2,0,7,-7,2,0
377362,1,0,0,0,15,1
13489,4,6,27,-21,7,1
252384,4,6,29,-23,10,1
150637,4,10,22,-12,17,0
321082,1,0,0,0,6,0
94168,2,10,7,3,9,1
340899,2,0,10,-10,15,1
11627,1,14,0,14,6,1
258535,1,0,0,0,13,1
219439,1,0,0,0,13,0
43225,3,14,10,4,3,1
284549,1,0,0,0,7,1
219946,2,6,7,-1,13,0
250685,4,10,22,-12,10,0
389819,3,24,6,18,3,0
317547,4,10,27,-17,5,1
270331,4,27,27,0,1,0
251344,2,14,13,1,10,0
246471,2,9,0,9,8,1
43635,2,7,3,4,3,0
107350,3,16,6,10,15,0
218289,2,7,14,-7,12,1
105612,4,32,28,4,14,0
255144,1,0,0,0,12,1
294278,4,28,21,7,12,1
353171,4,20,29,-9,3,1
117585,1,0,0,0,2,0
314307,2,7,14,-7,3,1
71290,2,7,10,-3,16,0
65259,1,0,7,-7,13,0
118435,3,20,10,10,2,0
242132,2,13,7,6,6,1
301093,4,33,13,20,15,1
273664,3,16,13,3,2,1
15034,2,7,16,-9,7,0
49567,4,14,3,11,6,1
278353,3,17,14,3,4,0
208086,4,21,19,2,8,1
288279,4,10,35,-25,9,0
394321,3,24,10,14,5,0
399918,2,0,6,-6,8,1
193954,1,7,0,7,1,0
405679,1,0,0,0,10,1
374928,4,14,28,-14,14,1
28124,4,27,10,17,13,0
352161,4,15,20,-5,3,0
88532,4,19,14,5,6,1
321517,4,24,30,-6,7,1
9397,1,0,0,0,5,0
586,4,14,34,-20,1,1
110315,3,3,17,-14,16,1
153266,2,2,0,2,1,0
228486,2,10,7,3,17,1
274120,4,20,0,20,3,0
183451,4,27,6,21,14,0
259511,4,35,10,25,13,1
290555,4,20,20,0,10,1
109674,1,3,0,3,16,0
376405,4,9,6,3,14,0
382248,2,17,3,14,17,0
95861,4,13,17,-4,10,0
163352,4,22,26,-4,5,1
256158,4,24,22,2,12,1
78637,4,30,13,17,2,0
71342,3,10,20,-10,16,0
273485,3,7,13,-6,2,1
392576,4,10,27,-17,4,1
87909,3,13,15,-2,6,1
253683,2,3,0,3,11,0
282019,4,28,28,0,6,1
65277,2,3,14,-11,13,0
280864,3,13,3,10,6,0
159130,4,31,7,24,3,0
74545,3,0,3,-3,17,0
360013,2,3,26,-23,7,1
8263,4,16,13,3,4,1
296364,4,13,25,-12,13,0
216361,3,14,13,1,12,0
417257,4,20,20,0,16,0
149538,2,14,9,5,16,1
54713,4,34,36,-2,8,1
53378,2,3,14,-11,8,1
189942,3,6,7,-1,17,1
344157,4,27,11,16,17,1
63934,4,6,24,-18,12,0
374550,2,17,13,4,14,0
242472,3,3,10,-7,6,1
77997,3,3,16,-13,1,0
378069,4,0,17,-17,15,1
308856,3,10,10,0,1,0
21132,3,0,0,0,10,1
292311,2,12,10,2,11,0
299968,1,0,7,-7,14,0
43701,4,14,17,-3,3,1
254324,3,13,19,-6,11,0
35985,4,6,21,-15,17,1
80939,2,13,0,13,3,0
174507,2,7,7,0,10,1
227868,2,7,6,1,16,1
162086,3,35,13,22,4,0
105803,1,6,3,3,14,0
99568,1,0,0,0,11,1
2979,2,10,10,0,2,0
340420,4,24,13,11,15,0
57241,4,20,14,6,10,0
290810,2,10,7,3,10,1
263291,2,10,0,10,15,0
280857,3,10,3,7,6,0
47592,4,49,6,43,5,0
23110,4,20,17,3,11,0
67099,4,10,17,-7,14,1
47351,3,3,10,-7,5,0
65098,1,0,0,0,13,0
9270,1,7,0,7,5,1
385325,4,14,20,-6,1,0
169819,3,10,17,-7,8,0
156742,1,7,7,0,2,0
105417,3,23,17,6,14,0
110171,3,20,23,-3,16,1
397765,4,15,14,1,7,1
352126,3,9,20,-11,3,0
210449,2,9,14,-5,9,1
250118,1,7,0,7,9,0
118510,2,14,0,14,2,1
230491,4,28,14,14,1,0
376334,2,3,0,3,14,1
368165,3,13,21,-8,11,1
304012,1,0,10,-10,16,0
172255,4,21,13,8,9,0
49572,4,20,3,17,6,1
67730,2,14,0,14,14,1
226486,4,14,10,4,16,0
41118,4,11,19,-8,2,1
252811,3,9,6,3,11,0
85229,4,17,17,0,4,0
131443,4,20,19,1,8,0
246381,4,20,10,10,7,1
393869,3,13,17,-4,5,0
287894,1,0,3,-3,9,1
406382,3,10,7,3,11,1
228869,4,9,17,-8,17,1
20242,4,27,10,17,10,0
216984,2,3,3,0,12,1
18811,1,0,0,0,9,1
82703,4,19,19,0,3,0
416920,3,3,7,-4,15,1
28641,1,0,6,-6,14,0
41554,4,18,7,11,2,0
128732,1,0,0,0,7,1
246511,3,19,7,12,8,1
410651,4,17,31,-14,13,0
306145,2,7,0,7,17,0
142547,1,0,0,0,13,1
80984,3,20,10,10,3,1
420615,2,7,10,-3,17,0
367005,3,3,31,-28,10,0
265976,4,0,33,-33,16,0
200708,2,7,0,7,4,1
186803,3,26,7,19,15,0
414290,3,21,28,-7,14,0
154557,2,7,7,0,1,1
317903,1,7,0,7,5,0
288657,1,0,7,-7,9,0
326301,1,0,3,-3,9,0
286781,4,20,28,-8,8,1
114473,2,10,10,0,1,0
216582,4,40,11,29,12,0
170850,2,7,0,7,8,0
365659,1,0,0,0,9,1
389544,4,26,17,9,3,1
290322,1,6,0,6,10,0
139143,3,12,6,6,12,1
108830,3,7,10,-3,15,1
305014,4,24,26,-2,16,0
185571,3,10,20,-10,15,0
80379,3,27,9,18,2,0
133850,1,0,0,0,9,0
311928,3,21,10,11,2,1
65348,4,6,21,-15,13,1
312099,3,30,7,23,2,0
345754,4,16,7,9,17,0
335731,3,10,7,3,13,0
153599,4,12,14,-2,1,1
43537,3,10,3,7,3,0
66006,1,0,0,0,13,1
274833,1,0,7,-7,3,1
340442,1,0,3,-3,15,0
318942,1,0,0,0,5,0
329565,4,45,21,24,10,1
183788,2,10,14,-4,14,0
299387,1,0,13,-13,14,0
377741,4,39,7,32,15,0
387857,2,10,28,-18,2,1
80674,3,17,19,-2,3,0
287836,3,28,17,11,9,0
321240,1,3,0,3,6,0
80399,4,27,16,11,2,0
294132,4,21,27,-6,12,0
48453,4,17,20,-3,5,1
244635,1,0,10,-10,7,0
91091,4,9,6,3,7,0
179796,4,6,27,-21,12,1
31145,2,3,13,-10,15,1
137129,4,30,6,24,11,1
304249,4,33,14,19,16,1
317321,2,0,0,0,5,0
185813,1,0,0,0,15,0
61893,4,26,23,3,12,1
151690,4,36,44,-8,17,1
7096,2,21,14,7,4,1
125633,3,14,24,-10,5,0
46941,4,20,30,-10,5,0
313346,4,13,27,-14,3,0
212824,4,23,21,2,10,1
274651,1,7,0,7,3,1
74426,4,10,20,-10,17,1
335572,2,6,7,-1,13,1
254374,4,13,30,-17,11,0
182575,1,0,3,-3,14,0
312820,2,7,0,7,3,1
28275,4,17,14,3,13,0
295936,4,13,24,-11,12,0
357318,4,14,19,-5,5,0
336217,1,0,0,0,13,0
340597,1,6,0,6,15,0
173741,2,3,3,0,10,0
136361,4,18,14,4,11,0
244565,4,25,16,9,7,1
79887,2,3,13,-10,2,1
236658,2,10,0,10,3,0
244961,2,0,20,-20,7,0
26160,3,0,20,-20,13,1
377941,1,0,0,0,15,0
178740,1,6,0,6,12,1
270122,3,24,10,14,1,0
77681,3,10,17,-7,1,1
178033,4,7,23,-16,12,1
5137,4,13,7,6,3,1
185334,1,0,0,0,15,1
270326,4,26,27,-1,1,1
120388,2,16,6,10,3,0
395936,2,23,3,20,6,1
86427,3,20,7,13,5,1
177381,2,16,7,9,11,1
270511,1,0,7,-7,1,1
222827,3,17,13,4,14,1
299287,3,23,7,16,14,1
369673,1,13,7,6,11,1
41903,2,14,3,11,2,0
215165,2,7,6,1,11,0
122452,3,13,26,-13,4,0
197728,3,7,10,-3,3,1
410531,1,7,7,0,13,1
403311,2,6,0,6,9,1
102062,3,28,10,18,12,0
338298,1,0,0,0,14,1
9122,1,0,0,0,5,0
104438,1,0,7,-7,13,0
119237,2,7,3,4,3,0
234494,3,20,20,0,2,1
180001,2,7,13,-6,13,0
36716,4,23,10,13,17,0
211610,1,0,3,-3,9,1
32412,3,31,6,25,15,0
222575,1,0,0,0,14,0
377028,4,22,25,-3,15,0
153781,4,2,27,-25,1,1
208043,3,21,3,18,8,0
59481,3,3,20,-17,11,1
322456,2,12,0,12,7,0
198636,3,3,14,-11,3,1
249969,1,0,3,-3,9,0
112117,2,7,20,-13,17,1
97448,1,0,0,0,10,0
247108,2,13,3,10,8,0
44014,4,3,28,-25,3,1
44872,3,7,17,-10,4,1
249052,2,21,17,4,9,1
42072,3,20,10,10,2,1
349575,2,3,28,-25,2,1
313956,4,28,32,-4,3,1
361184,1,0,7,-7,7,1
113570,2,0,0,0,17,1
385136,3,14,17,-3,1,0
368215,1,0,0,0,11,1
262683,1,0,0,0,15,1
194801,4,10,23,-13,2,0
30813,1,0,7,-7,15,1
77090,2,7,17,-10,1,1
325117,1,10,7,3,8,0
350768,3,10,3,7,2,0
35757,2,3,0,3,17,0
389626,2,10,10,0,3,1
122288,3,6,19,-13,4,0
162920,1,0,0,0,5,1
73806,3,6,0,6,17,0
312010,4,41,17,24,2,0
391898,3,16,20,-4,4,1
146617,1,0,6,-6,15,0
275319,3,10,16,-6,3,1
228608,1,10,14,-4,17,0
194058,4,27,7,20,1,0
295577,3,23,25,-2,12,1
259386,4,35,41,-6,13,1
352071,2,3,7,-4,3,0
125402,1,6,0,6,5,1
206031,4,19,17,2,7,1
163031,4,19,3,16,5,1
147161,4,17,46,-29,15,0
237776,1,0,7,-7,4,1
151091,4,17,10,7,17,1
150885,2,0,7,-7,17,0
125173,3,17,7,10,5,1
93562,2,3,3,0,9,1
179971,1,0,6,-6,13,1
174177,2,3,6,-3,10,1
147779,1,0,0,0,15,0
413443,3,10,38,-28,14,1
137149,4,31,6,25,11,1
256769,3,10,13,-3,12,0
117909,1,0,0,0,2,0
214216,1,0,3,-3,11,1
200780,4,31,3,28,4,1
158089,3,22,9,13,3,0
385247,2,0,3,-3,1,1
269773,2,7,0,7,1,1
45335,3,20,16,4,4,0
274409,3,3,17,-14,3,1
252921,2,6,0,6,11,0
175372,2,14,3,11,11,1
239648,1,0,0,0,4,0
139103,2,9,3,6,12,0
220354,1,3,0,3,13,1
41815,4,21,14,7,2,1
268175,3,9,17,-8,17,1
378926,4,13,30,-17,15,1
361434,4,17,24,-7,7,1
53300,4,10,10,0,8,0
159766,4,7,13,-6,3,0
47316,2,0,10,-10,5,0
44070,1,0,3,-3,3,0
174714,4,9,7,2,10,0
315159,2,7,7,0,4,1
155881,3,7,13,-6,2,1
201388,4,28,22,6,5,1
219585,1,0,0,0,13,1
186283,2,13,3,10,15,0
178012,3,7,20,-13,12,1
316299,3,10,16,-6,4,0
69024,4,24,17,7,15,0
90051,4,18,21,-3,7,0
240694,1,0,0,0,5,1
143453,1,14,7,7,14,0
175158,3,35,10,25,10,0
348090,3,0,19,-19,1,1
383054,1,10,7,3,17,1
330667,2,6,3,3,11,1
388366,4,17,12,5,2,0
239304,3,3,14,-11,4,0
340043,3,14,12,2,15,1
232590,1,0,0,0,1,1
137987,2,7,14,-7,11,1
290737,4,47,25,22,10,1
242201,3,23,7,16,6,0
122756,4,10,27,-17,4,0
263973,4,23,7,16,15,1
210876,2,7,3,4,9,1
380216,2,13,16,-3,16,1
379694,1,3,0,3,16,1
238146,1,3,3,0,4,0
14402,1,0,0,0,7,0
407122,3,7,20,-13,11,1
335401,1,0,3,-3,13,1
384947,1,7,0,7,1,0
175343,1,7,0,7,11,0
266469,2,0,9,-9,16,0
421208,1,6,0,6,17,0
40057,3,20,7,13,1,0
170440,3,21,3,18,8,0
254173,3,3,12,-9,11,1
411756,2,0,17,-17,13,1
375735,1,3,0,3,14,0
192505,3,14,17,-3,1,0
299695,2,17,3,14,14,1
248971,4,27,3,24,9,0
140278,2,7,6,1,12,0
649,2,0,3,-3,1,0
227893,2,17,6,11,16,1
382133,3,27,3,24,17,1
186069,4,31,48,-17,15,0
229067,1,3,0,3,17,1
188223,1,0,7,-7,16,1
128239,3,20,7,13,7,0
193484,4,33,20,13,1,0
188549,2,3,10,-7,16,1
233705,2,7,21,-14,2,1
211528,3,36,14,22,9,0
374433,3,18,0,18,14,1
19199,4,21,19,2,10,1
194605,2,21,7,14,2,1
121779,1,0,0,0,4,1
307098,4,24,6,18,17,1
107229,4,14,31,-17,15,0
234754,1,0,0,0,2,0
29977,2,14,0,14,14,0
303801,4,20,17,3,16,0
265774,3,10,3,7,16,1
268495,4,23,9,14,17,0
183074,2,7,0,7,14,0
103608,1,0,0,0,13,1
329937,2,7,10,-3,11,0
289191,3,20,10,10,9,1
404771,2,10,6,4,10,0
415623,3,23,13,10,15,1
16629,2,7,27,-20,8,0
330218,2,7,7,0,11,1
14166,2,0,21,-21,7,0
334767,4,32,11,21,13,1
9073,3,28,13,15,4,1
92156,3,3,37,-34,8,1
64820,1,0,0,0,13,1
122939,1,0,0,0,4,1
98756,3,34,6,28,11,0
369246,2,14,7,7,11,0
265862,1,0,6,-6,16,0
68859,3,6,17,-11,15,0
243539,1,3,0,3,6,0
176310,2,7,14,-7,11,1
238779,2,7,0,7,4,1
24126,4,14,14,0,12,0
213312,1,3,0,3,10,0
304475,2,0,7,-7,16,1
398076,3,21,28,-7,7,0
281194,3,24,13,11,6,0
382720,4,3,13,-10,17,1
69437,3,24,3,21,15,0
261822,2,6,10,-4,14,0
179007,4,19,3,16,12,1
176344,3,16,14,2,11,0
214136,3,3,6,-3,11,1
324520,2,6,7,-1,8,1
68829,3,6,14,-8,15,0
99274,1,7,0,7,11,1
271373,1,0,0,0,1,1
322408,4,17,26,-9,7,1
131903,4,34,7,27,8,0
68594,4,20,28,-8,14,1
279125,3,21,20,1,5,0
211069,3,30,0,30,9,1
149214,1,7,0,7,16,1
377304,4,20,14,6,15,1
65235,4,10,13,-3,13,0
276132,1,0,0,0,3,1
205033,3,9,17,-8,6,0
353308,4,38,28,10,4,1
261728,3,14,7,7,14,0
300487,3,16,3,13,14,1
163340,4,22,23,-1,5,1
243449,3,3,17,-14,6,0
360416,2,0,0,0,7,1
411313,2,3,10,-7,13,1
319986,3,43,16,27,6,0
310734,2,3,3,0,2,0
194517,4,26,10,16,2,0
144736,3,3,7,-4,14,1
82798,3,9,9,0,3,0
371931,4,34,17,17,12,1
393597,3,7,26,-19,5,0
250364,4,20,20,0,9,1
230104,1,0,9,-9,17,0
314040,2,6,7,-1,3,1
343458,2,7,7,0,16,0
163937,3,23,10,13,5,0
14348,4,2,14,-12,7,1
388123,2,3,3,0,2,0
70168,3,27,7,20,15,0
239084,1,0,3,-3,4,1
183864,4,37,28,9,14,0
123729,1,7,0,7,5,0
276859,4,26,20,6,4,1
221218,1,0,10,-10,14,1
341222,3,13,7,6,16,1
110301,2,0,17,-17,16,1
151546,1,0,0,0,17,0
297705,3,10,13,-3,13,1
402752,3,24,7,17,9,0
245019,4,14,27,-13,7,0
49505,2,7,3,4,6,1
324599,4,16,9,7,8,1
287297,1,3,0,3,8,0
401524,2,0,14,-14,8,1
417546,4,24,28,-4,16,0
72110,4,10,17,-7,16,1
96700,1,0,7,-7,10,0
213816,2,35,0,35,10,1
10468,2,3,0,3,5,1
253338,1,7,0,7,11,0
316852,1,0,0,0,4,1
273533,4,21,28,-7,2,1
273701,4,22,20,2,2,1
111595,1,0,0,0,16,0
317804,2,9,3,6,5,0
195320,1,3,0,3,2,1
61497,1,0,7,-7,11,1
302367,3,10,13,-3,15,1
75593,3,7,3,4,17,0
216144,1,7,0,7,12,0
98216,1,0,0,0,11,1
321495,4,24,30,-6,7,0
395745,1,0,0,0,6,1
344443,4,28,24,4,17,0
289446,2,3,0,3,10,0
255608,1,0,7,-7,12,0
82869,1,0,0,0,4,1
125333,3,24,3,21,5,0
381191,1,7,3,4,16,0
113698,1,0,10,-10,17,1
46372,4,6,17,-11,4,0
219055,3,30,13,17,13,1
246529,3,22,7,15,8,1
173151,2,10,14,-4,9,0
374978,2,14,20,-6,14,1
141707,3,23,21,2,13,1
142101,2,0,7,-7,13,1
403619,3,24,13,11,9,0
184742,1,7,0,7,15,0
73416,4,30,3,27,17,1
239769,4,20,13,7,4,1
222682,3,14,24,-10,14,0
62267,2,21,7,14,12,0
28646,2,0,7,-7,14,1
313089,1,0,0,0,3,0
222871,1,0,0,0,14,1
313246,1,0,0,0,3,1
82238,4,16,13,3,3,1
47072,4,17,7,10,5,1
39166,4,27,10,17,1,0
299559,2,3,3,0,14,1
78363,4,38,35,3,2,0
321605,3,10,6,4,7,1
25152,3,20,3,17,12,0
178884,1,0,0,0,12,0
317911,1,7,0,7,5,1
172249,3,14,13,1,9,1
414517,2,7,3,4,14,1
219444,1,0,0,0,13,0
245367,1,9,0,9,7,0
289769,3,3,10,-7,10,0
345068,2,6,0,6,17,0
298171,1,0,0,0,14,0
219066,3,31,13,18,13,1
73497,2,3,28,-25,17,0
273987,4,7,29,-22,2,1
7200,1,0,0,0,4,0
8115,4,27,20,7,4,0
144758,4,3,10,-7,14,0
284916,2,7,14,-7,7,1
400809,2,14,13,1,8,1
284435,2,7,9,-2,7,0
175244,2,15,0,15,10,0
276214,3,24,10,14,3,1
5626,2,0,14,-14,3,1
264640,4,20,20,0,16,1
200199,4,14,37,-23,4,0
311706,4,12,9,3,2,1
356221,4,29,7,22,5,0
85369,4,28,10,18,5,1
318967,1,0,3,-3,5,0
16311,1,6,0,6,8,1
378732,2,14,7,7,15,0
377848,2,20,7,13,15,0
273247,4,40,7,33,2,0
204802,4,28,24,4,6,1
238843,3,34,0,34,4,1
254601,3,13,14,-1,11,1
46695,1,0,0,0,4,1
225622,2,0,10,-10,16,1
310626,3,13,30,-17,2,1
61947,1,0,0,0,12,1
307159,2,0,10,-10,17,1
342896,3,16,17,-1,16,0
19432,2,17,14,3,10,0
309987,2,3,10,-7,2,1
354293,1,7,0,7,4,0
224170,3,0,20,-20,15,0
333278,4,6,24,-18,12,1
130451,1,3,0,3,8,0
367832,2,10,7,3,10,0
204345,4,3,17,-14,6,0
135998,3,3,10,-7,10,1
73840,4,13,7,6,17,1
41043,3,3,13,-10,2,1
231067,4,27,8,19,1,1
406257,3,21,27,-6,11,1
388685,4,20,7,13,3,0
57758,2,16,3,13,10,1
348822,2,3,14,-11,2,1
19729,2,6,6,0,10,1
13516,4,6,41,-35,7,1
137473,1,7,0,7,11,0
58804,4,18,29,-11,10,0
302202,2,21,7,14,15,1
377407,3,7,13,-6,15,0
256341,1,0,0,0,12,1
245581,3,40,0,40,7,0
247243,2,21,14,7,8,1
336398,2,3,3,0,14,0
256674,1,0,0,0,12,1
419405,1,3,0,3,16,1
164040,2,3,3,0,5,0
298293,4,20,13,7,14,0
143909,2,0,0,0,14,1
12146,4,14,21,-7,6,1
382814,2,21,0,21,17,0
132809,1,3,0,3,9,0
27423,1,0,0,0,13,1
207122,1,7,0,7,7,0
218862,2,14,3,11,13,1
41971,4,38,6,32,2,0
169873,4,27,17,10,8,0
314672,4,14,21,-7,3,1
176440,1,0,0,0,11,0
274384,2,3,10,-7,3,0
280598,3,17,9,8,5,1
6368,2,0,13,-13,3,1
381568,4,28,16,12,17,1
145090,1,0,0,0,14,0
298053,1,0,14,-14,13,0
326651,3,16,6,10,9,0
209467,4,24,20,4,8,0
246056,3,16,13,3,7,0
150349,3,27,7,20,16,0
366855,3,3,6,-3,10,0
226549,1,0,0,0,16,1
316895,2,9,8,1,4,1
186152,2,12,6,6,15,1
333820,3,14,20,-6,12,0
341227,3,16,7,9,16,1
156462,2,0,3,-3,2,0
137783,4,17,37,-20,11,0
304617,2,14,7,7,16,0
193740,3,3,27,-24,1,1
193303,4,10,23,-13,1,0
415497,4,23,3,20,15,0
158432,4,19,27,-8,3,1
294817,2,28,14,14,12,0
262637,3,26,10,16,15,1
395397,3,28,3,25,5,1
48779,4,17,28,-11,5,1
309745,4,26,9,17,1,0
142439,2,7,10,-3,13,0
258484,4,21,21,0,13,1
389215,3,21,7,14,3,0
281288,2,13,6,7,6,1
45501,4,27,23,4,4,0
372002,2,10,0,10,13,1
170656,1,0,0,0,8,0
6200,1,7,0,7,3,1
235328,4,32,21,11,3,1
259318,3,13,13,0,13,0
103385,3,10,20,-10,13,1
89176,1,0,0,0,7,0
70235,1,0,0,0,15,1
215497,3,10,3,7,11,1
411857,1,0,0,0,13,0
391365,1,0,0,0,4,0
405449,3,21,10,11,10,1
38673,3,7,7,0,1,1
285311,4,21,9,12,7,1
50780,4,24,21,3,6,1
367386,2,10,14,-4,10,1
222523,3,17,14,3,14,1
237615,1,0,0,0,4,1
400268,4,17,9,8,8,1
41657,3,17,7,10,2,1
251502,2,16,6,10,10,1
8609,2,7,10,-3,4,0
303412,2,10,0,10,16,0
279750,4,30,6,24,5,1
26367,1,0,0,0,13,1
348054,2,0,10,-10,1,0
117764,1,3,6,-3,2,0
15515,3,16,6,10,8,1
56846,1,0,0,0,9,1
277927,4,7,27,-20,4,1
151390,4,34,14,20,17,1
107816,4,7,20,-13,15,0
130747,1,0,3,-3,8,1
379290,2,0,3,-3,16,0
137263,3,7,13,-6,11,0
16535,4,30,13,17,8,0
208373,4,17,30,-13,8,0
226461,3,7,10,-3,16,1
118515,2,17,0,17,2,0
210351,4,16,17,-1,9,0
304022,2,0,13,-13,16,0
250729,1,3,0,3,10,0
169164,2,3,6,-3,7,0
304153,1,0,0,0,16,1
195727,4,17,16,1,2,0
178595,1,3,3,0,12,0
53206,1,0,0,0,8,1
191064,2,7,0,7,17,1
192569,1,0,0,0,1,1
250398,4,24,26,-2,9,1
319491,3,3,10,-7,6,0
416948,4,10,7,3,15,0
366596,4,26,14,12,10,0
137513,2,13,14,-1,11,1
239175,4,20,16,4,4,0
22868,2,0,10,-10,11,0
274532,2,21,15,6,3,0
41443,2,2,0,2,2,0
234772,2,0,3,-3,2,0
61111,2,0,7,-7,11,1
277046,1,3,0,3,4,1
372026,3,13,3,10,13,1
54037,2,3,0,3,8,1
36377,3,13,19,-6,17,1
65449,2,0,14,-14,13,1
29278,2,21,7,14,14,0
125252,1,0,0,0,5,1
216405,4,21,23,-2,12,1
381347,2,6,0,6,16,0
47918,1,0,0,0,5,1
107955,3,6,6,0,15,0
193171,1,0,0,0,1,1
217463,2,9,3,6,12,0
230142,2,3,23,-20,17,1
6856,4,10,28,-18,3,0
234462,2,17,6,11,2,0
94417,4,17,24,-7,9,1
309041,4,0,20,-20,1,0
399757,2,0,17,-17,8,0
39171,4,27,10,17,1,0
337857,4,30,12,18,14,0
409610,4,42,20,22,12,1
44159,4,13,20,-7,3,1
395477,2,7,0,7,6,1
66793,3,10,6,4,14,0
179228,2,14,3,11,12,1
346117,4,16,12,4,1,1
3529,1,0,0,0,2,1
402262,2,9,10,-1,9,0
49715,4,21,31,-10,6,1
147141,3,17,46,-29,15,1
25365,1,3,0,3,12,1
272175,1,0,0,0,2,1
195049,2,7,17,-10,2,1
12225,2,0,0,0,6,0
347511,3,12,30,-18,1,1
118049,4,20,20,0,2,1
108787,1,0,7,-7,15,0
401739,4,24,14,10,8,0
154102,1,0,3,-3,1,1
403489,3,17,12,5,9,1
154650,4,24,21,3,1,0
181992,2,14,7,7,13,1
383635,2,0,7,-7,17,0
47970,2,3,21,-18,5,0
367309,4,3,17,-14,10,1
80747,1,3,0,3,3,1
329645,2,13,7,6,11,1
281321,2,14,13,1,6,1
342791,4,7,14,-7,16,1
387998,2,3,3,0,2,1
373979,2,10,0,10,13,1
252565,1,0,0,0,10,1
334934,1,0,0,0,13,0
259244,1,0,0,0,13,0
416301,2,10,3,7,15,1
149853,3,3,16,-13,16,1
355138,3,23,16,7,4,1
51971,4,13,16,-3,7,0
49688,3,14,21,-7,6,0
3441,2,3,16,-13,2,0
167919,4,21,19,2,7,1
33980,3,10,27,-17,16,0
267891,4,26,24,2,17,1
258190,4,20,13,7,13,0
40021,2,20,7,13,1,0
287667,3,9,10,-1,9,1
365267,2,3,13,-10,9,0
75756,3,28,16,12,1,0
49134,1,0,0,0,6,1
190068,2,17,3,14,17,0
410343,4,7,26,-19,13,1
163512,1,7,0,7,5,0
87057,1,0,0,0,5,1
247273,3,28,27,1,8,0
334203,1,0,0,0,13,1
348992,2,14,6,8,2,0
104305,2,31,14,17,13,0
322361,3,14,13,1,7,1
264104,3,13,27,-14,15,0
165334,1,0,0,0,6,0
282603,1,0,7,-7,6,1
412270,4,28,22,6,13,1
320711,2,14,17,-3,6,0
356265,1,0,0,0,5,1
343932,2,14,0,14,17,0
188785,4,0,20,-20,16,1
272643,1,0,0,0,2,1
225260,4,17,7,10,15,0
421594,4,16,9,7,17,1
383666,2,6,14,-8,17,0
211134,1,0,3,-3,9,1
319247,1,0,0,0,6,0
119421,2,0,14,-14,3,1
55079,2,13,3,10,8,1
211751,4,29,23,6,9,1
247782,4,10,6,4,8,0
240612,2,19,7,12,5,1
16086,3,30,7,23,8,1
259700,1,3,7,-4,14,1
37652,2,27,0,27,17,1
284670,4,14,27,-13,7,1
178071,4,23,23,0,12,1
273297,2,21,0,21,2,1
17828,2,13,10,3,9,1
321079,1,0,0,0,6,0
229666,1,7,7,0,17,1
122088,1,7,7,0,4,1
282323,1,7,0,7,6,0
420769,2,0,3,-3,17,0
222697,4,14,24,-10,14,0
361022,2,9,2,7,7,1
230988,2,7,0,7,1,0
367614,4,31,12,19,10,1
217512,4,19,3,16,12,0
224877,1,0,3,-3,15,0
95865,4,13,17,-4,10,0
27815,3,14,14,0,13,1
207595,3,21,10,11,7,0
293278,4,26,7,19,11,1
149981,2,14,3,11,16,0
270774,4,6,10,-4,1,1
199961,2,10,10,0,4,1
407941,4,17,24,-7,11,0
391798,1,0,0,0,4,1
77352,2,7,7,0,1,1
51684,1,0,0,0,7,1
37329,2,7,0,7,17,1
67870,2,6,3,3,14,0
157102,3,10,14,-4,2,1
331692,1,0,13,-13,12,1
116566,2,3,0,3,2,0
376442,4,23,23,0,14,1
335814,1,7,7,0,13,1
212528,4,13,16,-3,10,1
33271,3,16,0,16,16,1
231155,2,10,0,10,1,0
402557,2,7,7,0,9,1
374156,3,23,7,16,13,1
60981,2,27,13,14,11,0
299503,1,0,0,0,14,1
356048,3,24,10,14,5,0
334505,1,7,14,-7,13,1
280941,4,21,13,8,6,0
241782,4,10,15,-5,5,0
314244,4,17,20,-3,3,0
294598,1,0,0,0,12,1
287218,4,13,23,-10,8,1
81596,4,17,24,-7,3,0
184802,2,17,20,-3,15,0
310052,4,9,10,-1,2,0
190698,3,28,17,11,17,1
111684,3,28,10,18,16,0
355081,1,0,13,-13,4,1
187020,1,0,0,0,16,1
366069,4,51,21,30,10,1
93704,2,0,3,-3,9,1
227930,3,27,20,7,16,0
342840,1,10,0,10,16,1
14523,4,34,36,-2,7,0
287226,4,16,23,-7,8,0
102234,4,30,14,16,13,1
312968,2,0,0,0,3,0
203955,2,3,7,-4,6,1
259910,2,14,10,4,14,1
61153,4,0,14,-14,11,1
24377,2,10,0,10,12,0
113579,2,3,0,3,17,0
300921,3,10,20,-10,15,1
109059,4,23,41,-18,15,0
106079,1,0,0,0,14,1
386737,1,0,0,0,2,1
384938,1,0,0,0,1,1
377183,4,16,17,-1,15,1
391711,2,3,10,-7,4,1
413118,3,30,35,-5,14,1
21984,2,7,3,4,11,0
231524,4,23,29,-6,1,1
42728,4,7,20,-13,3,1
125255,1,0,0,0,5,0
313877,2,21,19,2,3,0
365211,4,14,38,-24,9,1
378882,3,13,13,0,15,0
221465,4,3,41,-38,14,0
114470,2,9,10,-1,1,1
210087,1,0,0,0,9,0
410625,4,17,17,0,13,1
236233,4,27,22,5,3,0
221456,3,3,38,-35,14,0
228569,4,20,23,-3,17,0
9228,4,3,23,-20,5,0
232128,1,0,0,0,1,1
145825,4,13,33,-20,15,1
413994,3,3,24,-21,14,0
82709,4,19,22,-3,3,1
375241,5,27,24,3,14,0
29179,4,3,19,-16,14,1
323440,1,0,0,0,7,0
170048,1,0,0,0,8,1
331145,2,7,13,-6,11,0
306861,2,0,3,-3,17,0
325052,4,26,24,2,8,0
304507,3,3,14,-11,16,1
91988,3,13,23,-10,8,1
224125,2,0,10,-10,15,0
74337,1,0,3,-3,17,1
67947,4,22,6,16,14,0
173955,4,20,19,1,10,1
323037,2,14,7,7,7,0
235088,2,0,7,-7,2,0
390373,2,7,13,-6,3,0
396004,4,31,20,11,6,0
402356,1,0,0,0,9,0
411,3,38,20,18,1,0
238378,3,10,23,-13,4,0
31645,3,24,9,15,15,0
173431,2,0,7,-7,10,1
305679,2,3,7,-4,17,1
359175,3,10,14,-4,6,0
298489,1,10,0,10,14,0
371815,1,0,3,-3,12,0
34217,1,10,0,10,16,0
42660,3,0,10,-10,3,1
335417,2,7,6,1,13,1
70923,4,15,36,-21,15,1
94268,1,0,0,0,9,0
50445,3,10,10,0,6,0
295060,1,0,0,0,12,1
361110,4,23,16,7,7,0
111429,4,0,20,-20,16,0
312881,4,14,7,7,3,1
285709,1,0,0,0,8,0
40494,4,7,20,-13,2,0
135959,2,0,3,-3,10,1
247424,3,10,9,1,8,1
386537,3,14,21,-7,2,0
134992,4,7,27,-20,10,1
286220,1,0,6,-6,8,1
155364,2,10,3,7,2,1
26382,1,7,0,7,13,1
171256,1,0,0,0,9,1
316431,2,16,10,6,4,0
200243,1,3,0,3,4,1
298771,1,7,6,1,14,1
73742,1,3,0,3,17,1
11015,4,9,31,-22,5,1
253589,3,6,10,-4,11,1
4859,1,13,0,13,3,1
306794,4,19,33,-14,17,0
235204,1,9,0,9,3,0
41766,2,7,7,0,2,1
191803,1,3,7,-4,1,1
115501,1,0,0,0,1,1
353430,3,25,3,22,4,0
381198,2,7,3,4,16,0
152187,2,7,0,7,17,1
131837,2,14,7,7,8,1
96473,3,10,17,-7,10,1
191103,3,7,13,-6,17,1
253154,4,21,23,-2,11,0
40512,4,7,20,-13,2,1
37788,3,7,9,-2,1,0
340879,1,0,3,-3,15,1
199301,4,17,38,-21,4,1
266507,3,3,15,-12,16,1
242,3,12,17,-5,1,0
27151,2,0,7,-7,13,0
288617,4,23,41,-18,9,0
305816,1,0,7,-7,17,1
341999,3,13,3,10,16,1
35173,2,0,14,-14,16,0
300756,2,7,13,-6,15,1
266198,2,24,0,24,16,1
403553,1,7,0,7,9,1
3107,2,0,3,-3,2,0
97505,2,16,0,16,10,0
206643,4,10,16,-6,7,1
265268,4,9,6,3,16,0
53046,1,7,0,7,7,1
344689,3,6,20,-14,17,0
368089,1,7,0,7,11,0
361729,1,0,0,0,7,1
74284,4,10,23,-13,17,0
363827,2,13,16,-3,8,0
301430,1,3,3,0,15,1
193428,3,20,20,0,1,1
74868,4,20,20,0,17,1
188108,2,0,10,-10,16,1
185719,2,17,3,14,15,1
411441,2,7,17,-10,13,1
101397,3,12,7,5,12,1
281554,4,20,23,-3,6,1
216465,1,17,0,17,12,1
406075,2,0,20,-20,11,1
337984,4,23,0,23,14,1
97729,4,9,13,-4,11,1
188084,2,0,3,-3,16,0
150162,2,6,13,-7,16,0
286603,4,17,38,-21,8,0
115509,1,0,0,0,1,0
353337,1,0,0,0,4,1
271961,4,23,27,-4,2,1
329463,2,3,0,3,10,0
412932,2,9,3,6,14,0
351370,3,10,7,3,3,0
32588,4,27,13,14,15,0
42782,2,6,21,-15,3,1
8712,1,0,0,0,4,1
149096,3,14,17,-3,16,1
357340,1,0,0,0,5,1
372657,3,14,9,5,13,1
282261,3,19,14,5,6,0
311100,4,10,3,7,2,1
347787,3,10,0,10,1,1
130230,3,3,26,-23,8,1
255756,1,0,0,0,12,1
370298,3,7,34,-27,12,0
101015,4,20,16,4,12,1
385671,5,24,24,0,1,1
53949,4,20,25,-5,8,1
36653,3,13,3,10,17,0
194321,3,10,6,4,2,1
144056,1,7,0,7,14,1
99827,4,8,24,-16,12,0
400901,1,6,0,6,8,0
286092,3,10,10,0,8,1
244768,1,0,0,0,7,0
185877,2,9,10,-1,15,1
65718,2,7,16,-9,13,0
52697,3,3,13,-10,7,0
7313,4,20,19,1,4,1
143363,3,7,13,-6,14,0
278403,1,0,0,0,4,0
260616,2,0,10,-10,14,1
34379,1,7,0,7,16,1
400816,2,17,13,4,8,0
300650,3,17,3,14,15,0
154970,4,29,24,5,1,0
90428,2,0,13,-13,7,1
209263,4,27,7,20,8,1
98474,4,24,14,10,11,0
398725,2,0,17,-17,7,0
147326,1,0,0,0,15,1
237917,4,14,27,-13,4,0
273369,4,35,7,28,2,1
206847,2,3,7,-4,7,1
242457,2,3,7,-4,6,0
72013,2,0,10,-10,16,1
404306,2,0,3,-3,10,0
415779,4,21,17,4,15,0
34164,4,10,10,0,16,0
150835,1,0,0,0,17,1
1407,3,10,0,10,1,1
251868,3,14,13,1,10,0
102528,4,31,10,21,13,0
51655,4,27,20,7,7,0
305654,1,3,7,-4,17,1
56922,3,34,7,27,9,1
89488,1,0,0,0,7,1
291905,3,17,10,7,11,1
351961,2,21,14,7,3,1
114130,4,24,14,10,17,0
288386,3,10,0,10,9,1
320985,2,7,0,7,6,0
418034,4,28,35,-7,16,1
90768,3,20,7,13,7,0
378802,4,17,10,7,15,0
48734,3,10,19,-9,5,0
223204,2,3,3,0,15,0
217756,3,10,7,3,12,1
396676,2,7,7,0,6,1
273488,3,7,13,-6,2,1
221877,2,6,7,-1,14,1
182963,3,10,37,-27,14,0
419277,2,0,7,-7,16,0
87847,2,10,9,1,6,0
69805,1,7,0,7,15,0
270594,4,19,14,5,1,1
241183,4,20,10,10,5,1
163110,2,13,19,-6,5,1
127765,2,7,21,-14,6,1
43900,1,0,0,0,3,1
162895,4,13,6,7,5,0
269209,2,3,3,0,17,0
123674,3,10,22,-12,4,0
260501,2,20,0,20,14,0
408328,3,3,7,-4,12,1
15296,1,0,0,0,8,1
326553,4,51,22,29,9,0
201794,2,13,0,13,5,0
352360,2,14,0,14,3,0
292282,2,6,7,-1,11,1
189023,2,7,7,0,16,1
252818,3,9,13,-4,11,1
293531,3,10,10,0,11,0
197268,2,0,0,0,3,1
199047,1,0,7,-7,4,0
94061,3,6,28,-22,9,1
153582,3,12,14,-2,1,0
29063,1,0,3,-3,14,0
68980,2,21,7,14,15,0
11876,4,41,20,21,6,1
292700,1,7,0,7,11,0
362529,3,16,12,4,8,1
149386,2,6,6,0,16,0
25558,2,17,7,10,12,1
97507,2,16,0,16,10,0
349863,2,3,3,0,2,0
300715,1,7,0,7,15,0
83913,4,23,24,-1,4,1
40579,2,17,7,10,2,0
398088,3,24,28,-4,7,0
91497,3,19,0,19,8,0
414711,3,3,17,-14,14,1
309992,3,6,10,-4,2,1
394671,4,17,21,-4,5,1
28101,3,24,10,14,13,0
114878,4,16,33,-17,1,1
144030,4,21,16,5,14,0
23099,4,10,17,-7,11,1
10097,3,41,7,34,5,0
170220,1,0,3,-3,8,1
253345,1,7,0,7,11,1
4223,2,10,6,4,2,1
114323,2,7,6,1,1,1
115664,2,3,3,0,1,0
265788,3,17,12,5,16,1
164222,3,27,38,-11,5,1
418780,4,14,24,-10,16,1
127776,2,10,21,-11,6,0
265200,2,6,3,3,16,0
203349,3,14,27,-13,6,1
377167,4,13,17,-4,15,1
342730,2,0,7,-7,16,1
37606,1,7,0,7,17,1
61726,4,24,30,-6,12,0
17465,1,0,0,0,9,1
311586,1,3,0,3,2,1
115073,1,3,0,3,1,0
134713,1,3,0,3,10,0
186857,4,29,20,9,15,1
214784,3,3,20,-17,11,1
48978,1,3,0,3,6,0
2516,2,3,0,3,2,0
70471,3,17,17,0,15,0
239794,1,0,0,0,4,0
331968,1,0,0,0,12,0
55161,4,29,17,12,8,0
123166,2,3,21,-18,4,1
113193,4,41,16,25,17,0
150704,2,6,3,3,17,0
4079,3,16,21,-5,2,0
17424,4,17,7,10,9,0
38845,4,3,10,-7,1,1
59537,4,13,35,-22,11,1
318808,1,0,0,0,5,1
239969,2,0,10,-10,5,0
193394,2,10,17,-7,1,1
140088,1,0,0,0,12,1
6001,4,17,36,-19,3,1
212271,1,7,3,4,10,1
394982,1,0,0,0,5,1
32710,3,7,13,-6,15,0
4258,3,13,6,7,2,1
303396,1,10,0,10,16,0
157118,3,13,14,-1,2,1
168791,4,19,16,3,7,1
65581,2,6,6,0,13,0
104264,2,16,0,16,13,1
186590,1,14,0,14,15,1
295296,4,14,5,9,12,0
170568,2,21,3,18,8,0
77969,2,3,10,-7,1,1
5174,1,0,0,0,3,0
105132,4,33,14,19,14,0
285301,3,14,9,5,7,1
420651,3,21,16,5,17,0
290594,1,0,0,0,10,0
410916,3,14,15,-1,13,0
376618,1,0,0,0,14,0
297505,2,5,0,5,13,0
397194,3,13,0,13,6,0
25582,3,24,10,14,12,1
363830,3,13,17,-4,8,1
353540,2,17,0,17,4,0
148057,3,7,10,-3,15,1
365314,3,17,16,1,9,0
218676,1,0,0,0,13,1
357497,1,0,6,-6,5,1
118993,3,0,23,-23,3,1
265866,1,0,6,-6,16,0
397085,4,24,16,8,6,0
404322,2,0,6,-6,10,1
149357,2,3,0,3,16,0
35987,4,6,21,-15,17,1
68738,4,34,7,27,15,0
96156,2,0,16,-16,10,1
410106,2,14,7,7,13,1
415953,4,24,30,-6,15,0
113428,2,0,7,-7,17,1
382249,3,17,3,14,17,0
350769,3,10,3,7,2,0
337901,2,10,0,10,14,0
50584,2,0,6,-6,6,1
226863,2,0,7,-7,16,1
48026,4,10,27,-17,5,0
343336,2,0,10,-10,16,0
14634,3,17,7,10,7,0
60868,4,17,23,-6,11,0
116821,1,0,0,0,2,1
295235,2,14,5,9,12,0
186436,2,10,10,0,15,1
319921,2,16,7,9,6,0
15928,2,6,7,-1,8,1
83777,1,0,0,0,4,1
149577,3,14,23,-9,16,1
214898,3,7,12,-5,11,0
107855,1,0,0,0,15,1
344330,1,7,0,7,17,0
9318,2,21,7,14,5,0
366841,2,3,3,0,10,0
137690,2,0,13,-13,11,1
36717,4,23,10,13,17,0
248267,1,7,0,7,8,0
164773,3,26,14,12,6,1
20460,1,0,0,0,10,1
37299,1,7,0,7,17,0
338057,2,0,7,-7,14,0
199240,3,17,21,-4,4,0
419630,3,23,16,7,17,0
307204,3,0,10,-10,17,1
150523,1,0,0,0,17,1
59241,4,21,58,-37,10,0
317016,2,0,10,-10,4,0
143224,3,10,13,-3,13,0
369265,2,14,14,0,11,0
412832,3,21,35,-14,14,1
79969,1,0,0,0,2,1
85558,4,17,22,-5,5,0
190411,3,7,7,0,17,0
66054,3,7,0,7,13,0
23304,2,3,10,-7,11,1
37638,2,17,0,17,17,1
45483,3,27,17,10,4,0
99111,4,23,7,16,11,0
89916,1,0,0,0,7,1
35403,5,30,30,0,16,1
32052,2,7,10,-3,15,1
1891,1,0,0,0,1,1
34817,1,0,0,0,16,1
94458,2,0,0,0,9,0
23902,2,3,0,3,12,1
277838,2,7,14,-7,4,1
72919,2,17,7,10,16,0
209763,4,16,6,10,8,0
163537,2,7,3,4,5,1
240811,3,23,10,13,5,1
306934,4,6,30,-24,17,0
350042,3,20,10,10,2,0
296493,3,20,3,17,13,1
91240,4,20,17,3,8,1
298540,3,13,0,13,14,1
203845,4,31,31,0,6,0
29804,1,3,0,3,14,0
138656,3,3,28,-25,12,1
261626,1,0,0,0,14,0
144219,2,9,7,2,14,0
368347,1,0,0,0,11,1
81954,1,0,0,0,3,0
153814,1,0,0,0,1,1
183387,2,17,3,14,14,0
372699,1,0,0,0,13,0
335550,2,3,0,3,13,1
235669,2,0,3,-3,3,0
239901,4,13,3,10,4,0
169463,1,0,7,-7,8,0
376480,1,0,3,-3,14,1
71163,2,19,10,9,16,0
165269,3,17,14,3,6,0
105521,2,26,14,12,14,0
65889,2,7,14,-7,13,1
269032,2,10,3,7,17,0
178356,3,21,17,4,12,0
331560,2,7,20,-13,11,1
288458,4,19,7,12,9,0
167804,1,0,6,-6,7,1
249413,4,18,15,3,9,1
401098,2,21,3,18,8,1
410680,1,0,3,-3,13,1
206649,1,0,0,0,7,0
216000,1,0,9,-9,11,1
60362,2,10,7,3,11,1
60408,3,20,7,13,11,0
175937,4,37,27,10,11,0
419723,2,3,10,-7,17,0
289241,4,30,20,10,9,0
24537,2,7,13,-6,12,1
393621,4,7,33,-26,5,1
34512,1,0,0,0,16,0
353418,3,18,0,18,4,1
281752,1,0,0,0,6,0
399398,4,37,10,27,7,0
240391,5,24,23,1,5,1
328204,4,14,17,-3,10,1
35191,3,0,14,-14,16,1
30456,3,23,28,-5,14,1
351949,2,14,14,0,3,1
43106,4,6,17,-11,3,0
404871,1,0,0,0,10,0
83491,1,0,0,0,4,0
255500,2,17,7,10,12,0
321536,1,0,3,-3,7,1
408278,1,0,0,0,12,1
281320,2,14,13,1,6,1
72306,1,0,0,0,16,0
305485,1,0,0,0,17,1
408206,3,13,3,10,12,1
384193,4,29,20,9,1,1
13405,1,3,13,-10,7,0
229854,2,13,0,13,17,0
201753,1,3,0,3,5,1
345456,4,3,22,-19,17,1
195697,3,14,10,4,2,0
411514,4,13,24,-11,13,0
327433,3,3,17,-14,9,0
176651,2,14,12,2,11,0
118320,4,26,7,19,2,0
12630,1,0,0,0,6,1
35956,3,3,7,-4,17,0
105226,2,7,24,-17,14,1
411416,1,0,7,-7,13,1
71987,1,0,3,-3,16,0
266808,3,10,14,-4,16,0
200610,3,27,14,13,4,1
283160,3,13,9,4,7,1
208745,2,3,6,-3,8,1
104382,4,52,38,14,13,0
77959,2,3,10,-7,1,0
329868,1,0,0,0,11,0
347779,2,7,0,7,1,1
2832,3,24,24,0,2,1
410377,1,0,7,-7,13,1
190846,3,16,9,7,17,0
38031,2,3,0,3,1,1
302330,2,7,3,4,15,0
4343,2,0,7,-7,2,1
142249,1,0,0,0,13,1
32756,4,7,24,-17,15,1
139999,3,28,10,18,12,0
308465,4,7,25,-18,1,1
54790,2,10,0,10,8,1
407955,4,17,24,-7,11,1
24221,3,10,10,0,12,0
44688,1,0,9,-9,3,1
129334,1,7,7,0,7,1
37131,4,16,20,-4,17,1
356572,4,9,9,0,5,0
345816,1,0,7,-7,17,1
192397,1,0,7,-7,1,1
377701,3,25,7,18,15,0
303755,2,17,10,7,16,0
20546,4,17,0,17,10,0
41794,3,10,14,-4,2,1
87316,4,24,24,0,6,0
69690,2,7,7,0,15,1
333782,2,6,14,-8,12,1
366266,3,14,10,4,10,0
57417,4,14,6,8,10,0
139075,1,6,3,3,12,0
401148,3,41,13,28,8,0
31856,1,0,0,0,15,1
348179,1,6,7,-1,1,0
12474,4,13,9,4,6,1
322682,4,9,9,0,7,0
93962,1,0,7,-7,9,1
181179,1,0,0,0,13,0
387356,1,14,0,14,2,1
90432,2,0,13,-13,7,0
338015,1,0,0,0,14,0
185870,2,9,3,6,15,1
59866,5,15,16,-1,11,0
16825,4,20,31,-11,8,1
243494,4,10,30,-20,6,0
251721,3,24,3,21,10,0
232388,4,13,22,-9,1,1
354127,4,19,0,19,4,1
243955,4,25,19,6,6,0
76974,4,17,13,4,1,1
52316,1,3,0,3,7,0
68759,1,3,0,3,15,0
407563,2,10,6,4,11,0
100659,3,14,14,0,12,0
359325,3,3,13,-10,6,0
408109,1,0,0,0,12,0
186167,3,16,6,10,15,0
416747,2,7,0,7,15,0
343288,1,0,0,0,16,0
81024,4,20,23,-3,3,1
253077,2,14,7,7,11,1
282182,1,3,0,3,6,1
244065,3,20,27,-7,6,0
348932,1,0,0,0,2,1
342053,1,0,0,0,16,0
87394,2,7,7,0,6,1
398885,2,3,3,0,7,0
32984,3,6,24,-18,15,0
228307,1,0,0,0,17,0
119716,1,7,0,7,3,0
347626,2,17,10,7,1,0
68841,3,6,17,-11,15,1
140928,4,20,13,7,13,1
349550,2,3,14,-11,2,0
295834,1,0,7,-7,12,1
372278,2,10,7,3,13,1
84423,2,6,0,6,4,0
102991,4,19,38,-19,13,1
404377,4,20,6,14,10,0
394701,1,7,0,7,5,0
312813,2,7,0,7,3,1
181398,2,17,14,3,13,0
112309,4,45,17,28,17,0
275671,4,37,3,34,3,0
290559,4,23,20,3,10,1
83512,2,0,7,-7,4,0
324535,2,7,9,-2,8,1
19063,4,10,6,4,10,1
217964,1,7,0,7,12,0
376396,3,9,6,3,14,0
65755,3,14,16,-2,13,0
274596,4,24,26,-2,3,0
117581,1,0,0,0,2,0
127224,4,16,16,0,6,1
34276,3,17,9,8,16,1
231866,2,7,20,-13,1,0
8127,4,27,20,7,4,0
80143,1,6,0,6,2,1
48359,1,0,7,-7,5,0
190507,2,10,6,4,17,1
153965,1,7,6,1,1,0
242570,1,3,0,3,6,0
364661,1,0,0,0,9,1
255900,1,3,0,3,12,0
306049,3,10,13,-3,17,1
46939,4,20,30,-10,5,0
79655,4,24,21,3,2,0
178522,3,16,13,3,12,0
209574,3,41,20,21,8,0
152642,2,7,6,1,17,1
411674,4,34,28,6,13,1
247614,4,19,23,-4,8,0
10376,3,10,38,-28,5,1
50145,3,0,17,-17,6,0
96773,3,7,10,-3,10,1
126520,2,7,6,1,6,1
123104,5,24,21,3,4,1
374310,3,14,13,1,13,1
191025,4,26,9,17,17,1
177055,1,3,0,3,11,0
262286,2,10,9,1,15,0
55894,4,19,22,-3,9,1
324871,2,10,10,0,8,0
332179,3,3,13,-10,12,1
300970,4,27,27,0,15,0
282895,5,23,23,0,6,1
75381,1,7,0,7,17,0
320460,3,17,17,0,6,1
344969,3,10,14,-4,17,0
348820,2,3,13,-10,2,0
238899,4,41,21,20,4,0
254351,4,13,27,-14,11,0
113165,3,41,7,34,17,1
171618,2,6,3,3,9,0
353262,2,28,17,11,4,0
124987,2,3,3,0,5,1
349255,1,0,21,-21,2,1
410007,4,6,41,-35,12,0
220157,4,26,13,13,13,1
194882,2,0,10,-10,2,0
227479,3,16,10,6,16,1
410992,1,7,7,0,13,1
176942,2,10,3,7,11,1
216289,1,0,0,0,12,1
303001,4,20,16,4,16,1
383497,2,7,3,4,17,1
190510,2,10,6,4,17,1
310216,4,24,10,14,2,1
128976,3,28,10,18,7,1
180507,3,21,20,1,13,1
321910,3,14,21,-7,7,0
394084,4,16,23,-7,5,0
131892,4,31,7,24,8,0
4003,1,0,0,0,2,0
2093,2,7,13,-6,1,1
237342,2,0,0,0,3,0
210518,4,9,28,-19,9,1
345832,1,0,7,-7,17,0
217023,3,19,3,16,12,1
118362,1,3,7,-4,2,1
179131,3,9,13,-4,12,1
23799,3,17,0,17,12,0
290656,2,34,10,24,10,1
229968,2,0,3,-3,17,1
6420,3,9,20,-11,3,1
208474,2,17,7,10,8,1
377055,1,0,7,-7,15,0
45769,3,10,14,-4,4,1
280301,3,16,16,0,5,1
189969,3,13,7,6,17,0
30053,4,33,7,26,14,1
143200,2,7,3,4,13,0
256748,3,3,6,-3,12,0
356615,1,0,0,0,5,0
345991,1,0,0,0,1,0
245940,4,13,37,-24,7,1
290961,2,17,10,7,10,1
127875,1,0,0,0,6,1
179397,2,6,13,-7,12,0
46753,2,7,3,4,4,0
246770,2,3,6,-3,8,1
192756,2,0,6,-6,1,0
167576,4,3,17,-14,7,1
71525,4,33,14,19,16,0
260027,1,0,7,-7,14,1
293614,1,7,0,7,12,0
320823,1,3,4,-1,6,0
116064,4,16,7,9,1,0
83345,2,0,14,-14,4,1
102784,2,10,3,7,13,1
315202,3,10,10,0,4,0
202330,4,13,6,7,5,0
4846,1,0,0,0,3,1
170965,4,44,20,24,8,1
96355,4,3,30,-27,10,1
254906,2,17,7,10,12,1
101526,2,10,14,-4,12,1
65008,2,0,14,-14,13,1
258753,4,3,34,-31,13,0
125025,3,3,12,-9,5,1
86123,2,28,3,25,5,1
381479,1,14,0,14,17,0
255271,4,13,17,-4,12,0
41668,3,24,7,17,2,1
326119,4,30,3,27,9,0
384529,1,0,20,-20,1,0
359121,2,7,0,7,6,0
252200,4,23,24,-1,10,1
225721,1,0,0,0,16,1
276649,3,17,6,11,4,1
227785,3,3,14,-11,16,1
144867,2,14,6,8,14,0
367825,2,10,7,3,10,0
335020,3,16,10,6,13,0
267066,2,3,0,3,17,0
370010,2,10,7,3,12,1
260570,4,30,8,22,14,0
330397,3,10,20,-10,11,1
188658,1,0,0,0,16,1
238445,1,0,0,0,4,1
2594,4,10,26,-16,2,0
83061,2,6,14,-8,4,1
67139,1,0,0,0,14,1
289152,2,13,7,6,9,0
357840,2,6,24,-18,6,1
16716,1,0,0,0,8,1
102303,2,10,10,0,13,1
372219,4,9,25,-16,13,1
129533,2,3,14,-11,7,1
81138,3,13,14,-1,3,1
395125,4,24,34,-10,5,1
266358,3,17,0,17,16,1
234556,4,20,20,0,2,1
352342,1,7,0,7,3,0
308900,4,17,23,-6,1,0
118941,1,0,10,-10,3,1
159865,2,17,0,17,3,1
204519,1,0,0,0,6,0
382114,3,21,3,18,17,1
77623,2,0,7,-7,1,0
243943,4,25,13,12,6,0
126135,1,0,0,0,6,0
137819,1,0,6,-6,11,1
328436,2,3,0,3,10,0
127874,1,0,0,0,6,1
8074,3,17,7,10,4,0
269783,2,10,6,4,1,0
43840,3,21,16,5,3,1
278972,3,7,30,-23,5,1
143273,4,17,16,1,13,1
305672,2,3,7,-4,17,1
241480,4,10,42,-32,5,1
144055,1,7,0,7,14,1
171980,4,21,21,0,9,0
351927,1,7,7,0,3,1
313253,1,3,0,3,3,0
294676,3,6,14,-8,12,1
47427,5,13,13,0,5,1
181710,2,7,7,0,13,0
374076,1,0,0,0,13,0
412265,4,28,15,13,13,0
341436,4,0,16,-16,16,1
346224,3,26,0,26,1,1
290098,4,13,15,-2,10,1
287074,4,26,24,2,8,0
413286,3,17,0,17,14,1
197149,3,24,20,4,3,1
277310,4,0,16,-16,4,1
173811,4,17,3,14,10,1
92963,1,3,0,3,8,1
221924,3,19,16,3,14,0
158888,1,14,0,14,3,0
269837,3,22,10,12,1,0
21854,2,13,0,13,11,1
161244,2,14,3,11,4,1
103315,1,7,3,4,13,0
246130,1,7,0,7,7,0
185791,4,25,3,22,15,0
56721,2,0,10,-10,9,0
38114,4,6,6,0,1,1
137235,2,7,13,-6,11,1
126070,3,14,3,11,6,0
141667,2,23,14,9,13,0
70674,4,17,22,-5,15,1
121281,4,31,30,1,3,1
286772,4,20,28,-8,8,0
178102,5,26,26,0,12,0
273002,2,3,3,0,2,1
28558,3,33,7,26,14,0
213823,2,35,0,35,10,1
174681,3,9,7,2,10,1
359954,4,30,30,0,6,1
349041,4,17,17,0,2,1
372514,4,23,17,6,13,0
415169,3,3,24,-21,15,1
47850,3,10,6,4,5,0
130148,2,0,9,-9,8,0
314594,2,7,0,7,3,0
360292,2,0,13,-13,7,1
111546,3,21,10,11,16,1
118099,2,3,13,-10,2,1
414426,3,7,23,-16,14,1
49263,4,17,10,7,6,1
398909,3,10,10,0,7,0
325815,3,6,10,-4,9,0
181073,2,10,7,3,13,1
109618,4,25,14,11,16,1
153125,3,13,17,-4,1,1
343777,2,7,3,4,17,0
214217,1,0,3,-3,11,1
212064,4,17,40,-23,9,1
368228,1,0,0,0,11,0
219467,2,0,14,-14,13,0
188448,3,3,6,-3,16,0
345176,4,15,9,6,17,1
125600,2,14,10,4,5,1
105372,2,23,7,16,14,1
396962,1,7,0,7,6,0
79774,3,20,7,13,2,0
388155,3,3,6,-3,2,0
119682,4,20,19,1,3,0
106925,3,12,3,9,14,0
259274,2,13,6,7,13,0
314217,3,14,20,-6,3,0
125158,2,17,7,10,5,1
253359,1,7,7,0,11,0
154026,3,10,21,-11,1,1
291578,3,20,3,17,11,1
266934,2,13,7,6,17,1
222179,2,10,10,0,14,1
324722,3,13,7,6,8,1
37337,2,14,0,14,17,0
344549,3,0,0,0,17,1
245438,3,9,6,3,7,0
224057,4,14,9,5,15,1
40349,4,9,7,2,2,0
288043,1,0,0,0,9,1
263874,1,0,0,0,15,1
244880,4,7,10,-3,7,0
334189,1,0,0,0,13,0
275848,1,3,0,3,3,0
378740,3,14,7,7,15,0
379413,1,0,0,0,16,0
168511,4,17,30,-13,7,0
229000,3,14,16,-2,17,1
229876,3,13,14,-1,17,1
418970,1,7,7,0,16,0
48936,4,15,13,2,5,1
192374,4,27,27,0,1,0
169746,1,0,7,-7,8,1
58802,4,18,29,-11,10,1
415712,2,7,10,-3,15,1
329308,1,6,14,-8,10,0
136545,1,0,10,-10,11,1
270959,1,0,7,-7,1,1
241863,3,13,6,7,5,1
364913,4,13,23,-10,9,1
57355,3,14,3,11,10,0
301746,2,0,17,-17,15,0
183603,1,0,0,0,14,0
105533,2,29,14,15,14,0
258161,4,13,13,0,13,0
317414,4,7,17,-10,5,0
288918,4,26,31,-5,9,0
230656,1,0,7,-7,1,1
99595,2,0,3,-3,11,0
219208,3,13,3,10,13,0
2611,4,13,27,-14,2,0
118363,1,3,7,-4,2,1
298700,3,13,14,-1,14,0
212868,1,0,0,0,10,0
370805,4,26,17,9,12,1
177329,1,0,0,0,11,1
335302,3,3,9,-6,13,0
134877,1,7,0,7,10,1
174275,1,0,0,0,10,0
82057,4,17,7,10,3,0
251641,1,3,3,0,10,0
360600,2,7,10,-3,7,1
350297,2,14,0,14,2,0
293843,4,24,19,5,12,1
347539,4,28,37,-9,1,0
161677,1,0,0,0,4,1
284260,1,0,0,0,7,1
50195,1,0,0,0,6,1
191922,1,0,0,0,1,0
99210,3,23,17,6,11,1
110254,1,0,3,-3,16,1
72911,2,10,7,3,16,1
340509,3,0,34,-34,15,1
312768,1,0,0,0,3,1
187224,2,0,6,-6,16,1
36269,4,24,27,-3,17,0
131314,1,0,0,0,8,0
197526,1,0,0,0,3,1
58308,4,26,13,13,10,1
48865,2,6,0,6,5,1
246516,3,19,7,12,8,1
214704,1,3,0,3,11,0
348587,4,28,17,11,2,0
225394,4,27,35,-8,15,0
238983,3,14,12,2,4,1
198956,3,13,23,-10,3,1
385492,4,35,17,18,1,1
320909,4,3,14,-11,6,1
48059,1,0,0,0,5,1
152476,2,10,7,3,17,1
37469,2,0,7,-7,17,0
17991,3,16,21,-5,9,1
260666,3,10,22,-12,14,0
80777,2,3,0,3,3,0
87997,2,10,0,10,6,0
721,4,6,24,-18,1,0
413063,1,13,7,6,14,0
82902,2,3,3,0,4,0
192051,4,31,27,4,1,0
287173,3,10,13,-3,8,0
100771,2,6,3,3,12,0
290027,2,7,0,7,10,0
403248,4,31,24,7,9,0
412655,3,13,10,3,14,0
345440,3,0,19,-19,17,1
136341,4,18,14,4,11,1
347758,2,7,0,7,1,0
324838,2,3,3,0,8,1
416736,2,0,0,0,15,1
331539,1,0,14,-14,11,1
38988,3,30,10,20,1,0
416277,1,10,3,7,15,0
116100,1,0,0,0,1,0
1105,3,10,36,-26,1,0
336249,2,10,0,10,13,0
400960,2,16,7,9,8,1
171248,1,0,0,0,9,1
360692,1,0,7,-7,7,1
287239,4,16,23,-7,8,1
326035,2,9,0,9,9,1
305144,3,21,10,11,16,1
222168,2,7,10,-3,14,1
249545,3,14,10,4,9,0
335942,1,0,9,-9,13,1
396450,4,20,25,-5,6,1
335695,2,7,7,0,13,1
222377,4,24,3,21,14,0
366840,2,3,3,0,10,0
59338,3,0,6,-6,11,0
111372,2,0,7,-7,16,1
20052,4,19,16,3,10,1
332626,3,27,12,15,12,0
74041,1,3,0,3,17,1
231702,1,0,0,0,1,0
407793,4,10,7,3,11,1
337997,4,23,0,23,14,1
175303,4,15,19,-4,10,1
395588,1,0,3,-3,6,1
418393,1,14,0,14,16,0
334690,2,15,3,12,13,1
310707,1,3,0,3,2,0
244658,2,7,23,-16,7,0
231931,4,7,41,-34,1,1
319168,3,2,3,-1,5,0
267067,2,3,0,3,17,0
265717,1,0,0,0,16,1
109774,4,20,0,20,16,1
189582,2,0,0,0,17,1
289142,2,13,6,7,9,0
177430,3,17,10,7,11,0
288061,2,7,0,7,9,1
271917,3,17,13,4,2,0
360128,1,7,3,4,7,1
74252,3,3,10,-7,17,1
2851,3,31,24,7,2,1
4186,2,7,6,1,2,1
228699,3,19,23,-4,17,0
206693,2,0,13,-13,7,0
203326,2,14,24,-10,6,0
396255,2,3,3,0,6,0
128785,2,10,10,0,7,0
278914,2,7,16,-9,5,0
298834,3,21,9,12,14,1
421219,2,6,7,-1,17,1
386421,4,23,17,6,2,1
73132,4,13,17,-4,16,0
141571,4,34,18,16,13,0
117343,3,21,0,21,2,1
318711,2,10,20,-10,5,0
91548,4,26,10,16,8,0
214041,4,43,14,29,10,0
121812,2,0,7,-7,4,0
295871,2,7,14,-7,12,1
269287,4,13,19,-6,17,1
18284,2,10,17,-7,9,1
126449,1,0,3,-3,6,1
286088,3,10,3,7,8,0
371679,1,0,0,0,12,1
45884,2,7,3,4,4,0
213068,3,17,3,14,10,0
391862,2,13,10,3,4,1
283713,2,0,0,0,7,0
211289,1,3,0,3,9,0
168744,3,10,6,4,7,1
116700,2,6,10,-4,2,1
209775,4,16,6,10,8,1
14932,3,14,24,-10,7,1
2312,4,13,17,-4,1,1
356088,4,34,16,18,5,0
281471,2,7,10,-3,6,0
376982,3,15,16,-1,15,0
312194,2,7,7,0,2,0
365299,3,10,16,-6,9,0
223295,4,3,12,-9,15,1
79084,4,19,21,-2,2,1
201513,3,25,7,18,5,0
85801,3,13,13,0,5,0
394881,2,0,17,-17,5,1
18934,4,9,27,-18,9,1
209051,2,3,10,-7,8,1
351548,3,0,27,-27,3,1
187118,3,10,0,10,16,1
186446,2,10,10,0,15,0
285607,3,20,17,3,8,1
330619,1,0,0,0,11,1
174849,3,16,17,-1,10,0
169012,2,19,14,5,7,0
337010,2,13,0,13,14,0
192751,2,0,6,-6,1,0
260163,1,0,0,0,14,1
303071,1,0,7,-7,16,1
12215,2,0,0,0,6,1
65612,3,6,9,-3,13,0
103726,4,3,17,-14,13,1
339054,1,0,0,0,15,0
227404,1,0,7,-7,16,0
313097,1,0,0,0,3,1
111841,3,6,10,-4,17,1
191404,3,0,31,-31,17,0
184760,2,14,7,7,15,1
268551,1,7,3,4,17,1
371131,1,0,6,-6,12,0
293911,2,7,21,-14,12,1
80767,2,3,0,3,3,0
128608,1,3,7,-4,7,0
416571,1,0,0,0,15,1
151266,1,0,0,0,17,1
298285,4,20,13,7,14,1
418857,2,6,10,-4,16,1
302911,1,13,0,13,16,0
263292,2,10,0,10,15,0
391753,3,10,10,0,4,0
344139,3,20,3,17,17,1
360666,4,17,34,-17,7,0
283528,1,6,7,-1,7,1
234181,2,10,10,0,2,1
404644,3,20,19,1,10,0
243440,3,3,17,-14,6,1
205707,4,20,19,1,7,0
169553,4,10,35,-25,8,1
66266,1,0,0,0,14,0
182849,4,36,20,16,14,0
348279,4,16,46,-30,1,1
278726,1,0,0,0,5,0
15011,1,0,13,-13,7,1
196864,3,10,20,-10,3,0
46150,1,7,7,0,4,0
3263,2,3,0,3,2,0
320759,3,17,23,-6,6,0
325318,2,12,10,2,8,0
17440,4,17,7,10,9,0
334053,1,0,0,0,13,0
9648,3,12,21,-9,5,1
97098,3,34,6,28,10,0
334177,4,30,14,16,13,0
111863,4,13,10,3,17,1
340735,1,0,7,-7,15,1
300584,1,0,0,0,15,1
285265,2,14,6,8,7,0
159734,2,7,10,-3,3,1
247568,3,13,16,-3,8,1
113483,4,3,7,-4,17,1
264027,1,7,0,7,15,0
239718,3,7,10,-3,4,1
43592,4,31,3,28,3,1
95607,4,12,13,-1,10,1
164180,2,17,20,-3,5,0
114340,2,17,6,11,1,0
43277,4,24,10,14,3,1
366689,2,17,10,7,10,1
417374,3,13,10,3,16,0
386823,3,13,14,-1,2,1
176815,2,10,7,3,11,0
170300,3,0,12,-12,8,1
54066,3,10,3,7,8,1
19753,3,9,12,-3,10,1
324914,4,17,23,-6,8,1
204892,3,3,13,-10,6,1
15974,3,12,14,-2,8,1
257853,3,7,12,-5,13,1
100484,2,7,10,-3,12,1
393725,3,0,7,-7,5,1
57490,2,20,10,10,10,1
418773,4,14,21,-7,16,0
168568,2,7,10,-3,7,1
315189,2,10,10,0,4,0
3006,3,13,31,-18,2,0
154431,2,14,0,14,1,0
10139,1,0,0,0,5,0
111701,4,31,13,18,16,0
126859,3,10,6,4,6,1
48602,3,21,24,-3,5,0
49027,2,10,7,3,6,0
50323,4,13,23,-10,6,1
228759,1,0,7,-7,17,1
340690,4,19,20,-1,15,0
321660,4,20,20,0,7,0
12233,2,0,3,-3,6,0
286436,3,17,3,14,8,0
418168,3,24,6,18,16,0
94343,3,17,7,10,9,1
408096,4,20,17,3,12,0
146374,2,3,3,0,15,1
146112,4,22,17,5,15,0
315359,2,13,10,3,4,0
67826,1,0,3,-3,14,1
268344,3,20,6,14,17,0
136898,2,0,13,-13,11,1
174323,2,10,0,10,10,0
133545,1,0,0,0,9,1
130735,1,0,0,0,8,0
53409,3,3,21,-18,8,1
278833,4,14,21,-7,5,1
369132,2,13,7,6,11,0
11694,3,17,3,14,6,0
64453,2,14,13,1,13,0
198737,1,3,0,3,3,0
141553,4,33,10,23,13,1
167049,3,13,17,-4,7,0
76761,2,17,0,17,1,1
310800,4,13,13,0,2,0
355089,2,6,13,-7,4,0
164129,1,0,0,0,5,1
220553,3,10,20,-10,13,0
352633,1,0,0,0,3,1
70698,1,7,3,4,15,1
152714,1,0,0,0,17,1
217411,1,3,0,3,12,0
7228,2,0,13,-13,4,0
196584,3,20,13,7,2,0
191898,4,29,16,13,1,1
75488,4,31,7,24,17,1
301100,4,33,13,20,15,1
396230,2,0,3,-3,6,0
356856,4,10,16,-6,5,0
209480,1,0,3,-3,8,1
354047,2,13,0,13,4,1
66732,1,0,3,-3,14,1
24890,4,16,6,10,12,0
307122,1,0,0,0,17,1
24290,4,13,17,-4,12,0
250876,4,10,18,-8,10,1
367215,1,0,0,0,10,1
308358,1,0,3,-3,1,0
191644,1,0,3,-3,17,1
40508,4,7,20,-13,2,1
151952,3,27,24,3,17,1
81724,3,17,17,0,3,0
187648,1,7,3,4,16,1
303028,4,23,19,4,16,0
273556,1,0,0,0,2,1
351345,2,7,7,0,3,1
159320,4,27,24,3,3,0
83249,3,9,10,-1,4,1
208330,2,14,24,-10,8,0
207214,4,17,20,-3,7,1
266400,4,36,8,28,16,1
417873,3,13,10,3,16,1
53347,1,3,7,-4,8,1
186554,5,34,33,1,15,1
280697,2,0,3,-3,5,0
86947,1,7,0,7,5,1
339997,2,14,6,8,15,0
9900,2,0,3,-3,5,1
174028,2,0,13,-13,10,1
131289,4,21,17,4,8,0
216254,4,17,20,-3,12,1
120299,4,24,13,11,3,0
82938,2,3,16,-13,4,1
1445,4,19,7,12,1,1
340973,4,17,17,0,15,0
303034,4,23,19,4,16,1
341500,2,3,7,-4,16,0
405602,3,14,20,-6,10,1
27521,3,23,9,14,13,0
105364,2,23,7,16,14,0
134553,1,0,0,0,10,1
68452,1,0,0,0,14,0
58861,2,3,9,-6,10,1
415133,2,0,21,-21,15,1
330026,1,0,0,0,11,0
369032,4,13,7,6,11,0
247080,2,2,3,-1,8,1
48503,1,11,0,11,5,0
92469,4,23,10,13,8,1
39493,4,13,19,-6,1,1
149826,2,3,10,-7,16,0
197173,3,27,27,0,3,1
34584,3,17,0,17,16,0
159139,4,31,7,24,3,1
192312,3,27,10,17,1,0
387026,4,14,28,-14,2,0
280873,3,16,3,13,6,0
157306,4,19,3,16,2,0
254162,3,3,12,-9,11,1
163438,3,7,20,-13,5,0
307569,1,0,0,0,17,1
350248,4,34,0,34,2,0
417860,3,10,10,0,16,1
180746,2,0,3,-3,13,1
40466,3,7,14,-7,2,0
158472,2,3,7,-4,3,0
340574,1,0,0,0,15,1
223008,4,13,23,-10,14,0
351078,3,21,16,5,3,0
34697,2,3,3,0,16,1
343232,3,16,0,16,16,1
373281,4,16,23,-7,13,0
379321,3,3,6,-3,16,1
66246,4,45,3,42,13,0
149083,2,14,7,7,16,0
186791,3,26,7,19,15,0
230121,2,3,10,-7,17,1
253210,2,0,7,-7,11,1
320204,1,7,0,7,6,0
10990,4,9,28,-19,5,0
378166,3,21,16,5,15,1
5543,3,16,10,6,3,0
317512,3,10,27,-17,5,1
85653,2,23,7,16,5,1
114739,4,15,17,-2,1,0
386753,1,0,0,0,2,1
256524,1,0,0,0,12,1
325736,1,0,7,-7,9,0
319374,4,23,28,-5,6,0
3430,2,3,16,-13,2,1
100921,2,7,3,4,12,0
67587,2,0,20,-20,14,1
64821,1,0,0,0,13,1
18997,2,7,0,7,10,0
153181,4,20,20,0,1,1
165772,1,0,0,0,6,0
178162,2,0,7,-7,12,0
280297,3,16,16,0,5,0
84574,2,10,7,3,4,0
82113,1,0,0,0,3,0
241063,1,7,0,7,5,1
158625,2,7,7,0,3,1
76634,2,10,0,10,1,1
306770,3,16,27,-11,17,1
367472,4,36,24,12,10,0
337026,2,13,0,13,14,1
314092,4,30,20,10,3,1
301419,1,3,0,3,15,1
138262,1,0,0,0,11,1
154202,4,10,13,-3,1,0
56463,3,0,38,-38,9,0
365442,3,10,19,-9,9,0
225443,1,0,0,0,15,1
46954,4,20,36,-16,5,0
374947,1,0,6,-6,14,1
89275,4,15,0,15,7,0
88853,4,13,16,-3,6,1
369053,4,20,13,7,11,0
10782,2,7,0,7,5,1
366452,4,34,10,24,10,0
35964,4,3,7,-4,17,1
85623,2,7,0,7,5,1
231418,1,0,6,-6,1,1
83464,4,10,23,-13,4,0
112814,1,0,0,0,17,1
177560,2,10,0,10,11,0
143949,2,0,10,-10,14,0
284224,4,9,26,-17,7,1
16685,4,14,30,-16,8,1
18724,2,3,7,-4,9,1
270497,1,0,7,-7,1,1
189095,4,31,30,1,16,0
416183,2,10,12,-2,15,1
178883,1,0,0,0,12,0
233898,3,14,6,8,2,0
198154,2,7,3,4,3,1
404147,2,6,6,0,10,0
97405,3,9,23,-14,10,1
248173,3,6,10,-4,8,1
321973,4,31,28,3,7,0
364532,2,3,14,-11,9,1
28310,1,0,0,0,14,1
119651,4,17,12,5,3,0
279492,2,10,6,4,5,0
194154,2,3,3,0,1,0
120495,5,39,41,-2,3,1
206916,4,10,23,-13,7,0
380870,1,0,0,0,16,0
191468,1,0,0,0,17,0
276599,1,7,3,4,4,1
334944,1,0,7,-7,13,1
316133,3,24,19,5,4,1
297247,3,21,6,15,13,0
34469,4,38,3,35,16,1
67899,3,16,3,13,14,1
17501,2,13,0,13,9,0
100217,3,17,0,17,12,0
31894,2,6,7,-1,15,0
267639,1,0,14,-14,17,1
97103,3,34,6,28,10,0
45376,4,20,16,4,4,0
74521,2,0,3,-3,17,1
218226,4,37,3,34,12,1
57304,2,7,0,7,10,0
351724,4,21,17,4,3,0
296662,3,3,16,-13,13,1
245662,1,3,0,3,7,0
417378,3,13,17,-4,16,1
177699,2,13,14,-1,12,1
272815,1,20,0,20,2,0
11906,1,0,0,0,6,1
325871,1,0,0,0,9,1
197345,4,20,10,10,3,1
46243,4,21,31,-10,4,1
411872,1,7,0,7,13,0
241176,4,20,10,10,5,0
302990,3,20,16,4,16,1
91269,1,7,0,7,8,0
318809,1,0,0,0,5,1
377703,3,25,7,18,15,0
2985,2,10,17,-7,2,1
256077,1,0,9,-9,12,0
93872,2,14,3,11,9,1
123855,4,17,3,14,5,1
186408,1,3,0,3,15,0
90642,4,20,33,-13,7,1
95680,2,10,3,7,10,0
55761,1,0,0,0,9,1
268923,3,6,33,-27,17,1
21197,4,0,16,-16,10,0
363718,3,16,13,3,8,1
392722,4,16,6,10,4,0
103743,4,10,23,-13,13,0
269112,4,16,16,0,17,0
417334,2,10,3,7,16,0
140403,1,0,0,0,12,1
328626,3,17,35,-18,10,1
31704,1,0,0,0,15,1
57853,4,22,17,5,10,1
390117,3,17,21,-4,3,1
384349,4,16,10,6,1,0
354746,1,6,3,3,4,1
309746,4,26,9,17,1,0
336945,4,21,21,0,14,0
237313,1,0,0,0,3,1
78886,3,17,7,10,2,0
235787,4,20,27,-7,3,1
301982,4,27,20,7,15,0
277525,2,3,7,-4,4,1
131534,3,6,13,-7,8,0
360425,2,7,0,7,7,1
402654,4,26,23,3,9,1
66573,1,0,14,-14,14,1
346851,3,16,3,13,1,0
184191,1,7,0,7,14,0
264452,4,19,28,-9,15,1
358004,3,24,13,11,6,1
142820,4,12,10,2,13,0
14431,2,17,3,14,7,0
219677,3,10,14,-4,13,1
372116,2,3,7,-4,13,1
220852,3,7,28,-21,14,1
48132,3,7,6,1,5,0
251695,2,14,3,11,10,1
374729,3,0,33,-33,14,0
284935,2,7,14,-7,7,1
265561,1,0,0,0,16,0
14663,4,27,14,13,7,1
140298,2,14,6,8,12,0
334339,1,0,3,-3,13,1
83554,3,0,17,-17,4,0
56810,4,17,20,-3,9,0
237040,1,0,14,-14,3,0
338247,3,27,24,3,14,0
152722,1,0,0,0,17,1
27096,4,17,9,8,13,1
204038,4,16,7,9,6,0
236592,4,19,9,10,3,1
232023,2,0,10,-10,1,1
268403,1,7,0,7,17,1
89953,2,2,7,-5,7,0
198042,3,3,30,-27,3,0
12830,2,13,3,10,6,0
756,1,0,0,0,1,1
152204,2,14,0,14,17,1
137246,3,7,13,-6,11,0
327242,2,6,3,3,9,0
354520,4,33,28,5,4,1
89649,2,3,10,-7,7,1
218070,4,21,24,-3,12,1
217987,2,14,10,4,12,1
256478,4,19,24,-5,12,0
307232,4,9,10,-1,17,1
385868,1,0,0,0,1,1
98740,3,28,6,22,11,1
202901,3,28,0,28,5,0
145596,2,21,0,21,14,0
319073,4,20,38,-18,5,0
279758,4,30,6,24,5,0
63014,2,6,21,-15,12,1
129825,1,10,0,10,7,0
176019,3,17,0,17,11,1
122988,2,0,3,-3,4,1
164189,2,17,21,-4,5,0
254301,3,6,16,-10,11,0
359667,4,40,7,33,6,0
222903,2,7,3,4,14,0
144264,3,15,7,8,14,1
213627,1,7,6,1,10,0
26853,1,10,0,10,13,0
307340,3,14,19,-5,17,1
371143,2,0,9,-9,12,0
276200,3,24,3,21,3,0
315421,4,23,30,-7,4,0
370431,2,7,6,1,12,1
173277,1,7,10,-3,10,1
188373,2,3,0,3,16,0
246098,4,26,20,6,7,0
404021,2,3,21,-18,10,1
403985,1,0,7,-7,10,1
73389,3,23,3,20,17,1
355432,3,13,13,0,4,0
321892,2,14,21,-7,7,1
21802,1,0,0,0,11,1
5981,4,17,23,-6,3,0
153857,2,0,3,-3,1,1
403051,4,24,24,0,9,0
137029,1,7,0,7,11,0
353279,3,28,20,8,4,0
362996,4,33,16,17,8,0
91303,2,7,0,7,8,0
37739,1,7,0,7,1,1
314353,3,10,17,-7,3,1
419258,1,0,0,0,16,0
231201,4,10,7,3,1,0
263531,4,20,26,-6,15,0
224455,2,9,10,-1,15,0
223772,1,0,0,0,15,1
250261,1,0,0,0,9,1
261221,2,21,0,21,14,0
132522,1,2,13,-11,9,1
377434,3,7,13,-6,15,0
414255,2,21,21,0,14,0
292344,3,12,13,-1,11,0
230397,2,7,0,7,1,0
286333,4,25,19,6,8,0
366222,1,0,0,0,10,1
311497,3,10,10,0,2,1
345363,1,0,7,-7,17,0
180597,1,7,6,1,13,0
180587,1,7,3,4,13,0
337119,1,0,0,0,14,0
118540,2,17,3,14,2,0
66199,2,24,3,21,13,0
66648,3,7,17,-10,14,0
350269,1,7,0,7,2,0
271998,1,0,0,0,2,1
340220,3,23,31,-8,15,1
190845,3,16,3,13,17,0
358064,1,0,0,0,6,0
417898,4,13,10,3,16,1
308403,3,0,18,-18,1,1
321386,1,7,9,-2,7,0
81023,4,20,23,-3,3,1
279613,4,10,16,-6,5,1
175666,2,10,3,7,11,1
86819,2,9,6,3,5,0
310916,3,3,6,-3,2,1
137206,2,7,3,4,11,1
28030,1,6,7,-1,13,1
84957,1,6,7,-1,4,1
28874,4,23,7,16,14,0
114274,4,17,24,-7,1,0
220674,2,10,0,10,13,1
203668,3,14,20,-6,6,0
198424,2,3,3,0,3,1
43598,4,31,3,28,3,0
377850,2,20,7,13,15,1
178432,1,0,0,0,12,0
320522,1,7,0,7,6,0
240022,3,10,20,-10,5,1
387534,2,3,0,3,2,0
390052,1,7,0,7,3,0
357922,1,0,0,0,6,0
389684,4,24,16,8,3,1
52789,1,0,23,-23,7,0
227407,1,0,7,-7,16,1
333429,4,23,13,10,12,1
89062,2,6,6,0,6,0
216504,2,27,8,19,12,0
44697,2,0,9,-9,3,1
55344,1,0,0,0,9,1
311232,3,6,0,6,2,1
119335,4,14,16,-2,3,1
326849,4,10,17,-7,9,0
273812,3,10,7,3,2,1
325479,3,19,3,16,8,0
301163,2,13,11,2,15,0
60703,3,21,3,18,11,1
264471,4,20,35,-15,15,1
140219,5,13,13,0,12,0
106838,1,0,0,0,14,1
66371,3,14,24,-10,14,0
342427,3,10,3,7,16,1
25302,3,37,14,23,12,0
15475,2,9,0,9,8,1
16868,1,0,7,-7,8,1
384579,2,9,42,-33,1,1
184753,1,14,0,14,15,0
123364,3,21,17,4,4,1
13951,4,24,21,3,7,1
290757,1,0,0,0,10,0
20041,3,19,9,10,10,1
293489,2,10,3,7,11,0
115942,4,20,30,-10,1,0
301166,2,13,11,2,15,0
137609,4,34,34,0,11,1
97107,3,34,6,28,10,1
254833,4,20,13,7,11,0
1725,4,28,0,28,1,1
258969,2,0,13,-13,13,0
149060,2,7,7,0,16,0
128692,4,6,20,-14,7,1
373002,1,0,0,0,13,1
205773,1,7,0,7,7,0
314810,3,28,7,21,4,0
129076,2,17,21,-4,7,0
52939,2,14,7,7,7,0
58230,2,7,3,4,10,0
393347,1,7,7,0,5,1
118863,3,27,7,20,2,1
49274,4,20,17,3,6,1
155719,3,13,20,-7,2,0
178044,4,13,23,-10,12,0
94767,1,3,3,0,9,0
135681,3,14,10,4,10,0
47249,4,12,9,3,5,1
236793,2,3,9,-6,3,0
182679,3,3,19,-16,14,1
31214,4,23,34,-11,15,1
247487,4,20,19,1,8,1
315363,2,13,10,3,4,0
268005,3,14,9,5,17,0
183254,3,10,20,-10,14,1
73480,2,3,14,-11,17,0
289335,3,28,17,11,9,0
374173,3,23,15,8,13,1
15158,1,0,0,0,8,1
316331,4,17,26,-9,4,1
176498,2,9,17,-8,11,1
232849,4,16,17,-1,2,0
391613,4,10,24,-14,4,1
274308,4,32,18,14,3,0
72943,3,17,7,10,16,1
221837,1,0,0,0,14,1
49949,2,21,0,21,6,0
119178,4,13,7,6,3,1
27741,1,7,7,0,13,0
239507,1,0,0,0,4,1
256145,3,24,16,8,12,0
134892,2,7,13,-6,10,1
195258,4,23,17,6,2,0
85526,3,14,12,2,5,1
109093,1,7,0,7,15,0
120774,4,23,6,17,3,1
152171,1,7,0,7,17,0
285755,2,7,10,-3,8,1
203939,2,3,7,-4,6,0
131616,1,0,3,-3,8,1
110692,1,0,0,0,16,0
159917,3,38,7,31,3,0
41169,2,0,7,-7,2,0
185273,3,27,9,18,15,0
179505,1,0,13,-13,12,0
166950,4,16,9,7,6,0
18402,1,0,0,0,9,0
364266,3,0,26,-26,9,1
139481,4,34,10,24,12,0
123920,2,0,0,0,5,1
99040,2,6,0,6,11,1
244292,4,26,7,19,6,0
115172,4,13,27,-14,1,0
277375,2,17,9,8,4,1
207559,2,14,0,14,7,0
241406,3,7,28,-21,5,0
347445,2,6,13,-7,1,0
259277,2,13,7,6,13,1
141925,1,7,0,7,13,1
404140,2,6,0,6,10,0
414115,2,3,10,-7,14,1
186188,3,16,12,4,15,0
182408,1,0,0,0,14,0
342441,3,10,3,7,16,1
308592,3,9,16,-7,1,0
50308,4,13,16,-3,6,0
156080,4,20,24,-4,2,1
417477,2,10,14,-4,16,0
232607,1,0,0,0,1,0
54000,1,0,0,0,8,1
163605,3,14,19,-5,5,0
414286,3,21,28,-7,14,0
144951,4,20,7,13,14,0
904,1,0,0,0,1,0
224015,2,14,6,8,15,1
256717,2,0,6,-6,12,1
278299,2,14,0,14,4,0
402764,3,24,7,17,9,0
8951,4,28,13,15,4,0
129460,4,23,23,0,7,0
361117,4,23,16,7,7,0
387042,1,0,7,-7,2,1
234376,4,17,10,7,2,0
47855,3,10,6,4,5,0
109331,4,20,3,17,15,0
369655,1,6,0,6,11,1
33950,2,0,27,-27,16,1
157999,1,0,3,-3,3,0
408750,2,10,7,3,12,0
274752,4,24,20,4,3,0
321203,4,3,19,-16,6,1
115804,1,0,0,0,1,1
216384,4,14,23,-9,12,1
24338,1,3,0,3,12,1
375989,4,20,15,5,14,1
387024,4,14,28,-14,2,0
165043,2,10,17,-7,6,0
201567,4,32,28,4,5,0
54396,4,24,19,5,8,1
324192,1,0,0,0,8,0
398461,2,7,3,4,7,1
124341,4,41,27,14,5,1
277384,2,17,9,8,4,0
239044,4,36,21,15,4,1
142001,3,13,14,-1,13,0
276328,2,14,14,0,3,0
236717,4,30,7,23,3,1
11847,3,34,17,17,6,1
274347,1,3,7,-4,3,0
62951,1,0,0,0,12,0
79016,2,10,7,3,2,0
389490,2,13,3,10,3,1
107978,4,6,20,-14,15,1
295857,2,7,14,-7,12,0
311978,4,35,17,18,2,1
7010,4,13,7,6,3,1
342946,4,37,17,20,16,0
289430,1,0,0,0,10,0
121762,4,28,49,-21,4,0
176244,4,14,27,-13,11,0
401994,3,3,9,-6,9,0
178964,3,12,3,9,12,0
335386,1,0,0,0,13,0
2670,2,6,0,6,2,0
204809,4,28,30,-2,6,0
153374,1,0,10,-10,1,1
129356,2,16,7,9,7,1
385201,4,21,20,1,1,1
15090,4,10,26,-16,7,1
279218,2,10,6,4,5,1
302048,2,13,16,-3,15,0
230967,1,0,0,0,1,0
149831,2,3,10,-7,16,1
372144,2,9,7,2,13,0
208271,1,0,7,-7,8,1
402798,4,30,20,10,9,1
27872,1,0,0,0,13,1
401242,2,7,14,-7,8,1
405156,4,12,10,2,10,0
352362,2,14,6,8,3,0
269571,4,24,31,-7,1,1
210902,3,12,3,9,9,1
26663,1,0,0,0,13,1
338524,3,20,17,3,14,0
30421,2,10,13,-3,14,0
319722,4,33,16,17,6,1
158459,1,0,7,-7,3,1
241279,3,3,0,3,5,1
347459,2,6,13,-7,1,1
169042,3,26,14,12,7,1
159525,2,7,6,1,3,0
387858,2,10,28,-18,2,1
398823,4,21,24,-3,7,1
369831,1,0,0,0,12,0
332902,3,24,0,24,12,0
225196,2,3,7,-4,15,1
3284,2,3,3,0,2,0
252094,1,7,7,0,10,0
44995,2,10,3,7,4,1
88637,3,20,10,10,6,1
64418,2,0,3,-3,13,0
232817,3,16,14,2,2,0
343521,4,10,10,0,16,0
389432,1,0,0,0,3,1
292244,1,0,0,0,11,1
348235,3,16,17,-1,1,0
71061,3,27,0,27,16,0
360535,1,0,7,-7,7,1
227915,3,27,13,14,16,0
273180,3,24,0,24,2,0
186439,2,10,10,0,15,1
276206,3,24,3,21,3,0
401943,1,0,3,-3,9,1
177954,2,7,3,4,12,1
71782,4,38,33,5,16,0
336800,4,10,23,-13,14,1
203195,3,10,17,-7,5,0
66042,2,7,0,7,13,0
233605,3,20,34,-14,2,0
146725,4,14,32,-18,15,0
415123,2,0,14,-14,15,0
31934,3,6,13,-7,15,1
10008,1,0,0,0,5,1
78115,2,7,3,4,2,1
350908,3,3,14,-11,3,0
124270,2,24,17,7,5,0
277613,4,12,21,-9,4,0
297369,2,6,10,-4,13,1
326953,2,2,0,2,9,0
344851,3,30,10,20,17,0
47015,2,17,0,17,5,1
269576,4,24,31,-7,1,0
297467,1,0,0,0,13,0
350543,1,7,0,7,2,0
131141,4,27,12,15,8,1
348085,3,0,19,-19,1,0
64205,3,31,6,25,13,0
411819,4,0,34,-34,13,1
390983,2,13,21,-8,4,1
2476,4,28,20,8,2,0
323687,3,20,0,20,8,1
95756,1,0,0,0,10,1
96690,1,0,7,-7,10,1
276908,2,14,0,14,4,0
77813,2,7,14,-7,1,0
99369,4,23,10,13,11,1
314700,4,17,28,-11,3,1
322371,3,14,13,1,7,0
419734,2,10,10,0,17,0
53718,3,7,0,7,8,0
3265,2,3,0,3,2,0
338431,4,30,24,6,14,0
165918,1,0,7,-7,6,1
372201,4,9,16,-7,13,0
190343,1,6,0,6,17,1
161877,2,13,9,4,4,1
317553,4,16,27,-11,5,1
371434,2,7,7,0,12,1
155954,1,0,7,-7,2,1
292074,4,22,19,3,11,1
206266,3,10,6,4,7,0
391005,3,20,27,-7,4,1
276803,2,17,17,0,4,1
250830,3,3,9,-6,10,1
125970,4,16,23,-7,6,1
236745,1,0,0,0,3,0
266007,1,0,0,0,16,1
284512,4,24,15,9,7,1
39560,2,0,6,-6,1,1
76567,4,7,41,-34,1,1
261508,2,6,0,6,14,1
253513,1,0,7,-7,11,0
82110,1,0,0,0,3,0
82107,1,0,0,0,3,1
280138,2,21,0,21,5,0
185041,1,0,3,-3,15,1
290758,1,0,0,0,10,0
193383,2,7,17,-10,1,1
243369,1,0,6,-6,6,0
333160,1,0,0,0,12,0
392614,2,7,0,7,4,0
193396,2,10,17,-7,1,0
106187,4,0,10,-10,14,1
119169,4,10,7,3,3,1
281246,4,27,19,8,6,1
57849,4,22,17,5,10,1
61051,4,34,19,15,11,1
18876,3,9,6,3,9,0
219527,3,9,21,-12,13,0
222043,3,17,10,7,14,0
51377,4,22,23,-1,7,1
347674,4,20,17,3,1,0
109262,2,6,0,6,15,0
85299,2,7,3,4,5,1
25103,2,3,0,3,12,1
68110,4,3,10,-7,14,1
409112,3,3,10,-7,12,1
94013,2,6,21,-15,9,0
39851,2,6,0,6,1,0
358668,1,0,0,0,6,1
268913,3,6,30,-24,17,0
338346,2,3,0,3,14,0
306096,4,26,13,13,17,1
364875,3,6,20,-14,9,1
169727,4,23,17,6,8,1
98170,4,21,19,2,11,1
297570,4,21,7,14,13,0
231649,3,14,13,1,1,1
337279,1,0,0,0,14,0
214752,3,3,13,-10,11,0
267054,1,3,0,3,17,1
73431,4,30,3,27,17,0
159187,1,7,7,0,3,1
105051,2,6,14,-8,14,0
298936,2,3,6,-3,14,0
298547,3,13,0,13,14,0
102092,4,42,17,25,12,0
143183,2,7,3,4,13,1
14345,4,2,13,-11,7,0
263671,4,27,10,17,15,0
233061,1,0,0,0,2,1
203171,2,0,17,-17,5,1
264777,3,10,23,-13,16,1
24262,4,13,17,-4,12,0
26394,2,10,0,10,13,0
203933,2,3,7,-4,6,0
371398,1,7,7,0,12,1
138789,2,0,26,-26,12,1
364283,3,3,29,-26,9,1
105136,4,33,14,19,14,1
120745,3,23,0,23,3,0
174210,3,3,23,-20,10,0
74760,1,0,0,0,17,1
283718,2,0,0,0,7,0
386253,4,14,17,-3,2,1
198528,4,17,12,5,3,0
14199,4,0,31,-31,7,0
188011,4,23,14,9,16,0
358782,4,21,20,1,6,0
89928,1,0,7,-7,7,1
88651,3,20,10,10,6,0
307779,2,17,7,10,1,1
368821,2,7,0,7,11,0
133001,2,6,14,-8,9,1
375052,4,28,27,1,14,0
367202,4,29,26,3,10,1
85601,1,7,0,7,5,0
63477,3,28,13,15,12,1
337945,3,20,0,20,14,0
156071,4,20,24,-4,2,0
10203,3,6,3,3,5,1
86111,2,28,3,25,5,0
66175,2,17,3,14,13,1
230099,1,0,3,-3,17,0
252895,1,3,0,3,11,1
48404,2,3,17,-14,5,1
110746,2,3,3,0,16,1
293092,4,10,20,-10,11,0
180283,2,6,7,-1,13,1
190371,2,7,0,7,17,1
34054,1,0,0,0,16,1
185876,2,9,9,0,15,0
145708,1,0,7,-7,15,0
192834,3,7,15,-8,1,0
155762,4,27,30,-3,2,1
167307,2,9,10,-1,7,1
3563,2,14,7,7,2,0
114938,2,0,3,-3,1,1
41651,3,17,7,10,2,1
407084,2,0,13,-13,11,1
347810,3,10,0,10,1,0
144823,1,14,0,14,14,1
405320,4,14,10,4,10,0
327718,3,6,13,-7,10,0
315217,3,17,10,7,4,1
186795,3,26,7,19,15,1
86554,2,23,3,20,5,1
420871,4,17,34,-17,17,0
335526,1,0,0,0,13,0
273806,3,10,7,3,2,0
36540,4,13,20,-7,17,1
389694,4,27,16,11,3,0
86556,2,23,3,20,5,0
130101,4,17,36,-19,8,0
392289,1,0,7,-7,4,0
139276,3,13,13,0,12,1
78023,3,12,16,-4,1,1
385776,3,20,0,20,1,0
96154,2,0,16,-16,10,0
363588,4,10,15,-5,8,1
420952,2,7,14,-7,17,1
175062,1,0,0,0,10,0
405173,4,12,16,-4,10,1
201067,4,41,7,34,5,0
21410,2,6,7,-1,11,1
217317,3,0,10,-10,12,0
77928,1,3,0,3,1,0
288967,2,16,0,16,9,0
97023,2,13,0,13,10,0
40352,4,9,7,2,2,1
87581,3,17,3,14,6,0
155415,3,13,10,3,2,1
217084,1,0,0,0,12,1
47300,1,0,7,-7,5,0
68409,4,3,21,-18,14,0
105687,3,28,3,25,14,0
337861,1,0,0,0,14,1
106416,2,13,0,13,14,0
95472,4,43,7,36,10,0
319335,3,13,21,-8,6,1
76645,2,10,0,10,1,0
146922,1,0,0,0,15,1
304310,2,7,0,7,16,0
77621,2,0,7,-7,1,1
162366,3,10,10,0,4,0
255028,2,3,9,-6,12,0
373098,3,9,21,-12,13,1
22666,4,30,23,7,11,0
305161,4,27,10,17,16,0
355403,2,10,10,0,4,0
323825,3,13,15,-2,8,0
362821,3,7,21,-14,8,1
249166,1,0,0,0,9,1
25354,1,3,0,3,12,0
27841,4,17,17,0,13,0
152123,4,13,13,0,17,1
128642,2,3,10,-7,7,1
281632,2,21,0,21,6,0
352859,3,14,10,4,3,0
384531,1,0,21,-21,1,1
293644,2,10,7,3,12,0
215518,4,13,3,10,11,0
260667,3,10,22,-12,14,0
349117,2,7,0,7,2,0
406616,1,0,0,0,11,0
394676,4,24,21,3,5,0
160089,4,23,39,-16,3,1
105523,2,26,14,12,14,1
398742,2,14,17,-3,7,0
244340,2,0,7,-7,7,1
308670,1,0,6,-6,1,1
310253,1,3,0,3,2,0
27209,3,19,7,12,13,0
54007,1,0,0,0,8,0
23532,4,17,17,0,11,0
383480,1,0,3,-3,17,0
187025,1,0,0,0,16,0
417572,1,0,0,0,16,1
199836,3,3,17,-14,4,0
163719,2,0,9,-9,5,1
172724,3,14,10,4,9,0
273158,2,10,0,10,2,1
297735,4,24,23,1,13,0
295825,1,0,0,0,12,0
336313,3,20,10,10,13,0
82686,4,12,13,-1,3,0
242461,2,3,7,-4,6,0
187365,2,14,7,7,16,0
142945,3,3,13,-10,13,1
172694,2,14,3,11,9,1
413488,4,24,38,-14,14,1
359312,2,3,13,-10,6,1
399743,2,0,10,-10,8,0
412737,1,0,7,-7,14,1
399730,2,0,3,-3,8,0
117936,2,7,6,1,2,1
105526,2,26,14,12,14,1
9189,3,3,16,-13,5,1
103817,2,9,0,9,13,1
282255,3,12,14,-2,6,1
235615,4,27,27,0,3,0
82750,2,6,6,0,3,0
389265,4,31,7,24,3,1
50880,3,7,17,-10,6,0
15632,3,21,10,11,8,0
162793,2,0,0,0,5,0
220850,3,7,28,-21,14,1
333066,3,10,12,-2,12,1
61463,4,24,17,7,11,0
155023,1,6,12,-6,1,0
121714,3,21,14,7,4,0
391921,4,23,27,-4,4,0
286100,3,10,10,0,8,0
412916,2,6,3,3,14,0
235530,2,3,13,-10,3,1
147203,1,0,7,-7,15,1
156273,1,0,0,0,2,1
92323,4,20,0,20,8,0
209660,1,6,0,6,8,0
103823,3,9,0,9,13,0
215312,2,14,7,7,11,0
252669,3,6,3,3,10,1
104924,3,3,6,-3,14,1
62501,4,13,16,-3,12,1
69274,2,13,0,13,15,0
171638,3,19,10,9,9,0
247262,2,28,14,14,8,0
270804,1,3,0,3,1,0
413246,2,10,0,10,14,0
359885,2,20,21,-1,6,0
363392,2,14,10,4,8,0
348520,2,28,7,21,2,0
183989,3,22,3,19,14,0
270217,2,3,13,-10,1,0
10513,3,20,0,20,5,0
222938,2,13,13,0,14,0
165223,2,7,7,0,6,1
6455,4,15,20,-5,3,1
310101,1,7,0,7,2,0
283368,1,0,0,0,7,1
287782,2,21,10,11,9,1
98983,1,0,0,0,11,1
389321,2,7,6,1,3,1
57971,4,13,17,-4,10,0
242817,4,21,34,-13,6,0
196854,3,3,20,-17,3,1
241036,1,0,0,0,5,0
130862,4,20,15,5,8,1
222517,3,15,14,1,14,1
116626,4,13,3,10,2,1
206903,4,10,20,-10,7,1
137829,2,0,6,-6,11,1
276108,4,34,3,31,3,1
329337,2,6,20,-14,10,1
27791,3,14,14,0,13,0
410752,3,19,6,13,13,0
346904,4,23,16,7,1,1
386123,4,24,16,8,1,1
55447,4,20,10,10,9,0
62261,2,21,7,14,12,0
41603,2,7,0,7,2,1
37228,3,10,14,-4,17,1
63816,4,14,34,-20,12,1
105655,2,7,3,4,14,1
249178,1,9,0,9,9,0
159287,4,24,24,0,3,1
201696,4,24,20,4,5,0
263457,2,6,13,-7,15,0
27908,2,0,3,-3,13,1
263543,4,20,29,-9,15,1
92452,4,20,10,10,8,1
97697,3,9,10,-1,11,0
193243,3,3,10,-7,1,0
46230,4,14,31,-17,4,1
390402,3,7,27,-20,3,1
414552,3,21,3,18,14,1
85009,2,25,7,18,4,1
362061,2,14,7,7,8,0
183626,2,0,0,0,14,0
384350,4,16,10,6,1,0
50220,1,7,7,0,6,0
294672,2,6,14,-8,12,1
347071,1,0,0,0,1,0
398090,3,24,28,-4,7,0
366953,1,0,13,-13,10,0
44967,1,0,0,0,4,1
381320,1,6,0,6,16,0
255410,4,24,6,18,12,1
304254,4,33,14,19,16,0
311234,3,6,0,6,2,1
388365,4,17,12,5,2,0
42536,4,10,21,-11,3,1
234763,1,0,0,0,2,0
304412,4,31,21,10,16,0
30004,2,20,0,20,14,0
218060,4,21,24,-3,12,0
163245,2,3,3,0,5,0
67921,3,19,3,16,14,1
46121,1,0,0,0,4,1
250328,3,7,7,0,9,1
30446,3,17,28,-11,14,1
351031,2,7,10,-3,3,0
157784,4,20,10,10,2,0
34621,4,24,7,17,16,0
335840,2,14,7,7,13,1
182888,1,0,9,-9,14,0
250270,1,7,0,7,9,0
205418,4,27,0,27,6,0
384650,1,0,7,-7,1,1
194201,4,6,17,-11,1,1
353448,4,25,6,19,4,0
214284,3,14,10,4,11,0
136371,1,0,0,0,11,0
51037,3,0,17,-17,6,0
404727,1,7,3,4,10,0
246036,2,7,13,-6,7,1
36594,1,3,0,3,17,1
352397,2,34,7,27,3,1
3946,4,19,14,5,2,1
404888,1,0,3,-3,10,1
186541,4,24,33,-9,15,1
376320,1,0,0,0,14,1
380617,1,7,0,7,16,0
276848,4,26,20,6,4,0
328448,2,3,0,3,10,0
282970,2,14,3,11,6,1
224460,2,9,10,-1,15,0
3444,2,3,23,-20,2,1
192086,1,0,3,-3,1,0
353877,3,10,21,-11,4,0
63345,3,17,3,14,12,1
119518,4,14,24,-10,3,0
318237,1,3,0,3,5,1
292251,1,0,0,0,11,0
410908,3,14,15,-1,13,1
284159,2,6,13,-7,7,0
46842,1,7,0,7,5,1
268979,1,0,0,0,17,0
70469,3,17,17,0,15,0
393379,2,21,13,8,5,0
162763,1,0,0,0,5,1
176868,4,17,16,1,11,1
348264,4,16,46,-30,1,1
83945,1,7,0,7,4,1
46485,3,27,6,21,4,1
223611,1,6,0,6,15,0
234215,3,20,10,10,2,0
355494,4,23,27,-4,4,1
408394,4,19,14,5,12,0
203219,4,10,17,-7,5,1
90836,1,7,0,7,7,1
200108,2,7,10,-3,4,0
113595,2,6,0,6,17,0
222661,3,14,17,-3,14,0
306772,3,16,27,-11,17,1
292331,3,12,13,-1,11,1
5399,3,13,16,-3,3,0
212954,3,14,7,7,10,0
303306,3,27,0,27,16,1
225094,4,13,14,-1,15,0
45338,3,20,16,4,4,0
310208,4,24,10,14,2,0
97894,4,21,27,-6,11,0
335970,2,0,15,-15,13,1
139884,4,23,24,-1,12,1
141726,4,30,21,9,13,0
223906,4,30,6,24,15,0
192255,2,10,3,7,1,0
100516,3,10,17,-7,12,0
310154,3,21,7,14,2,1
364118,2,14,3,11,9,1
45248,1,0,0,0,4,0
106036,4,24,3,21,14,1
415548,2,0,0,0,15,0
103686,3,0,10,-10,13,1
11026,1,0,0,0,5,1
197867,2,11,7,4,3,0
151730,2,7,3,4,17,1
382738,4,9,20,-11,17,1
393896,4,20,20,0,5,1
305228,2,14,14,0,16,0
150127,2,3,13,-10,16,1
224294,2,9,9,0,15,1
263179,2,3,14,-11,15,1
417834,2,10,0,10,16,0
288886,4,13,24,-11,9,0
270577,3,13,14,-1,1,1
142325,3,0,3,-3,13,0
76739,1,0,0,0,1,1
332734,2,21,6,15,12,0
284686,4,17,27,-10,7,0
394054,3,9,13,-4,5,0
8002,1,3,0,3,4,0
298282,4,20,13,7,14,1
407533,2,10,0,10,11,0
166031,4,20,21,-1,6,0
268556,1,7,3,4,17,0
369124,2,13,7,6,11,0
129352,2,14,7,7,7,1
100557,4,20,20,0,12,0
109945,4,23,16,7,16,0
6164,4,7,27,-20,3,1
208414,1,0,0,0,8,0
11309,1,0,0,0,6,1
271197,4,21,20,1,1,0
134326,2,16,14,2,10,0
255998,3,19,12,7,12,0
1157,4,10,36,-26,1,1
165658,2,0,7,-7,6,0
76780,2,24,0,24,1,1
123052,4,7,13,-6,4,1
234052,3,20,0,20,2,0
114985,3,13,12,1,1,0
86501,1,6,0,6,5,1
50851,2,7,14,-7,6,1
406737,4,41,7,34,11,1
363828,2,13,17,-4,8,1
229582,3,27,13,14,17,1
407670,1,0,0,0,11,0
419165,2,10,6,4,16,0
373185,2,3,3,0,13,0
114710,4,15,10,5,1,0
400865,4,31,19,12,8,0
159330,4,27,31,-4,3,1
244261,3,23,7,16,6,1
151673,4,23,41,-18,17,1
412427,1,0,0,0,14,0
164975,4,10,19,-9,6,1
135989,2,3,10,-7,10,1
2906,4,31,34,-3,2,0
374007,3,10,7,3,13,1
200011,3,24,17,7,4,0
115319,4,20,15,5,1,0
416118,1,0,0,0,15,0
288170,1,0,0,0,9,1
233757,3,13,27,-14,2,1
15542,4,23,6,17,8,0
207452,3,14,14,0,7,0
298802,2,14,6,8,14,0
318384,1,13,0,13,5,1
283715,2,0,0,0,7,0
345184,1,0,0,0,17,1
57321,2,7,0,7,10,1
325790,3,6,10,-4,9,0
157140,4,16,20,-4,2,1
232304,2,3,3,0,1,0
67817,1,0,3,-3,14,1
192738,1,0,3,-3,1,1
291808,1,0,0,0,11,1
165212,2,7,7,0,6,1
47540,3,37,6,31,5,0
89477,1,0,0,0,7,1
357460,4,31,33,-2,5,1
173986,1,0,0,0,10,1
379683,1,3,0,3,16,0
16636,3,7,27,-20,8,1
91971,3,13,23,-10,8,0
102041,2,21,3,18,12,0
313029,3,17,0,17,3,1
225242,4,17,7,10,15,0
280276,2,13,13,0,5,0
43451,1,0,0,0,3,1
303394,1,10,0,10,16,1
259828,1,0,0,0,14,0
66899,2,6,7,-1,14,1
24854,3,13,3,10,12,0
294594,1,0,0,0,12,0
394987,1,0,6,-6,5,0
141262,4,10,24,-14,13,1
254169,3,3,12,-9,11,0
3559,1,14,7,7,2,0
204563,2,0,35,-35,6,1
292716,1,7,7,0,11,1
122626,4,27,7,20,4,1
369461,4,45,7,38,11,0
60709,3,21,3,18,11,0
103961,3,3,10,-7,13,1
130475,2,3,3,0,8,0
86107,2,28,3,25,5,0
318600,3,10,10,0,5,0
78878,3,17,0,17,2,1
390953,2,10,0,10,4,0
140635,3,31,10,21,12,1
344186,1,0,0,0,17,0
230373,1,0,0,0,1,0
394533,4,10,28,-18,5,0
41455,2,2,7,-5,2,1
213755,1,0,0,0,10,1
250643,2,3,12,-9,10,0
252581,1,0,0,0,10,1
367737,4,13,13,0,10,0
170443,3,21,3,18,8,0
182628,2,0,6,-6,14,1
25276,3,27,7,20,12,0
189750,2,7,6,1,17,1
178512,3,16,13,3,12,1
327103,2,7,0,7,9,0
302537,4,3,13,-10,15,1
311238,3,6,0,6,2,0
135524,2,14,6,8,10,0
32951,2,0,17,-17,15,1
197662,1,0,0,0,3,0
106629,3,37,7,30,14,1
53276,3,3,7,-4,8,0
373905,4,43,16,27,13,0
64972,1,0,0,0,13,0
188593,4,12,13,-1,16,1
85542,4,17,19,-2,5,1
98511,4,31,24,7,11,0
32312,1,0,0,0,15,0
416750,2,7,0,7,15,0
392455,1,0,0,0,4,0
240294,2,7,7,0,5,1
136190,4,13,10,3,10,0
80372,3,20,9,11,2,1
319133,2,2,0,2,5,0
237133,4,8,33,-25,3,1
338716,4,27,17,10,14,1
61198,1,0,0,0,11,0
240991,4,21,22,-1,5,1
243201,1,0,0,0,6,0
187306,4,10,13,-3,16,1
239828,2,0,0,0,4,1
210301,2,6,10,-4,9,1
281440,2,0,10,-10,6,0
248915,2,17,0,17,9,0
13146,2,10,16,-6,6,1
172409,3,13,42,-29,9,1
329945,3,7,10,-3,11,1
143136,4,37,27,10,13,0
150180,3,6,26,-20,16,1
376035,1,0,0,0,14,0
359001,2,10,0,10,6,1
97668,3,3,3,0,11,0
420636,2,13,16,-3,17,1
161729,2,17,3,14,4,0
28910,1,0,0,0,14,1
269978,3,16,13,3,1,0
354370,3,45,3,42,4,0
297700,3,10,13,-3,13,1
135115,3,31,6,25,10,0
249270,4,26,14,12,9,1
115994,2,13,0,13,1,1
288053,1,7,0,7,9,0
299779,4,17,14,3,14,0
137195,1,7,0,7,11,0
140115,2,7,0,7,12,1
10155,1,0,0,0,5,0
190289,4,7,14,-7,17,1
227591,2,28,0,28,16,1
117533,4,17,17,0,2,0
219006,2,14,0,14,13,1
389263,4,31,7,24,3,1
62963,1,0,7,-7,12,0
326087,3,30,3,27,9,1
36590,1,3,0,3,17,0
14215,4,0,37,-37,7,0
377001,4,15,16,-1,15,0
285225,1,0,3,-3,7,1
320025,4,43,30,13,6,0
340852,4,24,27,-3,15,1
153683,1,2,14,-12,1,0
369682,2,16,7,9,11,0
216273,1,0,0,0,12,1
167863,2,7,16,-9,7,0
340752,2,7,7,0,15,1
205286,1,3,0,3,6,1
409266,3,13,13,0,12,0
61080,1,0,0,0,11,1
32967,2,0,24,-24,15,1
103223,3,3,7,-4,13,1
360748,2,17,21,-4,7,1
335994,2,13,15,-2,13,0
373465,1,0,0,0,13,0
184089,2,9,7,2,14,0
180966,3,17,21,-4,13,1
19524,1,0,0,0,10,0
380444,4,10,24,-14,16,1
248373,1,0,0,0,8,1
180892,1,7,0,7,13,0
403390,4,26,11,15,9,1
158563,4,13,17,-4,3,1
347106,2,10,3,7,1,0
404883,1,0,3,-3,10,1
389510,3,20,10,10,3,1
23195,3,23,6,17,11,0
410442,3,9,17,-8,13,0
377233,2,7,0,7,15,0
375840,4,20,7,13,14,1
9430,2,3,0,3,5,0
43292,1,0,0,0,3,0
33439,4,20,20,0,16,0
57922,2,13,16,-3,10,0
218855,2,13,3,10,13,1
183448,4,27,6,21,14,0
170200,4,30,30,0,8,1
343807,3,21,3,18,17,0
421622,1,3,0,3,17,0
74269,3,10,17,-7,17,1
370323,3,14,35,-21,12,0
314940,3,0,10,-10,4,0
10867,4,27,21,6,5,1
305116,3,21,10,11,16,1
277778,4,17,6,11,4,1
677,3,0,17,-17,1,1
192026,4,24,20,4,1,0
110808,4,6,10,-4,16,0
267624,1,0,0,0,17,1
40489,4,7,20,-13,2,1
149318,4,20,27,-7,16,1
283139,3,6,9,-3,7,1
31613,2,17,6,11,15,0
328959,3,16,7,9,10,1
203210,3,10,17,-7,5,1
250813,3,3,9,-6,10,1
52078,3,13,10,3,7,0
170154,3,7,13,-6,8,1
79553,1,0,0,0,2,0
26745,3,6,17,-11,13,1
39322,4,17,27,-10,1,1
46558,1,0,0,0,4,0
192221,4,6,33,-27,1,1
136658,4,22,19,3,11,0
195937,2,0,17,-17,2,1
74948,2,17,7,10,17,0
388789,3,14,0,14,3,1
233563,2,14,14,0,2,0
298923,1,0,6,-6,14,0
116622,3,13,3,10,2,0
115755,4,13,16,-3,1,0
192376,4,27,27,0,1,0
245320,4,16,13,3,7,1
335170,3,20,7,13,13,0
314264,4,24,23,1,3,0
316939,3,17,18,-1,4,1
415714,2,14,10,4,15,0
138979,3,14,6,8,12,0
139889,4,23,24,-1,12,0
407150,3,17,27,-10,11,0
249746,4,21,21,0,9,1
252171,3,20,10,10,10,1
253351,1,7,0,7,11,0
397069,4,21,16,5,6,1
196573,3,20,6,14,2,0
13237,1,0,0,0,7,1
364878,3,6,20,-14,9,1
322900,2,6,0,6,7,1
298910,1,0,3,-3,14,0
108839,3,7,10,-3,15,0
406446,4,31,13,18,11,1
346012,2,0,3,-3,1,1
340580,1,0,0,0,15,1
230258,2,6,10,-4,17,1
135393,3,28,17,11,10,0
104636,3,7,3,4,14,0
32258,3,24,14,10,15,0
176543,4,12,17,-5,11,1
393234,2,14,6,8,5,0
350975,4,21,17,4,3,1
246375,4,20,10,10,7,1
53556,3,14,12,2,8,0
332811,4,35,16,19,12,0
51176,3,24,3,21,7,0
321736,2,6,6,0,7,1
354242,4,20,17,3,4,1
60046,2,7,3,4,11,1
204671,1,0,0,0,6,1
82555,4,17,27,-10,3,0
141099,4,14,17,-3,13,1
124850,2,0,6,-6,5,1
395025,2,0,14,-14,5,0
384553,2,3,28,-25,1,0
365801,4,31,17,14,9,0
163125,2,16,19,-3,5,0
243681,1,7,0,7,6,0
278872,4,21,31,-10,5,0
134577,2,10,3,7,10,0
380805,3,9,21,-12,16,1
65980,1,0,0,0,13,1
252674,3,6,3,3,10,0
206500,1,0,0,0,7,0
201974,3,3,0,3,5,0
111503,2,7,0,7,16,1
206784,1,0,0,0,7,1
136216,1,0,0,0,11,0
240636,3,20,17,3,5,1
5738,1,0,0,0,3,0
246032,2,7,13,-6,7,1
51847,1,0,0,0,7,0
211693,3,23,9,14,9,1
224683,4,19,10,9,15,0
68707,4,24,0,24,15,1
52185,2,0,3,-3,7,1
286814,1,3,0,3,8,0
13454,3,3,21,-18,7,1
320325,4,14,24,-10,6,1
343602,2,15,7,8,17,0
214944,4,7,26,-19,11,0
237838,2,7,13,-6,4,0
113348,4,26,38,-12,17,1
280839,2,10,3,7,6,1
310281,2,17,0,17,2,0
186009,2,10,33,-23,15,0
177022,4,26,13,13,11,0
369580,3,14,0,14,11,0
252097,1,7,7,0,10,0
224397,1,0,0,0,15,1
63468,3,28,13,15,12,0
199617,1,0,0,0,4,0
410068,1,7,7,0,13,1
362438,1,0,0,0,8,0
205043,3,9,17,-8,6,1
182166,3,26,7,19,13,0
180724,1,0,0,0,13,0
398960,4,23,20,3,7,1
411143,2,0,20,-20,13,1
313334,4,13,27,-14,3,1
319085,4,26,41,-15,5,1
230,3,12,10,2,1,0
202272,2,3,0,3,5,1
223030,1,7,0,7,14,0
263785,3,0,21,-21,15,0
412221,3,21,3,18,13,0
30622,3,17,3,14,14,1
375637,3,17,17,0,14,1
177480,4,27,17,10,11,1
386435,4,23,17,6,2,1
230165,3,3,26,-23,17,0
401266,2,10,14,-4,8,0
329188,2,3,6,-3,10,0
204111,2,3,10,-7,6,0
378819,1,0,0,0,15,0
9238,4,10,30,-20,5,0
144721,3,3,0,3,14,1
95459,4,34,7,27,10,1
195580,4,13,7,6,2,1
147481,1,0,0,0,15,1
255627,2,0,7,-7,12,1
408716,1,3,0,3,12,0
195236,3,16,16,0,2,0
104268,2,17,0,17,13,0
397507,4,20,22,-2,6,0
154044,4,17,21,-4,1,1
5914,2,0,16,-16,3,1
416283,1,10,3,7,15,1
1844,3,16,7,9,1,0
120252,2,14,3,11,3,1
327357,1,0,0,0,9,0
109812,1,10,0,10,16,0
351700,4,14,17,-3,3,1
198374,4,20,14,6,3,1
202412,2,3,3,0,5,0
204946,4,13,27,-14,6,0
89945,1,2,7,-5,7,1
265163,1,0,3,-3,16,1
229277,3,24,21,3,17,1
285828,4,14,24,-10,8,0
202066,1,0,0,0,5,1
395690,4,18,34,-16,6,0
85036,3,25,16,9,4,0
2022,4,13,15,-2,1,0
357425,3,24,24,0,5,1
298090,2,3,23,-20,13,0
50304,3,13,16,-3,6,0
272656,1,8,0,8,2,1
127110,2,3,9,-6,6,1
353445,4,25,6,19,4,0
221570,2,20,12,8,14,0
268695,1,0,0,0,17,1
365198,4,14,31,-17,9,0
216122,1,0,0,0,12,1
2993,3,13,24,-11,2,0
219179,2,0,3,-3,13,1
262240,1,3,0,3,15,1
91667,3,21,21,0,8,1
102461,2,3,3,0,13,1
281666,3,24,10,14,6,0
381342,1,6,0,6,16,0
86064,1,13,0,13,5,1
263393,1,0,0,0,15,1
407624,4,10,17,-7,11,0
19018,3,7,3,4,10,1
114400,4,34,13,21,1,0
68267,4,20,30,-10,14,1
41861,1,7,0,7,2,1
333843,3,21,21,0,12,0
152544,4,24,7,17,17,0
218645,4,10,30,-20,13,0
6541,3,3,3,0,3,0
80162,2,7,7,0,2,0
140325,3,17,13,4,12,0
383642,2,0,13,-13,17,0
97739,4,16,13,3,11,0
138214,3,7,12,-5,11,1
278792,2,7,7,0,5,0
360510,4,17,14,3,7,0
327322,4,16,27,-11,9,1
72346,2,0,17,-17,16,0
27805,3,14,14,0,13,0
30408,2,3,13,-10,14,1
355245,2,3,14,-11,4,1
226118,3,7,17,-10,16,0
380153,1,0,0,0,16,1
365370,1,0,0,0,9,1
226466,3,7,10,-3,16,1
237231,3,13,0,13,3,1
30892,3,3,17,-14,15,0
339179,4,29,13,16,15,1
58324,4,27,13,14,10,0
251960,1,0,7,-7,10,0
101902,3,6,13,-7,12,0
228222,3,10,27,-17,17,1
33506,2,14,0,14,16,1
375004,2,21,27,-6,14,0
415376,1,0,0,0,15,0
188252,2,14,7,7,16,1
9067,3,28,13,15,4,0
130637,2,7,21,-14,8,0
294599,1,0,0,0,12,1
82024,3,10,0,10,3,0
133937,3,6,6,0,9,0
261233,3,28,0,28,14,0
170633,4,47,9,38,8,0
103739,4,10,23,-13,13,0
409287,4,13,16,-3,12,1
213598,4,29,14,15,10,0
390544,3,17,7,10,3,0
405254,2,7,7,0,10,1
43653,2,14,3,11,3,0
180740,2,0,3,-3,13,0
152624,2,0,6,-6,17,0
351555,3,0,27,-27,3,1
259990,4,23,20,3,14,0
261159,4,21,24,-3,14,1
114832,3,13,30,-17,1,0
170986,1,7,7,0,8,1
328306,2,3,14,-11,10,1
414846,2,21,7,14,15,0
295481,1,0,0,0,12,1
416655,3,31,7,24,15,1
270945,1,0,0,0,1,0
60112,3,20,19,1,11,1
183566,3,14,17,-3,14,0
371137,1,0,9,-9,12,1
33375,2,13,10,3,16,0
83191,1,3,6,-3,4,0
136954,4,10,13,-3,11,1
137988,2,7,14,-7,11,1
144572,3,7,19,-12,14,1
140951,4,23,13,10,13,0
392885,1,0,0,0,4,0
157994,1,0,3,-3,3,0
397465,3,13,16,-3,6,1
272087,3,10,6,4,2,1
384151,3,14,20,-6,1,0
185736,3,20,3,17,15,0
215500,3,13,3,10,11,0
295886,3,10,14,-4,12,1
173838,4,23,3,20,10,0
357276,3,3,16,-13,5,0
361021,2,9,2,7,7,1
13278,2,0,20,-20,7,1
301507,3,20,15,5,15,1
94241,4,24,30,-6,9,1
222479,2,6,14,-8,14,1
170039,4,35,17,18,8,0
122040,4,19,13,6,4,1
43457,1,0,0,0,3,0
246053,3,10,13,-3,7,0
6118,3,7,10,-3,3,1
120577,2,0,13,-13,3,1
230990,2,7,0,7,1,0
75379,1,6,0,6,17,1
196953,2,14,0,14,3,1
230237,1,6,0,6,17,0
141007,2,7,0,7,13,1
48309,4,16,13,3,5,0
285571,2,7,10,-3,8,0
8937,3,28,0,28,4,0
369944,1,0,0,0,12,1
309630,4,19,3,16,1,0
216364,3,14,16,-2,12,1
193102,3,13,6,7,1,0
361569,4,19,10,9,7,0
373558,3,16,26,-10,13,0
123580,1,0,0,0,4,1
415538,1,0,0,0,15,0
85654,2,24,7,17,5,0
145846,4,13,33,-20,15,0
354945,2,7,3,4,4,0
319287,2,10,3,7,6,0
327728,3,6,13,-7,10,0
46068,3,21,14,7,4,0
120151,4,10,6,4,3,1
147257,2,0,21,-21,15,0
280672,2,0,3,-3,5,1
328849,1,0,0,0,10,0
212656,4,7,31,-24,10,1
232551,4,23,17,6,1,0
16379,3,21,10,11,8,0
307283,1,7,3,4,17,1
335388,1,0,0,0,13,0
191788,1,0,0,0,1,1
405780,4,18,21,-3,10,0
33161,4,17,42,-25,16,0
116812,1,0,0,0,2,1
80072,3,17,15,2,2,0
219895,1,0,0,0,13,1
408789,3,10,25,-15,12,1
322683,4,9,9,0,7,0
25948,1,3,3,0,13,1
127798,3,10,28,-18,6,1
88024,2,24,0,24,6,0
333213,2,0,7,-7,12,1
414994,2,10,10,0,15,0
116406,2,3,3,0,1,0
171499,3,17,10,7,9,0
46424,1,0,0,0,4,0
156505,3,7,6,1,2,0
168710,2,10,3,7,7,1
363625,1,0,0,0,8,1
132226,1,7,0,7,9,1
243690,1,7,0,7,6,0
123207,3,6,21,-15,4,0
72768,2,14,7,7,16,1
235767,4,19,27,-8,3,1
56596,3,19,17,2,9,1
372400,1,6,0,6,13,0
405364,1,0,0,0,10,0
421340,1,3,3,0,17,0
145810,3,13,17,-4,15,1
414509,1,7,3,4,14,1
192387,1,0,0,0,1,1
184385,3,21,6,15,14,0
135409,3,28,17,11,10,0
355387,2,3,3,0,4,0
138748,1,0,0,0,12,0
193249,3,3,16,-13,1,0
383769,1,0,0,0,1,1
265848,1,0,0,0,16,1
142779,3,12,10,2,13,1
216549,3,34,11,23,12,1
208669,4,6,6,0,8,1
29835,2,6,10,-4,14,1
245332,4,23,13,10,7,0
396422,3,20,18,2,6,1
312772,1,0,0,0,3,0
168965,1,0,0,0,7,0
308281,4,13,16,-3,1,0
124642,4,13,17,-4,5,0
316212,1,0,7,-7,4,1
42349,2,7,9,-2,2,1
172067,2,7,3,4,9,1
7804,4,30,9,21,4,0
389747,1,10,0,10,3,0
268499,4,23,9,14,17,1
305866,3,7,14,-7,17,1
201246,1,0,0,0,5,1
193241,3,3,10,-7,1,0
230703,2,6,27,-21,1,1
359826,1,0,0,0,6,0
264167,4,27,27,0,15,0
222648,2,7,7,0,14,0
222184,2,10,10,0,14,1
77272,4,16,10,6,1,1
255022,2,3,9,-6,12,1
343346,2,0,20,-20,16,0
171360,4,16,17,-1,9,1
392738,1,7,0,7,4,0
315897,4,9,26,-17,4,1
404278,1,0,3,-3,10,0
21335,4,12,17,-5,11,1
402698,2,3,0,3,9,1
318769,4,17,26,-9,5,0
372997,1,0,0,0,13,0
245767,4,16,20,-4,7,0
72676,3,13,10,3,16,0
328338,3,3,30,-27,10,1
70180,3,30,14,16,15,1
11958,2,7,0,7,6,1
187250,3,7,6,1,16,1
60630,1,0,3,-3,11,1
345122,3,15,3,12,17,0
364961,1,7,0,7,9,0
76983,4,17,13,4,1,0
125672,4,28,24,4,5,1
109906,4,23,0,23,16,0
349796,4,29,29,0,2,1
417570,4,31,31,0,16,1
353960,5,31,31,0,4,1
244747,1,0,0,0,7,1
369656,1,6,0,6,11,1
367710,3,3,13,-10,10,1
190625,1,14,7,7,17,0
243076,2,0,9,-9,6,0
227240,1,0,10,-10,16,1
355657,4,38,17,21,5,0
350169,2,11,0,11,2,0
84492,4,20,17,3,4,1
124212,1,0,13,-13,5,0
228145,1,7,3,4,17,0
364826,2,3,7,-4,9,0
72894,2,3,7,-4,16,0
105089,3,26,14,12,14,0
67521,4,39,14,25,14,1
155157,1,7,0,7,1,0
333829,3,14,21,-7,12,0
91710,4,21,24,-3,8,0
213395,3,10,27,-17,10,0
27779,2,14,14,0,13,0
63677,4,26,36,-10,12,1
398708,1,0,7,-7,7,0
386412,4,20,17,3,2,1
260663,3,10,22,-12,14,1
292441,2,3,3,0,11,0
381974,2,0,23,-23,17,0
41480,2,5,7,-2,2,1
202502,4,9,16,-7,5,0
176912,1,0,0,0,11,0
104552,1,0,0,0,14,0
373027,2,0,0,0,13,1
155740,4,20,20,0,2,0
310012,3,9,10,-1,2,0
261079,2,0,14,-14,14,0
284346,3,6,17,-11,7,1
402874,3,17,6,11,9,1
143515,3,17,21,-4,14,0
181382,2,14,7,7,13,1
80385,3,27,9,18,2,0
166396,2,9,7,2,6,1
311194,2,3,0,3,2,1
27848,4,17,17,0,13,1
307298,2,14,3,11,17,0
316215,1,0,7,-7,4,1
279946,1,0,10,-10,5,1
313664,4,25,30,-5,3,1
359988,1,3,13,-10,7,0
324214,1,0,0,0,8,1
197490,4,20,9,11,3,0
398279,1,3,0,3,7,0
195669,2,7,7,0,2,0
53368,2,3,7,-4,8,1
6300,4,16,17,-1,3,1
413665,1,7,3,4,14,0
47832,2,10,6,4,5,0
75673,4,16,6,10,17,1
88889,1,9,0,9,6,1
110092,1,0,3,-3,16,1
286606,4,17,38,-21,8,0
403546,1,7,0,7,9,1
2771,1,7,0,7,2,0
413890,4,17,9,8,14,0
254186,4,3,18,-15,11,0
268729,2,7,3,4,17,1
225823,4,24,14,10,16,0
129344,1,14,7,7,7,1
336474,4,17,17,0,14,0
58068,1,7,10,-3,10,1
239110,2,10,10,0,4,1
261936,1,7,3,4,14,0
196219,2,7,3,4,2,0
240771,2,7,7,0,5,1
338402,3,24,10,14,14,1
218521,4,34,17,17,13,0
404266,1,0,3,-3,10,1
385270,2,7,3,4,1,0
167753,4,26,23,3,7,1
310832,4,27,13,14,2,0
11130,4,24,20,4,5,0
197051,4,30,33,-3,3,1
186479,3,10,13,-3,15,1
375339,3,7,17,-10,14,1
238940,2,14,6,8,4,1
27651,3,7,27,-20,13,1
45638,3,13,13,0,4,1
265437,1,0,0,0,16,0
21438,3,12,14,-2,11,0
163523,1,7,3,4,5,1
339430,2,7,17,-10,15,1
323000,1,0,0,0,7,1
258789,1,7,0,7,13,0
374291,3,14,13,1,13,1
45245,1,0,0,0,4,1
21427,2,9,14,-5,11,1
126287,1,0,0,0,6,1
267070,2,3,0,3,17,0
82457,2,7,14,-7,3,0
314769,2,21,0,21,4,0
151799,3,21,16,5,17,0
78165,3,20,3,17,2,0
403082,4,34,27,7,9,0
206963,1,7,0,7,7,1
7737,2,20,3,17,4,1
413576,3,9,17,-8,14,0
228773,1,0,7,-7,17,1
102788,3,10,3,7,13,1
49050,3,10,13,-3,6,0
261102,3,7,21,-14,14,1
358298,3,0,20,-20,6,0
384536,1,0,21,-21,1,0
335681,1,7,6,1,13,0
135897,5,24,24,0,10,1
284534,4,24,15,9,7,1
116350,4,40,13,27,1,0
421792,1,0,3,-3,17,1
242107,1,7,0,7,6,0
100461,2,7,7,0,12,0
227038,3,10,6,4,16,1
103736,4,3,23,-20,13,1
228666,3,16,17,-1,17,0
349591,3,13,28,-15,2,0
177498,4,27,17,10,11,1
261321,1,0,7,-7,14,1
421721,3,17,17,0,17,1
280158,3,28,0,28,5,0
375227,4,24,24,0,14,1
144576,3,7,19,-12,14,1
131703,3,17,22,-5,8,0
247044,1,0,3,-3,8,1
238708,4,19,17,2,4,0
133299,2,7,0,7,9,1
290403,3,26,10,16,10,1
186978,4,10,12,-2,15,0
20555,4,17,0,17,10,0
137923,4,27,15,12,11,0
112696,2,3,0,3,17,1
174783,2,12,7,5,10,1
183961,3,20,3,17,14,0
71926,3,15,13,2,16,0
274155,1,0,0,0,3,1
316763,2,10,7,3,4,1
207284,2,0,7,-7,7,0
178723,4,11,26,-15,12,0
227910,3,27,13,14,16,0
251343,2,14,7,7,10,0
81976,1,0,0,0,3,1
40777,3,17,28,-11,2,1
411401,1,0,0,0,13,1
376960,2,3,16,-13,15,1
47910,1,0,0,0,5,1
130323,2,7,0,7,8,0
372512,4,23,17,6,13,1
256007,4,19,12,7,12,1
378468,3,20,0,20,15,0
105116,3,26,14,12,14,1
289493,3,13,7,6,10,1
53603,4,14,22,-8,8,1
319889,1,0,0,0,6,1
84967,1,9,7,2,4,1
64656,1,0,0,0,13,1
352448,4,38,24,14,3,0
73923,2,14,0,14,17,1
117509,3,14,17,-3,2,1
164712,1,6,0,6,6,0
325061,4,26,24,2,8,0
249269,4,26,14,12,9,1
357731,3,40,13,27,5,0
247083,2,2,3,-1,8,0
277007,4,31,20,11,4,0
393327,1,0,0,0,5,1
39688,2,3,0,3,1,0
37779,2,7,3,4,1,0
339520,1,0,0,0,15,1
340448,1,0,6,-6,15,0
385309,3,14,20,-6,1,1
19014,3,7,3,4,10,0
94553,4,10,10,0,9,0
101325,1,0,0,0,12,1
16231,2,3,3,0,8,0
295582,3,23,25,-2,12,0
411475,3,10,17,-7,13,1
331938,4,6,28,-22,12,0
167436,1,0,0,0,7,0
95365,1,7,0,7,10,1
130494,2,10,3,7,8,0
135114,3,31,6,25,10,0
260273,4,24,3,21,14,0
264594,3,12,17,-5,16,0
60824,2,10,13,-3,11,0
235638,1,0,0,0,3,0
251906,4,14,19,-5,10,1
343846,4,24,3,21,17,1
146698,3,7,29,-22,15,0
334548,2,21,17,4,13,0
184769,2,17,7,10,15,1
245113,2,14,6,8,7,1
265925,2,0,16,-16,16,0
374068,4,24,10,14,13,1
102911,2,6,14,-8,13,0
121502,2,9,0,9,4,0
376365,2,6,0,6,14,1
40328,3,6,7,-1,2,0
129847,2,10,0,10,7,1
332725,2,20,6,14,12,1
414237,2,14,14,0,14,0
346099,4,10,12,-2,1,0
29435,2,7,14,-7,14,0
108019,1,3,0,3,15,0
168971,1,0,7,-7,7,1
134166,2,0,3,-3,10,0
153508,1,2,0,2,1,0
411299,2,0,10,-10,13,1
125558,1,0,7,-7,5,1
214412,2,7,7,0,11,1
286546,2,10,14,-4,8,0
90396,1,0,6,-6,7,0
254044,3,14,13,1,11,0
221501,4,10,41,-31,14,1
341888,4,30,15,15,16,0
334734,3,25,9,16,13,1
400249,3,10,6,4,8,0
142241,1,0,0,0,13,0
26903,3,10,6,4,13,1
54920,2,0,0,0,8,0
389036,2,20,0,20,3,0
163360,1,0,0,0,5,1
316269,2,7,16,-9,4,1
48106,2,7,3,4,5,0
270737,3,6,3,3,1,1
77344,2,7,7,0,1,0
249124,4,28,28,0,9,1
357190,4,18,27,-9,5,1
285931,2,23,6,17,8,0
5221,2,14,17,-3,3,1
234727,4,30,33,-3,2,1
354067,3,16,0,16,4,1
335577,3,9,7,2,13,1
261877,3,6,20,-14,14,1
389630,2,10,10,0,3,0
179937,4,33,9,24,13,1
192074,5,37,34,3,1,1
157774,4,17,10,7,2,1
54648,3,14,22,-8,8,0
151454,2,21,7,14,17,1
36994,4,0,32,-32,17,0
407056,1,0,0,0,11,0
177858,3,20,16,4,12,1
177034,4,26,13,13,11,0
226575,2,3,3,0,16,1
111937,2,7,21,-14,17,0
175723,3,30,6,24,11,1
184586,1,0,0,0,15,1
387627,4,13,6,7,2,0
46566,1,0,0,0,4,1
32582,4,27,13,14,15,1
224722,1,3,0,3,15,0
63792,4,14,24,-10,12,0
268304,2,17,3,14,17,1
72930,2,17,7,10,16,1
162185,2,7,7,0,4,0
312619,1,0,0,0,3,1
197328,3,17,9,8,3,0
92430,3,17,10,7,8,1
240632,3,20,17,3,5,0
373715,3,13,18,-5,13,0
70716,2,7,10,-3,15,0
41399,4,14,15,-1,2,1
203059,3,33,10,23,5,0
133813,4,19,17,2,9,0
210991,1,0,0,0,9,1
135972,2,3,3,0,10,0
208009,2,14,0,14,8,1
313501,4,17,17,0,3,1
389800,3,17,6,11,3,0
109104,2,7,7,0,15,1
320903,4,3,14,-11,6,0
346743,4,27,13,14,1,0
109491,4,12,16,-4,16,1
173750,2,3,3,0,10,1
47516,2,17,6,11,5,1
411234,4,11,23,-12,13,1
318291,3,6,7,-1,5,1
289036,3,26,21,5,9,0
390391,3,7,20,-13,3,0
413578,3,9,17,-8,14,0
254805,4,20,10,10,11,0
77076,2,7,17,-10,1,1
233101,2,8,0,8,2,0
307079,4,24,6,18,17,1
100808,3,9,3,6,12,0
416621,2,21,7,14,15,1
336632,5,7,7,0,14,1
179611,4,28,23,5,12,1
121603,4,22,16,6,4,0
420723,1,0,0,0,17,0
191479,1,7,7,0,17,0
127187,4,13,16,-3,6,1
409820,2,10,0,10,12,0
106710,1,7,5,2,14,0
323063,2,17,14,3,7,1
46700,1,0,0,0,4,0
327582,3,10,15,-5,10,0
168724,3,10,6,4,7,0
228091,4,3,10,-7,17,0
26720,2,3,14,-11,13,0
296474,3,17,0,17,13,0
364199,1,0,0,0,9,0
156595,1,0,0,0,2,0
421448,4,38,20,18,17,1
341454,1,0,0,0,16,0
64647,4,20,24,-4,13,0
376318,1,0,0,0,14,1
130183,2,0,19,-19,8,1
290782,2,3,0,3,10,0
34828,1,0,0,0,16,1
91521,4,19,9,10,8,0
175790,1,0,0,0,11,1
26080,1,0,10,-10,13,1
26327,4,19,21,-2,13,1
140712,2,6,14,-8,12,1
165647,2,0,7,-7,6,1
185785,4,25,3,22,15,1
369111,2,6,7,-1,11,0
241059,1,7,0,7,5,1
390547,3,17,7,10,3,1
31228,4,26,34,-8,15,0
96213,4,3,19,-16,10,0
311037,2,10,0,10,2,0
290949,2,17,7,10,10,0
50319,4,13,23,-10,6,0
410755,3,19,6,13,13,1
28038,1,7,7,0,13,1
127763,2,7,21,-14,6,1
73832,4,13,0,13,17,0
125165,3,17,7,10,5,0
107495,3,3,20,-17,15,1
249877,3,9,20,-11,9,1
68739,4,34,7,27,15,1
171560,1,0,0,0,9,0
230807,4,20,27,-7,1,0
102620,2,12,6,6,13,1
127935,3,23,0,23,6,0
268035,4,21,9,12,17,0
103017,1,0,0,0,13,1
16595,1,7,7,0,8,0
157215,2,7,0,7,2,1
91237,4,20,17,3,8,0
5992,4,17,29,-12,3,0
413210,1,7,0,7,14,0
337037,2,16,0,16,14,1
262148,3,21,6,15,15,1
147913,4,24,31,-7,15,0
402723,2,16,0,16,9,1
37790,3,7,9,-2,1,1
9230,4,3,29,-26,5,0
300169,3,21,3,18,14,0
65485,3,23,14,9,13,1
237568,4,38,20,18,3,0
237969,2,3,3,0,4,1
73618,2,0,0,0,17,0
291797,4,9,23,-14,11,1
67927,3,19,3,16,14,1
273604,2,10,3,7,2,1
383486,1,0,3,-3,17,1
119655,4,17,12,5,3,0
209862,2,13,16,-3,8,1
228508,3,20,7,13,17,0
137077,2,14,3,11,11,1
335255,2,0,3,-3,13,1
189446,2,7,0,7,17,1
412748,1,0,10,-10,14,1
89861,3,16,13,3,7,1
217278,2,0,7,-7,12,1
240200,4,16,6,10,5,0
297736,4,24,23,1,13,1
169632,2,13,0,13,8,1
385961,4,24,21,3,1,0
307102,4,24,6,18,17,1
193226,2,3,7,-4,1,1
48706,2,7,19,-12,5,1
11072,2,10,7,3,5,0
199615,4,41,17,24,4,1
20351,3,10,13,-3,10,0
349294,2,13,21,-8,2,1
398004,1,7,0,7,7,0
68939,1,7,7,0,15,0
244367,2,0,17,-17,7,0
379525,1,0,3,-3,16,1
130411,4,7,6,1,8,1
200993,2,14,0,14,5,0
350669,4,20,10,10,2,0
285281,3,14,6,8,7,0
13587,2,3,7,-4,7,0
73382,3,23,3,20,17,0
324128,3,0,10,-10,8,1
114906,4,31,40,-9,1,1
349152,3,20,7,13,2,0
418099,1,14,0,14,16,0
21530,2,7,7,0,11,0
35712,1,3,0,3,17,1
383692,3,9,24,-15,17,0
49971,2,21,6,15,6,0
399720,1,0,3,-3,8,1
197241,1,0,0,0,3,1
147250,2,0,21,-21,15,1
116026,3,13,7,6,1,1
212056,4,17,40,-23,9,1
216502,2,27,8,19,12,0
174551,3,10,14,-4,10,0
60367,2,10,7,3,11,1
67320,2,14,3,11,14,0
206976,1,21,0,21,7,0
109344,4,20,3,17,15,1
220431,3,23,14,9,13,1
133525,4,30,20,10,9,1
365245,1,3,7,-4,9,0
245719,2,10,10,0,7,1
197965,1,0,3,-3,3,0
199029,1,0,0,0,4,0
102378,4,16,20,-4,13,1
29822,2,6,3,3,14,0
124120,3,10,21,-11,5,1
125563,1,7,7,0,5,0
105550,3,29,14,15,14,1
192947,3,7,17,-10,1,1
189787,3,17,6,11,17,1
318376,1,7,0,7,5,0
23807,3,17,7,10,12,1
366972,2,0,17,-17,10,0
146612,1,0,0,0,15,0
355050,1,0,0,0,4,1
279996,3,3,13,-10,5,1
187956,2,6,7,-1,16,0
92717,2,3,17,-14,8,1
407816,1,3,0,3,11,0
138718,4,28,35,-7,12,0
184583,4,45,21,24,14,0
290646,2,28,7,21,10,0
398157,1,7,3,4,7,1
277428,4,34,15,19,4,0
259852,1,7,7,0,14,0
295229,2,14,5,9,12,1
373728,4,13,21,-8,13,0
212200,3,3,24,-21,10,0
239213,1,0,0,0,4,0
144093,2,13,0,13,14,1
291894,3,10,10,0,11,1
198532,4,17,12,5,3,1
350845,1,0,0,0,3,0
215850,4,51,20,31,11,1
197594,3,19,0,19,3,0
209431,4,14,17,-3,8,1
263138,2,0,7,-7,15,1
134180,2,0,16,-16,10,0
382547,3,0,10,-10,17,0
404427,1,7,0,7,10,1
154577,2,14,7,7,1,0
347165,3,23,17,6,1,1
142733,2,9,10,-1,13,1
316665,4,12,12,0,4,0
153493,1,0,0,0,1,1
343742,1,7,0,7,17,1
333299,1,0,0,0,12,1
229717,3,13,17,-4,17,1
419161,2,10,3,7,16,0
24500,2,0,7,-7,12,1
368667,1,0,10,-10,11,1
143377,3,7,22,-15,14,0
40927,3,16,20,-4,2,1
215762,2,29,3,26,11,0
135166,1,0,0,0,10,1
272644,1,0,0,0,2,1
57047,3,7,20,-13,9,1
310127,2,14,6,8,2,0
276430,1,0,0,0,4,1
364621,4,21,37,-16,9,1
79711,2,7,7,0,2,1
64877,3,10,3,7,13,1
417329,2,7,3,4,16,1
378850,2,7,6,1,15,0
149885,4,6,16,-10,16,0
398235,4,35,17,18,7,0
36157,1,0,7,-7,17,1
171966,4,14,14,0,9,0
200506,4,26,18,8,4,0
243696,1,7,3,4,6,1
79824,1,0,0,0,2,0
60702,3,21,3,18,11,1
398454,2,7,0,7,7,0
172354,2,3,14,-11,9,1
28394,3,13,3,10,14,1
196271,3,21,10,11,2,0
242440,2,0,7,-7,6,0
58937,4,20,32,-12,10,1
98750,3,34,6,28,11,0
88222,4,17,17,0,6,1
224005,2,14,6,8,15,1
361468,1,7,0,7,7,0
385370,1,0,7,-7,1,1
22439,2,24,24,0,11,0
384490,4,28,6,22,1,1
52731,4,12,23,-11,7,1
95062,1,0,7,-7,9,1
311693,4,6,9,-3,2,1
294565,4,31,13,18,12,0
93366,4,30,12,18,9,1
17871,4,24,17,7,9,1
388305,2,10,3,7,2,0
23561,4,17,20,-3,11,1
239257,2,0,7,-7,4,1
26016,3,10,16,-6,13,0
57200,3,13,7,6,10,1
264561,3,10,17,-7,16,0
417519,3,24,21,3,16,0
228442,1,0,0,0,17,1
210703,1,7,0,7,9,1
368291,3,9,6,3,11,1
281615,2,21,0,21,6,0
231406,1,0,0,0,1,0
87876,3,10,12,-2,6,1
153208,4,20,23,-3,1,1
72026,2,7,10,-3,16,1
102558,1,2,0,2,13,1
94724,4,38,43,-5,9,0
57944,3,13,17,-4,10,0
92229,1,7,0,7,8,0
403855,1,10,0,10,10,1
390884,4,15,28,-13,3,0
288321,1,0,0,0,9,1
373847,3,27,3,24,13,0
221545,2,20,12,8,14,0
188793,4,7,20,-13,16,0
250191,3,17,13,4,9,0
77286,4,19,10,9,1,0
393795,1,0,0,0,5,0
160125,1,7,0,7,3,0
5346,2,10,0,10,3,0
113802,4,13,24,-11,17,1
192730,1,0,3,-3,1,0
377017,4,15,19,-4,15,1
38503,2,10,3,7,1,0
309028,4,0,20,-20,1,0
145685,4,42,7,35,14,0
309917,1,0,0,0,2,0
311478,2,10,3,7,2,1
334058,1,0,0,0,13,1
82109,1,0,0,0,3,0
72657,3,13,3,10,16,1
246665,3,31,3,28,8,1
253117,3,21,13,8,11,0
328441,2,3,0,3,10,1
340467,1,0,13,-13,15,0
39956,1,0,0,0,1,1
344504,2,0,0,0,17,1
150142,2,3,13,-10,16,0
133083,4,15,25,-10,9,1
403670,4,37,20,17,9,0
181599,3,16,6,10,13,0
236662,2,10,0,10,3,0
29543,1,0,10,-10,14,0
124175,4,22,21,1,5,0
35391,4,30,23,7,16,0
30769,4,31,28,3,15,0
129124,4,34,28,6,7,0
353449,4,25,12,13,4,0
2839,3,24,24,0,2,0
56390,1,0,20,-20,9,0
213746,1,0,0,0,10,0
179118,3,9,13,-4,12,1
7872,2,3,14,-11,4,0
123286,1,7,6,1,4,0
304539,4,10,21,-11,16,1
178524,3,16,13,3,12,0
299556,2,3,3,0,14,1
271238,1,0,0,0,1,1
180543,4,21,22,-1,13,0
166733,2,13,3,10,6,0
372320,3,24,10,14,13,0
157239,2,7,3,4,2,1
332670,4,34,20,14,12,0
107435,1,0,3,-3,15,0
89627,1,3,0,3,7,1
249240,3,19,7,12,9,0
187707,3,16,6,10,16,0
282145,4,23,8,15,6,1
21243,2,3,0,3,11,0
367090,1,7,0,7,10,0
42123,4,27,27,0,2,0
28829,2,10,7,3,14,1
416112,4,21,13,8,15,0
175813,2,14,3,11,11,1
124365,1,0,0,0,5,0
59412,1,0,6,-6,11,0
145606,2,21,0,21,14,0
221503,4,10,41,-31,14,1
251911,4,20,19,1,10,0
308231,2,7,10,-3,1,1
91916,2,0,3,-3,8,1
65681,1,0,7,-7,13,1
145420,2,0,13,-13,14,0
400359,2,17,10,7,8,0
21541,2,7,7,0,11,0
241382,2,7,14,-7,5,1
153170,4,20,17,3,1,0
95771,1,0,0,0,10,1
271528,1,0,0,0,2,0
171434,1,0,0,0,9,1
131109,3,20,9,11,8,0
150467,3,27,6,21,16,0
107787,3,7,20,-13,15,0
329776,2,17,13,4,11,1
331393,1,3,7,-4,11,1
31854,1,0,0,0,15,1
286592,3,17,31,-14,8,0
400751,1,0,0,0,8,1
191189,1,0,10,-10,17,1
80887,1,3,0,3,3,1
396639,4,23,17,6,6,1
13922,3,21,7,14,7,0
146391,3,10,3,7,15,1
216587,4,40,18,22,12,1
53731,3,7,3,4,8,0
254590,2,7,14,-7,11,0
183878,4,44,28,16,14,1
387071,2,7,14,-7,2,1
318602,3,10,10,0,5,0
396380,2,20,12,8,6,0
103254,3,3,10,-7,13,1
122163,4,24,21,3,4,1
365967,1,13,7,6,10,1
66867,2,0,7,-7,14,0
151978,4,34,27,7,17,0
157861,2,6,9,-3,3,0
170940,4,31,20,11,8,1
207018,2,28,0,28,7,0
185255,3,24,9,15,15,0
112332,4,45,17,28,17,0
410493,4,15,26,-11,13,1
338456,1,7,0,7,14,0
294772,1,0,7,-7,12,1
413653,1,0,3,-3,14,1
172800,1,0,0,0,9,0
127397,4,24,23,1,6,0
208911,2,7,6,1,8,1
386734,1,0,0,0,2,0
199026,1,0,0,0,4,1
357430,3,24,24,0,5,1
102258,1,7,0,7,13,0
89004,4,39,10,29,6,1
179078,2,3,6,-3,12,1
47549,3,37,6,31,5,1
10017,1,7,0,7,5,0
264775,3,10,16,-6,16,0
235631,1,0,0,0,3,0
36294,1,7,0,7,17,0
170614,4,41,9,32,8,0
367438,3,20,21,-1,10,1
154346,4,27,24,3,1,1
122305,3,6,19,-13,4,0
16253,3,6,16,-10,8,1
1257,3,10,13,-3,1,1
82629,3,12,10,2,3,1
3753,2,13,9,4,2,0
237116,4,8,33,-25,3,1
397317,3,0,24,-24,6,1
103081,3,27,7,20,13,1
113767,3,3,17,-14,17,0
27811,3,14,14,0,13,0
37984,4,17,14,3,1,0
394543,1,0,0,0,5,1
147350,1,0,0,0,15,0
107656,3,13,23,-10,15,0
191899,4,29,16,13,1,1
107953,3,6,6,0,15,0
72928,2,17,7,10,16,1
387003,4,14,21,-7,2,0
69800,1,7,0,7,15,0
183400,2,17,3,14,14,1
134013,1,6,0,6,9,0
393691,2,0,0,0,5,1
196067,2,3,21,-18,2,1
323173,2,0,0,0,7,1
62993,2,6,13,-7,12,0
293246,3,23,7,16,11,1
246263,4,24,16,8,7,0
418788,4,14,24,-10,16,0
331326,3,0,27,-27,11,1
149235,2,7,6,1,16,0
270334,5,27,27,0,1,1
195101,4,7,29,-22,2,1
143454,1,14,7,7,14,1
140695,1,3,0,3,12,0
406146,4,3,29,-26,11,1
223324,1,0,0,0,15,0
276560,4,22,7,15,4,1
132675,2,3,3,0,9,0
356070,4,27,10,17,5,0
3352,4,3,6,-3,2,1
390474,1,0,0,0,3,0
281024,3,17,13,4,6,0
368606,4,16,6,10,11,1
382117,3,21,3,18,17,0
263161,2,3,7,-4,15,0
240116,1,6,3,3,5,1
96152,2,0,16,-16,10,0
370481,3,20,9,11,12,0
14440,2,24,3,21,7,0
416443,2,13,0,13,15,1
421079,2,13,3,10,17,0
266604,1,0,0,0,16,1
125408,1,7,0,7,5,1
48566,2,14,14,0,5,0
11848,3,34,17,17,6,1
16847,4,26,38,-12,8,1
171302,2,6,3,3,9,1
289161,2,13,7,6,9,1
359064,4,10,13,-3,6,0
20983,2,14,24,-10,10,1
97619,1,3,0,3,11,0
334018,4,20,13,7,12,0
417733,4,35,19,16,16,0
231918,3,7,41,-34,1,0
308882,4,10,20,-10,1,1
192373,4,27,27,0,1,1
349345,4,30,42,-12,2,1
130673,3,7,38,-31,8,1
275938,4,20,18,2,3,1
99918,2,10,3,7,12,0
269171,1,0,3,-3,17,1
335032,4,16,13,3,13,0
203597,1,0,0,0,6,1
341615,1,0,0,0,16,1
5807,3,24,7,17,3,0
179735,2,3,10,-7,12,1
94695,4,24,36,-12,9,1
198581,1,0,0,0,3,0
157810,1,0,0,0,3,0
138685,3,6,28,-22,12,0
268061,4,24,9,15,17,0
305882,3,7,14,-7,17,1
168105,1,6,2,4,7,0
324064,1,0,0,0,8,0
126524,2,7,6,1,6,1
44181,4,13,27,-14,3,1
337948,3,20,0,20,14,1
40101,1,0,0,0,2,1
398518,4,28,16,12,7,0
172015,1,0,0,0,9,1
233704,2,7,21,-14,2,0
294049,2,7,14,-7,12,1
152975,3,35,17,18,1,0
395506,3,21,14,7,6,0
55387,2,10,7,3,9,1
159824,1,7,0,7,3,1
234068,3,20,7,13,2,1
295444,4,17,13,4,12,0
222373,4,24,3,21,14,0
404040,2,10,28,-18,10,0
16633,2,7,27,-20,8,0
17835,2,13,10,3,9,1
243417,2,3,17,-14,6,1
287728,1,0,0,0,9,1
329475,2,3,0,3,10,1
150301,2,17,7,10,16,0
175669,2,16,3,13,11,0
356306,2,17,0,17,5,0
196485,1,0,3,-3,2,1
388177,3,3,6,-3,2,0
386557,4,14,24,-10,2,0
216263,4,24,20,4,12,0
216119,1,0,0,0,12,0
270874,3,16,13,3,1,0
315193,2,10,10,0,4,1
218708,1,0,7,-7,13,1
328493,3,6,3,3,10,1
253161,4,21,23,-2,11,1
421181,1,0,0,0,17,1
65990,1,0,0,0,13,1
17807,2,10,3,7,9,1
112555,2,17,19,-2,17,1
403216,4,24,17,7,9,0
233930,4,17,13,4,2,1
22599,2,20,3,17,11,1
85854,4,20,16,4,5,1
59440,2,0,10,-10,11,1
174992,3,12,28,-16,10,1
221800,4,13,28,-15,14,0
296961,4,29,7,22,13,0
336472,4,10,17,-7,14,1
283832,1,7,0,7,7,1
45020,3,13,10,3,4,1
356901,1,0,0,0,5,1
277782,4,17,12,5,4,1
338330,2,3,0,3,14,1
14575,1,0,7,-7,7,1
309061,4,0,20,-20,1,0
80586,1,0,6,-6,3,0
52489,2,3,0,3,7,1
416275,1,7,3,4,15,1
15155,1,0,0,0,8,1
354582,1,0,0,0,4,0
289472,2,3,7,-4,10,1
9422,1,0,0,0,5,1
286691,2,10,7,3,8,1
161901,2,13,9,4,4,1
5043,2,7,0,7,3,1
237809,2,0,10,-10,4,0
231526,4,23,29,-6,1,1
242778,3,14,24,-10,6,0
58014,5,20,20,0,10,0
7477,3,29,6,23,4,0
365149,3,7,28,-21,9,1
296330,3,6,16,-10,13,1
115255,2,0,9,-9,1,1
100341,2,9,17,-8,12,0
254754,2,10,3,7,11,0
1853,4,16,10,6,1,1
178700,4,3,20,-17,12,0
212088,1,0,0,0,10,0
380532,3,7,17,-10,16,0
408787,3,10,25,-15,12,1
122325,4,6,19,-13,4,1
51661,4,27,20,7,7,1
266745,1,0,7,-7,16,0
387489,1,0,0,0,2,0
228525,3,20,7,13,17,0
38696,3,14,14,0,1,1
225567,1,0,0,0,16,0
380211,2,13,16,-3,16,1
72975,4,38,15,23,16,0
86589,3,30,3,27,5,1
354363,3,38,3,35,4,1
301250,4,27,20,7,15,1
291430,3,14,17,-3,10,1
450,1,0,0,0,1,0
247680,2,7,6,1,8,1
274146,4,27,0,27,3,0
367511,1,6,0,6,10,1
9891,2,0,0,0,5,0
94783,2,3,3,0,9,0
145771,2,10,10,0,15,1
416803,3,13,10,3,15,1
201502,3,25,7,18,5,1
324663,1,0,7,-7,8,1
45655,4,13,13,0,4,0
172532,2,0,7,-7,9,0
243980,1,0,0,0,6,1
293965,4,7,21,-14,12,0
89059,2,6,6,0,6,0
249075,3,21,17,4,9,1
372967,4,28,7,21,13,1
14141,2,0,14,-14,7,0
182273,2,7,0,7,14,1
329488,2,10,7,3,10,1
43482,1,0,0,0,3,1
272853,2,20,0,20,2,0
112262,2,17,17,0,17,1
325168,3,13,14,-1,8,1
282905,1,0,0,0,6,1
390066,2,7,7,0,3,0
5591,4,26,10,16,3,1
415777,4,21,17,4,15,0
233127,2,29,3,26,2,0
170688,2,7,3,4,8,0
265012,1,0,0,0,16,1
199058,2,0,14,-14,4,1
168873,3,17,3,14,7,1
353763,5,20,20,0,4,0
147221,1,0,21,-21,15,1
114359,2,24,13,11,1,0
126601,4,23,20,3,6,1
214817,4,10,27,-17,11,1
347985,4,0,24,-24,1,1
333253,4,6,21,-15,12,1
92427,3,17,10,7,8,1
51024,2,0,17,-17,6,1
380885,1,0,0,0,16,0
56734,2,0,10,-10,9,0
378452,3,17,0,17,15,0
137815,1,0,6,-6,11,0
157287,4,13,3,10,2,1
356922,1,3,0,3,5,0
79009,2,10,7,3,2,1
229935,1,0,0,0,17,0
125949,4,16,13,3,6,0
55967,2,10,7,3,9,0
382853,3,28,3,25,17,1
140472,3,14,26,-12,12,1
29184,4,3,26,-23,14,1
282176,1,3,0,3,6,0
156911,1,7,10,-3,2,1
343071,3,12,13,-1,16,0
329414,4,16,41,-25,10,1
292021,2,6,9,-3,11,1
347757,2,6,0,6,1,1
949,3,0,3,-3,1,1
313959,4,36,32,4,3,0
119915,1,6,14,-8,3,1
178088,5,23,23,0,12,1
237216,2,3,0,3,3,1
36043,2,10,0,10,17,1
399726,1,0,3,-3,8,1
258694,2,0,14,-14,13,0
77781,2,7,14,-7,1,0
190001,4,16,10,6,17,1
244298,4,26,7,19,6,1
159009,4,33,29,4,3,0
178498,3,16,6,10,12,0
143231,3,10,13,-3,13,1
251059,1,7,7,0,10,0
263824,4,7,24,-17,15,1
204379,1,0,3,-3,6,1
394930,3,7,17,-10,5,0
230634,4,16,24,-8,1,0
117010,2,0,10,-10,2,1
314659,3,14,14,0,3,1
292088,4,25,19,6,11,0
390562,3,17,14,3,3,1
320656,1,7,7,0,6,0
318254,2,3,7,-4,5,1
53848,1,0,0,0,8,0
37415,4,24,0,24,17,1
340309,2,10,0,10,15,0
230269,2,16,10,6,17,0
143873,1,0,0,0,14,1
375468,2,16,7,9,14,0
289489,3,13,7,6,10,0
420895,1,0,0,0,17,1
361040,2,16,2,14,7,1
387645,1,0,0,0,2,0
6396,3,9,13,-4,3,0
23806,3,17,6,11,12,0
229992,2,0,6,-6,17,1
145209,4,49,0,49,14,1
350081,4,30,13,17,2,0
199712,3,28,7,21,4,0
292864,1,7,0,7,11,0
24408,3,13,7,6,12,1
72098,4,10,17,-7,16,0
195397,3,23,3,20,2,1
122607,3,27,7,20,4,0
170205,1,0,0,0,8,0
412887,1,0,0,0,14,1
38978,3,30,3,27,1,0
253963,1,0,0,0,11,0
380415,4,10,24,-14,16,0
227652,4,42,0,42,16,0
98520,1,0,0,0,11,1
141265,4,10,24,-14,13,1
161806,4,30,6,24,4,0
402108,2,6,0,6,9,1
56917,3,34,7,27,9,0
26397,2,10,0,10,13,0
112131,3,7,20,-13,17,0
280360,1,0,0,0,5,1
391067,1,0,0,0,4,0
89795,1,3,0,3,7,0
282445,1,0,0,0,6,1
383359,2,0,6,-6,17,1
44437,3,17,7,10,3,1
90076,1,0,0,0,7,0
135840,3,7,14,-7,10,0
343826,3,21,3,18,17,0
164358,3,20,3,17,5,0
325329,3,12,10,2,8,0
66080,3,10,3,7,13,0
191828,2,10,10,0,1,1
81625,4,30,31,-1,3,1
120471,4,26,27,-1,3,1
413858,3,14,6,8,14,1
318859,2,21,12,9,5,1
395321,1,14,0,14,5,1
121974,2,10,7,3,4,0
325033,3,20,24,-4,8,1
405138,3,3,10,-7,10,1
409307,4,13,16,-3,12,1
299332,4,28,16,12,14,0
346645,2,14,6,8,1,1
7303,4,20,13,7,4,0
261298,4,38,0,38,14,0
345742,3,13,7,6,17,0
275732,2,7,0,7,3,1
343279,4,22,0,22,16,1
36353,2,13,13,0,17,1
92299,3,20,0,20,8,0
279328,1,0,0,0,5,0
73107,4,13,10,3,16,1
75590,2,7,3,4,17,0
253376,2,7,14,-7,11,0
50967,1,0,7,-7,6,0
135534,3,14,6,8,10,1
371806,4,24,17,7,12,1
132151,3,10,6,4,9,1
315628,2,0,0,0,4,1
167931,4,21,19,2,7,0
420004,2,3,7,-4,17,1
66200,2,24,3,21,13,0
90876,2,28,0,28,7,1
133596,2,3,7,-4,9,1
218171,3,14,3,11,12,1
378886,3,13,13,0,15,1
163599,3,7,19,-12,5,1
357270,3,3,16,-13,5,1
110445,2,17,0,17,16,0
389099,3,23,0,23,3,1
282817,3,3,13,-10,6,0
139822,2,10,10,0,12,0
301614,2,10,3,7,15,1
392058,4,10,24,-14,4,1
153452,4,20,17,3,1,1
192478,3,0,17,-17,1,1
210077,5,17,17,0,8,0
167940,1,0,0,0,7,0
329917,2,7,10,-3,11,0
81833,2,0,21,-21,3,0
242336,3,20,13,7,6,0
255482,2,10,0,10,12,1
155554,3,23,3,20,2,0
169194,2,10,6,4,7,1
296211,3,16,26,-10,13,1
320753,3,17,23,-6,6,0
124214,1,0,14,-14,5,1
125088,1,0,0,0,5,1
203200,3,10,17,-7,5,1
218207,4,30,3,27,12,0
215691,4,14,6,8,11,1
50431,3,10,7,3,6,1
415058,4,13,34,-21,15,1
245866,2,3,23,-20,7,1
59953,3,3,24,-21,11,1
323896,1,0,0,0,8,1
339122,2,10,6,4,15,1
323757,1,6,3,3,8,1
163487,4,10,26,-16,5,1
149025,1,0,0,0,16,0
84040,3,30,15,15,4,0
116055,4,16,7,9,1,0
175132,3,28,10,18,10,0
121945,2,3,7,-4,4,1
51420,2,3,10,-7,7,1
271709,2,13,10,3,2,0
224675,4,19,10,9,15,0
223165,1,0,0,0,15,0
367265,2,3,3,0,10,1
223029,1,7,0,7,14,0
88475,2,10,7,3,6,0
65937,4,17,14,3,13,0
67170,2,0,0,0,14,0
263358,4,24,10,14,15,1
222988,4,13,13,0,14,0
325322,3,12,10,2,8,1
302642,2,17,6,11,15,1
338289,4,34,37,-3,14,0
327076,1,0,0,0,9,1
358963,1,0,0,0,6,1
214620,3,3,16,-13,11,0
143388,3,7,23,-16,14,0
68889,4,6,20,-14,15,1
95670,2,10,3,7,10,0
228396,4,10,20,-10,17,1
275267,1,10,2,8,3,0
417768,5,35,35,0,16,1
65017,2,0,14,-14,13,0
195137,4,7,29,-22,2,1
381978,3,0,23,-23,17,1
67809,1,0,0,0,14,0
405829,5,24,24,0,10,1
103118,4,34,7,27,13,0
304518,3,10,14,-4,16,1
12981,2,0,7,-7,6,1
164277,1,6,0,6,5,0
333437,4,26,13,13,12,0
50727,3,14,14,0,6,1
56894,2,27,0,27,9,0
34149,3,10,3,7,16,0
307596,2,0,0,0,17,0
259154,3,14,13,1,13,1
181045,1,7,0,7,13,0
186765,2,20,0,20,15,1
390290,4,17,20,-3,3,1
371822,1,0,10,-10,12,1
381321,1,6,0,6,16,0
197637,4,33,0,33,3,0
41587,1,0,0,0,2,1
84042,4,30,15,15,4,0
327932,1,0,0,0,10,1
137144,4,31,6,25,11,1
344010,4,23,6,17,17,1
223657,2,13,3,10,15,0
146522,2,7,10,-3,15,1
338101,4,6,7,-1,14,1
37663,3,30,0,30,17,1
85010,2,25,7,18,4,1
276993,4,24,20,4,4,1
18482,4,10,14,-4,9,1
12834,2,13,3,10,6,1
154190,4,10,13,-3,1,1
177317,4,20,20,0,11,1
72795,3,21,14,7,16,1
161489,4,10,6,4,4,0
106471,3,16,9,7,14,1
41900,2,14,3,11,2,1
200258,2,9,7,2,4,1
4000,1,0,0,0,2,1
382854,3,28,3,25,17,1
31582,2,7,3,4,15,1
253055,2,7,0,7,11,1
191290,4,10,17,-7,17,0
381273,4,24,17,7,16,0
101360,2,6,0,6,12,0
118035,4,20,13,7,2,1
20155,2,10,0,10,10,0
304713,4,21,14,7,16,1
209395,3,14,7,7,8,0
249482,1,0,3,-3,9,1
403610,3,17,13,4,9,0
190090,2,17,3,14,17,1
151737,2,7,3,4,17,0
358313,3,0,20,-20,6,0
105909,4,19,13,6,14,0
224690,4,19,17,2,15,1
266826,4,16,14,2,16,1
400817,2,17,13,4,8,0
176557,4,19,17,2,11,1
315072,3,30,14,16,4,1
63187,3,14,23,-9,12,0
401769,4,27,14,13,8,0
139343,1,0,0,0,12,0
67786,4,24,0,24,14,0
208398,4,17,43,-26,8,1
196946,2,14,0,14,3,0
179198,1,7,0,7,12,1
344778,1,0,0,0,17,1
225524,3,0,21,-21,15,0
11034,1,7,0,7,5,0
392528,3,3,20,-17,4,1
82060,4,17,10,7,3,1
416148,1,3,6,-3,15,0
235190,1,2,0,2,3,1
58867,2,3,9,-6,10,1
97901,1,0,0,0,11,0
1766,1,0,0,0,1,1
93732,2,0,13,-13,9,1
244972,2,0,20,-20,7,1
95086,2,0,7,-7,9,1
130106,4,17,36,-19,8,1
358835,2,0,7,-7,6,1
39825,1,3,0,3,1,0
346188,2,17,0,17,1,0
98926,4,7,17,-10,11,1
50198,1,6,0,6,6,1
4921,2,14,7,7,3,0
215205,3,7,16,-9,11,1
215966,4,20,28,-8,11,0
156477,2,0,3,-3,2,0
311159,1,0,0,0,2,1
286237,2,3,13,-10,8,1
366367,1,6,0,6,10,1
340342,2,17,7,10,15,0
383073,2,17,7,10,17,1
142086,1,0,7,-7,13,1
288769,4,3,13,-10,9,1
64526,1,0,0,0,13,1
298188,1,0,3,-3,14,1
357061,1,6,7,-1,5,1
336405,2,3,3,0,14,1
60467,1,7,0,7,11,0
176093,4,24,16,8,11,0
160893,1,0,0,0,4,1
19982,2,6,3,3,10,1
312767,1,0,0,0,3,1
124108,3,3,21,-18,5,0
14789,3,38,3,35,7,1
237664,2,10,7,3,4,1
235601,4,27,13,14,3,0
228162,1,7,17,-10,17,0
401254,2,7,14,-7,8,1
396900,4,27,20,7,6,0
363975,3,3,9,-6,8,1
231279,1,3,3,0,1,0
6770,1,3,0,3,3,1
143751,1,3,0,3,14,1
60169,1,0,0,0,11,1
369873,3,7,9,-2,12,0
151816,4,21,16,5,17,1
403908,3,20,14,6,10,1
59937,2,3,10,-7,11,1
186596,2,17,0,17,15,0
220158,4,26,13,13,13,1
126904,4,17,14,3,6,1
10863,4,27,21,6,5,0
363270,3,24,7,17,8,1
153069,1,0,10,-10,1,1
419677,1,0,0,0,17,0
368441,4,23,14,9,11,1
346204,2,20,0,20,1,1
251157,4,10,27,-17,10,1
365809,4,31,17,14,9,1
103183,2,0,0,0,13,1
393107,3,23,3,20,4,1
206248,2,7,6,1,7,0
146017,1,3,0,3,15,1
257938,1,0,0,0,13,0
393787,1,0,0,0,5,1
144256,2,9,7,2,14,1
404782,2,16,13,3,10,1
244285,4,26,7,19,6,1
311551,4,17,19,-2,2,1
257068,3,7,14,-7,12,0
306674,4,14,35,-21,17,1
64768,4,28,7,21,13,0
219194,3,0,3,-3,13,0
235200,1,2,0,2,3,1
328080,1,0,0,0,10,1
308663,1,0,6,-6,1,1
212938,3,7,7,0,10,0
213867,4,48,7,41,10,0
172069,2,10,3,7,9,0
350101,4,30,20,10,2,0
211029,2,17,0,17,9,1
210502,4,9,14,-5,9,0
12053,1,0,0,0,6,1
300127,2,7,3,4,14,1
343285,1,0,0,0,16,0
342384,2,0,3,-3,16,0
132079,1,7,0,7,9,0
414477,4,16,23,-7,14,1
361952,3,10,3,7,7,0
49367,3,7,17,-10,6,1
227378,1,0,0,0,16,0
122783,4,10,27,-17,4,0
227206,4,16,17,-1,16,0
374449,3,32,0,32,14,0
230238,1,6,0,6,17,0
136760,3,13,10,3,11,0
112615,4,31,34,-3,17,1
183991,4,22,9,13,14,0
186858,4,29,20,9,15,1
257389,3,20,7,13,13,0
308941,1,0,3,-3,1,1
231357,4,9,16,-7,1,1
417933,1,0,7,-7,16,1
161406,2,7,3,4,4,1
341193,2,10,7,3,16,1
219781,2,28,0,28,13,1
159192,1,7,7,0,3,0
172630,1,0,0,0,9,1
299782,4,17,17,0,14,1
182724,4,27,26,1,14,0
175214,1,10,0,10,10,0
306410,1,0,10,-10,17,1
321907,3,14,21,-7,7,0
381917,1,0,7,-7,17,1
229331,4,24,34,-10,17,1
54411,4,33,25,8,8,0
141176,2,3,14,-11,13,1
10327,2,10,14,-4,5,1
150452,2,27,3,24,16,0
133960,4,16,6,10,9,0
226942,4,3,13,-10,16,0
356940,2,3,3,0,5,1
93128,1,0,0,0,9,1
387164,4,10,41,-31,2,0
68003,1,0,3,-3,14,1
20340,2,10,13,-3,10,0
332450,2,16,3,13,12,0
205736,4,27,25,2,7,1
349965,1,0,0,0,2,0
337653,3,21,13,8,14,0
35750,2,3,0,3,17,0
55960,2,10,7,3,9,1
111350,2,0,7,-7,16,1
323309,1,0,0,0,7,0
274103,3,20,0,20,3,1
213303,1,3,0,3,10,0
182437,1,7,0,7,14,1
265143,4,20,17,3,16,0
375323,2,7,14,-7,14,1
165609,1,0,0,0,6,0
157355,1,3,0,3,2,0
196647,1,7,0,7,3,1
100436,1,0,7,-7,12,1
223491,2,7,3,4,15,1
421230,2,6,7,-1,17,0
351632,1,0,7,-7,3,0
5734,1,0,0,0,3,0
100510,3,10,17,-7,12,1
418844,2,0,3,-3,16,1
222246,4,13,24,-11,14,0
264089,2,10,27,-17,15,1
307109,4,24,6,18,17,1
46648,3,10,0,10,4,1
34507,1,0,0,0,16,0
38848,4,3,10,-7,1,0
54286,1,0,0,0,8,1
72249,4,27,17,10,16,0
349021,3,14,7,7,2,0
66280,1,0,0,0,14,1
406221,2,14,17,-3,11,1
227648,4,42,0,42,16,0
143744,1,0,0,0,14,1
417069,3,20,0,20,15,1
88474,2,10,7,3,6,0
131150,4,27,12,15,8,0
260898,1,0,0,0,14,0
51480,3,27,24,3,7,1
77024,1,0,7,-7,1,0
183184,1,0,0,0,14,0
336839,1,0,7,-7,14,1
400866,4,31,19,12,8,0
214773,3,3,20,-17,11,1
419595,2,20,10,10,17,1
383279,3,38,17,21,17,1
126684,2,7,6,1,6,0
397753,3,9,14,-5,7,0
131608,1,0,0,0,8,0
307322,2,14,19,-5,17,1
420119,1,0,0,0,17,1
131203,2,7,10,-3,8,1
218832,1,0,3,-3,13,1
279381,2,12,14,-2,5,1
291060,1,0,0,0,10,1
217738,3,10,7,3,12,0
262137,3,21,3,18,15,0
83045,2,6,13,-7,4,0
287521,3,14,33,-19,9,1
363874,4,13,29,-16,8,1
130604,1,7,7,0,8,0
278532,4,36,7,29,4,1
53033,4,27,24,3,7,0
323772,2,6,3,3,8,1
50889,3,14,23,-9,6,0
246440,1,7,0,7,8,1
196624,4,27,30,-3,2,0
208743,2,0,6,-6,8,1
246305,2,7,3,4,7,0
379323,3,10,6,4,16,0
320670,1,14,10,4,6,0
74425,4,10,20,-10,17,1
124476,4,16,17,-1,5,0
130324,2,7,0,7,8,0
328304,2,3,14,-11,10,1
83346,2,0,14,-14,4,1
115439,3,39,13,26,1,0
241267,3,3,0,3,5,0
32145,4,24,21,3,15,0
22017,3,14,17,-3,11,0
129571,3,6,17,-11,7,0
233443,3,17,10,7,2,1
131245,3,14,17,-3,8,0
143431,1,0,0,0,14,1
265369,3,14,13,1,16,0
59611,2,14,3,11,11,1
419292,2,0,10,-10,16,0
303892,2,0,17,-17,16,1
65552,1,6,0,6,13,0
151862,1,10,0,10,17,0
329201,2,10,6,4,10,0
305664,1,3,7,-4,17,0
377357,1,0,0,0,15,0
107158,2,0,14,-14,15,1
237413,4,12,17,-5,3,0
34099,2,0,0,0,16,0
274135,4,27,0,27,3,1
246245,4,24,16,8,7,1
369793,4,52,50,2,11,1
361686,3,10,32,-22,7,0
352676,2,7,3,4,3,1
208536,4,47,15,32,8,0
186822,3,29,7,22,15,0
299420,2,0,20,-20,14,0
365498,4,10,25,-15,9,1
45713,2,7,0,7,4,0
420628,2,13,13,0,17,0
121186,2,14,13,1,3,0
93008,2,10,3,7,8,1
170350,4,6,15,-9,8,0
415738,2,14,10,4,15,1
118001,3,20,6,14,2,0
182184,3,33,7,26,13,0
382628,1,0,0,0,17,0
32743,4,7,24,-17,15,0
319632,2,16,3,13,6,1
28068,2,14,10,4,13,1
160249,1,0,0,0,4,1
170462,4,21,3,18,8,1
162593,1,0,7,-7,5,1
187100,3,10,0,10,16,0
93029,3,13,6,7,8,1
208811,4,6,22,-16,8,0
184689,4,10,24,-14,15,1
407358,1,0,0,0,11,1
342258,2,6,0,6,16,1
149490,1,7,6,1,16,0
53286,4,3,7,-4,8,0
196350,1,7,0,7,2,1
384230,1,6,0,6,1,0
308805,1,0,3,-3,1,1
202794,4,19,17,2,5,1
54821,3,13,0,13,8,1
291997,2,6,3,3,11,0
249978,1,0,3,-3,9,1
29203,4,3,26,-23,14,1
382204,1,3,3,0,17,1
112675,1,3,0,3,17,0
395880,4,10,17,-7,6,1
180843,4,20,20,0,13,0
310985,4,16,37,-21,2,0
295052,1,0,0,0,12,0
111961,2,14,21,-7,17,1
289790,3,16,10,6,10,1
290848,4,17,21,-4,10,1
179537,2,0,16,-16,12,0
136081,1,0,7,-7,10,1
215482,3,10,3,7,11,1
59884,1,0,0,0,11,1
300409,1,2,0,2,14,1
145896,2,0,0,0,15,0
377070,1,0,7,-7,15,1
28144,4,30,10,20,13,0
31246,4,33,41,-8,15,1
418193,4,24,6,18,16,1
24938,1,10,7,3,12,0
382471,1,0,0,0,17,0
326419,1,0,0,0,9,0
253029,1,0,0,0,11,0
198716,1,0,0,0,3,0
98078,1,0,0,0,11,1
19163,3,21,10,11,10,0
271742,2,13,10,3,2,1
84249,1,0,7,-7,4,0
362755,1,0,0,0,8,1
368657,1,0,3,-3,11,0
150876,2,0,7,-7,17,0
360883,2,6,0,6,7,1
14831,1,0,0,0,7,1
24966,2,10,14,-4,12,1
247921,4,20,6,14,8,0
149081,2,14,7,7,16,0
160264,1,3,0,3,4,0
419436,2,10,3,7,16,0
41232,4,10,13,-3,2,0
106772,3,20,15,5,14,0
92665,1,0,10,-10,8,1
339947,4,33,7,26,15,1
42427,4,22,22,0,2,0
232714,4,20,3,17,1,0
69919,4,34,23,11,15,0
231329,3,9,10,-1,1,1
180361,3,15,14,1,13,1
67274,1,7,0,7,14,0
224450,2,9,10,-1,15,1
118251,2,9,7,2,2,1
239353,1,0,6,-6,4,0
181118,3,24,14,10,13,1
296732,1,0,0,0,13,0
420641,3,21,16,5,17,1
45044,3,23,10,13,4,0
171399,5,19,20,-1,9,1
273201,3,33,7,26,2,0
158567,4,13,17,-4,3,1
253194,1,0,7,-7,11,1
94693,4,24,36,-12,9,1
409964,2,6,21,-15,12,1
187950,2,3,7,-4,16,1
69968,2,21,0,21,15,1
86283,3,13,20,-7,5,0
211085,4,37,0,37,9,1
275946,4,20,18,2,3,0
28254,3,17,0,17,13,0
291760,4,3,17,-14,11,1
242153,2,13,7,6,6,0
158188,2,10,0,10,3,0
246592,1,7,3,4,8,0
397525,1,0,0,0,7,1
201528,4,32,14,18,5,1
14863,1,0,0,0,7,0
156435,1,0,3,-3,2,0
206743,4,7,24,-17,7,1
12151,4,14,21,-7,6,0
176001,2,14,0,14,11,1
298488,1,10,0,10,14,0
363846,3,13,20,-7,8,1
18210,4,29,20,9,9,0
317489,2,10,10,0,5,0
40465,3,7,14,-7,2,0
196755,4,54,13,41,3,1
183650,2,0,8,-8,14,1
8061,3,17,7,10,4,1
178487,2,16,3,13,12,0
170438,3,21,3,18,8,0
305056,1,14,0,14,16,1
274053,2,10,0,10,3,0
329033,1,0,7,-7,10,1
256587,2,13,0,13,12,1
121958,2,3,7,-4,4,1
91479,2,12,0,12,8,1
392616,2,7,0,7,4,0
386100,4,14,6,8,1,1
209603,4,43,34,9,8,1
229831,2,6,0,6,17,0
73339,2,13,0,13,17,1
400879,4,31,19,12,8,1
93145,2,0,0,0,9,1
272592,4,13,6,7,2,1
47171,2,6,0,6,5,1
65820,5,34,33,1,13,0
382970,3,3,13,-10,17,1
64256,1,0,3,-3,13,1
372523,4,26,17,9,13,0
160350,3,3,21,-18,4,0
203564,1,0,0,0,6,1
204190,4,24,20,4,6,1
33934,2,0,24,-24,16,0
50874,2,7,17,-10,6,1
124412,2,6,0,6,5,0
175742,4,37,13,24,11,1
387735,4,0,23,-23,2,0
314431,1,7,0,7,3,0
279781,1,6,3,3,5,1
170817,1,7,0,7,8,0
78135,2,14,3,11,2,1
401709,3,10,14,-4,8,0
62982,2,6,7,-1,12,0
233637,4,23,41,-18,2,1
12542,2,3,17,-14,6,1
343584,1,12,7,5,17,1
13321,3,7,27,-20,7,1
358402,2,15,13,2,6,1
288380,2,7,0,7,9,1
367164,3,29,23,6,10,0
36744,1,0,7,-7,17,0
171532,4,17,10,7,9,1
293088,4,10,20,-10,11,1
356662,2,16,9,7,5,0
275551,1,0,0,0,3,1
274631,1,0,0,0,3,0
176233,4,14,27,-13,11,0
333887,4,28,28,0,12,1
131950,1,0,7,-7,8,1
118608,4,37,10,27,2,1
56023,4,10,23,-13,9,1
341155,1,0,0,0,16,1
124788,4,6,9,-3,5,0
212849,5,24,24,0,10,0
170677,2,0,3,-3,8,1
72072,3,10,10,0,16,1
369219,1,0,7,-7,11,1
268473,3,22,9,13,17,1
222340,3,14,3,11,14,1
13422,2,3,14,-11,7,1
112479,4,13,16,-3,17,1
25695,3,14,7,7,12,0
261878,3,6,20,-14,14,1
408301,2,0,7,-7,12,1
122207,1,0,7,-7,4,1
346517,2,24,30,-6,1,0
162309,1,3,0,3,4,0
227721,2,0,0,0,16,1
134028,2,13,3,10,9,0
52917,1,0,0,0,7,1
316803,4,16,7,9,4,1
356803,2,0,6,-6,5,0
310772,3,6,3,3,2,1
104487,3,14,24,-10,13,0
36665,3,13,3,10,17,1
137251,3,7,13,-6,11,0
147959,1,0,0,0,15,1
378826,1,0,3,-3,15,1
71443,2,24,7,17,16,1
152524,3,23,7,16,17,1
85133,1,0,3,-3,4,0
353452,4,25,12,13,4,1
394623,3,17,7,10,5,0
393705,2,0,7,-7,5,1
186018,2,16,34,-18,15,1
3187,4,16,9,7,2,0
339652,4,31,24,7,15,0
413507,1,0,0,0,14,0
106041,4,24,3,21,14,0
310529,4,23,9,14,2,0
228635,2,10,14,-4,17,1
196625,1,0,0,0,3,1
101295,4,17,20,-3,12,1
264780,3,10,23,-13,16,1
250722,1,0,0,0,10,1
264405,2,3,21,-18,15,1
38717,4,23,17,6,1,1
215592,2,14,3,11,11,0
105608,4,32,28,4,14,0
19864,2,10,21,-11,10,1
191132,4,28,20,8,17,0
291379,1,7,7,0,10,1
259140,2,14,7,7,13,0
197845,2,6,7,-1,3,1
181171,4,24,21,3,13,1
47036,2,17,0,17,5,0
385629,4,9,24,-15,1,0
18253,2,0,17,-17,9,1
8087,3,17,13,4,4,1
278310,2,14,0,14,4,0
156684,3,14,14,0,2,0
295721,3,10,9,1,12,0
43151,1,0,0,0,3,1
30068,4,46,7,39,14,0
240971,4,21,16,5,5,1
164815,4,26,21,5,6,0
112405,3,13,13,0,17,0
174463,1,7,0,7,10,0
402533,1,7,0,7,9,0
95686,2,10,6,4,10,1
309525,2,3,0,3,1,1
327369,2,0,7,-7,9,0
327541,2,7,9,-2,10,0
363866,4,13,26,-13,8,0
116074,4,16,10,6,1,1
169192,2,10,6,4,7,1
210996,1,6,0,6,9,1
44287,3,17,20,-3,3,1
186672,4,27,3,24,15,0
286830,1,3,7,-4,8,0
169774,2,0,7,-7,8,0
190337,1,0,0,0,17,1
248880,1,14,0,14,9,1
415447,3,15,3,12,15,1
110064,4,48,16,32,16,0
361410,4,17,14,3,7,0
194859,1,0,7,-7,2,0
70633,4,17,17,0,15,0
236468,2,7,3,4,3,1
29548,2,0,10,-10,14,0
182840,4,29,20,9,14,1
99447,2,0,3,-3,11,0
255044,2,3,18,-15,12,0
18562,2,3,10,-7,9,1
164769,3,26,14,12,6,0
108263,3,9,7,2,15,0
208186,3,0,3,-3,8,0
385895,2,3,7,-4,1,0
66804,4,10,6,4,14,1
80412,4,27,16,11,2,1
133158,2,10,17,-7,9,0
140243,1,0,0,0,12,0
100789,2,6,3,3,12,1
12173,1,0,0,0,6,0
336795,4,10,17,-7,14,1
190757,1,3,0,3,17,0
391912,4,23,26,-3,4,0
377565,3,17,9,8,15,0
170066,1,0,0,0,8,0
173953,4,20,19,1,10,1
138435,2,7,7,0,12,1
321215,4,3,19,-16,6,1
39906,3,6,10,-4,1,0
129341,1,14,7,7,7,0
240927,2,14,6,8,5,1
180651,3,24,6,18,13,0
101435,4,18,7,11,12,0
176012,2,17,0,17,11,1
51425,2,3,10,-7,7,0
86371,1,7,0,7,5,0
62162,3,7,14,-7,12,0
81399,3,7,10,-3,3,1
371072,4,13,20,-7,12,1
377447,4,7,13,-6,15,0
9231,4,3,30,-27,5,1
366197,4,14,51,-37,10,0
106536,1,7,0,7,14,0
1803,2,10,0,10,1,1
400612,1,0,0,0,8,1
112830,1,7,0,7,17,0
171768,2,6,14,-8,9,1
225095,4,13,14,-1,15,0
293436,4,35,24,11,11,0
347375,4,21,21,0,1,0
199995,3,17,16,1,4,0
366893,4,3,16,-13,10,0
3313,3,3,6,-3,2,1
112620,4,31,34,-3,17,1
123579,1,0,0,0,4,1
366311,4,28,10,18,10,1
301078,4,30,13,17,15,0
397167,2,6,0,6,6,0
223630,1,6,3,3,15,0
328748,2,14,6,8,10,0
368126,2,7,7,0,11,1
301611,2,10,3,7,15,0
310283,2,17,0,17,2,0
293434,4,29,24,5,11,1
239754,4,13,13,0,4,1
158488,2,3,10,-7,3,0
352267,3,3,6,-3,3,1
247212,1,6,7,-1,8,1
30695,2,3,7,-4,15,1
249210,2,12,7,5,9,1
195529,2,6,0,6,2,0
299554,2,3,3,0,14,0
290589,4,26,20,6,10,0
186950,3,7,9,-2,15,0
368005,3,17,21,-4,11,1
287621,2,3,3,0,9,0
313385,1,7,0,7,3,1
414859,2,21,7,14,15,1
143297,1,0,7,-7,14,0
90690,1,0,0,0,7,1
210692,1,0,0,0,9,1
154392,1,0,0,0,1,0
320766,4,17,23,-6,6,1
378743,3,14,7,7,15,1
154342,3,27,23,4,1,0
142441,2,7,10,-3,13,0
109763,4,13,0,13,16,0
190512,2,10,6,4,17,1
369179,4,19,20,-1,11,1
444,4,45,26,19,1,1
347131,2,13,10,3,1,1
240420,1,0,0,0,5,1
166678,1,0,0,0,6,1
137794,1,0,0,0,11,0
28371,2,6,0,6,14,0
18862,2,3,6,-3,9,1
199146,4,14,38,-24,4,0
23332,2,6,10,-4,11,1
369947,1,0,0,0,12,1
252313,2,0,16,-16,10,0
330276,4,24,21,3,11,1
2259,3,10,10,0,1,1
113207,4,41,22,19,17,1
240219,4,16,6,10,5,0
260284,4,24,3,21,14,0
203090,4,39,17,22,5,1
218644,4,10,30,-20,13,0
354496,3,27,28,-1,4,0
137116,4,24,6,18,11,1
87891,3,13,15,-2,6,1
308563,2,6,9,-3,1,1
70025,3,24,10,14,15,0
273742,1,0,7,-7,2,1
196906,4,10,22,-12,3,1
407258,2,7,16,-9,11,1
235727,3,3,20,-17,3,1
143624,2,10,10,0,14,1
390234,2,3,6,-3,3,0
312076,2,17,7,10,2,1
182742,1,3,0,3,14,1
348976,2,14,0,14,2,1
303269,2,13,0,13,16,0
20810,2,14,0,14,10,0
125000,2,3,3,0,5,0
179178,1,0,0,0,12,1
315941,2,0,7,-7,4,1
141964,2,10,13,-3,13,0
139165,4,19,13,6,12,1
206888,3,10,17,-7,7,0
250913,1,0,3,-3,10,1
30688,2,3,6,-3,15,0
101194,1,0,7,-7,12,0
278940,2,7,23,-16,5,0
371492,4,14,24,-10,12,1
388827,4,14,17,-3,3,0
167550,3,0,10,-10,7,1
265448,1,0,7,-7,16,1
327080,1,0,0,0,9,1
47438,5,16,13,3,5,1
13450,2,3,21,-18,7,1
45775,3,10,14,-4,4,1
347944,3,0,21,-21,1,0
66338,2,6,21,-15,14,1
34084,2,0,0,0,16,1
395145,1,0,0,0,5,1
277396,3,23,9,14,4,1
122841,2,10,3,7,4,1
266214,2,24,6,18,16,0
352410,3,35,10,25,3,1
119811,3,24,13,11,3,1
288480,1,0,0,0,9,1
239861,2,10,3,7,4,1
421732,4,17,17,0,17,1
237275,4,26,0,26,3,0
237738,4,20,17,3,4,0
335768,4,17,7,10,13,0
409211,2,10,3,7,12,1
11165,1,0,0,0,6,0
118957,2,0,17,-17,3,1
94401,4,17,21,-4,9,1
14861,1,0,0,0,7,1
194160,2,3,3,0,1,0
357811,2,3,14,-11,6,0
131124,3,27,9,18,8,0
234863,4,3,12,-9,2,0
362279,4,18,24,-6,8,0
170802,4,27,13,14,8,0
103593,1,0,0,0,13,1
192279,2,24,3,21,1,0
263969,3,23,6,17,15,0
401006,4,22,15,7,8,0
297715,3,17,20,-3,13,1
171084,4,17,40,-23,8,1
202358,4,20,13,7,5,0
168448,3,0,24,-24,7,1
380465,1,0,0,0,16,0
212055,4,17,40,-23,9,1
395635,2,7,17,-10,6,0
184738,1,0,0,0,15,1
282127,3,23,8,15,6,1
224048,3,14,6,8,15,0
308391,2,0,12,-12,1,0
402329,4,23,24,-1,9,1
336458,3,10,17,-7,14,0
207103,1,0,0,0,7,0
301349,3,17,7,10,15,0
35194,3,0,14,-14,16,0
317038,2,0,10,-10,4,1
88221,4,17,17,0,6,1
39349,1,0,0,0,1,1
70462,3,17,17,0,15,1
159613,4,20,12,8,3,0
188316,4,20,13,7,16,1
191451,4,0,34,-34,17,1
102304,2,10,10,0,13,1
195395,3,17,3,14,2,1
337782,2,23,6,17,14,1
256248,2,6,7,-1,12,0
252287,2,0,13,-13,10,0
343809,3,21,3,18,17,0
272904,4,20,17,3,2,1
1184,1,3,0,3,1,1
207526,1,0,0,0,7,1
91321,2,7,7,0,8,1
56047,5,24,23,1,9,0
214865,2,0,9,-9,11,1
190373,2,7,0,7,17,1
132212,1,0,0,0,9,1
358422,3,22,13,9,6,1
235371,2,14,7,7,3,1
414435,3,13,23,-10,14,0
183568,3,20,17,3,14,0
256701,1,0,3,-3,12,0
136696,1,0,10,-10,11,1
353796,1,7,0,7,4,0
140374,4,17,29,-12,12,1
330207,2,7,6,1,11,0
118100,2,3,13,-10,2,1
48236,2,0,10,-10,5,1
215411,1,7,0,7,11,1
174085,3,0,36,-36,10,1
309779,1,0,0,0,1,1
323222,3,7,3,4,7,1
181970,1,7,0,7,13,1
329580,1,7,0,7,11,1
73266,4,14,16,-2,16,0
119101,2,7,7,0,3,0
263603,2,14,7,7,15,0
192910,2,7,7,0,1,1
356827,3,0,13,-13,5,0
158914,2,14,3,11,3,0
153046,1,0,7,-7,1,1
420191,3,3,3,0,17,0
359227,5,28,28,0,6,1
77267,3,16,7,9,1,0
78717,2,13,7,6,2,1
185274,3,27,9,18,15,0
312227,3,7,17,-10,2,1
386090,3,14,6,8,1,1
44429,2,10,0,10,3,1
406893,4,27,23,4,11,0
166434,2,17,7,10,6,1
414239,2,14,20,-6,14,0
241459,4,10,42,-32,5,1
24233,3,10,17,-7,12,1
204309,3,0,10,-10,6,0
223005,4,13,23,-10,14,0
386906,1,7,7,0,2,0
399057,3,10,12,-2,7,0
80991,4,20,17,3,3,1
347749,2,0,0,0,1,0
689,3,0,17,-17,1,0
24436,4,16,7,9,12,0
234707,4,30,23,7,2,0
348166,1,6,0,6,1,1
315237,4,20,10,10,4,0
280644,1,0,0,0,5,0
170128,3,7,10,-3,8,0
414061,1,0,0,0,14,1
157937,4,9,15,-6,3,0
279868,3,17,13,4,5,0
208994,1,0,0,0,8,0
409203,2,3,0,3,12,0
247317,4,42,28,14,8,0
125800,4,14,23,-9,5,1
74947,2,17,7,10,17,0
31718,1,0,0,0,15,0
347151,3,16,10,6,1,1
170564,2,21,3,18,8,0
283535,1,6,7,-1,7,1
20487,2,0,0,0,10,1
359646,4,36,7,29,6,1
278135,2,7,7,0,4,0
212288,2,7,3,4,10,0
238134,1,0,3,-3,4,0
136823,4,20,13,7,11,0
220520,2,0,14,-14,13,0
176391,4,19,28,-9,11,1
112764,3,13,7,6,17,0
37561,4,13,10,3,17,1
343887,4,26,6,20,17,0
233891,2,14,6,8,2,1
112756,3,13,7,6,17,1
325703,4,34,21,13,9,1
71697,1,3,0,3,16,1
233212,1,0,0,0,2,1
155559,3,23,3,20,2,1
107738,2,7,7,0,15,0
278615,2,14,0,14,4,0
16333,1,7,0,7,8,1
34877,3,20,7,13,16,1
66291,1,0,0,0,14,0
145843,4,13,33,-20,15,1
204041,4,16,7,9,6,0
358819,1,0,7,-7,6,1
169016,2,19,14,5,7,1
80740,1,3,0,3,3,0
239685,2,7,10,-3,4,1
41757,2,7,7,0,2,0
195972,3,0,27,-27,2,0
325768,2,0,7,-7,9,0
419602,2,20,16,4,17,1
88562,1,0,0,0,6,1
106341,3,14,19,-5,14,1
194403,1,3,0,3,2,0
137563,3,20,27,-7,11,1
163092,2,7,12,-5,5,0
238091,4,13,13,0,4,1
272221,2,6,0,6,2,0
417405,4,16,17,-1,16,1
43737,1,0,0,0,3,1
159866,2,17,0,17,3,1
197030,4,23,33,-10,3,1
178650,2,3,13,-10,12,0
404391,4,20,13,7,10,0
329509,3,17,7,10,10,1
46552,1,0,0,0,4,1
152810,4,14,10,4,17,0
299253,2,17,0,17,14,0
416474,3,21,10,11,15,0
387248,2,6,7,-1,2,1
304196,2,13,7,6,16,0
11145,4,24,27,-3,5,1
256756,3,3,6,-3,12,0
217129,2,0,9,-9,12,1
245134,2,17,15,2,7,0
377352,1,0,0,0,15,0
105317,1,0,0,0,14,0
21096,2,0,0,0,10,1
47314,2,0,7,-7,5,0
326264,4,17,48,-31,9,0
120414,3,19,9,10,3,1
318359,4,9,29,-20,5,1
69292,3,16,3,13,15,0
316774,3,10,7,3,4,0
257897,4,16,19,-3,13,1
108820,2,0,10,-10,15,1
226084,2,0,14,-14,16,1
401716,3,10,14,-4,8,1
75719,2,21,10,11,1,0
381745,1,0,0,0,17,1
181848,2,21,7,14,13,0
327723,3,6,13,-7,10,0
15019,2,0,16,-16,7,1
247474,4,13,12,1,8,1
417881,3,13,10,3,16,0
211602,1,0,3,-3,9,0
301696,1,0,0,0,15,0
399455,2,0,17,-17,7,0
112435,3,13,13,0,17,1
35875,1,0,0,0,17,1
228209,3,10,27,-17,17,0
198687,4,15,21,-6,3,0
155730,3,20,20,0,2,0
121649,2,0,7,-7,4,0
122723,3,7,17,-10,4,0
385877,1,0,0,0,1,0
88401,1,0,0,0,6,0
363224,2,14,7,7,8,0
357528,2,10,6,4,5,0
9303,2,7,0,7,5,1
264391,2,3,14,-11,15,0
154328,3,20,14,6,1,0
411536,4,13,31,-18,13,0
417035,2,10,0,10,15,1
329164,1,3,3,0,10,1
212482,3,10,6,4,10,0
286595,3,17,37,-20,8,0
250506,3,16,7,9,9,0
415699,2,7,3,4,15,0
16515,3,20,13,7,8,1
9017,2,7,7,0,4,0
176840,3,16,10,6,11,1
295168,4,10,21,-11,12,0
83558,3,0,17,-17,4,1
150002,3,14,3,11,16,0
393377,2,21,7,14,5,0
189836,4,27,17,10,17,1
68013,1,0,10,-10,14,1
320076,1,3,0,3,6,1
332963,4,31,3,28,12,0
356051,3,24,10,14,5,1
248586,2,7,3,4,9,1
288213,2,3,7,-4,9,0
401015,4,22,15,7,8,1
48425,3,17,17,0,5,1
356857,4,10,16,-6,5,0
69799,1,7,0,7,15,0
375082,1,0,0,0,14,1
344181,4,35,11,24,17,1
216826,2,0,7,-7,12,1
217741,3,10,7,3,12,0
315584,4,7,14,-7,4,1
143507,3,14,21,-7,14,1
216824,2,0,7,-7,12,1
306039,3,10,10,0,17,0
416308,2,10,3,7,15,1
356317,2,17,0,17,5,0
201992,3,10,7,3,5,1
284729,1,3,7,-4,7,1
47731,4,6,17,-11,5,0
297747,4,31,23,8,13,0
217337,3,7,10,-3,12,0
314936,3,0,10,-10,4,1
409008,4,31,31,0,12,1
51875,2,6,10,-4,7,0
152138,4,20,13,7,17,0
330072,2,0,3,-3,11,1
42016,1,6,0,6,2,0
387549,2,3,3,0,2,1
114391,3,34,13,21,1,0
398623,2,0,0,0,7,1
393503,1,7,0,7,5,0
50647,4,17,9,8,6,0
49841,3,21,10,11,6,1
362847,4,14,28,-14,8,0
251037,1,0,0,0,10,0
96474,3,10,17,-7,10,1
414317,4,21,42,-21,14,0
392631,2,7,0,7,4,1
317327,2,0,0,0,5,1
238572,4,16,20,-4,4,0
12012,4,24,14,10,6,0
15089,4,10,26,-16,7,0
178666,3,3,13,-10,12,1
143783,2,3,0,3,14,0
189999,4,16,10,6,17,1
40737,2,17,7,10,2,0
238815,2,27,0,27,4,0
206955,1,7,0,7,7,0
110421,2,10,0,10,16,0
180423,1,7,7,0,13,0
36868,4,24,42,-18,17,1
96266,1,0,6,-6,10,0
362867,4,14,28,-14,8,0
152149,1,0,0,0,17,1
205518,3,14,17,-3,6,1
53748,4,10,3,7,8,0
71090,4,27,3,24,16,0
57242,4,20,14,6,10,0
351715,4,21,17,4,3,0
217281,2,0,7,-7,12,1
337492,2,7,12,-5,14,0
315955,2,0,7,-7,4,0
269832,3,21,10,11,1,1
131690,3,10,22,-12,8,1
64859,2,7,0,7,13,0
140996,2,7,0,7,13,1
330665,2,6,3,3,11,0
232216,3,9,12,-3,1,1
192005,3,17,20,-3,1,0
28367,2,6,0,6,14,0
361128,4,23,23,0,7,1
63387,4,17,10,7,12,1
302174,1,14,0,14,15,1
284347,3,6,17,-11,7,1
175791,1,6,0,6,11,1
144427,3,3,13,-10,14,0
368995,3,10,7,3,11,0
418690,1,0,7,-7,16,1
376179,1,7,0,7,14,0
142927,3,3,10,-7,13,0
339820,1,7,0,7,15,0
179144,4,12,13,-1,12,0
353713,3,3,17,-14,4,1
246814,3,10,20,-10,8,0
51104,1,0,0,0,7,1
378991,1,7,0,7,15,0
152655,3,10,6,4,17,1
87631,1,0,0,0,6,0
256895,2,14,10,4,12,0
233699,2,7,21,-14,2,1
331872,2,0,3,-3,12,1
230320,3,19,10,9,17,0
57278,1,0,0,0,10,1
133969,4,16,13,3,9,1
191418,3,0,31,-31,17,0
381730,4,32,31,1,17,1
167778,5,26,26,0,7,1
48577,3,14,17,-3,5,0
316728,1,10,0,10,4,1
380938,2,9,7,2,16,1
57026,2,7,17,-10,9,1
366559,3,20,7,13,10,0
322208,3,0,20,-20,7,1
252005,2,14,20,-6,10,0
381480,1,14,0,14,17,1
409187,1,0,0,0,12,1
268212,4,12,28,-16,17,1
184530,3,27,14,13,14,0
152558,4,24,14,10,17,0
210561,1,6,7,-1,9,0
80644,3,10,16,-6,3,1
223893,4,30,6,24,15,0
382799,2,21,0,21,17,0
2159,4,13,23,-10,1,1
308234,2,7,10,-3,1,1
85825,3,13,13,0,5,1
389095,3,23,0,23,3,1
283374,1,0,0,0,7,0
142021,4,20,14,6,13,1
287943,2,14,13,1,9,1
290023,2,7,0,7,10,0
198835,4,13,29,-16,3,1
295972,1,0,0,0,13,1
108989,2,16,27,-11,15,0
81505,2,0,14,-14,3,0
218756,3,0,13,-13,13,0
224080,4,14,9,5,15,1
11521,3,6,10,-4,6,0
195043,2,7,17,-10,2,0
224933,3,3,9,-6,15,0
345004,4,10,23,-13,17,1
294190,2,0,7,-7,12,0
188887,3,10,10,0,16,1
209974,1,0,3,-3,8,1
179795,4,6,27,-21,12,1
261425,4,10,24,-14,14,1
44770,4,13,12,1,3,0
223790,1,6,0,6,15,0
295969,1,0,0,0,13,1
244462,1,0,3,-3,7,0
211152,2,0,10,-10,9,1
15387,4,10,17,-7,8,1
22507,4,31,35,-4,11,0
345547,2,7,17,-10,17,1
180258,1,0,0,0,13,1
181409,3,17,17,0,13,0
45292,2,7,7,0,4,0
129033,1,0,7,-7,7,1
152769,2,7,7,0,17,0
250710,4,17,22,-5,10,0
319064,4,20,38,-18,5,1
85340,3,21,3,18,5,1
17654,2,7,3,4,9,1
28648,2,0,7,-7,14,1
188567,3,3,13,-10,16,1
235364,1,14,0,14,3,0
274658,1,7,0,7,3,0
27549,4,23,12,11,13,0
334982,2,10,7,3,13,0
12588,4,3,24,-21,6,0
176013,2,17,0,17,11,1
33052,1,3,0,3,16,0
84622,3,20,13,7,4,1
369312,3,14,20,-6,11,1
231483,3,23,12,11,1,0
58560,2,10,10,0,10,0
345759,4,16,10,6,17,0
357991,3,24,13,11,6,1
228356,2,7,17,-10,17,1
51150,2,17,3,14,7,0
20004,2,9,6,3,10,0
71540,1,0,0,0,16,1
160139,2,10,0,10,3,0
273122,1,0,0,0,2,1
393043,1,0,3,-3,4,1
285604,3,20,10,10,8,0
158944,2,14,15,-1,3,0
244122,4,20,34,-14,6,0
349537,1,0,14,-14,2,1
36059,2,17,0,17,17,1
296202,3,16,26,-10,13,0
354288,1,7,0,7,4,1
226902,3,3,10,-7,16,0
221985,1,0,0,0,14,0
390493,1,7,0,7,3,1
401786,1,7,0,7,9,1
50680,1,0,7,-7,6,1
107719,1,7,0,7,15,0
52907,1,0,0,0,7,1
36082,3,31,0,31,17,1
92918,4,34,7,27,8,0
312152,4,33,23,10,2,1
369576,3,14,0,14,11,1
330715,4,6,6,0,11,1
71765,3,31,29,2,16,0
154500,4,14,17,-3,1,1
150179,3,6,26,-20,16,1
411787,3,0,33,-33,13,1
262361,4,16,19,-3,15,0
72806,3,24,14,10,16,0
19735,3,9,6,3,10,0
334161,4,23,7,16,13,0
71167,2,19,10,9,16,0
202808,1,0,0,0,5,0
32601,4,27,13,14,15,1
179734,2,3,10,-7,12,1
101458,4,18,13,5,12,1
20341,2,10,13,-3,10,0
372800,3,3,0,3,13,0
399031,2,10,12,-2,7,1
267910,1,0,0,0,17,1
396100,2,17,9,8,6,0
84368,4,28,30,-2,4,1
212968,3,14,7,7,10,1
297681,2,10,6,4,13,1
169283,4,23,6,17,7,1
159811,1,0,0,0,3,0
279453,4,16,30,-14,5,0
252881,1,3,0,3,11,1
246872,5,20,23,-3,8,1
243605,3,20,7,13,6,0
34647,4,31,10,21,16,0
86777,4,30,21,9,5,0
201249,1,0,0,0,5,1
94529,3,3,10,-7,9,1
114158,1,0,0,0,1,1
417241,3,20,20,0,16,0
129213,2,14,6,8,7,1
267678,2,7,24,-17,17,1
46311,2,3,14,-11,4,0
420753,2,0,3,-3,17,1
38621,1,0,0,0,1,0
82496,3,10,17,-7,3,0
245357,1,9,0,9,7,0
243588,3,10,7,3,6,0
218143,2,7,3,4,12,0
248129,1,3,3,0,8,0
148240,4,18,31,-13,16,1
19940,4,22,21,1,10,0
29281,2,21,7,14,14,1
195721,4,14,16,-2,2,1
20722,4,24,20,4,10,1
286490,1,0,0,0,8,1
204258,2,0,7,-7,6,1
60450,4,23,27,-4,11,1
391732,3,9,10,-1,4,1
205344,2,20,0,20,6,1
205540,4,14,24,-10,6,1
363046,1,0,0,0,8,1
40301,2,6,0,6,2,1
167709,3,23,20,3,7,0
267425,4,17,17,0,17,0
178713,4,3,20,-17,12,0
253024,1,0,0,0,11,0
252181,3,20,17,3,10,1
97533,3,23,0,23,10,0
192840,4,7,15,-8,1,1
151877,2,13,0,13,17,0
165512,2,0,14,-14,6,1
111346,2,0,7,-7,16,1
146204,2,0,10,-10,15,0
16473,2,3,0,3,8,1
59050,2,3,10,-7,10,1
183681,3,0,14,-14,14,1
233492,4,26,10,16,2,0
387548,2,3,3,0,2,1
153297,3,2,10,-8,1,1
133947,4,13,6,7,9,0
228795,2,3,14,-11,17,1
159805,1,0,0,0,3,1
156099,1,7,0,7,2,0
194384,1,0,0,0,2,1
44447,3,17,7,10,3,0
175513,2,3,0,3,11,0
124989,2,3,3,0,5,1
397627,3,6,27,-21,7,0
250089,4,17,16,1,9,1
239605,4,20,10,10,4,0
371439,2,7,7,0,12,1
6494,2,0,0,0,3,1
127226,4,16,16,0,6,1
387705,3,0,13,-13,2,0
361527,3,10,7,3,7,1
371729,2,14,14,0,12,1
12815,2,3,3,0,6,1
36920,2,0,16,-16,17,0
72530,3,16,17,-1,16,0
221098,2,0,6,-6,14,1
220148,3,26,13,13,13,0
321738,2,6,6,0,7,1
368418,3,20,7,13,11,0
1691,3,14,0,14,1,1
139026,4,21,19,2,12,1
226994,2,3,6,-3,16,1
278092,4,13,17,-4,4,0
204599,2,0,38,-38,6,0
104873,2,0,3,-3,14,1
109287,3,6,0,6,15,0
121397,4,7,6,1,3,0
364298,3,3,29,-26,9,1
103769,1,3,0,3,13,0
3906,2,19,14,5,2,1
404032,2,3,28,-25,10,1
24081,3,7,7,0,12,0
329456,1,3,0,3,10,0
29058,4,20,10,10,14,1
15007,1,0,7,-7,7,0
90125,2,3,0,3,7,1
242022,3,7,3,4,5,0
274850,2,0,10,-10,3,1
273698,4,22,20,2,2,1
299953,1,0,7,-7,14,1
311133,4,13,13,0,2,0
160659,2,10,0,10,4,0
138090,4,49,24,25,11,1
415780,4,21,23,-2,15,0
209962,1,0,3,-3,8,0
247609,4,19,23,-4,8,1
130936,2,7,21,-14,8,1
326495,2,31,9,22,9,0
215715,1,3,0,3,11,1
240502,3,3,7,-4,5,1
82522,4,10,20,-10,3,0
152218,2,21,0,21,17,0
53733,3,7,3,4,8,0
52958,2,14,17,-3,7,1
392551,4,10,20,-10,4,0
38986,3,30,10,20,1,0
328474,3,6,3,3,10,0
242782,3,14,24,-10,6,0
208258,1,0,0,0,8,0
239706,2,7,10,-3,4,0
238743,1,0,0,0,4,1
50615,3,3,6,-3,6,1
112744,3,10,7,3,17,1
46430,1,0,0,0,4,1
245848,2,3,17,-14,7,0
408055,3,10,10,0,12,0
140220,5,13,13,0,12,0
105451,4,23,31,-8,14,1
351352,2,10,7,3,3,0
407621,4,10,17,-7,11,0
347110,2,10,3,7,1,1
290050,2,7,6,1,10,0
130651,3,7,28,-21,8,0
16965,3,27,20,7,8,0
358837,2,3,7,-4,6,0
368705,2,7,16,-9,11,0
386931,2,7,21,-14,2,1
26805,4,13,43,-30,13,1
135813,2,7,14,-7,10,0
101978,1,0,0,0,12,0
406962,2,3,13,-10,11,1
139722,3,7,7,0,12,0
170071,1,0,0,0,8,0
172151,4,13,21,-8,9,1
138456,2,21,14,7,12,0
421016,4,14,34,-20,17,0
6985,3,10,7,3,3,0
230630,4,16,24,-8,1,0
142216,5,11,13,-2,13,1
103607,1,0,0,0,13,0
262071,1,7,0,7,15,0
240548,4,19,19,0,5,0
288612,4,23,41,-18,9,1
70751,3,20,17,3,15,0
31266,1,0,0,0,15,0
12765,4,59,0,59,6,1
71451,2,30,7,23,16,0
221321,4,6,35,-29,14,1
142565,1,0,3,-3,13,1
41486,3,5,7,-2,2,1
247012,4,20,31,-11,8,0
318443,3,21,7,14,5,1
146126,4,25,17,8,15,0
271639,4,23,30,-7,2,1
61061,1,0,0,0,11,1
160939,2,7,7,0,4,0
310862,1,3,0,3,2,0
280256,2,6,13,-7,5,0
196225,2,7,10,-3,2,1
340756,2,10,7,3,15,0
283342,4,10,16,-6,7,1
231936,4,7,41,-34,1,1
101057,2,0,10,-10,12,1
66142,1,3,0,3,13,0
61237,2,14,7,7,11,1
3420,2,3,16,-13,2,1
398964,4,23,20,3,7,0
342524,1,0,6,-6,16,1
288124,3,16,7,9,9,0
14647,3,23,14,9,7,1
236232,4,27,22,5,3,0
241946,1,0,0,0,5,1
375196,4,17,17,0,14,0
344518,2,0,0,0,17,0
321741,2,6,6,0,7,1
401643,1,0,7,-7,8,1
47510,2,17,3,14,5,0
331086,1,0,0,0,11,0
331175,3,7,13,-6,11,0
215773,3,29,6,23,11,0
404178,3,9,7,2,10,0
117871,4,12,20,-8,2,0
322984,4,20,0,20,7,0
116934,4,21,13,8,2,0
400713,4,16,10,6,8,0
223389,3,7,19,-12,15,1
390717,3,13,10,3,3,1
8142,1,0,7,-7,4,1
322659,4,6,9,-3,7,0
213353,2,10,6,4,10,1
343519,3,10,10,0,16,0
104015,4,13,13,0,13,1
229396,2,3,0,3,17,1
393402,3,21,17,4,5,0
347503,3,12,23,-11,1,1
374195,4,23,28,-5,13,1
166963,4,19,9,10,6,0
214718,2,3,7,-4,11,1
84893,3,34,17,17,4,0
75692,1,14,0,14,1,0
242771,3,14,24,-10,6,1
186786,2,26,7,19,15,1
224457,2,9,10,-1,15,0
199773,1,3,0,3,4,0
403551,1,7,0,7,9,1
98666,1,0,0,0,11,0
146619,1,0,7,-7,15,1
274480,1,7,0,7,3,0
131548,3,9,16,-7,8,1
233953,4,24,13,11,2,0
263134,1,0,7,-7,15,1
208682,4,9,6,3,8,0
415532,1,0,0,0,15,0
217595,2,3,9,-6,12,1
108397,3,3,21,-18,15,1
403164,2,10,14,-4,9,1
264637,4,20,20,0,16,1
334145,3,16,7,9,13,1
325403,1,0,0,0,8,0
113251,2,7,7,0,17,1
117331,2,21,0,21,2,0
300278,2,0,7,-7,14,1
281967,3,14,14,0,6,0
67393,4,30,13,17,14,1
174449,5,17,17,0,10,1
287527,4,14,33,-19,9,1
290570,4,23,20,3,10,1
13396,1,0,7,-7,7,1
339659,4,31,24,7,15,1
148710,1,10,0,10,16,1
17646,2,7,3,4,9,1
383041,1,3,7,-4,17,1
340482,2,0,19,-19,15,0
410972,1,0,7,-7,13,1
143330,2,0,13,-13,14,0
113692,1,0,7,-7,17,0
158916,2,14,3,11,3,1
391109,2,7,14,-7,4,1
115615,4,30,9,21,1,0
65433,2,0,14,-14,13,1
421100,2,20,3,17,17,0
316268,2,7,16,-9,4,1
163618,3,21,19,2,5,0
181621,4,23,6,17,13,0
400617,1,0,0,0,8,0
219612,2,3,0,3,13,1
345961,4,27,23,4,17,0
163023,4,19,3,16,5,0
163256,2,6,6,0,5,0
305013,4,24,20,4,16,0
55959,2,10,7,3,9,0
143660,3,16,10,6,14,0
283709,2,0,0,0,7,1
124247,2,7,17,-10,5,1
269590,1,0,0,0,1,1
273551,4,28,35,-7,2,0
394711,1,14,0,14,5,0
143799,3,6,0,6,14,0
103911,1,3,0,3,13,0
123047,3,7,13,-6,4,0
39106,2,13,7,6,1,0
414220,1,7,7,0,14,1
243389,1,3,7,-4,6,0
77249,3,16,7,9,1,0
158280,1,0,0,0,3,1
19463,3,17,17,0,10,1
53993,1,0,0,0,8,0
4505,3,17,19,-2,2,0
44778,4,13,19,-6,3,1
21138,3,0,13,-13,10,1
247139,3,20,6,14,8,0
414709,3,3,17,-14,14,0
120502,5,39,41,-2,3,1
35660,3,23,3,20,17,0
231885,2,7,27,-20,1,1
222328,2,14,3,11,14,0
318034,4,17,16,1,5,1
11888,4,48,20,28,6,0
300674,4,24,3,21,15,1
221850,2,6,0,6,14,0
347601,2,7,10,-3,1,1
407840,2,3,0,3,11,1
205621,2,7,6,1,7,1
46831,1,0,0,0,5,1
166524,1,0,0,0,6,0
161860,1,13,0,13,4,0
184451,4,31,13,18,14,1
349775,4,23,21,2,2,1
121557,3,16,10,6,4,0
45056,4,23,13,10,4,0
38664,2,7,0,7,1,0
355813,1,6,0,6,5,0
194076,4,35,14,21,1,0
387011,4,14,28,-14,2,1
399910,2,0,6,-6,8,0
421833,2,0,13,-13,17,1
48852,2,3,0,3,5,1
49447,5,20,20,0,6,0
50162,4,0,24,-24,6,0
297780,1,7,0,7,13,0
337840,4,30,6,24,14,1
225366,3,17,21,-4,15,0
299284,3,23,7,16,14,1
388406,1,0,3,-3,2,1
413136,3,33,35,-2,14,1
46129,1,0,7,-7,4,1
152097,3,13,10,3,17,0
203108,4,42,17,25,5,1
270637,1,0,0,0,1,0
126900,4,17,14,3,6,1
208689,4,9,13,-4,8,1
134281,1,0,6,-6,10,0
261627,1,0,0,0,14,0
64097,4,34,24,10,13,0
120024,4,30,38,-8,3,0
145656,3,28,7,21,14,1
305156,4,24,10,14,16,1
274342,1,3,7,-4,3,1
86987,3,14,6,8,5,1
121098,4,18,31,-13,3,1
231355,4,9,16,-7,1,0
352688,3,17,3,14,3,1
46541,4,40,9,31,4,1
213599,4,29,14,15,10,0
307368,4,16,22,-6,17,0
155710,3,10,20,-10,2,1
125714,1,0,7,-7,5,1
230119,2,3,10,-7,17,1
49934,2,14,0,14,6,1
261531,3,12,0,12,14,0
7180,4,48,24,24,4,0
346177,2,17,0,17,1,0
103184,2,0,0,0,13,1
315270,4,20,19,1,4,1
119322,4,14,16,-2,3,0
342233,2,3,0,3,16,0
254413,2,13,0,13,11,1
113084,4,16,23,-7,17,1
324033,4,20,25,-5,8,0
87630,1,0,0,0,6,0
50055,1,0,0,0,6,0
198732,1,3,0,3,3,1
205024,2,9,10,-1,6,0
399524,3,0,26,-26,7,1
262502,4,21,35,-14,15,0
40539,1,7,0,7,2,0
148994,4,13,12,1,16,0
160109,1,0,0,0,3,1
186581,1,7,0,7,15,1
377201,1,0,0,0,15,0
102065,3,34,10,24,12,1
296523,4,26,3,23,13,0
189370,4,20,10,10,16,0
269349,2,7,7,0,1,0
172313,1,0,0,0,9,1
219137,1,0,3,-3,13,1
39725,3,9,0,9,1,1
185473,4,24,20,4,15,0
353298,4,38,28,10,4,0
305458,4,20,3,17,17,0
163882,2,9,10,-1,5,0
343999,4,23,6,17,17,0
190362,2,7,0,7,17,0
355874,3,13,10,3,5,0
318862,2,21,12,9,5,1
342291,3,20,3,17,16,0
236883,1,12,0,12,3,1
378457,3,17,0,17,15,1
163848,1,0,7,-7,5,1
134958,3,7,22,-15,10,0
91524,4,19,10,9,8,1
362799,2,7,21,-14,8,1
210664,4,20,24,-4,9,0
58037,1,0,0,0,10,1
382335,1,0,0,0,17,0
413451,4,16,38,-22,14,1
240980,4,21,22,-1,5,1
248046,3,31,13,18,8,1
413181,4,46,45,1,14,0
268202,4,12,25,-13,17,0
337520,3,7,19,-12,14,0
264856,1,0,6,-6,16,0
80416,4,27,16,11,2,1
210333,3,16,17,-1,9,1
65906,3,14,14,0,13,1
349219,4,27,21,6,2,0
59420,1,0,7,-7,11,1
93330,3,24,3,21,9,1
246463,2,9,0,9,8,0
276152,1,10,0,10,3,0
110441,2,17,0,17,16,1
199062,2,0,14,-14,4,1
191447,4,0,34,-34,17,1
113842,1,0,0,0,17,1
217847,2,3,14,-11,12,1
191945,1,0,6,-6,1,1
302497,3,3,10,-7,15,1
385508,1,0,0,0,1,1
397057,4,21,9,12,6,0
265105,3,13,10,3,16,1
72925,2,17,7,10,16,1
281653,3,24,10,14,6,0
25594,3,27,10,17,12,1
72173,2,3,10,-7,16,1
178402,4,31,34,-3,12,1
266409,4,36,8,28,16,0
22631,3,23,10,13,11,1
212017,3,10,23,-13,9,0
398198,2,14,10,4,7,1
216988,2,3,3,0,12,0
236885,1,12,0,12,3,1
393178,1,0,3,-3,5,0
194796,3,10,23,-13,2,1
130308,1,7,0,7,8,1
70190,4,30,14,16,15,0
37021,1,3,0,3,17,1
344401,3,28,21,7,17,0
174491,2,7,7,0,10,1
170246,2,0,6,-6,8,0
212391,4,13,17,-4,10,0
112213,1,7,0,7,17,0
348169,1,6,0,6,1,1
129118,3,27,28,-1,7,1
134394,4,32,24,8,10,0
228917,1,7,9,-2,17,1
245678,1,3,3,0,7,0
225083,3,10,14,-4,15,1
288744,4,0,10,-10,9,1
239489,4,22,24,-2,4,0
105109,3,26,14,12,14,1
380621,1,7,0,7,16,0
107899,2,0,3,-3,15,1
236940,3,29,7,22,3,0
263561,1,0,0,0,15,0
343095,4,12,20,-8,16,1
108343,1,0,7,-7,15,0
198026,3,0,30,-30,3,0
229544,2,17,6,11,17,1
407895,3,9,16,-7,11,0
17900,4,24,17,7,9,0
73031,2,0,10,-10,16,1
366874,3,3,6,-3,10,0
291190,4,24,29,-5,10,1
248598,2,7,3,4,9,1
363854,3,13,26,-13,8,1
155014,1,6,10,-4,1,1
251791,1,0,0,0,10,1
400727,4,16,17,-1,8,1
123437,1,0,0,0,4,0
248778,3,27,14,13,9,1
325558,1,0,0,0,9,1
60514,2,27,7,20,11,1
320616,4,31,18,13,6,1
96728,2,0,10,-10,10,1
402818,1,0,0,0,9,1
50286,3,13,16,-3,6,1
163091,2,7,12,-5,5,0
112293,3,38,17,21,17,0
7997,1,3,0,3,4,0
411339,3,17,10,7,13,0
157852,2,6,9,-3,3,1
109519,1,0,7,-7,16,1
414186,4,17,23,-6,14,1
193838,2,17,0,17,1,1
47487,2,10,3,7,5,1
413149,4,33,35,-2,14,0
266096,3,17,10,7,16,0
57485,2,14,10,4,10,1
112320,4,45,17,28,17,0
228424,4,10,27,-17,17,0
417920,4,16,10,6,16,0
132264,2,21,7,14,9,0
56200,1,3,0,3,9,1
77683,3,10,17,-7,1,0
324949,1,0,7,-7,8,1
280931,4,21,10,11,6,0
225355,3,10,21,-11,15,0
157180,1,0,0,0,2,0
152776,3,7,7,0,17,0
105238,3,7,24,-17,14,0
224978,4,10,19,-9,15,0
337552,4,7,33,-26,14,0
148779,3,13,13,0,16,0
260189,2,7,0,7,14,1
77583,4,27,14,13,1,1
10574,1,0,0,0,5,0
155550,3,23,3,20,2,0
336794,4,10,17,-7,14,1
244120,4,20,34,-14,6,1
365232,1,0,7,-7,9,0
790,2,7,3,4,1,0
261015,4,10,3,7,14,0
109547,2,0,7,-7,16,0
413316,4,20,0,20,14,1
145483,3,16,17,-1,14,0
125379,1,0,0,0,5,0
392264,1,0,0,0,4,0
93465,3,3,28,-25,9,0
363696,3,8,10,-2,8,0
49180,2,10,0,10,6,1
255328,2,14,0,14,12,0
40386,1,0,0,0,2,0
134848,4,55,20,35,10,1
97937,2,0,7,-7,11,1
252088,1,0,0,0,10,0
364505,1,0,7,-7,9,1
217556,1,3,3,0,12,0
351984,3,28,14,14,3,0
9214,3,3,23,-20,5,1
195649,2,7,7,0,2,0
173999,1,0,6,-6,10,1
207061,4,38,3,35,7,0
162987,3,6,3,3,5,0
199963,2,10,10,0,4,1
303555,1,7,3,4,16,1
174131,1,0,0,0,10,1
393951,1,0,0,0,5,1
20806,2,14,0,14,10,0
84524,4,27,31,-4,4,1
236298,2,0,9,-9,3,0
38110,4,6,6,0,1,1
135168,1,0,0,0,10,1
270735,3,6,3,3,1,1
280399,2,3,7,-4,5,1
113318,3,16,31,-15,17,1
280479,4,34,31,3,5,0
146198,2,0,10,-10,15,1
384377,1,7,0,7,1,0
39589,3,20,6,14,1,1
393351,1,7,7,0,5,1
284888,1,0,6,-6,7,0
365375,1,0,0,0,9,1
420133,2,0,3,-3,17,1
408035,2,10,7,3,12,0
127412,1,0,0,0,6,1
136275,2,15,7,8,11,1
94675,3,17,29,-12,9,1
327789,1,0,3,-3,10,0
285590,3,13,10,3,8,0
236495,2,7,9,-2,3,0
154728,2,3,7,-4,1,0
301875,2,0,3,-3,15,0
236086,4,44,10,34,3,1
311148,1,0,0,0,2,1
76132,1,0,0,0,1,0
178877,4,41,21,20,12,0
309809,1,7,0,7,1,0
176569,4,19,17,2,11,0
103512,2,13,0,13,13,0
329252,4,24,13,11,10,1
155880,3,7,13,-6,2,1
220517,2,0,14,-14,13,0
302429,1,0,3,-3,15,1
50441,3,10,7,3,6,0
195321,1,3,0,3,2,0
183332,1,7,0,7,14,0
164389,4,30,3,27,5,1
137667,1,0,7,-7,11,1
95913,4,20,23,-3,10,1
407667,1,0,0,0,11,0
273576,1,3,3,0,2,1
398629,2,0,0,0,7,0
70153,2,20,7,13,15,1
382146,4,27,3,24,17,1
389632,2,16,10,6,3,1
16049,2,13,0,13,8,1
113099,1,0,0,0,17,1
62181,4,10,17,-7,12,1
237692,3,20,14,6,4,1
158263,4,38,0,38,3,0
72257,4,27,17,10,16,1
42277,4,37,7,30,2,1
372955,4,25,7,18,13,0
297389,3,9,24,-15,13,1
50083,2,0,14,-14,6,1
360117,1,6,3,3,7,1
62167,3,7,14,-7,12,1
403818,4,18,30,-12,9,1
265646,3,6,15,-9,16,1
195494,2,0,0,0,2,1
188535,2,3,3,0,16,0
411834,4,7,34,-27,13,1
185,2,3,3,0,1,1
346533,3,24,33,-9,1,0
220130,3,26,13,13,13,1
345422,3,0,13,-13,17,1
256443,3,12,21,-9,12,0
85399,4,31,10,21,5,0
338678,3,13,10,3,14,1
170867,2,7,0,7,8,0
216999,2,3,3,0,12,1
95475,4,43,7,36,10,1
129741,3,17,17,0,7,0
119348,4,14,16,-2,3,0
388117,2,3,3,0,2,1
56097,2,14,7,7,9,1
84443,2,6,7,-1,4,0
374904,4,14,18,-4,14,0
207541,1,7,0,7,7,1
29009,3,7,7,0,14,1
171323,3,10,3,7,9,0
277598,4,12,14,-2,4,0
171727,1,0,0,0,9,1
124458,4,9,13,-4,5,0
337607,2,14,7,7,14,0
132535,2,2,26,-24,9,0
63761,3,14,15,-1,12,0
127221,4,16,16,0,6,0
140100,2,0,0,0,12,1
74427,4,10,20,-10,17,1
261579,4,12,15,-3,14,1
69581,3,7,10,-3,15,0
106304,2,7,9,-2,14,1
339645,4,31,17,14,15,0
232659,3,7,0,7,1,0
13860,2,7,0,7,7,1
345091,2,6,3,3,17,1
38542,3,24,6,18,1,0
312269,4,10,23,-13,2,0
344209,1,0,3,-3,17,1
367694,2,0,6,-6,10,1
329208,2,10,13,-3,10,1
318179,4,22,17,5,5,1
149592,4,17,26,-9,16,0
259778,4,20,10,10,14,0
185843,2,3,3,0,15,1
141441,4,13,23,-10,13,1
341846,3,13,12,1,16,0
51070,4,3,23,-20,6,1
219371,3,23,13,10,13,0
405760,3,10,13,-3,10,0
258486,4,27,21,6,13,1
152292,4,28,0,28,17,0
79385,1,3,0,3,2,0
118643,1,7,6,1,2,1
322281,1,7,0,7,7,0
98881,2,7,7,0,11,0
35400,5,30,30,0,16,1
313704,2,7,3,4,3,1
18542,1,3,3,0,9,1
412352,3,17,17,0,13,1
400081,2,17,9,8,8,0
59048,2,3,10,-7,10,0
109932,4,23,16,7,16,1
84404,1,3,0,3,4,1
370101,1,7,0,7,12,0
127379,4,17,23,-6,6,0
238827,3,27,0,27,4,0
342180,4,15,19,-4,16,0
79024,3,10,7,3,2,0
45720,2,7,7,0,4,1
233543,1,7,13,-6,2,0
81720,3,17,17,0,3,1
31901,2,6,7,-1,15,0
94141,2,3,7,-4,9,0
391745,3,10,10,0,4,1
392843,4,17,20,-3,4,0
108366,2,0,14,-14,15,0
186017,2,10,34,-24,15,1
386545,4,14,21,-7,2,0
325554,1,0,0,0,9,0
279957,2,0,10,-10,5,1
420089,1,0,0,0,17,0
192681,4,13,7,6,1,1
321837,1,7,7,0,7,0
310260,1,9,0,9,2,1
209512,2,20,10,10,8,1
113267,2,7,14,-7,17,1
110696,1,0,3,-3,16,1
312812,2,7,0,7,3,1
293639,2,10,7,3,12,0
178318,2,7,3,4,12,0
194370,4,26,6,20,2,0
52706,3,3,20,-17,7,1
109993,2,17,10,7,16,1
306121,1,0,0,0,17,1
414240,2,14,21,-7,14,1
81461,4,10,16,-6,3,1
142387,1,0,0,0,13,0
286833,1,3,7,-4,8,0
78623,4,30,13,17,2,0
40748,2,17,14,3,2,0
328944,3,9,7,2,10,0
250507,3,16,7,9,9,0
53133,3,19,38,-19,7,0
286926,4,23,13,10,8,0
32271,4,24,21,3,15,1
15092,4,10,26,-16,7,1
54036,2,3,0,3,8,1
153593,3,12,14,-2,1,0
276484,2,13,7,6,4,0
169051,3,26,14,12,7,1
371891,3,24,10,14,12,1
156542,4,14,6,8,2,0
281822,3,10,0,10,6,0
240334,3,7,23,-16,5,0
84580,2,10,7,3,4,1
46197,2,14,14,0,4,0
306220,4,20,3,17,17,1
49714,4,21,31,-10,6,1
248134,2,3,3,0,8,1
39197,1,0,0,0,1,1
332079,4,10,9,1,12,1
282057,1,3,8,-5,6,0
226235,2,6,0,6,16,1
19541,1,0,0,0,10,0
368369,1,7,0,7,11,1
26744,3,6,17,-11,13,0
76399,4,29,12,17,1,1
119220,1,0,3,-3,3,1
97094,3,31,6,25,10,1
311261,4,6,3,3,2,1
154471,3,14,7,7,1,0
119314,4,14,13,1,3,0
122515,1,0,0,0,4,1
409047,1,3,7,-4,12,0
407098,2,0,20,-20,11,1
288952,1,9,0,9,9,0
228849,3,6,17,-11,17,1
225212,3,3,7,-4,15,0
191561,3,14,24,-10,17,0
55631,1,7,0,7,9,0
390188,1,0,3,-3,3,0
286455,4,17,10,7,8,0
112818,1,0,0,0,17,0
300141,2,14,3,11,14,0
87447,4,20,10,10,6,0
384079,1,0,7,-7,1,0
50022,4,28,10,18,6,1
386096,4,14,6,8,1,0
322813,3,3,27,-24,7,0
142106,2,0,7,-7,13,0
338325,1,3,0,3,14,1
134569,1,10,0,10,10,0
360871,1,0,0,0,7,1
85671,3,24,14,10,5,0
177449,3,24,10,14,11,0
420155,2,0,3,-3,17,0
174313,2,10,0,10,10,1
57537,4,24,16,8,10,1
389266,4,34,7,27,3,1
379976,1,0,0,0,16,1
103550,3,33,0,33,13,1
373446,4,17,20,-3,13,1
32026,1,7,0,7,15,0
333558,3,16,10,6,12,1
212757,2,10,21,-11,10,1
329913,2,7,10,-3,11,1
1833,3,16,7,9,1,1
237861,3,7,27,-20,4,0
322008,1,3,0,3,7,0
105953,1,10,0,10,14,0
17570,4,13,17,-4,9,1
328629,3,20,35,-15,10,0
267949,2,0,0,0,17,0
220530,2,7,17,-10,13,0
321553,1,3,3,0,7,0
172754,4,21,16,5,9,0
5952,3,17,23,-6,3,0
351354,2,10,7,3,3,0
96292,2,0,9,-9,10,0
236880,1,12,0,12,3,0
130321,2,7,0,7,8,0
106332,3,14,19,-5,14,1
401732,4,17,14,3,8,1
125405,1,7,0,7,5,0
304,1,0,0,0,1,1
239910,4,13,3,10,4,1
393666,1,0,0,0,5,1
382722,4,9,13,-4,17,1
104398,4,52,38,14,13,0
74028,1,0,0,0,17,0
329555,4,45,14,31,10,0
234235,4,20,17,3,2,1
263631,2,17,10,7,15,1
276692,4,23,13,10,4,0
122392,1,0,17,-17,4,0
258370,1,7,0,7,13,0
162585,1,0,0,0,5,0
120535,1,0,6,-6,3,1
70425,2,14,17,-3,15,1
233820,4,32,37,-5,2,0
368763,4,21,22,-1,11,1
124861,3,3,6,-3,5,1
303154,4,21,28,-7,16,0
292940,4,10,0,10,11,1
395324,1,14,0,14,5,1
126664,2,0,3,-3,6,1
119535,1,7,0,7,3,0
70223,4,30,30,0,15,1
35696,4,23,10,13,17,1
305068,2,21,7,14,16,0
130590,1,7,0,7,8,0
126181,2,14,3,11,6,0
349716,2,14,7,7,2,1
13867,2,7,0,7,7,1
20500,3,3,0,3,10,0
111039,1,7,0,7,16,1
260933,2,0,0,0,14,1
355418,2,10,10,0,4,1
102974,4,12,31,-19,13,0
285058,2,0,0,0,7,0
76824,3,33,0,33,1,1
414698,2,3,10,-7,14,0
381405,3,16,0,16,16,0
402932,4,24,9,15,9,0
116036,3,13,7,6,1,0
206010,4,16,16,0,7,0
208870,1,7,0,7,8,0
246527,3,22,7,15,8,1
224122,1,0,10,-10,15,1
28542,3,24,7,17,14,1
147196,1,0,0,0,15,0
92580,3,17,3,14,8,1
305077,2,21,7,14,16,1
33239,2,10,0,10,16,0
407607,3,10,17,-7,11,0
327149,3,14,17,-3,9,1
351671,3,7,10,-3,3,1
246384,4,26,10,16,7,0
254620,3,21,14,7,11,1
263188,3,3,17,-14,15,1
101534,2,10,20,-10,12,0
132144,3,10,3,7,9,0
81743,3,17,17,0,3,1
224629,3,16,10,6,15,1
12914,4,13,13,0,6,0
374089,1,7,0,7,13,1
8669,4,7,10,-3,4,1
185546,2,10,9,1,15,0
17793,2,7,3,4,9,0
407281,3,17,16,1,11,0
366253,2,7,10,-3,10,1
138375,4,32,7,25,11,0
288024,1,0,0,0,9,1
418914,4,20,17,3,16,1
278404,1,0,0,0,4,0
24270,4,13,17,-4,12,0
19540,1,0,0,0,10,0
167772,5,26,26,0,7,1
194260,1,0,0,0,2,1
207647,4,42,10,32,7,0
353033,4,26,10,16,3,0
163591,3,7,19,-12,5,0
50185,4,6,30,-24,6,0
298198,1,0,3,-3,14,0
177331,1,3,0,3,11,1
338218,2,14,21,-7,14,0
417208,2,17,17,0,16,0
249362,2,10,12,-2,9,1
32855,3,6,7,-1,15,1
82209,4,16,3,13,3,1
108692,3,27,13,14,15,0
130112,1,0,0,0,8,0
374434,3,18,0,18,14,1
256477,4,19,24,-5,12,0
277668,1,7,0,7,4,1
183968,3,20,3,17,14,1
13273,2,0,13,-13,7,1
413134,3,33,35,-2,14,1
180042,3,21,20,1,13,0
390441,4,14,33,-19,3,0
278170,2,17,14,3,4,1
175342,1,7,0,7,11,0
212752,2,10,21,-11,10,0
181351,1,13,0,13,13,1
231265,1,0,3,-3,1,0
122831,2,10,3,7,4,1
159155,4,31,7,24,3,0
197952,1,0,0,0,3,0
418578,2,14,3,11,16,0
151173,2,3,10,-7,17,0
244899,1,0,0,0,7,0
316193,4,30,35,-5,4,1
113321,3,16,31,-15,17,1
416042,3,14,3,11,15,1
249,3,12,24,-12,1,1
299729,3,17,6,11,14,0
158971,3,14,29,-15,3,1
34009,4,17,27,-10,16,0
110713,1,0,3,-3,16,1
398728,2,0,17,-17,7,1
271147,2,7,10,-3,1,0
363546,3,3,5,-2,8,1
185225,2,10,6,4,15,1
314717,1,0,0,0,4,1
261839,2,6,10,-4,14,0
198272,1,3,7,-4,3,1
235743,3,10,20,-10,3,0
65942,4,17,14,3,13,1
21739,3,24,14,10,11,0
413,3,38,20,18,1,0
57812,3,19,10,9,10,1
405974,4,14,7,7,11,1
74580,4,10,3,7,17,1
351913,1,0,7,-7,3,1
305690,2,3,7,-4,17,1
183336,1,7,0,7,14,1
361959,3,10,6,4,7,1
303577,2,14,6,8,16,1
197000,3,20,17,3,3,1
258165,4,13,13,0,13,1
18739,2,6,10,-4,9,0
215273,1,0,0,0,11,1
410092,2,14,7,7,13,0
76454,1,0,7,-7,1,0
266082,3,17,10,7,16,1
354114,4,19,0,19,4,1
270318,4,20,27,-7,1,1
333360,2,17,10,7,12,1
326490,2,24,9,15,9,1
222563,4,17,14,3,14,0
236782,2,0,9,-9,3,1
291228,1,7,3,4,10,0
199376,2,7,10,-3,4,0
701,4,0,17,-17,1,0
365123,2,0,14,-14,9,1
113825,1,0,0,0,17,0
262458,3,7,21,-14,15,0
179747,3,6,10,-4,12,0
35021,2,9,0,9,16,0
102211,4,24,7,17,13,0
269816,3,13,10,3,1,1
143154,1,0,0,0,13,0
391316,3,17,3,14,4,1
358953,1,0,0,0,6,0
347324,4,7,21,-14,1,0
16638,3,7,27,-20,8,1
197959,1,0,3,-3,3,0
141608,1,0,0,0,13,1
293656,2,10,7,3,12,1
417740,4,35,19,16,16,0
234909,1,7,0,7,2,0
301480,3,20,9,11,15,0
104068,1,10,7,3,13,0
162765,1,0,0,0,5,0
32875,4,12,7,5,15,0
79932,3,10,16,-6,2,1
244691,3,14,23,-9,7,1
58943,4,20,32,-12,10,0
48741,3,10,19,-9,5,0
5846,4,27,7,20,3,1
144892,3,14,7,7,14,0
227728,2,3,6,-3,16,0
343072,3,12,13,-1,16,1
60668,2,14,3,11,11,1
204854,2,3,3,0,6,1
369652,1,6,0,6,11,1
248378,1,3,0,3,8,0
334891,4,27,10,17,13,1
55156,4,29,17,12,8,0
324728,3,16,7,9,8,0
189164,2,21,0,21,16,0
50477,4,17,10,7,6,0
275797,4,16,3,13,3,0
391372,1,0,3,-3,4,1
217693,1,7,0,7,12,1
323171,2,0,0,0,7,0
327310,4,16,20,-4,9,1
277604,4,12,21,-9,4,1
256609,3,21,0,21,12,1
185527,1,3,3,0,15,1
207807,4,30,22,8,7,0
195818,3,20,14,6,2,0
405695,1,10,0,10,10,0
193487,4,33,20,13,1,0
355214,1,0,14,-14,4,0
127538,4,3,23,-20,6,0
420341,3,17,3,14,17,0
333421,4,23,13,10,12,0
382327,1,0,0,0,17,0
71297,2,7,10,-3,16,0
394819,4,31,6,25,5,1
58044,1,7,0,7,10,0
236319,2,0,16,-16,3,0
166424,2,17,7,10,6,0
73543,4,3,38,-35,17,0
256040,4,25,12,13,12,1
129137,4,34,28,6,7,1
288699,2,0,7,-7,9,1
235914,4,10,14,-4,3,0
213689,3,14,17,-3,10,0
282659,2,6,10,-4,6,1
386695,4,17,13,4,2,0
298312,4,20,13,7,14,0
376091,3,0,3,-3,14,1
358529,1,10,3,7,6,1
59328,2,0,6,-6,11,0
321015,3,10,7,3,6,1
164987,1,0,0,0,6,0
319275,2,3,3,0,6,1
46984,1,0,0,0,5,1
213868,4,48,7,41,10,0
104274,2,17,6,11,13,0
421402,3,16,20,-4,17,1
125999,1,0,0,0,6,1
98285,3,14,27,-13,11,0
46973,1,0,0,0,5,1
213848,3,45,7,38,10,1
306155,2,7,0,7,17,0
313930,4,28,29,-1,3,0
294955,3,14,7,7,12,1
238426,4,17,36,-19,4,1
339963,1,7,0,7,15,0
237255,4,20,0,20,3,1
346869,3,23,12,11,1,0
388519,4,3,23,-20,2,1
234497,3,20,20,0,2,1
367239,1,3,0,3,10,0
92251,2,7,0,7,8,1
331951,1,0,0,0,12,1
268826,4,38,10,28,17,0
327143,3,14,17,-3,9,1
308884,4,10,20,-10,1,1
29342,4,21,10,11,14,0
317150,1,0,0,0,5,0
327758,4,13,23,-10,10,1
88623,2,20,7,13,6,1
297200,2,0,0,0,13,1
416027,2,7,3,4,15,1
230540,2,3,7,-4,1,1
159255,3,17,24,-7,3,0
328225,4,14,17,-3,10,0
284043,3,10,3,7,7,0
96706,2,0,7,-7,10,1
325557,1,0,0,0,9,1
302007,1,7,0,7,15,0
366036,3,37,14,23,10,1
392087,4,18,33,-15,4,0
28541,3,24,7,17,14,1
64947,4,10,6,4,13,1
153011,4,42,24,18,1,0
402608,3,17,16,1,9,0
233281,2,7,9,-2,2,0
45193,4,7,10,-3,4,0
149900,4,6,16,-10,16,0
319709,4,33,9,24,6,0
41512,3,15,7,8,2,1
135313,1,0,7,-7,10,1
353208,1,0,7,-7,4,1
42375,3,14,9,5,2,0
226813,4,14,29,-15,16,1
308784,1,0,0,0,1,0
115445,3,39,14,25,1,1
50061,1,0,7,-7,6,1
367348,1,0,0,0,10,0
246734,1,3,0,3,8,0
280897,4,19,3,16,6,1
301175,2,13,11,2,15,0
387254,2,6,7,-1,2,1
238072,4,13,13,0,4,1
333280,4,6,24,-18,12,1
1633,1,0,0,0,1,0
29088,1,0,6,-6,14,0
186473,3,10,13,-3,15,1
79211,4,20,10,10,2,1
273611,2,10,3,7,2,1
25607,4,30,10,20,12,1
280717,3,0,6,-6,5,1
79694,1,7,0,7,2,0
404270,1,0,3,-3,10,0
207029,3,28,3,25,7,0
27174,2,13,7,6,13,1
50654,4,17,9,8,6,1
394558,1,0,0,0,5,0
184255,3,24,7,17,14,1
252982,4,15,13,2,11,1
308532,2,0,9,-9,1,1
326579,1,3,0,3,9,0
335561,2,6,6,0,13,0
203858,4,34,31,3,6,0
149622,1,0,0,0,16,1
258098,2,13,6,7,13,0
62439,3,0,13,-13,12,1
75953,4,32,7,25,1,1
223595,4,24,13,11,15,0
349185,4,27,14,13,2,1
351148,1,7,0,7,3,0
39996,2,7,7,0,1,0
79569,2,7,0,7,2,0
169677,3,20,17,3,8,1
278033,3,10,10,0,4,0
253159,4,21,23,-2,11,1
278961,3,7,23,-16,5,0
207787,4,24,16,8,7,1
241285,3,10,0,10,5,0
322876,1,6,0,6,7,0
334559,3,21,17,4,13,1
94638,2,14,19,-5,9,1
106525,1,0,0,0,14,0
69634,4,14,17,-3,15,1
329590,1,10,0,10,11,0
223231,2,3,6,-3,15,1
48551,2,11,14,-3,5,1
208144,2,0,0,0,8,1
401810,2,7,7,0,9,1
63311,2,10,3,7,12,0
245193,4,17,28,-11,7,1
176131,1,14,7,7,11,0
394901,3,0,17,-17,5,0
205855,4,20,0,20,7,1
123184,3,6,21,-15,4,0
152241,3,21,0,21,17,0
39939,4,9,10,-1,1,0
286647,1,6,0,6,8,1
346306,1,0,0,0,1,0
230730,3,9,27,-18,1,1
246873,1,0,0,0,8,0
350074,4,27,13,14,2,1
249835,2,6,10,-4,9,0
191313,4,20,20,0,17,1
102791,3,10,3,7,13,0
24879,4,13,6,7,12,1
287886,1,0,0,0,9,0
383329,1,0,0,0,17,0
323684,3,20,0,20,8,0
14222,4,0,38,-38,7,1
111287,4,17,16,1,16,0
220952,2,7,7,0,14,0
405348,4,17,12,5,10,0
116008,3,13,0,13,1,1
331220,4,17,20,-3,11,0
383875,4,3,7,-4,1,0
52080,4,13,13,0,7,1
315717,4,17,19,-2,4,1
318463,3,31,7,24,5,1
113473,3,3,7,-4,17,0
360906,2,21,0,21,7,1
77358,2,7,7,0,1,0
136028,4,6,10,-4,10,1
281483,3,7,10,-3,6,1
42550,4,10,24,-14,3,0
139898,4,23,24,-1,12,1
418200,4,24,6,18,16,0
49318,2,7,3,4,6,0
359098,1,0,0,0,6,1
80640,2,7,16,-9,3,1
418207,4,31,6,25,16,1
380203,2,13,9,4,16,0
386749,1,0,0,0,2,1
40657,4,34,7,27,2,1
234367,3,17,10,7,2,1
145020,3,6,3,3,14,0
8494,3,15,3,12,4,0
190856,4,24,10,14,17,0
84143,2,7,0,7,4,1
371080,4,13,20,-7,12,0
77425,4,21,21,0,1,0
305876,3,7,14,-7,17,1
134105,4,27,13,14,9,0
302673,3,17,13,4,15,0
17399,3,17,0,17,9,1
405483,4,24,16,8,10,1
311049,2,10,3,7,2,1
48310,4,22,13,9,5,0
144250,2,9,7,2,14,0
224732,2,5,0,5,15,0
175719,3,30,6,24,11,0
95367,1,7,0,7,10,1
230249,2,6,7,-1,17,0
246798,3,3,13,-10,8,0
144460,4,10,32,-22,14,0
313621,4,22,30,-8,3,1
225800,3,10,14,-4,16,1
368924,1,0,0,0,11,0
410169,4,20,17,3,13,1
35715,1,3,0,3,17,0
193953,1,7,0,7,1,0
101476,4,25,20,5,12,0
341237,3,16,10,6,16,1
19149,2,14,10,4,10,1
388764,2,14,0,14,3,1
225543,4,8,24,-16,15,1
311271,4,6,3,3,2,1
199833,2,3,17,-14,4,1
135382,3,21,17,4,10,0
210966,4,33,23,10,9,1
389288,1,0,0,0,3,0
36728,1,0,7,-7,17,1
161043,1,0,0,0,4,0
98033,4,17,24,-7,11,1
300644,3,10,3,7,15,1
149800,1,3,7,-4,16,1
98192,4,28,26,2,11,1
58031,5,20,26,-6,10,0
275415,1,6,10,-4,3,0
322609,2,3,6,-3,7,1
42214,2,17,0,17,2,0
35637,3,17,3,14,17,1
198001,2,0,20,-20,3,0
279272,3,19,13,6,5,0
141292,1,0,7,-7,13,1
145355,4,42,26,16,14,1
20939,2,7,7,0,10,0
149935,1,7,0,7,16,0
20200,3,17,10,7,10,0
420044,3,24,14,10,17,0
286414,2,14,0,14,8,0
405787,4,18,21,-3,10,1
14872,2,7,0,7,7,0
172129,4,13,18,-5,9,1
244422,4,3,20,-17,7,1
399161,2,6,3,3,7,1
132228,1,7,0,7,9,1
263020,2,10,0,10,15,0
400962,2,19,7,12,8,0
54872,4,26,3,23,8,1
86696,2,10,7,3,5,1
136388,1,0,0,0,11,1
385614,4,6,17,-11,1,0
346769,1,0,0,0,1,0
102187,3,17,7,10,13,0
371634,4,17,17,0,12,1
136289,3,18,7,11,11,1
415185,3,10,24,-14,15,1
18128,2,3,17,-14,9,1
320091,2,10,0,10,6,1
178771,2,21,7,14,12,0
99889,2,0,3,-3,12,0
88955,3,33,10,23,6,0
300646,3,10,3,7,15,1
216286,1,0,0,0,12,1
311503,3,17,10,7,2,0
412651,2,10,10,0,14,1
146916,4,41,0,41,15,0
347718,1,0,0,0,1,1
395732,4,26,37,-11,6,1
124478,4,16,17,-1,5,0
2972,2,10,10,0,2,0
165261,3,17,14,3,6,0
42763,1,3,7,-4,3,1
289641,3,10,19,-9,10,0
396096,2,17,9,8,6,0
243720,2,14,3,11,6,1
340718,4,25,23,2,15,1
14110,1,0,7,-7,7,0
214025,4,36,7,29,10,1
323400,3,20,0,20,7,0
251470,1,16,3,13,10,0
38014,1,3,0,3,1,0
29820,1,6,3,3,14,1
62966,1,0,7,-7,12,0
389727,1,3,0,3,3,0
226223,1,3,0,3,16,1
158333,2,13,14,-1,3,0
159710,2,7,7,0,3,0
114781,2,7,10,-3,1,0
55873,4,19,14,5,9,0
323407,4,20,0,20,7,1
229005,4,20,16,4,17,1
87400,2,7,7,0,6,1
206755,4,7,24,-17,7,1
418712,2,0,7,-7,16,1
135437,4,31,27,4,10,0
253466,4,14,38,-24,11,1
89888,4,30,13,17,7,0
71126,1,12,0,12,16,1
287738,1,14,0,14,9,0
331040,3,45,10,35,11,0
355310,4,14,17,-3,4,0
364882,3,6,20,-14,9,1
356067,4,27,10,17,5,0
245191,4,17,28,-11,7,1
76972,4,17,13,4,1,1
245040,4,14,27,-13,7,1
179114,3,9,6,3,12,0
341815,2,10,9,1,16,0
96328,3,3,16,-13,10,1
409174,1,0,0,0,12,1
52347,2,3,10,-7,7,1
171300,2,0,3,-3,9,1
123503,2,7,0,7,4,0
394463,2,7,15,-8,5,0
232411,4,26,25,1,1,1
308060,1,0,7,-7,1,0
116606,3,13,3,10,2,1
10978,3,9,28,-19,5,1
164753,2,20,14,6,6,1
401454,4,24,10,14,8,1
7287,4,17,13,4,4,0
345552,2,7,17,-10,17,0
159460,4,20,23,-3,3,1
35962,4,3,7,-4,17,1
272220,2,0,0,0,2,0
47692,3,3,17,-14,5,0
198055,4,3,30,-27,3,1
357279,3,3,19,-16,5,1
20832,3,14,6,8,10,0
149247,2,7,13,-6,16,1
289900,2,6,3,3,10,1
27033,2,10,0,10,13,0
311461,2,3,3,0,2,1
68881,4,6,20,-14,15,0
70374,4,18,33,-15,15,1
393962,1,3,0,3,5,0
243335,4,14,30,-16,6,1
247123,3,20,6,14,8,1
368207,4,24,21,3,11,0
114000,5,20,20,0,17,1
420780,2,3,3,0,17,0
381905,1,0,0,0,17,0
162275,4,30,20,10,4,1
266884,1,0,0,0,17,1
329037,2,3,7,-4,10,0
105427,4,23,24,-1,14,1
271382,1,0,0,0,1,1
214184,4,19,9,10,11,1
237106,3,8,26,-18,3,0
287811,3,21,17,4,9,1
248308,2,17,7,10,8,1
292651,4,22,16,6,11,1
190048,1,17,0,17,17,0
68522,2,7,21,-14,14,0
126980,2,10,10,0,6,0
234609,2,10,10,0,2,1
90351,4,14,29,-15,7,0
251372,2,24,14,10,10,1
104501,3,14,31,-17,13,0
338192,2,7,21,-14,14,1
260968,3,10,3,7,14,1
166622,3,22,20,2,6,1
403432,2,14,3,11,9,0
187721,3,16,13,3,16,0
366142,3,7,35,-28,10,1
321874,2,7,14,-7,7,1
386508,2,7,7,0,2,0
331708,2,0,13,-13,12,1
26504,4,30,29,1,13,0
98887,2,7,10,-3,11,0
213617,1,7,0,7,10,0
360184,3,17,13,4,7,0
208185,3,0,3,-3,8,0
8926,3,28,0,28,4,0
141309,1,0,7,-7,13,1
30215,4,13,31,-18,14,1
352707,3,17,3,14,3,0
287919,2,13,10,3,9,1
205798,2,7,0,7,7,0
237610,1,0,0,0,4,0
84212,4,17,10,7,4,1
327160,4,21,17,4,9,1
138732,4,28,38,-10,12,1
315568,4,7,14,-7,4,1
77998,3,3,16,-13,1,0
71509,4,33,14,19,16,0
171745,1,3,7,-4,9,0
387282,3,6,10,-4,2,1
151474,2,28,7,21,17,1
271453,3,14,0,14,1,1
336864,2,7,7,0,14,0
271889,2,7,10,-3,2,0
134862,1,0,0,0,10,0
349487,4,9,20,-11,2,1
25364,1,3,0,3,12,1
47978,2,3,21,-18,5,0
2748,4,9,7,2,2,0
345958,4,27,23,4,17,0
305086,2,21,10,11,16,0
379711,2,6,0,6,16,1
22327,3,0,3,-3,11,1
79399,1,3,0,3,2,0
379756,3,9,17,-8,16,0
82990,4,13,19,-6,4,1
366166,3,7,38,-31,10,0
232524,3,20,10,10,1,0
347366,4,21,21,0,1,0
237123,4,8,33,-25,3,1
332881,2,17,0,17,12,1
25962,2,3,6,-3,13,1
166729,2,7,3,4,6,0
392098,1,0,0,0,4,0
304603,1,6,7,-1,16,1
273682,4,22,13,9,2,1
184472,1,0,7,-7,14,1
73876,1,0,0,0,17,0
301523,4,20,18,2,15,0
208419,1,0,0,0,8,1
385379,1,7,7,0,1,0
333479,2,3,0,3,12,0
204248,2,0,7,-7,6,1
420860,4,17,33,-16,17,0
271979,1,0,0,0,2,1
48257,2,3,10,-7,5,1
419472,3,10,9,1,16,1
51948,4,13,16,-3,7,0
127962,3,23,13,10,6,0
134891,2,7,13,-6,10,1
137326,1,0,0,0,11,1
40907,3,13,20,-7,2,1
134719,1,3,0,3,10,1
349492,4,9,20,-11,2,1
288692,2,0,7,-7,9,0
374776,4,16,39,-23,14,0
325978,4,22,7,15,9,1
401828,2,7,14,-7,9,0
352458,4,38,24,14,3,0
21640,1,0,0,0,11,1
172508,1,0,0,0,9,1
59620,2,14,3,11,11,0
49986,3,21,7,14,6,0
357387,2,14,17,-3,5,1
107258,1,0,0,0,15,1
102950,3,12,24,-12,13,0
162579,4,38,17,21,4,1
398979,1,0,2,-2,7,0
402516,1,0,0,0,9,0
161717,2,10,3,7,4,0
300978,1,0,0,0,15,0
281327,3,14,13,1,6,0
330934,1,6,0,6,11,0
69699,2,7,7,0,15,1
257700,3,3,10,-7,13,0
245154,3,17,25,-8,7,1
357699,2,26,6,20,5,1
301640,3,10,6,4,15,1
196739,4,54,0,54,3,0
417121,4,34,0,34,15,0
299700,2,17,3,14,14,0
22156,2,10,6,4,11,0
51923,3,13,10,3,7,1
406683,3,21,0,21,11,0
172551,3,7,21,-14,9,0
409665,2,10,3,7,12,1
300864,2,0,7,-7,15,0
358194,4,23,17,6,6,0
155260,4,28,14,14,1,0
5208,2,7,10,-3,3,0
287538,4,14,40,-26,9,1
41832,4,21,14,7,2,1
87274,3,17,17,0,6,0
147710,3,10,10,0,15,1
355358,1,3,0,3,4,0
188947,4,26,13,13,16,0
13322,3,7,27,-20,7,1
238012,3,10,13,-3,4,0
333015,2,3,9,-6,12,0
326055,2,9,3,6,9,0
96683,1,0,0,0,10,0
298710,4,19,21,-2,14,0
230986,2,7,0,7,1,0
200758,3,24,3,21,4,1
238288,1,0,0,0,4,1
126902,4,17,14,3,6,1
143423,4,13,26,-13,14,0
253139,4,21,20,1,11,0
196060,2,3,14,-11,2,0
59999,4,3,31,-28,11,0
210297,2,6,10,-4,9,0
360856,1,0,0,0,7,1
360124,1,7,3,4,7,1
113640,4,9,13,-4,17,0
403441,2,14,6,8,9,1
280205,4,28,14,14,5,1
133137,2,7,10,-3,9,1
49474,1,0,0,0,6,0
216668,2,14,6,8,12,1
15499,3,16,6,10,8,1
179301,4,33,3,30,12,0
38642,2,0,0,0,1,0
226042,1,0,0,0,16,1
108017,1,3,0,3,15,0
351701,4,14,17,-3,3,1
304206,2,19,7,12,16,1
210839,1,0,0,0,9,0
6428,4,9,20,-11,3,0
358417,2,19,13,6,6,1
119466,3,7,17,-10,3,1
285222,1,0,3,-3,7,0
239803,1,0,0,0,4,1
235118,3,0,10,-10,2,1
343696,4,18,10,8,17,1
317162,2,0,3,-3,5,0
296099,4,9,17,-8,13,1
67440,2,10,7,3,14,1
197061,1,0,0,0,3,0
44517,1,0,0,0,3,0
124824,2,0,3,-3,5,0
3058,4,22,41,-19,2,1
135111,3,31,6,25,10,0
238341,2,3,16,-13,4,1
364314,4,3,32,-29,9,1
188867,2,3,7,-4,16,0
241217,1,0,0,0,5,1
119132,3,10,7,3,3,0
198998,4,19,26,-7,3,0
164095,4,12,6,6,5,1
162746,4,35,24,11,5,1
271605,3,23,20,3,2,0
233093,2,8,0,8,2,0
166534,1,0,0,0,6,1
19819,1,3,7,-4,10,0
21441,3,12,14,-2,11,0
371056,3,10,13,-3,12,1
237082,3,0,26,-26,3,0
126727,3,13,13,0,6,0
286650,1,7,0,7,8,0
2897,4,31,31,0,2,0
127296,2,10,14,-4,6,1
187384,2,20,7,13,16,1
346637,2,14,3,11,1,0
359599,2,17,0,17,6,1
299334,4,28,16,12,14,1
286938,4,23,19,4,8,1
342433,3,10,3,7,16,1
125117,2,7,0,7,5,0
393371,2,21,7,14,5,1
175001,3,13,28,-15,10,1
18463,3,7,7,0,9,0
384120,2,7,17,-10,1,0
224763,2,5,3,2,15,0
250797,3,3,9,-6,10,0
61843,3,13,20,-7,12,0
209356,2,7,7,0,8,0
180271,1,6,0,6,13,1
364321,4,9,32,-23,9,0
65039,3,3,17,-14,13,0
211394,4,10,13,-3,9,0
385532,1,0,0,0,1,0
183831,3,27,21,6,14,1
54918,2,0,0,0,8,0
181558,2,13,0,13,13,0
188653,5,20,22,-2,16,0
293355,2,7,0,7,11,0
207846,2,7,0,7,8,0
340296,1,3,0,3,15,1
185683,1,7,3,4,15,1
262207,4,31,16,15,15,0
261116,3,20,21,-1,14,1
117104,4,7,24,-17,2,0
411170,2,0,23,-23,13,0
259881,2,14,7,7,14,0
116880,2,7,7,0,2,0
198106,1,0,0,0,3,0
76840,4,33,6,27,1,0
287557,4,20,43,-23,9,1
294389,3,16,9,7,12,0
268601,2,7,6,1,17,1
32483,1,7,3,4,15,0
267595,4,27,34,-7,17,1
227529,4,26,17,9,16,0
187886,4,7,23,-16,16,0
119687,5,20,19,1,3,0
297125,4,31,6,25,13,0
222714,4,14,24,-10,14,0
241390,2,7,21,-14,5,1
254459,3,20,7,13,11,0
253878,3,31,14,17,11,1
144398,2,0,9,-9,14,0
117440,1,7,0,7,2,0
363831,3,13,17,-4,8,1
204505,4,17,24,-7,6,0
37593,1,7,0,7,17,1
249922,4,18,20,-2,9,0
140286,2,14,6,8,12,0
79804,4,28,20,8,2,0
200160,3,7,31,-24,4,1
138331,3,26,0,26,11,1
236360,3,7,23,-16,3,1
388768,2,14,0,14,3,1
341089,3,14,17,-3,15,0
229613,4,33,13,20,17,0
2474,4,28,20,8,2,0
225634,2,7,10,-3,16,0
391775,4,10,13,-3,4,1
389240,3,28,7,21,3,1
11354,2,14,0,14,6,1
222618,2,7,7,0,14,1
18572,2,10,10,0,9,0
185796,4,25,3,22,15,0
84425,2,6,0,6,4,0
282592,1,0,0,0,6,0
43669,3,14,10,4,3,1
361213,2,7,10,-3,7,0
406639,2,0,0,0,11,1
166988,1,0,7,-7,7,0
228192,2,7,27,-20,17,1
326650,3,16,6,10,9,0
218563,2,7,14,-7,13,0
379948,4,24,6,18,16,0
275812,4,16,3,13,3,0
254105,1,0,6,-6,11,1
215458,2,7,3,4,11,1
245788,4,23,20,3,7,1
12501,1,0,14,-14,6,1
151489,3,35,7,28,17,0
358321,4,0,27,-27,6,1
221261,2,0,19,-19,14,0
360335,3,6,20,-14,7,1
92122,2,3,24,-21,8,1
354424,1,7,0,7,4,0
87452,4,20,10,10,6,0
394500,3,10,25,-15,5,1
402825,1,7,0,7,9,0
77855,3,17,28,-11,1,1
395670,3,7,27,-20,6,1
402056,4,3,26,-23,9,1
233418,2,14,3,11,2,1
237280,4,26,0,26,3,1
287054,3,19,24,-5,8,1
341694,3,23,13,10,16,0
161104,2,3,16,-13,4,0
2513,2,3,0,3,2,1
415013,3,10,20,-10,15,1
177931,1,0,0,0,12,0
60047,2,7,3,4,11,1
239364,1,0,7,-7,4,0
356657,2,16,3,13,5,1
306570,2,0,17,-17,17,1
347582,1,7,7,0,1,0
80492,2,5,3,2,3,1
285905,2,20,0,20,8,0
245162,3,17,25,-8,7,0
363875,4,13,29,-16,8,1
181567,2,13,0,13,13,0
133586,2,3,7,-4,9,1
199105,3,14,24,-10,4,1
185510,1,3,3,0,15,0
413231,2,7,0,7,14,0
49298,1,0,3,-3,6,1
340923,2,0,10,-10,15,1
304940,2,7,3,4,16,1
6931,2,0,0,0,3,1
286925,4,23,13,10,8,0
23179,2,23,6,17,11,1
312329,1,7,14,-7,3,0
347080,1,0,3,-3,1,1
290236,3,17,3,14,10,1
109474,4,12,13,-1,16,1
8092,3,24,13,11,4,0
167513,3,0,3,-3,7,0
139153,3,19,6,13,12,1
197343,4,20,10,10,3,0
261244,3,28,0,28,14,1
153425,3,13,17,-4,1,1
227918,3,27,19,8,16,0
29293,3,21,7,14,14,1
215457,2,7,3,4,11,1
296168,2,13,13,0,13,1
261865,3,6,20,-14,14,1
336515,1,0,0,0,14,0
91066,4,9,0,9,7,0
4490,2,14,12,2,2,0
237987,2,3,10,-7,4,1
314885,2,0,0,0,4,0
223206,2,3,3,0,15,0
332561,1,3,3,0,12,1
377820,2,7,0,7,15,1
141647,2,17,14,3,13,0
383103,3,20,7,13,17,1
416628,3,28,7,21,15,1
421592,4,16,9,7,17,0
363739,4,26,20,6,8,0
264345,1,0,0,0,15,1
222106,4,34,17,17,14,1
255017,2,3,9,-6,12,0
12513,2,0,17,-17,6,1
310145,2,14,7,7,2,0
49173,2,10,0,10,6,1
171699,4,26,23,3,9,0
418437,2,14,3,11,16,1
187478,1,0,3,-3,16,0
243564,2,10,7,3,6,0
307767,2,10,7,3,1,1
338334,2,3,0,3,14,0
131624,1,0,6,-6,8,1
139379,2,14,0,14,12,0
339302,3,38,7,31,15,0
167739,4,26,23,3,7,0
275301,2,10,8,2,3,1
399158,1,0,3,-3,7,1
283208,1,0,0,0,7,1
134572,2,10,0,10,10,0
383994,3,3,16,-13,1,1
26401,2,10,3,7,13,1
114169,1,0,0,0,1,0
168679,1,7,0,7,7,0
261739,4,14,7,7,14,0
408118,1,0,0,0,12,1
384437,2,21,0,21,1,0
55615,4,34,14,20,9,0
419119,1,10,0,10,16,1
232335,2,6,9,-3,1,0
149548,3,14,9,5,16,0
58079,2,7,10,-3,10,1
178699,4,3,20,-17,12,0
158988,4,21,29,-8,3,1
15426,1,0,0,0,8,0
179650,5,31,30,1,12,0
336605,4,7,0,7,14,1
189737,1,0,6,-6,17,1
380538,3,7,17,-10,16,1
460,1,0,3,-3,1,1
364931,4,16,23,-7,9,1
211057,3,27,0,27,9,0
252229,4,26,24,2,10,0
294290,1,0,0,0,12,1
259106,1,0,0,0,13,1
410541,2,7,7,0,13,0
252690,4,6,10,-4,10,1
58649,4,20,20,0,10,0
372770,2,3,0,3,13,0
208529,4,44,15,29,8,1
340019,2,14,6,8,15,0
32163,1,7,0,7,15,1
61518,2,7,7,0,11,0
56374,1,0,0,0,9,0
194729,2,0,10,-10,2,1
47139,1,3,0,3,5,1
20868,4,28,9,19,10,0
226242,2,6,0,6,16,0
132138,3,10,3,7,9,1
131502,2,0,6,-6,8,1
315709,4,16,16,0,4,1
115745,4,13,13,0,1,0
136148,3,10,10,0,10,0
1320,1,0,0,0,1,1
39036,4,37,24,13,1,0
211001,2,7,0,7,9,1
347197,4,23,27,-4,1,1
52809,2,0,30,-30,7,0
115188,4,13,30,-17,1,0
117171,2,13,3,10,2,0
286870,2,9,7,2,8,0
34046,1,0,0,0,16,0
413634,4,17,24,-7,14,1
343961,2,16,6,10,17,1
195947,3,0,17,-17,2,1
259245,1,0,0,0,13,0
289772,3,3,10,-7,10,1
332717,2,14,6,8,12,1
190291,4,7,14,-7,17,0
290846,4,17,21,-4,10,1
321742,2,6,6,0,7,1
80638,2,7,16,-9,3,1
119714,1,7,0,7,3,0
240250,1,7,0,7,5,0
144786,4,10,17,-7,14,0
65213,4,10,10,0,13,0
263682,4,27,13,14,15,1
318994,2,0,16,-16,5,0
315140,1,7,7,0,4,0
303185,4,24,28,-4,16,1
414307,4,21,42,-21,14,0
228428,4,10,27,-17,17,1
290019,2,7,0,7,10,1
265677,4,9,18,-9,16,1
319010,2,7,16,-9,5,0
262427,2,7,7,0,15,1
203388,4,27,33,-6,6,0
378579,3,17,13,4,15,0
142758,2,9,10,-1,13,1
199096,3,14,24,-10,4,0
14182,3,0,24,-24,7,0
278165,2,17,14,3,4,1
3391,1,0,7,-7,2,1
41905,2,14,3,11,2,0
354469,2,21,21,0,4,0
335136,2,17,0,17,13,0
171922,2,7,7,0,9,1
380321,1,7,0,7,16,0
61416,3,13,3,10,11,1
22174,3,10,15,-5,11,1
281507,3,10,10,0,6,1
190985,3,12,3,9,17,1
259210,4,14,32,-18,13,1
278702,4,24,10,14,4,0
109588,3,19,14,5,16,1
117260,4,33,24,9,2,0
320969,1,7,0,7,6,1
219536,3,15,21,-6,13,0
319605,1,9,3,6,6,1
88499,3,16,14,2,6,1
345466,4,9,22,-13,17,0
81224,2,7,7,0,3,0
302861,4,12,23,-11,15,0
338154,1,7,0,7,14,0
61572,3,28,7,21,11,0
215597,2,14,3,11,11,0
389319,2,7,6,1,3,1
36537,4,13,20,-7,17,1
363289,3,27,7,20,8,0
402459,3,24,15,9,9,1
98782,4,34,8,26,11,1
245142,3,17,15,2,7,0
75300,3,7,26,-19,17,1
313603,3,12,23,-11,3,1
418445,3,17,3,14,16,0
338031,2,0,0,0,14,1
196122,3,16,21,-5,2,1
213061,3,17,3,14,10,0
200050,4,24,20,4,4,0
188699,2,0,17,-17,16,0
314301,1,6,14,-8,3,1
98837,1,7,0,7,11,1
159314,4,27,24,3,3,1
21891,3,28,0,28,11,0
180745,2,0,3,-3,13,1
129189,2,7,6,1,7,0
67350,3,20,6,14,14,1
97741,4,16,13,3,11,0
378583,3,17,13,4,15,1
325860,4,13,20,-7,9,1
142046,4,23,14,9,13,0
405266,2,14,7,7,10,1
103363,2,10,17,-7,13,0
43134,1,0,0,0,3,0
21808,1,0,0,0,11,0
205375,3,27,0,27,6,1
196070,2,3,21,-18,2,1
233108,2,8,3,5,2,1
166171,3,28,19,9,6,0
337089,4,26,0,26,14,0
129884,3,13,0,13,7,0
174652,2,6,0,6,10,0
220967,2,14,7,7,14,0
74662,2,0,10,-10,17,1
355891,3,13,10,3,5,1
323652,2,19,0,19,8,1
239394,2,6,7,-1,4,0
397140,2,3,0,3,6,0
249639,1,0,7,-7,9,1
46957,4,20,36,-16,5,1
392627,2,7,0,7,4,1
262730,2,21,0,21,15,0
348439,4,13,26,-13,1,0
389462,2,10,0,10,3,0
312225,3,7,17,-10,2,1
92585,3,17,3,14,8,0
18710,2,3,7,-4,9,0
273582,1,3,3,0,2,1
367283,3,3,17,-14,10,1
50650,4,17,9,8,6,1
112220,1,7,7,0,17,1
383600,4,24,24,0,17,1
72138,1,0,0,0,16,0
211193,3,7,10,-3,9,0
390965,2,13,7,6,4,0
268502,4,23,9,14,17,1
201170,3,13,21,-8,5,0
309551,2,6,0,6,1,1
14162,2,0,21,-21,7,0
334465,4,17,13,4,13,0
60637,2,0,3,-3,11,1
112742,3,10,0,10,17,0
179309,4,33,11,22,12,1
382339,1,0,0,0,17,1
404239,4,12,16,-4,10,1
288106,3,13,7,6,9,1
161919,3,13,9,4,4,1
177723,3,13,14,-1,12,1
134692,4,37,31,6,10,0
38418,4,30,16,14,1,1
417520,3,24,21,3,16,0
50803,1,0,7,-7,6,1
193453,4,23,20,3,1,0
265186,2,6,3,3,16,0
52341,2,3,3,0,7,0
343845,4,24,3,21,17,1
42055,3,20,7,13,2,0
379515,4,26,18,8,16,1
103336,2,7,17,-10,13,1
405676,1,0,0,0,10,1
51942,4,13,16,-3,7,0
389133,4,30,14,16,3,0
74606,1,0,0,0,17,1
254019,3,7,13,-6,11,0
182956,3,10,37,-27,14,0
115867,2,7,13,-6,1,0
151271,1,0,0,0,17,1
49733,4,35,31,4,6,0
336838,1,0,7,-7,14,1
336339,4,20,13,7,13,1
309217,1,0,0,0,1,0
246848,4,13,20,-7,8,1
19562,2,7,14,-7,10,1
285019,1,0,0,0,7,1
120135,3,10,6,4,3,0
222932,2,13,13,0,14,1
29153,3,0,19,-19,14,1
197253,1,0,0,0,3,1
105097,3,26,14,12,14,1
151047,2,10,3,7,17,0
160143,2,10,0,10,3,1
412345,3,10,17,-7,13,1
25298,3,37,14,23,12,1
194161,2,3,3,0,1,0
119458,3,7,17,-10,3,0
352462,4,38,24,14,3,0
14682,4,33,21,12,7,1
239816,1,0,0,0,4,1
37559,4,13,10,3,17,1
69063,1,0,0,0,15,1
381339,1,6,0,6,16,1
165699,3,7,7,0,6,1
71076,4,27,0,27,16,1
108727,4,44,13,31,15,0
83295,4,22,17,5,4,1
222226,3,13,17,-4,14,0
68507,2,0,14,-14,14,1
49093,4,13,20,-7,6,1
49840,3,21,10,11,6,1
274829,1,0,0,0,3,0
73779,2,6,0,6,17,1
82542,4,17,27,-10,3,0
379140,1,6,3,3,16,1
318923,4,24,28,-4,5,1
279558,3,10,13,-3,5,0
153202,4,20,20,0,1,0
257077,3,7,14,-7,12,0
137869,2,17,6,11,11,0
60595,4,30,47,-17,11,0
113263,2,7,14,-7,17,1
277325,1,0,0,0,4,0
114802,2,7,20,-13,1,1
358392,2,9,13,-4,6,0
191900,4,29,16,13,1,1
253040,1,0,0,0,11,1
288462,4,19,7,12,9,0
124044,1,0,0,0,5,0
88172,2,14,10,4,6,0
71758,3,24,23,1,16,0
287972,3,17,13,4,9,1
150532,1,0,0,0,17,0
126176,2,14,3,11,6,0
6983,3,3,7,-4,3,1
171215,4,9,14,-5,8,0
169188,2,10,6,4,7,0
313109,1,0,0,0,3,0
9010,1,7,7,0,4,1
246964,3,20,17,3,8,0
283231,1,10,0,10,7,1
396399,2,20,12,8,6,0
195173,1,7,0,7,2,1
162801,2,0,0,0,5,1
322755,2,3,14,-11,7,0
204827,1,0,0,0,6,1
270273,3,3,24,-21,1,1
340808,3,17,16,1,15,1
131442,4,20,19,1,8,0
192543,4,17,17,0,1,0
125218,4,31,14,17,5,1
344882,4,30,10,20,17,1
16100,3,33,7,26,8,1
49784,2,7,7,0,6,0
313146,2,10,10,0,3,0
112127,3,7,20,-13,17,0
241838,2,13,3,10,5,1
331090,1,0,0,0,11,1
254211,4,3,25,-22,11,0
86658,1,7,0,7,5,1
408044,3,10,10,0,12,1
373112,4,10,21,-11,13,0
10878,1,0,0,0,5,1
155306,1,0,0,0,2,1
142730,2,9,7,2,13,0
43996,3,3,21,-18,3,0
194141,2,3,0,3,1,1
194838,1,0,0,0,2,0
269842,3,22,10,12,1,1
159062,2,16,0,16,3,1
379041,3,7,6,1,15,0
203787,3,17,10,7,6,1
352967,3,13,3,10,3,1
168622,4,17,16,1,7,0
26852,1,10,0,10,13,0
77598,1,0,7,-7,1,1
216474,2,17,1,16,12,1
296044,3,3,7,-4,13,0
372055,4,13,10,3,13,0
165889,4,6,19,-13,6,0
289544,1,0,0,0,10,1
360976,1,0,0,0,7,0
374184,4,23,21,2,13,0
38209,2,3,7,-4,1,0
106650,4,46,7,39,14,1
192809,3,0,15,-15,1,0
51135,2,10,3,7,7,1
326808,3,3,14,-11,9,1
345452,4,3,22,-19,17,0
65238,1,0,0,0,13,1
3302,3,3,3,0,2,1
11337,1,14,0,14,6,0
275719,1,0,0,0,3,1
394508,3,10,25,-15,5,0
254612,3,14,14,0,11,1
80128,1,0,0,0,2,1
116122,2,0,3,-3,1,1
149024,1,0,0,0,16,0
418907,4,19,17,2,16,1
43407,4,21,24,-3,3,0
156738,1,7,7,0,2,0
412482,2,16,7,9,14,1
243706,2,14,3,11,6,0
63985,1,7,3,4,13,1
251433,4,46,14,32,10,0
113218,4,44,22,22,17,1
305545,2,6,0,6,17,0
71969,4,25,16,9,16,0
341469,1,0,0,0,16,0
114870,4,16,33,-17,1,0
124278,3,27,17,10,5,0
127746,2,0,14,-14,6,1
416633,3,31,7,24,15,0
259657,4,9,9,0,13,0
262172,4,28,13,15,15,1
217876,3,17,21,-4,12,1
323364,2,10,0,10,7,1
370329,4,14,35,-21,12,1
371187,3,11,19,-8,12,1
222522,3,17,14,3,14,1
366816,2,0,3,-3,10,1
289704,1,0,0,0,10,0
195439,4,24,10,14,2,0
114681,3,6,10,-4,1,1
129259,3,17,13,4,7,0
401065,1,13,3,10,8,1
72519,3,16,17,-1,16,0
92836,2,14,0,14,8,1
67889,2,13,3,10,14,1
357947,1,7,6,1,6,1
190124,3,27,3,24,17,0
12739,4,59,0,59,6,1
207179,3,14,13,1,7,0
55861,4,13,14,-1,9,0
327019,4,8,10,-2,9,0
71387,1,7,0,7,16,0
100155,1,7,0,7,12,1
378719,2,14,7,7,15,0
259315,3,13,13,0,13,0
320733,3,14,23,-9,6,1
148479,3,21,3,18,16,0
154858,1,3,0,3,1,1
203693,4,14,30,-16,6,1
73555,4,3,41,-38,17,1
372052,4,13,10,3,13,0
142188,4,8,10,-2,13,0
258629,4,13,13,0,13,1
291359,1,7,0,7,10,0
322532,4,15,3,12,7,1
47321,2,0,10,-10,5,1
142634,3,13,13,0,13,1
83723,3,22,20,2,4,0
266774,2,0,14,-14,16,1
216548,3,34,11,23,12,1
315223,3,17,10,7,4,0
233760,3,13,27,-14,2,1
64933,4,10,6,4,13,1
393678,2,0,0,0,5,1
16201,2,3,0,3,8,0
96452,2,10,14,-4,10,0
378399,2,7,0,7,15,1
272088,3,10,6,4,2,1
92818,1,7,0,7,8,1
28362,2,3,0,3,14,1
408723,1,3,7,-4,12,1
149201,1,7,0,7,16,0
102650,3,15,13,2,13,1
93072,4,20,20,0,8,0
303386,1,7,0,7,16,1
125503,4,23,7,16,5,1
268430,2,14,3,11,17,0
371861,2,21,10,11,12,1
306455,2,3,17,-14,17,1
53147,4,19,38,-19,7,1
305696,2,3,7,-4,17,1
114066,2,21,0,21,17,0
325066,4,26,31,-5,8,1
125410,2,7,0,7,5,1
311042,2,10,0,10,2,0
18821,1,3,0,3,9,1
172322,1,0,0,0,9,1
9030,2,14,7,7,4,0
247585,3,16,16,0,8,1
361925,2,7,3,4,7,1
359288,2,3,13,-10,6,1
291387,2,7,7,0,10,0
116509,4,12,22,-10,1,1
10812,3,21,0,21,5,0
338802,2,7,0,7,15,1
184862,4,27,20,7,15,1
290716,4,41,25,16,10,1
252308,2,0,16,-16,10,0
41202,3,0,13,-13,2,1
119984,3,23,24,-1,3,1
31015,2,3,3,0,15,0
136414,2,3,7,-4,11,1
44723,2,0,12,-12,3,0
148291,2,7,0,7,16,0
42621,2,0,7,-7,3,0
86662,1,7,0,7,5,1
140222,5,13,13,0,12,1
164308,2,13,0,13,5,0
280701,2,0,6,-6,5,0
333293,4,12,24,-12,12,1
389004,1,0,0,0,3,1
415853,2,7,20,-13,15,0
134276,4,10,26,-16,10,0
165435,4,6,36,-30,6,1
420532,4,10,42,-32,17,0
375090,1,0,0,0,14,0
72682,4,19,10,9,16,1
266627,2,10,3,7,16,0
197638,4,33,0,33,3,0
282102,3,16,8,8,6,1
396251,2,0,3,-3,6,1
316601,3,6,9,-3,4,1
114907,4,31,40,-9,1,1
292646,4,22,16,6,11,0
175763,4,40,21,19,11,0
70959,1,0,0,0,16,0
352322,1,0,0,0,3,0
351444,4,20,16,4,3,0
192527,4,14,17,-3,1,1
36502,3,10,13,-3,17,1
172050,2,7,0,7,9,0
48534,2,11,0,11,5,0
51666,4,27,20,7,7,1
53057,1,10,0,10,7,0
98979,1,0,0,0,11,1
82955,3,6,16,-10,4,1
12297,4,6,6,0,6,0
404297,2,0,3,-3,10,0
345521,2,7,10,-3,17,0
64958,1,0,0,0,13,1
294007,1,0,0,0,12,1
327332,4,16,27,-11,9,1
152675,3,17,6,11,17,1
232313,2,3,3,0,1,1
234732,4,37,33,4,2,0
256396,2,6,7,-1,12,1
125259,1,0,0,0,5,1
221849,2,6,0,6,14,0
30417,2,10,13,-3,14,0
91015,2,6,0,6,7,0
402321,4,23,18,5,9,0
249851,2,6,17,-11,9,0
409004,4,31,31,0,12,0
143497,2,14,21,-7,14,0
298231,2,20,3,17,14,0
33364,2,13,9,4,16,0
386334,2,10,3,7,2,0
15565,1,0,0,0,8,0
187520,2,6,10,-4,16,0
258849,3,14,7,7,13,0
166974,1,0,0,0,7,1
206289,3,10,6,4,7,1
235747,4,10,27,-17,3,1
44577,2,10,14,-4,3,0
187634,1,0,3,-3,16,1
19160,2,21,10,11,10,0
112562,2,24,19,5,17,0
288259,3,10,28,-18,9,0
48345,1,0,0,0,5,0
2367,2,7,3,4,2,0
182902,2,0,17,-17,14,1
373917,4,43,16,27,13,0
224614,2,9,7,2,15,0
196540,2,10,6,4,2,1
8322,2,9,3,6,4,1
363481,1,0,0,0,8,0
311698,4,12,9,3,2,1
353970,5,34,31,3,4,0
331641,4,23,30,-7,11,0
141520,3,17,10,7,13,1
330192,1,0,0,0,11,1
249006,1,0,0,0,9,1
241748,4,7,9,-2,5,0
111891,4,19,17,2,17,1
182257,1,7,0,7,14,1
150120,1,0,6,-6,16,1
347561,1,0,0,0,1,1
405303,3,14,7,7,10,0
268881,2,6,17,-11,17,1
415580,2,7,7,0,15,0
216354,3,14,13,1,12,0
225965,3,27,14,13,16,1
65144,2,0,0,0,13,1
267079,2,3,3,0,17,1
28748,4,10,16,-6,14,0
339167,4,23,13,10,15,0
80921,2,6,0,6,3,0
150702,2,6,3,3,17,0
200659,4,35,28,7,4,1
169019,2,19,14,5,7,0
262742,2,21,0,21,15,1
79551,1,0,0,0,2,0
401711,3,10,14,-4,8,1
208101,1,0,0,0,8,1
342527,1,0,6,-6,16,1
418595,2,14,10,4,16,1
38667,2,7,6,1,1,0
220857,3,7,28,-21,14,0
54991,4,13,10,3,8,1
202344,4,20,12,8,5,0
293336,1,6,0,6,11,1
327366,2,0,7,-7,9,0
125082,1,0,0,0,5,0
367671,2,0,3,-3,10,1
259406,1,0,3,-3,13,1
153972,2,7,7,0,1,1
269694,3,10,12,-2,1,0
309814,2,7,7,0,1,1
312566,3,37,0,37,3,1
356462,2,0,3,-3,5,0
257055,3,7,14,-7,12,1
51927,3,13,10,3,7,1
224169,3,0,20,-20,15,0
129186,1,7,0,7,7,0
43055,2,3,7,-4,3,1
360083,4,10,40,-30,7,1
94256,4,24,37,-13,9,1
56869,2,7,0,7,9,1
304579,1,0,0,0,16,0
287057,3,26,24,2,8,0
157813,1,0,0,0,3,0
312671,2,28,7,21,3,0
232522,3,20,10,10,1,0
261218,2,21,0,21,14,0
273507,3,14,19,-5,2,0
302315,1,7,3,4,15,1
235687,2,0,3,-3,3,0
347362,4,14,21,-7,1,0
399640,3,13,6,7,8,1
249080,3,21,17,4,9,0
317289,1,0,0,0,5,1
137389,2,3,21,-18,11,1
357111,3,6,14,-8,5,0
20152,2,10,0,10,10,1
298005,4,37,7,30,13,0
48105,2,7,3,4,5,0
73549,4,3,41,-38,17,1
269490,2,10,10,0,1,1
19609,3,17,21,-4,10,0
399308,1,14,7,7,7,1
405538,1,0,7,-7,10,0
138948,2,7,3,4,12,1
251760,4,30,9,21,10,0
18383,1,0,0,0,9,1
249841,2,6,17,-11,9,1
385906,2,3,7,-4,1,0
10900,1,3,7,-4,5,1
191796,1,3,0,3,1,0
240229,4,16,12,4,5,0
389622,2,10,7,3,3,0
88109,4,24,3,21,6,1
129121,4,34,28,6,7,0
161171,4,3,33,-30,4,0
220841,3,7,21,-14,14,1
185210,2,10,3,7,15,0
154949,4,29,17,12,1,0
66819,4,13,6,7,14,1
112120,2,7,20,-13,17,0
162122,4,51,13,38,4,0
140122,2,10,0,10,12,1
324979,2,13,14,-1,8,0
181814,1,0,0,0,13,1
372885,2,10,0,10,13,1
318448,3,24,7,17,5,0
344786,2,7,0,7,17,0
335025,3,16,10,6,13,0
389242,3,28,7,21,3,1
174038,2,0,19,-19,10,0
118753,4,27,19,8,2,1
357747,4,43,19,24,5,0
268083,1,0,0,0,17,0
24611,4,10,26,-16,12,1
283867,2,7,10,-3,7,1
254390,1,7,0,7,11,0
193170,1,0,0,0,1,1
189731,1,0,3,-3,17,0
99853,1,0,0,0,12,0
258792,1,7,0,7,13,0
323159,1,0,0,0,7,0
134703,1,0,0,0,10,0
123327,2,21,7,14,4,0
361482,2,7,0,7,7,0
147816,2,0,7,-7,15,1
402390,2,7,7,0,9,0
132314,4,31,17,14,9,0
52770,1,0,20,-20,7,1
186046,3,24,34,-10,15,1
19898,3,13,21,-8,10,1
250912,1,0,3,-3,10,1
116634,4,23,3,20,2,0
29615,4,14,13,1,14,0
409368,2,10,3,7,12,0
158111,4,25,9,16,3,0
87398,2,7,7,0,6,1
65714,2,0,16,-16,13,1
395504,2,20,14,6,6,1
394298,2,10,7,3,5,0
83211,2,3,7,-4,4,0
282412,4,10,23,-13,6,0
317193,2,7,10,-3,5,0
378928,4,13,30,-17,15,1
407556,2,10,3,7,11,0
168022,3,3,14,-11,7,0
74467,1,0,0,0,17,0
147883,3,9,31,-22,15,1
312277,4,10,23,-13,2,1
117820,3,9,6,3,2,0
141097,4,14,10,4,13,0
159949,4,45,17,28,3,1
361404,4,17,14,3,7,0
306465,3,3,17,-14,17,1
110789,3,3,10,-7,16,1
96908,3,19,7,12,10,0
408768,2,10,13,-3,12,0
394782,3,21,0,21,5,1
214385,2,0,7,-7,11,1
323044,2,14,13,1,7,0
64395,1,0,3,-3,13,1
319520,4,13,17,-4,6,1
328703,1,0,0,0,10,1
65331,3,3,21,-18,13,1
122067,1,0,7,-7,4,1
182158,2,19,7,12,13,1
50673,1,0,0,0,6,0
337324,2,14,7,7,14,0
161051,1,0,0,0,4,1
105164,1,7,0,7,14,0
350672,4,20,13,7,2,0
361870,1,0,0,0,7,0
250549,4,19,14,5,9,0
39149,3,20,10,10,1,1
176788,2,3,7,-4,11,1
247140,3,20,6,14,8,0
167262,4,30,20,10,7,0
302556,4,3,16,-13,15,1
11843,3,34,17,17,6,1
106580,2,24,0,24,14,1
142819,4,12,10,2,13,0
322313,2,7,7,0,7,1
195460,1,0,0,0,2,0
43386,4,21,17,4,3,0
107457,2,0,16,-16,15,0
111843,3,6,10,-4,17,1
252502,3,10,25,-15,10,1
280836,2,10,0,10,6,0
272878,3,20,17,3,2,0
239752,4,13,13,0,4,1
345752,4,16,7,9,17,1
28546,3,24,7,17,14,1
290888,4,24,30,-6,10,1
9285,1,7,0,7,5,0
209228,3,20,7,13,8,1
273137,2,10,0,10,2,0
259755,3,10,10,0,14,1
171433,1,0,0,0,9,1
342331,4,23,6,17,16,0
382246,2,17,3,14,17,1
354843,4,33,28,5,4,1
179576,3,7,23,-16,12,0
88422,1,0,0,0,6,1
108244,3,6,0,6,15,0
325017,3,20,21,-1,8,1
74009,4,37,0,37,17,1
181144,4,24,14,10,13,1
25417,3,6,3,3,12,0
419465,2,10,6,4,16,0
346680,3,21,6,15,1,0
67632,3,7,35,-28,14,0
290914,1,0,0,0,10,1
19450,3,17,14,3,10,0
41500,3,8,7,1,2,1
61177,4,0,21,-21,11,0
12466,4,13,9,4,6,1
205380,3,27,0,27,6,1
106472,3,16,9,7,14,1
103980,3,6,10,-4,13,0
63348,3,17,3,14,12,1
343769,2,7,3,4,17,1
324891,3,17,13,4,8,0
275827,4,22,3,19,3,0
296545,4,26,10,16,13,1
4142,4,26,31,-5,2,1
291851,2,0,7,-7,11,0
87036,4,14,22,-8,5,1
42343,2,7,9,-2,2,1
195994,4,7,27,-20,2,0
66119,4,10,13,-3,13,1
410748,3,17,6,11,13,1
415910,3,10,20,-10,15,0
391190,4,10,24,-14,4,1
159777,4,7,13,-6,3,0
192617,2,3,7,-4,1,1
343253,4,22,0,22,16,1
219521,3,9,21,-12,13,1
205034,3,9,17,-8,6,0
242946,4,24,23,1,6,0
139115,2,9,6,3,12,0
3564,2,14,7,7,2,0
400494,2,7,3,4,8,0
61902,4,27,23,4,12,0
247718,2,7,6,1,8,0
356134,2,10,0,10,5,1
121114,1,0,0,0,3,0
180812,4,10,20,-10,13,1
372645,3,14,9,5,13,0
112735,2,10,0,10,17,0
354794,3,13,17,-4,4,0
17640,1,7,3,4,9,1
120807,1,0,7,-7,3,1
284890,1,0,7,-7,7,1
109383,2,3,10,-7,16,0
247255,2,21,14,7,8,1
15567,1,0,0,0,8,0
16596,2,7,13,-6,8,0
124308,4,34,20,14,5,0
125139,2,14,7,7,5,0
368231,1,0,0,0,11,0
135267,4,24,10,14,10,0
348973,2,14,0,14,2,0
227697,1,0,0,0,16,0
352873,4,14,13,1,3,0
331411,1,6,7,-1,11,0
219150,2,0,3,-3,13,0
153443,3,20,17,3,1,1
60283,4,17,16,1,11,0
154627,3,21,21,0,1,1
147934,4,31,38,-7,15,1
310949,3,3,23,-20,2,1
401357,1,9,0,9,8,0
228380,3,7,17,-10,17,1
318685,1,3,13,-10,5,1
375143,2,14,10,4,14,0
410431,3,9,17,-8,13,0
64376,4,30,27,3,13,0
272465,4,31,24,7,2,0
275344,4,10,19,-9,3,1
368974,2,7,7,0,11,1
121414,4,7,12,-5,3,1
401170,4,44,13,31,8,0
318436,3,21,7,14,5,1
274354,1,3,7,-4,3,1
55501,1,10,0,10,9,0
332102,1,0,0,0,12,0
47841,3,10,6,4,5,0
275096,1,7,0,7,3,0
10084,3,37,7,30,5,1
26105,2,0,10,-10,13,0
61956,2,0,0,0,12,1
98196,4,35,26,9,11,1
333115,4,20,30,-10,12,1
315059,3,30,14,16,4,1
295798,5,27,24,3,12,0
59737,2,6,7,-1,11,0
125170,3,17,7,10,5,1
50562,2,0,6,-6,6,1
303500,4,25,17,8,16,1
133938,3,6,6,0,9,1
173125,1,3,7,-4,9,0
62548,1,3,0,3,12,0
373254,4,13,16,-3,13,0
71679,4,3,34,-31,16,0
403881,2,10,7,3,10,1
154113,2,0,6,-6,1,0
201724,4,30,20,10,5,0
72467,2,10,10,0,16,1
42827,3,6,31,-25,3,1
2948,2,7,10,-3,2,0
109548,2,0,7,-7,16,0
366981,2,0,24,-24,10,1
369381,1,3,0,3,11,1
326872,4,10,20,-10,9,1
194047,3,26,7,19,1,1
236104,1,0,0,0,3,0
287746,1,14,3,11,9,1
19784,4,12,15,-3,10,1
19334,3,14,17,-3,10,1
19422,2,17,7,10,10,0
65044,3,3,17,-14,13,0
108037,1,3,6,-3,15,0
173898,2,12,10,2,10,1
347593,1,7,7,0,1,1
326882,4,10,20,-10,9,1
324817,1,3,0,3,8,1
215889,2,3,7,-4,11,0
302920,1,13,3,10,16,1
74410,3,10,13,-3,17,1
41185,3,0,7,-7,2,0
185957,1,0,7,-7,15,1
34779,4,20,3,17,16,1
409650,2,7,0,7,12,1
217661,4,26,23,3,12,1
413223,2,7,0,7,14,1
245915,3,6,37,-31,7,1
39407,2,3,10,-7,1,1
298607,4,13,10,3,14,1
291580,3,20,3,17,11,1
103627,2,0,7,-7,13,1
244656,2,6,23,-17,7,1
417216,3,17,17,0,16,0
137851,2,10,6,4,11,0
265510,3,7,10,-3,16,1
348786,1,0,7,-7,2,0
115944,1,0,0,0,1,0
179546,2,0,23,-23,12,1
214415,2,7,7,0,11,0
118173,4,31,27,4,2,0
205362,3,20,0,20,6,0
255958,2,6,12,-6,12,1
388698,1,0,0,0,3,0
191421,3,0,31,-31,17,0
128044,2,3,3,0,7,0
318979,2,0,6,-6,5,1
196156,4,31,24,7,2,1
161211,1,0,3,-3,4,0
411470,3,10,17,-7,13,0
25891,4,31,17,14,12,0
113964,4,20,20,0,17,1
182572,1,0,3,-3,14,0
183888,4,51,28,23,14,1
282711,4,9,20,-11,6,0
349074,1,7,0,7,2,1
209182,2,0,7,-7,8,1
362460,1,0,6,-6,8,1
334246,2,6,7,-1,13,0
67075,4,10,9,1,14,1
236904,2,19,0,19,3,1
26360,1,0,0,0,13,0
196419,3,20,7,13,2,0
37951,4,10,14,-4,1,0
205696,3,20,19,1,7,1
178080,5,23,23,0,12,1
223624,1,6,0,6,15,0
388813,4,14,14,0,3,1
310872,2,3,3,0,2,0
312558,3,37,0,37,3,0
355064,1,0,6,-6,4,1
251054,1,6,7,-1,10,1
8633,3,7,10,-3,4,0
327124,2,7,3,4,9,1
129592,3,13,20,-7,7,1
296606,2,3,7,-4,13,1
213384,3,10,20,-10,10,0
102909,2,6,14,-8,13,0
173011,2,14,0,14,9,0
108663,2,27,0,27,15,0
407720,2,3,0,3,11,1
115670,2,3,3,0,1,0
251830,2,7,7,0,10,0
410001,3,6,35,-29,12,0
84182,4,10,10,0,4,0
265905,2,0,9,-9,16,0
221153,3,0,23,-23,14,1
4311,1,0,6,-6,2,0
154203,4,10,13,-3,1,0
70475,3,20,17,3,15,1
339465,3,10,23,-13,15,0
375465,2,16,7,9,14,0
181222,2,0,0,0,13,0
248891,2,14,0,14,9,0
214057,4,43,21,22,10,1
419464,2,10,6,4,16,0
391397,2,7,10,-3,4,1
145288,2,14,9,5,14,1
158668,3,14,7,7,3,0
133494,3,27,17,10,9,0
407744,3,10,0,10,11,0
256553,2,7,0,7,12,1
327647,1,0,0,0,10,0
369675,2,13,7,6,11,1
127797,3,10,27,-17,6,0
301555,1,0,0,0,15,1
163962,4,26,13,13,5,0
342360,1,0,0,0,16,1
20303,2,10,3,7,10,1
340902,2,0,10,-10,15,0
42630,2,0,7,-7,3,0
193914,4,31,16,15,1,0
91809,3,17,0,17,8,1
183301,4,22,20,2,14,1
238282,4,10,24,-14,4,1
193288,4,3,23,-20,1,1
220938,1,0,0,0,14,0
135323,1,6,10,-4,10,1
346936,1,0,3,-3,1,0
372773,2,3,0,3,13,1
251994,2,7,13,-6,10,1
392756,1,7,3,4,4,0
54862,4,26,3,23,8,0
290703,3,41,25,16,10,1
225585,1,0,7,-7,16,0
179278,3,33,3,30,12,0
152450,1,7,0,7,17,1
61404,3,13,3,10,11,1
123224,4,13,21,-8,4,0
337056,3,19,0,19,14,1
201451,2,12,0,12,5,0
381945,2,0,13,-13,17,0
198804,3,3,16,-13,3,1
373602,4,30,39,-9,13,0
370359,4,20,35,-15,12,1
54663,3,14,22,-8,8,0
46021,2,14,7,7,4,0
97737,4,15,13,2,11,1
220851,3,7,28,-21,14,1
176216,4,14,24,-10,11,1
42682,3,7,10,-3,3,1
72296,1,0,0,0,16,1
386155,1,3,3,0,2,0
311745,2,0,10,-10,2,0
188430,3,3,3,0,16,0
286568,3,10,30,-20,8,0
226254,2,6,0,6,16,1
240737,2,0,7,-7,5,0
290877,4,23,21,2,10,1
27440,1,3,0,3,13,1
318054,1,0,0,0,5,1
94676,3,17,29,-12,9,1
139650,1,0,0,0,12,0
207592,3,21,10,11,7,1
189659,3,10,6,4,17,0
140559,1,7,7,0,12,0
124030,1,0,0,0,5,0
75515,4,37,7,30,17,0
279284,4,19,13,6,5,0
371617,3,17,17,0,12,0
83238,3,9,7,2,4,1
216420,4,21,23,-2,12,1
204136,3,3,10,-7,6,1
315863,4,9,19,-10,4,0
357892,4,13,34,-21,6,1
350463,3,0,12,-12,2,1
47147,2,3,0,3,5,1
59777,3,9,10,-1,11,1
60741,4,28,3,25,11,1
67981,1,0,0,0,14,1
122617,4,27,7,20,4,1
326824,3,10,14,-4,9,0
404733,1,7,3,4,10,0
159641,4,27,20,7,3,0
205885,4,22,7,15,7,1
351490,2,0,24,-24,3,1
142526,4,30,13,17,13,0
114693,3,6,10,-4,1,0
370178,3,24,3,21,12,0
344100,2,10,3,7,17,0
40449,2,7,14,-7,2,0
365471,4,10,19,-9,9,0
346072,3,3,6,-3,1,1
39214,1,0,0,0,1,1
273875,1,0,0,0,2,0
374592,3,20,13,7,14,0
146333,1,3,3,0,15,0
328294,2,3,7,-4,10,0
21833,2,0,0,0,11,1
372928,3,22,7,15,13,1
354071,3,16,0,16,4,1
93887,3,17,3,14,9,0
159197,1,7,7,0,3,0
329215,3,17,13,4,10,0
271013,3,10,21,-11,1,1
39463,3,13,10,3,1,0
112826,1,0,0,0,17,1
220951,2,7,7,0,14,0
112632,4,38,34,4,17,1
319966,3,30,10,20,6,1
181474,4,31,24,7,13,0
285932,2,23,7,16,8,1
46387,4,6,17,-11,4,0
316682,5,12,12,0,4,0
150949,4,13,14,-1,17,0
176993,3,13,6,7,11,1
262839,1,7,13,-6,15,1
103467,1,3,0,3,13,1
280268,2,6,13,-7,5,1
319727,1,0,0,0,6,1
318652,4,10,13,-3,5,1
106412,2,13,0,13,14,1
118692,3,14,6,8,2,1
274350,1,3,7,-4,3,0
9986,4,3,3,0,5,0
71616,3,3,24,-21,16,0
359848,1,17,7,10,6,0
260212,2,10,3,7,14,1
328654,4,27,35,-8,10,0
11029,1,6,0,6,5,1
50429,3,10,7,3,6,1
257924,1,0,0,0,13,0
41201,3,0,13,-13,2,1
356959,2,17,3,14,5,0
288964,2,16,0,16,9,0
250404,4,27,26,1,9,0
67436,2,10,7,3,14,0
3114,2,0,6,-6,2,0
264212,1,3,7,-4,15,1
369942,1,0,0,0,12,1
398679,4,0,6,-6,7,0
109504,1,0,0,0,16,1
163772,3,7,12,-5,5,1
26373,1,6,0,6,13,1
160679,3,10,0,10,4,0
324974,1,13,14,-1,8,0
186289,2,13,3,10,15,1
108039,1,3,7,-4,15,1
175712,3,29,6,23,11,1
178689,3,3,20,-17,12,0
316034,4,0,31,-31,4,1
150100,1,0,0,0,16,1
244384,3,0,17,-17,7,1
22877,2,0,13,-13,11,1
156449,2,0,3,-3,2,1
169708,4,20,17,3,8,1
223508,2,7,10,-3,15,0
55350,1,7,0,7,9,0
274807,1,0,0,0,3,0
374897,4,14,18,-4,14,1
418049,4,28,35,-7,16,1
304289,1,0,0,0,16,0
274121,4,20,0,20,3,0
177258,3,14,16,-2,11,0
315810,2,0,19,-19,4,0
91764,2,3,0,3,8,1
208264,1,0,7,-7,8,1
327967,2,7,0,7,10,1
219812,3,38,0,38,13,0
173219,4,20,24,-4,9,1
270763,4,6,3,3,1,0
226769,4,7,20,-13,16,1
226132,3,14,17,-3,16,0
154315,3,13,14,-1,1,0
336645,5,7,7,0,14,0
235643,1,0,3,-3,3,0
297841,3,14,10,4,13,1
210318,3,16,10,6,9,0
116740,3,13,26,-13,2,0
270188,1,0,0,0,1,1
309351,1,0,0,0,1,1
30359,4,10,17,-7,14,0
153413,2,13,10,3,1,1
182162,3,26,7,19,13,1
245608,4,40,13,27,7,1
273655,3,13,13,0,2,1
117834,3,9,13,-4,2,1
188035,4,23,17,6,16,0
261670,2,7,0,7,14,0
402548,2,7,7,0,9,1
283420,2,20,7,13,7,1
19192,3,21,13,8,10,0
163409,2,0,12,-12,5,0
403324,3,9,0,9,9,0
193993,2,14,7,7,1,1
72556,4,19,31,-12,16,1
124262,2,17,17,0,5,1
158533,3,10,17,-7,3,1
151990,4,34,34,0,17,1
5083,3,13,7,6,3,1
320114,2,17,0,17,6,1
4456,1,7,3,4,2,0
287289,1,3,0,3,8,0
116072,4,16,10,6,1,1
27453,2,9,0,9,13,1
421847,3,0,13,-13,17,1
231930,4,7,41,-34,1,0
324236,2,3,0,3,8,1
44870,3,7,17,-10,4,1
407841,2,3,0,3,11,1
396647,1,0,0,0,6,1
408305,2,0,7,-7,12,0
34492,4,48,9,39,16,0
164630,3,7,17,-10,5,1
409355,1,3,3,0,12,1
116204,4,22,19,3,1,1
95845,3,6,10,-4,10,1
382953,3,3,13,-10,17,0
135570,4,21,6,15,10,0
12294,4,6,6,0,6,1
161746,2,17,6,11,4,1
199,2,3,10,-7,1,1
33857,4,9,41,-32,16,1
170091,2,7,0,7,8,1
229215,1,3,0,3,17,0
166571,2,6,7,-1,6,0
4968,4,24,17,7,3,0
66446,1,0,7,-7,14,0
380049,3,21,17,4,16,0
348689,2,10,10,0,2,1
131869,3,24,7,17,8,1
82569,1,0,3,-3,3,1
271898,2,7,13,-6,2,1
147225,2,0,21,-21,15,1
324251,2,3,0,3,8,1
360951,4,31,5,26,7,1
306786,4,16,33,-17,17,1
42379,3,14,9,5,2,0
194284,2,10,0,10,2,0
109782,4,27,0,27,16,0
243003,5,34,34,0,6,1
321100,1,0,3,-3,6,1
62647,4,17,20,-3,12,1
133942,4,6,6,0,9,1
732,4,6,24,-18,1,0
38822,3,3,10,-7,1,1
258606,3,13,10,3,13,0
126622,5,23,23,0,6,0
332359,4,16,13,3,12,1
145654,3,28,7,21,14,1
225468,2,0,7,-7,15,0
262908,3,14,23,-9,15,1
68023,2,0,10,-10,14,0
109271,3,6,0,6,15,1
146685,3,7,29,-22,15,0
346263,4,40,3,37,1,0
343633,2,15,7,8,17,1
233598,3,20,34,-14,2,0
248405,1,10,0,10,8,0
365956,1,0,0,0,10,0
49137,1,0,0,0,6,1
131143,4,27,12,15,8,1
262331,4,13,9,4,15,0
274327,1,0,0,0,3,1
382081,2,14,3,11,17,1
344594,4,0,6,-6,17,0
163229,1,0,3,-3,5,1
190118,3,27,3,24,17,1
365138,2,7,21,-14,9,1
95095,2,0,7,-7,9,0
29362,4,27,16,11,14,1
126157,1,0,3,-3,6,1
68375,3,3,14,-11,14,0
234739,1,0,0,0,2,1
230876,2,7,10,-3,1,1
263716,1,0,0,0,15,0
135567,4,20,6,14,10,1
264490,1,0,0,0,16,1
3893,2,19,7,12,2,0
57848,4,22,17,5,10,0
193082,2,0,6,-6,1,1
347120,2,13,3,10,1,0
165745,4,17,7,10,6,0
389586,1,7,0,7,3,1
126887,4,17,6,11,6,0
69057,4,27,24,3,15,1
137703,2,0,13,-13,11,1
337628,2,14,10,4,14,1
79093,4,22,21,1,2,1
393986,2,3,7,-4,5,0
148896,1,3,6,-3,16,0
386835,3,13,21,-8,2,1
100756,1,6,0,6,12,0
218303,2,10,14,-4,12,1
48486,4,27,34,-7,5,0
299476,4,10,20,-10,14,0
255724,4,10,20,-10,12,0
197538,1,3,0,3,3,0
374321,4,22,13,9,13,1
22534,1,0,0,0,11,1
13782,3,7,27,-20,7,0
302987,3,20,16,4,16,1
1411,3,16,0,16,1,1
182075,4,17,21,-4,13,0
131377,2,7,13,-6,8,0
310234,1,0,0,0,2,1
233488,4,23,10,13,2,1
115658,1,0,3,-3,1,1
346343,2,3,6,-3,1,1
369104,2,6,7,-1,11,1
384383,1,13,0,13,1,1
58915,3,13,31,-18,10,0
294425,4,19,12,7,12,1
366263,2,14,10,4,10,0
232982,3,10,3,7,2,0
392395,4,26,38,-12,4,1
245738,3,13,10,3,7,1
63530,4,31,26,5,12,1
154145,3,7,6,1,1,0
153122,2,13,17,-4,1,0
232911,1,0,3,-3,2,0
170979,1,7,0,7,8,0
23094,4,10,17,-7,11,0
417090,3,27,0,27,15,1
132867,3,3,14,-11,9,1
45029,3,13,10,3,4,1
104137,3,24,27,-3,13,0
237293,1,0,0,0,3,1
302880,4,15,26,-11,15,0
190880,4,27,17,10,17,0
315936,2,0,7,-7,4,1
251083,2,10,14,-4,10,0
254760,3,10,3,7,11,1
22284,2,0,3,-3,11,0
218781,4,3,16,-13,13,0
147626,4,15,0,15,15,1
290787,2,3,0,3,10,1
73397,3,30,3,27,17,0
141234,3,3,24,-21,13,1
77242,3,16,6,10,1,0
84321,3,14,27,-13,4,0
57356,3,14,3,11,10,0
401625,4,24,31,-7,8,0
138313,2,20,0,20,11,0
93888,3,17,3,14,9,0
5387,3,13,13,0,3,0
186498,3,17,20,-3,15,0
112805,4,34,10,24,17,0
119102,2,7,7,0,3,1
277969,1,0,0,0,4,0
347533,4,20,37,-17,1,1
394583,2,13,0,13,5,1
105096,3,26,14,12,14,1
266042,2,10,0,10,16,0
33387,2,13,10,3,16,1
306791,4,19,33,-14,17,0
149778,1,3,0,3,16,1
219497,2,3,21,-18,13,1
243203,1,0,0,0,6,1
214228,1,0,10,-10,11,1
344513,2,0,0,0,17,1
371792,4,24,14,10,12,1
81374,2,7,7,0,3,0
131117,3,20,9,11,8,1
172939,4,48,31,17,9,1
359829,1,0,7,-7,6,1
309778,1,0,0,0,1,1
304094,3,6,23,-17,16,1
50287,3,13,16,-3,6,1
234989,3,13,16,-3,2,0
374490,4,32,7,25,14,1
229589,3,30,13,17,17,0
218495,4,31,17,14,13,1
9145,1,0,13,-13,5,1
116312,3,17,13,4,1,1
189276,1,3,0,3,16,0
17959,2,13,21,-8,9,1
67962,4,29,6,23,14,0
290349,2,6,3,3,10,1
273945,3,7,9,-2,2,0
242012,2,7,3,4,5,1
343061,3,9,13,-4,16,1
350569,2,10,0,10,2,0
112695,2,3,0,3,17,1
397913,3,7,9,-2,7,0
355095,2,6,13,-7,4,0
80679,4,17,26,-9,3,1
419011,2,7,14,-7,16,0
265551,4,20,13,7,16,1
317773,1,3,0,3,5,0
404120,1,6,0,6,10,1
344030,4,23,9,14,17,0
86543,2,20,3,17,5,1
59305,2,0,3,-3,11,0
298227,2,20,3,17,14,0
142372,4,7,6,1,13,1
95080,1,0,7,-7,9,1
96229,4,3,22,-19,10,0
227857,1,7,6,1,16,0
375338,3,7,17,-10,14,1
57192,3,13,0,13,10,0
42353,2,7,9,-2,2,0
90484,3,0,20,-20,7,0
319677,3,32,3,29,6,1
137170,1,0,0,0,11,0
132106,2,10,0,10,9,0
38155,1,0,0,0,1,1
337914,2,10,0,10,14,1
249194,1,9,0,9,9,0
315705,4,10,16,-6,4,1
361512,3,7,7,0,7,1
158403,4,16,20,-4,3,0
48520,1,11,0,11,5,1
41715,1,0,0,0,2,0
139326,4,20,13,7,12,0
266418,4,36,8,28,16,0
204546,1,0,21,-21,6,1
385683,5,27,27,0,1,1
77806,2,7,14,-7,1,0
418390,1,14,0,14,16,1
401499,1,0,0,0,8,0
412868,4,38,35,3,14,0
366938,1,0,7,-7,10,1
342870,2,16,7,9,16,1
291230,1,7,3,4,10,0
260740,1,3,3,0,14,1
398293,1,3,0,3,7,0
104140,3,24,27,-3,13,0
298777,1,7,6,1,14,0
198231,4,16,9,7,3,1
202067,1,0,0,0,5,1
42482,2,0,12,-12,3,1
300641,3,10,3,7,15,1
169914,1,0,0,0,8,1
348570,3,28,17,11,2,0
338255,3,27,31,-4,14,1
243530,1,0,0,0,6,1
81738,3,17,17,0,3,0
58057,1,7,10,-3,10,1
38802,2,3,10,-7,1,1
331933,4,6,28,-22,12,0
42289,4,37,14,23,2,1
140594,2,24,7,17,12,0
199853,3,10,17,-7,4,0
51733,2,0,10,-10,7,1
374662,1,0,0,0,14,1
408212,3,13,3,10,12,1
400291,4,31,9,22,8,0
144689,2,0,0,0,14,1
84769,4,13,24,-11,4,0
265335,2,7,7,0,16,0
199215,2,10,14,-4,4,1
31906,2,6,10,-4,15,1
143512,3,17,21,-4,14,0
123570,4,19,17,2,4,0
380925,2,6,0,6,16,0
118403,3,13,10,3,2,0
88910,2,16,3,13,6,1
241354,1,0,0,0,5,1
414151,3,10,13,-3,14,0
206735,4,7,21,-14,7,1
83198,2,3,7,-4,4,1
346959,2,7,3,4,1,0
5353,2,10,7,3,3,0
411753,2,0,10,-10,13,0
57724,1,0,0,0,10,1
85112,1,0,0,0,4,0
239715,3,7,10,-3,4,1
178718,4,3,26,-23,12,1
176835,3,10,10,0,11,1
214352,1,0,0,0,11,0
242592,2,3,0,3,6,1
395560,4,28,14,14,6,1
343148,1,0,0,0,16,1
124580,3,6,14,-8,5,0
139039,4,24,19,5,12,0
390858,3,3,28,-25,3,1
226260,2,6,0,6,16,1
78003,3,9,16,-7,1,0
374358,1,0,0,0,14,1
316646,4,12,12,0,4,1
346981,2,7,3,4,1,0
197201,4,34,27,7,3,1
171009,2,7,10,-3,8,1
50136,3,0,17,-17,6,1
56293,3,3,20,-17,9,1
8701,4,17,10,7,4,0
350707,2,7,0,7,2,1
18293,3,13,17,-4,9,1
52300,1,0,0,0,7,1
97229,3,12,6,6,10,1
273732,1,0,0,0,2,0
76997,4,17,20,-3,1,1
65159,2,0,3,-3,13,1
69628,4,14,17,-3,15,0
64852,2,7,0,7,13,0
178730,4,11,26,-15,12,1
368933,1,0,7,-7,11,1
268092,1,0,7,-7,17,1
340417,4,24,13,11,15,0
381379,2,16,0,16,16,1
227724,2,0,0,0,16,1
19246,1,0,7,-7,10,1
98832,1,7,0,7,11,0
215822,4,45,13,32,11,0
292890,2,7,0,7,11,1
252576,1,0,0,0,10,0
50131,3,0,17,-17,6,0
371795,4,24,14,10,12,0
329228,3,17,13,4,10,1
204272,2,0,7,-7,6,0
236047,3,30,3,27,3,0
416075,4,21,6,15,15,0
122765,4,10,27,-17,4,1
243075,2,0,9,-9,6,0
120558,2,0,6,-6,3,0
19939,4,22,21,1,10,0
87173,4,21,10,11,5,0
74913,1,7,0,7,17,0
80871,4,6,13,-7,3,0
361229,3,7,17,-10,7,0
195483,1,0,0,0,2,0
179839,1,0,0,0,13,1
220770,1,0,0,0,14,0
362043,2,14,7,7,8,0
126121,4,30,9,21,6,1
254928,3,31,7,24,12,0
250985,3,3,6,-3,10,0
217672,1,0,0,0,12,0
176082,4,24,16,8,11,1
259520,4,38,10,28,13,0
127662,4,30,12,18,6,0
14019,2,3,14,-11,7,0
66028,2,7,0,7,13,1
137715,2,7,20,-13,11,1
334644,1,0,0,0,13,1
347697,4,27,24,3,1,0
35297,2,6,0,6,16,1
96221,4,3,22,-19,10,1
382066,1,7,0,7,17,0
55287,3,13,10,3,9,1
148054,3,7,9,-2,15,0
78585,3,16,10,6,2,0
19997,2,9,3,6,10,0
409151,4,3,17,-14,12,0
187149,4,16,0,16,16,1
145031,3,13,3,10,14,0
389636,2,17,10,7,3,0
344934,2,3,7,-4,17,1
366386,2,19,0,19,10,1
403786,4,15,16,-1,9,0
24506,2,7,7,0,12,0
366411,3,26,7,19,10,0
94970,3,6,9,-3,9,1
392726,1,0,0,0,4,1
152615,2,0,6,-6,17,1
6708,4,3,23,-20,3,1
201611,2,7,10,-3,5,1
106480,3,29,9,20,14,0
95554,2,9,10,-1,10,1
19848,2,10,14,-4,10,1
211019,2,17,0,17,9,0
68782,2,6,0,6,15,0
421081,2,13,3,10,17,0
390940,1,7,0,7,4,1
154742,2,3,10,-7,1,1
380351,2,10,7,3,16,1
124856,2,0,6,-6,5,1
163932,3,23,10,13,5,1
194110,1,0,0,0,1,0
14510,4,34,30,4,7,0
240493,3,3,7,-4,5,1
140540,4,21,29,-8,12,1
62480,4,13,13,0,12,0
265329,2,7,6,1,16,0
221711,2,10,0,10,14,1
253105,3,21,7,14,11,1
50339,4,13,23,-10,6,1
352872,4,14,13,1,3,0
113985,5,20,20,0,17,0
5456,1,0,0,0,3,0
380711,4,7,10,-3,16,1
260142,4,6,35,-29,14,0
284983,4,16,27,-11,7,1
285160,4,3,3,0,7,0
141507,2,7,10,-3,13,1
39805,1,0,0,0,1,1
168806,1,7,0,7,7,0
351434,4,20,16,4,3,0
320324,4,14,24,-10,6,0
318121,2,9,7,2,5,0
340496,2,0,27,-27,15,1
376292,4,17,21,-4,14,1
110829,4,6,13,-7,16,1
103448,1,0,0,0,13,1
256352,1,3,0,3,12,0
334729,3,24,9,15,13,1
72538,3,16,24,-8,16,0
19716,2,6,6,0,10,0
229056,1,0,0,0,17,1
321704,1,3,3,0,7,0
330863,3,13,17,-4,11,1
349936,4,10,12,-2,2,1
266676,3,29,3,26,16,1
319188,3,9,10,-1,5,0
365644,4,38,35,3,9,1
13050,4,14,7,7,6,1
150670,1,0,0,0,17,0
180731,1,0,3,-3,13,1
387037,1,0,0,0,2,0
116202,4,22,19,3,1,1
37911,2,3,14,-11,1,0
307208,3,0,10,-10,17,0
350829,1,0,0,0,3,0
43121,4,6,27,-21,3,1
287518,3,14,33,-19,9,1
182683,4,11,19,-8,14,0
23621,2,7,10,-3,12,0
298260,3,20,13,7,14,0
171287,2,0,3,-3,9,1
73373,3,20,3,17,17,0
404189,3,9,9,0,10,0
16820,4,20,24,-4,8,0
41537,4,18,7,11,2,1
281243,4,27,19,8,6,0
23705,4,12,33,-21,12,1
189919,2,3,7,-4,17,1
417619,2,14,3,11,16,1
253741,3,17,10,7,11,1
277315,4,0,16,-16,4,0
215579,1,14,0,14,11,0
227053,4,17,6,11,16,0
231252,1,0,0,0,1,0
5257,3,24,24,0,3,0
247389,2,3,6,-3,8,0
11760,1,0,0,0,6,1
57392,4,14,3,11,10,0
93431,2,3,14,-11,9,1
80168,2,7,10,-3,2,0
126501,2,0,6,-6,6,0
299178,4,10,19,-9,14,1
333709,4,21,0,21,12,1
126989,2,10,10,0,6,1
350750,3,10,3,7,2,1
146715,3,7,32,-25,15,1
56006,4,10,23,-13,9,0
275774,3,16,3,13,3,1
296334,3,6,16,-10,13,0
42013,1,6,0,6,2,0
299619,4,13,16,-3,14,1
17652,2,7,3,4,9,1
391086,1,7,7,0,4,0
286631,4,17,41,-24,8,0
61227,2,14,0,14,11,0
340826,4,24,16,8,15,1
141991,3,10,14,-4,13,1
277256,3,0,13,-13,4,0
279536,2,10,6,4,5,0
360412,1,0,0,0,7,0
322179,2,0,17,-17,7,0
233552,2,7,14,-7,2,1
222053,3,20,10,10,14,0
179081,2,3,6,-3,12,1
82815,4,12,16,-4,3,0
342269,3,13,0,13,16,0
41009,2,3,10,-7,2,1
114988,3,13,12,1,1,1
143389,3,7,26,-19,14,0
216091,4,24,19,5,11,0
16242,3,3,3,0,8,1
8562,1,0,0,0,4,1
399768,2,0,24,-24,8,1
364447,3,35,21,14,9,0
269729,4,10,24,-14,1,1
82466,2,7,14,-7,3,0
31406,1,0,0,0,15,1
383164,4,26,24,2,17,1
158427,4,19,27,-8,3,0
337359,3,14,7,7,14,0
120168,4,19,6,13,3,0
252003,2,14,20,-6,10,0
154172,3,7,13,-6,1,1
327993,2,10,0,10,10,0
145073,4,20,13,7,14,0
126879,3,17,6,11,6,0
357390,2,14,17,-3,5,1
94964,2,6,6,0,9,0
195475,1,0,0,0,2,0
296200,3,16,26,-10,13,0
400100,3,17,23,-6,8,0
383988,3,3,13,-10,1,0
21277,2,3,14,-11,11,1
27067,3,17,6,11,13,0
242346,3,27,13,14,6,0
271657,4,30,37,-7,2,0
316995,1,0,7,-7,4,0
406645,2,6,0,6,11,1
368204,4,24,21,3,11,0
14049,3,3,21,-18,7,0
298767,1,7,6,1,14,1
396026,4,38,20,18,6,1
306776,4,16,33,-17,17,1
193387,2,7,17,-10,1,1
387186,4,17,41,-24,2,0
68245,3,20,17,3,14,0
283101,2,3,0,3,7,1
395153,1,3,0,3,5,0
249237,3,19,7,12,9,0
382510,2,0,3,-3,17,0
315749,1,0,0,0,4,0
369417,2,17,7,10,11,1
182481,3,14,0,14,14,1
282963,2,14,3,11,6,1
55801,2,0,7,-7,9,1
89881,4,30,13,17,7,0
56203,1,3,0,3,9,0
69259,2,6,0,6,15,0
40641,4,34,7,27,2,1
147670,2,10,0,10,15,0
117567,4,17,23,-6,2,1
341529,3,6,7,-1,16,0
254153,3,3,12,-9,11,0
166839,1,0,3,-3,6,0
291227,1,7,3,4,10,0
414405,2,7,17,-10,14,0
277267,3,0,13,-13,4,1
318513,1,0,0,0,5,1
43380,3,14,17,-3,3,1
157704,2,10,3,7,2,1
308180,1,0,7,-7,1,1
78112,2,7,3,4,2,1
155475,1,0,0,0,2,1
35673,4,23,10,13,17,1
49079,4,13,13,0,6,0
178975,3,12,3,9,12,0
395039,2,0,17,-17,5,1
410720,2,17,3,14,13,0
274932,4,17,16,1,3,1
48418,3,17,17,0,5,0
216731,3,27,6,21,12,0
69971,2,21,0,21,15,0
410943,4,14,29,-15,13,1
172493,1,0,0,0,9,1
313849,2,7,10,-3,3,0
393124,3,24,3,21,4,0
248103,1,0,0,0,8,0
96656,4,3,10,-7,10,0
230885,3,14,10,4,1,0
312656,2,14,7,7,3,1
392254,4,10,16,-6,4,1
347387,5,21,21,0,1,1
325435,2,13,0,13,8,0
27540,4,23,12,11,13,1
243997,1,7,6,1,6,0
173592,2,0,13,-13,10,1
117065,3,6,17,-11,2,1
362195,2,3,3,0,8,1
412254,4,28,9,19,13,0
215353,3,17,13,4,11,0
84384,1,3,0,3,4,1
412635,2,10,3,7,14,1
45195,4,7,10,-3,4,1
7291,4,17,13,4,4,1
103275,4,3,10,-7,13,0
362317,1,3,7,-4,8,0
325311,2,9,10,-1,8,1
22296,2,0,3,-3,11,1
96104,1,0,6,-6,10,1
418776,4,14,21,-7,16,0
127973,4,23,20,3,6,0
199926,1,0,10,-10,4,1
267312,4,17,17,0,17,1
298924,1,0,6,-6,14,1
401590,3,17,17,0,8,0
342116,2,12,6,6,16,0
204445,3,7,17,-10,6,0
342744,3,0,7,-7,16,0
177591,3,17,10,7,11,0
218997,2,14,0,14,13,0
407819,1,3,0,3,11,0
379999,1,0,0,0,16,1
99183,2,10,3,7,11,0
17850,3,16,10,6,9,0
227849,1,7,6,1,16,1
134058,3,20,3,17,9,1
230168,3,3,26,-23,17,1
343157,1,3,0,3,16,0
186705,4,27,16,11,15,0
386538,3,14,21,-7,2,0
165642,2,0,0,0,6,0
397684,1,3,0,3,7,0
75434,3,10,7,3,17,1
395036,2,0,17,-17,5,1
47018,2,17,0,17,5,1
219971,3,6,21,-15,13,1
252461,2,0,12,-12,10,0
404520,4,31,27,4,10,0
1972,3,10,2,8,1,0
113560,2,0,0,0,17,0
239406,2,6,7,-1,4,0
419397,1,3,0,3,16,0
352277,3,3,6,-3,3,0
139463,4,27,10,17,12,0
421014,4,14,28,-14,17,0
125393,1,0,0,0,5,0
140776,3,22,21,1,12,0
359521,4,0,21,-21,6,0
330679,3,6,3,3,11,0
212594,2,7,17,-10,10,1
131902,4,34,7,27,8,0
9869,1,0,0,0,5,1
321819,4,24,9,15,7,0
266949,2,16,7,9,17,0
356021,2,21,10,11,5,1
97762,1,0,0,0,11,1
25656,1,7,0,7,12,0
329304,1,6,14,-8,10,1
351311,1,7,0,7,3,1
184379,3,21,6,15,14,1
221592,3,20,18,2,14,1
324504,1,0,0,0,8,0
292232,4,24,17,7,11,0
63887,2,6,21,-15,12,0
126503,2,0,6,-6,6,0
184929,2,0,10,-10,15,0
151251,4,24,26,-2,17,0
286730,3,20,7,13,8,0
36305,1,7,0,7,17,0
410853,2,14,6,8,13,1
371124,1,0,6,-6,12,1
385528,1,0,0,0,1,0
331614,3,20,30,-10,11,1
174067,3,0,33,-33,10,0
206971,1,14,0,14,7,1
272171,1,0,0,0,2,1
50314,4,13,23,-10,6,1
181282,3,3,13,-10,13,0
157763,3,17,10,7,2,0
136015,3,3,10,-7,10,1
331940,4,6,28,-22,12,0
323403,4,20,0,20,7,0
27311,2,14,3,11,13,1
381677,3,17,7,10,17,0
144399,2,0,10,-10,14,1
311697,4,6,9,-3,2,1
89214,2,3,0,3,7,1
232923,2,0,3,-3,2,0
75887,2,21,7,14,1,0
258851,3,14,7,7,13,0
66148,1,3,0,3,13,0
215062,3,13,7,6,11,0
168786,4,16,16,0,7,1
411444,2,7,17,-10,13,1
219351,3,16,13,3,13,1
306396,1,0,3,-3,17,0
277380,2,17,9,8,4,0
150774,4,13,9,4,17,0
37580,1,0,0,0,17,1
266188,2,21,0,21,16,1
420504,3,3,35,-32,17,1
133194,3,13,17,-4,9,0
295930,4,13,24,-11,12,1
27517,3,23,9,14,13,0
108174,1,0,0,0,15,1
391589,3,10,24,-14,4,1
209223,3,17,7,10,8,1
374868,3,14,3,11,14,1
379920,3,20,6,14,16,1
145885,1,0,0,0,15,1
419335,3,0,17,-17,16,0
279251,3,16,13,3,5,0
20217,4,24,10,14,10,0
104911,2,3,3,0,14,0
49200,2,17,0,17,6,0
335284,2,3,6,-3,13,0
51126,1,7,0,7,7,0
48316,4,22,13,9,5,1
39927,4,9,10,-1,1,0
222095,4,27,17,10,14,1
205519,3,14,17,-3,6,0
209092,3,3,20,-17,8,0
135643,2,7,7,0,10,0
131884,4,31,7,24,8,1
406429,4,31,7,24,11,1
227944,4,27,27,0,16,1
182045,3,17,14,3,13,1
344955,3,10,14,-4,17,1
292977,4,10,14,-4,11,1
387908,4,10,28,-18,2,1
420241,1,0,0,0,17,1
307614,2,6,7,-1,17,1
301094,4,33,13,20,15,1
322860,1,0,0,0,7,1
401882,4,14,28,-14,9,1
338560,4,23,31,-8,14,0
36941,2,0,25,-25,17,0
206674,1,0,7,-7,7,0
150659,4,17,22,-5,17,1
335704,2,7,7,0,13,1
113018,3,10,13,-3,17,1
324399,2,14,3,11,8,0
109153,3,31,7,24,15,1
252623,2,6,3,3,10,1
195178,1,7,0,7,2,1
58979,1,0,0,0,10,0
264511,1,7,7,0,16,0
224252,1,6,3,3,15,0
149171,4,24,31,-7,16,1
190870,4,27,17,10,17,0
353018,4,23,10,13,3,1
5186,1,0,3,-3,3,0
232597,1,0,0,0,1,0
262902,3,14,23,-9,15,0
279695,2,23,3,20,5,0
236668,2,10,7,3,3,1
31278,1,0,3,-3,15,0
183210,2,7,0,7,14,0
225030,1,0,6,-6,15,0
101419,3,15,7,8,12,0
343801,2,14,3,11,17,1
306443,2,3,17,-14,17,1
420689,4,21,16,5,17,0
162193,2,10,7,3,4,0
39949,4,9,10,-1,1,1
37261,4,13,21,-8,17,1
356379,4,24,14,10,5,1
406136,4,3,26,-23,11,0
348275,4,16,46,-30,1,0
420879,4,17,34,-17,17,1
300621,2,10,3,7,15,0
187745,4,16,20,-4,16,1
60150,4,34,19,15,11,1
137777,4,10,37,-27,11,1
888,1,0,0,0,1,0
169619,2,6,0,6,8,1
52568,4,19,10,9,7,1
73016,1,0,0,0,16,0
42498,2,10,12,-2,3,0
13963,4,24,21,3,7,1
210972,1,0,0,0,9,0
97595,1,0,0,0,11,1
348956,1,14,0,14,2,0
101541,2,10,21,-11,12,1
349190,4,27,14,13,2,0
197420,2,13,3,10,3,0
91330,3,7,7,0,8,0
351569,4,0,27,-27,3,0
128343,2,7,3,4,7,0
60663,2,14,3,11,11,0
143341,2,0,13,-13,14,1
94743,1,0,0,0,9,1
8095,4,24,13,11,4,0
318648,4,10,13,-3,5,0
252353,3,0,22,-22,10,1
285461,4,33,8,25,8,1
8260,4,16,13,3,4,1
290140,4,24,15,9,10,1
271452,3,14,0,14,1,1
21766,4,31,23,8,11,0
216978,2,3,3,0,12,1
61774,1,0,7,-7,12,1
395222,3,10,13,-3,5,0
142910,2,3,10,-7,13,0
116623,3,13,3,10,2,0
402716,2,10,0,10,9,1
31055,3,10,13,-3,15,1
20897,4,28,23,5,10,1
127431,1,3,0,3,6,0
401236,2,7,7,0,8,0
290045,2,7,6,1,10,1
180534,4,21,20,1,13,0
395112,4,23,34,-11,5,1
90660,4,27,33,-6,7,0
142900,2,0,10,-10,13,0
69082,1,0,0,0,15,0
329627,2,10,7,3,11,0
317412,4,7,17,-10,5,1
105028,1,0,7,-7,14,0
236517,3,10,9,1,3,0
176294,2,6,14,-8,11,1
386009,1,7,0,7,1,1
391783,4,10,13,-3,4,0
83054,2,6,14,-8,4,0
409835,2,13,0,13,12,0
110186,4,23,30,-7,16,1
374796,1,7,0,7,14,0
61925,1,0,0,0,12,0
333116,4,20,30,-10,12,1
2675,2,6,6,0,2,0
186088,4,31,55,-24,15,1
237840,2,7,20,-13,4,1
178607,1,3,3,0,12,1
402270,2,10,16,-6,9,1
170373,1,7,0,7,8,1
234015,2,14,0,14,2,1
192178,3,3,20,-17,1,1
19581,3,14,21,-7,10,1
406506,2,0,16,-16,11,1
322046,2,13,0,13,7,0
383533,3,14,13,1,17,1
70161,3,20,7,13,15,0
108232,2,6,0,6,15,1
302893,1,0,0,0,16,1
419142,2,10,3,7,16,1
136733,2,13,10,3,11,0
373696,3,6,15,-9,13,0
357418,3,24,17,7,5,0
109693,2,3,0,3,16,1
369215,1,0,7,-7,11,1
87434,3,20,7,13,6,0
92605,4,17,3,14,8,0
358826,1,0,7,-7,6,0
372350,4,24,17,7,13,0
298114,3,3,31,-28,13,1
268742,2,10,3,7,17,1
282960,2,14,3,11,6,0
277341,1,7,0,7,4,0
307867,4,27,35,-8,1,1
66281,1,0,0,0,14,1
45118,1,7,0,7,4,0
325969,4,22,7,15,9,1
230863,2,7,7,0,1,0
329771,2,17,6,11,11,0
31119,1,0,3,-3,15,1
177769,4,13,17,-4,12,0
318024,4,17,16,1,5,0
141080,4,14,10,4,13,1
308795,1,0,3,-3,1,1
204477,3,10,24,-14,6,0
133035,3,9,14,-5,9,1
107124,4,40,6,34,15,0
122335,4,6,19,-13,4,1
374815,1,7,0,7,14,1
65588,2,6,6,0,13,1
392746,1,7,0,7,4,0
116999,1,0,3,-3,2,1
242241,4,30,14,16,6,0
73635,2,3,0,3,17,1
145044,3,13,6,7,14,1
150669,1,0,0,0,17,0
345468,4,9,22,-13,17,0
61217,1,7,0,7,11,1
89528,2,0,10,-10,7,1
306856,2,0,3,-3,17,1
413448,4,10,38,-28,14,1
75873,2,14,7,7,1,1
269356,2,7,14,-7,1,1
40454,3,7,14,-7,2,0
75835,1,7,0,7,1,1
341599,4,25,17,8,16,1
86436,3,27,7,20,5,0
63166,2,14,10,4,12,0
414507,1,7,3,4,14,1
81735,3,17,17,0,3,0
208286,1,0,14,-14,8,1
203116,1,0,7,-7,5,1
211401,4,10,13,-3,9,1
212037,4,10,37,-27,9,0
358619,4,27,9,18,6,0
234228,4,20,17,3,2,1
13163,3,19,16,3,6,0
238038,3,10,13,-3,4,1
255357,2,14,3,11,12,0
70763,3,20,23,-3,15,0
21114,2,0,0,0,10,1
76165,2,9,6,3,1,1
248922,3,17,3,14,9,0
166172,3,28,19,9,6,0
79885,2,3,13,-10,2,1
344041,4,23,9,14,17,1
149128,3,17,24,-7,16,1
84257,2,0,7,-7,4,1
279427,3,16,24,-8,5,1
167490,2,0,3,-3,7,1
214038,4,43,14,29,10,1
329245,4,23,13,10,10,1
87021,4,14,22,-8,5,1
166761,3,20,9,11,6,0
15901,2,6,7,-1,8,0
200979,1,14,0,14,5,1
173334,3,14,27,-13,10,1
378471,4,20,0,20,15,0
78232,1,0,0,0,2,1
261055,2,0,14,-14,14,1
220845,3,7,27,-20,14,0
384015,3,10,23,-13,1,1
267219,2,9,7,2,17,1
273794,3,10,7,3,2,0
140605,2,24,10,14,12,0
55218,2,7,0,7,9,0
325091,4,33,38,-5,8,1
82258,1,0,0,0,3,0
221740,3,10,7,3,14,1
323775,2,6,3,3,8,1
137575,4,20,33,-13,11,0
82058,4,17,7,10,3,0
341148,1,0,0,0,16,1
205915,1,3,0,3,7,1
239798,1,0,0,0,4,0
233672,1,7,0,7,2,1
163015,4,16,3,13,5,1
214713,1,3,7,-4,11,1
269637,2,3,0,3,1,0
128819,3,13,13,0,7,1
283444,3,20,7,13,7,0
62058,4,26,10,16,12,1
348255,3,16,39,-23,1,1
401911,4,25,28,-3,9,0
287814,3,21,17,4,9,1
86837,2,9,13,-4,5,0
38866,4,3,13,-10,1,1
153512,1,2,0,2,1,1
251116,3,10,14,-4,10,1
271161,3,7,16,-9,1,0
280414,2,6,10,-4,5,0
311205,2,6,0,6,2,0
15073,3,10,26,-16,7,0
331839,1,0,0,0,12,0
350726,2,7,0,7,2,0
296686,4,10,16,-6,13,1
287190,3,10,13,-3,8,0
333961,2,14,10,4,12,1
311513,3,17,13,4,2,0
33342,1,3,3,0,16,1
142609,2,6,3,3,13,1
397734,2,9,14,-5,7,1
315266,4,20,16,4,4,0
93402,1,3,6,-3,9,0
115304,4,17,15,2,1,0
382484,1,0,0,0,17,1
88388,4,24,10,14,6,0
414821,1,13,0,13,15,0
73487,2,3,21,-18,17,1
237528,3,24,7,17,3,0
117921,1,0,3,-3,2,1
275626,3,24,3,21,3,1
217424,1,3,0,3,12,1
365191,4,14,28,-14,9,0
86192,4,31,10,21,5,1
308157,4,16,19,-3,1,1
257793,1,0,0,0,13,1
385957,4,24,21,3,1,0
230719,2,9,27,-18,1,1
374297,3,14,13,1,13,1
280794,1,0,0,0,6,1
349039,4,14,17,-3,2,1
189083,4,24,30,-6,16,1
98454,3,17,14,3,11,1
107237,4,14,31,-17,15,1
125744,2,7,14,-7,5,1
234859,4,3,12,-9,2,0
218986,1,14,0,14,13,0
81630,1,0,0,0,3,1
243057,2,0,9,-9,6,0
68076,3,3,10,-7,14,0
65071,4,6,17,-11,13,0
287350,3,13,3,10,8,1
276988,4,24,20,4,4,0
25324,4,39,14,25,12,1
328065,4,17,17,0,10,0
198255,1,3,0,3,3,0
6237,2,13,7,6,3,1
299572,3,10,3,7,14,0
410235,2,7,0,7,13,1
313121,2,6,3,3,3,1
120336,1,0,0,0,3,0
251942,1,0,7,-7,10,1
243762,3,17,17,0,6,0
181923,4,28,35,-7,13,0
84189,4,17,10,7,4,0
106418,2,13,0,13,14,0
337366,3,14,7,7,14,1
94950,2,3,6,-3,9,0
226106,2,7,14,-7,16,0
320943,1,0,0,0,6,1
15609,2,14,10,4,8,1
216423,4,24,23,1,12,0
318639,4,10,13,-3,5,1
227856,1,7,6,1,16,0
23767,2,10,0,10,12,0
174823,2,13,17,-4,10,0
48658,1,7,0,7,5,0
383020,1,0,0,0,17,0
144799,4,10,17,-7,14,1
362914,2,7,0,7,8,1
266762,2,0,14,-14,16,1
11023,1,0,0,0,5,1
368286,3,6,6,0,11,1
34768,4,20,3,17,16,0
160838,3,34,17,17,4,1
289464,2,3,7,-4,10,1
212366,4,13,10,3,10,0
34093,2,0,0,0,16,0
93400,1,3,0,3,9,0
38963,2,23,3,20,1,1
377010,4,15,19,-4,15,1
335108,1,3,0,3,13,0
112819,1,0,0,0,17,0
402731,2,17,0,17,9,0
314110,4,33,20,13,3,0
290679,3,35,16,19,10,0
228255,4,10,27,-17,17,1
89485,1,0,0,0,7,0
385650,4,16,24,-8,1,0
154296,2,6,14,-8,1,1
420300,2,7,0,7,17,1
124500,1,0,0,0,5,1
244320,1,0,7,-7,7,1
388030,3,12,6,6,2,1
129666,1,0,3,-3,7,1
401012,4,22,15,7,8,1
417611,2,14,0,14,16,0
43217,3,14,10,4,3,1
416949,4,10,7,3,15,0
417382,3,13,17,-4,16,0
13425,2,3,14,-11,7,0
7045,1,0,0,0,4,0
252017,3,14,20,-6,10,1
154331,3,20,17,3,1,1
349829,1,0,0,0,2,0
62757,3,14,0,14,12,1
182314,2,14,7,7,14,1
366796,1,0,0,0,10,1
64783,4,31,7,24,13,1
381589,4,42,16,26,17,1
419503,4,10,17,-7,16,0
357334,1,0,0,0,5,0
87075,1,0,0,0,5,0
116149,3,7,10,-3,1,0
260017,1,0,0,0,14,0
83651,1,0,3,-3,4,1
276542,4,22,7,15,4,1
276834,3,20,20,0,4,0
349135,2,13,7,6,2,1
338847,3,13,7,6,15,0
54900,1,0,0,0,8,1
262406,2,7,7,0,15,1
109232,2,6,0,6,15,0
386868,4,26,28,-2,2,0
119117,2,10,7,3,3,0
33227,2,10,0,10,16,1
316002,4,0,31,-31,4,0
144426,3,3,13,-10,14,0
150435,2,20,0,20,16,0
67157,2,0,0,0,14,1
407329,4,23,26,-3,11,0
384973,2,14,6,8,1,1
160132,1,7,0,7,3,1
17277,4,21,34,-13,9,1
137782,4,17,37,-20,11,0
91628,2,14,7,7,8,1
98886,2,7,7,0,11,0
399840,4,17,27,-10,8,1
45460,3,27,14,13,4,0
251558,3,16,13,3,10,1
90898,3,34,7,27,7,1
327996,2,10,0,10,10,0
144040,1,0,0,0,14,1
165816,2,3,6,-3,6,0
190204,2,0,0,0,17,1
134221,3,3,23,-20,10,1
243315,4,14,10,4,6,0
284228,4,9,26,-17,7,1
84041,4,30,15,15,4,0
196916,4,10,22,-12,3,1
179924,4,26,9,17,13,1
93794,4,3,19,-16,9,1
401165,4,44,13,31,8,0
405040,1,0,0,0,10,1
304393,4,31,21,10,16,0
238287,4,10,24,-14,4,0
166970,1,0,0,0,7,1
386803,2,10,7,3,2,0
191734,3,16,17,-1,17,0
103484,2,6,0,6,13,1
343485,3,7,7,0,16,0
276455,1,10,7,3,4,0
115970,1,10,0,10,1,1
335148,2,17,0,17,13,0
233629,4,23,41,-18,2,0
91887,1,0,0,0,8,0
59209,3,14,45,-31,10,1
268266,1,3,0,3,17,1
141464,1,7,0,7,13,1
177358,1,10,0,10,11,0
130884,1,0,0,0,8,0
368817,1,7,0,7,11,0
73533,3,3,38,-35,17,1
209440,4,17,17,0,8,0
67240,4,7,3,4,14,0
316925,3,17,15,2,4,0
320671,1,14,10,4,6,0
131183,1,0,0,0,8,0
194508,4,26,10,16,2,0
239922,4,13,9,4,4,0
113361,4,26,38,-12,17,1
226858,2,0,7,-7,16,0
254269,2,6,9,-3,11,1
375650,3,17,17,0,14,0
52633,1,3,0,3,7,0
417189,2,3,17,-14,16,0
29066,1,0,3,-3,14,1
89709,3,9,20,-11,7,1
101935,4,6,13,-7,12,1
356732,4,26,24,2,5,1
14621,3,17,7,10,7,1
220504,1,0,14,-14,13,1
255673,3,3,7,-4,12,1
87289,3,24,17,7,6,0
325226,4,13,26,-13,8,1
177558,2,10,0,10,11,0
345981,1,0,0,0,1,1
133290,2,7,0,7,9,0
219005,2,14,0,14,13,1
115091,2,3,13,-10,1,1
401166,4,44,13,31,8,0
110538,1,0,0,0,16,1
154574,2,14,7,7,1,1
239612,4,20,10,10,4,0
243147,4,20,22,-2,6,0
407435,3,14,7,7,11,0
383339,1,0,0,0,17,0
356392,4,31,20,11,5,1
324874,2,10,13,-3,8,0
75709,2,21,7,14,1,0
23014,2,0,14,-14,11,1
285794,3,7,17,-10,8,0
390520,2,10,7,3,3,0
135373,2,20,17,3,10,1
385443,3,28,10,18,1,0
420963,3,7,14,-7,17,0
372145,2,9,7,2,13,0
65369,4,13,28,-15,13,0
333420,4,23,13,10,12,0
307616,2,7,7,0,17,0
400771,1,13,0,13,8,1
202170,4,13,6,7,5,0
160222,4,37,14,23,3,0
64420,2,0,6,-6,13,1
200900,3,17,0,17,4,1
47864,3,10,13,-3,5,1
174975,2,6,20,-14,10,0
174500,2,7,7,0,10,0
210497,4,9,14,-5,9,0
75886,2,21,7,14,1,0
316102,2,17,13,4,4,1
82868,1,0,0,0,4,1
72219,3,17,10,7,16,0
209858,2,13,13,0,8,0
222736,1,3,0,3,14,0
154925,3,19,10,9,1,1
59731,1,6,7,-1,11,0
244353,2,0,10,-10,7,1
352797,2,14,0,14,3,0
55605,4,27,7,20,9,0
340477,2,0,13,-13,15,1
279283,4,19,13,6,5,0
96444,2,10,14,-4,10,0
154540,1,0,0,0,1,1
25258,2,14,7,7,12,1
177427,3,17,10,7,11,0
153658,1,2,0,2,1,0
183128,3,7,6,1,14,1
227309,3,13,20,-7,16,0
152158,1,0,0,0,17,1
334457,4,17,13,4,13,0
334570,3,24,24,0,13,1
338281,4,34,34,0,14,0
369145,3,13,7,6,11,1
6181,1,6,0,6,3,1
243712,2,14,3,11,6,1
104167,4,27,27,0,13,0
141692,3,23,21,2,13,1
210027,3,7,10,-3,8,0
390722,3,13,10,3,3,0
390137,4,20,35,-15,3,1
6918,1,0,0,0,3,1
329444,1,0,0,0,10,1
234422,1,7,3,4,2,1
165604,1,0,0,0,6,0
159806,1,0,0,0,3,1
77818,3,7,14,-7,1,0
185810,4,25,3,22,15,0
317054,3,7,10,-3,4,1
225440,1,0,0,0,15,1
299232,1,3,0,3,14,1
382221,2,10,3,7,17,1
164946,3,3,15,-12,6,0
97848,3,7,24,-17,11,0
326046,2,9,0,9,9,0
14219,4,0,38,-38,7,1
391683,2,0,3,-3,4,1
274843,2,0,7,-7,3,0
275164,3,14,16,-2,3,1
219460,2,0,7,-7,13,0
88359,4,24,7,17,6,1
359583,2,17,0,17,6,0
315594,1,0,0,0,4,1
312388,3,13,27,-14,3,1
65646,4,6,19,-13,13,1
98177,4,21,19,2,11,1
392989,4,12,10,2,4,0
41777,2,7,14,-7,2,1
390799,1,0,7,-7,3,1
58811,4,18,36,-18,10,1
141933,1,10,0,10,13,0
233221,1,0,0,0,2,0
411071,4,17,17,0,13,1
117189,2,16,10,6,2,1
15751,2,0,5,-5,8,1
63359,4,17,3,14,12,1
145593,2,21,0,21,14,0
32446,4,31,6,25,15,1
36752,1,0,7,-7,17,1
188727,2,0,17,-17,16,0
237134,4,8,33,-25,3,1
11940,1,0,0,0,6,1
14580,1,0,7,-7,7,0
31951,3,16,13,3,15,0
185059,2,0,3,-3,15,0
193573,3,0,10,-10,1,1
175804,1,14,0,14,11,0
3603,2,20,21,-1,2,1
321302,3,12,19,-7,6,1
60812,2,10,13,-3,11,1
290434,4,35,10,25,10,1
118131,3,16,20,-4,2,1
307912,1,0,0,0,1,1
210445,2,9,14,-5,9,1
114022,1,0,0,0,17,1
377513,1,0,0,0,15,0
92197,4,10,43,-33,8,1
159861,2,17,0,17,3,1
85380,4,31,10,21,5,0
163895,2,16,10,6,5,0
250881,4,16,18,-2,10,1
406096,3,0,20,-20,11,0
96660,4,3,17,-14,10,1
269727,4,10,24,-14,1,1
317857,4,9,10,-1,5,1
233896,3,14,6,8,2,0
409302,4,13,16,-3,12,0
250653,3,3,19,-16,10,0
135680,3,13,10,3,10,1
397196,3,13,0,13,6,1
23391,4,20,17,3,11,0
239634,4,20,20,0,4,1
393679,2,0,0,0,5,1
186518,4,17,26,-9,15,0
190063,2,17,3,14,17,1
83820,2,10,3,7,4,0
242366,4,34,13,21,6,1
105673,2,14,3,11,14,1
318182,4,22,17,5,5,0
53449,4,10,28,-18,8,0
303039,4,23,19,4,16,0
52430,4,12,17,-5,7,1
200860,2,14,0,14,4,0
240226,4,16,12,4,5,0
188832,1,0,0,0,16,1
387091,2,10,21,-11,2,0
326644,3,16,6,10,9,0
368163,3,13,21,-8,11,1
101782,5,13,13,0,12,0
382321,4,20,3,17,17,1
389736,1,3,0,3,3,1
386242,4,12,17,-5,2,1
281148,2,7,0,7,6,1
279440,4,16,30,-14,5,1
218622,3,10,30,-20,13,1
246697,4,45,10,35,8,0
199159,4,14,45,-31,4,0
371736,2,14,14,0,12,1
235854,2,0,14,-14,3,0
182781,2,10,3,7,14,0
397322,3,0,24,-24,6,0
130196,3,0,19,-19,8,1
145377,4,52,26,26,14,0
59818,4,12,13,-1,11,1
137474,1,7,0,7,11,0
6662,2,3,10,-7,3,0
372174,3,9,13,-4,13,1
13126,2,10,7,3,6,0
262167,4,28,6,22,15,1
164031,2,0,3,-3,5,1
395894,1,0,0,0,6,1
351828,3,20,14,6,3,1
144825,1,14,0,14,14,1
73736,1,3,0,3,17,0
355947,1,0,0,0,5,0
122027,4,16,13,3,4,1
62826,1,0,0,0,12,1
215994,1,0,0,0,11,0
340875,1,0,3,-3,15,0
47366,3,3,13,-10,5,0
267648,1,0,20,-20,17,0
51501,4,34,24,10,7,0
226005,4,34,27,7,16,0
60958,2,14,6,8,11,1
214653,4,10,16,-6,11,1
161133,3,3,26,-23,4,1
209696,2,9,3,6,8,1
123319,2,14,7,7,4,1
289070,4,41,28,13,9,0
214749,2,3,10,-7,11,0
81882,3,0,27,-27,3,0
380887,1,0,0,0,16,0
184453,1,0,0,0,14,0
348616,4,34,23,11,2,0
149697,2,20,0,20,16,1
385364,1,0,0,0,1,0
71710,2,10,7,3,16,1
245489,1,0,0,0,7,0
69606,3,7,17,-10,15,0
189522,4,20,0,20,17,0
159167,1,0,0,0,3,1
156307,2,10,0,10,2,1
174560,4,10,14,-4,10,1
41030,2,3,10,-7,2,1
214615,3,3,16,-13,11,1
134708,1,0,0,0,10,1
72035,2,7,10,-3,16,0
190279,4,7,14,-7,17,0
44074,1,0,6,-6,3,1
404038,2,9,28,-19,10,1
128484,2,21,20,1,7,0
383022,1,0,0,0,17,0
56231,2,3,7,-4,9,0
169770,2,0,7,-7,8,0
131290,4,21,17,4,8,0
13134,2,10,7,3,6,0
219672,3,10,7,3,13,0
30056,4,40,7,33,14,0
1627,1,0,0,0,1,1
102684,4,29,28,1,13,1
150736,2,13,9,4,17,1
332580,2,10,3,7,12,1
179210,1,7,0,7,12,0
216059,3,17,12,5,11,0
216013,1,7,9,-2,11,0
339702,2,7,3,4,15,0
370137,2,10,3,7,12,1
333020,2,3,9,-6,12,1
291279,3,14,19,-5,10,0
106262,1,0,3,-3,14,1
237262,4,23,0,23,3,1
390238,2,3,6,-3,3,0
303787,3,20,17,3,16,0
180676,4,27,6,21,13,1
407074,1,0,6,-6,11,0
414009,3,3,31,-28,14,1
324812,1,3,0,3,8,0
160768,1,10,6,4,4,0
169271,4,23,6,17,7,1
50525,1,0,3,-3,6,1
63366,4,17,3,14,12,1
335795,1,0,0,0,13,1
270093,2,17,10,7,1,1
318908,4,24,22,2,5,0
305081,2,21,7,14,16,0
98623,4,7,7,0,11,1
239731,3,10,13,-3,4,1
368415,3,20,7,13,11,0
375378,4,14,24,-10,14,0
117191,2,16,10,6,2,0
251091,2,10,14,-4,10,0
74082,2,9,0,9,17,0
232612,1,0,0,0,1,0
97834,3,7,24,-17,11,1
95329,4,17,24,-7,10,1
229907,4,27,14,13,17,0
85332,2,21,3,18,5,1
217080,1,0,0,0,12,1
198907,2,3,16,-13,3,1
278096,4,13,17,-4,4,1
338128,4,12,7,5,14,0
8528,4,15,10,5,4,1
278614,2,14,0,14,4,0
250808,3,3,9,-6,10,1
119267,2,7,3,4,3,1
342581,3,12,13,-1,16,1
343434,1,6,0,6,16,1
390935,1,7,0,7,4,1
130359,3,7,3,4,8,0
415560,2,6,7,-1,15,1
227073,4,20,9,11,16,0
94283,1,3,0,3,9,0
137097,3,17,3,14,11,0
80358,3,20,6,14,2,0
139329,4,20,13,7,12,0
388149,2,3,6,-3,2,0
61480,1,0,7,-7,11,1
196649,1,13,0,13,3,1
45731,2,7,7,0,4,1
313597,3,12,23,-11,3,1
122475,4,13,26,-13,4,0
247175,4,27,6,21,8,0
128125,4,13,6,7,7,0
348469,1,7,0,7,2,0
154376,4,34,24,10,1,0
346774,1,0,0,0,1,0
123311,2,14,7,7,4,1
52509,2,10,0,10,7,0
173983,4,23,19,4,10,1
360934,3,24,3,21,7,0
246953,3,20,10,10,8,1
229954,1,0,3,-3,17,1
83020,1,0,0,0,4,0
144857,2,14,0,14,14,1
290739,4,47,25,22,10,1
240989,4,21,22,-1,5,1
72574,4,19,31,-12,16,1
134653,4,34,24,10,10,0
228493,2,17,7,10,17,0
195131,4,7,29,-22,2,1
185731,2,20,3,17,15,0
51190,3,24,6,18,7,1
248379,1,3,0,3,8,0
63829,1,0,0,0,12,0
108178,1,3,0,3,15,0
237212,2,3,0,3,3,1
370533,1,0,0,0,12,1
281595,1,7,0,7,6,0
174661,2,9,0,9,10,0
121034,3,11,21,-10,3,0
93281,2,14,3,11,9,0
395356,2,21,3,18,5,0
36633,2,10,3,7,17,0
191335,1,0,7,-7,17,0
131134,4,27,9,18,8,0
314850,1,0,0,0,4,1
76492,2,0,20,-20,1,1
134149,1,0,3,-3,10,1
127209,4,13,16,-3,6,1
378228,1,0,0,0,15,1
53913,3,13,13,0,8,1
369217,1,0,7,-7,11,1
387076,2,7,14,-7,2,0
79111,1,0,0,0,2,0
308720,3,7,13,-6,1,1
254977,4,45,14,31,12,1
315125,1,0,0,0,4,1
226605,3,10,3,7,16,1
226119,3,7,17,-10,16,0
339557,2,10,7,3,15,1
81380,2,7,7,0,3,1
89148,4,23,6,17,6,0
203357,3,20,27,-7,6,1
235640,1,0,0,0,3,0
254742,2,3,3,0,11,0
399715,1,0,3,-3,8,0
299395,2,0,13,-13,14,1
14202,4,0,31,-31,7,0
153782,4,2,27,-25,1,1
67676,4,7,35,-28,14,0
384909,4,13,36,-23,1,1
173442,2,0,7,-7,10,0
154384,4,34,24,10,1,0
302041,2,7,10,-3,15,0
416632,3,31,7,24,15,0
240142,2,13,3,10,5,1
5868,1,0,0,0,3,1
229606,4,30,13,17,17,1
91113,1,0,0,0,8,0
36580,1,0,0,0,17,1
236947,3,36,7,29,3,0
42679,3,7,10,-3,3,0
249660,2,3,7,-4,9,1
265266,4,9,6,3,16,0
304314,2,7,0,7,16,1
29235,1,14,0,14,14,0
168510,4,17,30,-13,7,0
169294,4,23,6,17,7,1
407465,4,14,10,4,11,1
392899,1,0,0,0,4,0
210315,3,9,10,-1,9,1
249550,3,14,10,4,9,0
250391,4,24,26,-2,9,1
23370,3,20,17,3,11,0
95712,3,13,9,4,10,0
30621,3,17,3,14,14,1
177459,4,24,10,14,11,1
65436,2,0,14,-14,13,0
236004,2,10,3,7,3,1
392760,2,7,3,4,4,1
16084,2,30,7,23,8,0
86345,4,27,30,-3,5,1
159436,4,20,20,0,3,0
56245,2,3,7,-4,9,1
19608,3,17,21,-4,10,0
43970,3,3,14,-11,3,0
335242,1,0,0,0,13,0
336858,2,7,7,0,14,1
367248,2,3,0,3,10,1
325141,2,13,7,6,8,0
338144,1,0,0,0,14,0
105243,3,7,24,-17,14,0
394739,2,14,0,14,5,0
317128,1,0,0,0,5,1
408087,4,20,17,3,12,0
343107,4,12,20,-8,16,0
308726,3,10,13,-3,1,1
118839,3,20,7,13,2,1
405306,3,14,7,7,10,0
2640,1,3,0,3,2,0
418992,2,7,7,0,16,1
55389,2,10,7,3,9,1
313043,4,20,0,20,3,1
325646,3,17,7,10,9,0
397699,1,6,0,6,7,0
166573,2,8,7,1,6,1
151449,2,21,7,14,17,1
164212,3,20,35,-15,5,1
211021,2,17,0,17,9,1
356966,2,17,3,14,5,0
353112,2,10,22,-12,3,0
278663,3,17,3,14,4,1
182720,4,21,26,-5,14,1
369786,4,45,50,-5,11,1
303975,4,14,34,-20,16,1
171906,2,7,7,0,9,1
421160,4,44,16,28,17,1
249035,1,14,10,4,9,1
163720,2,0,9,-9,5,1
273603,2,10,3,7,2,0
275807,4,16,3,13,3,1
276215,3,24,10,14,3,1
20732,4,31,20,11,10,1
1161,4,10,36,-26,1,1
60341,2,3,0,3,11,0
395010,2,0,14,-14,5,1
185174,1,0,0,0,15,1
60858,3,17,23,-6,11,1
153045,1,0,6,-6,1,0
144306,4,29,7,22,14,0
366748,3,27,10,17,10,1
388396,1,0,0,0,2,0
334471,4,24,13,11,13,0
31725,1,0,0,0,15,0
285375,1,3,0,3,8,1
103725,4,3,17,-14,13,1
137977,1,7,7,0,11,0
119731,1,7,3,4,3,1
43647,2,7,3,4,3,1
229012,4,21,16,5,17,1
375496,3,26,7,19,14,1
264042,1,7,7,0,15,1
32013,1,0,0,0,15,1
330834,2,10,17,-7,11,0
310782,3,6,3,3,2,0
289169,2,20,7,13,9,0
59165,2,0,34,-34,10,0
331168,3,7,13,-6,11,1
112655,1,0,0,0,17,1
105564,3,29,21,8,14,1
167682,3,16,20,-4,7,0
270466,4,13,7,6,1,1
99628,2,10,3,7,11,0
252868,1,0,0,0,11,1
183186,1,0,0,0,14,0
2039,1,0,0,0,1,0
36120,4,44,7,37,17,1
48862,2,6,0,6,5,1
105127,4,26,14,12,14,1
26303,3,13,21,-8,13,1
306491,4,17,17,0,17,0
376099,3,0,3,-3,14,1
238969,3,14,12,2,4,0
31791,3,6,17,-11,15,0
102199,3,24,7,17,13,0
230311,3,19,10,9,17,1
98366,1,0,0,0,11,0
239033,4,36,18,18,4,0
90922,3,48,7,41,7,1
75396,2,10,0,10,17,0
210215,4,10,21,-11,9,0
400741,4,16,17,-1,8,1
105818,2,6,3,3,14,1
414808,1,7,0,7,15,0
182480,2,14,0,14,14,1
1103,3,10,36,-26,1,0
204867,2,3,3,0,6,0
75690,1,7,0,7,1,1
95843,3,6,10,-4,10,1
192098,1,0,3,-3,1,1
36569,4,23,37,-14,17,1
356986,3,20,3,17,5,1
107758,2,7,13,-6,15,0
104280,2,17,7,10,13,1
380264,4,29,16,13,16,0
51058,3,3,20,-17,6,0
419846,2,0,6,-6,17,1
2698,3,6,7,-1,2,1
186676,4,27,3,24,15,0
124046,1,0,6,-6,5,0
305986,2,3,3,0,17,1
246888,1,0,7,-7,8,1
45651,4,13,13,0,4,0
414981,2,10,7,3,15,0
40435,2,7,14,-7,2,1
224680,4,19,10,9,15,0
150544,1,0,3,-3,17,1
413877,3,17,6,11,14,0
302365,3,10,13,-3,15,0
296229,4,22,26,-4,13,1
160174,2,27,7,20,3,0
210693,1,0,0,0,9,1
42296,1,0,2,-2,2,0
302420,1,0,0,0,15,0
149220,2,7,0,7,16,0
21101,2,0,0,0,10,0
29834,2,6,10,-4,14,1
401847,3,7,21,-14,9,0
238674,3,16,14,2,4,0
420250,1,0,0,0,17,1
245423,3,9,6,3,7,1
198093,1,0,0,0,3,0
6395,3,3,13,-10,3,0
21156,3,0,16,-16,10,1
408292,2,0,0,0,12,1
338197,2,14,21,-7,14,0
335121,2,9,0,9,13,1
6543,3,3,3,0,3,0
345048,1,0,0,0,17,0
296356,4,13,25,-12,13,1
280781,4,14,14,0,5,0
267473,1,0,7,-7,17,0
152067,3,3,7,-4,17,1
65625,3,6,16,-10,13,0
207402,1,7,0,7,7,1
221313,4,6,32,-26,14,0
69870,3,24,9,15,15,0
354622,2,3,7,-4,4,1
24807,2,6,3,3,12,1
67800,4,31,0,31,14,0
196267,3,21,10,11,2,0
370791,4,19,17,2,12,1
55783,1,0,0,0,9,0
208816,4,6,22,-16,8,1
138453,2,14,14,0,12,1
340472,2,0,13,-13,15,0
274684,2,7,9,-2,3,1
70817,1,0,0,0,15,1
321314,3,12,19,-7,6,1
130871,4,20,15,5,8,0
142293,2,0,0,0,13,1
392116,1,0,6,-6,4,1
267402,3,3,10,-7,17,0
255131,1,0,0,0,12,0
130916,1,0,14,-14,8,1
386653,3,7,13,-6,2,0
97703,3,9,10,-1,11,1
397238,4,16,0,16,6,0
314205,3,14,20,-6,3,0
21996,2,7,10,-3,11,0
301949,4,17,20,-3,15,0
289563,1,7,6,1,10,0
107890,2,0,3,-3,15,1
119034,4,7,33,-26,3,1
394215,4,33,17,16,5,0
310743,2,3,3,0,2,1
369679,2,16,7,9,11,0
98267,2,14,24,-10,11,0
256497,4,19,31,-12,12,0
168547,2,7,10,-3,7,1
314681,4,14,21,-7,3,1
147176,4,17,49,-32,15,0
102709,1,0,0,0,13,1
83579,3,0,17,-17,4,0
94888,4,13,13,0,9,0
249556,3,14,10,4,9,1
349232,1,0,7,-7,2,0
130513,3,10,6,4,8,1
145579,2,21,0,21,14,0
273052,4,9,3,6,2,1
205789,2,7,0,7,7,0
39896,3,6,10,-4,1,0
270566,3,13,14,-1,1,1
153410,2,13,10,3,1,0
65477,3,23,14,9,13,0
118504,1,14,0,14,2,1
365902,3,14,21,-7,9,1
96864,2,10,0,10,10,0
167055,3,13,17,-4,7,0
170312,3,0,12,-12,8,0
92908,4,34,7,27,8,0
345052,1,0,0,0,17,1
406131,4,3,26,-23,11,0
38641,2,0,0,0,1,0
42709,4,7,19,-12,3,0
350284,2,14,0,14,2,0
340704,4,22,20,2,15,0
380844,4,9,24,-15,16,0
315916,1,0,0,0,4,0
258091,2,13,6,7,13,0
338136,4,12,7,5,14,0
96705,2,0,7,-7,10,1
270006,4,19,20,-1,1,1
406795,2,0,17,-17,11,0
125856,1,3,3,0,6,1
85680,3,24,14,10,5,0
157524,1,0,0,0,2,1
84289,2,7,21,-14,4,0
98606,3,7,7,0,11,1
151517,4,35,7,28,17,1
99914,2,3,3,0,12,0
209340,2,7,7,0,8,1
31231,4,26,34,-8,15,0
44654,4,23,24,-1,3,0
173046,3,24,6,18,9,1
208396,4,17,43,-26,8,1
91248,1,0,0,0,8,1
377807,1,7,0,7,15,0
417686,3,28,12,16,16,1
181781,4,7,17,-10,13,1
249291,4,33,17,16,9,1
124066,2,0,14,-14,5,1
75966,1,0,0,0,1,0
65272,2,0,14,-14,13,1
236868,1,0,0,0,3,1
47829,2,7,6,1,5,1
118937,1,0,10,-10,3,0
93359,4,30,6,24,9,0
174653,2,6,0,6,10,0
141928,1,7,0,7,13,1
47310,2,0,7,-7,5,1
235473,4,28,39,-11,3,0
53869,2,7,7,0,8,1
148623,3,7,9,-2,16,0
85356,3,28,3,25,5,0
8764,2,6,0,6,4,0
338650,2,6,0,6,14,1
275432,2,13,10,3,3,1
288466,1,0,0,0,9,0
226516,4,14,20,-6,16,1
37383,3,23,0,23,17,1
228898,1,0,0,0,17,1
26468,4,27,19,8,13,1
211356,3,10,10,0,9,0
323144,1,0,0,0,7,1
358224,1,0,7,-7,6,1
167853,2,7,13,-6,7,0
207016,2,28,0,28,7,0
187531,2,6,13,-7,16,1
98825,1,7,0,7,11,0
394272,1,0,0,0,5,1
69830,2,14,3,11,15,1
95977,2,0,0,0,10,0
401789,1,7,0,7,9,0
154894,2,13,3,10,1,0
117415,4,34,17,17,2,0
380631,2,7,7,0,16,0
37164,1,0,0,0,17,1
146945,1,13,0,13,15,1
285067,2,0,0,0,7,1
149303,4,19,27,-8,16,1
255156,1,0,0,0,12,1
193798,1,0,0,0,1,1
210290,2,6,7,-1,9,1
268327,3,20,3,17,17,1
103762,1,0,0,0,13,1
375054,4,28,27,1,14,0
367540,2,14,6,8,10,1
308414,3,0,18,-18,1,1
82637,3,12,10,2,3,1
376928,1,3,3,0,15,0
119859,4,24,24,0,3,0
227167,3,10,7,3,16,1
308402,3,0,18,-18,1,1
28485,1,17,0,17,14,0
166681,1,0,0,0,6,1
230896,3,21,10,11,1,0
50509,1,0,0,0,6,0
49643,2,0,7,-7,6,1
288850,2,10,17,-7,9,0
79865,2,3,13,-10,2,1
8793,3,6,0,6,4,1
288859,3,10,24,-14,9,1
242899,3,21,13,8,6,0
31628,3,24,6,18,15,0
61041,4,34,19,15,11,1
120706,2,16,0,16,3,1
367860,3,20,10,10,10,0
18224,1,0,0,0,9,0
383660,2,6,14,-8,17,1
3582,2,14,14,0,2,0
351109,4,37,30,7,3,0
188851,2,3,0,3,16,0
95033,4,20,16,4,9,1
157839,1,6,9,-3,3,0
43750,1,13,0,13,3,1
370795,4,19,17,2,12,1
107853,4,23,30,-7,15,1
368161,3,13,21,-8,11,1
169064,3,33,14,19,7,0
75,2,7,7,0,1,1
275128,2,7,10,-3,3,1
286616,4,17,38,-21,8,0
99119,4,23,7,16,11,1
319622,2,16,3,13,6,1
70851,2,7,10,-3,15,0
238934,2,14,3,11,4,0
201489,3,19,7,12,5,1
156803,2,20,20,0,2,1
246536,4,22,7,15,8,1
269930,2,7,10,-3,1,1
341080,3,7,17,-10,15,0
24250,3,13,17,-4,12,0
64800,4,31,7,24,13,0
100338,2,9,17,-8,12,0
59333,2,0,6,-6,11,1
79576,2,7,0,7,2,1
365544,1,14,7,7,9,0
361342,2,0,0,0,7,1
230734,3,9,27,-18,1,0
406721,4,34,0,34,11,0
107392,4,19,12,7,15,0
385556,2,0,10,-10,1,0
408468,2,7,3,4,12,1
117372,3,34,3,31,2,0
389558,4,27,17,10,3,0
292442,2,3,3,0,11,0
220168,4,29,13,16,13,1
50679,1,0,7,-7,6,1
258453,4,21,13,8,13,0
303816,4,20,17,3,16,1
345876,2,3,14,-11,17,0
280799,1,0,0,0,6,1
103041,2,7,0,7,13,0
280259,2,6,13,-7,5,0
214646,4,3,16,-13,11,1
215703,1,3,0,3,11,0
119765,2,10,6,4,3,1
366991,2,0,30,-30,10,0
191699,2,10,17,-7,17,0
51347,3,19,20,-1,7,0
297682,2,10,6,4,13,0
274360,2,3,7,-4,3,0
331714,2,3,13,-10,12,0
173977,4,23,19,4,10,1
69882,3,24,16,8,15,1
81265,3,10,7,3,3,0
302647,2,17,6,11,15,1
378355,4,12,13,-1,15,0
227459,3,13,10,3,16,0
284967,3,13,20,-7,7,1
767,2,0,0,0,1,0
186026,2,17,34,-17,15,0
136945,4,3,13,-10,11,1
86139,3,28,3,25,5,0
152828,4,21,10,11,17,0
360137,2,10,3,7,7,0
65362,4,13,28,-15,13,1
94453,1,0,0,0,9,1
288403,3,10,0,10,9,1
226539,1,0,0,0,16,1
349841,1,0,3,-3,2,1
294350,2,10,3,7,12,1
399584,1,0,0,0,8,1
367702,2,3,6,-3,10,0
33515,2,17,0,17,16,0
417775,1,0,0,0,16,1
173312,2,14,17,-3,10,0
256576,2,7,0,7,12,1
17757,1,0,0,0,9,1
372281,2,10,7,3,13,1
295468,4,17,22,-5,12,0
157004,4,13,13,0,2,1
347327,4,7,21,-14,1,0
290723,4,44,25,19,10,1
317695,4,23,9,14,5,0
264328,4,17,36,-19,15,0
233658,1,0,0,0,2,1
302841,4,12,23,-11,15,1
102013,2,7,3,4,12,0
15355,3,10,6,4,8,1
235215,1,12,0,12,3,0
241790,1,0,3,-3,5,0
261519,2,9,0,9,14,1
263136,2,0,7,-7,15,1
319652,3,24,3,21,6,0
218211,4,30,3,27,12,1
375836,4,20,7,13,14,0
301239,4,27,17,10,15,0
150388,4,33,14,19,16,1
92797,4,12,26,-14,8,1
207177,3,14,13,1,7,0
256723,2,0,6,-6,12,1
129566,3,6,17,-11,7,1
315829,3,3,19,-16,4,0
273464,2,7,10,-3,2,1
291921,4,24,10,14,11,0
389916,2,15,10,5,3,0
199060,2,0,14,-14,4,1
209885,3,16,16,0,8,1
63950,4,6,27,-21,12,0
102040,2,21,3,18,12,0
47873,4,21,13,8,5,0
45321,3,17,13,4,4,0
52687,3,3,13,-10,7,0
75773,3,35,26,9,1,0
268864,2,0,10,-10,17,1
322776,2,3,20,-17,7,1
41378,4,14,12,2,2,0
253329,1,0,0,0,11,1
229640,4,46,13,33,17,1
22091,5,27,24,3,11,1
24681,2,20,7,13,12,0
323683,3,20,0,20,8,0
175721,3,30,6,24,11,0
227042,3,10,6,4,16,1
155889,4,14,13,1,2,1
387272,3,6,10,-4,2,0
129074,2,17,21,-4,7,0
251888,3,14,13,1,10,1
413580,3,9,17,-8,14,0
126276,4,35,9,26,6,1
48483,4,27,34,-7,5,1
72046,2,7,10,-3,16,0
113347,4,26,38,-12,17,1
161548,1,3,3,0,4,0
227642,4,35,0,35,16,0
12104,2,7,7,0,6,1
88168,2,14,10,4,6,0
416806,3,13,10,3,15,0
116241,1,3,0,3,1,1
232768,2,7,0,7,2,0
241610,4,6,27,-21,5,1
124763,4,3,9,-6,5,1
298256,3,20,13,7,14,1
115633,1,0,0,0,1,0
124271,2,24,17,7,5,1
362312,1,0,7,-7,8,1
159560,3,17,6,11,3,0
348679,2,9,10,-1,2,1
253268,3,3,13,-10,11,0
90658,4,27,33,-6,7,0
341932,1,0,0,0,16,1
359507,3,0,21,-21,6,1
164260,4,48,41,7,5,0
343222,3,16,0,16,16,0
138185,2,7,9,-2,11,1
53917,3,14,13,1,8,0
150597,3,3,13,-10,17,0
178805,2,24,14,10,12,1
207065,4,38,3,35,7,0
251107,3,10,14,-4,10,0
276556,4,22,7,15,4,0
126743,4,13,13,0,6,0
347378,5,21,21,0,1,1
249572,3,20,13,7,9,1
155052,2,6,18,-12,1,0
251754,4,30,9,21,10,0
165896,4,6,19,-13,6,0
242036,3,7,3,4,5,1
275444,2,20,10,10,3,0
294054,2,7,14,-7,12,0
3588,2,20,14,6,2,0
362117,4,35,20,15,8,0
74007,4,37,0,37,17,1
34327,4,23,9,14,16,0
250200,3,17,16,1,9,1
133444,2,14,14,0,9,0
33308,4,30,3,27,16,0
417833,2,10,0,10,16,0
91823,3,24,0,24,8,1
185012,4,14,29,-15,15,0
297679,2,7,6,1,13,1
388217,4,6,13,-7,2,1
105008,1,0,0,0,14,0
18301,3,13,17,-4,9,1
242683,4,16,10,6,6,0
72830,4,31,17,14,16,1
282957,2,13,3,10,6,1
386502,2,7,7,0,2,0
87782,1,0,0,0,6,1
25705,3,14,10,4,12,0
37963,4,10,14,-4,1,1
314022,2,3,0,3,3,1
97138,4,34,6,28,10,0
336558,2,0,0,0,14,1
331303,3,0,17,-17,11,0
294899,1,0,6,-6,12,0
371863,2,21,10,11,12,1
297764,1,7,0,7,13,0
153163,4,20,17,3,1,1
415298,2,0,14,-14,15,0
348290,4,16,46,-30,1,0
370626,3,14,14,0,12,0
61246,2,21,7,14,11,0
334206,1,0,0,0,13,1
351020,2,7,7,0,3,0
301510,3,20,15,5,15,1
58865,2,3,9,-6,10,1
264571,3,10,17,-7,16,0
319,1,14,0,14,1,0
166926,3,13,6,7,6,1
272029,2,7,3,4,2,0
27941,3,14,10,4,13,0
161200,1,0,0,0,4,0
239782,4,20,20,0,4,1
164605,2,7,16,-9,5,0
136777,3,13,10,3,11,1
326165,2,7,7,0,9,0
257001,1,0,7,-7,12,1
295586,4,23,31,-8,12,0
173668,4,13,22,-9,10,1
377661,2,16,7,9,15,0
79608,3,14,7,7,2,0
208711,1,0,0,0,8,1
405843,5,24,24,0,10,0
385330,4,14,20,-6,1,1
377240,2,7,3,4,15,1
268150,2,6,14,-8,17,1
92709,2,3,10,-7,8,0
282971,2,14,3,11,6,1
142783,3,12,10,2,13,0
353154,4,13,29,-16,3,1
222990,4,13,13,0,14,0
313130,2,7,10,-3,3,1
148759,2,13,6,7,16,1
100612,2,0,7,-7,12,1
135169,1,6,0,6,10,1
255967,3,6,12,-6,12,1
418074,5,35,41,-6,16,0
35537,4,30,7,23,17,1
332026,3,3,3,0,12,1
22570,2,6,3,3,11,1
235802,1,0,0,0,3,0
216390,4,14,23,-9,12,1
141412,4,10,20,-10,13,1
26680,1,0,7,-7,13,1
309938,1,0,0,0,2,0
116721,2,6,17,-11,2,1
382894,1,0,7,-7,17,1
388755,2,11,0,11,3,1
340601,1,6,0,6,15,0
330146,4,0,16,-16,11,1
2392,2,14,10,4,2,0
210181,3,7,14,-7,9,0
332433,2,10,3,7,12,1
417167,2,3,10,-7,16,0
276339,2,14,21,-7,3,1
235077,2,0,7,-7,2,0
126068,3,14,3,11,6,0
83679,2,22,16,6,4,0
153673,1,2,7,-5,1,1
272686,2,9,3,6,2,0
341445,1,0,0,0,16,1
282368,2,7,13,-6,6,0
134649,4,31,24,7,10,1
227896,2,20,6,14,16,0
92567,3,17,3,14,8,1
218276,2,7,7,0,12,1
50452,3,10,10,0,6,1
306652,4,14,27,-13,17,1
251589,4,19,20,-1,10,0
124806,1,0,3,-3,5,0
201961,2,0,0,0,5,1
136770,3,13,10,3,11,1
200651,4,33,28,5,4,1
71661,4,3,34,-31,16,1
134709,1,0,0,0,10,1
101876,2,3,10,-7,12,1
261786,1,0,0,0,14,0
254610,3,14,14,0,11,1
345443,3,3,19,-16,17,0
77349,2,7,7,0,1,1
52255,4,17,19,-2,7,0
210266,1,3,0,3,9,0
299585,3,13,3,10,14,0
188091,2,0,3,-3,16,0
16342,2,7,7,0,8,1
308958,2,0,3,-3,1,1
269700,4,10,12,-2,1,0
228727,4,26,30,-4,17,0
347346,4,7,21,-14,1,1
200400,2,10,6,4,4,0
70108,1,9,0,9,15,1
154461,3,14,7,7,1,1
244396,3,0,17,-17,7,1
258494,4,30,21,9,13,1
17152,4,30,17,13,9,1
57688,4,24,17,7,10,0
393734,3,7,7,0,5,0
3120,2,0,6,-6,2,1
366755,4,27,10,17,10,0
8131,4,27,20,7,4,0
116846,2,7,7,0,2,1
186882,1,7,0,7,15,0
336409,2,3,3,0,14,1
352294,4,6,6,0,3,1
413227,2,7,0,7,14,1
217374,4,21,10,11,12,0
166231,1,0,0,0,6,0
142053,4,23,14,9,13,1
146458,1,0,0,0,15,0
41745,2,0,7,-7,2,1
175611,4,36,14,22,11,0
9053,3,21,13,8,4,1
305268,3,28,21,7,16,0
229234,2,10,7,3,17,0
415593,3,14,10,4,15,0
128891,1,0,3,-3,7,1
349739,3,20,7,13,2,0
360574,2,7,10,-3,7,0
282476,2,7,0,7,6,0
340443,1,0,3,-3,15,0
38378,2,14,9,5,1,0
194496,4,23,10,13,2,1
123082,4,14,21,-7,4,1
173957,4,20,19,1,10,1
206104,3,20,6,14,7,0
158754,2,0,3,-3,3,0
317586,1,3,0,3,5,0
266889,1,0,0,0,17,0
63165,2,14,10,4,12,0
60072,2,7,3,4,11,0
295406,3,10,10,0,12,0
389295,1,0,0,0,3,0
326247,3,10,48,-38,9,0
255610,1,0,7,-7,12,0
197645,4,33,7,26,3,1
11494,2,6,7,-1,6,0
132034,4,3,24,-21,8,1
14212,4,0,31,-31,7,0
210448,2,9,14,-5,9,1
142916,2,3,10,-7,13,0
238606,1,6,0,6,4,1
99803,3,0,21,-21,12,0
262349,4,13,16,-3,15,1
357440,4,31,30,1,5,1
191171,1,0,0,0,17,0
24459,4,16,7,9,12,1
363885,4,20,29,-9,8,0
113280,2,10,21,-11,17,1
188970,1,0,0,0,16,0
20083,4,22,16,6,10,1
133583,2,3,7,-4,9,1
68168,1,7,7,0,14,1
60806,2,10,10,0,11,0
134807,3,47,17,30,10,1
194016,2,14,7,7,1,0
149533,2,14,9,5,16,0
107115,4,40,6,34,15,1
253228,2,0,7,-7,11,1
248265,1,7,0,7,8,0
163612,3,14,19,-5,5,1
230581,3,13,17,-4,1,1
216857,3,10,14,-4,12,1
163829,4,17,25,-8,5,1
86874,3,9,23,-14,5,1
207218,4,17,20,-3,7,1
67080,4,10,9,1,14,0
240325,3,7,23,-16,5,1
155486,1,7,0,7,2,1
396998,2,14,3,11,6,0
303405,1,10,0,10,16,1
261290,4,38,0,38,14,0
220262,2,20,9,11,13,1
246616,2,14,3,11,8,1
279784,1,7,3,4,5,0
176063,4,24,6,18,11,0
209102,3,3,27,-24,8,1
106666,4,46,16,30,14,1
257388,3,20,7,13,13,1
10485,2,6,0,6,5,1
167189,2,23,7,16,7,0
55649,1,10,13,-3,9,0
286219,1,0,6,-6,8,1
189077,4,21,30,-9,16,1
378337,4,12,6,6,15,0
247021,4,20,31,-11,8,0
288986,2,16,7,9,9,1
240218,4,16,6,10,5,0
142684,4,20,20,0,13,0
196549,3,17,6,11,2,0
185807,4,25,3,22,15,1
418980,2,7,7,0,16,0
380702,4,7,7,0,16,0
312902,4,21,21,0,3,0
261059,2,0,14,-14,14,1
16365,2,21,7,14,8,0
254311,3,6,19,-13,11,1
22960,4,3,26,-23,11,0
319674,3,26,3,23,6,1
353435,3,25,3,22,4,1
389364,3,23,13,10,3,1
234269,1,0,0,0,2,1
127002,3,24,13,11,6,0
409412,3,20,3,17,12,1
78848,2,7,0,7,2,1
272480,1,0,0,0,2,0
374842,2,7,3,4,14,1
138268,1,3,0,3,11,0
48067,1,0,0,0,5,1
394236,4,40,25,15,5,0
326717,1,0,0,0,9,0
339164,4,23,13,10,15,1
384083,1,0,7,-7,1,0
79400,1,3,0,3,2,1
334985,2,10,7,3,13,0
103897,1,0,0,0,13,1
55044,1,7,0,7,8,1
194643,3,24,7,17,2,0
324172,4,3,17,-14,8,1
302979,3,20,16,4,16,1
303761,3,17,10,7,16,1
372571,1,7,0,7,13,1
276972,3,17,20,-3,4,0
338713,4,27,16,11,14,0
339632,4,31,17,14,15,0
222230,4,13,17,-4,14,0
248245,1,0,0,0,8,0
291414,2,7,10,-3,10,1
284622,2,14,16,-2,7,0
162082,3,28,13,15,4,1
151718,1,7,0,7,17,0
67364,3,27,6,21,14,1
189019,2,7,7,0,16,0
273269,1,7,0,7,2,1
232258,4,18,12,6,1,0
89013,1,0,0,0,6,0
226828,1,0,0,0,16,1
263400,1,0,0,0,15,1
316892,2,9,2,7,4,0
386419,4,23,17,6,2,1
124570,3,6,7,-1,5,0
100617,2,0,7,-7,12,1
74649,2,0,3,-3,17,0
60636,2,0,3,-3,11,1
91207,4,10,17,-7,8,1
145991,4,13,21,-8,15,1
377511,1,0,0,0,15,0
42803,3,6,28,-22,3,1
354709,4,17,17,0,4,0
272398,2,24,0,24,2,0
360582,2,7,10,-3,7,0
344896,1,0,7,-7,17,1
118508,2,14,0,14,2,1
358003,3,24,13,11,6,1
309257,2,0,7,-7,1,0
233178,4,29,10,19,2,1
247396,2,3,6,-3,8,0
79672,1,0,0,0,2,0
263051,3,10,3,7,15,0
47225,4,12,9,3,5,0
371992,2,10,0,10,13,0
61196,1,0,0,0,11,0
142381,4,7,6,1,13,1
228006,1,0,0,0,17,1
201054,3,41,0,41,5,0
174462,1,7,0,7,10,0
393329,1,6,0,6,5,1
160549,4,23,14,9,4,1
249905,3,12,20,-8,9,1
244896,1,0,0,0,7,1
43155,1,0,0,0,3,1
342007,3,20,3,17,16,0
55499,1,10,0,10,9,1
344889,1,0,6,-6,17,0
281611,2,21,0,21,6,0
361373,3,10,7,3,7,0
132090,1,7,0,7,9,1
107507,4,3,23,-20,15,1
157327,4,19,9,10,2,0
367231,1,0,0,0,10,1
257430,4,23,14,9,13,0
332080,4,10,9,1,12,1
263596,2,7,7,0,15,1
389399,4,30,19,11,3,0
190601,1,0,0,0,17,1
186209,4,23,13,10,15,0
16261,3,6,16,-10,8,1
190579,4,20,20,0,17,0
372028,3,13,3,10,13,1
91042,3,6,0,6,7,1
354914,1,0,0,0,4,1
99559,1,0,0,0,11,0
208450,2,10,0,10,8,0
199830,2,3,17,-14,4,1
100120,4,16,6,10,12,0
347488,3,12,16,-4,1,0
263516,4,20,23,-3,15,0
279429,4,16,24,-8,5,1
209252,4,27,7,20,8,0
213289,4,17,27,-10,10,1
13404,1,3,7,-4,7,0
243536,1,3,0,3,6,0
59075,3,3,17,-14,10,1
176249,4,14,27,-13,11,1
239514,1,3,0,3,4,0
42146,5,27,27,0,2,0
41149,1,0,7,-7,2,0
113959,4,20,13,7,17,1
254400,1,7,0,7,11,1
10029,1,14,0,14,5,1
410272,2,7,13,-6,13,1
80623,2,7,10,-3,3,0
411004,2,13,7,6,13,1
128893,1,0,3,-3,7,1
126882,3,17,6,11,6,1
393429,3,28,24,4,5,1
80876,1,0,0,0,3,1
315172,2,7,7,0,4,0
345787,4,22,10,12,17,0
216206,3,14,3,11,12,1
60005,4,3,31,-28,11,0
215643,3,14,6,8,11,0
93302,2,21,3,18,9,0
269579,4,24,31,-7,1,0
110867,1,7,0,7,16,1
43413,4,21,24,-3,3,1
107138,1,0,0,0,15,0
9044,2,21,13,8,4,0
337039,3,16,0,16,14,1
175172,4,42,17,25,10,0
90670,4,27,33,-6,7,1
194968,4,14,22,-8,2,1
152420,4,38,3,35,17,0
80828,3,3,3,0,3,1
233741,2,13,24,-11,2,0
158349,3,13,17,-4,3,1
263485,3,13,16,-3,15,1
417635,2,14,3,11,16,1
368659,1,0,9,-9,11,0
196176,1,0,0,0,2,1
321303,3,12,19,-7,6,0
17445,4,17,7,10,9,0
107704,1,0,0,0,15,0
166380,1,3,0,3,6,0
146259,3,3,30,-27,15,1
34219,1,10,0,10,16,0
386368,3,17,6,11,2,1
316495,4,22,23,-1,4,0
221757,3,10,14,-4,14,1
82329,3,6,10,-4,3,1
234695,4,30,23,7,2,1
419390,1,0,0,0,16,0
387017,4,14,28,-14,2,0
65746,3,14,16,-2,13,1
132720,3,10,17,-7,9,0
185706,2,16,3,13,15,1
126460,1,0,3,-3,6,0
378454,3,17,0,17,15,0
260996,4,10,3,7,14,1
212893,2,0,7,-7,10,1
20022,3,19,6,13,10,0
61897,4,27,23,4,12,0
257919,1,0,0,0,13,0
210324,3,16,10,6,9,0
246372,4,20,10,10,7,1
261528,2,12,0,12,14,0
101044,1,0,0,0,12,0
297108,3,24,0,24,13,1
174910,1,0,0,0,10,1
418572,2,14,3,11,16,1
319941,2,23,10,13,6,1
404025,2,3,21,-18,10,1
184920,2,0,7,-7,15,0
46217,3,14,21,-7,4,0
365429,2,7,12,-5,9,0
265532,4,14,13,1,16,1
142337,3,0,3,-3,13,1
59653,3,21,6,15,11,0
244797,2,7,0,7,7,0
120873,3,14,17,-3,3,0
61091,2,0,0,0,11,0
99064,3,16,0,16,11,1
239753,4,13,13,0,4,1
222071,3,20,10,10,14,1
16216,2,3,0,3,8,1
2847,3,31,24,7,2,0
18988,2,0,0,0,10,1
328379,4,3,47,-44,10,1
80480,2,5,3,2,3,1
118668,2,14,6,8,2,0
185080,2,0,10,-10,15,1
272173,1,0,0,0,2,1
420556,4,10,42,-32,17,1
29252,2,14,0,14,14,1
296810,3,7,7,0,13,1
119528,1,0,0,0,3,1
376399,3,9,6,3,14,0
142022,4,20,14,6,13,1
383209,1,14,3,11,17,1
238374,3,10,23,-13,4,1
28419,4,13,6,7,14,1
265216,2,6,6,0,16,1
12010,4,24,14,10,6,0
220458,4,26,21,5,13,0
69223,1,0,0,0,15,1
76776,2,24,0,24,1,1
237598,4,38,28,10,3,1
302703,4,23,20,3,15,0
156208,4,16,10,6,2,1
73824,3,13,0,13,17,0
88337,3,14,7,7,6,0
56827,5,20,20,0,9,0
236525,3,10,9,1,3,1
122457,3,13,26,-13,4,1
225132,1,0,0,0,15,0
122792,1,0,0,0,4,1
344361,2,14,7,7,17,1
321898,3,14,21,-7,7,1
357871,3,13,31,-18,6,0
242728,2,7,7,0,6,0
122743,3,10,17,-7,4,1
61142,3,0,7,-7,11,1
173610,2,0,13,-13,10,1
417608,2,14,0,14,16,0
200698,1,7,0,7,4,0
3698,1,3,0,3,2,1
416593,2,7,0,7,15,0
218620,3,10,29,-19,13,0
405232,2,7,7,0,10,1
256131,3,14,16,-2,12,1
30509,4,38,43,-5,14,0
394327,3,24,10,14,5,0
114740,4,15,17,-2,1,0
146514,2,7,7,0,15,0
353488,1,0,0,0,4,1
31424,1,3,0,3,15,0
84988,2,16,7,9,4,1
333793,2,6,14,-8,12,1
182227,4,33,7,26,13,1
19084,4,10,6,4,10,0
288448,4,19,7,12,9,0
233044,4,24,17,7,2,0
301793,3,3,27,-24,15,0
193773,4,10,27,-17,1,1
392940,2,6,3,3,4,0
199194,1,7,7,0,4,1
80996,4,20,17,3,3,1
331982,2,0,0,0,12,0
222730,1,3,0,3,14,1
332086,4,17,9,8,12,0
298658,2,6,0,6,14,0
226436,2,0,7,-7,16,1
254746,2,3,3,0,11,0
29523,1,0,7,-7,14,1
140726,2,12,14,-2,12,0
98572,2,6,7,-1,11,1
255445,1,0,0,0,12,1
367492,4,36,31,5,10,0
145830,4,13,33,-20,15,0
251824,2,7,7,0,10,0
92032,4,27,26,1,8,1
121811,2,0,7,-7,4,0
28187,2,3,0,3,13,1
182533,4,35,21,14,14,1
13518,4,6,41,-35,7,1
33289,4,23,3,20,16,1
369363,1,0,0,0,11,1
115950,1,0,0,0,1,1
208322,2,7,24,-17,8,1
392198,3,10,13,-3,4,0
9958,4,3,3,0,5,0
359142,2,7,0,7,6,0
169626,2,13,0,13,8,0
212505,4,13,13,0,10,0
7769,3,30,3,27,4,1
126342,2,7,14,-7,6,0
386608,1,0,7,-7,2,1
62906,4,10,10,0,12,1
185157,4,0,23,-23,15,1
154336,3,27,17,10,1,0
338617,1,3,0,3,14,0
172732,3,14,10,4,9,1
409965,2,6,21,-15,12,0
206399,2,10,0,10,7,0
181615,4,23,6,17,13,1
151805,3,21,16,5,17,0
119097,2,7,7,0,3,0
398828,4,21,24,-3,7,0
147144,3,17,46,-29,15,1
171712,1,0,0,0,9,0
71924,3,15,13,2,16,0
17066,2,13,3,10,9,0
150474,3,27,6,21,16,1
277427,4,34,9,25,4,0
393740,3,7,7,0,5,1
271887,2,7,10,-3,2,0
160500,3,20,7,13,4,0
291717,2,0,6,-6,11,0
398908,3,10,10,0,7,1
237023,1,0,7,-7,3,0
315873,4,9,19,-10,4,1
240084,1,0,0,0,5,0
402591,3,10,16,-6,9,1
208739,2,0,6,-6,8,1
359638,3,27,7,20,6,1
81619,4,30,31,-1,3,1
147620,4,15,0,15,15,0
334675,2,15,3,12,13,0
380354,2,10,7,3,16,0
70955,4,15,39,-24,15,0
377,2,28,10,18,1,1
325217,4,13,26,-13,8,1
172304,5,24,23,1,9,1
136469,3,17,13,4,11,0
118568,3,17,3,14,2,1
187098,3,10,0,10,16,1
46684,4,17,3,14,4,1
199141,4,14,38,-24,4,1
294679,3,6,14,-8,12,1
212607,2,7,17,-10,10,0
90983,1,3,0,3,7,0
81701,2,14,17,-3,3,1
249111,4,21,20,1,9,1
409716,3,10,6,4,12,0
240745,2,7,7,0,5,0
99063,3,16,0,16,11,1
400497,2,7,3,4,8,0
45768,3,10,14,-4,4,1
183269,3,13,20,-7,14,0
26374,1,7,0,7,13,0
279673,2,23,0,23,5,0
294128,4,14,27,-13,12,1
168340,4,24,24,0,7,0
372401,1,6,0,6,13,0
407861,2,3,7,-4,11,1
102532,4,31,10,21,13,0
167535,3,0,10,-10,7,0
35471,2,14,7,7,17,0
411186,3,0,23,-23,13,1
68446,1,0,0,0,14,0
196048,1,3,14,-11,2,0
268684,1,0,0,0,17,1
33443,4,20,20,0,16,1
279330,1,0,0,0,5,0
63915,3,6,21,-15,12,0
95071,1,0,7,-7,9,0
44191,4,13,27,-14,3,0
174546,3,10,14,-4,10,1
90379,1,0,0,0,7,0
139322,4,20,13,7,12,1
376208,2,10,7,3,14,1
299604,4,13,10,3,14,0
308423,3,7,18,-11,1,0
358734,3,14,14,0,6,0
260994,4,10,3,7,14,1
366594,4,20,14,6,10,1
366593,4,20,14,6,10,1
110043,4,48,10,38,16,0
210059,4,17,17,0,8,0
39453,3,13,10,3,1,0
338480,2,14,0,14,14,0
