,qtr,cur_home_score,cur_away_score,score_differential,week,home_possession
152287,4,28,0,28,17,1
18624,4,17,17,0,9,1
398606,2,0,0,0,7,1
101947,4,9,13,-4,12,1
117692,4,27,13,14,2,0
179338,1,0,0,0,12,1
275388,1,0,0,0,3,0
108694,3,27,13,14,15,0
96708,2,0,7,-7,10,1
113742,2,3,10,-7,17,0
93162,2,0,3,-3,9,1
420665,3,21,16,5,17,0
240194,4,16,6,10,5,0
66570,1,0,13,-13,14,0
267808,2,10,14,-4,17,1
385440,3,27,10,17,1,1
134779,3,27,10,17,10,1
128083,3,3,6,-3,7,0
5520,2,10,10,0,3,1
405606,3,20,20,0,10,1
394837,1,0,7,-7,5,1
330861,3,13,17,-4,11,1
364622,4,21,37,-16,9,1
308868,3,10,13,-3,1,0
140903,3,17,10,7,13,1
22093,1,0,0,0,11,0
30826,1,0,14,-14,15,1
55784,2,0,0,0,9,0
13236,1,0,0,0,7,1
347260,2,0,7,-7,1,1
231402,1,0,0,0,1,0
32167,1,7,0,7,15,1
189816,3,17,17,0,17,1
85192,3,7,10,-3,4,1
259553,1,0,0,0,13,1
394736,2,14,0,14,5,1
276332,2,14,21,-7,3,1
125646,3,14,24,-10,5,1
337262,4,16,26,-10,14,1
4025,1,7,7,0,2,1
9184,2,3,16,-13,5,0
397117,1,3,0,3,6,0
52329,2,3,3,0,7,1
172117,4,13,12,1,9,0
231469,3,10,12,-2,1,1
295174,4,10,21,-11,12,1
231096,1,0,0,0,1,1
102775,2,10,3,7,13,0
94890,5,13,13,0,9,0
226895,3,3,10,-7,16,0
88250,1,0,0,0,6,1
286926,4,23,13,10,8,0
108577,4,17,14,3,15,1
168928,4,24,12,12,7,0
154831,1,0,0,0,1,0
286529,2,3,14,-11,8,1
224026,3,14,6,8,15,1
146490,1,7,0,7,15,1
285451,3,33,8,25,8,1
77951,2,3,10,-7,1,1
236428,1,0,0,0,3,0
60214,2,3,7,-4,11,1
180279,2,6,0,6,13,0
102107,4,42,24,18,12,0
246904,1,7,7,0,8,1
17474,1,7,0,7,9,0
322460,2,12,0,12,7,0
252761,2,3,6,-3,11,1
409289,4,13,16,-3,12,0
44508,4,27,20,7,3,0
288571,3,23,31,-8,9,0
72376,3,10,23,-13,16,1
393836,2,7,17,-10,5,1
76403,4,29,12,17,1,1
113793,4,13,17,-4,17,1
16254,3,6,16,-10,8,1
87044,4,14,22,-8,5,0
240982,4,21,22,-1,5,0
53417,3,3,28,-25,8,1
417529,3,24,28,-4,16,1
12975,1,0,0,0,6,1
137998,2,13,14,-1,11,0
274789,5,24,23,1,3,0
15893,1,3,7,-4,8,0
388390,4,24,20,4,2,0
381593,1,0,0,0,17,1
257008,1,0,7,-7,12,0
95002,4,6,16,-10,9,1
402047,4,3,26,-23,9,1
326504,3,31,9,22,9,1
104748,2,17,13,4,14,0
101289,4,17,14,3,12,1
251207,2,10,10,0,10,0
216594,4,43,18,25,12,0
389447,1,3,0,3,3,0
117283,1,0,0,0,2,0
140777,3,22,21,1,12,1
154896,2,13,9,4,1,0
185163,4,0,23,-23,15,0
384013,3,10,22,-12,1,0
6972,3,0,7,-7,3,1
163360,1,0,0,0,5,1
59008,2,0,10,-10,10,1
5412,4,20,16,4,3,1
64263,1,0,3,-3,13,0
336132,2,10,3,7,13,0
405268,2,14,7,7,10,0
284980,4,16,27,-11,7,1
124260,2,17,17,0,5,1
17631,1,6,3,3,9,1
95946,1,0,0,0,10,0
22169,3,10,15,-5,11,0
201392,4,28,22,6,5,0
136652,4,22,19,3,11,0
379629,4,26,13,13,16,0
25835,2,17,7,10,12,0
278424,1,8,0,8,4,0
51580,2,7,3,4,7,1
203618,2,0,7,-7,6,1
331447,2,6,7,-1,11,1
318380,1,7,0,7,5,0
94153,2,10,7,3,9,0
409573,4,35,11,24,12,0
245236,1,3,0,3,7,0
158118,4,25,9,16,3,1
370752,2,12,10,2,12,1
368919,4,38,9,29,11,0
43220,3,14,10,4,3,1
120520,1,0,0,0,3,0
105855,3,16,10,6,14,0
339792,4,24,13,11,15,0
227888,2,17,6,11,16,1
148452,2,7,3,4,16,0
355049,1,0,0,0,4,1
133408,1,0,7,-7,9,1
116868,2,7,7,0,2,1
1753,4,28,0,28,1,1
367807,2,9,7,2,10,1
302041,2,7,10,-3,15,0
391945,4,30,27,3,4,0
381855,4,18,21,-3,17,1
29703,2,10,0,10,14,0
358232,1,0,7,-7,6,1
385941,3,10,21,-11,1,1
412238,4,21,9,12,13,1
33525,2,17,0,17,16,1
262344,4,13,16,-3,15,1
12152,4,14,21,-7,6,0
363758,4,29,27,2,8,1
88861,4,13,16,-3,6,1
142874,1,0,0,0,13,0
28568,4,33,7,26,14,1
198618,2,0,7,-7,3,0
352861,3,14,10,4,3,0
227777,3,3,14,-11,16,0
116995,1,0,3,-3,2,0
10786,2,14,0,14,5,0
21503,1,0,0,0,11,0
302125,4,34,34,0,15,0
197321,3,17,3,14,3,1
182025,3,14,14,0,13,1
94825,3,6,11,-5,9,0
256764,3,3,13,-10,12,1
76815,3,33,0,33,1,0
103850,3,19,0,19,13,1
254787,3,17,10,7,11,1
155126,4,19,33,-14,1,1
233742,3,13,24,-11,2,0
262354,4,16,16,0,15,0
269578,4,24,31,-7,1,0
368309,4,9,12,-3,11,0
257171,1,0,9,-9,12,0
285382,1,3,0,3,8,1
55512,1,10,0,10,9,1
80873,4,6,13,-7,3,0
232980,3,10,3,7,2,0
191300,4,17,17,0,17,0
31653,4,24,9,15,15,1
91535,4,19,10,9,8,1
42580,4,10,31,-21,3,1
262625,3,26,10,16,15,1
236849,4,6,9,-3,3,0
320465,4,17,17,0,6,1
372753,2,0,0,0,13,1
56276,3,3,17,-14,9,0
254895,2,14,7,7,12,1
181197,1,0,0,0,13,1
77835,3,14,21,-7,1,1
162173,2,7,6,1,4,0
323818,3,13,15,-2,8,1
235723,3,3,20,-17,3,0
271590,2,7,20,-13,2,1
253888,3,38,14,24,11,1
40432,2,7,7,0,2,0
308068,2,0,13,-13,1,0
359937,4,23,30,-7,6,0
245322,4,16,13,3,7,1
285089,2,3,0,3,7,1
370615,3,14,14,0,12,1
353654,1,3,0,3,4,1
126980,2,10,10,0,6,0
249937,4,18,23,-5,9,0
25766,4,17,17,0,12,1
271353,4,16,37,-21,1,0
295868,2,7,14,-7,12,0
232516,3,20,10,10,1,0
299966,1,0,7,-7,14,0
231035,3,24,0,24,1,0
20779,1,7,0,7,10,0
151333,2,13,14,-1,17,0
344859,4,30,10,20,17,1
50000,3,28,10,18,6,1
386568,4,14,31,-17,2,1
47326,2,0,10,-10,5,0
286929,4,23,13,10,8,0
127524,4,3,23,-20,6,1
324079,2,0,7,-7,8,1
211875,4,29,17,12,9,1
21995,2,7,10,-3,11,0
169804,3,3,17,-14,8,1
201159,2,6,21,-15,5,0
421124,3,20,13,7,17,1
80053,3,17,6,11,2,0
76867,1,0,0,0,1,0
190306,4,7,20,-13,17,1
83393,3,10,14,-4,4,0
418053,4,28,35,-7,16,1
91584,1,0,7,-7,8,1
15113,4,10,26,-16,7,1
392870,4,17,23,-6,4,1
227746,2,3,14,-11,16,0
183004,4,10,44,-34,14,0
278789,2,7,7,0,5,1
70971,1,0,0,0,16,0
268252,1,0,0,0,17,1
292446,2,3,3,0,11,0
46607,2,3,0,3,4,0
7471,3,29,6,23,4,1
203123,1,0,7,-7,5,1
22398,1,3,10,-7,11,0
385103,2,0,3,-3,1,0
287749,1,14,3,11,9,1
317442,1,3,0,3,5,0
286488,1,0,0,0,8,1
204260,2,0,7,-7,6,1
405388,1,7,7,0,10,0
125405,1,7,0,7,5,0
257769,1,0,0,0,13,1
136346,4,18,14,4,11,1
66979,1,0,0,0,14,1
324449,4,14,6,8,8,1
377728,3,32,7,25,15,1
251880,3,14,13,1,10,0
44595,3,10,14,-4,3,1
414445,4,13,23,-10,14,1
211479,2,19,7,12,9,1
268715,1,0,3,-3,17,1
162141,1,0,0,0,4,1
257864,3,13,12,1,13,0
135409,3,28,17,11,10,0
108060,2,6,14,-8,15,1
324157,4,3,10,-7,8,1
15796,3,0,12,-12,8,0
159521,2,7,3,4,3,0
29539,1,0,10,-10,14,0
12990,2,0,7,-7,6,0
187670,2,7,3,4,16,1
272999,2,3,3,0,2,0
46872,2,13,3,10,5,0
100686,4,21,21,0,12,0
257829,2,7,3,4,13,0
122732,3,7,17,-10,4,1
401673,2,0,14,-14,8,1
137814,1,0,6,-6,11,1
179789,4,6,24,-18,12,0
125283,2,3,0,3,5,0
371225,4,14,19,-5,12,1
399195,2,10,13,-3,7,1
223713,3,30,13,17,15,1
310646,3,13,30,-17,2,1
113185,3,41,16,25,17,1
255498,2,17,7,10,12,0
395625,2,7,17,-10,6,1
373489,1,0,10,-10,13,0
419062,4,10,20,-10,16,0
322780,2,3,20,-17,7,0
52964,2,14,17,-3,7,1
19855,2,10,14,-4,10,0
77569,4,20,14,6,1,1
245372,2,9,3,6,7,0
335489,4,13,12,1,13,0
305671,2,3,7,-4,17,1
84884,3,27,17,10,4,1
19257,1,7,7,0,10,1
105600,4,32,28,4,14,0
261383,3,10,17,-7,14,0
233937,4,17,13,4,2,1
255589,1,0,0,0,12,1
25551,2,17,7,10,12,0
141043,3,7,10,-3,13,0
217042,4,23,3,20,12,0
167467,2,0,0,0,7,1
414200,1,0,0,0,14,0
28096,3,21,10,11,13,1
309862,3,21,7,14,1,1
344072,1,3,3,0,17,0
408942,3,17,15,2,12,1
70407,1,7,14,-7,15,1
191868,3,20,10,10,1,1
215573,1,7,0,7,11,1
69243,1,3,0,3,15,1
23872,1,0,0,0,12,0
203942,2,3,7,-4,6,1
230246,1,6,7,-1,17,1
109102,2,7,7,0,15,1
204440,3,7,17,-10,6,1
252314,2,0,16,-16,10,0
415479,4,23,3,20,15,1
334771,4,32,11,21,13,0
394704,1,7,0,7,5,0
242924,3,21,16,5,6,1
270063,2,3,10,-7,1,1
204880,2,3,10,-7,6,0
136055,4,6,13,-7,10,0
50940,4,24,27,-3,6,1
129482,5,29,26,3,7,0
253991,2,0,6,-6,11,1
54024,2,3,0,3,8,0
408685,4,34,17,17,12,0
147401,2,14,7,7,15,0
248896,2,14,0,14,9,1
346184,2,17,0,17,1,1
414564,3,21,9,12,14,0
219887,1,0,0,0,13,1
72286,1,0,0,0,16,0
93489,4,3,31,-28,9,1
378200,4,27,16,11,15,1
228826,3,6,17,-11,17,0
275554,1,7,0,7,3,0
227935,3,27,26,1,16,0
366325,4,28,10,18,10,0
371332,3,34,10,24,12,1
361589,1,0,0,0,7,0
45068,4,23,20,3,4,0
280774,4,14,14,0,5,1
376597,4,15,6,9,14,0
359166,3,7,13,-6,6,0
268255,1,3,0,3,17,0
27290,1,7,3,4,13,0
76672,3,13,0,13,1,1
212507,4,13,13,0,10,0
70060,4,31,17,14,15,1
279876,3,17,13,4,5,1
314692,4,17,28,-11,3,0
222221,3,13,10,3,14,0
203493,3,21,3,18,6,1
341521,2,3,7,-4,16,1
140385,4,17,29,-12,12,0
136929,3,0,13,-13,11,1
89353,1,3,6,-3,7,0
407438,3,14,10,4,11,1
312480,1,10,0,10,3,1
389488,2,13,3,10,3,0
166688,1,6,0,6,6,1
417950,2,14,14,0,16,0
358922,4,14,35,-21,6,0
99472,2,0,10,-10,11,1
371411,1,7,7,0,12,1
63859,2,3,14,-11,12,1
301511,3,20,15,5,15,0
259237,1,0,0,0,13,1
111934,2,6,21,-15,17,1
397039,3,21,9,12,6,0
199015,4,19,26,-7,3,0
206323,4,24,6,18,7,0
13415,1,3,14,-11,7,0
6957,2,0,6,-6,3,0
376610,4,15,6,9,14,0
45489,3,27,17,10,4,0
200647,4,27,28,-1,4,1
71525,4,33,14,19,16,0
250351,3,13,14,-1,9,1
123503,2,7,0,7,4,0
91190,3,10,17,-7,8,0
157741,3,10,10,0,2,0
90373,4,20,32,-12,7,0
210149,2,0,6,-6,9,0
172087,3,10,9,1,9,1
419097,1,0,0,0,16,1
108990,3,16,27,-11,15,0
289045,4,32,21,11,9,1
376246,3,10,14,-4,14,1
391272,2,14,0,14,4,0
217175,3,9,16,-7,12,1
372046,3,13,10,3,13,1
4947,3,14,17,-3,3,1
57567,1,0,0,0,10,1
919,2,0,0,0,1,1
411219,4,11,23,-12,13,1
277084,2,3,14,-11,4,1
117149,1,6,3,3,2,1
37123,4,16,17,-1,17,0
21985,2,7,3,4,11,0
207593,3,21,10,11,7,0
283976,1,0,0,0,7,1
67018,2,0,0,0,14,0
304715,4,21,14,7,16,1
299646,1,7,0,7,14,1
111474,1,7,0,7,16,0
168932,4,24,13,11,7,1
232941,2,7,3,4,2,1
288854,2,10,23,-13,9,0
395408,4,28,3,25,5,0
84590,2,10,10,0,4,1
342102,2,6,3,3,16,1
200084,1,7,0,7,4,0
231634,3,14,13,1,1,0
404864,4,30,27,3,10,0
370562,2,14,0,14,12,0
346649,2,14,6,8,1,1
187922,1,0,7,-7,16,1
318574,2,10,7,3,5,1
262071,1,7,0,7,15,0
278806,3,7,14,-7,5,1
314407,4,10,17,-7,3,1
336868,2,7,14,-7,14,1
197230,1,0,0,0,3,0
218473,3,24,17,7,13,1
227430,2,10,7,3,16,1
368791,1,0,0,0,11,0
178403,4,31,34,-3,12,1
318931,4,31,28,3,5,0
399165,2,7,3,4,7,0
99053,3,9,0,9,11,1
10071,2,28,7,21,5,1
45090,1,0,0,0,4,1
257483,2,6,3,3,13,1
324056,1,0,0,0,8,0
42282,4,37,7,30,2,0
411719,1,0,3,-3,13,0
378080,4,0,17,-17,15,1
27120,1,0,0,0,13,1
84839,1,0,3,-3,4,1
326960,2,2,7,-5,9,1
140395,1,0,0,0,12,1
5635,2,0,14,-14,3,1
287152,2,10,3,7,8,0
112259,2,17,10,7,17,0
60358,2,10,7,3,11,0
98691,1,7,3,4,11,1
124530,2,6,0,6,5,0
160178,3,27,7,20,3,1
421687,2,17,7,10,17,0
336,1,14,3,11,1,0
388176,3,3,6,-3,2,0
162730,4,26,24,2,5,1
203486,2,21,3,18,6,0
165263,3,17,14,3,6,0
184530,3,27,14,13,14,0
320901,4,3,14,-11,6,0
185157,4,0,23,-23,15,1
352641,1,0,0,0,3,0
319626,2,16,3,13,6,0
119807,3,24,13,11,3,1
193506,1,0,0,0,1,1
126742,4,13,13,0,6,0
393703,2,0,7,-7,5,1
192682,4,13,7,6,1,0
340978,4,17,17,0,15,1
171272,1,0,0,0,9,0
238170,2,3,9,-6,4,0
317368,3,0,3,-3,5,1
232777,2,13,0,13,2,0
277199,2,0,7,-7,4,0
20451,1,0,0,0,10,0
2654,2,3,0,3,2,1
340055,3,17,12,5,15,1
280753,4,14,14,0,5,0
267015,4,22,17,5,17,0
60081,3,7,10,-3,11,1
162127,4,51,20,31,4,1
17733,4,17,6,11,9,1
141644,2,17,14,3,13,1
199108,3,14,24,-10,4,0
6740,1,0,0,0,3,0
85461,2,14,3,11,5,1
115028,4,20,19,1,1,0
189992,4,16,7,9,17,0
342275,3,13,3,10,16,0
337458,2,7,6,1,14,0
65541,1,3,0,3,13,1
225414,4,27,38,-11,15,0
377611,4,20,12,8,15,1
248516,4,23,20,3,8,1
330702,3,6,3,3,11,0
318894,3,21,15,6,5,0
354622,2,3,7,-4,4,1
342440,3,10,3,7,16,1
106246,1,0,0,0,14,0
391432,3,10,17,-7,4,1
284194,3,9,20,-11,7,1
148518,4,24,10,14,16,1
341830,2,13,9,4,16,0
182201,4,33,7,26,13,0
396898,4,27,20,7,6,0
421458,1,0,0,0,17,0
134843,4,55,20,35,10,0
366928,1,0,7,-7,10,1
345243,2,13,14,-1,17,1
204193,4,24,20,4,6,0
181761,4,7,14,-7,13,0
110195,4,23,33,-10,16,1
391731,3,3,10,-7,4,1
348602,4,28,23,5,2,1
231409,1,0,0,0,1,1
385215,1,0,0,0,1,0
371771,3,17,14,3,12,1
399987,4,12,13,-1,8,1
129925,4,13,0,13,7,1
275366,4,10,22,-12,3,1
297944,2,17,7,10,13,1
353766,5,20,20,0,4,0
87335,4,27,24,3,6,0
8814,3,19,0,19,4,1
346769,1,0,0,0,1,0
14987,1,0,7,-7,7,1
402228,1,0,3,-3,9,1
278568,1,0,0,0,4,1
155761,4,27,29,-2,2,0
280380,1,3,0,3,5,0
356140,2,10,0,10,5,0
218991,1,14,0,14,13,0
245119,2,17,6,11,7,0
78627,4,30,13,17,2,0
360528,1,0,7,-7,7,1
357197,1,0,0,0,5,0
109885,3,20,0,20,16,1
386436,4,23,17,6,2,1
98660,4,14,10,4,11,0
413399,2,3,21,-18,14,0
417710,4,35,12,23,16,0
204552,1,0,21,-21,6,0
155342,1,10,3,7,2,0
411974,4,20,17,3,13,1
115088,2,3,7,-4,1,1
241500,1,0,0,0,5,0
415862,2,7,20,-13,15,1
336883,2,7,14,-7,14,1
367198,4,29,23,6,10,0
232037,2,0,17,-17,1,0
368559,3,9,0,9,11,0
402733,3,17,0,17,9,0
113846,1,0,0,0,17,1
317500,3,10,17,-7,5,0
363070,1,7,0,7,8,0
26385,1,7,0,7,13,1
327035,4,8,10,-2,9,0
14744,2,21,0,21,7,1
333753,1,0,0,0,12,1
49542,3,13,3,10,6,1
361615,1,0,3,-3,7,0
219929,2,6,0,6,13,1
76981,4,17,13,4,1,0
363490,1,0,2,-2,8,0
150752,3,13,9,4,17,0
277848,2,7,14,-7,4,1
31186,3,23,27,-4,15,1
110953,3,7,10,-3,16,0
366688,2,17,10,7,10,1
127709,1,0,0,0,6,0
96069,4,13,14,-1,10,1
382914,2,0,7,-7,17,1
261024,1,0,0,0,14,0
148965,3,13,12,1,16,0
199107,3,14,24,-10,4,0
382625,1,0,0,0,17,0
179145,4,12,13,-1,12,0
101148,4,19,27,-8,12,0
113233,1,0,0,0,17,1
107554,1,0,0,0,15,0
400881,4,31,19,12,8,1
395638,2,7,17,-10,6,1
168850,2,14,3,11,7,0
415484,4,23,3,20,15,0
72311,1,0,7,-7,16,1
56451,3,0,38,-38,9,1
150659,4,17,22,-5,17,1
241080,2,13,0,13,5,0
310167,3,21,10,11,2,1
288019,1,0,0,0,9,0
334670,2,15,3,12,13,0
365565,2,20,14,6,9,1
34994,1,6,0,6,16,1
365828,1,0,0,0,9,0
11119,4,17,13,4,5,0
115863,2,7,13,-6,1,1
366124,2,7,21,-14,10,1
308133,3,16,19,-3,1,1
225250,4,17,7,10,15,0
143166,1,0,3,-3,13,1
242214,4,23,14,9,6,1
71490,3,33,14,19,16,0
88156,2,7,10,-3,6,1
76568,4,7,41,-34,1,1
39652,1,0,0,0,1,0
71118,1,12,0,12,16,0
38178,1,3,7,-4,1,1
150212,4,6,26,-20,16,0
273959,3,7,9,-2,2,0
29016,4,14,7,7,14,0
359735,2,17,9,8,6,1
359669,4,40,7,33,6,0
350462,3,0,12,-12,2,1
225428,1,0,0,0,15,1
298589,4,13,7,6,14,0
59147,1,0,14,-14,10,0
69571,2,7,10,-3,15,0
337281,1,0,0,0,14,0
326295,1,0,3,-3,9,1
346316,1,0,3,-3,1,0
211514,3,26,14,12,9,1
347204,4,23,27,-4,1,1
420790,2,3,10,-7,17,1
328613,3,17,28,-11,10,0
303975,4,14,34,-20,16,1
326375,3,20,10,10,9,1
325643,3,17,7,10,9,1
285044,1,0,0,0,7,0
393234,2,14,6,8,5,0
333898,1,0,0,0,12,0
317268,4,7,16,-9,5,1
199919,1,0,7,-7,4,0
232001,1,0,7,-7,1,1
350528,4,17,19,-2,2,1
397311,3,0,21,-21,6,0
142322,3,0,3,-3,13,1
386944,2,7,21,-14,2,0
291259,2,7,12,-5,10,0
401810,2,7,7,0,9,1
201014,2,27,0,27,5,0
208796,3,6,15,-9,8,0
274977,1,7,3,4,3,1
201215,4,20,24,-4,5,0
135290,4,34,17,17,10,0
199534,2,20,3,17,4,1
188033,4,23,17,6,16,0
17131,4,30,17,13,9,0
327451,4,10,27,-17,9,1
185779,4,25,3,22,15,0
403447,2,14,9,5,9,0
81858,2,0,21,-21,3,0
1606,4,16,20,-4,1,1
420125,2,0,0,0,17,0
352171,4,15,27,-12,3,1
417221,3,17,17,0,16,0
101708,2,10,0,10,12,0
190159,4,30,3,27,17,0
156772,2,14,7,7,2,0
220156,4,26,13,13,13,1
108495,2,7,7,0,15,1
277555,2,6,14,-8,4,1
143628,2,10,10,0,14,1
386030,2,7,0,7,1,1
401203,1,0,0,0,8,1
310433,2,14,3,11,2,1
336454,3,10,17,-7,14,1
346075,3,10,6,4,1,0
58310,4,27,13,14,10,0
149949,1,7,3,4,16,1
92593,3,17,3,14,8,0
246644,3,24,3,21,8,1
325728,1,0,7,-7,9,0
22780,3,3,21,-18,11,1
382502,1,0,0,0,17,0
311844,4,20,26,-6,2,0
298925,1,0,6,-6,14,1
92275,2,10,0,10,8,1
307843,4,27,28,-1,1,1
236721,4,30,7,23,3,0
289983,4,6,9,-3,10,1
409611,1,0,0,0,12,0
234460,2,17,6,11,2,0
180149,2,7,0,7,13,1
187776,1,7,0,7,16,1
377876,3,20,10,10,15,0
154049,4,17,21,-4,1,1
101524,2,10,14,-4,12,0
223639,2,6,3,3,15,1
10920,2,6,7,-1,5,0
249404,3,18,15,3,9,0
416345,3,16,3,13,15,0
87326,4,24,24,0,6,1
275073,4,34,20,14,3,0
168540,1,6,3,3,7,1
387045,1,0,7,-7,2,1
240440,2,0,7,-7,5,1
255254,4,13,17,-4,12,1
246824,4,10,20,-10,8,1
4764,2,13,0,13,3,0
202357,4,20,13,7,5,0
107272,1,0,0,0,15,0
292487,3,10,12,-2,11,1
247539,2,6,10,-4,8,1
53823,1,0,0,0,8,1
245438,3,9,6,3,7,0
399702,1,0,0,0,8,0
163207,1,0,0,0,5,0
22181,3,10,15,-5,11,1
111293,4,17,19,-2,16,0
215411,1,7,0,7,11,1
233358,4,19,26,-7,2,1
17718,4,17,6,11,9,0
307938,2,7,3,4,1,1
358343,1,6,0,6,6,0
384036,4,20,23,-3,1,1
228624,2,10,14,-4,17,1
198374,4,20,14,6,3,1
23937,3,16,0,16,12,1
333871,4,28,21,7,12,0
410742,3,17,6,11,13,1
259672,4,9,16,-7,13,1
410828,1,14,0,14,13,0
32810,2,6,0,6,15,1
289937,3,6,3,3,10,0
128991,3,35,10,25,7,0
311941,3,21,10,11,2,1
148243,4,18,31,-13,16,1
338363,2,3,0,3,14,0
201285,2,14,0,14,5,0
143511,3,17,21,-4,14,0
220406,2,23,14,9,13,0
399902,2,0,6,-6,8,1
191658,2,0,9,-9,17,0
413888,4,17,9,8,14,1
242629,3,13,0,13,6,0
290570,4,23,20,3,10,1
162599,1,0,7,-7,5,0
22475,3,24,27,-3,11,1
348968,2,14,0,14,2,1
256372,1,6,0,6,12,1
125497,4,23,0,23,5,0
398046,2,14,20,-6,7,0
362898,1,0,0,0,8,0
21493,4,15,17,-2,11,0
385609,3,6,17,-11,1,0
218405,1,3,14,-11,13,1
230696,2,6,20,-14,1,0
402441,3,21,12,9,9,0
38962,2,23,3,20,1,1
215255,4,10,16,-6,11,1
220335,1,0,0,0,13,1
406615,1,0,0,0,11,0
274348,1,3,7,-4,3,0
149384,2,6,6,0,16,0
245665,1,3,0,3,7,0
202126,3,13,3,10,5,1
221241,2,0,16,-16,14,0
230860,2,7,7,0,1,1
163776,3,10,12,-2,5,0
288841,2,10,17,-7,9,0
259703,1,3,7,-4,14,1
1939,2,3,0,3,1,0
276251,4,31,17,14,3,0
333720,4,21,6,15,12,0
50944,4,24,27,-3,6,0
41403,4,14,15,-1,2,0
410721,2,17,3,14,13,0
293839,4,24,19,5,12,1
44325,4,24,23,1,3,1
249408,4,18,15,3,9,1
247346,4,42,48,-6,8,1
352941,2,10,0,10,3,1
345554,2,7,17,-10,17,0
310690,4,20,36,-16,2,0
287587,1,0,3,-3,9,1
77501,2,7,7,0,1,0
181825,2,14,7,7,13,0
9665,3,12,28,-16,5,1
413093,2,27,21,6,14,0
339704,2,7,3,4,15,0
59127,4,26,39,-13,10,1
164561,4,26,17,9,5,1
22072,4,24,24,0,11,0
362780,2,7,14,-7,8,0
413523,1,0,3,-3,14,1
286618,4,17,41,-24,8,0
197968,1,0,9,-9,3,0
221573,2,20,12,8,14,0
182433,1,7,0,7,14,1
142363,4,7,6,1,13,1
98048,5,24,24,0,11,1
107810,3,7,20,-13,15,1
37887,2,3,7,-4,1,0
277895,3,7,20,-13,4,0
24252,3,13,17,-4,12,0
351711,4,14,17,-3,3,0
309266,2,0,10,-10,1,1
31444,2,3,7,-4,15,0
193343,1,7,0,7,1,0
308625,4,34,16,18,1,0
4129,4,26,28,-2,2,0
215059,3,13,7,6,11,0
337094,4,26,7,19,14,0
75600,3,7,3,4,17,1
55807,2,0,7,-7,9,0
331832,1,0,0,0,12,1
94444,1,0,0,0,9,1
28109,3,27,10,17,13,0
72473,2,10,10,0,16,1
165775,1,0,0,0,6,1
81257,3,10,7,3,3,1
185789,4,25,3,22,15,1
108376,2,0,21,-21,15,1
365431,2,7,18,-11,9,0
383033,1,3,0,3,17,1
159378,2,7,10,-3,3,0
387584,3,6,3,3,2,1
77807,2,7,14,-7,1,0
123932,2,7,0,7,5,0
242666,4,13,10,3,6,1
277658,1,7,0,7,4,0
327265,3,9,13,-4,9,1
38064,2,3,0,3,1,0
137010,5,20,20,0,11,1
226936,4,3,13,-10,16,0
335413,2,7,6,1,13,1
271667,1,0,0,0,2,0
190892,4,34,20,14,17,1
62298,3,21,19,2,12,1
108145,4,19,42,-23,15,1
362226,3,6,17,-11,8,1
121006,2,8,21,-13,3,0
79449,3,9,14,-5,2,0
177191,1,0,0,0,11,1
203898,5,37,37,0,6,1
6817,2,3,21,-18,3,0
305361,2,14,3,11,17,0
318151,3,15,10,5,5,1
321852,1,7,7,0,7,0
223864,3,9,6,3,15,1
174619,1,3,0,3,10,1
190397,3,7,0,7,17,0
334667,2,2,3,-1,13,1
261009,4,10,3,7,14,0
421286,4,19,10,9,17,0
286396,2,14,0,14,8,1
131860,3,24,7,17,8,0
19933,4,22,21,1,10,0
406873,4,20,23,-3,11,1
223572,4,17,13,4,15,1
188069,1,0,3,-3,16,1
358384,2,9,10,-1,6,0
321820,4,24,9,15,7,0
309263,2,0,10,-10,1,1
186162,2,16,6,10,15,1
217540,1,3,0,3,12,1
247348,4,42,48,-6,8,1
314153,1,7,7,0,3,1
61923,1,0,0,0,12,0
99050,3,9,0,9,11,1
127345,3,10,20,-10,6,1
147104,2,13,31,-18,15,1
196928,1,0,0,0,3,1
88997,4,39,10,29,6,0
277901,3,7,20,-13,4,1
323516,3,17,10,7,7,1
377111,2,10,10,0,15,0
346339,2,3,3,0,1,0
221685,1,3,0,3,14,1
76178,2,9,13,-4,1,1
229811,1,6,0,6,17,0
57756,2,16,3,13,10,1
295428,3,10,13,-3,12,0
237200,2,3,0,3,3,1
266583,1,0,0,0,16,1
332715,2,14,6,8,12,1
315577,4,7,14,-7,4,1
262246,1,3,0,3,15,0
141228,3,3,24,-21,13,0
92088,2,3,10,-7,8,1
402364,1,0,6,-6,9,0
141059,3,14,10,4,13,0
101593,3,13,31,-18,12,1
269528,3,13,24,-11,1,1
217537,1,0,0,0,12,1
295127,3,7,14,-7,12,0
232802,3,16,14,2,2,0
392061,4,10,24,-14,4,1
277769,4,17,6,11,4,0
407977,1,0,0,0,12,1
317941,2,10,3,7,5,0
85139,1,0,3,-3,4,1
335826,1,7,7,0,13,0
352284,3,3,6,-3,3,1
89052,2,6,6,0,6,1
217308,2,0,7,-7,12,0
205906,1,3,0,3,7,0
300744,2,7,6,1,15,1
114053,2,14,0,14,17,0
268202,4,12,25,-13,17,0
222456,2,3,7,-4,14,1
245122,2,17,12,5,7,0
237694,3,20,14,6,4,1
306346,4,24,10,14,17,0
130661,3,7,35,-28,8,0
50562,2,0,6,-6,6,1
259250,1,0,0,0,13,1
8526,4,15,10,5,4,1
273754,2,0,7,-7,2,1
238554,4,16,20,-4,4,1
224015,2,14,6,8,15,1
16787,3,3,17,-14,8,0
25066,1,0,0,0,12,1
139688,2,0,0,0,12,1
32329,1,7,0,7,15,0
126712,3,7,13,-6,6,1
214918,3,7,19,-12,11,1
320738,3,14,23,-9,6,0
72242,4,24,17,7,16,1
234902,1,0,0,0,2,1
341006,1,0,0,0,15,1
115591,4,27,9,18,1,1
390427,4,14,27,-13,3,0
125647,3,14,24,-10,5,1
330055,2,0,3,-3,11,1
141390,3,10,17,-7,13,0
8711,1,0,0,0,4,1
198881,1,0,13,-13,3,1
276938,2,17,14,3,4,0
217015,3,6,3,3,12,1
317981,3,10,10,0,5,0
87076,1,0,0,0,5,0
386234,3,12,17,-5,2,0
211388,4,10,13,-3,9,0
44371,1,0,0,0,3,1
91570,1,0,0,0,8,1
199842,3,3,17,-14,4,1
146410,3,13,3,10,15,1
327395,2,0,14,-14,9,1
341180,2,3,0,3,16,1
174257,4,10,33,-23,10,0
117400,4,34,10,24,2,0
294171,1,0,7,-7,12,1
43176,2,7,7,0,3,0
63442,2,14,13,1,12,1
413414,2,3,31,-28,14,1
108197,1,3,0,3,15,1
394038,3,9,13,-4,5,0
157258,3,10,3,7,2,1
402375,1,0,7,-7,9,0
169629,2,13,0,13,8,1
212545,1,0,0,0,10,0
50229,1,7,7,0,6,0
376457,5,23,23,0,14,1
253757,4,24,10,14,11,1
45597,2,7,13,-6,4,1
399296,1,14,0,14,7,0
38380,3,14,16,-2,1,1
135147,4,31,6,25,10,0
57725,1,0,0,0,10,1
295110,3,7,14,-7,12,1
414876,3,21,7,14,15,0
238363,2,10,16,-6,4,1
146452,4,24,3,21,15,0
176075,4,24,8,16,11,0
393922,4,23,20,3,5,0
393856,2,10,17,-7,5,1
69341,4,19,9,10,15,1
204802,4,28,24,4,6,1
6123,3,7,10,-3,3,0
418970,1,7,7,0,16,0
207344,4,13,21,-8,7,0
89693,3,6,17,-11,7,1
124396,2,6,0,6,5,0
26832,1,7,0,7,13,0
168634,4,17,16,1,7,0
93990,1,0,14,-14,9,1
309727,3,19,6,13,1,0
257597,5,19,20,-1,13,0
402875,3,17,6,11,9,1
403796,4,18,23,-5,9,1
274801,1,0,0,0,3,1
272605,4,16,9,7,2,1
383687,3,9,24,-15,17,1
57487,2,14,10,4,10,1
359762,3,24,16,8,6,1
32800,2,0,0,0,15,1
417060,2,17,0,17,15,1
342396,2,0,3,-3,16,1
406853,4,7,23,-16,11,1
50777,4,24,21,3,6,0
123961,3,10,0,10,5,0
377674,2,16,7,9,15,1
282096,2,15,8,7,6,1
67299,2,14,3,11,14,1
339069,1,0,0,0,15,0
51147,2,17,3,14,7,0
86523,2,13,3,10,5,0
305183,4,33,10,23,16,0
290024,2,7,0,7,10,0
127173,3,10,9,1,6,1
267752,4,23,34,-11,17,0
320684,1,14,10,4,6,0
129765,4,17,24,-7,7,0
91552,4,26,10,16,8,1
188772,4,0,20,-20,16,1
332935,4,31,3,28,12,0
276170,2,17,0,17,3,0
312649,2,14,7,7,3,0
396521,2,17,7,10,6,1
365643,4,38,35,3,9,0
162219,3,19,20,-1,4,1
85492,2,14,9,5,5,1
103145,1,0,0,0,13,0
137565,3,20,27,-7,11,0
233035,4,24,17,7,2,1
157691,2,7,3,4,2,1
107259,1,0,0,0,15,1
111087,3,24,0,24,16,0
103471,1,6,0,6,13,0
209421,4,14,17,-3,8,0
102718,1,0,0,0,13,1
394648,4,17,21,-4,5,0
122101,2,10,14,-4,4,1
151211,3,10,20,-10,17,1
413857,3,14,6,8,14,1
105550,3,29,14,15,14,1
45505,4,27,23,4,4,0
318231,1,3,0,3,5,1
393645,1,0,0,0,5,0
330809,2,10,10,0,11,0
233089,1,8,0,8,2,0
164431,1,7,0,7,5,1
74046,1,3,0,3,17,0
255997,3,19,12,7,12,0
118133,3,16,20,-4,2,1
359811,4,37,33,4,6,1
283170,4,20,9,11,7,1
213216,3,10,13,-3,10,0
184896,1,0,7,-7,15,1
322757,2,3,20,-17,7,0
92589,3,17,3,14,8,1
29067,1,0,3,-3,14,1
152400,3,28,3,25,17,1
49185,2,10,0,10,6,1
214141,3,3,6,-3,11,0
20887,4,28,23,5,10,1
404625,3,13,13,0,10,1
182928,2,0,30,-30,14,1
16185,1,0,0,0,8,0
339533,1,7,0,7,15,0
416623,2,28,7,21,15,0
300841,1,0,6,-6,15,0
212785,3,10,21,-11,10,1
354491,3,24,28,-4,4,1
260496,2,13,0,13,14,1
134607,2,24,10,14,10,0
271880,2,7,10,-3,2,0
71340,3,10,20,-10,16,0
55230,2,7,0,7,9,0
136422,2,10,7,3,11,0
388014,3,6,3,3,2,0
40267,2,3,0,3,2,1
213256,4,17,16,1,10,0
104206,1,0,0,0,13,1
265989,4,0,33,-33,16,1
383646,2,0,14,-14,17,1
396569,3,17,10,7,6,1
196002,4,7,30,-23,2,0
300602,2,10,0,10,15,0
83146,4,13,30,-17,4,1
188684,1,0,14,-14,16,1
269628,2,3,0,3,1,1
106564,2,14,0,14,14,1
129352,2,14,7,7,7,1
184841,4,24,20,4,15,1
103795,2,6,0,6,13,0
373722,3,13,21,-8,13,1
16191,1,0,0,0,8,1
48622,4,21,27,-6,5,1
78814,1,0,0,0,2,1
42107,4,27,20,7,2,1
42585,1,0,0,0,3,1
116946,4,28,13,15,2,0
176651,2,14,12,2,11,0
383654,2,6,14,-8,17,0
309820,2,7,7,0,1,0
59096,4,10,23,-13,10,0
322987,4,20,0,20,7,0
159621,4,20,20,0,3,1
80337,2,13,6,7,2,1
347447,2,6,13,-7,1,0
294220,3,13,7,6,12,0
418691,1,0,7,-7,16,1
108397,3,3,21,-18,15,1
313592,3,12,23,-11,3,0
128942,2,25,3,22,7,0
3531,1,0,0,0,2,1
112754,3,10,7,3,17,1
202581,2,14,13,1,5,0
421334,1,0,3,-3,17,1
209023,1,3,0,3,8,0
312072,2,17,7,10,2,0
365709,2,10,3,7,9,0
288381,2,7,0,7,9,1
252784,2,3,6,-3,11,1
180760,2,7,6,1,13,1
156367,3,31,7,24,2,1
299133,3,3,13,-10,14,0
312239,3,7,17,-10,2,1
390769,1,0,0,0,3,0
255971,3,6,12,-6,12,1
149606,4,17,26,-9,16,0
387773,4,0,43,-43,2,1
410542,2,7,7,0,13,0
229552,2,17,6,11,17,1
145191,3,49,0,49,14,0
323479,2,3,3,0,7,0
287850,4,28,20,8,9,0
340786,3,17,10,7,15,0
271979,1,0,0,0,2,1
289922,3,6,3,3,10,1
130212,3,3,26,-23,8,0
112381,2,10,13,-3,17,1
66516,3,28,24,4,14,1
390969,2,13,7,6,4,0
10115,4,44,7,37,5,1
382805,2,21,0,21,17,1
368538,2,9,0,9,11,0
81319,4,17,14,3,3,1
143703,4,19,10,9,14,0
120918,4,28,31,-3,3,1
295836,1,0,7,-7,12,1
214471,3,7,17,-10,11,1
343441,1,7,0,7,16,1
82393,4,13,10,3,3,0
357702,2,26,6,20,5,0
69433,3,24,3,21,15,1
1334,1,0,0,0,1,0
344017,4,23,9,14,17,0
264024,1,0,0,0,15,1
384035,4,20,23,-3,1,1
16318,1,7,0,7,8,1
276419,4,32,44,-12,3,1
92503,1,7,0,7,8,0
286916,3,16,13,3,8,1
393584,3,7,19,-12,5,0
110963,3,7,10,-3,16,0
227510,4,19,17,2,16,1
324669,1,0,7,-7,8,1
48792,4,24,28,-4,5,0
82276,1,3,0,3,3,0
257629,1,0,7,-7,13,0
349456,3,6,20,-14,2,0
248001,2,21,3,18,8,1
97510,2,16,0,16,10,1
119976,3,16,24,-8,3,1
266429,1,0,0,0,16,0
142166,4,2,7,-5,13,0
7889,2,3,14,-11,4,1
47125,1,3,0,3,5,0
338917,1,3,0,3,15,0
293901,2,7,14,-7,12,0
104171,4,27,27,0,13,1
330864,3,13,17,-4,11,1
414955,1,7,7,0,15,1
365289,2,10,13,-3,9,0
315425,4,23,30,-7,4,1
337226,3,16,16,0,14,0
355164,4,26,23,3,4,0
396130,3,17,23,-6,6,0
72848,4,44,17,27,16,1
344618,1,0,3,-3,17,0
349774,4,23,21,2,2,1
241297,4,10,7,3,5,1
92370,1,7,0,7,8,1
7151,4,34,21,13,4,0
60247,3,10,13,-3,11,1
288504,1,3,14,-11,9,1
395822,3,3,14,-11,6,1
331830,1,0,0,0,12,1
321161,3,3,16,-13,6,1
383821,2,3,7,-4,1,0
343835,3,21,3,18,17,1
358974,1,7,0,7,6,1
46220,3,14,21,-7,4,0
229943,1,0,0,0,17,0
379549,2,13,3,10,16,0
62818,4,20,0,20,12,1
134480,3,3,23,-20,10,0
229053,1,0,0,0,17,1
273303,2,21,0,21,2,1
388405,1,0,3,-3,2,1
343631,2,15,7,8,17,1
272968,1,3,0,3,2,0
237452,1,0,0,0,3,1
283295,3,10,9,1,7,0
211242,4,21,26,-5,9,1
348824,2,3,14,-11,2,1
318219,1,0,0,0,5,1
328184,4,14,14,0,10,0
383415,3,10,9,1,17,0
247920,4,20,6,14,8,0
278537,4,43,7,36,4,0
181735,3,7,7,0,13,1
237640,2,3,7,-4,4,0
30470,3,31,35,-4,14,1
101622,4,13,38,-25,12,1
257536,3,19,10,9,13,0
187909,1,0,0,0,16,1
316803,4,16,7,9,4,1
21946,1,7,0,7,11,1
328425,2,3,0,3,10,0
65042,3,3,17,-14,13,0
195580,4,13,7,6,2,1
389808,3,17,6,11,3,1
401714,3,10,14,-4,8,1
272892,3,20,17,3,2,0
122926,4,37,6,31,4,0
40268,2,3,0,3,2,1
411865,1,0,0,0,13,1
212946,3,7,7,0,10,1
255956,2,6,12,-6,12,1
237274,4,26,0,26,3,1
70202,4,30,22,8,15,0
376602,4,15,6,9,14,1
317627,2,3,3,0,5,0
315128,1,0,0,0,4,0
120143,3,10,6,4,3,0
122235,1,3,10,-7,4,1
278535,4,42,7,35,4,1
318409,2,21,7,14,5,1
190700,3,35,17,18,17,0
374105,2,13,7,6,13,1
368491,1,0,0,0,11,1
63388,4,17,10,7,12,1
227654,4,42,0,42,16,0
189300,2,3,6,-3,16,0
169818,3,9,17,-8,8,1
7172,4,41,24,17,4,1
161765,3,24,6,18,4,1
146069,2,13,3,10,15,0
336413,2,3,3,0,14,1
197505,4,20,9,11,3,1
117392,4,34,3,31,2,0
394062,4,9,16,-7,5,1
329118,4,27,7,20,10,1
367409,2,17,14,3,10,0
396765,4,7,20,-13,6,1
188013,4,23,14,9,16,0
188393,2,3,0,3,16,0
109394,2,3,10,-7,16,1
212881,1,0,0,0,10,0
344236,2,7,10,-3,17,0
261440,4,17,24,-7,14,0
301912,2,11,13,-2,15,0
53194,1,0,0,0,8,0
393734,3,7,7,0,5,0
54070,3,10,3,7,8,0
21604,3,7,31,-24,11,0
389242,3,28,7,21,3,1
315897,4,9,26,-17,4,1
229607,4,30,13,17,17,1
243820,4,27,20,7,6,0
205977,3,13,10,3,7,0
48013,3,10,24,-14,5,0
187763,1,0,0,0,16,0
394491,3,10,18,-8,5,0
208786,3,6,15,-9,8,0
56984,1,0,10,-10,9,1
110995,4,14,20,-6,16,0
60657,2,7,3,4,11,1
358190,4,20,17,3,6,1
276698,4,23,13,10,4,0
214088,1,3,0,3,11,0
239243,2,0,7,-7,4,0
17741,4,24,6,18,9,0
160859,4,34,24,10,4,0
156825,3,23,20,3,2,0
369475,4,48,7,41,11,0
315258,4,20,16,4,4,1
193661,1,3,6,-3,1,0
135083,3,17,6,11,10,1
235658,1,0,3,-3,3,0
234450,2,10,6,4,2,1
149294,4,13,27,-14,16,0
9010,1,7,7,0,4,1
86531,2,13,3,10,5,1
206945,1,0,0,0,7,1
177627,4,24,20,4,11,0
135312,1,0,6,-6,10,0
116091,1,0,0,0,1,1
277576,3,6,14,-8,4,1
153215,1,2,0,2,1,1
403882,2,10,7,3,10,0
359859,2,17,14,3,6,0
273187,3,24,7,17,2,1
222183,2,10,10,0,14,1
181577,3,13,3,10,13,0
43923,2,0,7,-7,3,1
367788,1,3,0,3,10,0
318809,1,0,0,0,5,1
33905,1,0,10,-10,16,1
292156,2,21,0,21,11,0
319887,1,0,0,0,6,1
190169,1,0,0,0,17,1
348070,2,0,10,-10,1,1
365669,1,7,0,7,9,0
166920,3,13,6,7,6,0
132282,3,24,7,17,9,1
50399,2,7,7,0,6,1
351093,4,27,23,4,3,1
399416,4,37,10,27,7,0
367183,4,29,23,6,10,0
391685,2,0,3,-3,4,1
266398,3,36,8,28,16,1
10900,1,3,7,-4,5,1
66902,2,6,7,-1,14,1
201580,1,0,0,0,5,1
31926,3,6,13,-7,15,1
143424,4,13,26,-13,14,0
421679,2,17,7,10,17,1
389389,4,30,13,17,3,0
277897,3,7,20,-13,4,0
300725,2,7,0,7,15,0
14974,4,17,24,-7,7,1
68367,3,3,14,-11,14,0
103190,2,3,0,3,13,1
202649,4,34,20,14,5,0
271810,4,36,27,9,2,0
4211,2,10,6,4,2,1
373895,4,37,16,21,13,0
131517,2,6,6,0,8,0
302017,1,7,3,4,15,0
281502,3,10,10,0,6,0
13788,3,7,27,-20,7,0
402541,1,7,7,0,9,1
173742,2,3,3,0,10,0
366741,3,27,10,17,10,0
383668,2,6,17,-11,17,0
343329,2,0,10,-10,16,0
244392,3,0,17,-17,7,1
269749,1,7,0,7,1,1
374386,2,9,0,9,14,0
248655,4,24,10,14,9,0
269473,1,3,3,0,1,1
220264,3,20,9,11,13,0
180252,1,0,0,0,13,1
358244,2,0,14,-14,6,1
183829,3,27,21,6,14,0
19152,2,14,10,4,10,1
246938,2,20,7,13,8,0
340281,1,3,0,3,15,0
175479,1,0,0,0,11,0
419019,2,7,17,-10,16,1
362418,4,30,20,10,8,0
210966,4,33,23,10,9,1
94979,3,6,9,-3,9,0
135949,1,0,3,-3,10,0
58882,2,3,18,-15,10,0
240671,4,36,24,12,5,0
131437,4,7,19,-12,8,1
398043,2,14,14,0,7,0
126009,1,0,0,0,6,0
206565,2,10,10,0,7,1
237236,3,13,0,13,3,0
370849,1,3,0,3,12,0
165663,2,0,7,-7,6,1
23938,3,16,0,16,12,1
225257,4,17,7,10,15,1
328665,4,27,38,-11,10,1
2519,2,3,0,3,2,1
158723,1,0,0,0,3,1
306262,1,7,0,7,17,1
132541,2,2,29,-27,9,1
276912,2,14,0,14,4,0
316790,3,13,7,6,4,1
143592,1,7,3,4,14,0
296079,4,9,14,-5,13,1
99643,3,23,3,20,11,0
203033,2,17,3,14,5,1
325752,2,0,7,-7,9,0
60051,2,7,3,4,11,0
248992,4,27,3,24,9,0
116310,3,17,13,4,1,1
22355,4,0,6,-6,11,0
283553,2,6,14,-8,7,0
116486,4,6,19,-13,1,1
404318,2,0,6,-6,10,1
51774,3,3,19,-16,7,1
353297,3,38,28,10,4,0
18140,3,12,17,-5,9,1
257150,1,0,0,0,12,0
370402,1,7,0,7,12,0
208983,4,27,24,3,8,0
385635,4,9,24,-15,1,1
57363,3,14,3,11,10,1
136082,1,0,7,-7,10,1
208144,2,0,0,0,8,1
307894,1,0,0,0,1,1
306226,4,20,3,17,17,1
228550,4,20,14,6,17,0
231373,4,9,16,-7,1,0
213197,2,3,10,-7,10,1
155982,2,10,14,-4,2,0
134902,2,7,16,-9,10,1
85171,2,7,10,-3,4,0
301488,3,20,12,8,15,0
242983,5,34,34,0,6,1
220858,3,7,28,-21,14,0
269424,4,21,20,1,1,1
149859,3,3,16,-13,16,1
116199,4,22,19,3,1,1
197397,1,13,0,13,3,0
209270,4,34,7,27,8,0
56930,3,34,7,27,9,1
100355,3,9,20,-11,12,0
150055,4,31,6,25,16,0
253324,1,0,0,0,11,1
291368,1,7,7,0,10,0
135506,2,7,6,1,10,0
35182,3,0,14,-14,16,0
101072,2,7,10,-3,12,1
89545,3,0,20,-20,7,1
61811,2,0,17,-17,12,1
150978,4,22,17,5,17,1
66317,2,0,14,-14,14,1
216656,2,14,6,8,12,0
69877,3,24,15,9,15,0
56581,3,16,17,-1,9,1
107289,2,3,0,3,15,0
169184,2,10,6,4,7,1
261717,3,14,7,7,14,1
280921,4,21,10,11,6,0
372772,2,3,0,3,13,1
347302,3,7,14,-7,1,1
275552,1,6,0,6,3,1
387103,2,10,21,-11,2,1
179981,1,0,6,-6,13,0
3043,4,20,41,-21,2,1
410823,1,7,0,7,13,1
41957,4,31,6,25,2,0
209799,1,0,0,0,8,0
305054,1,14,0,14,16,0
295238,2,14,5,9,12,1
257832,2,7,6,1,13,1
183424,3,24,6,18,14,0
75907,3,29,7,22,1,0
401067,1,14,3,11,8,0
50550,2,0,6,-6,6,1
125383,1,0,0,0,5,0
55118,3,23,10,13,8,1
173537,4,13,27,-14,10,0
233416,2,14,3,11,2,1
376644,1,0,0,0,14,1
158601,1,7,7,0,3,1
397395,1,0,10,-10,6,1
62841,1,3,0,3,12,0
410519,1,7,0,7,13,0
186015,2,10,34,-24,15,1
108317,1,0,6,-6,15,0
310613,2,13,27,-14,2,0
318203,4,22,27,-5,5,1
322248,4,0,27,-27,7,1
362129,4,42,23,19,8,0
226429,2,0,7,-7,16,0
63458,2,14,13,1,12,1
105921,4,19,13,6,14,0
338803,2,7,0,7,15,1
233735,2,13,24,-11,2,1
402292,3,13,16,-3,9,1
418317,3,6,21,-15,16,1
228911,1,7,3,4,17,1
221648,4,23,24,-1,14,0
71964,4,25,16,9,16,1
369378,1,3,0,3,11,1
209763,4,16,6,10,8,0
335647,1,0,0,0,13,0
184331,1,0,3,-3,14,0
279813,2,7,6,1,5,1
229056,1,0,0,0,17,1
35333,3,16,0,16,16,1
35324,2,16,0,16,16,1
63688,4,33,36,-3,12,0
104848,1,0,0,0,14,0
226428,2,0,7,-7,16,0
381238,3,14,10,4,16,1
89977,2,2,14,-12,7,0
10420,4,10,45,-35,5,1
261118,3,21,21,0,14,0
209568,3,41,20,21,8,1
291921,4,24,10,14,11,0
389607,2,7,7,0,3,1
264123,3,20,27,-7,15,0
415338,4,14,14,0,15,0
306412,1,0,10,-10,17,0
301956,4,17,20,-3,15,1
4932,3,14,17,-3,3,1
290267,4,17,6,11,10,1
185661,1,0,0,0,15,1
58230,2,7,3,4,10,0
126600,4,23,19,4,6,0
307286,1,7,3,4,17,1
168091,1,6,0,6,7,1
195408,3,24,3,21,2,0
374594,3,20,13,7,14,0
255857,4,20,7,13,12,1
214383,2,0,7,-7,11,1
149784,1,3,0,3,16,0
367269,2,3,3,0,10,0
54880,1,0,0,0,8,0
49627,2,0,7,-7,6,1
78629,4,30,13,17,2,1
139327,4,20,13,7,12,0
243563,2,10,7,3,6,0
30157,2,10,17,-7,14,1
254054,4,14,20,-6,11,0
348919,4,9,21,-12,2,1
315068,3,30,14,16,4,1
230175,3,3,26,-23,17,1
33462,4,23,20,3,16,1
261198,1,21,0,21,14,0
225958,3,27,7,20,16,0
308367,2,0,6,-6,1,0
297476,1,0,0,0,13,1
305793,1,0,0,0,17,0
252877,1,0,0,0,11,1
5234,3,21,17,4,3,0
334933,1,0,0,0,13,0
92185,4,10,43,-33,8,0
307040,2,17,0,17,17,1
155473,1,0,0,0,2,1
96984,4,22,17,5,10,1
2338,1,0,0,0,2,0
78138,2,17,3,14,2,0
321921,3,14,21,-7,7,0
153369,1,0,7,-7,1,0
61233,2,14,0,14,11,0
53454,4,10,28,-18,8,1
237165,1,0,0,0,3,0
45832,1,0,0,0,4,0
228804,2,3,14,-11,17,1
283807,4,21,3,18,7,0
165726,4,14,7,7,6,0
218139,2,7,3,4,12,1
97014,1,10,0,10,10,0
234728,4,30,33,-3,2,1
220739,4,13,13,0,13,1
325125,1,10,7,3,8,0
358162,3,17,9,8,6,1
193273,3,3,20,-17,1,1
111028,1,7,0,7,16,0
375326,2,7,14,-7,14,1
364574,3,15,28,-13,9,1
404308,2,0,3,-3,10,0
246659,3,31,3,28,8,1
3931,3,19,14,5,2,0
133999,1,0,0,0,9,1
187639,1,0,3,-3,16,1
80838,4,3,3,0,3,1
384313,3,16,0,16,1,0
321641,4,17,13,4,7,1
250569,4,19,22,-3,9,0
164394,4,33,3,30,5,0
414158,4,10,20,-10,14,1
154719,2,3,7,-4,1,1
46650,4,10,0,10,4,0
76249,4,12,27,-15,1,0
58634,4,13,17,-4,10,1
29165,3,3,19,-16,14,0
281152,2,14,7,7,6,1
414162,4,10,20,-10,14,1
227076,4,20,9,11,16,0
141551,4,27,10,17,13,1
15717,1,0,0,0,8,0
283519,1,6,0,6,7,0
84290,2,7,24,-17,4,0
17286,4,21,41,-20,9,1
226100,2,7,14,-7,16,1
10962,3,9,28,-19,5,1
17820,2,10,10,0,9,1
54006,1,0,0,0,8,0
341122,4,14,24,-10,15,1
66469,2,7,10,-3,14,1
367623,4,31,12,19,10,0
309417,3,0,3,-3,1,1
45151,2,7,7,0,4,0
319675,3,26,3,23,6,1
35771,2,3,3,0,17,0
205377,3,27,0,27,6,1
58971,4,20,32,-12,10,0
313280,2,6,7,-1,3,0
383365,2,0,6,-6,17,0
75368,1,0,0,0,17,0
286656,1,7,0,7,8,0
376146,4,3,16,-13,14,0
256629,4,21,7,14,12,1
205640,2,7,9,-2,7,1
397811,1,0,0,0,7,0
302555,4,3,16,-13,15,1
99569,1,0,0,0,11,1
1869,4,19,10,9,1,1
185389,2,0,9,-9,15,0
289191,3,20,10,10,9,1
85656,2,24,7,17,5,0
320215,1,7,0,7,6,0
404630,3,13,13,0,10,0
295741,4,10,16,-6,12,0
109591,3,19,14,5,16,0
416816,4,13,10,3,15,1
83304,4,22,17,5,4,1
55614,4,33,14,19,9,1
167510,3,0,3,-3,7,0
326240,3,10,41,-31,9,0
297161,1,0,0,0,13,0
222650,2,7,7,0,14,0
259586,2,0,0,0,13,0
225001,1,0,0,0,15,0
381493,2,14,0,14,17,0
356128,2,7,0,7,5,1
286632,4,17,41,-24,8,1
336922,3,7,21,-14,14,1
202830,1,7,0,7,5,1
94038,3,6,21,-15,9,0
269748,1,7,0,7,1,1
76592,1,7,0,7,1,0
364146,3,31,3,28,9,0
147796,1,0,7,-7,15,1
202523,1,0,3,-3,5,1
51862,2,6,7,-1,7,0
91841,4,24,12,12,8,0
42158,1,0,0,0,2,1
226511,4,14,17,-3,16,0
195313,1,0,0,0,2,1
168583,2,14,10,4,7,0
282408,4,10,23,-13,6,0
392487,2,3,17,-14,4,0
86392,2,7,7,0,5,1
353789,1,0,0,0,4,1
336853,2,7,7,0,14,0
296987,4,29,14,15,13,0
100881,1,0,0,0,12,0
105322,1,0,0,0,14,0
295313,4,14,5,9,12,1
409890,4,30,8,22,12,1
393329,1,6,0,6,5,1
236670,3,10,7,3,3,0
82061,4,17,10,7,3,1
223816,2,9,0,9,15,0
21741,3,24,14,10,11,0
14766,3,31,3,28,7,0
309465,4,17,6,11,1,1
46844,1,10,0,10,5,0
97204,2,6,6,0,10,1
265701,4,12,18,-6,16,0
147234,2,0,21,-21,15,0
328001,2,10,3,7,10,1
242514,4,15,13,2,6,1
155347,2,10,3,7,2,1
118043,4,20,13,7,2,0
351361,2,10,7,3,3,1
56306,3,3,20,-17,9,1
107988,4,6,20,-14,15,1
120003,4,23,31,-8,3,1
395226,3,10,13,-3,5,0
76759,2,17,0,17,1,0
206922,4,10,23,-13,7,1
116391,1,3,0,3,1,0
348904,4,9,21,-12,2,0
179005,4,19,3,16,12,1
241838,2,13,3,10,5,1
407839,1,3,0,3,11,1
343243,3,16,0,16,16,1
165413,3,6,30,-24,6,1
386406,4,20,17,3,2,1
263112,1,0,7,-7,15,1
263037,3,10,3,7,15,1
311528,4,17,13,4,2,0
404062,3,10,35,-25,10,0
107748,2,7,10,-3,15,1
215178,2,7,9,-2,11,0
242142,2,13,7,6,6,1
4847,1,0,0,0,3,1
3995,4,32,20,12,2,0
65837,1,0,0,0,13,1
130076,4,17,30,-13,8,0
113669,4,9,13,-4,17,1
303270,2,13,0,13,16,0
255543,4,30,7,23,12,1
264349,1,0,0,0,15,0
337244,4,16,23,-7,14,1
260771,2,3,6,-3,14,0
803,3,7,6,1,1,0
207369,4,13,21,-8,7,0
226760,3,7,20,-13,16,1
86034,4,25,28,-3,5,0
245525,1,21,0,21,7,1
401961,2,0,9,-9,9,1
134285,1,0,7,-7,10,1
179137,3,9,13,-4,12,1
141223,3,3,24,-21,13,0
288978,2,16,7,9,9,1
344500,2,0,0,0,17,1
359791,4,27,26,1,6,1
89783,1,3,0,3,7,0
295305,4,14,5,9,12,0
260931,2,0,0,0,14,1
399677,4,19,9,10,8,0
310007,3,6,10,-4,2,1
376797,2,14,7,7,15,1
86419,2,20,7,13,5,1
143208,2,7,10,-3,13,1
248376,1,3,0,3,8,1
135460,1,0,0,0,10,0
316096,2,17,12,5,4,0
287539,4,14,40,-26,9,1
189471,3,14,0,14,17,0
10401,4,10,45,-35,5,1
399023,2,10,9,1,7,0
94648,2,17,19,-2,9,0
355296,3,14,14,0,4,0
170803,1,0,0,0,8,0
304440,1,0,7,-7,16,0
132511,1,0,6,-6,9,1
134357,3,23,21,2,10,0
20719,4,24,20,4,10,1
19903,3,13,21,-8,10,1
32041,2,7,10,-3,15,1
4706,4,23,27,-4,2,1
404166,2,9,7,2,10,0
395404,4,28,3,25,5,0
348416,4,13,20,-7,1,0
347012,3,10,3,7,1,0
269739,1,0,0,0,1,1
313500,4,17,17,0,3,1
334608,4,30,31,-1,13,1
310299,2,23,0,23,2,1
246810,3,3,20,-17,8,1
303876,1,0,14,-14,16,1
206604,3,10,13,-3,7,0
22485,3,31,29,2,11,0
228032,2,0,0,0,17,1
387466,4,21,16,5,2,1
37867,1,0,0,0,1,1
77800,2,7,14,-7,1,1
128418,4,14,16,-2,7,0
166071,1,7,0,7,6,0
337077,3,26,0,26,14,0
340340,2,17,7,10,15,0
184847,4,24,20,4,15,0
108422,4,12,21,-9,15,1
188088,2,0,3,-3,16,0
142116,2,0,7,-7,13,0
21480,4,15,17,-2,11,1
143806,3,6,0,6,14,0
170435,3,21,3,18,8,0
95244,2,3,10,-7,10,1
116429,2,3,10,-7,1,1
25080,1,3,0,3,12,1
126796,1,0,6,-6,6,1
388021,3,6,6,0,2,1
93899,3,17,6,11,9,1
144406,2,0,10,-10,14,0
210899,3,12,3,9,9,1
42163,1,6,0,6,2,1
309090,1,9,3,6,1,1
238690,3,16,17,-1,4,0
288670,2,0,7,-7,9,0
41368,3,14,12,2,2,1
169534,3,3,28,-25,8,1
211342,3,10,10,0,9,0
382829,3,21,3,18,17,0
404101,4,13,49,-36,10,0
291053,1,0,0,0,10,0
149123,3,17,17,0,16,0
411806,3,0,34,-34,13,0
13841,1,0,0,0,7,1
112023,4,35,21,14,17,1
382006,3,0,30,-30,17,1
79195,3,20,10,10,2,1
405587,3,14,17,-3,10,0
91377,4,21,7,14,8,1
211389,4,10,13,-3,9,1
310269,2,10,0,10,2,0
350776,3,10,3,7,2,1
319409,1,0,0,0,6,0
270769,4,6,10,-4,1,1
254954,4,38,7,31,12,1
127035,4,24,20,4,6,0
201886,5,31,30,1,5,1
399118,4,16,36,-20,7,1
404188,3,9,9,0,10,0
307000,2,7,0,7,17,1
59953,3,3,24,-21,11,1
44721,2,0,12,-12,3,0
268911,2,6,30,-24,17,1
396256,2,3,3,0,6,0
420207,4,3,10,-7,17,0
158781,2,7,3,4,3,1
416045,3,21,3,18,15,0
270120,3,17,10,7,1,0
146862,3,31,0,31,15,0
225043,2,0,13,-13,15,0
243086,3,0,9,-9,6,1
383277,3,38,17,21,17,1
376998,3,15,16,-1,15,0
405672,1,0,0,0,10,1
304135,4,16,33,-17,16,1
71750,3,17,23,-6,16,0
295825,1,0,0,0,12,0
190687,3,28,14,14,17,0
301487,3,20,9,11,15,0
108022,1,3,0,3,15,1
159627,4,27,20,7,3,0
98347,4,49,35,14,11,0
324057,1,0,0,0,8,0
85599,1,0,0,0,5,1
64655,1,0,0,0,13,1
393357,1,14,7,7,5,0
125718,1,0,7,-7,5,1
225685,4,21,10,11,16,0
69286,3,13,3,10,15,1
219044,3,24,7,17,13,1
323361,2,10,0,10,7,1
409671,2,10,3,7,12,0
339380,1,0,3,-3,15,1
343561,4,13,10,3,16,0
308349,1,0,3,-3,1,1
402963,1,7,7,0,9,0
95555,3,9,10,-1,10,0
2417,3,21,13,8,2,1
119993,4,23,24,-1,3,1
227750,2,3,14,-11,16,0
174067,3,0,33,-33,10,0
197622,4,26,0,26,3,0
343909,1,7,0,7,17,1
341326,1,0,10,-10,16,1
127483,3,3,17,-14,6,1
123701,4,10,32,-22,4,0
203060,3,33,10,23,5,0
170343,4,0,15,-15,8,1
49941,2,14,0,14,6,1
202495,4,9,16,-7,5,1
237857,3,7,27,-20,4,1
208312,2,7,21,-14,8,0
76937,3,14,13,1,1,0
61640,1,0,0,0,12,0
25121,2,10,0,10,12,0
305802,1,0,7,-7,17,1
185933,4,22,23,-1,15,0
350233,4,27,0,27,2,0
315314,1,3,0,3,4,0
318371,1,0,0,0,5,1
105244,3,7,24,-17,14,0
6407,3,9,13,-4,3,0
216742,4,27,9,18,12,0
214871,2,0,9,-9,11,0
403739,2,12,3,9,9,0
178600,1,3,3,0,12,0
32705,3,7,13,-6,15,0
52979,3,14,17,-3,7,1
226165,4,28,20,8,16,0
98829,1,7,0,7,11,1
165667,2,7,7,0,6,0
144107,3,16,0,16,14,0
97997,3,17,10,7,11,0
288941,1,6,0,6,9,1
141233,3,3,24,-21,13,1
322549,1,0,0,0,7,0
337002,2,10,0,10,14,0
102175,2,14,7,7,13,1
25856,2,24,10,14,12,0
271071,4,28,34,-6,1,1
132133,3,10,3,7,9,1
204708,2,7,7,0,6,0
148756,2,13,6,7,16,1
195296,4,23,24,-1,2,1
51856,1,6,0,6,7,0
117470,2,7,14,-7,2,0
266071,2,17,3,14,16,0
222433,1,3,7,-4,14,1
260789,2,3,6,-3,14,1
342921,3,23,17,6,16,1
37952,4,10,14,-4,1,0
321197,4,3,19,-16,6,1
169767,2,0,7,-7,8,0
176691,3,29,19,10,11,1
172003,1,0,0,0,9,0
94768,1,3,3,0,9,1
363954,2,0,6,-6,8,0
195147,1,0,0,0,2,1
28128,4,27,10,17,13,1
159288,4,24,24,0,3,1
1189,1,3,0,3,1,1
251476,1,16,3,13,10,1
283256,2,10,9,1,7,1
138032,2,22,17,5,11,0
326813,3,3,14,-11,9,1
96566,2,0,3,-3,10,1
64856,2,7,0,7,13,0
64215,4,38,6,32,13,0
9055,3,28,13,15,4,0
272743,3,15,3,12,2,0
286199,1,0,0,0,8,1
6370,2,0,13,-13,3,1
417880,3,13,10,3,16,0
135003,4,14,34,-20,10,1
31352,3,7,3,4,15,1
39850,2,6,0,6,1,0
113566,2,0,0,0,17,0
242006,2,7,3,4,5,1
182733,1,0,0,0,14,1
283440,3,20,7,13,7,0
215344,3,14,13,1,11,1
147878,3,3,31,-28,15,1
352204,1,0,3,-3,3,1
252667,3,6,3,3,10,1
49195,2,16,0,16,6,1
150038,4,24,6,18,16,1
119119,2,10,7,3,3,0
121147,1,0,10,-10,3,0
39048,1,0,0,0,1,1
284888,1,0,6,-6,7,0
35728,1,3,0,3,17,0
3587,2,20,14,6,2,0
114305,1,7,6,1,1,0
124517,1,3,0,3,5,1
283071,1,3,0,3,7,0
121349,2,7,0,7,3,1
290587,4,26,20,6,10,0
363813,2,13,10,3,8,0
260958,3,10,0,10,14,0
229851,2,13,0,13,17,0
182342,3,24,10,14,14,0
94019,2,6,21,-15,9,1
28248,3,17,0,17,13,0
335810,1,7,0,7,13,0
217351,3,21,10,11,12,0
66597,2,0,14,-14,14,0
49966,2,21,0,21,6,1
56877,2,14,0,14,9,0
113319,3,16,31,-15,17,1
350917,3,3,14,-11,3,1
7370,1,0,0,0,4,1
407192,4,17,34,-17,11,0
406506,2,0,16,-16,11,1
351436,4,20,16,4,3,0
35050,3,15,10,5,16,0
289920,3,6,3,3,10,0
358153,3,17,6,11,6,0
225626,2,0,10,-10,16,1
345425,3,0,13,-13,17,0
109535,1,0,7,-7,16,0
257930,1,0,0,0,13,0
234972,3,13,3,10,2,0
157600,3,12,0,12,2,0
357653,1,6,0,6,5,0
339980,2,7,3,4,15,1
240164,3,16,3,13,5,1
63033,3,16,21,-5,12,1
234062,3,20,0,20,2,0
146652,2,7,23,-16,15,1
179443,4,13,20,-7,12,0
235736,3,3,20,-17,3,1
81261,3,10,7,3,3,1
347034,4,24,17,7,1,1
124421,3,6,7,-1,5,1
210865,2,6,3,3,9,1
351252,4,28,17,11,3,0
279945,1,0,10,-10,5,1
272339,1,14,0,14,2,1
222661,3,14,17,-3,14,0
38803,2,3,10,-7,1,1
316262,2,7,16,-9,4,0
175011,3,13,28,-15,10,0
317589,1,3,0,3,5,0
81276,3,10,7,3,3,0
204047,4,16,14,2,6,0
417280,4,20,23,-3,16,0
327521,2,7,7,0,10,0
129090,3,20,21,-1,7,1
184071,2,6,0,6,14,0
338037,2,0,0,0,14,0
294775,1,7,7,0,12,0
202322,3,13,3,10,5,0
323909,1,7,0,7,8,1
84281,2,7,21,-14,4,1
242462,2,3,7,-4,6,0
335571,2,6,7,-1,13,1
358423,3,22,13,9,6,1
74794,2,6,3,3,17,0
155489,1,7,0,7,2,0
817,3,13,6,7,1,1
42212,2,17,0,17,2,0
335376,1,0,0,0,13,0
26077,1,0,10,-10,13,1
95014,4,13,16,-3,9,0
94798,2,3,6,-3,9,0
176276,1,0,7,-7,11,0
296239,4,28,26,2,13,0
48822,1,3,0,3,5,1
154332,3,20,17,3,1,1
357361,1,7,7,0,5,1
395897,1,0,0,0,6,1
30643,4,24,9,15,14,0
200020,3,24,17,7,4,1
8435,1,3,0,3,4,1
173611,2,6,13,-7,10,1
222449,1,3,7,-4,14,1
206170,1,0,0,0,7,0
181219,2,0,0,0,13,0
213022,1,10,0,10,10,1
304990,4,16,20,-4,16,1
199087,2,7,21,-14,4,0
300244,1,0,0,0,14,1
61463,4,24,17,7,11,0
48686,2,7,10,-3,5,0
236720,4,30,7,23,3,1
405978,4,14,7,7,11,1
32410,3,31,6,25,15,0
183351,1,7,3,4,14,1
123950,3,10,0,10,5,1
36372,3,13,19,-6,17,1
130073,3,17,30,-13,8,0
237233,3,13,0,13,3,0
11768,1,0,0,0,6,1
38788,2,3,10,-7,1,0
295321,4,14,5,9,12,0
136046,4,6,10,-4,10,0
77874,4,17,31,-14,1,0
307518,4,38,19,19,17,1
287574,1,0,0,0,9,0
44018,4,3,28,-25,3,0
315799,2,0,13,-13,4,1
55850,3,7,14,-7,9,1
331519,1,0,0,0,11,0
69473,4,24,10,14,15,1
222766,2,10,7,3,14,0
127489,3,3,20,-17,6,1
228092,4,3,10,-7,17,1
104925,3,3,6,-3,14,1
204863,2,3,3,0,6,0
379002,2,7,3,4,15,0
288638,1,0,0,0,9,1
327643,1,0,0,0,10,0
31678,4,24,16,8,15,0
383574,4,21,21,0,17,0
140871,2,17,0,17,13,0
83820,2,10,3,7,4,0
24736,4,20,14,6,12,0
100185,2,14,0,14,12,0
46519,4,37,6,31,4,1
366549,2,20,7,13,10,1
404175,2,9,7,2,10,1
310363,4,29,0,29,2,1
297481,1,0,0,0,13,1
108736,4,44,13,31,15,0
91543,4,26,10,16,8,0
340520,3,0,40,-40,15,1
44998,2,10,3,7,4,1
294395,3,16,9,7,12,1
40682,1,0,0,0,2,0
406872,4,20,23,-3,11,1
36595,1,3,0,3,17,1
83025,1,0,0,0,4,1
144941,4,20,7,13,14,0
80700,4,32,26,6,3,0
272225,2,6,0,6,2,0
110545,1,0,0,0,16,1
92397,2,10,7,3,8,1
293997,1,0,0,0,12,1
223743,4,40,13,27,15,0
475,1,0,6,-6,1,1
375795,3,20,0,20,14,0
36126,4,44,7,37,17,0
28229,2,17,0,17,13,0
279527,2,10,6,4,5,1
280802,1,7,0,7,6,0
331399,1,3,7,-4,11,1
211529,3,36,14,22,9,0
233006,4,17,10,7,2,0
295904,3,10,17,-7,12,1
335825,1,7,7,0,13,1
271554,2,7,6,1,2,1
365836,1,7,0,7,9,0
344756,1,0,0,0,17,1
249865,2,6,17,-11,9,1
96602,2,3,3,0,10,0
388030,3,12,6,6,2,1
374410,2,15,0,15,14,0
415569,2,7,7,0,15,1
156979,3,7,13,-6,2,0
85309,2,14,3,11,5,1
297017,1,7,0,7,13,0
102323,3,13,10,3,13,0
60626,1,0,3,-3,11,1
104168,4,27,27,0,13,0
360803,4,24,30,-6,7,1
376445,4,23,23,0,14,1
343704,4,18,10,8,17,0
401896,4,17,28,-11,9,0
372703,1,0,0,0,13,1
415727,2,14,10,4,15,0
357455,4,31,33,-2,5,1
45039,3,23,10,13,4,0
281438,2,0,10,-10,6,0
135130,4,31,6,25,10,0
55004,4,19,10,9,8,1
260538,3,27,8,19,14,1
92453,4,20,10,10,8,1
354510,3,27,28,-1,4,0
216131,1,0,0,0,12,1
70324,3,10,23,-13,15,0
333650,2,0,0,0,12,1
3182,4,13,9,4,2,1
282360,2,7,13,-6,6,1
128545,4,21,35,-14,7,1
115874,3,7,16,-9,1,0
23982,4,23,6,17,12,1
135723,4,17,29,-12,10,0
256435,3,12,21,-9,12,0
45997,1,0,7,-7,4,1
223631,1,6,3,3,15,1
62377,1,0,7,-7,12,0
169616,2,6,0,6,8,1
414059,4,10,45,-35,14,0
408640,3,28,10,18,12,1
229886,3,20,14,6,17,1
417706,4,35,12,23,16,0
71338,3,10,20,-10,16,1
324305,3,25,7,18,8,0
369990,2,7,7,0,12,1
299429,3,0,20,-20,14,1
274203,2,10,0,10,3,0
256120,2,14,16,-2,12,1
193027,1,0,0,0,1,1
357564,3,10,13,-3,5,1
49873,4,28,17,11,6,0
21270,2,3,7,-4,11,0
371144,2,0,9,-9,12,0
2355,1,0,3,-3,2,1
190926,2,6,0,6,17,0
337155,2,3,0,3,14,0
92200,4,10,43,-33,8,1
74957,2,17,10,7,17,0
318646,4,10,13,-3,5,0
348511,2,21,7,14,2,1
14309,3,2,7,-5,7,0
33973,3,10,27,-17,16,0
200032,4,24,20,4,4,0
59494,3,6,20,-14,11,0
91465,2,9,0,9,8,1
94191,3,17,7,10,9,0
65376,1,0,0,0,13,0
135657,2,7,10,-3,10,1
273021,3,6,3,3,2,0
280483,4,34,31,3,5,1
298512,2,10,0,10,14,1
179557,2,0,23,-23,12,1
322292,1,7,0,7,7,1
293471,1,0,3,-3,11,1
222977,3,13,13,0,14,1
355389,2,3,3,0,4,0
291901,3,17,10,7,11,0
308173,4,16,28,-12,1,1
414829,2,13,7,6,15,1
389233,3,28,7,21,3,0
333416,4,23,13,10,12,1
240187,3,16,6,10,5,1
209314,1,0,7,-7,8,1
369928,4,16,22,-6,12,1
162267,4,30,20,10,4,0
255221,3,13,14,-1,12,1
178525,3,16,13,3,12,0
365613,3,35,24,11,9,0
392110,1,0,0,0,4,0
197207,4,37,27,10,3,0
342324,4,20,6,14,16,1
181436,3,24,24,0,13,0
171620,2,6,10,-4,9,1
135946,1,0,3,-3,10,0
373530,2,7,19,-12,13,0
73472,2,0,14,-14,17,1
400792,2,14,7,7,8,1
295374,2,10,3,7,12,1
364499,1,0,0,0,9,0
401001,4,22,15,7,8,1
41422,1,2,0,2,2,0
67819,1,0,3,-3,14,1
256243,2,6,7,-1,12,0
306494,4,17,17,0,17,0
338015,1,0,0,0,14,0
84249,1,0,7,-7,4,0
206705,2,0,14,-14,7,0
319373,4,23,28,-5,6,0
300854,1,0,7,-7,15,0
263826,4,7,24,-17,15,1
62348,4,24,22,2,12,1
28692,3,3,10,-7,14,1
284149,2,3,13,-10,7,1
138778,2,0,7,-7,12,1
57706,4,24,24,0,10,0
344590,4,0,6,-6,17,0
49563,4,14,3,11,6,1
206811,1,0,0,0,7,0
382065,1,7,0,7,17,0
347627,2,17,10,7,1,1
359385,4,13,20,-7,6,0
308702,2,7,6,1,1,1
17990,3,16,21,-5,9,1
232594,1,0,0,0,1,0
273013,2,6,3,3,2,0
416851,1,0,0,0,15,0
333705,3,21,0,21,12,1
169373,3,6,14,-8,8,0
71413,2,17,0,17,16,1
333915,1,0,7,-7,12,0
225281,1,0,7,-7,15,0
284713,1,0,6,-6,7,0
263744,2,0,0,0,15,0
396116,2,17,16,1,6,0
79955,4,13,23,-10,2,0
90175,3,3,0,3,7,1
315250,4,20,16,4,4,1
410975,1,0,7,-7,13,1
83887,4,23,17,6,4,0
895,1,0,0,0,1,1
107028,2,10,0,10,15,1
266784,3,3,14,-11,16,1
318211,4,22,27,-5,5,0
100144,1,0,0,0,12,1
281959,2,14,14,0,6,0
43870,4,27,16,11,3,1
259791,4,20,13,7,14,0
137513,2,13,14,-1,11,1
331607,3,20,30,-10,11,1
391307,3,17,3,14,4,1
247387,2,3,6,-3,8,0
145213,4,49,0,49,14,0
294174,1,0,7,-7,12,0
399852,1,0,0,0,8,1
342744,3,0,7,-7,16,0
119222,1,0,3,-3,3,1
267099,2,9,3,6,17,1
61355,1,0,0,0,11,1
163567,2,7,16,-9,5,1
40415,1,0,7,-7,2,0
277028,1,0,0,0,4,1
127872,1,0,0,0,6,1
232689,4,10,0,10,1,0
421126,3,27,13,14,17,0
303583,2,21,13,8,16,1
227899,2,20,6,14,16,0
77878,4,17,31,-14,1,1
416380,4,16,12,4,15,0
61817,2,0,17,-17,12,1
387135,3,10,31,-21,2,0
142286,2,0,0,0,13,0
151661,4,23,27,-4,17,0
72321,2,0,13,-13,16,0
280698,2,0,3,-3,5,0
291397,2,7,7,0,10,1
108217,2,6,0,6,15,1
219723,4,13,14,-1,13,1
332299,2,3,6,-3,12,1
357734,3,40,13,27,5,0
67872,2,6,3,3,14,1
287577,1,0,0,0,9,0
400173,1,0,0,0,8,0
273656,3,13,13,0,2,1
54293,1,0,2,-2,8,1
190931,2,6,0,6,17,1
163392,2,0,6,-6,5,1
138072,4,42,17,25,11,0
250588,1,0,0,0,10,1
143,4,10,10,0,1,0
53780,5,10,10,0,8,1
127339,3,10,20,-10,6,0
148393,1,0,0,0,16,1
145201,4,49,0,49,14,1
374795,1,7,0,7,14,0
164792,4,26,21,5,6,1
283018,3,21,3,18,6,0
131843,2,17,7,10,8,1
351292,1,0,0,0,3,0
74730,4,13,17,-4,17,1
90841,1,14,0,14,7,0
338078,3,0,7,-7,14,1
56373,1,0,0,0,9,0
419391,1,0,0,0,16,1
4297,1,0,0,0,2,1
48346,1,0,0,0,5,0
90834,1,7,0,7,7,1
321966,4,28,28,0,7,1
308722,3,7,13,-6,1,1
114049,2,14,0,14,17,1
332946,4,31,3,28,12,0
296949,3,29,0,29,13,0
310274,2,10,0,10,2,1
7576,2,14,0,14,4,0
51639,3,27,20,7,7,0
9440,2,10,0,10,5,0
158871,4,23,3,20,3,1
255074,3,6,21,-15,12,0
110362,4,20,17,3,16,0
264518,1,7,7,0,16,1
289064,4,35,28,7,9,1
402871,3,17,6,11,9,1
120509,5,42,41,1,3,0
329475,2,3,0,3,10,1
27476,2,17,0,17,13,0
316429,2,16,10,6,4,1
345649,1,7,0,7,17,0
381787,2,0,0,0,17,0
92265,2,10,0,10,8,1
328972,3,29,7,22,10,1
130108,4,17,36,-19,8,1
403457,2,17,9,8,9,0
256527,1,0,0,0,12,1
353665,2,3,0,3,4,1
377244,2,7,3,4,15,1
345081,2,6,3,3,17,0
301005,1,3,3,0,15,1
150131,2,3,13,-10,16,1
231907,3,7,34,-27,1,0
322099,4,26,0,26,7,1
55916,1,0,0,0,9,1
267575,4,27,27,0,17,0
327013,4,2,10,-8,9,1
305501,1,6,0,6,17,0
216151,1,7,0,7,12,0
148441,2,7,3,4,16,1
278375,4,17,21,-4,4,0
231028,3,17,0,17,1,1
368659,1,0,9,-9,11,0
256218,1,6,0,6,12,0
111945,2,7,21,-14,17,1
117056,3,0,17,-17,2,1
403084,4,34,27,7,9,0
315661,2,10,7,3,4,0
85735,1,0,0,0,5,1
112327,4,45,17,28,17,1
119819,4,24,16,8,3,0
294031,2,7,7,0,12,0
330926,5,31,31,0,11,1
393528,2,7,6,1,5,0
376033,1,0,0,0,14,0
114529,3,17,34,-17,1,0
228621,2,10,14,-4,17,0
57666,3,17,17,0,10,1
274851,2,0,10,-10,3,1
258415,3,21,13,8,13,1
25296,3,34,14,20,12,1
64407,1,0,3,-3,13,0
151747,2,7,6,1,17,1
366166,3,7,38,-31,10,0
196819,2,0,10,-10,3,0
294769,1,0,7,-7,12,1
353282,3,28,20,8,4,1
418992,2,7,7,0,16,1
80193,3,14,10,4,2,1
276458,1,10,7,3,4,0
296689,4,10,16,-6,13,1
45153,2,7,7,0,4,0
51274,1,6,0,6,7,0
46135,1,0,7,-7,4,1
140474,3,14,26,-12,12,1
297268,4,24,6,18,13,0
26776,3,6,33,-27,13,1
354028,2,12,0,12,4,1
373154,1,0,0,0,13,1
21381,1,3,7,-4,11,1
372393,1,6,0,6,13,1
381435,4,23,7,16,16,0
414120,2,10,10,0,14,0
188167,4,17,10,7,16,0
209166,1,0,7,-7,8,1
292681,4,22,16,6,11,0
99399,4,23,17,6,11,1
266958,3,16,10,6,17,1
172696,2,14,3,11,9,0
18826,1,3,0,3,9,1
347369,4,21,21,0,1,1
418929,4,27,17,10,16,1
185405,3,7,10,-3,15,0
363705,3,8,13,-5,8,1
162104,4,48,13,35,4,0
211393,4,10,13,-3,9,0
405983,4,21,7,14,11,0
340914,2,0,10,-10,15,1
237355,2,6,7,-1,3,0
278496,3,36,0,36,4,1
257177,1,0,9,-9,12,1
257045,2,7,14,-7,12,0
202711,2,6,10,-4,5,0
336558,2,0,0,0,14,1
411358,4,20,10,10,13,0
406599,4,20,37,-17,11,0
263365,4,31,10,21,15,0
58055,1,7,10,-3,10,0
64343,3,12,20,-8,13,1
3592,2,20,14,6,2,0
421505,2,3,3,0,17,0
131718,3,24,22,2,8,0
99460,2,0,3,-3,11,0
373542,3,10,19,-9,13,0
313988,1,0,0,0,3,1
49868,4,21,17,4,6,0
155050,2,6,12,-6,1,0
278667,3,17,3,14,4,1
92496,1,0,0,0,8,0
127222,4,16,16,0,6,0
343926,2,7,0,7,17,1
117589,1,0,0,0,2,0
205176,2,7,10,-3,6,1
58525,2,7,3,4,10,1
223295,4,3,12,-9,15,1
224199,4,0,23,-23,15,0
369295,3,14,17,-3,11,1
129587,3,13,20,-7,7,1
362745,1,0,0,0,8,0
9948,3,3,3,0,5,1
320542,2,14,0,14,6,1
85691,4,24,21,3,5,1
340938,3,7,10,-3,15,0
21893,3,28,0,28,11,0
159773,4,7,13,-6,3,1
352138,3,9,20,-11,3,1
364273,3,3,26,-23,9,1
285750,2,7,10,-3,8,0
119796,3,17,6,11,3,1
281406,1,0,0,0,6,0
15146,1,0,0,0,8,0
59580,1,0,3,-3,11,0
100684,3,21,21,0,12,0
384842,2,6,10,-4,1,0
290617,1,14,0,14,10,1
387341,1,7,0,7,2,1
205341,2,20,0,20,6,0
32898,4,26,7,19,15,0
211890,4,36,17,19,9,0
353230,2,7,10,-3,4,1
210765,3,21,10,11,9,1
63231,4,17,26,-9,12,0
121401,4,7,6,1,3,0
390341,1,7,7,0,3,0
211585,4,42,21,21,9,1
87255,2,10,14,-4,6,1
183185,1,0,0,0,14,0
271485,4,14,0,14,1,1
351477,1,0,17,-17,3,1
167800,1,0,6,-6,7,0
235795,1,0,0,0,3,0
391966,1,0,0,0,4,0
273872,1,0,0,0,2,0
96259,1,0,6,-6,10,0
185007,4,14,29,-15,15,1
168813,1,7,0,7,7,1
280869,3,13,3,10,6,1
213560,4,10,14,-4,10,1
113007,2,10,10,0,17,1
292839,1,0,0,0,11,1
361523,3,10,7,3,7,0
91836,4,24,6,18,8,0
186027,2,17,34,-17,15,0
317244,4,7,16,-9,5,0
143740,1,0,0,0,14,0
296057,3,3,7,-4,13,1
145016,2,6,3,3,14,1
135184,1,10,0,10,10,1
323973,3,17,13,4,8,0
222689,4,14,24,-10,14,1
16621,2,7,27,-20,8,1
373350,2,7,0,7,13,0
147309,4,7,31,-24,15,1
238368,3,10,16,-6,4,1
104710,1,0,6,-6,14,1
208822,4,6,22,-16,8,0
86652,1,7,0,7,5,0
36013,1,7,0,7,17,0
120838,2,7,14,-7,3,0
360582,2,7,10,-3,7,0
131976,2,0,10,-10,8,0
258221,1,0,0,0,13,0
64768,4,28,7,21,13,0
299022,4,16,18,-2,14,0
133529,4,30,20,10,9,1
56385,1,0,7,-7,9,0
98180,4,27,19,8,11,1
37774,2,7,3,4,1,1
64189,3,31,6,25,13,1
244809,2,7,3,4,7,0
257016,2,0,7,-7,12,1
415073,4,13,34,-21,15,0
213254,4,17,16,1,10,0
96761,3,7,10,-3,10,1
205862,4,20,0,20,7,1
119655,4,17,12,5,3,0
122202,4,30,28,2,4,1
201464,2,12,0,12,5,0
332003,2,0,3,-3,12,0
319653,3,24,3,21,6,0
248538,5,23,26,-3,8,0
226297,3,16,7,9,16,1
273180,3,24,0,24,2,0
24368,2,3,0,3,12,1
255178,2,7,0,7,12,0
70065,4,31,17,14,15,1
101419,3,15,7,8,12,0
290019,2,7,0,7,10,1
387755,4,0,37,-37,2,1
55778,1,0,0,0,9,0
218249,1,0,7,-7,12,1
420505,3,3,35,-32,17,1
28669,2,3,7,-4,14,0
278444,2,22,0,22,4,1
48475,4,27,27,0,5,0
90981,1,3,0,3,7,1
192352,4,27,27,0,1,1
134597,2,17,10,7,10,1
184424,4,24,6,18,14,1
376788,2,14,0,14,15,0
263122,1,0,7,-7,15,1
44254,2,17,13,4,3,0
234099,4,27,14,13,2,0
167706,3,23,20,3,7,0
267628,1,0,0,0,17,0
12486,1,0,0,0,6,0
208183,3,0,3,-3,8,1
124402,2,6,0,6,5,1
69248,2,6,0,6,15,0
146456,4,24,3,21,15,1
314876,2,0,0,0,4,1
147476,4,36,10,26,15,1
367349,1,0,0,0,10,0
97209,2,9,6,3,10,1
153210,1,2,0,2,1,1
359676,4,40,7,33,6,1
158129,1,0,0,0,3,0
382714,4,3,13,-10,17,0
265525,4,14,10,4,16,1
347309,3,7,20,-13,1,0
247039,1,0,0,0,8,0
164123,4,22,6,16,5,0
216706,3,24,6,18,12,0
185709,2,17,3,14,15,0
403794,4,15,23,-8,9,1
256011,4,19,12,7,12,1
318078,1,9,0,9,5,0
403409,1,6,0,6,9,1
116896,3,7,10,-3,2,0
1936,2,0,0,0,1,1
10908,2,6,7,-1,5,0
376661,2,3,0,3,14,1
307850,4,27,28,-1,1,0
290177,2,3,0,3,10,0
371058,3,10,13,-3,12,1
240739,2,0,7,-7,5,0
33216,2,10,0,10,16,1
96789,4,7,16,-9,10,0
123968,3,10,7,3,5,1
151716,1,7,0,7,17,0
405953,3,14,7,7,11,1
155539,2,20,3,17,2,1
154350,4,27,24,3,1,1
73663,3,13,0,13,17,0
267252,2,10,14,-4,17,1
70617,3,17,17,0,15,1
311357,3,21,10,11,2,0
255978,3,9,12,-3,12,1
205169,2,7,10,-3,6,0
113594,2,6,0,6,17,0
233965,4,24,19,5,2,1
109150,3,31,7,24,15,0
232506,3,20,3,17,1,0
25326,4,39,14,25,12,1
199533,2,17,3,14,4,1
217228,4,12,22,-10,12,1
115606,4,30,9,21,1,0
105947,1,7,0,7,14,1
289965,4,6,6,0,10,0
354396,4,45,10,35,4,1
88853,4,13,16,-3,6,1
411025,2,17,14,3,13,0
280704,2,0,6,-6,5,1
116289,2,17,3,14,1,0
194230,4,18,17,1,1,0
199088,2,7,21,-14,4,0
57153,2,7,0,7,10,0
48934,4,15,13,2,5,1
418458,3,17,3,14,16,0
147348,1,0,0,0,15,1
245100,2,14,6,8,7,1
405867,1,7,0,7,11,1
337549,4,7,33,-26,14,0
385828,4,30,3,27,1,1
192529,4,14,17,-3,1,1
179153,4,12,13,-1,12,0
410126,3,17,10,7,13,1
356819,2,0,7,-7,5,1
57889,1,3,3,0,10,1
416025,2,7,3,4,15,1
66609,2,0,14,-14,14,0
402076,1,0,0,0,9,1
410509,1,0,0,0,13,1
294012,1,0,0,0,12,1
53738,4,7,3,4,8,1
273564,1,0,0,0,2,0
18243,1,0,14,-14,9,0
30810,1,0,0,0,15,0
323882,4,16,30,-14,8,1
304150,1,0,0,0,16,0
290964,2,17,10,7,10,1
323492,2,3,10,-7,7,1
126489,2,0,6,-6,6,1
70559,1,0,7,-7,15,0
348365,2,10,10,0,1,1
393572,3,7,12,-5,5,0
284518,4,24,15,9,7,0
52525,3,10,0,10,7,1
272054,2,10,3,7,2,0
47082,4,24,10,14,5,1
255980,3,15,12,3,12,1
153730,3,2,21,-19,1,1
416313,2,10,3,7,15,1
114565,4,17,40,-23,1,1
242519,4,18,13,5,6,0
72590,1,0,0,0,16,1
277814,1,7,7,0,4,1
218883,2,21,10,11,13,1
241602,4,6,27,-21,5,0
414952,1,7,7,0,15,1
270920,4,19,20,-1,1,0
71609,3,3,24,-21,16,0
108330,1,0,7,-7,15,0
108135,4,13,42,-29,15,0
62786,4,17,0,17,12,1
241920,4,23,20,3,5,0
288873,3,10,24,-14,9,1
42407,4,14,19,-5,2,1
290318,1,0,0,0,10,1
392367,3,20,28,-8,4,0
321861,2,7,14,-7,7,1
88827,4,13,13,0,6,1
244325,1,0,7,-7,7,0
22187,3,10,15,-5,11,0
316884,2,9,2,7,4,0
244531,3,25,13,12,7,1
198605,2,0,0,0,3,0
109671,1,0,0,0,16,1
396964,1,7,0,7,6,0
275484,3,20,17,3,3,1
38783,2,0,10,-10,1,1
167982,2,0,14,-14,7,1
386171,2,3,3,0,2,0
234917,1,10,0,10,2,0
263505,3,20,23,-3,15,0
171492,3,14,10,4,9,1
338057,2,0,7,-7,14,0
223136,4,40,24,16,14,0
360032,2,3,26,-23,7,0
218782,4,3,16,-13,13,0
339903,3,26,0,26,15,1
328935,3,9,7,2,10,1
403988,1,0,7,-7,10,0
326086,3,30,3,27,9,1
348868,3,6,14,-8,2,0
378227,1,0,0,0,15,1
294115,4,14,27,-13,12,0
309095,1,9,3,6,1,0
5955,3,17,23,-6,3,0
135986,2,3,10,-7,10,0
238396,4,17,30,-13,4,0
232305,2,3,3,0,1,0
336848,1,7,7,0,14,0
249319,1,3,0,3,9,1
359217,4,28,28,0,6,0
169450,1,0,0,0,8,0
386060,3,14,0,14,1,0
344386,2,21,14,7,17,0
9565,5,20,20,0,5,0
176761,1,0,0,0,11,1
71117,1,12,0,12,16,0
175343,1,7,0,7,11,0
314609,2,7,0,7,3,0
90673,4,27,33,-6,7,0
348530,2,28,7,21,2,1
49669,3,7,14,-7,6,1
78929,4,20,17,3,2,1
71919,3,15,13,2,16,1
260579,4,30,8,22,14,0
342920,3,23,17,6,16,1
111510,2,7,0,7,16,0
2688,2,6,7,-1,2,0
32473,1,7,3,4,15,0
291352,1,0,0,0,10,1
222112,4,34,17,17,14,0
117352,3,21,0,21,2,1
1903,1,0,0,0,1,1
414572,3,21,9,12,14,1
28428,4,13,6,7,14,1
244626,1,0,10,-10,7,1
196806,2,0,7,-7,3,0
315881,4,9,19,-10,4,0
228154,1,7,10,-3,17,0
163081,1,0,12,-12,5,0
48118,2,7,6,1,5,1
127735,1,0,7,-7,6,1
173925,3,13,16,-3,10,0
345862,2,3,7,-4,17,0
106800,4,27,22,5,14,0
401471,4,27,10,17,8,1
158314,2,6,14,-8,3,1
122380,1,0,10,-10,4,1
294129,4,14,27,-13,12,1
149099,3,14,17,-3,16,1
351430,4,20,16,4,3,0
408256,1,0,0,0,12,1
282005,4,21,28,-7,6,1
75057,1,0,0,0,17,1
54269,4,0,6,-6,8,1
17257,4,7,34,-27,9,1
400284,4,24,9,15,8,0
179264,3,26,3,23,12,1
387792,1,3,0,3,2,0
303079,1,0,7,-7,16,1
160876,4,34,27,7,4,0
417340,2,10,3,7,16,1
256251,2,6,7,-1,12,0
41608,2,7,0,7,2,1
17513,2,13,0,13,9,0
212371,4,13,16,-3,10,0
315946,2,0,7,-7,4,0
155583,4,23,10,13,2,0
123862,4,17,3,14,5,0
129378,2,16,7,9,7,1
413709,2,14,13,1,14,0
166705,2,7,3,4,6,1
290176,1,3,0,3,10,0
217202,4,12,19,-7,12,0
86880,4,9,23,-14,5,0
166072,1,7,0,7,6,0
368790,1,0,0,0,11,0
368729,3,7,16,-9,11,1
415078,1,0,0,0,15,0
110158,3,13,17,-4,16,1
237011,1,0,7,-7,3,1
160594,1,0,0,0,4,1
245861,2,3,23,-20,7,0
103066,2,21,7,14,13,1
366323,4,28,10,18,10,0
153273,3,2,7,-5,1,1
331557,2,7,20,-13,11,1
379722,2,6,0,6,16,1
381201,2,7,10,-3,16,1
296886,2,10,0,10,13,0
112332,4,45,17,28,17,0
303755,2,17,10,7,16,0
330852,3,13,17,-4,11,0
22275,2,0,3,-3,11,1
340885,1,0,3,-3,15,0
89950,2,2,7,-5,7,0
235168,4,7,17,-10,2,1
402146,3,12,0,12,9,1
258711,2,0,20,-20,13,1
69454,3,24,10,14,15,1
374343,4,28,13,15,13,0
372257,1,10,7,3,13,1
156098,1,7,0,7,2,0
170413,2,14,3,11,8,1
94562,4,10,10,0,9,1
217895,3,17,21,-4,12,0
402605,3,17,16,1,9,0
40806,4,17,28,-11,2,0
144549,2,7,16,-9,14,1
103931,2,3,0,3,13,1
334867,3,24,3,21,13,0
407204,1,0,3,-3,11,0
123591,1,0,0,0,4,0
285022,1,0,0,0,7,0
232442,1,3,0,3,1,0
148663,4,10,9,1,16,1
159840,2,14,0,14,3,0
146621,1,0,7,-7,15,1
410596,3,17,13,4,13,0
82014,2,7,0,7,3,1
289033,3,26,21,5,9,0
309718,3,19,6,13,1,0
149839,2,3,13,-10,16,1
267345,1,0,7,-7,17,1
311462,2,3,3,0,2,1
380350,2,7,7,0,16,1
331408,1,6,7,-1,11,1
177336,1,3,0,3,11,0
61181,4,0,21,-21,11,0
83477,1,0,0,0,4,0
131795,1,0,0,0,8,1
29422,2,0,14,-14,14,1
352044,1,0,0,0,3,1
358499,1,0,0,0,6,0
376513,2,6,3,3,14,0
156546,4,14,6,8,2,1
317271,4,7,16,-9,5,1
6766,1,0,0,0,3,1
255774,2,9,0,9,12,1
53064,1,10,7,3,7,1
47091,4,24,10,14,5,1
266881,1,0,0,0,17,1
118003,3,20,6,14,2,0
154621,3,21,14,7,1,0
328312,2,3,14,-11,10,0
353326,4,38,31,7,4,0
273374,4,35,7,28,2,1
146311,1,0,0,0,15,0
25252,2,14,7,7,12,0
270031,1,0,0,0,1,0
84309,3,14,27,-13,4,0
135839,3,7,14,-7,10,0
182752,1,3,0,3,14,1
270179,4,34,35,-1,1,1
372062,4,13,10,3,13,1
292755,2,19,17,2,11,1
31684,4,24,16,8,15,0
372917,2,19,0,19,13,1
67813,1,0,0,0,14,0
44604,3,17,21,-4,3,1
77098,3,7,17,-10,1,1
416942,3,10,7,3,15,1
192410,1,0,14,-14,1,0
8423,1,0,0,0,4,1
131053,1,7,0,7,8,1
138938,2,7,3,4,12,0
306751,3,10,20,-10,17,0
174213,3,3,23,-20,10,0
358918,4,14,35,-21,6,0
341641,2,3,3,0,16,1
174699,3,9,7,2,10,1
40842,1,0,0,0,2,1
262245,1,3,0,3,15,0
367381,2,10,14,-4,10,0
392209,3,10,13,-3,4,0
254090,1,0,0,0,11,1
151252,4,24,26,-2,17,0
405836,5,24,24,0,10,1
272857,2,20,7,13,2,1
361539,4,10,7,3,7,1
72263,4,27,24,3,16,1
191095,2,7,10,-3,17,0
293008,1,3,6,-3,11,0
175547,3,20,0,20,11,1
144716,2,3,0,3,14,0
347548,4,28,37,-9,1,1
362683,3,3,10,-7,8,0
237938,1,0,0,0,4,0
273105,1,0,0,0,2,1
124352,1,0,0,0,5,0
20683,3,17,17,0,10,0
317545,4,10,27,-17,5,0
18820,1,3,0,3,9,0
14266,2,0,7,-7,7,1
186409,1,3,0,3,15,0
149798,1,3,7,-4,16,1
255925,2,6,3,3,12,0
334451,4,17,10,7,13,0
363229,2,14,7,7,8,1
327333,4,16,27,-11,9,1
293394,3,16,10,6,11,0
142549,1,0,0,0,13,1
241918,4,20,20,0,5,1
42479,2,0,12,-12,3,1
141889,4,27,21,6,13,1
390154,4,20,35,-15,3,0
412279,1,0,0,0,13,0
378744,3,14,7,7,15,1
187025,1,0,0,0,16,0
229904,4,20,14,6,17,1
148505,4,24,3,21,16,0
210488,4,9,14,-5,9,0
89559,3,0,27,-27,7,1
119922,2,6,14,-8,3,0
358620,4,27,9,18,6,0
134084,4,27,13,14,9,0
170671,1,0,3,-3,8,0
131431,4,7,19,-12,8,0
169428,4,13,31,-18,8,1
116761,3,13,26,-13,2,1
236908,2,19,0,19,3,1
414702,2,3,16,-13,14,0
251036,1,0,0,0,10,0
64826,1,0,0,0,13,1
334747,4,25,9,16,13,0
76715,4,16,14,2,1,1
373423,4,10,17,-7,13,1
180078,4,28,20,8,13,1
209994,2,7,3,4,8,0
289358,4,28,25,3,9,1
193,2,3,10,-7,1,1
165392,3,6,17,-11,6,0
357966,2,21,6,15,6,0
48438,3,17,17,0,5,1
185033,1,0,0,0,15,0
275525,4,26,36,-10,3,1
122191,4,27,28,-1,4,0
280727,3,7,6,1,5,1
374404,2,15,0,15,14,1
61500,1,6,7,-1,11,1
319447,2,0,3,-3,6,0
341948,2,6,0,6,16,1
111476,1,7,0,7,16,0
256237,2,6,7,-1,12,1
50140,3,0,17,-17,6,1
368166,3,13,21,-8,11,1
274193,1,10,0,10,3,0
24762,4,20,34,-14,12,1
386621,2,7,7,0,2,0
47700,3,3,17,-14,5,1
3694,1,0,0,0,2,1
314695,4,17,28,-11,3,0
180170,3,10,0,10,13,1
65040,3,3,17,-14,13,0
81442,4,10,13,-3,3,1
251757,4,30,9,21,10,0
318375,1,6,0,6,5,1
233915,3,14,13,1,2,1
12618,4,3,27,-24,6,0
67443,2,10,7,3,14,1
82952,3,6,16,-10,4,0
196313,4,24,17,7,2,0
9612,2,6,14,-8,5,1
374159,3,23,7,16,13,0
300826,4,13,33,-20,15,0
291307,3,21,22,-1,10,1
302401,4,16,16,0,15,1
148488,3,24,3,21,16,0
144845,2,14,0,14,14,0
90664,4,27,33,-6,7,1
192053,4,31,27,4,1,0
3229,1,0,0,0,2,0
162926,1,3,0,3,5,1
264224,2,3,7,-4,15,0
21430,2,12,14,-2,11,1
182161,2,26,7,19,13,0
283397,2,13,7,6,7,0
26307,3,19,21,-2,13,0
361875,1,0,0,0,7,0
181750,3,7,14,-7,13,1
362008,1,0,0,0,8,0
302392,4,16,13,3,15,1
323458,1,0,3,-3,7,1
141037,3,7,10,-3,13,0
378011,2,0,7,-7,15,1
339760,3,24,6,18,15,1
420975,3,7,21,-14,17,1
9237,4,9,30,-21,5,1
125473,3,13,0,13,5,1
224744,2,5,0,5,15,0
67323,2,14,3,11,14,0
325686,4,34,7,27,9,0
228145,1,7,3,4,17,0
333219,2,3,7,-4,12,0
107052,2,17,0,17,15,1
101579,3,13,31,-18,12,0
413519,1,0,3,-3,14,0
256934,3,20,21,-1,12,1
289521,4,21,7,14,10,1
279470,1,7,0,7,5,0
373745,4,16,21,-5,13,1
274019,1,0,0,0,3,0
284022,3,3,3,0,7,0
242415,1,0,7,-7,6,1
360090,4,10,40,-30,7,1
40013,2,14,7,7,1,1
388185,4,3,13,-10,2,1
87176,4,21,10,11,5,0
276793,2,17,17,0,4,1
303198,5,31,31,0,16,1
251469,1,16,3,13,10,0
85380,4,31,10,21,5,0
267719,4,14,34,-20,17,1
372488,4,23,14,9,13,1
366552,2,20,7,13,10,1
103362,2,10,17,-7,13,0
415382,1,0,0,0,15,1
414575,3,21,9,12,14,0
22663,4,30,17,13,11,0
397055,4,21,9,12,6,0
144657,1,0,0,0,14,1
136379,1,0,0,0,11,0
67790,4,24,0,24,14,0
276644,3,17,6,11,4,1
97139,4,34,6,28,10,0
269036,2,10,6,4,17,0
357309,4,14,19,-5,5,1
361822,3,37,10,27,7,0
69741,3,16,7,9,15,0
48267,2,10,10,0,5,0
411608,2,14,13,1,13,0
254845,1,0,0,0,12,0
350097,4,30,20,10,2,0
67685,1,0,0,0,14,1
381911,1,0,0,0,17,0
385766,2,17,0,17,1,1
292298,2,6,10,-4,11,1
251777,1,0,0,0,10,1
192494,3,7,17,-10,1,1
255253,4,13,17,-4,12,1
41536,4,18,7,11,2,1
226185,4,35,35,0,16,0
186424,2,10,7,3,15,0
304010,1,0,10,-10,16,0
387724,3,0,16,-16,2,0
87851,2,10,9,1,6,1
76776,2,24,0,24,1,1
345888,2,10,17,-7,17,0
79689,1,0,0,0,2,1
62462,4,7,13,-6,12,1
63542,1,7,0,7,12,0
160260,1,0,0,0,4,1
109305,3,13,3,10,15,1
233666,1,0,0,0,2,1
254833,4,20,13,7,11,0
96657,4,3,16,-13,10,0
114772,1,7,10,-3,1,0
82617,2,3,10,-7,3,0
354093,3,19,0,19,4,1
104177,4,27,27,0,13,0
80991,4,20,17,3,3,1
89065,2,6,6,0,6,1
80835,4,3,3,0,3,0
180504,3,21,20,1,13,1
119076,1,0,7,-7,3,0
282969,2,14,3,11,6,0
88787,3,13,10,3,6,0
407676,1,0,0,0,11,0
16384,3,21,13,8,8,1
273071,4,9,3,6,2,1
113041,3,13,16,-3,17,1
381150,4,31,28,3,16,0
252891,1,3,0,3,11,1
46295,1,0,14,-14,4,1
413843,2,14,6,8,14,1
192508,3,14,17,-3,1,1
126174,2,14,3,11,6,0
258810,2,7,7,0,13,1
22662,4,30,17,13,11,0
122704,2,7,10,-3,4,1
397246,1,0,0,0,6,1
173921,3,13,16,-3,10,0
337418,5,21,21,0,14,0
353316,4,38,28,10,4,0
241960,1,7,0,7,5,1
398765,3,14,17,-3,7,1
98294,3,21,27,-6,11,1
237211,2,3,0,3,3,1
327838,2,10,10,0,10,0
126803,1,0,6,-6,6,0
400884,4,31,19,12,8,0
172702,2,14,3,11,9,1
333020,2,3,9,-6,12,1
131977,2,0,10,-10,8,0
301974,4,20,20,0,15,1
112765,4,13,7,6,17,0
138928,2,7,3,4,12,0
227396,1,0,7,-7,16,0
225764,2,10,7,3,16,0
178527,3,16,13,3,12,1
88059,3,24,3,21,6,0
107253,4,14,31,-17,15,0
161462,3,7,3,4,4,1
224535,4,18,13,5,15,1
283382,1,0,7,-7,7,1
257871,3,13,12,1,13,1
127058,4,31,23,8,6,0
53270,3,3,7,-4,8,1
161363,5,20,19,1,4,0
121619,1,0,0,0,4,0
227645,4,35,0,35,16,1
242636,3,13,0,13,6,1
327107,2,7,3,4,9,1
11399,3,23,0,23,6,1
299016,4,16,18,-2,14,0
264223,2,3,7,-4,15,0
11274,4,17,28,-11,6,0
274443,4,10,17,-7,3,0
156855,4,23,26,-3,2,1
250169,2,17,0,17,9,0
109480,4,12,13,-1,16,0
21808,1,0,0,0,11,0
269756,1,7,0,7,1,0
56563,2,16,14,2,9,0
292218,4,24,17,7,11,1
402880,3,17,6,11,9,0
95246,2,3,10,-7,10,0
27171,2,13,7,6,13,0
47262,4,19,9,10,5,0
308890,4,16,20,-4,1,1
335799,1,0,0,0,13,1
210344,4,16,17,-1,9,1
79641,4,24,14,10,2,0
140460,2,14,7,7,12,1
24716,3,20,14,6,12,0
137542,3,17,17,0,11,0
287510,3,14,26,-12,9,0
193159,4,16,6,10,1,0
6528,3,3,3,0,3,0
251079,2,10,14,-4,10,0
314351,3,10,17,-7,3,1
30934,4,10,24,-14,15,1
321170,3,3,19,-16,6,1
171816,4,23,17,6,9,1
297946,2,17,7,10,13,1
383198,1,14,0,14,17,1
225601,2,0,7,-7,16,1
276255,4,31,17,14,3,0
249772,4,35,28,7,9,1
78114,2,7,3,4,2,1
264324,4,17,36,-19,15,1
196787,1,0,7,-7,3,1
174685,3,9,7,2,10,1
5882,1,0,3,-3,3,0
37705,4,37,0,37,17,1
65020,3,0,17,-17,13,0
272356,2,21,0,21,2,1
298741,4,22,27,-5,14,1
373810,2,13,0,13,13,0
258724,3,3,20,-17,13,0
354570,1,0,0,0,4,0
283314,3,10,9,1,7,1
77078,2,7,17,-10,1,0
197870,2,11,7,4,3,0
326557,4,51,22,29,9,0
25156,3,20,3,17,12,0
174773,1,6,7,-1,10,0
138163,2,7,9,-2,11,0
312233,3,7,17,-10,2,1
65864,2,7,7,0,13,1
31350,3,7,3,4,15,1
135306,1,0,0,0,10,0
59209,3,14,45,-31,10,1
310428,2,14,3,11,2,0
296895,2,10,0,10,13,1
221273,3,0,22,-22,14,1
184194,1,7,0,7,14,0
310439,2,14,3,11,2,0
344416,3,28,24,4,17,1
205071,4,19,20,-1,6,1
155279,4,28,27,1,1,1
312828,2,7,0,7,3,0
87358,1,7,0,7,6,0
318641,4,10,13,-3,5,1
120165,4,19,6,13,3,0
113378,1,0,0,0,17,0
237918,4,14,27,-13,4,1
291267,2,7,12,-5,10,1
149935,1,7,0,7,16,0
409115,3,3,10,-7,12,0
343618,2,15,7,8,17,1
288065,2,7,0,7,9,1
393305,4,30,29,1,5,1
213340,2,10,6,4,10,0
334591,4,30,24,6,13,0
241151,4,20,10,10,5,1
38846,4,3,10,-7,1,1
7977,4,16,27,-11,4,1
281322,2,14,13,1,6,1
421257,3,16,7,9,17,0
314223,3,14,20,-6,3,1
169853,4,20,17,3,8,0
98643,4,14,10,4,11,1
135088,3,17,6,11,10,0
350484,3,7,19,-12,2,1
308469,4,7,25,-18,1,1
67249,4,7,3,4,14,0
46212,3,14,21,-7,4,0
199244,3,17,21,-4,4,0
2626,1,0,0,0,2,1
13742,2,0,17,-17,7,1
252247,1,0,6,-6,10,0
375215,4,17,24,-7,14,1
94491,2,0,0,0,9,1
317930,2,7,3,4,5,1
74288,4,10,24,-14,17,1
182018,3,14,14,0,13,0
226956,1,0,0,0,16,1
376836,3,21,7,14,15,0
204475,3,7,24,-17,6,1
166140,2,14,12,2,6,1
369933,4,16,22,-6,12,1
277873,3,7,17,-10,4,0
187467,1,0,0,0,16,0
292164,2,21,6,15,11,0
309129,2,23,3,20,1,1
48770,4,17,25,-8,5,0
303069,1,0,7,-7,16,1
152960,3,28,17,11,1,1
154348,4,27,24,3,1,1
329485,2,10,0,10,10,0
278123,1,0,7,-7,4,1
382218,2,10,3,7,17,1
392889,1,0,0,0,4,1
191773,1,0,0,0,1,0
281182,3,21,13,8,6,1
159279,3,23,24,-1,3,1
223745,4,40,13,27,15,0
68584,4,20,28,-8,14,0
26123,2,0,13,-13,13,1
148738,2,13,3,10,16,0
360909,3,24,0,24,7,0
96988,1,0,0,0,10,0
73155,1,7,0,7,16,0
150348,3,27,7,20,16,0
199376,2,7,10,-3,4,0
308294,4,13,23,-10,1,0
398266,1,0,0,0,7,1
410226,1,7,0,7,13,0
346999,3,7,3,4,1,1
115376,1,7,0,7,1,1
176081,4,24,16,8,11,1
87977,1,3,0,3,6,0
366623,4,26,14,12,10,0
55541,2,10,7,3,9,1
401838,2,7,14,-7,9,0
324323,4,31,7,24,8,0
50085,2,0,14,-14,6,1
167171,2,13,7,6,7,1
136970,4,17,13,4,11,0
256521,1,0,0,0,12,0
291538,2,3,3,0,11,0
218384,1,0,6,-6,13,0
104644,3,7,3,4,14,0
113112,1,7,0,7,17,1
216728,3,27,6,21,12,0
283471,4,23,14,9,7,0
328073,1,0,0,0,10,0
35551,4,30,7,23,17,1
409855,3,23,0,23,12,0
26107,2,0,10,-10,13,0
382711,3,3,13,-10,17,1
184731,1,0,0,0,15,1
146986,2,17,0,17,15,1
172262,4,21,13,8,9,1
394353,3,24,17,7,5,1
411328,3,10,10,0,13,1
18789,4,13,19,-6,9,0
378445,3,16,0,16,15,1
355597,3,24,9,15,5,0
223933,4,30,13,17,15,1
313204,4,23,16,7,3,0
420588,1,0,10,-10,17,1
199004,4,19,26,-7,3,1
33061,1,3,0,3,16,0
72827,4,31,17,14,16,1
267868,4,26,17,9,17,1
145155,2,29,0,29,14,0
88761,2,6,3,3,6,1
296695,4,10,16,-6,13,0
244066,3,20,27,-7,6,0
48002,3,3,24,-21,5,0
243062,2,0,9,-9,6,1
333676,2,14,0,14,12,1
56307,3,3,26,-23,9,1
168561,2,7,10,-3,7,0
419997,2,3,7,-4,17,1
393984,2,3,7,-4,5,1
127830,4,17,42,-25,6,1
80351,2,13,6,7,2,1
172403,3,13,35,-22,9,0
354770,2,12,17,-5,4,1
357464,4,31,33,-2,5,0
199069,2,7,14,-7,4,0
135985,2,3,10,-7,10,0
397999,1,0,0,0,7,1
76565,4,7,41,-34,1,1
47564,4,37,6,31,5,1
333738,4,21,7,14,12,0
285263,2,14,6,8,7,0
61043,4,34,19,15,11,1
167123,4,22,34,-12,7,0
401171,4,44,13,31,8,0
116013,3,13,0,13,1,1
283515,1,6,0,6,7,1
291442,3,14,20,-6,10,0
135852,4,7,17,-10,10,1
198129,2,0,3,-3,3,0
186962,3,7,12,-5,15,1
130193,3,0,19,-19,8,1
90413,1,0,13,-13,7,1
133514,4,27,20,7,9,1
271390,1,0,0,0,1,1
299186,4,17,19,-2,14,0
163128,3,16,19,-3,5,0
380686,3,7,7,0,16,1
355088,2,6,13,-7,4,0
131943,1,0,0,0,8,0
342182,4,15,19,-4,16,0
418771,4,14,21,-7,16,0
192321,3,27,17,10,1,1
129605,4,13,23,-10,7,1
371349,4,42,10,32,12,0
194659,4,31,7,24,2,1
176897,4,20,16,4,11,0
299849,2,10,0,10,14,1
234387,4,17,10,7,2,1
332295,2,3,6,-3,12,0
374808,1,7,0,7,14,1
131187,1,0,0,0,8,0
321152,2,3,16,-13,6,1
12715,3,51,0,51,6,1
98383,1,0,7,-7,11,0
174479,1,7,7,0,10,1
349426,2,0,13,-13,2,0
351883,4,27,14,13,3,0
20861,3,28,9,19,10,0
411333,3,16,10,6,13,1
300264,1,0,7,-7,14,1
117671,3,26,13,13,2,1
81996,2,7,0,7,3,0
141493,2,7,3,4,13,1
78252,2,0,0,0,2,0
370584,2,14,14,0,12,1
328556,1,7,6,1,10,0
328433,2,3,0,3,10,0
115400,2,20,7,13,1,1
327492,1,0,0,0,10,0
316586,2,6,6,0,4,1
340892,2,0,10,-10,15,1
67340,3,20,6,14,14,0
366733,3,24,10,14,10,1
38159,1,0,0,0,1,1
73510,2,3,31,-28,17,1
223257,3,3,9,-6,15,1
209086,3,3,20,-17,8,0
201894,1,0,0,0,5,0
77944,2,3,6,-3,1,0
135613,1,7,0,7,10,0
420801,3,3,10,-7,17,1
366929,1,0,7,-7,10,1
157995,1,0,3,-3,3,1
299431,3,0,20,-20,14,1
369965,1,7,0,7,12,0
373893,4,37,16,21,13,1
351344,2,7,7,0,3,1
182637,2,0,6,-6,14,0
186141,2,6,3,3,15,1
168148,3,16,5,11,7,1
278295,2,14,0,14,4,0
377069,1,0,7,-7,15,1
216382,3,14,23,-9,12,1
120789,4,26,6,20,3,0
278880,1,0,0,0,5,1
302566,4,3,16,-13,15,0
36934,2,0,25,-25,17,1
411408,1,0,6,-6,13,0
97738,4,16,13,3,11,0
245442,3,9,6,3,7,1
397768,4,17,14,3,7,0
221628,4,20,21,-1,14,1
91774,2,3,0,3,8,1
224978,4,10,19,-9,15,0
207831,1,0,0,0,8,1
134702,1,0,0,0,10,0
315354,2,10,10,0,4,1
188702,2,0,17,-17,16,0
223260,3,3,9,-6,15,0
196282,3,21,10,11,2,1
90946,4,61,7,54,7,1
185317,4,41,30,11,15,1
307917,2,0,0,0,1,1
45804,4,13,14,-1,4,1
188700,2,0,17,-17,16,0
171600,2,3,3,0,9,1
122979,2,0,3,-3,4,1
315030,2,21,7,14,4,1
42881,1,7,3,4,3,0
314985,4,0,20,-20,4,1
379319,3,3,6,-3,16,0
364551,2,9,21,-12,9,1
72620,2,13,0,13,16,0
290127,4,21,15,6,10,0
39430,3,10,10,0,1,0
275511,4,20,30,-10,3,1
9438,2,10,0,10,5,0
37151,1,0,0,0,17,1
153645,1,0,0,0,1,1
172800,1,0,0,0,9,0
64404,1,0,3,-3,13,0
300720,1,7,0,7,15,1
291651,4,23,20,3,11,1
331747,3,10,27,-17,12,1
276015,2,3,0,3,3,1
313634,4,25,30,-5,3,1
117841,3,9,13,-4,2,1
191236,2,7,17,-10,17,0
350789,4,17,3,14,2,0
408391,4,19,14,5,12,0
217116,2,0,7,-7,12,0
104262,2,10,0,10,13,0
78559,2,13,7,6,2,0
417720,4,35,19,16,16,1
67584,2,0,20,-20,14,1
179494,1,0,6,-6,12,1
115142,3,10,20,-10,1,1
69609,4,7,17,-10,15,0
4390,3,7,14,-7,2,1
269538,3,13,31,-18,1,1
408887,1,7,0,7,12,1
211392,4,10,13,-3,9,1
359169,3,7,14,-7,6,1
133193,3,13,17,-4,9,0
237747,5,20,20,0,4,1
35862,1,0,0,0,17,0
375569,1,0,0,0,14,0
131591,4,9,26,-17,8,1
165425,4,6,36,-30,6,0
20764,1,0,0,0,10,1
5155,4,19,14,5,3,0
167897,3,21,16,5,7,0
206820,2,0,0,0,7,0
158572,4,19,17,2,3,1
375234,5,24,24,0,14,1
378229,1,0,0,0,15,0
307696,4,17,23,-6,17,0
360736,2,17,14,3,7,0
23449,1,7,0,7,11,0
43344,2,14,7,7,3,0
279258,3,16,13,3,5,1
282803,2,3,13,-10,6,1
151268,1,0,0,0,17,1
39641,4,30,6,24,1,1
165118,4,17,24,-7,6,1
130448,1,3,0,3,8,0
137060,2,14,3,11,11,0
311314,1,7,0,7,2,1
346669,2,14,6,8,1,1
222521,3,17,14,3,14,0
191448,4,0,34,-34,17,1
175571,3,20,7,13,11,0
238416,4,17,33,-16,4,0
409204,2,3,3,0,12,0
333985,3,17,10,7,12,0
381811,2,0,14,-14,17,1
162672,3,16,17,-1,5,0
174941,2,3,7,-4,10,0
302976,3,20,16,4,16,0
36789,2,7,10,-3,17,1
366969,2,0,17,-17,10,0
75465,3,31,7,24,17,1
333477,1,3,0,3,12,1
143124,4,24,27,-3,13,1
173288,2,14,10,4,10,0
148562,1,0,0,0,16,0
243030,1,0,0,0,6,0
420330,3,17,3,14,17,1
416047,3,21,3,18,15,0
210909,3,19,10,9,9,1
207314,3,10,14,-4,7,0
10248,4,13,10,3,5,1
385762,2,17,0,17,1,0
322022,2,6,0,6,7,0
192881,1,0,0,0,1,0
299243,2,10,0,10,14,0
300266,1,0,7,-7,14,1
260690,4,10,25,-15,14,1
185074,2,0,3,-3,15,0
377103,2,10,10,0,15,0
175019,4,13,28,-15,10,1
377738,4,32,7,25,15,1
145741,2,0,10,-10,15,1
398952,4,23,13,10,7,0
393670,1,0,0,0,5,1
242795,4,14,31,-17,6,0
16223,2,3,0,3,8,0
332618,3,27,6,21,12,0
159846,2,14,0,14,3,1
89184,1,0,0,0,7,1
369260,2,14,14,0,11,1
189222,3,33,3,30,16,0
28293,4,24,14,10,13,1
45729,2,7,7,0,4,0
354169,1,3,0,3,4,0
18329,3,22,17,5,9,1
160382,4,3,28,-25,4,1
59499,3,6,20,-14,11,0
162463,1,7,3,4,4,1
186167,3,16,6,10,15,0
63633,3,13,33,-20,12,0
91554,4,26,10,16,8,1
290327,1,6,3,3,10,1
104819,4,27,33,-6,14,0
332857,2,7,0,7,12,1
255418,4,24,6,18,12,0
414700,2,3,10,-7,14,0
375897,2,13,3,10,14,1
380654,2,7,7,0,16,0
288818,2,10,14,-4,9,0
28785,1,0,0,0,14,0
159313,4,27,24,3,3,1
314259,4,17,23,-6,3,1
275624,3,24,3,21,3,0
232187,2,6,3,3,1,1
55806,2,0,7,-7,9,0
335640,4,19,10,9,13,1
143271,4,17,16,1,13,1
129251,3,14,13,1,7,1
411701,1,0,3,-3,13,1
107040,2,17,0,17,15,1
229458,4,13,6,7,17,0
142047,4,23,14,9,13,0
1103,3,10,36,-26,1,0
18026,4,22,28,-6,9,0
334347,1,0,3,-3,13,0
232421,1,0,0,0,1,1
59681,4,24,6,18,11,0
257417,4,20,14,6,13,1
297751,4,31,23,8,13,0
121093,4,18,31,-13,3,1
237885,4,7,27,-20,4,0
48343,1,0,0,0,5,0
293666,3,10,7,3,12,0
260514,3,27,0,27,14,0
27276,1,7,0,7,13,0
156396,4,38,20,18,2,1
299773,4,17,14,3,14,0
208350,3,17,27,-10,8,1
300738,2,7,6,1,15,0
237691,3,20,14,6,4,0
81156,4,16,20,-4,3,0
72468,2,10,10,0,16,0
126125,4,37,9,28,6,0
330671,2,6,3,3,11,0
26982,1,7,0,7,13,0
389247,4,31,7,24,3,0
407858,2,3,7,-4,11,1
184883,1,0,0,0,15,0
334561,3,21,17,4,13,1
270366,1,0,0,0,1,1
52370,3,6,17,-11,7,0
341196,2,10,7,3,16,1
184278,4,31,14,17,14,1
62838,1,3,0,3,12,0
158130,1,0,0,0,3,0
51838,1,0,0,0,7,0
334010,4,17,13,4,12,1
228063,3,3,3,0,17,0
34416,2,14,3,11,16,0
177615,4,17,20,-3,11,1
114799,2,7,20,-13,1,1
83072,2,6,14,-8,4,1
237565,4,38,14,24,3,0
54445,1,0,0,0,8,0
160546,4,23,14,9,4,1
361151,5,23,23,0,7,1
257381,3,20,0,20,13,0
408864,4,22,35,-13,12,0
287362,3,20,3,17,8,0
247844,2,7,3,4,8,1
136916,3,0,13,-13,11,0
263082,4,10,13,-3,15,1
219726,4,13,14,-1,13,1
313924,4,28,29,-1,3,0
264866,1,3,7,-4,16,1
144059,1,7,0,7,14,1
326708,4,23,13,10,9,0
41912,2,14,6,8,2,1
299745,3,17,6,11,14,1
305477,4,27,10,17,17,0
92133,3,3,30,-27,8,1
157715,2,10,3,7,2,1
318926,4,24,28,-4,5,1
152542,4,24,7,17,17,0
27535,4,23,12,11,13,0
228362,3,7,17,-10,17,0
363143,3,14,3,11,8,1
24951,2,10,14,-4,12,1
235280,3,18,6,12,3,1
191164,4,28,33,-5,17,1
55783,1,0,0,0,9,0
416667,4,34,7,27,15,1
321695,1,0,3,-3,7,1
374689,2,0,9,-9,14,1
137089,3,17,3,14,11,1
86876,3,9,23,-14,5,0
375374,4,14,24,-10,14,1
213676,3,14,17,-3,10,1
406027,1,0,3,-3,11,1
143622,2,10,10,0,14,1
81298,4,10,14,-4,3,0
299309,3,26,10,16,14,1
299526,1,0,3,-3,14,1
302263,4,38,13,25,15,1
46559,1,0,0,0,4,0
274478,1,6,0,6,3,1
149958,2,7,3,4,16,1
160939,2,7,7,0,4,0
281269,1,7,3,4,6,0
238534,3,16,13,3,4,1
226920,4,3,10,-7,16,0
202370,1,0,0,0,5,1
67824,1,0,3,-3,14,1
47996,3,3,24,-21,5,1
420791,2,3,10,-7,17,1
371714,2,14,14,0,12,1
272800,1,7,0,7,2,0
240587,2,3,7,-4,5,1
371112,1,0,0,0,12,0
10802,3,21,0,21,5,1
307057,3,24,0,24,17,0
54572,4,28,18,10,8,0
373080,3,3,13,-10,13,0
45155,2,7,7,0,4,0
12666,2,10,0,10,6,1
100798,2,6,3,3,12,1
133933,3,6,6,0,9,0
70523,4,39,23,16,15,0
32680,2,7,0,7,15,0
392794,2,17,3,14,4,1
210318,3,16,10,6,9,0
123446,1,0,0,0,4,1
355566,2,14,3,11,5,1
270070,2,10,10,0,1,0
106039,4,24,3,21,14,0
402859,2,10,3,7,9,1
209512,2,20,10,10,8,1
155842,2,7,10,-3,2,0
313942,4,28,29,-1,3,0
222624,2,7,7,0,14,0
40000,2,7,7,0,1,1
78880,3,17,0,17,2,1
331510,4,9,35,-26,11,1
65278,2,3,14,-11,13,0
38999,4,30,17,13,1,1
263589,1,0,7,-7,15,1
114052,2,14,0,14,17,0
232853,4,16,17,-1,2,1
258806,2,7,7,0,13,1
148265,1,0,0,0,16,1
311076,3,10,3,7,2,1
93058,4,20,12,8,8,0
157659,1,0,3,-3,2,0
6633,1,0,7,-7,3,1
214494,4,7,20,-13,11,0
202036,5,17,17,0,5,0
313149,2,10,10,0,3,0
130971,3,10,24,-14,8,0
21864,2,21,0,21,11,0
421497,2,0,3,-3,17,1
8107,4,24,20,4,4,1
391915,4,23,27,-4,4,1
184686,3,10,24,-14,15,1
132198,1,0,0,0,9,0
119249,2,7,3,4,3,1
79137,2,0,0,0,2,0
361765,2,14,0,14,7,0
38066,2,3,0,3,1,0
239751,4,13,13,0,4,0
362257,4,15,24,-9,8,1
299201,4,17,22,-5,14,1
134676,4,34,31,3,10,1
242549,1,0,0,0,6,0
150595,3,3,13,-10,17,0
240142,2,13,3,10,5,1
151214,3,17,20,-3,17,0
181106,3,24,7,17,13,0
192848,4,7,15,-8,1,1
265329,2,7,6,1,16,0
49971,2,21,6,15,6,0
244130,4,20,34,-14,6,1
78019,3,9,16,-7,1,1
317945,2,10,3,7,5,0
234147,2,0,7,-7,2,1
107139,1,0,0,0,15,0
122516,1,6,0,6,4,1
182827,3,29,17,12,14,0
261713,3,14,7,7,14,1
161321,4,20,13,7,4,0
60690,3,21,3,18,11,1
415339,4,14,14,0,15,0
291713,2,0,6,-6,11,0
173553,1,0,7,-7,10,0
84168,3,10,6,4,4,0
332228,4,10,16,-6,12,1
404901,1,3,3,0,10,0
136273,2,15,7,8,11,1
380166,1,7,0,7,16,0
59327,2,0,6,-6,11,0
167258,4,30,20,10,7,1
167320,2,16,10,6,7,0
227300,3,13,20,-7,16,1
24458,4,16,7,9,12,1
337881,1,10,0,10,14,1
372094,1,3,0,3,13,0
223393,3,7,19,-12,15,1
294322,2,10,3,7,12,0
107601,2,6,7,-1,15,0
7163,4,34,24,10,4,1
52225,3,7,16,-9,7,1
91953,2,3,23,-20,8,1
386251,4,14,17,-3,2,1
329399,4,16,34,-18,10,0
182532,4,35,21,14,14,1
66057,3,7,0,7,13,0
296213,4,16,26,-10,13,1
93522,1,0,0,0,9,1
44800,1,0,0,0,4,0
178188,2,0,10,-10,12,1
241878,3,13,13,0,5,1
185554,2,10,10,0,15,0
338479,2,14,0,14,14,0
88890,1,9,0,9,6,1
113204,4,41,22,19,17,0
231069,4,27,8,19,1,0
311413,4,45,20,25,2,0
242311,2,10,10,0,6,1
268143,2,6,14,-8,17,1
126149,1,0,3,-3,6,0
309865,3,21,7,14,1,1
368695,2,7,10,-3,11,1
356041,3,21,10,11,5,1
3467,3,3,23,-20,2,1
272727,3,12,3,9,2,1
380427,4,10,24,-14,16,1
386162,2,3,3,0,2,1
342699,2,0,0,0,16,0
173448,2,0,7,-7,10,1
138926,2,7,3,4,12,0
229537,2,17,6,11,17,0
244910,1,0,0,0,7,1
201850,4,20,30,-10,5,1
286460,4,17,10,7,8,1
51997,1,3,7,-4,7,0
105001,1,0,0,0,14,0
291946,4,27,17,10,11,0
371991,2,10,0,10,13,0
403060,4,24,24,0,9,0
239841,2,7,0,7,4,0
320198,1,0,0,0,6,1
142571,1,0,3,-3,13,0
19015,3,7,3,4,10,0
192541,4,17,17,0,1,0
336188,4,17,10,7,13,1
185984,1,3,20,-17,15,1
336640,5,7,7,0,14,1
198175,3,10,3,7,3,0
123369,3,21,23,-2,4,0
145483,3,16,17,-1,14,0
71648,3,3,31,-28,16,0
3419,2,3,16,-13,2,1
390293,4,17,20,-3,3,1
260380,3,6,6,0,14,0
165836,3,6,15,-9,6,0
267143,3,10,10,0,17,1
103671,3,0,10,-10,13,0
227585,2,28,0,28,16,0
85787,2,13,7,6,5,0
239535,2,3,0,3,4,0
259995,4,23,20,3,14,1
163770,3,7,12,-5,5,1
352911,1,0,0,0,3,1
135860,4,13,17,-4,10,1
28419,4,13,6,7,14,1
114446,1,0,7,-7,1,1
286530,2,3,14,-11,8,1
383065,2,17,7,10,17,1
313099,1,0,0,0,3,0
179525,2,0,16,-16,12,0
368328,4,12,19,-7,11,1
355293,3,14,14,0,4,0
352243,2,3,3,0,3,1
35405,5,30,30,0,16,0
166368,1,3,0,3,6,1
351508,2,0,27,-27,3,0
103840,3,19,0,19,13,0
229836,2,6,0,6,17,0
125667,4,28,24,4,5,0
415456,3,23,3,20,15,0
196989,3,20,16,4,3,0
261555,3,12,7,5,14,1
387508,1,0,0,0,2,1
209519,2,27,10,17,8,0
321517,4,24,30,-6,7,1
383282,3,45,17,28,17,0
16326,1,7,0,7,8,0
370461,3,13,6,7,12,0
157030,1,0,0,0,2,0
379941,4,21,6,15,16,0
43434,5,24,24,0,3,0
82759,2,6,6,0,3,1
29473,3,10,14,-4,14,0
367250,2,3,0,3,10,1
260046,2,3,7,-4,14,0
182034,3,14,14,0,13,0
57644,3,17,3,14,10,0
167101,4,16,34,-18,7,1
133970,4,16,13,3,9,1
287168,2,10,10,0,8,0
213373,2,10,13,-3,10,0
204889,2,3,13,-10,6,1
67257,4,7,3,4,14,1
38325,1,0,3,-3,1,1
405358,4,17,12,5,10,0
130157,2,0,16,-16,8,0
81227,2,7,7,0,3,1
279214,2,10,3,7,5,0
92001,4,26,23,3,8,1
110162,3,20,17,3,16,0
334487,1,0,14,-14,13,1
142124,2,0,7,-7,13,1
396041,1,0,0,0,6,1
212331,3,10,3,7,10,1
418057,4,28,35,-7,16,1
13499,4,6,27,-21,7,0
413506,1,0,0,0,14,0
385168,4,21,17,4,1,0
40798,4,17,28,-11,2,0
214472,3,7,17,-10,11,0
51528,4,34,31,3,7,0
337527,4,7,25,-18,14,0
202560,2,7,6,1,5,1
254831,4,20,13,7,11,0
178169,2,0,7,-7,12,1
322390,4,17,16,1,7,0
408823,4,13,28,-15,12,1
384486,4,28,6,22,1,1
86558,2,23,3,20,5,0
165736,4,14,7,7,6,0
286275,3,13,16,-3,8,0
216586,4,40,18,22,12,1
224628,3,16,10,6,15,1
240583,1,3,0,3,5,0
257499,2,9,10,-1,13,1
415574,2,7,7,0,15,1
53566,3,14,12,2,8,1
338864,3,13,20,-7,15,0
28169,1,3,0,3,13,0
30416,2,10,13,-3,14,0
307685,4,14,23,-9,17,1
130226,3,3,26,-23,8,0
9581,1,3,0,3,5,0
175552,3,20,0,20,11,1
404375,4,20,6,14,10,1
279878,3,17,13,4,5,1
335129,2,10,0,10,13,1
400076,2,17,9,8,8,0
184632,2,10,10,0,15,1
312635,1,0,0,0,3,1
331858,2,0,0,0,12,0
226906,3,3,10,-7,16,0
203330,2,14,24,-10,6,0
175287,3,15,10,5,10,0
233594,3,20,34,-14,2,1
231968,4,14,41,-27,1,0
91958,2,6,23,-17,8,1
201693,4,24,20,4,5,0
330022,1,0,0,0,11,1
221941,4,19,19,0,14,1
43592,4,31,3,28,3,1
382193,1,0,3,-3,17,1
62059,4,26,10,16,12,1
312870,3,14,0,14,3,0
334002,3,17,13,4,12,0
393518,1,7,6,1,5,1
294106,4,7,27,-20,12,1
345783,4,22,10,12,17,0
213898,1,0,0,0,10,1
108211,2,6,0,6,15,1
66653,3,7,24,-17,14,1
318367,1,0,0,0,5,1
396539,2,17,7,10,6,0
61802,2,0,17,-17,12,0
17607,4,20,17,3,9,0
178474,2,10,3,7,12,0
387753,4,0,37,-37,2,1
411702,1,0,3,-3,13,1
402543,1,7,7,0,9,0
122877,3,23,6,17,4,1
301391,4,17,10,7,15,0
306063,4,17,13,4,17,1
253528,2,3,7,-4,11,1
220662,2,10,0,10,13,0
58285,3,20,13,7,10,0
315038,2,21,7,14,4,1
420487,2,0,35,-35,17,1
223185,1,3,0,3,15,0
126783,1,0,3,-3,6,1
116856,2,7,7,0,2,0
304424,1,0,0,0,16,0
190401,3,7,7,0,17,1
322579,2,0,3,-3,7,0
63000,2,6,14,-8,12,1
188807,4,7,20,-13,16,0
237853,3,7,26,-19,4,0
17041,1,7,0,7,9,0
297999,4,30,7,23,13,1
122637,4,36,7,29,4,0
393207,2,7,6,1,5,0
89023,1,0,0,0,6,0
70468,3,17,17,0,15,0
349916,3,3,12,-9,2,0
339532,1,7,0,7,15,0
6909,1,0,0,0,3,0
171499,3,17,10,7,9,0
166231,1,0,0,0,6,0
177301,4,17,20,-3,11,1
102081,4,35,17,18,12,1
241939,4,30,27,3,5,0
414311,4,21,42,-21,14,1
343043,2,6,7,-1,16,1
405636,4,24,28,-4,10,0
310979,4,9,37,-28,2,1
196904,4,10,22,-12,3,1
33333,1,3,0,3,16,0
24605,4,10,26,-16,12,0
288362,2,7,0,7,9,0
99663,4,26,3,23,11,0
181299,4,3,20,-17,13,0
228898,1,0,0,0,17,1
373844,2,20,0,20,13,0
79598,3,14,7,7,2,1
308040,1,0,6,-6,1,0
272867,3,20,10,10,2,0
260345,2,0,0,0,14,0
141681,3,23,14,9,13,0
369172,4,19,14,5,11,0
160526,3,20,14,6,4,1
252378,4,0,29,-29,10,1
420776,2,0,3,-3,17,1
283091,2,3,0,3,7,0
381154,4,31,28,3,16,1
11607,1,0,0,0,6,1
113558,2,0,0,0,17,0
57101,4,21,27,-6,9,1
166674,4,32,20,12,6,0
93503,4,3,31,-28,9,0
38687,3,14,7,7,1,1
339059,1,0,0,0,15,0
3717,2,10,0,10,2,0
401117,3,27,3,24,8,1
105281,4,10,26,-16,14,0
237941,1,0,0,0,4,1
94921,1,0,3,-3,9,0
331110,1,0,6,-6,11,1
287091,4,32,32,0,8,1
128254,4,20,7,13,7,0
282330,1,7,0,7,6,0
290286,4,17,15,2,10,1
203735,1,0,6,-6,6,0
8831,4,32,0,32,4,1
143863,4,12,13,-1,14,0
38426,4,31,16,15,1,0
84637,4,23,13,10,4,0
275275,2,10,2,8,3,1
287557,4,20,43,-23,9,1
98477,4,31,14,17,11,0
171544,4,30,10,20,9,1
342201,1,0,0,0,16,0
411218,4,11,23,-12,13,1
276397,4,31,44,-13,3,1
225143,1,0,0,0,15,1
52446,1,0,0,0,7,1
59769,2,9,10,-1,11,0
350074,4,27,13,14,2,1
83436,4,10,23,-13,4,1
278895,1,0,7,-7,5,1
385730,1,7,0,7,1,1
291421,2,14,10,4,10,0
300678,4,24,3,21,15,1
212572,1,7,10,-3,10,1
248214,4,12,10,2,8,1
99368,4,23,10,13,11,0
162446,1,7,0,7,4,0
69365,1,0,0,0,15,1
275939,4,20,18,2,3,1
328353,3,3,37,-34,10,1
25257,2,14,7,7,12,0
129105,3,26,28,-2,7,1
120425,3,19,9,10,3,1
124364,1,0,0,0,5,0
213247,3,10,16,-6,10,1
404736,2,7,3,4,10,0
191582,4,21,24,-3,17,1
38101,3,6,6,0,1,1
122999,2,0,10,-10,4,1
369446,3,38,7,31,11,0
312,1,7,0,7,1,1
390159,4,20,35,-15,3,0
268383,4,29,6,23,17,0
324725,3,13,7,6,8,1
121268,4,28,30,-2,3,0
4087,3,16,21,-5,2,0
87457,4,20,16,4,6,0
228675,3,16,23,-7,17,1
347033,4,24,17,7,1,1
415108,1,0,14,-14,15,0
117826,3,9,6,3,2,0
410507,4,18,26,-8,13,0
368377,2,14,0,14,11,0
409446,4,34,3,31,12,1
48003,3,3,24,-21,5,0
113943,4,17,10,7,17,1
25598,3,27,10,17,12,1
353892,3,10,28,-18,4,1
80909,1,6,0,6,3,1
236952,3,36,7,29,3,1
225607,2,0,7,-7,16,0
112196,4,27,34,-7,17,0
260550,4,27,8,19,14,0
96517,4,17,24,-7,10,0
175489,1,0,0,0,11,0
127424,1,0,0,0,6,1
560,4,14,27,-13,1,1
210092,1,0,0,0,9,0
277744,3,7,6,1,4,1
197668,1,0,0,0,3,0
355882,3,13,10,3,5,1
364635,1,0,0,0,9,1
355830,1,12,0,12,5,1
123049,4,7,13,-6,4,0
299823,1,3,0,3,14,0
53090,2,19,14,5,7,1
170011,4,28,17,11,8,1
57501,3,21,10,11,10,0
105212,2,7,17,-10,14,0
76510,3,7,20,-13,1,0
177877,3,21,16,5,12,0
66214,3,24,3,21,13,0
358129,2,17,6,11,6,0
291477,4,21,20,1,10,0
115473,4,39,28,11,1,1
335724,3,10,7,3,13,1
303969,4,14,34,-20,16,1
387941,1,0,0,0,2,1
175768,4,40,28,12,11,1
384706,2,13,23,-10,1,1
225334,2,7,21,-14,15,1
135859,4,7,17,-10,10,1
7953,4,9,27,-18,4,0
91575,1,0,7,-7,8,1
414285,3,21,28,-7,14,0
66295,1,0,7,-7,14,1
147531,2,6,0,6,15,0
408003,2,3,0,3,12,1
52275,4,26,19,7,7,1
372563,1,6,0,6,13,1
12943,5,13,13,0,6,0
5138,4,19,7,12,3,1
244834,3,7,3,4,7,0
129888,3,13,0,13,7,0
250479,2,13,7,6,9,0
379181,3,9,10,-1,16,0
79605,3,14,7,7,2,0
68047,2,3,10,-7,14,1
261028,1,0,0,0,14,0
99339,3,20,3,17,11,0
222835,4,17,13,4,14,1
136934,3,3,13,-10,11,0
288809,1,3,14,-11,9,1
273178,3,24,0,24,2,0
253743,3,23,10,13,11,1
373773,1,0,0,0,13,0
380282,4,29,23,6,16,1
172970,1,7,0,7,9,0
25660,2,7,7,0,12,1
190579,4,20,20,0,17,0
296634,3,3,10,-7,13,1
264767,3,10,16,-6,16,0
336750,3,10,10,0,14,1
37533,3,10,10,0,17,1
358514,1,0,3,-3,6,0
318656,4,10,13,-3,5,0
21099,2,0,0,0,10,1
221902,3,19,7,12,14,0
388914,2,10,20,-10,3,0
381431,4,23,7,16,16,0
327834,2,10,10,0,10,1
208429,1,7,0,7,8,1
17616,1,0,0,0,9,1
330793,1,3,3,0,11,0
274421,3,10,17,-7,3,0
66813,4,10,6,4,14,1
164299,1,12,0,12,5,1
261562,3,12,7,5,14,0
272809,1,14,0,14,2,1
344431,4,28,24,4,17,0
225623,2,0,10,-10,16,1
229352,1,0,0,0,17,1
232111,4,13,33,-20,1,1
263825,4,7,24,-17,15,1
84980,1,15,7,8,4,1
135358,2,14,17,-3,10,1
186275,2,13,3,10,15,1
71150,2,19,3,16,16,0
128257,4,20,7,13,7,1
384362,4,16,17,-1,1,1
404478,2,14,13,1,10,0
103353,2,10,17,-7,13,1
50568,2,0,6,-6,6,0
9679,4,12,28,-16,5,1
92840,2,21,0,21,8,0
244041,2,20,17,3,6,0
59942,2,3,10,-7,11,0
121620,1,0,0,0,4,0
121527,3,9,7,2,4,1
320552,2,21,0,21,6,1
379167,2,6,10,-4,16,1
11226,2,13,14,-1,6,1
276606,2,7,3,4,4,0
14405,1,6,0,6,7,1
46646,3,10,0,10,4,1
235745,4,10,26,-16,3,0
337526,4,7,19,-12,14,0
304494,2,3,14,-11,16,0
239821,1,0,0,0,4,0
81726,3,17,17,0,3,1
414701,2,3,10,-7,14,0
44409,2,3,0,3,3,0
284169,3,6,20,-14,7,1
310218,4,24,10,14,2,0
127442,2,3,0,3,6,0
16946,3,27,20,7,8,1
102356,4,13,13,0,13,1
45736,2,7,7,0,4,1
61858,3,13,23,-10,12,1
272949,1,3,0,3,2,0
361707,4,10,39,-29,7,0
262701,1,7,0,7,15,1
266307,1,0,0,0,16,0
228226,3,10,27,-17,17,1
207415,2,7,0,7,7,0
355725,2,7,3,4,5,0
12998,2,7,7,0,6,0
43271,4,24,10,14,3,0
112242,2,14,7,7,17,0
49952,2,21,0,21,6,0
125556,1,0,7,-7,5,1
320539,1,14,0,14,6,1
262499,4,21,35,-14,15,0
284786,3,26,17,9,7,1
13447,2,3,21,-18,7,1
212259,1,7,0,7,10,0
166342,4,20,9,11,6,0
415556,2,0,6,-6,15,0
211049,3,20,0,20,9,1
373312,1,0,0,0,13,0
160404,1,0,0,0,4,0
96942,3,22,10,12,10,1
196682,2,33,0,33,3,1
209640,1,3,0,3,8,1
31504,4,3,17,-14,15,0
322286,1,7,0,7,7,0
148636,3,10,9,1,16,0
195567,4,13,7,6,2,0
17285,4,21,41,-20,9,1
301369,4,17,7,10,15,0
238802,2,20,0,20,4,1
57859,1,0,0,0,10,1
336805,4,10,29,-19,14,0
125641,3,14,24,-10,5,1
99897,2,0,3,-3,12,1
60385,3,13,7,6,11,1
401013,4,22,15,7,8,1
271062,4,28,28,0,1,0
336255,2,10,0,10,13,1
390226,2,0,6,-6,3,1
323703,4,26,0,26,8,0
254779,3,10,10,0,11,1
141622,1,3,7,-4,13,1
290908,1,0,0,0,10,1
400175,1,0,0,0,8,0
237610,1,0,0,0,4,0
170387,1,14,0,14,8,1
166000,3,17,21,-4,6,1
275849,1,3,0,3,3,0
190342,1,0,0,0,17,1
303082,2,0,7,-7,16,0
3414,2,3,16,-13,2,1
213607,1,0,0,0,10,1
95875,4,13,20,-7,10,0
330140,4,0,13,-13,11,0
60388,3,13,7,6,11,0
315761,1,0,0,0,4,0
381149,4,31,28,3,16,0
196568,3,17,6,11,2,1
36604,1,3,3,0,17,1
11864,4,41,17,24,6,0
113354,4,26,38,-12,17,0
379118,1,0,3,-3,16,0
212218,4,3,24,-21,10,0
292648,4,22,16,6,11,0
23799,3,17,0,17,12,0
260369,3,6,0,6,14,1
110363,4,20,17,3,16,1
272064,2,10,3,7,2,0
294645,2,0,7,-7,12,1
133931,3,6,6,0,9,0
205805,2,7,0,7,7,1
272354,2,21,0,21,2,0
60638,2,6,3,3,11,1
232792,3,13,14,-1,2,1
146831,2,17,0,17,15,0
174407,4,17,3,14,10,0
258069,1,6,0,6,13,1
200645,4,27,28,-1,4,1
194953,4,14,19,-5,2,0
226002,4,34,27,7,16,1
15338,2,7,3,4,8,0
270950,1,0,6,-6,1,0
399928,3,3,12,-9,8,0
86688,2,10,0,10,5,0
104778,3,20,19,1,14,0
107165,2,0,14,-14,15,0
17666,2,7,3,4,9,0
285628,4,20,24,-4,8,1
403264,1,0,0,0,9,1
230921,4,30,10,20,1,1
194278,2,10,0,10,2,1
300079,4,7,40,-33,14,1
177057,1,3,0,3,11,0
145979,4,13,21,-8,15,0
21709,2,16,7,9,11,1
247224,1,14,7,7,8,0
18028,4,22,28,-6,9,0
319120,1,2,0,2,5,0
363871,4,13,29,-16,8,1
195293,4,23,24,-1,2,1
284192,3,9,20,-11,7,1
106772,3,20,15,5,14,0
197460,3,13,9,4,3,1
200892,3,17,0,17,4,1
98178,4,21,19,2,11,1
141766,4,33,28,5,13,0
388760,2,14,0,14,3,0
19311,3,14,17,-3,10,0
420279,2,7,0,7,17,0
373293,4,16,30,-14,13,1
74779,1,3,3,0,17,1
382555,3,0,10,-10,17,0
19334,3,14,17,-3,10,1
306570,2,0,17,-17,17,1
252727,1,0,0,0,11,0
398353,3,3,13,-10,7,0
154769,3,13,16,-3,1,1
7748,2,27,3,24,4,1
406202,2,7,10,-3,11,0
181123,3,24,14,10,13,0
178453,2,7,3,4,12,1
182102,1,3,0,3,13,1
230939,4,31,10,21,1,1
152163,1,0,0,0,17,0
243101,3,7,9,-2,6,1
352584,4,34,20,14,3,0
149929,1,7,0,7,16,0
373150,1,0,0,0,13,1
372593,2,7,0,7,13,0
122345,4,13,19,-6,4,0
236325,2,0,23,-23,3,1
418114,2,14,0,14,16,0
332941,4,31,3,28,12,1
30949,4,17,24,-7,15,1
92462,4,23,10,13,8,0
113310,3,16,24,-8,17,0
331193,4,10,13,-3,11,1
400349,2,10,3,7,8,0
92112,2,3,17,-14,8,1
342636,4,22,27,-5,16,0
315825,3,3,19,-16,4,0
167768,5,26,26,0,7,0
10117,4,44,7,37,5,1
34906,3,27,10,17,16,1
274591,4,24,26,-2,3,1
408846,4,16,28,-12,12,0
319749,1,0,0,0,6,1
330067,2,0,3,-3,11,1
120969,1,5,7,-2,3,1
379328,3,10,13,-3,16,1
231972,1,0,0,0,1,1
218127,2,7,3,4,12,0
417072,3,20,0,20,15,1
152665,3,17,6,11,17,0
3525,4,17,30,-13,2,0
212237,4,3,24,-21,10,0
138910,1,0,3,-3,12,1
323613,1,7,0,7,8,0
126307,1,0,7,-7,6,1
339183,4,30,13,17,15,0
108922,1,0,0,0,15,1
13387,1,0,0,0,7,0
61575,3,28,7,21,11,1
130691,4,7,38,-31,8,0
337390,4,21,14,7,14,0
127961,3,23,13,10,6,0
332271,1,0,3,-3,12,0
361709,4,10,39,-29,7,1
201569,4,32,28,4,5,1
214451,3,7,14,-7,11,0
89033,1,6,3,3,6,0
368969,2,7,7,0,11,0
21086,1,0,0,0,10,1
57936,3,13,17,-4,10,0
383733,4,16,24,-8,17,0
55760,1,0,0,0,9,1
70915,3,15,33,-18,15,0
248256,1,0,0,0,8,1
250738,1,3,0,3,10,0
381433,4,23,7,16,16,0
139757,4,21,21,0,12,0
278443,2,22,0,22,4,1
326385,4,20,10,10,9,1
355777,4,10,9,1,5,1
167926,4,21,19,2,7,1
8049,2,17,7,10,4,0
63753,2,7,15,-8,12,1
401423,3,17,7,10,8,0
227025,3,10,6,4,16,1
214806,4,10,27,-17,11,0
349934,4,10,12,-2,2,0
140948,4,23,13,10,13,1
57060,3,7,20,-13,9,0
276236,4,31,10,21,3,0
19228,4,28,19,9,10,0
353053,1,7,0,7,3,0
42051,2,20,7,13,2,0
192998,4,17,17,0,1,0
39432,3,10,10,0,1,0
186238,1,0,0,0,15,1
203453,2,7,3,4,6,1
387449,4,21,16,5,2,0
91605,2,7,7,0,8,0
217307,2,0,7,-7,12,0
17862,3,24,17,7,9,0
364321,4,9,32,-23,9,0
77806,2,7,14,-7,1,0
12337,1,0,0,0,6,0
193160,4,16,6,10,1,0
102313,3,13,10,3,13,0
74466,1,0,0,0,17,0
158595,1,7,7,0,3,0
169716,4,20,17,3,8,0
294555,4,24,13,11,12,1
3206,4,16,9,7,2,0
91731,1,0,0,0,8,0
412299,2,7,7,0,13,0
42165,1,7,0,7,2,0
7518,4,29,6,23,4,1
350889,2,0,14,-14,3,0
209164,1,0,7,-7,8,0
134872,1,7,0,7,10,0
12021,4,24,14,10,6,1
149845,3,3,13,-10,16,0
208488,2,37,7,30,8,0
143434,1,0,0,0,14,1
178884,1,0,0,0,12,0
162285,1,0,0,0,4,1
241005,4,27,30,-3,5,1
10846,4,21,20,1,5,0
109975,2,10,0,10,16,0
148469,3,14,3,11,16,1
48840,2,3,0,3,5,1
56665,1,0,0,0,9,0
39083,2,13,0,13,1,0
189102,4,31,30,1,16,0
281660,3,24,10,14,6,1
281614,2,21,0,21,6,0
45164,3,7,10,-3,4,1
62144,3,7,7,0,12,0
34882,3,20,7,13,16,0
82801,3,9,9,0,3,0
30602,3,17,0,17,14,0
308684,2,7,6,1,1,1
148392,1,0,0,0,16,1
330875,3,13,17,-4,11,0
332531,4,30,16,14,12,1
353231,2,13,10,3,4,1
416995,1,0,0,0,15,0
334701,3,15,3,12,13,0
130901,1,0,6,-6,8,0
62275,2,21,10,11,12,0
113412,2,0,7,-7,17,0
38918,1,10,0,10,1,0
343026,2,3,0,3,16,1
334526,2,14,14,0,13,1
23997,4,26,6,20,12,0
19482,4,24,17,7,10,0
86852,3,9,23,-14,5,0
48117,2,7,6,1,5,1
239110,2,10,10,0,4,1
143838,4,12,7,5,14,1
261285,4,38,0,38,14,1
335699,2,7,7,0,13,1
81763,4,31,17,14,3,0
80827,3,3,3,0,3,1
135659,2,7,10,-3,10,1
371523,1,0,0,0,12,0
96596,2,3,3,0,10,1
151443,2,21,0,21,17,0
318430,2,21,7,14,5,1
2672,2,6,0,6,2,0
411444,2,7,17,-10,13,1
278280,1,7,0,7,4,0
274717,3,10,12,-2,3,0
291558,2,10,3,7,11,0
347091,1,3,3,0,1,0
86192,4,31,10,21,5,1
94499,2,0,0,0,9,1
413941,1,3,7,-4,14,1
42176,1,7,0,7,2,0
81981,2,0,0,0,3,1
142735,2,9,10,-1,13,1
4824,4,27,3,24,3,1
93797,4,3,19,-16,9,1
232133,1,0,0,0,1,1
371747,3,14,14,0,12,0
215085,4,19,7,12,11,0
64959,1,0,0,0,13,1
377930,4,30,16,14,15,1
93610,3,13,6,7,9,0
145765,2,10,10,0,15,0
396996,2,7,3,4,6,0
309337,4,3,23,-20,1,0
215213,3,10,16,-6,11,0
47895,4,21,13,8,5,1
112596,3,31,26,5,17,0
212868,1,0,0,0,10,0
326153,1,0,7,-7,9,1
273035,3,6,3,3,2,0
357145,4,6,14,-8,5,0
399497,3,0,24,-24,7,1
354982,3,7,12,-5,4,1
187198,1,0,0,0,16,1
149095,3,14,17,-3,16,1
149917,4,6,23,-17,16,0
270679,2,3,3,0,1,1
216306,1,7,7,0,12,1
140263,1,6,0,6,12,1
332513,4,23,15,8,12,0
146634,1,0,7,-7,15,1
132742,4,13,17,-4,9,1
25461,4,13,17,-4,12,0
130566,4,13,13,0,8,0
364250,2,0,19,-19,9,1
105928,1,0,0,0,14,1
181567,2,13,0,13,13,0
155385,2,13,3,10,2,0
345490,1,0,0,0,17,0
220373,2,13,6,7,13,0
72062,3,7,10,-3,16,0
333306,1,7,0,7,12,1
276577,1,0,0,0,4,1
309122,2,23,3,20,1,0
323100,3,26,14,12,7,1
265327,2,7,0,7,16,0
78515,1,0,0,0,2,0
379945,4,21,6,15,16,1
103849,3,19,0,19,13,1
64837,2,7,0,7,13,1
348071,2,0,16,-16,1,1
254329,3,13,19,-6,11,0
96064,4,13,14,-1,10,0
87367,1,7,0,7,6,1
162021,2,14,6,8,4,0
151439,1,21,0,21,17,0
410974,1,0,7,-7,13,1
391684,2,0,3,-3,4,1
353961,5,31,31,0,4,1
78615,4,23,13,10,2,1
143724,4,19,17,2,14,0
383177,1,0,0,0,17,0
111130,4,31,10,21,16,0
275932,3,20,18,2,3,0
383816,2,3,7,-4,1,0
195611,4,24,7,17,2,1
239990,2,0,13,-13,5,1
322034,2,6,0,6,7,1
61567,3,28,7,21,11,1
284971,4,13,20,-7,7,1
97909,1,0,0,0,11,0
269641,2,3,0,3,1,1
191019,4,26,3,23,17,0
183535,2,7,10,-3,14,1
13857,1,7,0,7,7,0
114211,2,3,7,-4,1,1
114812,3,13,20,-7,1,0
369801,4,52,50,2,11,1
247341,4,42,48,-6,8,1
412534,4,31,14,17,14,0
9153,2,0,13,-13,5,1
248372,1,0,0,0,8,0
292767,3,26,17,9,11,1
363540,3,3,5,-2,8,0
227619,3,28,0,28,16,1
334671,2,15,3,12,13,0
269050,2,10,13,-3,17,0
78479,4,24,0,24,2,0
385126,2,7,10,-3,1,1
396800,1,0,7,-7,6,1
191181,1,0,3,-3,17,0
412097,4,31,3,28,13,1
100076,3,6,6,0,12,0
194781,3,10,16,-6,2,0
343591,1,12,7,5,17,1
254361,4,13,30,-17,11,0
321880,2,14,14,0,7,0
163165,4,22,28,-6,5,1
416554,1,0,0,0,15,0
360912,3,24,0,24,7,0
25283,3,34,7,27,12,0
133685,4,30,35,-5,9,1
410103,2,14,7,7,13,1
165827,2,3,9,-6,6,1
40559,1,7,0,7,2,1
41050,3,3,13,-10,2,0
23945,3,16,0,16,12,0
238669,3,16,14,2,4,0
20677,3,10,17,-7,10,1
163644,4,21,29,-8,5,1
169984,3,21,10,11,8,0
32864,3,6,7,-1,15,1
120633,4,3,27,-24,3,1
102830,4,10,10,0,13,1
60113,3,20,19,1,11,1
274598,4,24,26,-2,3,0
318351,4,9,22,-13,5,1
262400,2,7,7,0,15,0
369086,1,3,0,3,11,1
352293,4,3,6,-3,3,1
187372,2,20,7,13,16,1
51958,4,13,16,-3,7,0
278582,1,7,0,7,4,1
265559,1,0,0,0,16,0
293750,1,7,0,7,12,1
113557,2,0,0,0,17,0
169472,1,0,14,-14,8,1
187826,2,7,10,-3,16,0
58200,1,0,0,0,10,0
38478,1,0,3,-3,1,1
323463,1,0,3,-3,7,0
131592,4,9,26,-17,8,1
282280,4,25,17,8,6,1
135068,2,17,3,14,10,0
180079,4,28,20,8,13,1
348949,1,7,0,7,2,1
133848,1,0,0,0,9,0
114283,1,0,0,0,1,0
312735,4,31,14,17,3,0
288091,2,10,0,10,9,0
410356,1,0,0,0,13,1
284071,4,13,10,3,7,1
343577,1,12,0,12,17,1
65036,3,0,17,-17,13,1
326764,2,3,7,-4,9,0
252105,1,7,7,0,10,0
103810,2,9,0,9,13,0
225139,1,0,0,0,15,0
44842,2,0,7,-7,4,0
382396,2,0,21,-21,17,1
107375,4,19,6,13,15,0
345805,1,0,7,-7,17,1
344687,3,6,20,-14,17,1
53559,3,14,12,2,8,0
318779,4,17,26,-9,5,0
119791,3,17,6,11,3,0
278819,3,7,21,-14,5,1
234665,3,23,20,3,2,0
229549,2,17,6,11,17,0
36002,1,0,0,0,17,1
191622,5,27,24,3,17,0
323186,2,7,0,7,7,0
75652,4,13,6,7,17,1
159507,1,7,0,7,3,1
164138,1,0,0,0,5,1
376985,3,15,16,-1,15,1
167173,2,13,7,6,7,1
149360,2,3,0,3,16,1
54690,4,34,29,5,8,0
121835,2,0,7,-7,4,0
342929,4,23,17,6,16,1
24161,1,0,0,0,12,1
37459,1,0,7,-7,17,1
41131,1,0,0,0,2,1
174433,4,17,10,7,10,0
254555,1,0,0,0,11,0
367388,2,10,14,-4,10,1
289456,2,3,7,-4,10,0
379085,4,7,12,-5,15,1
265244,3,9,6,3,16,0
393173,1,0,3,-3,5,1
341362,2,0,10,-10,16,0
184880,1,0,0,0,15,1
341436,4,0,16,-16,16,1
9505,3,13,10,3,5,1
320459,3,17,17,0,6,1
279956,2,0,10,-10,5,1
163578,2,7,16,-9,5,0
365859,2,7,7,0,9,1
257509,2,16,10,6,13,1
200786,4,31,10,21,4,1
361048,2,16,2,14,7,0
407205,1,0,3,-3,11,1
414762,4,10,17,-7,14,1
266239,3,31,19,12,16,1
7119,3,28,21,7,4,1
201833,3,20,23,-3,5,0
55202,1,7,0,7,9,1
302985,3,20,16,4,16,1
402185,4,19,14,5,9,1
32153,1,0,0,0,15,0
375915,2,14,3,11,14,0
164354,3,20,3,17,5,1
230619,4,16,24,-8,1,1
298935,2,3,6,-3,14,0
102425,1,3,0,3,13,0
207550,1,14,0,14,7,1
75859,2,14,0,14,1,0
58371,2,21,0,21,10,1
319739,1,0,0,0,6,0
365910,4,14,21,-7,9,0
43291,1,0,0,0,3,0
23258,4,30,13,17,11,0
416571,1,0,0,0,15,1
273122,1,0,0,0,2,1
91447,2,3,0,3,8,0
156671,3,6,14,-8,2,1
253065,2,14,0,14,11,0
415178,3,10,24,-14,15,0
309566,3,16,0,16,1,0
267495,1,3,14,-11,17,1
356620,1,0,0,0,5,1
84680,1,3,0,3,4,0
391582,3,10,21,-11,4,0
115231,2,0,3,-3,1,0
229101,2,13,7,6,17,0
293656,2,10,7,3,12,1
147729,4,17,17,0,15,0
14420,1,14,3,11,7,1
301449,2,10,3,7,15,1
82026,3,10,0,10,3,0
149668,2,17,0,17,16,1
413040,1,0,0,0,14,1
327220,1,0,3,-3,9,0
97295,1,0,0,0,10,1
290764,1,0,0,0,10,1
123531,3,10,10,0,4,1
119070,1,0,7,-7,3,1
318377,1,7,0,7,5,0
291403,2,7,7,0,10,1
318755,3,10,23,-13,5,1
312089,3,24,7,17,2,0
319437,2,0,0,0,6,0
16242,3,3,3,0,8,1
101635,4,13,38,-25,12,1
190337,1,0,0,0,17,1
319485,3,3,10,-7,6,0
188101,2,0,3,-3,16,1
121112,4,25,31,-6,3,1
333999,3,17,13,4,12,1
30134,2,10,10,0,14,0
55363,1,7,7,0,9,1
359543,1,0,0,0,6,0
40378,4,15,10,5,2,0
14418,1,14,3,11,7,1
36436,1,0,3,-3,17,0
344146,3,26,3,23,17,1
78667,1,0,0,0,2,1
87550,2,17,3,14,6,1
122908,4,34,6,28,4,0
303733,2,14,10,4,16,1
418494,4,24,12,12,16,0
228019,2,0,0,0,17,1
341190,2,10,6,4,16,0
132663,1,0,3,-3,9,1
108352,2,0,14,-14,15,1
377591,4,20,12,8,15,1
96358,4,3,30,-27,10,1
113554,1,0,0,0,17,1
182094,1,0,0,0,13,1
246001,1,0,3,-3,7,0
319288,2,10,3,7,6,0
37949,3,10,14,-4,1,1
171636,3,19,10,9,9,0
16291,4,25,29,-4,8,1
183605,1,0,0,0,14,0
348866,3,3,14,-11,2,1
286713,2,17,7,10,8,0
10059,2,28,6,22,5,0
189056,3,14,17,-3,16,1
15000,1,0,7,-7,7,1
138211,3,7,12,-5,11,1
396599,4,20,10,10,6,0
252138,2,10,10,0,10,0
321363,4,36,22,14,6,0
295522,2,14,7,7,12,1
216027,2,7,12,-5,11,1
163426,2,7,20,-13,5,1
417309,1,7,3,4,16,0
328478,3,6,3,3,10,1
78032,4,12,16,-4,1,0
38851,4,3,10,-7,1,0
286622,4,17,41,-24,8,1
299165,4,10,16,-6,14,0
356828,3,0,13,-13,5,0
59990,4,3,31,-28,11,1
324186,4,3,17,-14,8,0
317912,1,7,0,7,5,1
227511,4,19,17,2,16,1
39213,1,0,0,0,1,1
189737,1,0,6,-6,17,1
91240,4,20,17,3,8,1
408639,3,28,10,18,12,1
106112,2,0,0,0,14,1
21756,4,31,17,14,11,0
396713,3,7,14,-7,6,1
412122,1,0,0,0,13,1
153646,1,0,0,0,1,1
32785,1,0,0,0,15,0
4066,2,13,21,-8,2,1
265631,3,6,15,-9,16,0
324708,2,7,7,0,8,1
388519,4,3,23,-20,2,1
203186,2,7,17,-10,5,0
67414,1,7,0,7,14,0
335988,2,13,15,-2,13,0
303985,1,0,0,0,16,0
83026,1,0,0,0,4,1
267787,1,3,0,3,17,1
357528,2,10,6,4,5,0
262518,4,28,35,-7,15,1
228153,1,7,10,-3,17,0
408205,3,13,3,10,12,1
347332,4,7,21,-14,1,1
339918,4,26,0,26,15,1
34735,3,6,3,3,16,0
386092,3,14,6,8,1,1
112921,4,16,6,10,17,1
100007,1,3,0,3,12,0
126784,1,0,3,-3,6,1
273466,2,7,10,-3,2,1
235065,1,0,7,-7,2,0
381225,2,14,10,4,16,1
356812,2,0,7,-7,5,0
305677,2,3,7,-4,17,0
132502,1,0,0,0,9,0
296773,2,7,0,7,13,1
77885,4,17,31,-14,1,1
254944,3,38,7,31,12,1
274454,4,10,17,-7,3,0
151108,4,24,10,14,17,0
58975,1,0,0,0,10,1
306464,3,3,17,-14,17,1
86765,4,27,21,6,5,1
296264,1,0,3,-3,13,0
208201,3,0,10,-10,8,0
303811,4,20,17,3,16,0
72180,2,3,10,-7,16,1
358916,4,6,35,-29,6,1
417842,2,10,3,7,16,0
314763,2,14,0,14,4,0
312509,2,20,0,20,3,0
36294,1,7,0,7,17,0
211877,4,35,17,18,9,1
232129,1,0,0,0,1,1
241585,3,3,20,-17,5,1
99295,2,10,0,10,11,1
198821,3,6,22,-16,3,0
108453,1,0,0,0,15,0
166318,4,10,9,1,6,1
240565,1,3,0,3,5,0
245186,4,17,28,-11,7,0
253548,2,6,7,-1,11,1
383500,2,14,3,11,17,0
137703,2,0,13,-13,11,1
44356,1,0,0,0,3,1
240278,2,7,7,0,5,0
32400,3,31,6,25,15,0
135141,4,31,6,25,10,0
155317,1,7,0,7,2,0
196984,2,20,10,10,3,0
419278,2,0,7,-7,16,0
281519,4,17,13,4,6,0
325738,1,0,7,-7,9,0
172126,4,13,18,-5,9,1
279548,3,10,6,4,5,1
326518,3,38,9,29,9,0
8754,2,0,0,0,4,1
151663,4,23,27,-4,17,0
122606,3,27,7,20,4,0
26333,4,19,21,-2,13,1
418608,3,14,17,-3,16,0
156279,1,3,0,3,2,0
234152,2,0,7,-7,2,1
410583,3,10,7,3,13,1
316223,1,0,7,-7,4,0
100322,2,9,14,-5,12,1
31596,2,10,3,7,15,0
348907,4,9,21,-12,2,0
82707,4,19,19,0,3,0
361227,3,7,17,-10,7,0
21100,2,0,0,0,10,1
176694,3,29,19,10,11,1
376776,1,7,0,7,15,1
375800,3,20,0,20,14,1
244749,1,0,0,0,7,1
361683,3,10,32,-22,7,1
418475,3,17,6,11,16,1
189035,2,14,7,7,16,0
24504,2,7,7,0,12,0
200344,4,30,14,16,4,0
253691,2,3,3,0,11,0
211914,1,0,0,0,9,0
120774,4,23,6,17,3,1
27182,2,13,7,6,13,0
91992,3,13,23,-10,8,1
216252,4,17,20,-3,12,1
64267,1,0,3,-3,13,1
338894,4,13,25,-12,15,1
130682,3,7,38,-31,8,1
152175,1,7,0,7,17,0
60018,1,0,0,0,11,1
196020,1,0,0,0,2,1
237494,2,14,7,7,3,1
386805,3,10,7,3,2,0
357947,1,7,6,1,6,1
145886,1,0,0,0,15,1
119970,3,16,24,-8,3,0
79013,2,10,7,3,2,0
97692,3,9,10,-1,11,1
96198,3,3,16,-13,10,0
418631,4,21,31,-10,16,1
99564,1,0,0,0,11,0
136334,4,18,7,11,11,0
156280,1,3,0,3,2,0
204563,2,0,35,-35,6,1
145163,2,35,0,35,14,1
272942,1,0,0,0,2,1
343152,1,3,0,3,16,0
338979,3,13,3,10,15,0
138320,2,20,0,20,11,0
406358,2,10,7,3,11,0
175353,1,7,0,7,11,1
310923,3,3,6,-3,2,0
297351,2,3,10,-7,13,1
154260,1,3,7,-4,1,0
104315,2,38,21,17,13,0
253923,4,44,14,30,11,0
105603,4,32,28,4,14,0
277078,2,3,14,-11,4,1
215916,2,3,14,-11,11,1
86677,2,10,0,10,5,0
88380,4,24,10,14,6,0
52597,4,22,10,12,7,1
22347,4,0,6,-6,11,0
237826,2,7,13,-6,4,1
243756,3,17,17,0,6,1
281880,4,16,10,6,6,0
174482,1,7,7,0,10,0
4771,2,13,0,13,3,1
23586,1,7,0,7,12,1
61875,3,20,23,-3,12,1
116870,2,7,7,0,2,0
107179,2,0,21,-21,15,1
407726,2,10,0,10,11,0
20903,4,31,23,8,10,0
396326,4,6,13,-7,6,0
5926,2,7,23,-16,3,1
310927,3,3,9,-6,2,0
82335,3,6,10,-4,3,1
411802,3,0,34,-34,13,1
155388,2,13,3,10,2,1
323276,4,7,17,-10,7,0
217911,4,25,28,-3,12,0
242195,3,16,7,9,6,1
269995,4,16,20,-4,1,1
217076,1,0,0,0,12,0
326701,4,23,13,10,9,0
397824,1,0,0,0,7,0
220362,1,6,0,6,13,0
374411,2,15,0,15,14,0
13974,1,0,0,0,7,0
403018,3,13,21,-8,9,0
369510,1,3,0,3,11,0
310071,1,0,0,0,2,0
164893,2,0,3,-3,6,0
396798,1,0,6,-6,6,0
269211,2,3,6,-3,17,0
155438,4,13,10,3,2,1
176494,2,9,10,-1,11,0
92836,2,14,0,14,8,1
205641,2,7,9,-2,7,1
420435,1,0,7,-7,17,0
351736,1,0,0,0,3,1
58663,1,0,0,0,10,1
218315,3,17,14,3,12,0
350818,4,23,10,13,2,0
44296,3,17,20,-3,3,0
177782,1,0,0,0,12,1
377544,2,7,9,-2,15,0
149597,4,17,26,-9,16,0
35650,3,20,3,17,17,1
235617,4,27,34,-7,3,1
371621,3,17,17,0,12,1
321970,4,28,28,0,7,1
24289,4,13,17,-4,12,0
87859,2,10,9,1,6,1
66856,1,0,7,-7,14,0
62589,2,6,10,-4,12,0
251131,4,10,17,-7,10,0
19937,4,22,21,1,10,0
227581,2,28,0,28,16,0
75484,4,31,7,24,17,1
238078,4,13,13,0,4,0
92396,2,10,7,3,8,1
193621,4,7,17,-10,1,1
245353,1,6,0,6,7,1
240380,5,24,23,1,5,0
150291,2,14,7,7,16,1
142649,3,20,13,7,13,0
322707,5,9,12,-3,7,0
245278,3,9,3,6,7,1
82877,1,0,0,0,4,1
28752,4,10,16,-6,14,1
145225,4,56,0,56,14,0
269446,1,0,0,0,1,0
94181,2,17,7,10,9,0
231330,3,9,10,-1,1,1
350774,3,10,3,7,2,1
386637,2,7,13,-6,2,1
304518,3,10,14,-4,16,1
251224,2,10,24,-14,10,0
388368,4,17,12,5,2,0
262000,3,17,17,0,14,1
156997,4,13,13,0,2,0
157880,2,6,15,-9,3,1
258601,3,13,10,3,13,1
87864,2,10,9,1,6,0
117746,1,0,3,-3,2,1
92943,1,0,0,0,8,1
341157,1,0,0,0,16,1
275876,2,10,3,7,3,0
194007,2,14,7,7,1,1
284879,1,0,0,0,7,0
30139,2,10,10,0,14,0
385265,2,7,3,4,1,0
125960,4,16,20,-4,6,0
219296,2,10,7,3,13,1
98670,1,0,0,0,11,0
248319,3,17,7,10,8,0
149854,3,3,16,-13,16,1
406748,1,0,3,-3,11,1
317529,3,10,27,-17,5,0
9244,4,10,30,-20,5,0
67383,4,30,6,24,14,0
28374,2,6,0,6,14,1
243179,5,23,22,1,6,1
115386,2,20,0,20,1,0
210529,1,0,0,0,9,1
71181,3,19,10,9,16,0
230601,3,16,17,-1,1,0
345874,2,3,14,-11,17,1
309031,4,0,20,-20,1,1
119646,4,17,12,5,3,1
377786,1,0,0,0,15,0
294011,1,0,0,0,12,1
271248,1,3,0,3,1,0
214151,3,3,9,-6,11,1
103500,2,13,0,13,13,1
312913,4,21,24,-3,3,1
390447,4,14,33,-19,3,1
152777,3,7,7,0,17,0
116772,4,16,26,-10,2,1
230145,3,3,23,-20,17,1
343169,1,3,0,3,16,0
296355,4,13,25,-12,13,1
16102,3,33,7,26,8,0
119957,2,9,24,-15,3,1
229309,4,24,27,-3,17,1
190720,4,42,17,25,17,1
260486,2,13,0,13,14,1
299556,2,3,3,0,14,1
116877,2,7,7,0,2,1
330441,4,13,20,-7,11,0
324172,4,3,17,-14,8,1
314636,3,7,7,0,3,0
199711,3,28,7,21,4,0
372441,2,6,14,-8,13,1
69063,1,0,0,0,15,1
368953,2,7,7,0,11,1
257805,2,7,0,7,13,0
338212,2,14,21,-7,14,1
41784,3,10,14,-4,2,0
311831,4,17,20,-3,2,1
385899,2,3,7,-4,1,0
369850,2,7,0,7,12,0
216069,3,17,12,5,11,1
371061,3,13,13,0,12,0
136253,2,12,7,5,11,1
5444,4,20,23,-3,3,1
38958,2,23,3,20,1,0
380214,2,13,16,-3,16,1
146840,2,24,0,24,15,0
77214,2,6,0,6,1,1
191959,2,0,13,-13,1,1
192580,1,3,0,3,1,0
244365,2,0,17,-17,7,1
376157,1,0,0,0,14,1
247000,4,20,24,-4,8,0
135795,2,7,14,-7,10,1
171961,4,14,14,0,9,0
168980,1,3,7,-4,7,0
144160,4,23,13,10,14,1
34963,1,0,0,0,16,1
264050,1,7,14,-7,15,0
41835,4,27,14,13,2,1
245474,4,23,6,17,7,0
301112,1,0,0,0,15,0
154431,2,14,0,14,1,0
411393,4,20,13,7,13,0
132665,1,0,3,-3,9,1
387590,4,6,3,3,2,1
264892,2,10,14,-4,16,0
138122,1,7,3,4,11,1
390498,1,7,0,7,3,1
420478,2,0,34,-34,17,0
154366,4,34,24,10,1,0
349084,1,7,0,7,2,0
366827,2,0,3,-3,10,0
357789,1,3,7,-4,6,0
348844,2,3,14,-11,2,1
393616,4,7,33,-26,5,1
414043,4,10,45,-35,14,1
396727,3,7,14,-7,6,0
336202,4,24,10,14,13,0
369863,2,7,3,4,12,0
84485,4,20,10,10,4,0
378192,4,24,16,8,15,1
341060,2,7,17,-10,15,1
176616,1,0,3,-3,11,0
402918,4,17,9,8,9,0
351368,3,10,7,3,3,0
304057,2,3,20,-17,16,1
194274,2,7,0,7,2,1
15259,4,23,7,16,8,0
73701,4,20,9,11,17,1
249387,3,18,15,3,9,0
400830,3,24,13,11,8,0
203799,3,17,17,0,6,1
278190,3,24,21,3,4,1
187118,3,10,0,10,16,1
366631,4,26,14,12,10,0
415557,2,0,7,-7,15,1
234949,2,10,3,7,2,0
327840,2,16,10,6,10,0
273715,1,0,0,0,2,1
133754,2,7,7,0,9,0
184487,2,7,7,0,14,1
110013,3,27,10,17,16,0
322965,4,13,0,13,7,0
113802,4,13,24,-11,17,1
152407,4,35,3,32,17,1
380072,3,35,20,15,16,0
332580,2,10,3,7,12,1
67638,3,7,35,-28,14,0
27948,3,14,10,4,13,0
415125,2,0,20,-20,15,0
408669,4,28,17,11,12,1
384270,2,6,0,6,1,0
361737,1,7,0,7,7,0
64186,3,31,6,25,13,0
347515,4,12,30,-18,1,1
313821,1,7,0,7,3,0
168071,4,6,24,-18,7,1
66360,3,14,24,-10,14,1
187749,4,16,20,-4,16,0
168468,3,0,24,-24,7,1
124734,3,3,3,0,5,0
169739,1,0,0,0,8,0
82827,4,12,16,-4,3,1
210153,2,0,7,-7,9,1
369973,2,7,0,7,12,0
286554,2,10,21,-11,8,1
257340,2,17,0,17,13,1
214510,4,7,23,-16,11,1
209824,1,10,10,0,8,1
251342,2,14,7,7,10,0
333841,3,14,21,-7,12,1
106260,1,0,0,0,14,0
419555,1,7,7,0,17,1
49041,3,10,10,0,6,0
112976,2,7,0,7,17,0
247992,2,14,3,11,8,0
274943,4,17,16,1,3,0
340522,3,0,40,-40,15,0
295019,4,31,21,10,12,0
76653,3,10,0,10,1,1
248962,4,20,3,17,9,1
285463,4,36,8,28,8,1
317995,3,10,10,0,5,0
343189,2,3,0,3,16,0
99423,1,0,0,0,11,1
315035,2,21,7,14,4,1
369107,2,6,7,-1,11,1
242315,2,10,10,0,6,1
68184,2,7,7,0,14,0
295746,4,10,16,-6,12,1
87724,3,6,20,-14,6,1
168953,1,0,0,0,7,1
118258,2,9,7,2,2,1
160476,2,20,7,13,4,1
364673,2,3,0,3,9,1
410522,1,7,0,7,13,0
113332,4,19,31,-12,17,0
161523,1,0,0,0,4,1
167225,3,23,17,6,7,0
363942,2,0,3,-3,8,0
252160,3,17,10,7,10,1
238607,1,6,0,6,4,1
408809,3,10,25,-15,12,1
367952,1,3,13,-10,11,0
27644,3,7,20,-13,13,0
382345,1,0,0,0,17,0
33133,3,10,35,-25,16,1
63284,2,3,0,3,12,0
174127,4,8,36,-28,10,1
34587,3,17,7,10,16,1
144265,3,16,7,9,14,0
77074,2,7,17,-10,1,1
375690,4,26,20,6,14,0
190005,4,16,10,6,17,1
282670,2,6,17,-11,6,1
340970,4,17,17,0,15,0
366615,4,26,14,12,10,0
409438,4,34,3,31,12,0
330843,2,10,17,-7,11,1
338884,4,13,22,-9,15,0
92127,3,3,24,-21,8,0
391147,3,7,24,-17,4,1
264453,4,20,28,-8,15,0
197271,2,0,0,0,3,1
358253,2,0,14,-14,6,1
399117,4,10,36,-26,7,1
290931,2,14,0,14,10,0
333877,4,28,28,0,12,1
243998,1,7,7,0,6,1
321488,4,24,30,-6,7,1
64933,4,10,6,4,13,1
125044,4,3,19,-16,5,1
415219,4,17,31,-14,15,0
137584,4,20,34,-14,11,1
406492,2,0,13,-13,11,0
151655,3,23,27,-4,17,1
123360,3,21,17,4,4,1
366447,3,34,10,24,10,0
49670,3,7,14,-7,6,0
298800,2,14,6,8,14,0
130781,2,13,3,10,8,1
312960,1,0,0,0,3,1
374855,2,7,3,4,14,1
209546,2,34,17,17,8,0
55025,1,0,0,0,8,0
267471,1,0,7,-7,17,0
382519,2,0,3,-3,17,0
75758,3,28,16,12,1,0
246187,2,14,3,11,7,0
189701,4,20,6,14,17,0
338442,1,0,0,0,14,0
100166,2,7,0,7,12,0
61382,2,7,3,4,11,1
199318,1,0,0,0,4,1
394121,1,6,7,-1,5,1
51782,4,3,19,-16,7,1
362199,2,6,3,3,8,0
224160,2,0,20,-20,15,1
28733,4,10,16,-6,14,1
181876,3,21,21,0,13,1
150474,3,27,6,21,16,1
245319,4,16,13,3,7,0
149636,1,0,0,0,16,1
149539,2,14,9,5,16,1
16920,2,14,13,1,8,1
161251,2,17,3,14,4,0
209742,3,9,6,3,8,0
274852,2,0,10,-10,3,1
51812,4,10,28,-18,7,1
247549,2,13,10,3,8,0
19133,2,14,3,11,10,0
78363,4,38,35,3,2,0
366621,4,26,14,12,10,1
213941,2,16,7,9,10,1
45780,3,13,14,-1,4,0
143616,2,10,3,7,14,0
251095,3,10,14,-4,10,0
256958,4,32,27,5,12,0
128200,2,14,7,7,7,0
418764,3,7,21,-14,16,1
283613,3,13,20,-7,7,1
44836,1,0,7,-7,4,0
182015,2,14,14,0,13,1
42593,1,0,0,0,3,0
106226,5,10,10,0,14,0
272271,4,9,9,0,2,0
88778,2,13,9,4,6,0
145304,2,14,12,2,14,1
147602,4,15,0,15,15,0
217916,4,25,28,-3,12,1
290054,2,7,6,1,10,1
141746,4,33,21,12,13,1
217294,2,0,7,-7,12,0
252422,1,0,0,0,10,0
248479,3,17,6,11,8,0
234334,2,17,0,17,2,0
274040,1,10,0,10,3,0
310612,2,13,27,-14,2,0
140155,3,10,3,7,12,0
217356,4,21,10,11,12,1
28555,3,33,7,26,14,0
344860,4,30,10,20,17,1
93721,2,0,3,-3,9,0
315001,1,7,0,7,4,1
313273,2,6,7,-1,3,0
290691,3,41,22,19,10,0
110403,1,7,0,7,16,0
333027,2,3,9,-6,12,1
139223,1,3,6,-3,12,0
51241,4,39,25,14,7,0
95280,3,10,23,-13,10,0
295942,4,13,24,-11,12,0
35171,2,0,14,-14,16,0
26537,1,3,3,0,13,0
246433,1,7,0,7,8,0
80895,1,3,0,3,3,1
213845,3,45,6,39,10,0
260133,4,6,35,-29,14,1
41133,1,0,0,0,2,0
141941,2,10,0,10,13,0
190524,2,10,6,4,17,0
371498,4,17,24,-7,12,0
240944,3,14,9,5,5,1
416784,3,10,10,0,15,0
264025,1,6,0,6,15,1
173993,1,0,6,-6,10,1
12481,1,0,0,0,6,0
334621,4,38,31,7,13,1
290825,3,10,14,-4,10,1
415093,1,0,7,-7,15,1
296967,4,29,7,22,13,0
204720,2,7,14,-7,6,1
367588,3,27,12,15,10,1
103638,2,0,7,-7,13,0
252143,2,10,10,0,10,1
187902,4,7,23,-16,16,0
261542,3,12,7,5,14,1
240673,4,36,24,12,5,0
410964,1,0,0,0,13,0
257420,4,23,14,9,13,0
25803,1,3,0,3,12,0
389786,2,10,6,4,3,0
19709,2,3,6,-3,10,1
138644,2,3,21,-18,12,0
146038,2,10,0,10,15,1
207761,3,24,13,11,7,1
147311,4,7,31,-24,15,0
122951,1,0,0,0,4,0
127367,4,10,20,-10,6,0
341235,3,16,10,6,16,1
53998,1,0,0,0,8,1
99308,2,13,0,13,11,0
18815,1,3,0,3,9,0
185021,4,14,32,-18,15,0
77226,2,9,0,9,1,1
378020,3,0,7,-7,15,1
71674,4,3,34,-31,16,0
161513,4,17,6,11,4,0
136522,1,0,7,-7,11,0
234970,3,13,3,10,2,0
338811,2,10,0,10,15,0
63037,3,16,21,-5,12,0
27417,1,0,0,0,13,1
265043,2,10,3,7,16,0
411116,1,0,0,0,13,0
410912,3,14,15,-1,13,1
368892,4,31,3,28,11,1
306563,1,0,14,-14,17,0
365854,2,7,0,7,9,0
147944,4,31,41,-10,15,1
145014,2,3,3,0,14,1
52467,1,3,0,3,7,0
243770,3,17,17,0,6,0
398679,4,0,6,-6,7,0
365310,3,10,16,-6,9,1
305716,3,9,7,2,17,0
56748,3,7,10,-3,9,0
381973,2,0,20,-20,17,0
99858,1,0,0,0,12,1
37194,2,3,7,-4,17,0
379923,3,21,6,15,16,0
294102,4,7,27,-20,12,1
13569,2,3,0,3,7,0
301305,2,14,7,7,15,0
37515,3,10,7,3,17,0
90471,3,0,20,-20,7,1
247720,3,7,6,1,8,0
156231,4,16,23,-7,2,1
264636,4,20,20,0,16,0
259740,2,10,7,3,14,0
295698,2,3,9,-6,12,1
212186,3,3,17,-14,10,0
28290,4,24,14,10,13,1
261003,4,10,3,7,14,0
217526,1,0,0,0,12,1
337997,4,23,0,23,14,1
354995,3,7,19,-12,4,1
182694,4,11,19,-8,14,1
354078,3,19,0,19,4,0
386294,1,0,0,0,2,0
123425,1,0,0,0,4,0
69588,3,7,10,-3,15,0
311376,3,28,13,15,2,0
72302,1,0,0,0,16,1
417863,3,10,10,0,16,1
247314,4,42,28,14,8,0
394610,3,17,0,17,5,1
51630,3,21,20,1,7,1
324265,2,15,0,15,8,0
364529,2,3,14,-11,9,1
212961,3,14,7,7,10,1
80804,3,3,0,3,3,0
107741,2,7,7,0,15,0
146821,2,17,0,17,15,0
181906,4,21,35,-14,13,1
68863,3,6,17,-11,15,1
81877,2,0,24,-24,3,0
405118,3,0,10,-10,10,1
383862,4,3,7,-4,1,1
136666,1,0,0,0,11,1
163842,1,0,0,0,5,1
169740,1,0,0,0,8,0
230102,1,0,3,-3,17,0
82895,1,3,0,3,4,0
300084,4,7,40,-33,14,1
326051,2,9,0,9,9,0
386298,1,0,0,0,2,1
241156,4,20,10,10,5,1
366208,1,0,0,0,10,1
111697,3,31,13,18,16,0
165234,2,14,7,7,6,1
31386,4,7,3,4,15,1
146659,2,7,23,-16,15,0
7390,1,3,0,3,4,0
306765,3,16,20,-4,17,0
288029,1,0,0,0,9,1
261230,2,21,0,21,14,1
363023,4,33,26,7,8,0
236140,2,0,10,-10,3,1
145860,1,0,0,0,15,1
339667,1,0,0,0,15,1
151458,2,27,7,20,17,1
396968,1,7,0,7,6,0
274146,4,27,0,27,3,0
48430,3,17,17,0,5,0
75693,1,14,0,14,1,0
362927,2,14,0,14,8,0
61629,1,0,0,0,12,0
14786,3,38,3,35,7,0
193249,3,3,16,-13,1,0
262613,3,23,3,20,15,0
321524,1,0,0,0,7,0
308679,2,7,6,1,1,0
141353,2,3,17,-14,13,1
242463,2,3,7,-4,6,0
209684,2,6,0,6,8,1
24060,2,7,7,0,12,0
378506,4,23,0,23,15,1
120946,1,0,0,0,3,1
151757,2,7,6,1,17,1
306019,2,3,10,-7,17,1
301783,3,0,27,-27,15,1
347407,5,21,21,0,1,1
131008,4,17,30,-13,8,0
273605,2,10,3,7,2,1
45233,1,0,0,0,4,1
103573,4,33,0,33,13,0
392791,2,17,3,14,4,0
281031,3,17,13,4,6,1
155422,3,13,10,3,2,0
371417,2,7,7,0,12,0
264059,2,7,14,-7,15,0
333809,2,14,14,0,12,1
173195,3,20,17,3,9,1
412240,4,21,9,12,13,1
84645,4,23,16,7,4,1
146064,2,13,3,10,15,1
164096,4,12,6,6,5,0
349514,1,0,0,0,2,0
68232,3,19,14,5,14,1
7871,2,3,14,-11,4,0
199676,2,14,7,7,4,1
359263,1,0,3,-3,6,0
1204,2,10,0,10,1,0
100990,4,13,16,-3,12,0
323139,1,0,0,0,7,0
132181,4,29,13,16,9,1
276670,3,23,6,17,4,0
413810,1,13,0,13,14,1
2077,2,0,7,-7,1,1
307910,1,0,0,0,1,0
172872,3,24,10,14,9,0
345688,2,7,0,7,17,1
167427,1,0,0,0,7,1
280082,1,7,0,7,5,0
122676,1,0,3,-3,4,1
225907,2,14,0,14,16,0
45146,2,7,7,0,4,0
74852,3,20,20,0,17,1
18667,1,0,0,0,9,0
114297,1,0,6,-6,1,1
106645,4,46,7,39,14,0
407059,1,0,3,-3,11,1
62267,2,21,7,14,12,0
54438,1,0,0,0,8,1
244109,4,20,34,-14,6,0
125806,4,17,23,-6,5,1
44223,1,7,10,-3,3,1
18324,3,22,17,5,9,0
335115,2,3,0,3,13,0
313758,3,28,10,18,3,1
20803,2,14,0,14,10,0
41302,2,0,3,-3,2,1
71632,3,3,31,-28,16,0
47024,2,17,0,17,5,0
182483,3,14,0,14,14,1
161990,1,7,0,7,4,0
72672,3,13,10,3,16,1
157486,4,23,37,-14,2,0
16982,4,27,23,4,8,0
410118,2,17,7,10,13,0
329766,2,16,6,10,11,1
334360,2,0,3,-3,13,0
231258,1,0,3,-3,1,0
382742,4,9,20,-11,17,1
157924,3,9,15,-6,3,1
146769,1,7,0,7,15,0
416421,1,7,0,7,15,0
401066,1,14,3,11,8,0
149891,4,6,16,-10,16,1
78641,4,30,13,17,2,1
384506,4,28,12,16,1,1
371699,1,7,7,0,12,0
152293,1,0,0,0,17,0
89394,2,10,20,-10,7,0
88078,4,24,3,21,6,0
1625,1,0,0,0,1,0
200476,3,23,18,5,4,1
304193,2,13,7,6,16,0
413747,4,24,16,8,14,0
278107,1,0,0,0,4,0
116696,2,6,3,3,2,0
150592,2,3,13,-10,17,1
228083,3,3,10,-7,17,1
412325,2,7,14,-7,13,1
14337,3,2,7,-5,7,1
122368,1,0,0,0,4,0
307706,4,17,31,-14,17,1
294201,2,0,7,-7,12,1
235557,3,10,13,-3,3,1
111183,1,7,0,7,16,1
56587,3,19,17,2,9,1
246089,4,19,13,6,7,0
320073,1,3,0,3,6,1
291485,4,21,20,1,10,0
400437,4,24,10,14,8,0
292794,4,29,17,12,11,0
291557,2,10,3,7,11,0
345886,2,3,17,-14,17,0
217700,1,7,0,7,12,1
275526,4,26,36,-10,3,1
202234,1,3,0,3,5,0
286031,1,0,0,0,8,1
363459,4,28,42,-14,8,1
407745,3,10,0,10,11,0
169383,3,6,21,-15,8,1
43999,3,3,28,-25,3,1
344084,2,3,3,0,17,0
278727,1,0,0,0,5,0
3870,2,16,7,9,2,1
326918,1,2,0,2,9,0
179813,4,6,27,-21,12,0
66500,3,14,24,-10,14,0
334413,3,10,10,0,13,0
413268,3,17,0,17,14,1
216088,4,24,19,5,11,1
146237,3,3,16,-13,15,0
309704,2,10,6,4,1,1
246244,4,21,16,5,7,1
157552,2,2,0,2,2,0
302474,2,3,10,-7,15,1
10428,1,0,0,0,5,1
4877,1,14,0,14,3,1
58035,1,0,0,0,10,1
161297,3,20,6,14,4,1
229180,4,19,7,12,17,1
242858,1,7,3,4,6,0
138368,4,32,7,25,11,1
205864,4,20,0,20,7,0
9090,4,28,13,15,4,0
418643,4,21,31,-10,16,1
33498,2,14,0,14,16,0
295960,4,13,27,-14,12,0
240430,1,0,0,0,5,0
227092,1,0,0,0,16,1
42690,3,7,10,-3,3,0
79655,4,24,21,3,2,0
380879,1,0,0,0,16,0
405531,1,0,7,-7,10,0
261386,3,10,17,-7,14,0
130822,3,13,12,1,8,1
82401,4,13,10,3,3,1
9429,2,3,0,3,5,0
89124,4,23,6,17,6,1
364067,1,0,3,-3,9,1
321108,2,0,3,-3,6,0
153249,2,2,0,2,1,1
14785,3,38,3,35,7,0
59862,5,15,16,-1,11,0
39698,2,3,0,3,1,0
225801,3,10,14,-4,16,1
375603,2,7,14,-7,14,1
225955,3,27,7,20,16,0
172665,1,7,3,4,9,1
313931,4,28,29,-1,3,0
13394,1,0,7,-7,7,1
9027,2,7,7,0,4,1
395195,2,10,10,0,5,0
94646,2,17,19,-2,9,0
406775,1,0,10,-10,11,0
229781,4,20,17,3,17,1
371635,4,17,17,0,12,1
85048,3,31,16,15,4,0
362030,1,0,7,-7,8,1
37596,1,7,0,7,17,1
119224,1,0,3,-3,3,1
255531,3,30,7,23,12,1
14821,4,45,10,35,7,1
207587,2,21,9,12,7,0
107892,2,0,3,-3,15,1
343167,1,3,0,3,16,0
306340,3,24,10,14,17,1
94345,3,17,7,10,9,1
88580,1,3,7,-4,6,1
372186,3,9,13,-4,13,0
2498,1,3,0,3,2,0
399506,3,0,26,-26,7,1
153308,4,2,10,-8,1,1
102984,4,12,38,-26,13,1
117207,3,23,10,13,2,0
306481,3,10,17,-7,17,1
326409,4,20,17,3,9,1
268078,1,0,0,0,17,1
78703,2,13,0,13,2,0
125663,4,27,24,3,5,1
129315,1,0,0,0,7,0
31981,4,19,13,6,15,0
414944,1,0,7,-7,15,1
223811,2,6,0,6,15,1
27150,2,0,7,-7,13,0
215551,4,13,6,7,11,1
207115,1,0,0,0,7,1
153430,3,13,17,-4,1,1
232896,1,0,0,0,2,0
371798,4,24,14,10,12,0
50976,1,0,7,-7,6,1
15138,1,0,0,0,8,1
416649,3,31,7,24,15,0
281096,4,45,16,29,6,0
100403,4,9,20,-11,12,1
203934,2,3,7,-4,6,0
411446,2,7,17,-10,13,1
366206,1,0,0,0,10,1
253217,2,0,7,-7,11,1
304216,3,26,7,19,16,0
25789,1,0,0,0,12,1
265318,1,7,0,7,16,1
405000,4,9,20,-11,10,0
134452,2,3,20,-17,10,0
152135,4,20,13,7,17,0
11151,4,24,27,-3,5,1
150221,4,6,26,-20,16,1
263029,2,10,0,10,15,0
95409,2,28,7,21,10,0
258510,1,0,0,0,13,1
254499,4,29,13,16,11,1
183992,4,22,10,12,14,1
305140,3,21,10,11,16,0
104575,1,7,3,4,14,0
94387,4,17,21,-4,9,1
153810,1,0,0,0,1,1
384854,2,6,12,-6,1,1
204955,4,13,27,-14,6,0
195372,2,10,3,7,2,1
242339,3,20,13,7,6,1
86323,4,27,23,4,5,0
172925,4,41,24,17,9,0
14034,3,3,21,-18,7,0
230515,1,3,0,3,1,1
5077,2,13,0,13,3,1
46310,2,3,14,-11,4,0
134885,1,7,7,0,10,1
110297,2,0,17,-17,16,1
26881,2,10,6,4,13,0
411621,3,14,28,-14,13,1
121582,4,22,13,9,4,1
197228,1,0,0,0,3,1
43268,4,24,10,14,3,0
227802,4,6,27,-21,16,0
236924,2,26,0,26,3,0
34418,2,14,3,11,16,1
71666,4,3,34,-31,16,1
347242,1,0,0,0,1,1
66764,2,7,6,1,14,1
96466,3,10,17,-7,10,0
217646,4,26,16,10,12,0
312396,3,20,27,-7,3,0
250324,2,7,7,0,9,0
415193,4,17,24,-7,15,0
380533,3,7,17,-10,16,0
7079,2,14,14,0,4,0
109675,1,3,0,3,16,0
399150,1,0,3,-3,7,0
132876,3,6,14,-8,9,0
375970,3,20,12,8,14,1
272041,2,7,3,4,2,1
421454,1,0,0,0,17,1
132582,3,12,32,-20,9,0
140585,2,17,7,10,12,1
261720,3,14,7,7,14,0
216959,1,3,3,0,12,1
106323,3,7,19,-12,14,1
223632,1,6,3,3,15,1
116327,3,27,13,14,1,0
254156,3,3,12,-9,11,0
420651,3,21,16,5,17,0
235296,4,25,6,19,3,0
189273,1,3,0,3,16,0
307068,3,24,6,18,17,0
159951,4,45,17,28,3,1
287886,1,0,0,0,9,0
241601,4,6,27,-21,5,1
140787,4,22,24,-2,12,1
248050,4,31,13,18,8,1
164883,2,0,3,-3,6,1
255043,2,3,18,-15,12,0
43826,3,14,16,-2,3,1
16466,2,3,0,3,8,0
175648,1,3,0,3,11,0
110994,4,14,20,-6,16,0
387748,4,0,37,-37,2,1
90125,2,3,0,3,7,1
216042,2,10,12,-2,11,0
316117,3,24,16,8,4,0
226881,2,0,10,-10,16,1
24313,1,0,0,0,12,0
222320,2,7,3,4,14,1
321887,2,14,14,0,7,1
54905,1,0,0,0,8,0
182936,2,7,37,-30,14,1
343100,4,12,20,-8,16,1
45376,4,20,16,4,4,0
164498,3,17,0,17,5,0
54179,2,0,3,-3,8,0
149223,2,7,0,7,16,0
185453,4,17,13,4,15,1
128691,4,6,20,-14,7,1
398437,1,7,0,7,7,0
348055,2,0,10,-10,1,1
165593,4,10,35,-25,6,0
13064,4,14,7,7,6,0
190654,2,21,7,14,17,0
421103,2,20,3,17,17,0
132904,4,6,21,-15,9,1
396512,1,14,7,7,6,0
165600,1,0,0,0,6,1
351396,3,13,13,0,3,0
403452,2,17,9,8,9,1
394454,2,7,13,-6,5,0
362175,2,3,0,3,8,1
292318,3,12,10,2,11,0
130881,4,23,15,8,8,0
133294,2,7,0,7,9,1
184715,4,17,27,-10,15,1
52908,1,0,0,0,7,1
398290,1,3,0,3,7,1
116503,4,6,22,-16,1,1
99479,2,3,10,-7,11,1
49339,2,7,10,-3,6,1
106707,1,6,5,1,14,1
256245,2,6,7,-1,12,0
404324,2,7,6,1,10,0
45640,3,13,13,0,4,1
250047,3,17,13,4,9,1
351117,4,37,30,7,3,0
360542,1,0,7,-7,7,0
310829,4,27,13,14,2,0
299948,4,16,11,5,14,1
386320,1,7,3,4,2,1
24,1,0,0,0,1,0
63342,3,17,3,14,12,1
161031,4,23,7,16,4,1
262755,3,27,3,24,15,1
14724,2,14,0,14,7,1
210683,4,20,31,-11,9,0
263635,3,20,10,10,15,1
275631,3,24,3,21,3,0
177952,1,7,3,4,12,1
157293,4,16,3,13,2,0
85559,4,17,22,-5,5,1
344302,4,19,13,6,17,1
407705,2,3,0,3,11,0
71048,3,20,0,20,16,0
13884,2,14,0,14,7,1
194621,3,21,7,14,2,1
250808,3,3,9,-6,10,1
307138,1,0,3,-3,17,1
121919,1,0,7,-7,4,1
75099,2,7,6,1,17,0
145759,2,10,10,0,15,0
205068,4,19,20,-1,6,1
49051,3,10,13,-3,6,1
160444,2,6,7,-1,4,1
135026,1,14,0,14,10,0
238502,2,13,0,13,4,0
394483,3,7,18,-11,5,1
222907,2,13,3,10,14,0
409692,3,10,6,4,12,0
212832,4,24,24,0,10,0
112601,3,31,26,5,17,0
304401,4,31,21,10,16,1
246752,2,3,3,0,8,1
297309,1,0,0,0,13,0
67532,4,39,14,25,14,0
15228,3,13,7,6,8,1
167618,1,7,0,7,7,0
144717,2,3,0,3,14,1
167934,4,21,22,-1,7,0
348637,1,0,3,-3,2,1
18936,4,9,27,-18,9,1
128956,2,25,3,22,7,1
82423,1,0,7,-7,3,1
74066,2,9,0,9,17,0
1097,3,10,29,-19,1,1
78716,2,13,7,6,2,1
207501,4,28,14,14,7,0
190550,3,17,20,-3,17,1
49323,2,7,10,-3,6,1
94464,2,0,0,0,9,0
392948,2,6,3,3,4,1
358976,1,7,0,7,6,1
362641,2,0,7,-7,8,1
210780,4,24,10,14,9,0
276607,2,7,3,4,4,0
292828,4,29,24,5,11,0
131142,4,27,12,15,8,1
350423,1,0,3,-3,2,1
52165,1,0,0,0,7,0
323137,1,0,0,0,7,0
380737,1,0,0,0,16,0
326965,2,2,7,-5,9,1
229155,4,19,7,12,17,0
359614,3,24,0,24,6,0
128153,1,0,0,0,7,1
62108,2,7,7,0,12,1
146058,2,10,3,7,15,1
284976,4,16,20,-4,7,0
141949,2,10,7,3,13,1
241974,2,7,0,7,5,1
122537,1,7,0,7,4,1
205451,1,7,0,7,6,1
375585,1,7,7,0,14,0
378143,2,21,6,15,15,0
43255,4,24,10,14,3,1
101838,1,3,0,3,12,1
250959,2,3,6,-3,10,1
213915,1,10,0,10,10,0
172683,2,14,3,11,9,0
174701,3,9,7,2,10,0
347618,2,17,10,7,1,1
150684,1,0,3,-3,17,1
21276,2,3,13,-10,11,0
372933,3,22,7,15,13,1
50084,2,0,14,-14,6,1
215070,3,13,7,6,11,1
177409,2,17,10,7,11,0
165160,1,0,0,0,6,0
146083,3,19,10,9,15,0
235406,2,28,14,14,3,0
176759,1,0,0,0,11,1
24354,2,3,0,3,12,1
368454,4,30,21,9,11,0
284887,1,0,0,0,7,0
318313,3,9,19,-10,5,1
122650,1,0,0,0,4,1
421121,3,20,13,7,17,1
180569,1,0,0,0,13,1
39537,2,0,3,-3,1,0
124055,2,0,7,-7,5,0
306386,1,0,3,-3,17,0
255086,4,6,28,-22,12,0
49937,2,14,0,14,6,0
58704,2,7,10,-3,10,1
236646,2,10,0,10,3,0
66247,4,45,3,42,13,0
351701,4,14,17,-3,3,1
316035,4,0,31,-31,4,1
56513,1,10,0,10,9,1
69386,1,7,0,7,15,1
342199,1,0,0,0,16,0
25222,1,0,0,0,12,1
246707,4,45,10,35,8,0
69186,4,17,17,0,15,1
214187,4,19,9,10,11,0
298632,1,3,0,3,14,0
78401,2,14,0,14,2,0
291861,2,0,7,-7,11,1
114979,3,10,12,-2,1,1
332455,2,16,3,13,12,0
421531,3,10,3,7,17,1
273090,1,0,0,0,2,1
67062,3,10,9,1,14,1
15923,2,6,7,-1,8,0
47756,4,6,23,-17,5,1
267835,2,19,14,5,17,1
380637,2,7,7,0,16,1
65018,2,0,17,-17,13,0
247330,4,42,42,0,8,1
177110,3,24,13,11,11,0
359729,2,17,6,11,6,0
398637,3,0,0,0,7,0
132284,3,24,7,17,9,1
32470,1,7,3,4,15,1
287738,1,14,0,14,9,0
145954,3,7,21,-14,15,1
114791,2,7,17,-10,1,0
89098,3,13,6,7,6,1
195784,2,10,7,3,2,1
212756,2,10,21,-11,10,1
4800,3,27,0,27,3,0
266645,2,16,3,13,16,0
76087,4,13,23,-10,1,1
139953,2,10,3,7,12,1
213650,2,7,14,-7,10,1
69356,1,0,0,0,15,1
12805,2,3,3,0,6,0
126229,3,21,6,15,6,1
238210,3,3,16,-13,4,1
264421,3,3,28,-25,15,1
337511,3,7,12,-5,14,0
103803,2,6,0,6,13,1
79848,1,0,6,-6,2,1
127408,1,0,0,0,6,1
271715,2,13,10,3,2,1
245032,4,14,27,-13,7,1
180938,2,17,7,10,13,0
89528,2,0,10,-10,7,1
76553,4,7,41,-34,1,1
269969,3,16,13,3,1,0
25763,4,17,17,0,12,1
237714,4,20,17,3,4,0
322765,2,3,20,-17,7,1
254120,2,3,6,-3,11,0
99551,1,0,0,0,11,0
376282,4,17,14,3,14,0
18890,3,9,13,-4,9,0
302337,2,7,3,4,15,1
278723,1,0,0,0,5,0
163427,2,7,20,-13,5,1
315387,3,16,17,-1,4,0
356701,3,19,16,3,5,1
77135,4,17,17,0,1,0
103292,4,3,10,-7,13,0
209120,4,9,30,-21,8,1
311861,1,7,0,7,2,0
107248,4,14,31,-17,15,1
291414,2,7,10,-3,10,1
219873,4,51,0,51,13,0
355276,3,14,14,0,4,0
272470,4,31,24,7,2,1
42608,1,0,7,-7,3,1
198045,3,3,30,-27,3,0
195324,1,3,0,3,2,0
282856,4,9,20,-11,6,0
95348,4,17,24,-7,10,1
69120,2,14,7,7,15,0
61428,3,16,3,13,11,0
397384,1,0,3,-3,6,1
359964,4,33,30,3,6,1
408335,3,10,7,3,12,0
327326,4,16,27,-11,9,1
59010,2,0,10,-10,10,1
133280,1,0,0,0,9,1
320160,4,17,14,3,6,0
84344,4,21,30,-9,4,1
227642,4,35,0,35,16,0
197702,2,7,3,4,3,0
129988,1,0,10,-10,8,1
18361,4,25,20,5,9,1
244236,3,16,7,9,6,0
393896,4,20,20,0,5,1
366122,2,7,20,-13,10,0
183277,3,13,20,-7,14,1
319334,3,13,21,-8,6,1
403054,4,24,24,0,9,0
145611,2,21,0,21,14,1
405799,4,21,21,0,10,0
204651,4,17,48,-31,6,1
413021,4,19,18,1,14,0
339702,2,7,3,4,15,0
374359,1,0,0,0,14,1
391155,3,7,24,-17,4,1
324284,3,15,0,15,8,1
120012,4,23,38,-15,3,1
259790,4,20,13,7,14,0
242040,3,7,9,-2,5,1
74479,1,0,0,0,17,1
144162,4,23,13,10,14,1
402569,2,10,7,3,9,1
158114,4,25,9,16,3,0
209599,4,43,34,9,8,1
50057,1,0,0,0,6,0
220337,1,0,0,0,13,1
89821,2,6,3,3,7,0
58094,2,10,10,0,10,0
406539,3,14,29,-15,11,0
193756,4,10,27,-17,1,1
176388,4,19,28,-9,11,0
283241,2,10,0,10,7,0
59259,4,28,58,-30,10,0
92432,3,17,10,7,8,1
48955,4,28,20,8,5,0
174294,1,7,0,7,10,1
248903,2,14,0,14,9,1
241896,4,20,13,7,5,0
214489,4,7,20,-13,11,1
68875,4,6,20,-14,15,1
38433,4,31,16,15,1,1
285889,1,12,0,12,8,1
64576,2,10,7,3,13,0
215800,3,38,6,32,11,0
196144,3,31,24,7,2,1
139255,2,13,6,7,12,1
211856,3,22,10,12,9,0
318012,4,17,13,4,5,0
340322,2,16,7,9,15,1
93383,1,0,0,0,9,1
26673,1,0,0,0,13,0
329971,3,7,10,-3,11,0
349705,2,14,7,7,2,1
24456,4,16,7,9,12,0
241482,4,10,42,-32,5,1
101001,4,13,16,-3,12,1
326609,2,10,3,7,9,0
162830,3,3,3,0,5,0
226107,2,7,14,-7,16,0
308923,1,0,0,0,1,1
69963,2,21,0,21,15,1
135872,4,21,17,4,10,0
241649,1,0,0,0,5,1
178873,4,35,21,14,12,0
152285,4,28,0,28,17,1
4683,4,20,20,0,2,1
221954,4,22,19,3,14,1
188147,3,10,10,0,16,1
350863,2,0,7,-7,3,1
183571,3,20,17,3,14,0
91019,2,6,0,6,7,1
9031,2,14,7,7,4,0
13582,2,3,7,-4,7,0
406298,4,27,35,-8,11,1
121180,2,7,13,-6,3,1
256108,2,7,10,-3,12,0
28698,3,3,10,-7,14,0
133138,2,10,10,0,9,1
421662,2,10,7,3,17,1
354483,2,24,28,-4,4,1
48141,3,10,6,4,5,0
365463,3,10,19,-9,9,1
98843,1,7,0,7,11,0
97560,4,30,7,23,10,1
349988,1,3,7,-4,2,1
83529,2,0,13,-13,4,0
281216,4,24,16,8,6,1
395468,2,7,0,7,6,0
137821,1,0,6,-6,11,1
294621,1,0,0,0,12,0
323013,1,7,0,7,7,0
50766,4,21,21,0,6,0
33881,1,0,0,0,16,0
128272,4,20,7,13,7,0
54416,4,33,25,8,8,0
57697,4,24,24,0,10,1
294915,1,0,7,-7,12,0
394781,3,21,0,21,5,1
273577,1,3,3,0,2,0
76813,3,33,0,33,1,0
271719,2,13,10,3,2,1
32037,2,7,3,4,15,0
12746,4,59,0,59,6,0
140864,2,17,0,17,13,0
132209,1,0,0,0,9,1
240481,3,3,7,-4,5,1
201227,4,23,24,-1,5,1
76398,4,29,6,23,1,1
372489,4,23,14,9,13,1
341582,4,16,17,-1,16,1
250168,2,17,0,17,9,0
116191,4,14,19,-5,1,1
220918,1,0,0,0,14,0
272771,4,15,10,5,2,0
220509,2,0,14,-14,13,0
121719,3,21,21,0,4,1
308411,3,0,18,-18,1,1
392056,4,10,24,-14,4,1
411618,3,14,21,-7,13,0
114896,4,24,40,-16,1,1
293174,2,6,0,6,11,0
171479,2,14,10,4,9,1
271916,3,17,13,4,2,0
50840,2,7,14,-7,6,0
416864,1,0,0,0,15,1
245025,4,14,27,-13,7,0
211960,2,0,10,-10,9,0
157077,2,9,7,2,2,1
250144,2,10,0,10,9,1
180075,4,28,20,8,13,1
205393,4,27,0,27,6,0
297634,1,7,0,7,13,0
2496,1,3,0,3,2,1
361699,4,10,39,-29,7,1
403977,4,26,24,2,10,1
239447,3,9,17,-8,4,1
337977,4,23,0,23,14,0
161989,1,6,0,6,4,1
62368,1,0,0,0,12,0
40124,1,6,0,6,2,1
74308,4,10,30,-20,17,1
24526,2,7,7,0,12,1
184170,1,0,0,0,14,0
378237,1,0,0,0,15,1
232431,1,3,0,3,1,1
354696,4,17,17,0,4,1
176906,1,0,0,0,11,1
170213,1,0,0,0,8,0
418335,4,9,24,-15,16,1
151469,2,28,7,21,17,0
70066,4,31,17,14,15,0
187734,4,16,20,-4,16,1
241,3,12,17,-5,1,0
86400,2,20,7,13,5,0
409944,2,0,14,-14,12,1
36993,4,0,32,-32,17,0
201072,4,41,10,31,5,1
112329,4,45,17,28,17,1
223320,4,6,12,-6,15,1
21262,2,3,0,3,11,0
21986,2,7,3,4,11,0
296126,1,7,6,1,13,1
302060,2,13,24,-11,15,1
328876,1,3,0,3,10,1
101504,1,10,0,10,12,0
17579,4,13,17,-4,9,1
135820,3,7,14,-7,10,0
204823,1,0,0,0,6,1
91814,3,17,0,17,8,1
123566,4,19,17,2,4,1
94580,4,13,17,-4,9,1
64526,1,0,0,0,13,1
301575,1,7,0,7,15,0
31792,3,6,17,-11,15,0
415627,4,30,13,17,15,0
220314,4,26,9,17,13,1
252679,4,6,10,-4,10,1
73101,4,13,10,3,16,0
70273,2,7,7,0,15,0
55293,4,13,10,3,9,1
322755,2,3,14,-11,7,0
155066,2,6,26,-20,1,1
410594,3,17,7,10,13,0
130469,2,3,3,0,8,0
81379,2,7,7,0,3,1
225859,4,24,24,0,16,1
52999,4,27,24,3,7,1
202449,3,6,10,-4,5,0
267602,4,30,34,-4,17,0
154838,1,3,0,3,1,0
117905,1,0,0,0,2,0
313728,2,14,3,11,3,1
260450,1,7,0,7,14,0
183622,2,0,0,0,14,1
100385,4,9,20,-11,12,1
278610,2,13,0,13,4,1
201404,1,6,0,6,5,0
27041,3,10,3,7,13,1
122533,1,7,0,7,4,1
143266,4,17,16,1,13,0
182944,3,10,37,-27,14,0
169871,4,27,17,10,8,0
67164,2,0,0,0,14,0
210064,4,17,17,0,8,0
191179,1,0,3,-3,17,0
230742,3,9,27,-18,1,1
283713,2,0,0,0,7,0
94346,3,17,7,10,9,0
14913,3,14,16,-2,7,0
249854,2,6,17,-11,9,0
52573,4,19,10,9,7,1
112892,3,13,6,7,17,0
69885,3,24,16,8,15,0
121627,1,0,7,-7,4,1
391275,2,14,0,14,4,0
175731,3,37,13,24,11,1
243032,1,0,0,0,6,0
383006,4,10,24,-14,17,1
70370,4,18,33,-15,15,0
19114,1,7,3,4,10,0
255029,2,3,9,-6,12,0
140528,4,21,29,-8,12,0
20420,4,10,16,-6,10,1
13430,2,3,14,-11,7,0
295978,1,0,0,0,13,0
415854,2,7,20,-13,15,0
274340,1,3,7,-4,3,1
353033,4,26,10,16,3,0
263503,3,20,23,-3,15,0
187971,3,6,14,-8,16,0
272840,2,20,0,20,2,0
15707,1,0,0,0,8,1
394555,1,0,0,0,5,0
116629,4,16,3,13,2,1
72316,2,0,7,-7,16,0
359397,4,13,23,-10,6,1
368323,4,12,19,-7,11,0
349117,2,7,0,7,2,0
9718,1,0,7,-7,5,0
297984,3,30,7,23,13,0
76206,3,12,20,-8,1,0
199428,4,16,10,6,4,1
97387,3,9,16,-7,10,0
124834,2,0,6,-6,5,1
41668,3,24,7,17,2,1
55823,2,0,7,-7,9,1
369880,3,7,9,-2,12,0
284809,3,26,20,6,7,1
407962,4,17,24,-7,11,1
319491,3,3,10,-7,6,0
151433,1,14,0,14,17,1
239930,4,13,9,4,4,1
156966,3,7,10,-3,2,0
243187,5,23,22,1,6,0
277280,4,0,16,-16,4,1
277754,4,14,6,8,4,1
386044,2,13,0,13,1,1
12311,4,6,9,-3,6,0
322947,3,13,0,13,7,1
900,1,0,0,0,1,1
143870,1,0,0,0,14,0
145092,1,0,0,0,14,0
204421,2,7,10,-3,6,1
2643,1,3,0,3,2,0
132066,1,0,0,0,9,1
148447,2,7,3,4,16,0
310442,2,14,3,11,2,1
103880,4,26,0,26,13,1
263682,4,27,13,14,15,1
207681,1,0,0,0,7,0
10719,1,0,0,0,5,0
120326,4,24,13,11,3,0
231041,3,24,0,24,1,0
101487,1,7,0,7,12,0
45093,1,0,0,0,4,1
363358,2,0,10,-10,8,1
287848,4,28,20,8,9,1
342032,4,20,3,17,16,1
270288,4,10,27,-17,1,0
26488,4,30,22,8,13,1
157449,3,16,17,-1,2,0
325934,3,13,7,6,9,0
252446,2,0,5,-5,10,0
382530,2,0,10,-10,17,1
318414,2,21,7,14,5,0
89223,2,6,0,6,7,0
287340,2,13,3,10,8,0
387007,4,14,28,-14,2,1
18080,1,0,14,-14,9,1
100657,3,14,14,0,12,0
387582,3,6,3,3,2,1
42840,4,6,37,-31,3,0
105414,3,23,17,6,14,0
403514,4,24,19,5,9,1
196732,3,54,0,54,3,0
140759,3,15,21,-6,12,1
58110,2,10,10,0,10,0
31907,2,6,10,-4,15,1
303849,1,0,0,0,16,1
343787,2,7,3,4,17,1
296535,4,26,3,23,13,1
39295,3,10,27,-17,1,1
62429,3,0,13,-13,12,1
61663,2,7,3,4,12,1
325984,4,22,7,15,9,1
132918,4,6,21,-15,9,1
180772,3,7,13,-6,13,1
172044,2,7,0,7,9,0
373728,4,13,21,-8,13,0
102511,4,31,3,28,13,0
411979,4,20,17,3,13,0
400385,3,24,10,14,8,0
139132,3,12,6,6,12,0
182390,4,24,20,4,14,0
256754,3,3,6,-3,12,0
114955,2,7,3,4,1,0
327187,4,28,17,11,9,1
59972,3,3,24,-21,11,1
155251,3,28,14,14,1,1
2012,4,13,12,1,1,0
130122,1,0,3,-3,8,0
164919,3,0,6,-6,6,1
205645,2,7,9,-2,7,1
195595,4,24,7,17,2,0
194086,1,0,0,0,1,1
401891,4,17,28,-11,9,0
119663,4,17,12,5,3,0
8866,1,13,0,13,4,1
344665,2,3,13,-10,17,1
331906,3,0,16,-16,12,1
204732,2,14,14,0,6,1
271338,4,16,24,-8,1,0
266936,2,13,7,6,17,1
331710,2,3,13,-10,12,1
374061,4,24,10,14,13,1
412717,4,40,13,27,14,0
317317,2,0,0,0,5,0
303592,2,21,13,8,16,0
190577,4,20,20,0,17,0
156525,4,7,6,1,2,0
95231,2,3,7,-4,10,1
375056,4,28,27,1,14,0
285561,2,7,10,-3,8,0
162036,2,14,13,1,4,1
404723,1,0,3,-3,10,1
348123,4,17,19,-2,1,0
63724,2,7,9,-2,12,0
182097,1,0,0,0,13,1
51165,2,17,3,14,7,1
337907,2,10,0,10,14,1
286477,4,20,13,7,8,1
347130,2,13,10,3,1,1
149481,1,0,0,0,16,1
41772,2,7,13,-6,2,0
364613,4,21,37,-16,9,1
339178,4,23,13,10,15,1
207238,1,0,0,0,7,0
271649,4,23,37,-14,2,1
338601,4,39,38,1,14,0
265098,3,13,10,3,16,0
380349,2,7,7,0,16,1
274579,3,24,23,1,3,0
180190,3,16,7,9,13,0
353239,2,14,17,-3,4,0
308425,3,7,18,-11,1,0
93490,4,3,31,-28,9,1
302847,4,12,23,-11,15,0
251940,1,0,6,-6,10,0
378543,2,7,6,1,15,1
207366,4,13,21,-8,7,0
210310,3,9,10,-1,9,1
224812,4,11,10,1,15,0
136327,4,18,7,11,11,0
135760,1,0,6,-6,10,0
142158,3,2,7,-5,13,0
100714,4,21,24,-3,12,1
20108,1,3,0,3,10,0
376316,1,0,0,0,14,1
145475,3,16,17,-1,14,0
98376,1,0,7,-7,11,1
100826,3,9,19,-10,12,1
11787,1,14,0,14,6,0
155076,3,6,32,-26,1,0
52360,2,3,17,-14,7,1
130583,1,6,0,6,8,1
389196,2,21,7,14,3,1
271796,4,30,20,10,2,1
351775,2,10,14,-4,3,0
11653,2,14,0,14,6,1
152415,4,35,3,32,17,1
169781,2,0,14,-14,8,1
264253,2,10,17,-7,15,1
323078,3,20,14,6,7,1
90721,2,14,0,14,7,0
196277,3,21,10,11,2,1
160208,3,30,7,23,3,0
24429,4,16,7,9,12,0
321839,1,7,7,0,7,0
186503,4,17,20,-3,15,1
361889,1,0,0,0,7,0
204681,1,7,0,7,6,0
152382,3,21,3,18,17,1
280987,2,7,10,-3,6,1
122911,4,34,6,28,4,1
29230,1,7,0,7,14,1
151826,4,28,16,12,17,1
72110,4,10,17,-7,16,1
119283,3,14,10,4,3,1
22933,4,3,26,-23,11,1
352069,2,3,7,-4,3,0
402588,3,10,10,0,9,0
333587,4,24,23,1,12,1
15503,3,16,6,10,8,0
416760,2,7,7,0,15,0
90615,3,17,26,-9,7,0
253114,3,21,7,14,11,0
176035,3,24,0,24,11,0
122925,4,37,6,31,4,0
311112,4,13,9,4,2,0
412919,2,6,3,3,14,1
229380,2,3,0,3,17,1
15294,1,0,0,0,8,0
249582,4,21,13,8,9,0
171073,4,17,37,-20,8,0
390588,4,17,27,-10,3,1
136212,5,13,13,0,10,0
85401,4,31,10,21,5,0
158074,3,22,9,13,3,1
236137,2,0,10,-10,3,1
178132,1,0,7,-7,12,1
354159,1,0,0,0,4,1
191709,3,10,17,-7,17,1
286600,3,17,38,-21,8,1
302690,4,20,20,0,15,1
81133,3,13,14,-1,3,1
134656,4,34,24,10,10,0
301136,1,7,3,4,15,1
43710,4,14,17,-3,3,1
62785,4,17,0,17,12,1
105079,3,26,14,12,14,1
273711,4,31,20,11,2,0
81301,4,10,14,-4,3,0
36776,2,7,7,0,17,0
131709,3,17,22,-5,8,1
273029,3,6,3,3,2,1
173641,3,10,20,-10,10,1
319973,3,30,10,20,6,1
114746,1,0,0,0,1,0
225916,2,20,0,20,16,0
186951,3,7,9,-2,15,0
190833,3,16,3,13,17,0
257004,1,0,7,-7,12,1
260576,4,30,8,22,14,0
274950,4,17,19,-2,3,1
121841,3,0,10,-10,4,1
150024,3,21,6,15,16,0
176847,3,17,10,7,11,0
239788,4,20,20,0,4,1
251323,1,7,7,0,10,1
193313,4,10,26,-16,1,0
366719,3,24,10,14,10,1
222803,3,10,10,0,14,0
324926,4,23,23,0,8,0
81070,1,0,7,-7,3,1
224575,1,6,7,-1,15,0
155772,4,30,30,0,2,0
17287,4,21,41,-20,9,1
132765,4,20,24,-4,9,0
250080,4,17,13,4,9,0
44492,4,27,20,7,3,0
358178,4,20,9,11,6,0
63494,4,31,13,18,12,0
142535,4,30,16,14,13,0
403781,3,15,16,-1,9,1
33782,2,0,10,-10,16,0
13502,4,6,27,-21,7,0
99273,1,7,0,7,11,1
353632,1,3,0,3,4,0
189041,3,14,10,4,16,0
187534,2,6,13,-7,16,0
25792,1,0,0,0,12,1
366684,2,17,10,7,10,0
309072,1,3,0,3,1,0
68896,4,12,20,-8,15,1
35387,4,30,23,7,16,0
298604,4,13,10,3,14,0
259003,3,3,16,-13,13,0
355360,1,3,0,3,4,0
112353,1,3,0,3,17,1
202239,1,3,0,3,5,1
339220,1,0,0,0,15,1
88896,1,16,0,16,6,0
278551,4,43,13,30,4,0
250728,1,3,0,3,10,0
116203,4,22,19,3,1,1
188978,1,0,0,0,16,1
120567,2,0,6,-6,3,0
215901,2,3,7,-4,11,0
61498,1,0,7,-7,11,1
226666,1,7,0,7,16,0
212611,2,7,17,-10,10,1
98891,3,7,10,-3,11,1
117131,1,6,0,6,2,0
388441,2,0,13,-13,2,1
119944,2,6,14,-8,3,0
145047,3,13,6,7,14,1
276070,3,20,3,17,3,1
92438,3,20,10,10,8,0
286729,3,20,7,13,8,0
27114,1,0,0,0,13,0
143009,1,0,0,0,13,0
86773,4,30,21,9,5,1
328450,2,3,0,3,10,0
291182,4,24,23,1,10,0
400368,2,17,10,7,8,1
232770,2,7,0,7,2,0
170244,2,0,6,-6,8,0
351401,3,13,13,0,3,1
360836,4,31,37,-6,7,0
33658,2,14,0,14,16,1
159606,4,20,12,8,3,1
196439,4,20,21,-1,2,1
295804,5,27,27,0,12,1
38828,3,3,10,-7,1,1
168023,3,3,17,-14,7,0
40952,4,16,20,-4,2,1
415021,3,10,27,-17,15,1
284915,2,7,14,-7,7,0
12854,3,13,3,10,6,0
215833,4,51,13,38,11,0
393658,1,0,0,0,5,0
271074,4,35,34,1,1,0
82671,4,12,13,-1,3,1
173914,2,13,16,-3,10,1
217643,4,25,16,9,12,1
376605,4,15,6,9,14,1
139664,1,0,0,0,12,1
61539,2,21,7,14,11,0
369550,2,14,0,14,11,0
368878,3,31,3,28,11,0
318989,2,0,13,-13,5,1
320551,2,21,0,21,6,1
88223,4,23,17,6,6,1
399538,4,0,33,-33,7,1
54609,1,7,6,1,8,1
196152,4,31,24,7,2,0
122722,3,7,17,-10,4,0
306981,1,7,0,7,17,0
316707,1,0,0,0,4,1
78756,3,13,20,-7,2,0
66236,4,38,3,35,13,0
219612,2,3,0,3,13,1
388981,4,24,27,-3,3,0
17763,1,0,0,0,9,0
382660,2,0,0,0,17,1
306463,3,3,17,-14,17,1
116424,2,3,10,-7,1,1
190283,4,7,14,-7,17,0
368673,2,7,10,-3,11,0
409542,3,27,3,24,12,1
369883,3,7,9,-2,12,1
595,1,0,0,0,1,1
63446,2,14,13,1,12,0
211465,2,13,7,6,9,0
380977,4,9,14,-5,16,1
194962,4,14,22,-8,2,1
17492,1,10,0,10,9,1
413825,2,14,0,14,14,0
34858,2,17,7,10,16,0
330598,4,24,7,17,11,0
20329,2,10,13,-3,10,0
408387,4,19,14,5,12,1
417673,3,27,6,21,16,1
13510,4,6,34,-28,7,1
379710,2,3,0,3,16,1
271048,4,21,28,-7,1,1
97885,4,21,27,-6,11,0
223748,4,40,13,27,15,0
336257,2,10,0,10,13,1
129029,1,0,0,0,7,0
409251,3,13,12,1,12,0
97084,3,31,6,25,10,0
261759,4,21,7,14,14,0
367878,4,20,20,0,10,0
317685,4,16,9,7,5,1
79542,1,0,0,0,2,1
285934,3,23,7,16,8,1
346634,2,13,3,10,1,1
318562,2,10,0,10,5,0
240938,3,14,9,5,5,0
97228,3,12,6,6,10,1
136208,4,13,10,3,10,0
138992,3,14,9,5,12,0
227686,1,0,0,0,16,1
214111,2,3,3,0,11,0
20879,4,28,16,12,10,0
275498,3,20,24,-4,3,1
360331,3,0,20,-20,7,1
231105,1,0,0,0,1,1
197919,4,11,7,4,3,1
229926,4,29,20,9,17,0
47131,1,3,0,3,5,0
177755,4,13,17,-4,12,0
254189,4,3,18,-15,11,1
33810,2,0,24,-24,16,1
387946,1,3,0,3,2,0
154754,3,10,10,0,1,0
25678,2,7,7,0,12,0
169358,2,6,14,-8,8,1
298272,3,20,13,7,14,0
298420,3,7,21,-14,14,0
60311,1,3,0,3,11,0
140439,2,7,7,0,12,1
343828,3,21,3,18,17,1
23591,1,7,0,7,12,1
37871,1,0,0,0,1,0
330503,2,7,7,0,11,1
352768,1,7,0,7,3,0
318778,4,17,26,-9,5,1
320537,1,14,0,14,6,0
292594,2,6,16,-10,11,1
414353,1,7,3,4,14,1
401162,4,44,13,31,8,0
220349,1,3,0,3,13,1
284477,3,14,15,-1,7,1
279666,2,14,0,14,5,1
208492,3,37,7,30,8,1
88524,4,19,14,5,6,1
218826,1,0,3,-3,13,0
268651,4,17,20,-3,17,1
117517,3,17,17,0,2,0
24772,1,0,0,0,12,0
414794,1,0,0,0,15,0
319347,3,13,21,-8,6,1
352880,4,14,13,1,3,0
208173,3,0,3,-3,8,0
149285,3,13,20,-7,16,0
275630,3,24,3,21,3,0
74245,3,3,10,-7,17,0
379478,3,23,0,23,16,0
65756,3,14,16,-2,13,0
81090,2,3,14,-11,3,0
131235,2,14,17,-3,8,1
411326,3,10,10,0,13,1
240966,3,21,9,12,5,0
174182,2,3,13,-10,10,1
265735,2,3,0,3,16,1
174345,2,17,0,17,10,0
8034,2,10,7,3,4,1
263114,1,0,7,-7,15,0
8749,2,0,0,0,4,0
82441,1,0,7,-7,3,0
285399,2,17,0,17,8,0
109066,1,0,0,0,15,0
231061,4,24,8,16,1,1
131286,4,21,17,4,8,0
311335,2,14,7,7,2,0
6420,3,9,20,-11,3,1
254693,1,0,0,0,11,1
361328,2,0,0,0,7,1
391838,2,10,3,7,4,0
368861,3,24,3,21,11,1
407873,2,6,10,-4,11,0
19289,2,14,14,0,10,0
67576,2,0,7,-7,14,0
72464,2,7,10,-3,16,1
377016,4,15,19,-4,15,1
155872,3,7,13,-6,2,0
71112,1,6,0,6,16,0
372183,3,9,13,-4,13,0
234896,1,0,0,0,2,1
40340,3,6,7,-1,2,1
406759,1,0,3,-3,11,0
24179,1,0,0,0,12,1
304082,3,6,20,-14,16,0
190792,2,13,3,10,17,1
226673,1,7,3,4,16,0
372500,4,23,17,6,13,0
108704,3,34,13,21,15,0
337208,3,16,13,3,14,0
72359,3,7,20,-13,16,1
134492,3,3,30,-27,10,1
252642,2,6,3,3,10,0
213350,2,10,6,4,10,0
85422,1,0,0,0,5,1
67761,3,21,0,21,14,0
61758,4,24,45,-21,12,1
277005,4,31,20,11,4,0
393417,3,28,24,4,5,1
299468,4,10,20,-10,14,0
174552,3,10,14,-4,10,0
366835,2,0,3,-3,10,1
50266,2,10,14,-4,6,1
13396,1,0,7,-7,7,1
66626,3,0,17,-17,14,0
63302,2,3,0,3,12,0
387292,3,6,10,-4,2,1
191262,3,7,17,-10,17,0
408770,2,10,13,-3,12,0
193358,1,7,10,-3,1,1
415248,1,0,0,0,15,0
280778,4,14,14,0,5,0
19143,2,14,3,11,10,0
83776,1,0,0,0,4,1
38943,2,17,0,17,1,0
414267,3,21,21,0,14,0
96461,2,10,17,-7,10,1
151448,2,21,7,14,17,1
318708,2,10,20,-10,5,0
129334,1,7,7,0,7,1
243398,2,3,10,-7,6,1
371587,2,10,3,7,12,0
120071,1,3,0,3,3,1
211219,3,14,17,-3,9,0
181581,3,13,3,10,13,0
334793,1,0,0,0,13,1
112661,1,0,0,0,17,0
390262,3,10,6,4,3,1
180532,4,21,20,1,13,0
97625,1,3,0,3,11,1
351850,3,27,14,13,3,0
252183,3,20,17,3,10,1
134933,3,7,16,-9,10,1
354191,2,6,7,-1,4,0
381109,3,24,28,-4,16,1
326433,1,0,3,-3,9,1
330370,2,7,13,-6,11,0
50032,4,28,17,11,6,1
146507,2,7,7,0,15,0
163410,2,0,13,-13,5,1
275746,2,16,0,16,3,0
346320,1,0,3,-3,1,1
144958,1,0,0,0,14,1
386393,3,17,9,8,2,1
333238,3,6,14,-8,12,1
264118,3,13,27,-14,15,1
172772,4,21,18,3,9,0
411427,2,7,14,-7,13,1
278300,2,14,0,14,4,0
10813,3,21,0,21,5,0
357250,2,3,9,-6,5,1
15017,2,0,13,-13,7,0
216896,4,13,17,-4,12,0
81390,2,7,7,0,3,0
134349,3,16,21,-5,10,0
200736,2,17,0,17,4,1
41200,3,0,13,-13,2,1
355021,4,10,19,-9,4,0
227972,4,36,27,9,16,0
267728,4,16,34,-18,17,1
82290,2,3,3,0,3,0
215045,3,13,7,6,11,0
2913,1,0,0,0,2,0
389571,1,0,0,0,3,1
33710,4,35,0,35,16,0
183921,2,7,3,4,14,1
24556,3,10,13,-3,12,1
262847,2,7,20,-13,15,1
20102,1,0,0,0,10,1
48258,2,3,10,-7,5,1
419288,2,0,10,-10,16,1
130468,2,3,3,0,8,0
305094,2,21,10,11,16,1
393559,2,7,9,-2,5,0
161203,1,0,3,-3,4,1
32160,1,7,0,7,15,0
186033,3,23,34,-11,15,1
408238,4,20,3,17,12,1
112558,2,24,19,5,17,0
417949,2,13,14,-1,16,1
153371,1,0,7,-7,1,0
407826,1,3,0,3,11,1
103470,1,6,0,6,13,1
191232,2,7,17,-10,17,0
57036,2,7,17,-10,9,0
80525,3,5,10,-5,3,0
327348,1,0,0,0,9,1
74759,1,0,0,0,17,1
416908,2,3,7,-4,15,0
192535,4,17,17,0,1,0
233580,2,14,27,-13,2,1
252502,3,10,25,-15,10,1
279732,3,23,6,17,5,1
1988,3,10,12,-2,1,0
416659,4,34,7,27,15,0
322630,3,3,6,-3,7,1
27915,2,0,9,-9,13,0
360815,4,24,37,-13,7,1
239842,2,7,0,7,4,0
358487,4,41,27,14,6,0
63135,2,7,10,-3,12,1
71153,2,19,3,16,16,0
126942,1,3,7,-4,6,1
315604,1,0,0,0,4,0
417308,1,7,3,4,16,0
311346,2,14,10,4,2,1
314318,2,7,14,-7,3,0
393973,1,3,7,-4,5,0
303799,4,20,17,3,16,1
91142,2,3,7,-4,8,0
329647,2,13,7,6,11,1
328599,2,10,14,-4,10,1
222885,1,0,0,0,14,0
352832,3,14,3,11,3,0
225354,3,10,21,-11,15,0
404133,1,6,0,6,10,0
374544,2,17,12,5,14,0
77922,1,3,0,3,1,0
197006,3,20,17,3,3,0
339770,4,24,6,18,15,0
98757,3,34,6,28,11,0
264371,1,0,7,-7,15,1
20040,3,19,9,10,10,1
21274,2,3,7,-4,11,0
147609,4,15,0,15,15,1
198752,2,3,3,0,3,1
267411,3,10,10,0,17,0
154784,3,13,22,-9,1,0
180234,4,22,14,8,13,0
48006,3,9,24,-15,5,1
260134,4,6,35,-29,14,1
83703,3,22,20,2,4,0
415786,4,24,24,0,15,1
271996,1,0,0,0,2,1
96222,4,3,22,-19,10,1
24363,2,3,0,3,12,1
415128,2,0,21,-21,15,1
130329,2,7,0,7,8,0
51326,3,16,17,-1,7,0
52247,3,10,16,-6,7,0
175711,3,23,6,17,11,1
405832,5,24,24,0,10,0
285306,3,21,9,12,7,0
78163,3,20,3,17,2,0
125630,3,14,24,-10,5,0
140380,4,17,29,-12,12,1
326381,4,20,10,10,9,1
151216,3,17,20,-3,17,0
369485,4,48,7,41,11,0
74912,1,7,0,7,17,0
93170,2,0,3,-3,9,1
87384,2,7,7,0,6,1
72694,4,20,13,7,16,0
244722,4,24,26,-2,7,0
12369,2,7,3,4,6,1
81881,3,0,27,-27,3,0
24644,1,14,0,14,12,0
269888,1,0,0,0,1,1
267606,4,30,34,-4,17,1
247717,2,7,6,1,8,1
158295,1,6,7,-1,3,1
31443,2,3,7,-4,15,1
320149,3,17,14,3,6,1
296995,4,32,14,18,13,0
244479,1,0,3,-3,7,1
377598,4,20,12,8,15,0
324341,4,31,10,21,8,1
89011,1,0,0,0,6,1
395743,1,0,0,0,6,1
191201,1,0,17,-17,17,1
251998,2,14,20,-6,10,1
40244,1,0,0,0,2,0
303143,3,14,21,-7,16,0
400139,4,27,23,4,8,0
233667,1,6,0,6,2,1
131756,4,24,28,-4,8,1
4485,2,14,12,2,2,1
231472,3,10,12,-2,1,1
21405,2,6,7,-1,11,0
112534,2,10,9,1,17,0
102417,1,3,0,3,13,0
349283,2,13,21,-8,2,0
34835,1,7,0,7,16,1
80005,2,7,0,7,2,1
305713,3,9,7,2,17,0
165104,4,10,24,-14,6,1
392858,4,17,20,-3,4,0
342980,1,0,0,0,16,0
228187,2,7,27,-20,17,1
316210,1,0,6,-6,4,0
177907,4,21,23,-2,12,0
328899,2,6,0,6,10,0
152831,4,21,18,3,17,1
380171,2,7,3,4,16,1
35276,1,3,0,3,16,0
87054,4,14,25,-11,5,0
1283,4,17,16,1,1,1
198812,3,3,16,-13,3,1
24268,4,13,17,-4,12,1
130557,4,13,13,0,8,1
105524,2,26,14,12,14,1
230829,1,0,0,0,1,0
313920,4,28,26,2,3,0
82296,2,3,10,-7,3,1
346825,2,10,3,7,1,1
11238,3,17,14,3,6,0
105795,1,3,3,0,14,0
230914,4,24,10,14,1,0
95443,3,31,7,24,10,0
118745,4,27,12,15,2,0
342435,3,10,3,7,16,0
138075,4,42,24,18,11,1
421162,4,44,16,28,17,1
197703,2,7,3,4,3,0
329917,2,7,10,-3,11,0
79815,4,35,21,14,2,0
276019,2,3,0,3,3,1
69307,3,16,3,13,15,1
161506,4,17,6,11,4,0
27700,4,23,30,-7,13,1
49788,2,7,7,0,6,1
79179,3,17,10,7,2,0
219435,1,0,0,0,13,0
145569,1,14,0,14,14,0
238142,1,0,3,-3,4,1
27306,2,14,3,11,13,0
250935,2,3,6,-3,10,0
209717,3,9,6,3,8,1
41617,2,14,0,14,2,0
338982,3,13,3,10,15,1
107517,4,3,23,-20,15,1
15156,1,0,0,0,8,1
62203,4,13,17,-4,12,0
94735,4,38,43,-5,9,0
343290,1,0,3,-3,16,0
22572,2,6,3,3,11,0
8600,2,0,10,-10,4,0
54841,4,16,0,16,8,0
199903,4,17,24,-7,4,0
383364,2,0,6,-6,17,0
144451,4,10,26,-16,14,0
421574,4,16,6,10,17,1
399663,3,16,9,7,8,1
44674,1,0,0,0,3,1
15944,3,9,14,-5,8,1
163602,3,7,19,-12,5,1
181614,4,23,6,17,13,1
309651,1,0,3,-3,1,1
210503,4,9,20,-11,9,0
272523,2,7,3,4,2,1
342756,3,7,13,-6,16,0
8116,4,27,20,7,4,0
302947,2,20,6,14,16,0
162632,2,3,10,-7,5,1
5295,1,0,0,0,3,0
364222,2,0,7,-7,9,1
164172,2,17,13,4,5,0
407609,3,10,17,-7,11,0
166825,1,0,0,0,6,0
79965,4,13,23,-10,2,0
181507,1,0,0,0,13,1
322031,2,6,0,6,7,0
303471,3,22,10,12,16,1
220664,2,10,0,10,13,0
237882,4,7,27,-20,4,0
129667,1,0,3,-3,7,1
367305,3,3,17,-14,10,1
79830,1,0,0,0,2,0
316418,2,13,10,3,4,1
243679,1,7,0,7,6,0
162251,4,23,20,3,4,0
163885,2,16,10,6,5,0
18840,2,3,6,-3,9,1
330478,1,0,7,-7,11,1
135265,4,24,10,14,10,0
248159,2,3,10,-7,8,1
333460,1,3,0,3,12,0
406671,3,14,0,14,11,1
315217,3,17,10,7,4,1
287080,4,26,30,-4,8,0
337560,4,7,33,-26,14,1
26310,3,19,21,-2,13,0
353769,5,20,23,-3,4,0
329479,2,10,0,10,10,0
31676,4,24,16,8,15,0
77218,2,9,0,9,1,0
223563,4,17,13,4,15,1
192267,2,10,3,7,1,1
349939,4,10,12,-2,2,1
125734,2,7,7,0,5,1
126433,4,33,24,9,6,0
277444,4,34,17,17,4,0
140371,4,17,29,-12,12,1
38290,4,13,14,-1,1,1
290690,3,41,22,19,10,0
167509,2,0,3,-3,7,0
131343,1,7,3,4,8,0
302445,1,3,3,0,15,0
200717,2,7,0,7,4,0
310267,2,10,0,10,2,0
47142,2,3,0,3,5,1
361443,1,0,0,0,7,0
148073,4,14,10,4,15,0
242589,2,3,0,3,6,1
117128,1,6,0,6,2,0
153934,4,7,12,-5,1,0
75474,4,31,7,24,17,0
179470,4,21,20,1,12,0
25850,2,24,10,14,12,0
89997,3,5,14,-9,7,0
407275,3,10,16,-6,11,1
334967,2,3,7,-4,13,0
74391,2,7,10,-3,17,0
83971,2,14,0,14,4,0
55764,1,0,0,0,9,0
223927,4,30,6,24,15,0
194385,1,0,0,0,2,1
380276,4,29,16,13,16,0
22430,2,17,24,-7,11,1
335493,4,13,12,1,13,0
267940,1,0,0,0,17,0
56172,4,27,21,6,9,1
254376,1,0,0,0,11,0
218759,3,0,13,-13,13,0
176630,2,7,12,-5,11,0
381931,1,0,13,-13,17,0
201127,1,6,13,-7,5,0
4067,2,13,21,-8,2,1
329855,4,24,26,-2,11,1
86590,3,30,3,27,5,1
61609,4,35,14,21,11,0
351654,2,7,7,0,3,0
173802,3,17,3,14,10,1
243748,3,17,10,7,6,0
313955,4,28,32,-4,3,1
169736,1,0,0,0,8,0
16,1,0,0,0,1,0
153349,1,0,0,0,1,1
270242,2,3,21,-18,1,0
337500,3,7,12,-5,14,0
153463,4,20,17,3,1,1
178693,4,3,20,-17,12,1
157869,2,6,12,-6,3,1
202255,2,3,0,3,5,0
135817,2,7,14,-7,10,0
184296,4,34,14,20,14,1
22520,4,31,37,-6,11,0
262129,2,21,3,18,15,1
421332,1,0,3,-3,17,1
108339,1,0,7,-7,15,0
83916,4,23,24,-1,4,1
111746,1,0,0,0,17,0
175053,1,0,0,0,10,1
214069,1,0,0,0,11,1
262278,2,3,9,-6,15,1
227646,4,35,0,35,16,1
226092,2,7,14,-7,16,0
164245,4,41,38,3,5,0
184156,4,16,17,-1,14,1
73425,4,30,3,27,17,1
211156,2,0,10,-10,9,0
112070,1,7,0,7,17,0
292136,2,21,0,21,11,0
278815,3,7,21,-14,5,1
241533,2,3,3,0,5,0
296379,4,13,28,-15,13,0
147390,2,7,7,0,15,1
84170,3,10,7,3,4,1
353350,1,0,0,0,4,1
32793,1,0,0,0,15,1
179752,3,6,10,-4,12,0
373173,2,0,3,-3,13,1
82418,1,0,7,-7,3,1
327726,3,6,13,-7,10,0
332392,1,0,0,0,12,0
217691,1,7,0,7,12,1
196531,2,10,6,4,2,0
234110,1,0,0,0,2,0
280716,3,0,6,-6,5,1
420555,4,10,42,-32,17,1
309543,2,6,0,6,1,0
400698,3,16,7,9,8,0
254898,2,17,7,10,12,1
337979,4,23,0,23,14,0
5139,4,19,7,12,3,0
387557,3,6,3,3,2,1
200552,1,14,7,7,4,0
53080,2,19,7,12,7,0
149989,2,14,3,11,16,1
95699,3,10,9,1,10,1
222753,1,3,7,-4,14,1
234629,2,17,17,0,2,1
413772,4,24,16,8,14,1
355966,1,0,7,-7,5,1
7194,1,0,0,0,4,0
182171,3,26,7,19,13,0
208047,3,21,10,11,8,1
17745,4,24,13,11,9,0
304753,1,0,0,0,16,1
122928,4,37,6,31,4,0
137328,1,0,0,0,11,1
128498,2,21,21,0,7,0
78983,2,0,7,-7,2,1
172821,1,7,0,7,9,0
390168,4,20,38,-18,3,0
261512,2,9,0,9,14,0
9844,1,0,0,0,5,0
148197,3,13,21,-8,16,1
199961,2,10,10,0,4,1
239142,3,13,13,0,4,1
185585,3,10,20,-10,15,0
248854,1,0,0,0,9,1
307782,2,17,7,10,1,0
102779,2,10,3,7,13,0
121606,4,22,16,6,4,0
300209,4,28,3,25,14,1
146753,4,22,35,-13,15,1
160383,4,3,28,-25,4,1
396661,1,7,0,7,6,0
272185,1,0,0,0,2,0
32356,2,14,0,14,15,1
6639,2,0,10,-10,3,1
42054,3,20,7,13,2,0
138239,4,10,12,-2,11,1
72886,1,0,0,0,16,0
234049,3,20,0,20,2,0
310066,4,9,13,-4,2,0
73902,1,14,0,14,17,0
99910,2,3,3,0,12,1
114188,2,0,0,0,1,1
268616,3,7,6,1,17,0
53097,2,19,20,-1,7,0
23719,1,0,0,0,12,0
257126,4,17,21,-4,12,1
13796,4,7,27,-20,7,1
81535,2,0,21,-21,3,1
253874,2,28,14,14,11,1
294502,2,10,10,0,12,0
54423,4,33,25,8,8,0
20175,3,10,3,7,10,1
378383,1,7,0,7,15,0
30069,4,46,7,39,14,0
53795,5,10,10,0,8,1
363133,3,14,3,11,8,0
377622,1,0,0,0,15,1
419241,4,17,9,8,16,1
36401,4,20,26,-6,17,0
361955,3,10,3,7,7,0
232889,1,0,0,0,2,0
73060,2,7,10,-3,16,1
299647,1,7,0,7,14,1
223784,1,0,0,0,15,0
409892,4,30,8,22,12,1
163244,2,3,3,0,5,0
405734,2,10,7,3,10,1
185300,4,34,22,12,15,0
211843,3,22,10,12,9,0
207285,2,0,7,-7,7,0
415974,1,0,0,0,15,0
293378,2,7,10,-3,11,1
241066,1,7,0,7,5,0
417890,4,13,10,3,16,0
25447,4,13,17,-4,12,1
21727,3,24,14,10,11,0
333417,4,23,13,10,12,1
12517,2,0,17,-17,6,1
54917,2,0,0,0,8,0
250420,1,0,0,0,9,0
56614,4,26,17,9,9,0
251565,3,16,13,3,10,0
328920,2,6,7,-1,10,1
269615,1,3,0,3,1,0
398457,2,7,0,7,7,0
134634,3,31,17,14,10,0
208278,1,0,7,-7,8,1
266448,1,0,9,-9,16,1
57356,3,14,3,11,10,0
26386,1,10,0,10,13,1
176161,2,14,7,7,11,1
116427,2,3,10,-7,1,1
124204,1,0,7,-7,5,1
89381,2,10,13,-3,7,0
341898,4,36,15,21,16,1
79181,3,17,10,7,2,0
9704,4,19,28,-9,5,1
311491,3,10,3,7,2,0
34058,1,0,0,0,16,0
117168,2,13,3,10,2,0
362589,1,0,0,0,8,1
350488,3,10,19,-9,2,1
245373,2,9,3,6,7,1
257179,1,0,9,-9,12,1
26266,2,7,14,-7,13,1
187142,4,13,0,13,16,1
231508,4,23,20,3,1,0
18788,4,13,13,0,9,0
388170,3,3,6,-3,2,0
148687,4,10,9,1,16,1
28818,2,10,0,10,14,0
198949,3,13,23,-10,3,1
324417,3,14,3,11,8,1
303332,3,34,0,34,16,0
256466,4,18,24,-6,12,1
282806,2,3,13,-10,6,0
400709,4,16,10,6,8,0
10034,2,21,0,21,5,0
124145,3,19,21,-2,5,0
160301,2,3,7,-4,4,1
71529,4,33,14,19,16,1
172193,2,0,6,-6,9,1
183428,3,24,6,18,14,1
15225,3,13,7,6,8,1
305844,2,0,14,-14,17,1
242936,4,24,16,8,6,0
237248,3,20,0,20,3,0
229403,2,3,0,3,17,0
417571,4,34,31,3,16,1
100873,4,19,22,-3,12,0
180612,2,7,6,1,13,1
410616,4,17,17,0,13,0
177193,1,0,0,0,11,1
55596,4,27,7,20,9,0
122775,4,10,27,-17,4,0
67837,1,3,3,0,14,0
83637,1,0,0,0,4,0
119687,5,20,19,1,3,0
358070,1,0,0,0,6,1
241251,2,3,0,3,5,1
415576,2,7,7,0,15,0
421327,1,0,0,0,17,0
169200,2,10,6,4,7,0
211928,1,0,3,-3,9,1
392459,1,0,3,-3,4,0
126430,4,33,24,9,6,0
281221,4,27,16,11,6,0
325873,1,0,0,0,9,0
15770,2,0,5,-5,8,0
57212,4,13,7,6,10,1
182810,3,19,10,9,14,1
373897,4,37,16,21,13,0
368285,3,6,6,0,11,1
403562,2,10,0,10,9,1
339065,1,0,0,0,15,1
281980,3,21,21,0,6,1
351503,2,0,27,-27,3,0
152336,2,7,3,4,17,0
398397,4,3,27,-24,7,0
338158,1,7,7,0,14,1
233026,4,24,10,14,2,0
212473,3,10,3,7,10,1
352840,3,14,3,11,3,0
191120,3,21,20,1,17,0
166436,2,17,7,10,6,1
122935,4,37,6,31,4,1
305725,3,9,7,2,17,0
410284,3,7,13,-6,13,0
367327,4,6,20,-14,10,1
93140,2,0,0,0,9,0
253863,2,28,14,14,11,0
152463,1,10,0,10,17,0
42505,3,10,12,-2,3,0
196532,2,10,6,4,2,1
310423,2,14,3,11,2,0
44763,4,13,12,1,3,0
352118,3,6,20,-14,3,1
351109,4,37,30,7,3,0
328468,3,3,3,0,10,1
79142,2,0,0,0,2,1
34164,4,10,10,0,16,0
322787,3,3,20,-17,7,1
278202,3,24,21,3,4,1
298691,3,13,14,-1,14,1
369722,3,22,23,-1,11,1
78699,2,13,0,13,2,0
343437,1,7,0,7,16,0
395318,1,14,0,14,5,0
269869,4,22,10,12,1,1
53901,3,7,13,-6,8,0
45536,1,0,0,0,4,1
80672,3,17,19,-2,3,0
285732,1,0,3,-3,8,1
155598,4,23,17,6,2,1
29818,1,3,3,0,14,1
226343,4,22,7,15,16,1
375647,3,17,17,0,14,0
224466,2,9,10,-1,15,0
374656,1,0,0,0,14,1
270722,3,6,3,3,1,0
48103,2,7,3,4,5,0
6405,3,9,13,-4,3,0
196454,4,20,28,-8,2,1
276599,1,7,3,4,4,1
99406,1,0,0,0,11,0
12604,4,3,24,-21,6,0
44594,3,10,14,-4,3,1
336264,2,10,0,10,13,0
232053,3,0,24,-24,1,0
366032,3,37,14,23,10,0
93962,1,0,7,-7,9,1
330804,1,10,10,0,11,0
170108,2,7,3,4,8,1
390696,3,6,3,3,3,0
241941,1,0,0,0,5,0
312265,4,10,23,-13,2,1
319806,2,14,10,4,6,1
128941,2,25,3,22,7,1
359474,2,0,14,-14,6,1
310959,4,3,23,-20,2,0
225287,1,0,7,-7,15,0
326782,2,3,14,-11,9,0
339623,4,24,17,7,15,1
69225,1,3,0,3,15,0
410817,1,7,0,7,13,0
187531,2,6,13,-7,16,1
363010,4,33,26,7,8,0
22575,2,6,3,3,11,0
17236,3,7,34,-27,9,1
402763,3,24,7,17,9,0
254037,3,14,13,1,11,0
45452,2,21,7,14,4,0
50461,3,16,10,6,6,1
257140,5,24,24,0,12,0
240781,3,10,7,3,5,0
78584,3,16,10,6,2,0
47029,2,17,0,17,5,1
138873,4,12,47,-35,12,0
329690,4,30,17,13,11,1
293318,1,0,0,0,11,1
211313,2,10,3,7,9,0
415250,1,0,0,0,15,0
310098,1,7,0,7,2,0
299582,3,10,3,7,14,1
288904,4,13,31,-18,9,1
350876,2,0,14,-14,3,1
255130,1,0,0,0,12,1
380634,2,7,7,0,16,1
136845,1,0,0,0,11,0
85193,3,7,10,-3,4,1
275947,4,20,18,2,3,0
118768,1,7,0,7,2,1
155297,4,28,27,1,1,0
226953,1,0,0,0,16,1
245142,3,17,15,2,7,0
258670,1,0,6,-6,13,0
149279,3,13,20,-7,16,1
408984,4,31,24,7,12,0
360737,2,17,14,3,7,0
93867,2,14,0,14,9,0
348627,1,0,0,0,2,0
184662,3,10,23,-13,15,0
113946,4,20,10,10,17,0
19638,4,17,28,-11,10,1
269989,3,16,20,-4,1,1
66248,4,45,3,42,13,0
137750,4,10,34,-24,11,1
56132,3,17,14,3,9,1
186393,4,36,37,-1,15,0
383394,3,3,9,-6,17,0
281476,2,7,10,-3,6,1
118869,3,27,7,20,2,0
120539,1,0,6,-6,3,0
342869,2,16,7,9,16,1
265544,4,17,13,4,16,0
235074,1,0,7,-7,2,0
366887,4,3,13,-10,10,0
371102,4,13,27,-14,12,1
292435,2,3,3,0,11,0
154992,1,6,0,6,1,0
345502,1,7,10,-3,17,1
41177,2,0,7,-7,2,1
69262,2,6,0,6,15,0
71045,3,20,0,20,16,1
414535,2,14,3,11,14,0
34916,3,27,24,3,16,1
42868,1,0,0,0,3,0
282563,4,17,24,-7,6,0
406395,3,17,7,10,11,0
122281,3,6,19,-13,4,1
347854,4,16,8,8,1,0
228072,3,3,3,0,17,0
370909,3,13,17,-4,12,1
102315,3,13,10,3,13,0
50184,4,6,24,-18,6,0
86125,2,28,3,25,5,1
401185,1,0,0,0,8,0
375090,1,0,0,0,14,0
310509,4,20,9,11,2,0
151084,4,17,10,7,17,1
102996,4,19,38,-19,13,0
279136,4,21,20,1,5,0
128326,2,0,3,-3,7,0
242039,3,7,3,4,5,1
174166,2,0,3,-3,10,0
83308,1,0,0,0,4,1
387263,3,6,10,-4,2,1
254351,4,13,27,-14,11,0
333872,4,28,21,7,12,0
413147,4,33,35,-2,14,0
25633,1,0,0,0,12,1
66209,3,24,3,21,13,0
273079,4,9,3,6,2,1
337682,4,24,13,11,14,1
320108,2,17,0,17,6,0
162798,2,0,0,0,5,1
364939,1,0,0,0,9,1
230698,2,6,20,-14,1,1
160534,3,23,14,9,4,0
118122,2,13,20,-7,2,1
196524,2,10,3,7,2,0
221980,1,0,0,0,14,1
406494,2,0,13,-13,11,0
336939,4,20,21,-1,14,1
223760,1,0,0,0,15,1
307804,3,17,14,3,1,1
198637,3,3,14,-11,3,1
353058,1,7,6,1,3,1
267194,1,0,0,0,17,1
165220,2,7,7,0,6,1
201443,2,12,0,12,5,0
166710,2,7,3,4,6,1
66025,2,7,0,7,13,0
257786,1,0,0,0,13,1
212000,3,3,16,-13,9,0
6304,4,19,17,2,3,0
315,1,14,0,14,1,0
387206,1,0,7,-7,2,1
210197,3,7,21,-14,9,0
27339,2,21,10,11,13,1
60910,1,0,0,0,11,1
273650,3,13,12,1,2,0
270144,4,24,13,11,1,1
65080,4,6,17,-11,13,1
325314,2,9,10,-1,8,1
315397,3,16,23,-7,4,1
197153,3,27,20,7,3,0
5676,3,0,17,-17,3,1
353736,4,13,17,-4,4,0
56884,2,14,0,14,9,1
376073,2,0,3,-3,14,1
156131,2,7,7,0,2,1
89364,2,3,13,-10,7,1
209743,3,9,6,3,8,0
256052,1,0,3,-3,12,1
207161,3,14,10,4,7,0
37072,3,13,14,-1,17,0
235443,3,28,25,3,3,0
146405,3,13,3,10,15,1
162567,4,38,17,21,4,1
408043,3,10,10,0,12,1
335578,3,9,7,2,13,1
236711,4,30,7,23,3,0
373306,1,0,0,0,13,0
139017,4,14,12,2,12,1
34752,3,13,3,10,16,1
141031,2,7,7,0,13,0
139249,2,10,6,4,12,1
290014,1,7,0,7,10,1
147436,3,23,10,13,15,1
388158,3,3,6,-3,2,0
147853,2,3,14,-11,15,0
17033,1,7,0,7,9,1
206570,2,10,10,0,7,1
8557,1,0,0,0,4,0
417420,4,24,17,7,16,0
79488,4,12,17,-5,2,0
391331,4,24,3,21,4,1
156124,2,7,7,0,2,1
379902,3,14,3,11,16,1
296644,3,3,16,-13,13,1
35989,4,6,21,-15,17,1
347951,3,0,21,-21,1,0
89270,4,12,0,12,7,1
163819,4,17,22,-5,5,1
186868,1,6,0,6,15,1
193839,2,17,0,17,1,1
328621,3,17,35,-18,10,1
225344,2,10,21,-11,15,0
421897,4,21,26,-5,17,1
139875,4,23,17,6,12,0
392849,4,17,20,-3,4,1
215057,3,13,7,6,11,0
158657,3,14,7,7,3,1
213158,1,3,0,3,10,0
56070,1,7,0,7,9,0
327331,4,16,27,-11,9,1
206661,1,0,0,0,7,0
17312,1,7,0,7,9,0
419830,1,0,3,-3,17,1
58206,1,0,3,-3,10,0
161274,3,20,3,17,4,1
266497,3,3,15,-12,16,1
122041,4,19,13,6,4,1
267470,1,0,7,-7,17,0
128677,3,6,17,-11,7,0
303625,3,28,13,15,16,0
296078,4,9,14,-5,13,1
25117,2,10,0,10,12,0
182164,3,26,7,19,13,1
185001,4,14,20,-6,15,0
4008,1,0,0,0,2,1
84105,1,0,0,0,4,1
181774,4,7,17,-10,13,0
67430,1,7,7,0,14,1
382940,2,0,13,-13,17,0
136872,2,0,7,-7,11,0
8331,2,16,3,13,4,0
309055,4,0,20,-20,1,1
102921,2,9,21,-12,13,0
112903,3,16,6,10,17,0
179569,3,0,23,-23,12,1
407476,4,17,10,7,11,0
250427,1,0,0,0,9,1
221387,2,3,17,-14,14,0
266910,1,7,0,7,17,1
280021,3,3,20,-17,5,0
401654,1,0,7,-7,8,0
410965,1,0,0,0,13,0
309604,4,16,3,13,1,1
90575,2,14,7,7,7,0
198359,4,20,14,6,3,1
101342,1,3,0,3,12,1
349457,3,6,20,-14,2,0
381301,4,31,28,3,16,1
342514,1,0,0,0,16,0
287930,2,14,13,1,9,1
281630,2,21,0,21,6,0
141579,4,34,18,16,13,1
284382,4,21,17,4,7,1
421190,1,3,0,3,17,1
380256,4,23,16,7,16,1
14549,1,0,0,0,7,0
153328,4,2,13,-11,1,1
65481,3,23,14,9,13,0
402050,4,3,26,-23,9,0
87441,3,20,7,13,6,0
240659,4,29,24,5,5,0
35391,4,30,23,7,16,0
238754,1,0,0,0,4,1
336027,3,13,25,-12,13,1
48672,1,7,7,0,5,0
184384,3,21,6,15,14,0
7617,3,28,3,25,4,1
236564,4,10,9,1,3,1
155604,4,30,17,13,2,0
37762,2,7,0,7,1,0
230602,3,16,17,-1,1,0
415157,3,3,21,-18,15,1
295393,2,10,10,0,12,0
138196,3,7,9,-2,11,1
93910,3,24,6,18,9,0
27111,4,17,9,8,13,1
279337,1,0,0,0,5,1
3692,1,0,0,0,2,1
256382,2,6,7,-1,12,1
34463,3,38,3,35,16,0
96243,4,3,29,-26,10,1
20118,1,3,0,3,10,0
120460,4,19,19,0,3,0
184728,1,0,0,0,15,1
202814,1,0,0,0,5,1
110835,4,13,13,0,16,0
137004,5,20,20,0,11,0
387968,2,3,0,3,2,1
175930,4,36,27,9,11,1
370140,2,10,3,7,12,1
20170,2,10,0,10,10,0
221498,4,10,41,-31,14,1
189037,3,14,10,4,16,0
189474,3,14,0,14,17,0
3756,3,20,10,10,2,0
289701,1,0,0,0,10,0
367138,2,29,13,16,10,0
42546,4,10,21,-11,3,0
412917,2,6,3,3,14,1
153944,1,0,0,0,1,1
232196,3,9,9,0,1,1
384061,4,27,30,-3,1,0
89884,4,30,13,17,7,0
400682,3,9,7,2,8,1
267580,4,27,27,0,17,0
158743,1,0,0,0,3,0
41391,4,14,15,-1,2,1
373909,4,43,16,27,13,0
52236,3,7,16,-9,7,1
23009,2,0,14,-14,11,1
166768,3,20,9,11,6,0
403427,2,7,3,4,9,0
411135,2,0,13,-13,13,0
140410,1,0,6,-6,12,0
225510,3,0,21,-21,15,1
17644,2,7,3,4,9,1
6298,4,16,17,-1,3,1
124360,1,0,0,0,5,1
137664,1,0,7,-7,11,1
9486,3,10,3,7,5,1
149502,1,14,6,8,16,0
403652,4,30,20,10,9,1
316685,5,12,12,0,4,0
189903,2,0,7,-7,17,0
276675,3,23,6,17,4,0
87179,4,21,10,11,5,0
78533,1,0,7,-7,2,1
341369,3,0,10,-10,16,0
169755,1,0,7,-7,8,0
30571,2,10,0,10,14,1
235309,4,25,6,19,3,0
230743,3,9,27,-18,1,1
185205,2,7,3,4,15,1
36879,1,0,0,0,17,0
287120,1,7,3,4,8,0
59510,3,6,20,-14,11,0
400183,1,0,3,-3,8,1
300535,4,29,20,9,14,1
179580,3,7,23,-16,12,1
126302,1,0,7,-7,6,0
96375,4,9,36,-27,10,0
43359,3,14,14,0,3,1
287793,2,21,10,11,9,0
240506,3,6,7,-1,5,0
207502,4,28,14,14,7,0
117657,3,20,13,7,2,1
75197,1,0,0,0,17,0
190996,3,19,3,16,17,1
69898,4,27,16,11,15,0
63365,4,17,3,14,12,1
286184,5,24,24,0,8,1
195614,1,0,0,0,2,1
206313,4,10,6,4,7,1
62253,2,14,7,7,12,0
194916,3,7,10,-3,2,1
9851,1,0,0,0,5,1
322087,3,26,0,26,7,1
136206,4,13,10,3,10,0
374883,3,14,11,3,14,1
348813,2,3,7,-4,2,0
307970,3,7,6,1,1,1
286102,3,10,17,-7,8,1
192396,1,0,6,-6,1,0
223534,3,10,10,0,15,0
248796,3,30,14,16,9,0
240729,1,0,7,-7,5,1
233227,1,0,0,0,2,1
268962,4,6,36,-30,17,1
369611,4,20,6,14,11,0
209298,1,0,0,0,8,1
74438,4,13,20,-7,17,1
66319,2,0,14,-14,14,0
378837,2,7,3,4,15,0
196941,1,7,0,7,3,1
152838,4,21,18,3,17,1
37771,2,7,3,4,1,0
416455,2,14,7,7,15,0
75193,4,13,13,0,17,1
46776,3,14,20,-6,4,0
418077,1,0,0,0,16,0
340591,1,3,0,3,15,1
3473,3,3,30,-27,2,1
230548,2,9,7,2,1,1
178057,4,19,23,-4,12,1
292142,2,21,0,21,11,1
165503,2,0,7,-7,6,0
241617,4,6,27,-21,5,0
12883,3,13,13,0,6,1
393337,1,7,7,0,5,1
332463,3,16,6,10,12,1
348234,3,16,17,-1,1,0
377920,4,30,16,14,15,0
257310,1,3,0,3,13,0
24639,1,7,0,7,12,1
419889,3,6,18,-12,17,1
271983,1,0,0,0,2,0
164153,1,14,6,8,5,0
252070,4,14,30,-16,10,1
129485,5,29,26,3,7,0
42717,4,7,20,-13,3,1
103344,2,7,17,-10,13,1
359320,2,3,13,-10,6,0
356441,1,0,3,-3,5,1
169277,4,23,6,17,7,0
385514,1,0,0,0,1,0
363505,2,0,2,-2,8,1
267812,2,13,14,-1,17,1
78542,2,10,7,3,2,0
352339,1,7,0,7,3,0
401000,4,22,15,7,8,1
330568,4,14,7,7,11,0
234857,4,3,12,-9,2,0
397097,1,0,0,0,6,1
105559,3,29,14,15,14,0
80289,1,0,3,-3,2,1
114938,2,0,3,-3,1,1
257760,4,3,27,-24,13,0
121827,2,0,7,-7,4,1
173224,4,20,24,-4,9,0
403294,2,6,0,6,9,1
126974,2,10,10,0,6,0
106904,2,9,3,6,14,0
19419,2,17,7,10,10,0
208463,2,17,0,17,8,0
1440,4,19,0,19,1,0
222863,4,24,13,11,14,1
356201,3,22,0,22,5,0
325095,4,40,38,2,8,1
243103,3,7,9,-2,6,0
242660,4,13,3,10,6,0
132969,2,0,14,-14,9,1
1706,3,14,0,14,1,1
358068,1,0,0,0,6,1
31582,2,7,3,4,15,1
31301,2,7,3,4,15,1
177128,3,24,13,11,11,0
201743,1,3,0,3,5,0
315279,5,20,19,1,4,1
134890,2,7,13,-6,10,1
12696,2,38,0,38,6,1
130086,4,17,30,-13,8,0
405611,3,21,20,1,10,0
358986,2,7,0,7,6,0
179225,2,14,3,11,12,1
36921,2,0,16,-16,17,0
202676,1,0,0,0,5,0
10668,4,10,17,-7,5,0
99955,3,10,16,-6,12,1
95021,4,20,16,4,9,0
383820,2,3,7,-4,1,1
297740,4,24,23,1,13,1
400083,2,17,15,2,8,0
52855,3,14,50,-36,7,0
121659,2,0,7,-7,4,0
204697,1,7,7,0,6,1
33437,4,20,20,0,16,1
287521,3,14,33,-19,9,1
42884,1,7,3,4,3,0
58212,2,0,3,-3,10,0
399465,2,0,24,-24,7,1
395672,3,10,27,-17,6,0
371830,1,7,10,-3,12,0
241391,2,7,21,-14,5,1
164214,3,27,35,-8,5,0
199601,4,41,17,24,4,0
311582,1,3,0,3,2,1
35661,3,23,3,20,17,0
192460,2,0,17,-17,1,1
36867,4,24,42,-18,17,1
265206,2,6,6,0,16,1
219508,3,3,21,-18,13,1
238550,4,16,20,-4,4,1
125680,4,31,24,7,5,0
359066,4,10,13,-3,6,0
277922,4,7,27,-20,4,1
296970,4,29,7,22,13,0
352164,4,15,26,-11,3,0
180839,4,17,20,-3,13,1
292950,4,10,0,10,11,1
114071,2,21,0,21,17,0
410233,1,7,0,7,13,1
152568,4,24,20,4,17,0
224683,4,19,10,9,15,0
408661,4,28,17,11,12,1
264795,3,17,29,-12,16,1
314456,2,7,0,7,3,1
382341,1,0,0,0,17,1
207751,3,24,13,11,7,0
213805,2,28,0,28,10,1
235719,3,3,17,-14,3,0
320084,2,10,0,10,6,0
39649,1,0,0,0,1,0
274255,3,23,7,16,3,0
23610,2,7,7,0,12,0
144491,4,23,33,-10,14,1
310926,3,3,6,-3,2,0
76950,3,17,13,4,1,1
57227,4,20,7,13,10,0
115352,1,0,0,0,1,1
313961,1,0,0,0,3,1
18743,3,6,10,-4,9,1
248557,1,0,0,0,9,0
193579,3,0,10,-10,1,0
31773,3,0,17,-17,15,0
215521,4,13,3,10,11,1
74736,4,14,17,-3,17,0
235622,4,27,34,-7,3,1
380377,3,10,16,-6,16,0
335587,3,16,7,9,13,0
390257,3,10,6,4,3,0
68334,2,3,7,-4,14,1
173790,3,10,3,7,10,1
2040,1,0,0,0,1,1
333202,2,0,7,-7,12,1
247800,4,10,16,-6,8,1
71009,2,10,0,10,16,0
347872,1,0,0,0,1,1
33743,1,0,0,0,16,1
287596,1,0,3,-3,9,1
412680,3,30,10,20,14,0
208186,3,0,3,-3,8,0
251624,4,19,20,-1,10,0
21556,2,7,10,-3,11,1
317347,2,0,0,0,5,1
195374,2,10,3,7,2,1
264408,2,3,21,-18,15,1
386638,2,7,13,-6,2,1
19747,3,9,9,0,10,0
308619,4,21,16,5,1,1
384778,1,0,0,0,1,1
328122,2,6,0,6,10,1
195489,1,0,0,0,2,1
339991,2,14,3,11,15,0
32028,1,7,3,4,15,1
382692,3,3,6,-3,17,0
326286,1,0,3,-3,9,1
359146,2,7,0,7,6,1
17887,4,24,17,7,9,1
149763,4,55,0,55,16,0
109823,2,10,0,10,16,1
274752,4,24,20,4,3,0
286498,1,3,0,3,8,0
173039,3,21,6,15,9,1
243591,3,10,7,3,6,1
167857,2,7,16,-9,7,0
314530,4,24,7,17,3,0
106734,2,14,12,2,14,0
54168,2,0,3,-3,8,0
268792,3,31,10,21,17,1
24681,2,20,7,13,12,0
212028,3,10,37,-27,9,1
23554,4,17,17,0,11,0
65479,3,23,14,9,13,1
21215,1,0,0,0,11,1
305955,1,0,0,0,17,0
78041,4,12,23,-11,1,1
110404,1,7,0,7,16,0
234926,1,10,3,7,2,1
229303,4,24,27,-3,17,1
14682,4,33,21,12,7,1
335380,1,0,0,0,13,0
392591,1,0,0,0,4,1
180276,1,6,0,6,13,0
323929,1,7,7,0,8,1
76933,2,14,13,1,1,0
264005,4,30,7,23,15,0
50748,3,20,14,6,6,1
190921,1,6,0,6,17,1
395187,2,10,10,0,5,0
60616,1,0,3,-3,11,1
137467,4,6,28,-22,11,1
218563,2,7,14,-7,13,0
365209,4,14,38,-24,9,1
33401,3,20,10,10,16,0
155218,2,14,7,7,1,1
354397,4,45,10,35,4,1
139086,2,6,3,3,12,0
72630,2,13,0,13,16,0
56027,4,10,23,-13,9,0
111402,3,0,14,-14,16,0
312478,1,10,0,10,3,0
167652,2,10,13,-3,7,0
238553,4,16,20,-4,4,1
133732,1,0,0,0,9,0
43811,2,14,13,1,3,1
273003,2,3,3,0,2,1
41777,2,7,14,-7,2,1
18412,2,0,7,-7,9,1
119470,3,7,17,-10,3,1
237507,2,17,7,10,3,1
270943,1,0,0,0,1,0
303145,3,14,27,-13,16,0
20849,3,21,6,15,10,0
366885,4,3,13,-10,10,0
47320,2,0,10,-10,5,1
306591,2,0,17,-17,17,0
415875,2,7,20,-13,15,1
198426,2,3,3,0,3,1
50360,1,0,0,0,6,0
419696,1,0,3,-3,17,1
145325,3,28,12,16,14,1
409249,3,13,6,7,12,0
20215,4,23,10,13,10,1
152673,3,17,6,11,17,1
175684,2,23,3,20,11,0
214971,1,0,0,0,11,1
237841,2,7,20,-13,4,1
104283,2,24,7,17,13,0
230187,4,3,32,-29,17,1
235618,4,27,34,-7,3,1
392565,4,10,20,-10,4,0
414711,3,3,17,-14,14,1
82993,4,13,19,-6,4,1
355416,2,10,10,0,4,1
105972,2,17,0,17,14,0
372639,3,14,9,5,13,1
137355,2,3,7,-4,11,1
238459,1,3,0,3,4,1
138373,4,32,7,25,11,0
361241,3,14,20,-6,7,0
162513,3,21,10,11,4,1
79114,1,0,0,0,2,1
216914,4,13,24,-11,12,1
303530,1,0,0,0,16,1
286101,3,10,16,-6,8,0
47115,1,0,0,0,5,1
131052,1,7,0,7,8,1
128647,2,6,10,-4,7,0
207309,3,10,14,-4,7,0
399088,4,10,26,-16,7,0
30531,1,0,0,0,14,0
127348,3,10,20,-10,6,1
99945,3,10,9,1,12,0
384788,1,6,0,6,1,0
169696,4,20,17,3,8,0
235159,4,7,10,-3,2,0
74453,4,13,23,-10,17,0
379940,4,21,6,15,16,0
152734,1,0,0,0,17,1
374331,4,25,13,12,13,1
197640,4,33,0,33,3,0
82491,3,10,17,-7,3,1
132791,1,0,0,0,9,0
181069,2,7,7,0,13,1
220743,4,13,13,0,13,1
262885,3,14,23,-9,15,1
261345,2,0,14,-14,14,1
118872,4,27,7,20,2,0
18407,2,0,7,-7,9,1
309530,2,6,0,6,1,0
251388,3,27,14,13,10,1
171120,1,0,0,0,8,1
134554,1,0,0,0,10,1
189028,2,13,7,6,16,1
79261,1,9,0,9,2,0
201460,2,12,0,12,5,0
15233,3,16,7,9,8,0
340862,1,0,0,0,15,0
57613,2,3,3,0,10,1
20304,2,10,3,7,10,0
84965,1,6,7,-1,4,1
377918,4,23,16,7,15,1
53231,2,3,0,3,8,0
239046,4,36,21,15,4,0
144518,1,0,7,-7,14,1
24577,3,10,16,-6,12,0
205681,3,17,19,-2,7,1
152246,3,21,0,21,17,1
302657,3,17,6,11,15,0
243671,1,0,0,0,6,1
92350,1,0,0,0,8,1
45819,4,16,14,2,4,0
55982,3,10,20,-10,9,0
272989,2,3,3,0,2,1
291422,2,14,10,4,10,0
233433,2,17,9,8,2,0
311807,3,17,20,-3,2,0
45144,2,7,7,0,4,0
264215,1,3,7,-4,15,0
198493,3,17,3,14,3,0
271280,2,6,7,-1,1,0
365774,3,17,17,0,9,1
189234,4,39,11,28,16,1
381978,3,0,23,-23,17,1
123182,2,6,21,-15,4,0
315506,2,0,3,-3,4,1
201099,1,0,0,0,5,1
165839,3,6,16,-10,6,1
401753,4,27,14,13,8,1
370847,1,3,0,3,12,1
408128,1,0,0,0,12,1
84126,2,7,0,7,4,1
212530,4,13,16,-3,10,1
309164,3,35,3,32,1,1
89057,2,6,6,0,6,0
202611,3,24,13,11,5,0
169640,2,13,7,6,8,1
249564,3,14,13,1,9,0
135572,4,21,6,15,10,0
134518,4,3,36,-33,10,1
265792,3,17,12,5,16,1
64518,4,34,16,18,13,0
397284,2,0,14,-14,6,0
294187,2,0,7,-7,12,1
17882,4,24,17,7,9,0
242331,3,13,13,0,6,0
315872,4,9,19,-10,4,1
233987,1,14,0,14,2,0
279228,2,13,6,7,5,0
393795,1,0,0,0,5,0
23510,3,14,17,-3,11,0
250186,3,17,13,4,9,1
414490,1,0,0,0,14,0
353776,5,20,23,-3,4,1
43128,4,6,27,-21,3,1
412194,3,14,3,11,13,0
8114,4,27,20,7,4,0
175463,4,20,23,-3,11,0
229360,1,0,0,0,17,1
24162,1,0,0,0,12,1
128928,2,15,3,12,7,1
122039,4,19,13,6,4,1
330209,2,7,7,0,11,1
153866,2,7,3,4,1,0
386542,3,14,21,-7,2,0
392727,1,0,0,0,4,1
72453,1,7,7,0,16,0
5581,4,26,10,16,3,0
287652,3,3,10,-7,9,1
60433,4,23,17,6,11,1
296521,4,26,3,23,13,1
102239,4,30,14,16,13,1
200314,3,27,14,13,4,1
277381,2,17,9,8,4,0
108260,3,6,7,-1,15,1
184637,2,10,10,0,15,0
73447,1,0,7,-7,17,1
259787,4,20,13,7,14,1
97740,4,16,13,3,11,0
305856,3,7,14,-7,17,1
255553,4,30,7,23,12,1
164632,3,7,17,-10,5,1
405655,4,24,28,-4,10,1
356057,4,24,10,14,5,1
399888,2,0,3,-3,8,0
133857,1,0,3,-3,9,1
75125,3,7,6,1,17,0
54143,1,0,0,0,8,0
317939,2,10,3,7,5,0
150030,3,21,6,15,16,1
345639,1,0,0,0,17,1
69986,2,21,3,18,15,1
182849,4,36,20,16,14,0
372461,3,16,14,2,13,0
169342,2,3,14,-11,8,1
79638,4,21,14,7,2,1
153747,3,2,21,-19,1,0
57317,2,7,0,7,10,0
238724,4,19,17,2,4,0
25646,1,7,0,7,12,0
127296,2,10,14,-4,6,1
280627,4,23,9,14,5,0
4216,2,10,6,4,2,1
318601,3,10,10,0,5,0
293350,2,7,0,7,11,0
323060,2,17,14,3,7,0
163949,3,23,13,10,5,1
141545,3,27,10,17,13,0
240437,2,0,0,0,5,0
270446,4,10,7,3,1,1
60446,4,23,27,-4,11,0
246140,1,7,0,7,7,1
378650,4,23,23,0,15,0
358832,2,0,7,-7,6,1
108628,1,6,0,6,15,0
107779,3,7,13,-6,15,0
133447,2,14,14,0,9,0
376333,2,3,0,3,14,1
33558,3,17,3,14,16,1
48388,2,3,17,-14,5,1
23466,2,7,7,0,11,0
281772,2,3,0,3,6,1
312889,4,14,14,0,3,1
193820,2,10,0,10,1,0
118116,2,13,20,-7,2,0
285035,1,0,0,0,7,1
175528,2,3,0,3,11,1
266612,2,3,0,3,16,0
126958,2,3,10,-7,6,0
318636,4,10,13,-3,5,1
85790,2,13,7,6,5,0
366564,3,20,7,13,10,0
319713,4,33,9,24,6,1
409615,1,0,0,0,12,1
67703,1,7,0,7,14,1
256559,2,7,0,7,12,0
38510,2,10,3,7,1,1
267700,3,14,24,-10,17,0
263458,2,6,13,-7,15,0
266977,3,19,10,9,17,0
270306,4,17,27,-10,1,0
132224,1,7,0,7,9,0
106773,3,20,15,5,14,0
16173,1,0,0,0,8,0
309121,2,22,3,19,1,1
11224,2,7,14,-7,6,1
166582,2,15,14,1,6,1
170056,1,0,0,0,8,0
411265,1,0,0,0,13,0
116103,1,0,0,0,1,1
334202,1,0,0,0,13,1
138551,5,31,37,-6,12,0
245092,1,14,3,11,7,0
3060,4,22,47,-25,2,1
266981,3,19,10,9,17,0
265590,1,0,8,-8,16,0
76525,3,7,20,-13,1,0
389685,4,24,16,8,3,1
249834,2,6,10,-4,9,0
74077,2,9,0,9,17,1
390910,4,15,31,-16,3,1
124308,4,34,20,14,5,0
115519,2,0,3,-3,1,0
291509,1,0,0,0,11,1
363352,1,0,7,-7,8,0
319720,4,33,15,18,6,0
390328,1,0,7,-7,3,1
329378,3,16,34,-18,10,1
93620,3,13,6,7,9,0
155052,2,6,18,-12,1,0
176285,1,0,14,-14,11,1
162865,4,6,3,3,5,1
383370,2,0,6,-6,17,0
267499,2,6,14,-8,17,1
37809,3,14,9,5,1,0
87383,2,7,7,0,6,1
388017,3,6,3,3,2,0
46112,4,28,27,1,4,0
339481,4,10,26,-16,15,1
136403,2,3,0,3,11,0
185265,3,24,9,15,15,0
34298,3,20,9,11,16,0
169118,4,39,30,9,7,1
4427,4,14,14,0,2,1
264057,2,7,14,-7,15,0
205581,4,17,30,-13,6,1
6007,4,17,36,-19,3,1
162231,3,20,20,0,4,1
43543,3,17,3,14,3,0
192832,3,7,15,-8,1,0
52120,4,20,19,1,7,1
361560,4,19,10,9,7,0
402477,4,24,15,9,9,1
385094,2,0,3,-3,1,1
231657,4,17,13,4,1,0
183666,3,0,8,-8,14,1
234198,3,13,10,3,2,1
111007,4,14,20,-6,16,0
296044,3,3,7,-4,13,0
216147,1,7,0,7,12,1
310771,3,6,3,3,2,1
42343,2,7,9,-2,2,1
342681,1,0,0,0,16,1
203703,4,22,30,-8,6,0
221066,1,0,0,0,14,1
29500,4,10,14,-4,14,0
53858,2,0,0,0,8,0
278914,2,7,16,-9,5,0
273615,2,10,3,7,2,0
144754,3,3,10,-7,14,1
94694,4,24,36,-12,9,1
18298,3,13,17,-4,9,0
186303,2,19,3,16,15,0
131419,3,7,19,-12,8,0
265184,2,6,3,3,16,0
102677,4,29,28,1,13,1
101055,2,0,9,-9,12,0
108415,3,6,21,-15,15,1
204832,1,3,0,3,6,0
330024,1,0,0,0,11,0
416139,1,3,6,-3,15,0
236333,3,7,23,-16,3,0
167769,5,26,26,0,7,0
304256,4,33,14,19,16,0
313239,1,0,0,0,3,1
214966,1,0,0,0,11,1
393452,4,28,24,4,5,0
204692,1,7,7,0,6,0
265364,3,7,13,-6,16,1
123461,1,0,0,0,4,1
339087,2,3,0,3,15,0
340180,2,20,20,0,15,0
131165,4,27,12,15,8,1
124420,3,6,7,-1,5,1
232713,4,20,3,17,1,0
155881,3,7,13,-6,2,1
179917,3,24,9,15,13,1
104976,4,17,22,-5,14,1
209914,4,36,16,20,8,1
393419,3,28,24,4,5,1
297426,4,30,24,6,13,1
26523,1,3,0,3,13,0
69065,1,0,0,0,15,1
214565,2,3,3,0,11,1
295160,4,10,21,-11,12,1
100814,3,9,6,3,12,0
6742,1,0,0,0,3,0
73471,1,0,14,-14,17,1
1882,4,22,17,5,1,1
81918,4,7,30,-23,3,1
152920,2,14,14,0,1,1
94042,3,6,21,-15,9,0
304699,4,21,7,14,16,0
37479,2,7,7,0,17,0
288560,3,20,31,-11,9,1
182045,3,17,14,3,13,1
33603,5,17,16,1,16,0
104377,4,45,38,7,13,1
219725,4,13,14,-1,13,1
225179,2,3,7,-4,15,1
40113,1,3,0,3,2,1
342567,2,12,13,-1,16,1
396062,1,10,3,7,6,0
292415,1,3,0,3,11,0
238464,1,3,0,3,4,1
330305,1,0,0,0,11,0
206971,1,14,0,14,7,1
404391,4,20,13,7,10,0
15167,1,3,0,3,8,0
117030,2,0,17,-17,2,1
10931,2,6,14,-8,5,1
185621,4,20,20,0,15,0
276567,1,0,0,0,4,1
369787,4,51,50,1,11,1
66742,2,0,3,-3,14,1
369909,4,13,16,-3,12,1
173335,3,14,27,-13,10,1
22497,4,31,29,2,11,0
122230,1,3,7,-4,4,0
222602,1,7,0,7,14,0
91873,4,30,13,17,8,0
384685,2,10,17,-7,1,0
141652,2,20,14,6,13,1
342871,2,16,7,9,16,1
250453,2,7,0,7,9,1
171972,4,14,21,-7,9,1
78467,4,24,0,24,2,0
49236,3,17,10,7,6,0
304436,1,0,7,-7,16,1
29747,3,27,3,24,14,1
71891,2,12,13,-1,16,0
400468,1,0,0,0,8,1
332069,4,10,9,1,12,1
57840,4,22,10,12,10,0
94585,4,20,17,3,9,0
92661,1,0,3,-3,8,0
176818,2,10,10,0,11,0
237633,2,3,7,-4,4,1
84332,4,21,27,-6,4,0
201050,3,34,0,34,5,1
271393,1,7,0,7,1,0
181778,4,7,17,-10,13,1
55791,2,0,6,-6,9,0
58226,2,0,3,-3,10,1
215937,3,10,21,-11,11,1
11120,4,17,13,4,5,0
59777,3,9,10,-1,11,1
9285,1,7,0,7,5,0
4400,4,7,14,-7,2,0
12867,3,13,6,7,6,0
299573,3,10,3,7,14,0
287524,3,14,33,-19,9,1
199707,3,28,7,21,4,0
338034,2,0,0,0,14,1
148604,2,7,9,-2,16,0
259268,1,13,0,13,13,0
172146,4,13,18,-5,9,0
156706,4,14,20,-6,2,1
340362,3,17,10,7,15,0
329421,4,16,41,-25,10,0
301363,3,17,7,10,15,0
135111,3,31,6,25,10,0
376983,3,15,16,-1,15,1
333358,2,17,10,7,12,1
389814,3,17,6,11,3,1
85037,3,25,16,9,4,0
405134,3,3,10,-7,10,1
154822,4,24,23,1,1,1
139048,1,0,0,0,12,1
329060,2,3,7,-4,10,1
77001,4,17,20,-3,1,1
59195,2,14,42,-28,10,1
403019,3,13,21,-8,9,0
307680,4,14,23,-9,17,0
218318,3,17,14,3,12,0
168828,1,14,0,14,7,0
83636,1,0,0,0,4,0
137208,2,7,3,4,11,1
346893,4,23,16,7,1,1
38588,4,38,13,25,1,0
377695,2,19,7,12,15,1
265995,4,0,33,-33,16,1
232528,3,20,10,10,1,0
5164,1,0,0,0,3,1
404341,3,20,6,14,10,0
128443,1,7,0,7,7,1
357745,4,43,13,30,5,0
240302,2,7,7,0,5,0
153143,3,20,17,3,1,0
419069,4,10,20,-10,16,1
211374,4,10,10,0,9,0
251980,2,0,13,-13,10,1
226901,3,3,10,-7,16,0
61220,1,7,0,7,11,1
175812,2,14,3,11,11,1
229236,2,10,7,3,17,0
278218,4,24,21,3,4,1
316561,2,3,6,-3,4,1
354654,3,10,7,3,4,0
84028,3,27,15,12,4,1
234950,2,10,3,7,2,0
28805,2,3,0,3,14,1
395532,3,21,14,7,6,0
105441,4,23,24,-1,14,1
285080,2,3,0,3,7,0
285612,4,20,17,3,8,1
397568,2,6,10,-4,7,0
312020,1,6,0,6,2,1
145935,3,7,14,-7,15,0
155844,2,7,10,-3,2,0
221091,2,0,0,0,14,0
92193,4,10,43,-33,8,0
269020,2,7,3,4,17,1
128082,3,3,6,-3,7,0
102926,2,9,21,-12,13,1
9119,1,0,0,0,5,0
343938,2,14,0,14,17,1
14669,4,33,14,19,7,0
38525,2,24,3,21,1,0
210151,2,0,7,-7,9,1
197223,1,0,0,0,3,1
194555,1,7,0,7,2,1
388,3,28,10,18,1,0
386826,3,13,14,-1,2,0
57929,3,13,17,-4,10,0
247883,3,10,3,7,8,0
291955,1,0,0,0,11,0
18607,3,17,10,7,9,0
64225,4,38,6,32,13,1
371512,4,24,24,0,12,1
338400,3,24,10,14,14,1
351087,3,21,23,-2,3,1
170223,1,0,3,-3,8,0
43827,3,14,16,-2,3,1
58424,3,41,10,31,10,0
214106,2,3,3,0,11,0
274234,2,17,7,10,3,1
60159,1,0,0,0,11,0
337183,2,3,10,-7,14,1
94929,2,0,3,-3,9,1
240162,3,16,3,13,5,1
266884,1,0,0,0,17,1
250424,1,0,0,0,9,0
155142,4,19,33,-14,1,0
346874,4,23,13,10,1,0
400085,3,17,15,2,8,1
257975,2,0,14,-14,13,1
237682,3,20,7,13,4,0
116988,1,0,3,-3,2,1
247256,2,21,14,7,8,1
12756,4,59,0,59,6,1
209729,3,9,6,3,8,1
253892,3,38,14,24,11,0
267419,4,10,17,-7,17,1
347717,1,0,0,0,1,1
48883,3,9,0,9,5,1
95004,4,13,16,-3,9,0
368823,2,7,0,7,11,1
111102,3,24,6,18,16,0
362240,3,12,17,-5,8,1
147312,4,7,31,-24,15,0
97240,3,12,6,6,10,0
244181,2,7,7,0,6,0
273764,2,7,7,0,2,0
15807,3,0,12,-12,8,0
19285,2,7,14,-7,10,1
320411,2,14,0,14,6,1
42453,1,0,5,-5,3,0
44710,2,0,9,-9,3,0
60739,4,28,3,25,11,1
135906,5,24,24,0,10,0
48061,1,0,0,0,5,0
118824,2,20,0,20,2,0
377962,1,0,7,-7,15,1
367934,1,0,7,-7,11,0
378999,1,7,3,4,15,0
16856,4,26,38,-12,8,0
409007,4,31,31,0,12,0
299113,2,3,10,-7,14,1
104936,3,3,6,-3,14,0
374081,1,0,0,0,13,1
294857,3,42,21,21,12,0
331456,2,9,7,2,11,1
275478,3,20,17,3,3,0
369123,2,12,7,5,11,1
19653,4,23,28,-5,10,1
364813,1,3,7,-4,9,1
254753,2,9,3,6,11,1
53119,3,19,31,-12,7,1
184752,1,14,0,14,15,0
33802,2,0,24,-24,16,0
146230,3,0,16,-16,15,1
186946,3,7,9,-2,15,0
224942,3,3,9,-6,15,1
192474,2,0,17,-17,1,1
152423,4,38,3,35,17,1
130912,1,0,7,-7,8,0
141770,4,33,28,5,13,0
208392,4,17,43,-26,8,1
381757,1,0,0,0,17,0
93336,3,27,3,24,9,0
169958,2,13,10,3,8,1
143156,1,0,0,0,13,0
169927,1,7,0,7,8,1
402879,3,17,6,11,9,0
74306,4,10,30,-20,17,1
54230,3,0,3,-3,8,1
285030,1,0,0,0,7,0
29023,4,14,10,4,14,1
113088,4,16,23,-7,17,1
414248,2,14,21,-7,14,1
383069,2,17,7,10,17,1
54023,2,3,0,3,8,1
58906,3,6,25,-19,10,1
2531,2,10,0,10,2,0
208377,4,17,37,-20,8,1
181110,3,24,7,17,13,0
227876,2,17,6,11,16,0
233857,1,7,3,4,2,1
139919,1,7,3,4,12,0
350925,3,3,14,-11,3,1
415695,2,7,3,4,15,0
217169,3,9,16,-7,12,1
184552,3,35,14,21,14,1
53039,1,6,0,6,7,1
97558,4,30,7,23,10,1
333456,1,0,0,0,12,1
132073,1,7,0,7,9,0
290926,2,13,0,13,10,1
405,3,31,17,14,1,0
355844,2,13,7,6,5,0
26604,3,10,6,4,13,1
264362,1,0,7,-7,15,1
113757,3,3,17,-14,17,1
118085,1,3,6,-3,2,0
194770,3,3,16,-13,2,1
231736,2,3,13,-10,1,1
109219,1,3,0,3,15,0
163945,3,23,13,10,5,1
326333,2,0,10,-10,9,0
11755,4,33,31,2,6,0
114882,4,24,33,-9,1,0
31458,2,3,7,-4,15,0
202079,1,7,0,7,5,0
335929,1,0,0,0,13,0
248393,1,10,0,10,8,0
26001,3,10,16,-6,13,0
397232,4,16,0,16,6,0
16888,1,7,13,-6,8,1
64842,2,7,0,7,13,1
381343,1,6,0,6,16,0
347032,4,24,17,7,1,1
197735,3,13,10,3,3,1
356700,3,19,16,3,5,1
150375,4,33,7,26,16,0
61765,1,0,0,0,12,0
137585,4,20,34,-14,11,1
107771,2,7,13,-6,15,1
118947,2,0,10,-10,3,0
56085,1,7,0,7,9,1
28272,4,17,14,3,13,0
53922,3,14,13,1,8,0
142980,4,10,13,-3,13,0
396054,1,10,0,10,6,0
378733,2,14,7,7,15,0
405556,2,0,14,-14,10,0
57494,3,21,10,11,10,1
379070,3,7,6,1,15,0
228500,2,17,7,10,17,1
68926,1,0,0,0,15,0
107086,3,40,0,40,15,1
213029,2,17,0,17,10,0
187151,4,16,0,16,16,1
222583,1,0,0,0,14,1
360913,3,24,0,24,7,0
2800,2,21,13,8,2,0
62213,1,0,0,0,12,0
337197,3,9,13,-4,14,1
245824,1,0,10,-10,7,1
278837,4,14,24,-10,5,0
82148,2,3,3,0,3,1
391342,4,24,3,21,4,1
15506,3,16,6,10,8,0
36843,4,24,29,-5,17,1
383676,3,9,17,-8,17,0
284313,2,6,10,-4,7,0
383400,3,3,9,-6,17,1
370524,4,27,9,18,12,0
302547,4,3,13,-10,15,0
27487,2,17,7,10,13,1
323085,3,23,14,9,7,0
12597,4,3,24,-21,6,1
126115,4,30,9,21,6,0
362556,4,26,12,14,8,0
170350,4,6,15,-9,8,0
240573,1,3,0,3,5,1
95891,4,20,23,-3,10,0
340548,4,7,42,-35,15,1
310729,2,3,3,0,2,0
342772,4,7,14,-7,16,0
135459,1,0,0,0,10,0
106145,3,0,0,0,14,0
255591,1,0,0,0,12,1
137605,4,34,34,0,11,0
171003,2,7,7,0,8,0
255913,1,3,3,0,12,1
108372,2,0,14,-14,15,0
364058,1,0,0,0,9,0
166969,1,0,0,0,7,1
66905,2,9,7,2,14,0
261348,2,0,14,-14,14,1
1931,2,0,0,0,1,1
15608,2,14,10,4,8,1
387319,4,13,10,3,2,0
164977,4,16,19,-3,6,1
334909,4,27,10,17,13,1
17811,2,10,3,7,9,0
163994,1,0,0,0,5,0
288466,1,0,0,0,9,0
220715,3,13,6,7,13,1
156786,2,14,13,1,2,1
366109,2,7,14,-7,10,1
204130,3,3,10,-7,6,1
241467,4,10,42,-32,5,1
351328,2,7,7,0,3,1
324352,1,6,0,6,8,1
217959,1,0,0,0,12,1
335871,3,21,14,7,13,1
403639,3,24,20,4,9,1
114961,2,7,6,1,1,0
251514,2,16,13,3,10,1
111878,4,16,10,6,17,0
99979,4,17,19,-2,12,1
262312,3,10,9,1,15,1
347904,2,0,7,-7,1,0
76892,1,0,10,-10,1,1
84198,4,17,10,7,4,0
299163,3,10,16,-6,14,0
319192,3,9,16,-7,5,0
45734,2,7,7,0,4,1
6203,1,10,0,10,3,1
379870,2,7,0,7,16,1
153865,2,7,3,4,1,0
219531,3,9,21,-12,13,1
176353,3,16,21,-5,11,1
214445,3,7,14,-7,11,1
267260,3,17,14,3,17,1
310484,3,20,9,11,2,0
264399,2,3,21,-18,15,1
146303,4,17,33,-16,15,1
32748,4,7,24,-17,15,1
357887,4,13,34,-21,6,0
250540,4,16,14,2,9,1
211657,2,16,3,13,9,1
215695,1,0,0,0,11,1
245810,1,0,7,-7,7,1
108611,4,26,28,-2,15,1
333152,1,0,0,0,12,1
394878,2,0,14,-14,5,0
282671,2,6,17,-11,6,1
42478,2,0,12,-12,3,1
27219,3,19,7,12,13,0
135041,1,14,3,11,10,1
37104,3,13,17,-4,17,0
21114,2,0,0,0,10,1
398652,3,0,3,-3,7,1
179956,1,0,6,-6,13,0
351567,4,0,27,-27,3,0
107406,4,26,13,13,15,1
126142,1,0,0,0,6,0
25343,1,0,0,0,12,0
183621,2,0,0,0,14,1
347841,4,16,8,8,1,0
347275,2,0,7,-7,1,1
20484,2,0,0,0,10,1
345126,3,15,3,12,17,0
33230,2,10,0,10,16,0
287483,2,14,20,-6,9,1
227512,4,19,17,2,16,1
398362,3,3,20,-17,7,1
351845,3,27,14,13,3,0
275024,3,31,10,21,3,0
12788,1,0,3,-3,6,1
178684,3,3,20,-17,12,0
389651,3,24,10,14,3,0
395128,4,24,34,-10,5,1
208005,2,14,0,14,8,1
230874,2,7,10,-3,1,1
285516,1,0,0,0,8,0
12386,2,10,3,7,6,0
69773,4,19,17,2,15,1
178764,1,14,7,7,12,1
321726,2,6,6,0,7,1
291984,2,0,3,-3,11,0
367944,1,0,7,-7,11,1
392167,2,3,13,-10,4,1
71020,2,16,0,16,16,1
200079,1,7,0,7,4,0
379717,2,6,0,6,16,1
484,2,6,6,0,1,1
350100,4,30,20,10,2,0
53275,3,3,7,-4,8,0
40904,3,13,20,-7,2,1
411095,1,0,0,0,13,0
213889,4,54,14,40,10,1
281260,1,7,0,7,6,0
77247,3,16,7,9,1,0
122252,2,3,13,-10,4,0
334481,1,0,7,-7,13,1
296293,2,3,10,-7,13,1
80032,2,7,3,4,2,1
117213,3,23,10,13,2,1
221923,3,19,16,3,14,0
20263,1,7,0,7,10,0
102558,1,2,0,2,13,1
241424,3,7,35,-28,5,1
240000,2,3,13,-10,5,0
390123,3,17,21,-4,3,1
167485,2,0,0,0,7,0
317265,4,7,16,-9,5,1
396715,3,7,14,-7,6,1
45058,4,23,13,10,4,0
413163,4,40,42,-2,14,0
230234,1,6,0,6,17,0
64046,3,20,10,10,13,0
417662,3,21,6,15,16,0
197682,1,0,3,-3,3,1
375534,4,33,14,19,14,0
148674,4,10,9,1,16,0
171635,3,19,10,9,9,0
281601,1,14,0,14,6,0
199080,2,7,21,-14,4,1
376623,1,0,0,0,14,0
217212,4,12,19,-7,12,0
60322,1,3,0,3,11,1
87976,1,3,0,3,6,0
15275,4,30,7,23,8,0
305731,3,9,10,-1,17,1
18512,4,20,20,0,9,0
74643,2,0,3,-3,17,0
358741,3,14,17,-3,6,0
330626,1,0,0,0,11,1
210559,1,6,7,-1,9,0
101775,4,13,10,3,12,0
301758,2,0,17,-17,15,0
415634,4,30,13,17,15,1
134254,4,3,23,-20,10,1
254129,2,3,9,-6,11,1
104195,4,35,37,-2,13,0
174704,3,9,7,2,10,0
407453,3,14,10,4,11,1
281942,2,7,14,-7,6,1
242293,2,10,7,3,6,1
212537,4,13,16,-3,10,1
214943,4,7,26,-19,11,0
194337,3,17,6,11,2,1
103965,3,3,10,-7,13,1
255903,1,3,0,3,12,0
87761,4,6,20,-14,6,0
241489,1,0,0,0,5,1
122842,2,10,3,7,4,1
150949,4,13,14,-1,17,0
220681,2,10,0,10,13,0
225914,2,20,0,20,16,0
421415,3,24,20,4,17,1
223875,3,23,6,17,15,0
405099,2,0,10,-10,10,1
266655,3,19,3,16,16,0
358551,2,10,3,7,6,1
241103,2,13,7,6,5,0
201917,1,0,0,0,5,0
141428,4,13,20,-7,13,0
360190,3,17,13,4,7,1
353396,2,16,0,16,4,0
57037,2,7,20,-13,9,0
309082,1,9,0,9,1,0
12693,2,38,0,38,6,0
97231,3,12,6,6,10,1
117690,3,27,13,14,2,0
413498,1,0,0,0,14,0
334133,3,16,7,9,13,1
403763,3,12,13,-1,9,0
103269,4,3,10,-7,13,1
116805,4,34,33,1,2,1
355944,1,0,0,0,5,0
184796,2,17,17,0,15,0
261585,4,12,15,-3,14,0
119623,3,17,9,8,3,0
216941,1,3,0,3,12,0
21917,4,35,9,26,11,1
18634,4,20,17,3,9,0
98730,2,28,3,25,11,0
194726,2,0,10,-10,2,1
101891,3,6,13,-7,12,0
194613,2,21,7,14,2,1
342038,4,20,3,17,16,0
366059,4,51,14,37,10,0
108979,2,16,23,-7,15,0
310935,3,3,16,-13,2,1
186037,3,24,34,-10,15,0
217714,2,7,0,7,12,0
212174,3,3,17,-14,10,1
27353,3,24,10,14,13,1
261652,2,0,0,0,14,0
244004,1,7,7,0,6,0
396264,2,3,3,0,6,1
231463,3,10,9,1,1,0
197441,2,13,6,7,3,1
199436,4,19,10,9,4,1
22103,1,3,0,3,11,0
12176,1,0,0,0,6,0
320128,3,17,0,17,6,0
360868,1,0,0,0,7,1
197344,4,20,10,10,3,1
406086,3,0,20,-20,11,1
13748,2,0,17,-17,7,0
42451,1,0,5,-5,3,1
374489,4,32,7,25,14,1
19783,4,12,15,-3,10,1
346388,3,9,13,-4,1,0
233103,2,8,3,5,2,0
37737,1,7,0,7,1,1
228579,1,7,6,1,17,0
399746,2,0,10,-10,8,0
218663,4,10,33,-23,13,0
35188,3,0,14,-14,16,1
28855,3,23,7,16,14,0
400888,4,31,26,5,8,1
199580,3,34,17,17,4,1
138710,4,27,35,-8,12,1
345284,3,13,17,-4,17,1
31499,3,3,17,-14,15,1
375688,4,26,20,6,14,0
338059,2,0,7,-7,14,1
298715,4,19,21,-2,14,1
344906,1,0,7,-7,17,1
280620,4,20,9,11,5,1
272395,2,24,0,24,2,0
248635,3,14,10,4,9,1
284174,3,9,20,-11,7,1
200826,1,0,0,0,4,1
267708,3,14,24,-10,17,0
247257,2,27,14,13,8,1
136356,4,18,14,4,11,1
127512,4,3,23,-20,6,1
399067,3,10,19,-9,7,1
268298,2,17,3,14,17,1
81143,4,16,14,2,3,0
376389,3,9,6,3,14,1
317341,2,0,0,0,5,1
394405,1,0,3,-3,5,1
7767,3,30,3,27,4,0
326933,2,2,0,2,9,1
228095,4,3,10,-7,17,1
223180,1,3,0,3,15,0
148064,4,14,10,4,15,0
145865,1,0,0,0,15,0
205310,2,10,0,10,6,0
402741,3,17,7,10,9,1
217121,2,0,9,-9,12,0
390140,4,20,35,-15,3,1
200555,2,14,7,7,4,0
212487,3,10,6,4,10,1
400435,4,24,10,14,8,0
271196,4,20,20,0,1,1
390106,3,17,14,3,3,0
41099,4,3,19,-16,2,1
284614,2,14,10,4,7,1
367621,4,31,12,19,10,0
315226,3,17,10,7,4,0
153535,2,5,7,-2,1,0
44270,2,17,13,4,3,0
419815,1,0,0,0,17,1
319924,2,16,7,9,6,1
170904,3,14,20,-6,8,0
356076,4,33,10,23,5,1
22603,2,20,3,17,11,1
380660,2,7,7,0,16,1
17985,3,16,21,-5,9,0
51224,4,32,25,7,7,1
4293,4,27,6,21,2,0
315945,2,0,7,-7,4,0
333378,3,17,10,7,12,0
52902,1,0,0,0,7,0
378766,3,14,10,4,15,0
402802,4,30,20,10,9,0
345460,4,3,22,-19,17,1
102802,3,10,3,7,13,0
351703,4,14,17,-3,3,1
185066,2,0,3,-3,15,0
131017,4,17,30,-13,8,0
201186,3,19,21,-2,5,1
133297,2,7,0,7,9,1
244311,1,0,0,0,7,0
7045,1,0,0,0,4,0
376345,2,3,0,3,14,1
371031,2,10,10,0,12,1
281213,4,24,16,8,6,1
21647,1,0,0,0,11,1
302811,3,9,20,-11,15,1
421760,4,31,24,7,17,1
394190,3,26,17,9,5,1
121901,4,0,33,-33,4,1
358512,1,0,0,0,6,0
342550,2,3,6,-3,16,1
273341,3,28,0,28,2,0
317040,2,7,10,-3,4,0
420553,4,10,42,-32,17,1
397510,4,20,22,-2,6,1
115873,3,7,16,-9,1,1
57765,2,16,3,13,10,0
346280,4,40,3,37,1,1
111812,2,3,10,-7,17,0
40300,2,6,0,6,2,0
153641,4,15,17,-2,1,1
180267,1,3,0,3,13,1
154634,3,21,21,0,1,1
347355,4,14,21,-7,1,1
161963,4,13,23,-10,4,1
117138,1,6,3,3,2,1
239515,1,3,0,3,4,0
133296,2,7,0,7,9,1
359205,4,21,21,0,6,0
329847,4,24,23,1,11,0
98834,1,7,0,7,11,0
196461,4,20,28,-8,2,1
57516,3,21,10,11,10,0
16800,3,6,24,-18,8,1
302404,4,16,16,0,15,0
71197,3,19,13,6,16,0
1562,3,13,13,0,1,1
267638,1,0,13,-13,17,0
125903,2,13,10,3,6,1
229519,1,10,6,4,17,1
219085,4,45,13,32,13,0
402892,3,17,6,11,9,1
325774,2,0,10,-10,9,1
276351,2,14,28,-14,3,1
341876,4,23,15,8,16,0
367263,2,3,3,0,10,0
163956,4,26,13,13,5,0
84339,4,21,30,-9,4,1
406602,1,0,0,0,11,0
289921,3,6,3,3,10,1
305087,2,21,10,11,16,1
84262,2,0,13,-13,4,0
23632,2,7,13,-6,12,1
307174,2,0,10,-10,17,1
364263,3,0,26,-26,9,1
119867,5,24,24,0,3,0
294638,2,0,0,0,12,0
135319,1,0,10,-10,10,1
138308,2,20,0,20,11,1
333051,2,10,12,-2,12,0
329633,2,10,7,3,11,1
61259,3,21,14,7,11,1
49263,4,17,10,7,6,1
342208,1,0,0,0,16,1
372452,2,6,14,-8,13,1
292800,4,29,17,12,11,1
213978,2,29,7,22,10,0
251931,4,20,22,-2,10,0
190933,2,6,0,6,17,1
14041,3,3,21,-18,7,1
231430,2,7,6,1,1,1
369580,3,14,0,14,11,0
390142,4,20,35,-15,3,0
279590,4,10,16,-6,5,1
113472,3,3,7,-4,17,0
250845,4,3,12,-9,10,0
109895,3,23,0,23,16,0
260332,2,0,0,0,14,0
310145,2,14,7,7,2,0
248031,3,28,13,15,8,1
321897,3,14,21,-7,7,1
383208,1,14,3,11,17,1
99853,1,0,0,0,12,0
230974,1,0,0,0,1,1
306614,3,7,20,-13,17,1
140197,4,13,10,3,12,0
148136,2,3,7,-4,16,0
151065,3,10,10,0,17,1
201338,3,28,13,15,5,0
192052,4,31,27,4,1,0
417911,4,16,10,6,16,1
28279,4,23,14,9,13,1
389309,2,0,6,-6,3,1
345558,2,7,20,-13,17,1
177207,1,0,0,0,11,1
251866,3,14,13,1,10,0
408000,2,0,0,0,12,1
187201,2,0,0,0,16,0
347448,2,6,13,-7,1,1
92677,2,3,10,-7,8,0
228048,2,3,3,0,17,1
23214,3,23,13,10,11,0
90973,1,0,0,0,7,1
257534,3,19,10,9,13,0
285305,3,21,9,12,7,0
74356,2,7,3,4,17,1
120951,1,2,0,2,3,1
289958,4,6,6,0,10,0
49983,3,21,7,14,6,0
352753,4,24,13,11,3,1
416922,3,9,7,2,15,1
286975,1,0,0,0,8,1
160052,3,19,26,-7,3,1
69769,4,19,10,9,15,0
333605,1,0,0,0,12,1
319769,2,7,0,7,6,0
71426,2,24,0,24,16,0
315834,3,3,19,-16,4,1
224106,1,0,0,0,15,0
9785,3,2,10,-8,5,1
397758,3,9,14,-5,7,1
185323,4,47,30,17,15,1
151866,1,10,0,10,17,1
311660,3,6,6,0,2,0
55595,4,27,7,20,9,0
177671,2,7,7,0,12,1
219639,2,10,0,10,13,0
407483,4,17,10,7,11,1
286155,4,24,24,0,8,1
110595,2,17,7,10,16,1
366593,4,20,14,6,10,1
337051,3,19,0,19,14,0
37304,1,7,0,7,17,1
166114,2,14,3,11,6,1
333321,1,10,7,3,12,1
112744,3,10,7,3,17,1
334895,4,27,10,17,13,0
46211,3,14,21,-7,4,0
73237,3,7,16,-9,16,1
336523,1,0,0,0,14,1
123708,4,10,32,-22,4,1
246696,4,45,10,35,8,0
151723,1,7,0,7,17,0
319533,4,13,23,-10,6,1
90388,1,0,6,-6,7,1
361410,4,17,14,3,7,0
12885,3,13,13,0,6,1
192716,1,0,0,0,1,0
26674,1,0,6,-6,13,0
148672,4,10,9,1,16,0
236529,3,10,9,1,3,0
25950,1,3,3,0,13,0
267834,2,13,14,-1,17,1
47162,2,6,0,6,5,1
205538,4,14,24,-10,6,1
409334,1,0,0,0,12,0
58381,2,28,0,28,10,0
274356,1,3,7,-4,3,1
97022,2,13,0,13,10,1
268503,4,23,9,14,17,1
126581,4,16,13,3,6,0
13909,3,21,7,14,7,1
206106,3,20,6,14,7,0
231744,2,3,20,-17,1,1
220128,3,26,13,13,13,1
386658,3,7,13,-6,2,1
316085,2,16,6,10,4,1
36831,3,17,26,-9,17,1
216579,4,40,11,29,12,0
67031,2,7,3,4,14,0
253895,3,38,14,24,11,1
143175,1,7,3,4,13,0
383537,3,14,13,1,17,0
40720,2,10,7,3,2,0
354087,3,19,0,19,4,1
88313,2,14,7,7,6,1
206563,2,10,10,0,7,0
414958,1,7,7,0,15,1
144583,3,7,19,-12,14,1
9395,1,0,0,0,5,0
10998,4,9,31,-22,5,0
384856,2,6,12,-6,1,1
186712,4,27,16,11,15,1
157054,1,0,0,0,2,1
38118,4,9,6,3,1,0
182436,1,7,0,7,14,1
296464,3,17,0,17,13,0
258362,1,7,0,7,13,0
138964,3,7,6,1,12,0
205404,4,27,0,27,6,1
331330,3,0,27,-27,11,0
88000,2,10,0,10,6,0
326916,1,2,0,2,9,0
193698,2,3,20,-17,1,0
143854,4,12,7,5,14,0
328199,4,14,17,-3,10,0
3054,4,22,41,-19,2,1
90680,4,27,33,-6,7,0
198928,2,13,16,-3,3,0
358131,2,17,6,11,6,0
136742,2,13,10,3,11,1
60866,4,17,23,-6,11,0
105698,3,28,3,25,14,0
106890,2,9,3,6,14,0
86897,4,9,26,-17,5,1
93414,2,3,7,-4,9,0
273478,2,7,13,-6,2,1
9480,3,10,3,7,5,1
123062,4,14,13,1,4,0
380154,1,0,0,0,16,1
280766,4,14,14,0,5,0
250752,1,3,0,3,10,1
136246,2,12,7,5,11,0
193558,2,0,7,-7,1,0
333466,1,3,0,3,12,1
238357,2,10,16,-6,4,1
49594,4,28,10,18,6,0
323322,1,0,0,0,7,0
326977,3,2,7,-5,9,1
23350,3,12,10,2,11,0
82532,4,17,27,-10,3,0
281064,4,24,16,8,6,1
250890,1,0,0,0,10,0
126311,2,7,7,0,6,0
404696,4,27,32,-5,10,1
296650,3,3,16,-13,13,0
176700,3,29,19,10,11,1
165452,4,13,36,-23,6,1
96004,2,6,7,-1,10,1
83803,1,7,0,7,4,0
302626,2,10,3,7,15,1
275692,1,0,0,0,3,0
323747,1,6,0,6,8,0
232126,1,0,0,0,1,1
80622,2,6,10,-4,3,1
233627,4,23,41,-18,2,0
102172,2,14,7,7,13,0
256248,2,6,7,-1,12,0
240681,4,36,24,12,5,1
59579,1,0,3,-3,11,1
42435,1,0,0,0,3,1
190415,3,7,7,0,17,0
394773,3,21,0,21,5,0
145320,3,28,12,16,14,0
197642,4,33,7,26,3,1
392772,2,14,3,11,4,0
145986,4,13,21,-8,15,1
260083,3,6,14,-8,14,0
176900,1,0,0,0,11,1
251493,2,16,3,13,10,0
380376,2,10,10,0,16,1
308693,2,7,6,1,1,1
236070,4,44,10,34,3,0
357945,1,7,6,1,6,1
216304,1,7,6,1,12,0
374611,4,20,20,0,14,0
23723,1,0,0,0,12,1
235338,4,32,21,11,3,0
210122,1,0,0,0,9,0
328574,1,7,7,0,10,1
272538,2,10,3,7,2,0
280120,2,14,0,14,5,1
71586,2,3,14,-11,16,0
344824,3,20,10,10,17,1
64488,4,31,16,15,13,1
193562,2,0,7,-7,1,0
110768,2,3,3,0,16,1
188481,4,10,17,-7,16,0
132933,4,13,21,-8,9,0
155572,3,23,3,20,2,0
398624,2,0,0,0,7,1
233741,2,13,24,-11,2,0
101028,1,0,0,0,12,0
169085,4,36,23,13,7,0
274918,4,14,16,-2,3,1
124011,4,13,14,-1,5,1
207431,2,7,14,-7,7,1
390337,1,0,7,-7,3,1
154271,2,6,7,-1,1,1
100113,4,13,6,7,12,1
176296,2,7,14,-7,11,0
68543,3,10,28,-18,14,0
156424,1,0,3,-3,2,1
402247,2,3,10,-7,9,1
177305,4,17,20,-3,11,1
56622,4,26,17,9,9,1
373291,4,16,30,-14,13,1
115209,1,0,0,0,1,0
95809,2,6,3,3,10,1
8732,1,0,0,0,4,1
243977,1,0,0,0,6,1
181753,3,7,14,-7,13,1
197406,2,13,0,13,3,0
4108,4,23,28,-5,2,0
284898,2,0,7,-7,7,0
38491,1,10,3,7,1,0
74508,2,0,3,-3,17,1
26397,2,10,0,10,13,0
1890,1,0,0,0,1,1
309759,4,26,12,14,1,1
52758,1,0,0,0,7,0
49152,1,3,0,3,6,0
325317,2,12,10,2,8,1
382088,2,21,3,18,17,0
359539,4,0,21,-21,6,0
391265,2,14,0,14,4,0
2834,3,24,24,0,2,1
267923,1,0,0,0,17,1
105938,1,7,0,7,14,1
418904,4,13,17,-4,16,1
303537,1,0,0,0,16,0
22342,4,0,6,-6,11,1
130201,3,3,19,-16,8,0
7329,5,20,19,1,4,1
209749,4,16,6,10,8,0
76883,1,0,3,-3,1,0
331952,1,0,0,0,12,1
39670,1,3,0,3,1,0
179468,4,21,20,1,12,0
340662,3,16,13,3,15,1
366352,1,6,0,6,10,1
258222,1,0,0,0,13,0
282384,3,10,20,-10,6,1
368543,2,9,0,9,11,1
251847,2,14,10,4,10,1
96675,1,0,0,0,10,1
1005,4,0,6,-6,1,1
342815,1,0,0,0,16,1
18772,3,13,10,3,9,0
79208,4,20,10,10,2,0
60066,2,7,3,4,11,0
294182,2,0,7,-7,12,1
357094,2,6,14,-8,5,1
384581,3,10,42,-32,1,1
377547,2,7,9,-2,15,1
56225,1,3,7,-4,9,1
321804,4,21,9,12,7,1
416873,1,0,0,0,15,1
397268,1,0,14,-14,6,1
271170,3,7,17,-10,1,0
244271,3,23,7,16,6,1
93585,2,6,3,3,9,0
127898,2,10,0,10,6,0
265597,2,0,8,-8,16,1
169253,4,20,6,14,7,1
318343,4,9,22,-13,5,0
249624,1,0,0,0,9,1
198407,1,3,0,3,3,0
404000,1,0,14,-14,10,1
414706,2,3,17,-14,14,1
79320,3,15,3,12,2,1
340636,2,13,3,10,15,1
79277,2,12,3,9,2,0
97244,3,12,13,-1,10,1
16870,1,0,7,-7,8,1
145459,3,16,14,2,14,0
24045,2,0,7,-7,12,1
230144,3,3,23,-20,17,1
88869,1,0,0,0,6,0
152975,3,35,17,18,1,0
364342,1,0,0,0,9,0
289467,2,3,7,-4,10,1
62826,1,0,0,0,12,1
384809,2,6,3,3,1,0
253838,2,14,14,0,11,0
132561,2,2,29,-27,9,1
255059,3,3,21,-18,12,0
88847,4,13,16,-3,6,1
88453,2,7,0,7,6,1
235482,1,0,0,0,3,0
150245,1,0,0,0,16,0
107207,3,6,31,-25,15,0
289223,4,23,13,10,9,1
112192,4,27,34,-7,17,0
244013,2,7,10,-3,6,1
247446,3,13,9,4,8,1
274341,1,3,7,-4,3,1
351976,3,21,14,7,3,1
70499,4,30,20,10,15,0
389395,4,30,19,11,3,1
17614,1,0,0,0,9,1
412738,1,0,7,-7,14,1
70881,2,7,17,-10,15,1
105966,2,17,0,17,14,0
192788,2,0,15,-15,1,1
90228,4,6,3,3,7,1
96477,3,16,17,-1,10,1
372559,1,0,0,0,13,1
388015,3,6,3,3,2,0
33407,3,20,17,3,16,0
88151,2,7,10,-3,6,1
306429,2,0,10,-10,17,0
361904,2,0,0,0,7,1
332029,3,3,3,0,12,0
39202,1,0,0,0,1,0
401390,2,17,7,10,8,1
190844,3,16,3,13,17,0
69634,4,14,17,-3,15,1
146623,1,0,7,-7,15,1
351618,1,0,7,-7,3,1
119911,1,6,7,-1,3,0
78576,2,16,10,6,2,0
341653,2,10,6,4,16,0
155111,4,13,33,-20,1,0
18717,2,3,7,-4,9,0
265922,2,0,16,-16,16,1
239496,1,0,0,0,4,0
295652,1,0,0,0,12,1
9776,3,2,10,-8,5,0
25120,2,10,0,10,12,0
120528,1,0,6,-6,3,1
115837,2,0,10,-10,1,1
91112,1,0,0,0,8,0
313408,2,7,0,7,3,0
369789,4,52,50,2,11,0
390763,4,13,20,-7,3,1
330239,3,17,14,3,11,0
59564,1,0,3,-3,11,1
155205,2,14,7,7,1,0
188074,1,0,3,-3,16,1
35652,3,20,3,17,17,1
109322,4,20,3,17,15,0
219321,2,13,7,6,13,1
235413,3,28,17,11,3,0
317579,1,0,0,0,5,1
409980,3,6,28,-22,12,0
41594,1,7,0,7,2,0
367754,4,20,20,0,10,0
242139,2,13,7,6,6,0
222948,3,13,13,0,14,1
109489,4,12,16,-4,16,1
42260,4,30,7,23,2,1
148959,3,10,12,-2,16,1
18296,3,13,17,-4,9,0
318650,4,10,13,-3,5,1
318643,4,10,13,-3,5,1
21184,4,0,16,-16,10,0
232778,2,13,0,13,2,0
84972,1,9,7,2,4,0
286540,2,3,14,-11,8,1
382254,3,17,3,14,17,1
188135,3,10,10,0,16,0
421496,2,0,3,-3,17,1
72986,4,38,15,23,16,0
314790,3,21,7,14,4,0
240977,4,21,22,-1,5,0
129851,2,10,0,10,7,0
236304,2,0,9,-9,3,1
253759,4,24,10,14,11,0
95259,2,3,10,-7,10,0
108340,1,0,7,-7,15,0
66834,4,13,6,7,14,1
168892,3,17,6,11,7,1
358057,4,34,29,5,6,0
262383,1,0,0,0,15,0
359689,1,0,0,0,6,0
310984,4,16,37,-21,2,0
372628,3,14,6,8,13,0
260126,4,6,35,-29,14,1
231467,3,10,9,1,1,0
10641,3,7,17,-10,5,1
226912,3,3,10,-7,16,1
389807,3,17,6,11,3,1
362389,4,30,20,10,8,0
270186,1,0,0,0,1,1
160999,3,10,7,3,4,0
359387,4,13,20,-7,6,0
272129,4,17,9,8,2,1
151909,2,20,7,13,17,0
293926,2,7,21,-14,12,1
362318,1,3,7,-4,8,0
419822,1,0,0,0,17,0
127001,3,24,13,11,6,0
345659,1,7,0,7,17,1
91674,4,21,21,0,8,0
150606,3,3,16,-13,17,1
97865,4,14,27,-13,11,1
354771,2,13,17,-4,4,0
346427,4,15,19,-4,1,1
372392,1,6,0,6,13,0
12240,2,0,3,-3,6,1
145335,3,35,19,16,14,1
251281,4,13,27,-14,10,1
35916,2,3,0,3,17,1
289956,4,6,6,0,10,1
122642,4,36,7,29,4,0
208141,2,0,0,0,8,0
173612,2,7,13,-6,10,0
40953,4,16,20,-4,2,1
355456,3,20,13,7,4,1
92125,2,3,24,-21,8,1
409374,2,10,3,7,12,1
278543,4,43,7,36,4,1
307427,1,14,3,11,17,0
264772,3,10,16,-6,16,0
413788,1,0,0,0,14,1
6527,3,3,3,0,3,0
421471,1,0,0,0,17,1
60873,4,17,23,-6,11,0
108942,1,13,7,6,15,1
24747,4,20,27,-7,12,1
350126,1,0,0,0,2,1
236244,4,27,22,5,3,1
89564,3,0,27,-27,7,1
41672,4,24,7,17,2,1
45726,2,7,7,0,4,0
283414,2,20,7,13,7,0
400169,1,0,0,0,8,1
328953,3,16,7,9,10,0
406459,1,0,3,-3,11,0
26805,4,13,43,-30,13,1
306992,1,7,0,7,17,0
269109,4,13,16,-3,17,1
125584,2,7,10,-3,5,1
295448,4,17,13,4,12,0
174012,1,0,6,-6,10,0
57837,4,22,10,12,10,1
163186,4,30,28,2,5,1
231872,2,7,20,-13,1,1
5152,4,19,14,5,3,1
96443,2,10,14,-4,10,0
153555,2,5,14,-9,1,1
14629,3,17,7,10,7,0
209249,4,20,7,13,8,1
260257,4,17,3,14,14,0
268762,2,24,3,21,17,0
294663,2,3,14,-11,12,1
191377,2,0,24,-24,17,1
468,1,0,3,-3,1,0
316386,2,13,0,13,4,0
137773,4,10,37,-27,11,1
87395,2,7,7,0,6,1
15236,3,16,7,9,8,1
168440,3,0,17,-17,7,0
284193,3,9,20,-11,7,1
416827,4,19,10,9,15,0
203420,1,0,0,0,6,0
384524,1,0,14,-14,1,1
101126,4,13,17,-4,12,0
43493,2,7,0,7,3,0
44442,3,17,7,10,3,1
410107,2,14,7,7,13,1
20931,1,7,7,0,10,0
369493,1,0,0,0,11,1
252513,3,17,25,-8,10,1
394005,2,6,10,-4,5,0
179702,1,0,0,0,12,0
363773,1,0,7,-7,8,1
248794,3,30,14,16,9,1
313618,4,22,29,-7,3,0
78698,2,13,0,13,2,0
327433,3,3,17,-14,9,0
253250,3,3,7,-4,11,1
287893,1,0,3,-3,9,1
299378,1,0,13,-13,14,1
107646,3,13,20,-7,15,1
191644,1,0,3,-3,17,1
106286,2,0,6,-6,14,0
41950,4,24,6,18,2,1
259745,3,10,10,0,14,0
389467,2,10,0,10,3,1
300978,1,0,0,0,15,0
199922,1,0,10,-10,4,0
62042,4,24,10,14,12,1
26164,3,0,20,-20,13,1
245182,4,17,28,-11,7,1
100634,2,7,7,0,12,0
309268,2,0,10,-10,1,0
260308,1,0,0,0,14,1
197177,4,27,27,0,3,0
298209,2,7,3,4,14,1
115044,4,20,22,-2,1,1
189093,4,30,30,0,16,1
61695,3,17,10,7,12,1
209214,3,17,7,10,8,0
315281,5,20,19,1,4,1
179380,2,3,13,-10,12,1
37667,3,30,0,30,17,0
90704,1,7,0,7,7,1
366609,4,26,14,12,10,0
323428,4,23,6,17,7,0
18562,2,3,10,-7,9,1
163661,4,21,36,-15,5,0
345906,3,17,23,-6,17,0
24683,2,20,7,13,12,0
163974,4,33,20,13,5,0
415455,3,23,3,20,15,0
359325,3,3,13,-10,6,0
217451,2,9,0,9,12,0
273729,1,0,0,0,2,1
315210,3,17,10,7,4,0
417580,1,0,0,0,16,1
421289,4,19,10,9,17,0
108867,4,7,17,-10,15,1
3062,4,22,47,-25,2,1
289224,4,23,13,10,9,1
327636,1,0,0,0,10,1
220790,1,0,0,0,14,1
135987,2,3,10,-7,10,0
103391,3,10,20,-10,13,1
210681,4,20,31,-11,9,0
241749,4,7,9,-2,5,0
176418,4,22,28,-6,11,1
18307,3,16,17,-1,9,0
264434,3,10,28,-18,15,0
258809,2,7,7,0,13,1
124507,1,3,0,3,5,0
237787,1,0,7,-7,4,0
38248,3,13,14,-1,1,1
208726,1,0,0,0,8,1
276257,4,31,17,14,3,0
141153,1,3,7,-4,13,0
325718,1,0,0,0,9,0
306815,4,26,36,-10,17,1
102768,2,10,3,7,13,1
29548,2,0,10,-10,14,0
367405,2,17,14,3,10,0
226516,4,14,20,-6,16,1
391974,1,0,0,0,4,0
190160,4,30,3,27,17,0
300926,3,10,20,-10,15,0
194099,1,0,0,0,1,0
145673,4,35,7,28,14,1
398236,4,35,17,18,7,0
90406,1,0,6,-6,7,0
277819,1,7,7,0,4,0
62925,4,17,10,7,12,0
337540,4,7,33,-26,14,1
81968,1,0,0,0,3,0
377015,4,15,19,-4,15,1
19062,4,10,6,4,10,1
82123,1,0,0,0,3,1
239330,4,3,17,-14,4,0
72506,3,13,17,-4,16,0
55903,4,19,22,-3,9,0
211184,2,0,10,-10,9,0
79972,1,0,0,0,2,1
164121,4,22,6,16,5,0
174891,4,26,24,2,10,1
141892,4,27,21,6,13,0
396921,4,27,27,0,6,1
205874,4,20,7,13,7,1
66505,3,20,24,-4,14,1
275046,3,34,17,17,3,0
58007,5,20,20,0,10,0
245871,2,3,23,-20,7,0
396174,4,24,23,1,6,0
16908,2,14,13,1,8,1
353040,1,0,0,0,3,1
263873,1,0,0,0,15,1
347516,4,12,30,-18,1,1
206487,4,27,0,27,7,1
74511,2,0,3,-3,17,1
128568,4,28,35,-7,7,0
305917,4,21,21,0,17,1
381041,2,7,6,1,16,1
224658,4,16,10,6,15,0
260762,2,3,6,-3,14,0
175058,1,0,0,0,10,1
270028,1,0,0,0,1,1
338526,3,20,17,3,14,1
17501,2,13,0,13,9,0
69647,4,14,17,-3,15,1
191058,1,7,0,7,17,0
400371,2,17,10,7,8,1
410115,2,17,7,10,13,0
25355,1,3,0,3,12,0
254148,3,3,12,-9,11,1
150397,1,7,0,7,16,0
283831,1,7,0,7,7,1
21680,2,3,7,-4,11,0
325714,1,0,0,0,9,0
398409,4,10,30,-20,7,0
392213,3,10,16,-6,4,1
357529,2,10,6,4,5,0
215746,2,23,3,20,11,0
248514,4,23,20,3,8,1
149413,3,13,27,-14,16,1
156764,1,13,7,6,2,1
189752,2,7,6,1,17,1
288779,1,0,7,-7,9,1
157679,1,0,3,-3,2,1
321378,1,0,3,-3,7,1
383183,1,7,0,7,17,0
280750,4,14,14,0,5,0
101545,2,13,21,-8,12,0
242438,2,0,7,-7,6,0
158233,3,31,0,31,3,1
356530,3,9,3,6,5,0
148828,4,16,23,-7,16,0
13534,1,0,0,0,7,1
263743,2,0,0,0,15,0
329505,3,17,7,10,10,1
191942,1,0,6,-6,1,1
288094,3,10,7,3,9,1
54146,1,0,0,0,8,0
353422,3,18,0,18,4,0
387954,1,3,0,3,2,1
212837,4,24,24,0,10,1
39737,3,9,0,9,1,1
80239,4,28,31,-3,2,0
167246,4,30,17,13,7,0
3014,3,13,34,-21,2,1
179560,2,0,23,-23,12,1
268169,3,9,17,-8,17,1
292584,2,6,15,-9,11,0
255141,1,0,0,0,12,1
151729,2,7,3,4,17,1
308036,1,0,0,0,1,1
145468,3,16,17,-1,14,1
47749,4,6,20,-14,5,0
391906,4,23,20,3,4,0
274714,3,10,12,-2,3,0
38986,3,30,10,20,1,0
167421,1,0,0,0,7,0
16120,4,40,17,23,8,0
215907,2,3,7,-4,11,0
197108,2,13,17,-4,3,1
264825,4,23,37,-14,16,1
307003,2,7,0,7,17,1
52692,3,3,13,-10,7,0
29833,2,6,10,-4,14,1
122275,3,6,13,-7,4,1
345480,4,16,22,-6,17,1
180629,2,10,6,4,13,1
115427,3,32,7,25,1,1
356728,4,26,16,10,5,1
215929,3,10,14,-4,11,0
72753,1,14,0,14,16,1
288811,1,3,14,-11,9,1
205510,3,14,17,-3,6,0
402309,3,20,18,2,9,1
91421,1,3,0,3,8,0
381463,1,0,0,0,17,1
197590,3,19,0,19,3,1
368462,4,30,28,2,11,1
380109,4,35,30,5,16,1
225706,4,21,13,8,16,0
111433,4,0,20,-20,16,1
203688,4,14,23,-9,6,0
390325,1,0,7,-7,3,1
165777,1,0,0,0,6,1
270280,3,10,24,-14,1,0
371285,2,7,10,-3,12,0
248982,4,27,3,24,9,1
415253,1,0,0,0,15,1
220785,1,0,0,0,14,0
203106,4,42,17,25,5,1
302879,4,15,23,-8,15,0
297333,2,3,3,0,13,0
322775,2,3,20,-17,7,1
177748,4,13,17,-4,12,0
158688,4,17,7,10,3,1
347374,4,21,21,0,1,1
91713,1,0,0,0,8,1
203298,1,0,23,-23,6,0
82205,4,16,3,13,3,0
353495,1,0,0,0,4,1
233380,1,7,0,7,2,0
8426,1,3,0,3,4,0
290862,4,17,21,-4,10,1
58302,4,20,13,7,10,1
12728,3,52,0,52,6,1
141692,3,23,21,2,13,1
362722,4,6,20,-14,8,1
245500,1,7,0,7,7,0
373827,2,13,0,13,13,1
328636,3,20,35,-15,10,0
285006,4,16,27,-11,7,1
147052,1,0,0,0,15,0
87913,4,13,15,-2,6,1
330895,4,16,24,-8,11,0
363322,4,36,14,22,8,0
363500,2,0,2,-2,8,1
375880,1,7,0,7,14,0
290925,2,7,0,7,10,1
47396,4,10,13,-3,5,1
414227,2,7,14,-7,14,1
352161,4,15,20,-5,3,0
283983,1,0,0,0,7,0
235441,3,28,25,3,3,0
216675,2,21,6,15,12,0
190633,2,14,7,7,17,1
53113,3,19,24,-5,7,0
218166,2,14,3,11,12,0
11364,2,17,0,17,6,1
298615,1,0,0,0,14,1
26225,1,0,7,-7,13,0
385190,4,21,20,1,1,0
381455,4,26,14,12,16,1
304386,4,28,21,7,16,1
359616,3,24,0,24,6,1
165293,4,17,21,-4,6,0
118418,3,20,10,10,2,0
54116,4,20,10,10,8,1
421647,2,3,7,-4,17,1
307176,2,0,10,-10,17,0
389108,3,30,0,30,3,0
215469,2,10,3,7,11,0
367243,1,3,0,3,10,1
316633,4,9,12,-3,4,1
90006,3,5,21,-16,7,1
203663,3,14,20,-6,6,0
102607,2,5,6,-1,13,1
82982,4,13,19,-6,4,1
70689,1,0,3,-3,15,1
403554,1,10,0,10,9,1
197719,2,7,10,-3,3,0
275671,4,37,3,34,3,0
364054,4,6,24,-18,8,0
16007,4,18,14,4,8,1
346808,2,10,3,7,1,0
303905,2,7,17,-10,16,0
97636,2,3,3,0,11,1
202505,4,9,16,-7,5,0
5313,1,0,0,0,3,1
209192,2,7,7,0,8,1
56322,4,3,26,-23,9,0
205259,4,23,20,3,6,1
283480,4,23,14,9,7,1
417138,1,0,7,-7,16,0
15276,4,30,7,23,8,0
176670,2,26,12,14,11,0
353672,2,3,0,3,4,0
56682,1,0,0,0,9,0
234829,3,0,12,-12,2,0
139367,1,13,0,13,12,1
61036,4,34,16,18,11,0
390777,1,0,0,0,3,1
159050,1,10,0,10,3,0
266167,1,7,0,7,16,1
137732,3,10,27,-17,11,0
127377,4,17,23,-6,6,0
259248,1,0,0,0,13,0
300523,4,23,17,6,14,1
74640,2,0,3,-3,17,0
144545,2,7,10,-3,14,1
13947,4,24,20,4,7,0
244050,2,20,20,0,6,1
372668,4,14,17,-3,13,1
157382,2,3,7,-4,2,0
21690,2,10,7,3,11,0
255969,3,6,12,-6,12,1
4203,2,10,6,4,2,1
111825,3,6,10,-4,17,1
189666,4,17,6,11,17,0
130263,4,9,29,-20,8,1
200939,4,40,14,26,4,0
129965,1,0,0,0,8,1
317140,1,0,0,0,5,0
275380,4,10,22,-12,3,1
284832,4,29,27,2,7,1
141666,2,23,14,9,13,0
260665,3,10,22,-12,14,0
117025,2,0,10,-10,2,0
163933,3,23,10,13,5,1
6963,2,0,7,-7,3,0
36357,3,13,13,0,17,0
328392,1,0,0,0,10,1
339748,3,21,6,15,15,1
367988,2,17,14,3,11,0
389414,4,30,22,8,3,1
78291,3,3,21,-18,2,1
63048,3,16,21,-5,12,1
345269,3,13,14,-1,17,1
72343,2,0,14,-14,16,0
167504,2,0,3,-3,7,1
335131,2,10,0,10,13,1
228071,3,3,3,0,17,0
337269,4,16,26,-10,14,1
53387,2,3,14,-11,8,0
223376,2,7,12,-5,15,0
295710,3,3,9,-6,12,1
277134,4,10,24,-14,4,1
249249,3,19,14,5,9,0
268751,2,24,3,21,17,0
67891,2,16,3,13,14,1
266997,4,19,17,2,17,1
143619,2,10,10,0,14,1
376758,1,0,0,0,15,1
417092,3,34,0,34,15,0
82661,4,12,10,2,3,0
370321,3,14,35,-21,12,0
356203,3,22,0,22,5,0
36214,3,10,17,-7,17,0
49519,3,7,3,4,6,1
63380,4,17,3,14,12,0
104476,2,14,16,-2,13,0
54777,2,10,0,10,8,1
132938,1,0,0,0,9,1
226357,4,25,13,12,16,1
203047,3,20,10,10,5,1
208012,2,21,0,21,8,0
150377,4,33,7,26,16,0
57986,4,13,20,-7,10,1
409646,2,7,0,7,12,0
310265,2,10,0,10,2,0
401846,3,7,21,-14,9,0
62708,1,0,0,0,12,1
198033,3,0,30,-30,3,1
421042,1,0,0,0,17,1
237368,3,6,14,-8,3,1
235124,3,0,10,-10,2,1
25780,5,17,17,0,12,0
246270,4,27,16,11,7,1
274937,4,17,16,1,3,1
371050,3,10,13,-3,12,1
363054,1,0,0,0,8,1
238969,3,14,12,2,4,0
252945,3,9,0,9,11,0
308490,1,0,6,-6,1,1
78851,2,7,0,7,2,1
320334,4,17,24,-7,6,0
40397,1,0,0,0,2,0
34520,1,0,0,0,16,0
385067,1,0,0,0,1,0
224606,2,6,7,-1,15,1
68742,1,0,0,0,15,1
398505,3,21,16,5,7,1
49882,4,28,20,8,6,0
310918,3,3,6,-3,2,0
111142,4,31,10,21,16,1
53778,5,10,10,0,8,1
266436,1,0,0,0,16,1
202653,4,34,20,14,5,1
149053,2,0,7,-7,16,0
150624,3,10,22,-12,17,1
39071,1,6,0,6,1,0
30302,3,3,10,-7,14,0
157279,3,13,3,10,2,0
403289,2,6,0,6,9,0
245587,3,40,0,40,7,0
226964,1,3,0,3,16,0
136014,3,3,10,-7,10,1
194248,1,0,0,0,2,0
311999,4,35,17,18,2,0
269633,2,3,0,3,1,1
23461,2,7,7,0,11,1
280835,2,10,0,10,6,0
350971,4,21,17,4,3,0
291,4,12,34,-22,1,1
73589,1,0,0,0,17,1
245849,2,3,20,-17,7,0
224325,3,16,12,4,15,0
14846,1,0,0,0,7,0
347699,4,27,24,3,1,1
37480,2,7,7,0,17,1
81220,2,0,7,-7,3,1
12842,2,13,3,10,6,0
314938,3,0,10,-10,4,0
276924,2,14,14,0,4,1
143345,2,7,13,-6,14,0
42771,2,6,7,-1,3,0
278058,4,13,10,3,4,0
325801,3,6,10,-4,9,0
385634,4,9,24,-15,1,1
269925,2,7,3,4,1,0
68798,2,6,7,-1,15,1
356909,1,3,0,3,5,1
81491,1,0,7,-7,3,0
248153,2,3,10,-7,8,1
137092,3,17,3,14,11,0
378063,4,0,14,-14,15,0
146419,3,16,3,13,15,0
88794,3,13,10,3,6,0
280764,4,14,14,0,5,0
244937,2,0,20,-20,7,1
112831,1,7,0,7,17,0
284324,3,6,10,-4,7,0
368079,1,7,0,7,11,0
407642,4,10,17,-7,11,1
234071,4,20,7,13,2,0
278961,3,7,23,-16,5,0
189460,2,14,0,14,17,0
326991,3,2,10,-8,9,1
306030,3,10,10,0,17,1
145074,4,20,13,7,14,0
221856,2,6,0,6,14,1
219100,4,45,13,32,13,0
235652,1,0,3,-3,3,0
369357,1,0,0,0,11,0
172455,4,13,49,-36,9,0
19738,3,9,9,0,10,0
151587,2,0,3,-3,17,0
378169,3,24,16,8,15,1
403495,3,23,12,11,9,1
181499,5,31,31,0,13,0
210104,1,0,0,0,9,1
82663,4,12,10,2,3,0
406490,2,0,13,-13,11,0
377481,1,0,0,0,15,0
352770,1,7,0,7,3,0
243440,3,3,17,-14,6,1
121599,4,22,16,6,4,1
370863,2,3,3,0,12,1
288843,2,10,17,-7,9,0
197610,3,19,0,19,3,1
77358,2,7,7,0,1,0
94728,4,38,43,-5,9,1
345240,2,13,14,-1,17,0
47195,3,9,3,6,5,0
73253,4,7,16,-9,16,1
70219,4,30,30,0,15,0
315176,2,7,7,0,4,0
34795,4,20,6,14,16,1
367661,1,0,3,-3,10,0
21649,1,0,0,0,11,1
396875,3,27,10,17,6,0
299449,3,7,20,-13,14,0
55604,4,27,7,20,9,0
155099,3,6,33,-27,1,0
233523,1,0,7,-7,2,1
352375,2,21,7,14,3,1
206392,2,10,0,10,7,1
223346,1,0,3,-3,15,0
103124,4,34,7,27,13,0
391872,3,13,13,0,4,1
314341,3,10,17,-7,3,0
134165,2,0,3,-3,10,0
51926,3,13,10,3,7,1
379320,3,3,6,-3,16,1
235019,4,24,17,7,2,0
225909,2,14,0,14,16,0
341610,1,0,0,0,16,0
323821,3,13,15,-2,8,1
380021,2,14,0,14,16,0
396477,4,28,32,-4,6,1
10995,4,9,28,-19,5,0
367316,4,6,17,-11,10,0
265118,4,13,10,3,16,1
353413,3,18,0,18,4,0
145186,3,46,0,46,14,1
196389,2,10,0,10,2,1
140487,3,21,26,-5,12,1
327679,2,3,10,-7,10,1
162162,1,7,0,7,4,1
120721,2,17,0,17,3,0
47939,1,0,14,-14,5,1
327659,1,0,3,-3,10,1
34949,4,27,27,0,16,1
531,3,7,20,-13,1,0
316399,2,13,0,13,4,0
300757,2,7,13,-6,15,1
276823,3,20,20,0,4,0
217909,4,25,28,-3,12,0
323109,4,26,14,12,7,1
344014,4,23,6,17,17,0
174590,4,13,14,-1,10,0
46240,4,21,31,-10,4,0
162634,2,3,10,-7,5,1
353568,3,24,0,24,4,0
124556,2,6,7,-1,5,1
117558,4,17,20,-3,2,0
93015,3,13,3,10,8,1
57449,1,7,0,7,10,0
291964,1,0,0,0,11,0
128437,1,7,0,7,7,0
210030,3,7,10,-3,8,1
245754,3,16,17,-1,7,1
381840,3,10,14,-4,17,0
380951,3,9,7,2,16,0
328411,1,0,0,0,10,1
63500,4,31,16,15,12,0
179060,2,3,3,0,12,0
227661,4,42,7,35,16,1
108123,4,13,35,-22,15,0
385177,4,21,17,4,1,0
249519,2,14,3,11,9,0
129499,1,0,0,0,7,0
387385,2,21,7,14,2,1
298144,4,10,41,-31,13,1
177482,4,27,17,10,11,1
337737,1,3,0,3,14,1
229404,2,3,0,3,17,0
274912,4,14,16,-2,3,0
298332,1,0,0,0,14,0
266433,1,0,0,0,16,1
33234,2,10,0,10,16,0
87148,3,21,10,11,5,0
123214,3,6,21,-15,4,1
130200,3,3,19,-16,8,1
120827,1,7,14,-7,3,0
327687,2,3,10,-7,10,0
7243,2,0,13,-13,4,0
10788,2,14,0,14,5,0
31373,4,7,3,4,15,0
37760,2,7,0,7,1,0
379086,4,7,12,-5,15,1
190497,2,7,0,7,17,1
87226,1,7,7,0,6,0
311013,1,7,0,7,2,1
124661,1,0,0,0,5,0
258039,4,7,38,-31,13,0
80803,3,3,0,3,3,0
343985,3,16,6,10,17,0
59658,3,21,6,15,11,0
132576,3,12,29,-17,9,0
374345,4,28,13,15,13,0
111903,1,0,7,-7,17,1
52358,2,3,17,-14,7,1
392320,2,6,21,-15,4,1
210554,1,0,7,-7,9,1
319105,1,0,0,0,5,1
13527,1,0,0,0,7,1
285297,3,14,9,5,7,0
93822,1,0,0,0,9,0
384795,1,6,3,3,1,1
45671,4,13,13,0,4,1
329679,3,23,17,6,11,1
324224,1,3,0,3,8,0
34294,3,20,9,11,16,1
127333,3,10,20,-10,6,1
63676,4,26,36,-10,12,1
159513,1,7,0,7,3,0
246104,4,26,20,6,7,1
356759,1,0,0,0,5,0
130673,3,7,38,-31,8,1
104828,4,27,33,-6,14,1
16287,4,25,29,-4,8,0
272831,2,20,0,20,2,1
398436,1,7,0,7,7,0
148623,3,7,9,-2,16,0
315475,1,0,0,0,4,0
181016,1,0,0,0,13,0
333576,4,16,16,0,12,1
120144,3,10,6,4,3,0
385914,2,3,13,-10,1,0
327100,2,7,0,7,9,0
161379,1,0,0,0,4,0
349806,5,29,29,0,2,0
176424,4,22,28,-6,11,1
380112,4,35,30,5,16,0
188835,1,0,0,0,16,1
153207,4,20,23,-3,1,0
8982,1,0,0,0,4,0
151564,1,0,0,0,17,0
180473,2,14,13,1,13,0
159264,3,17,24,-7,3,0
173067,4,24,12,12,9,1
54987,4,13,9,4,8,0
32528,2,17,3,14,15,1
357855,3,6,24,-18,6,0
203629,2,7,7,0,6,0
344456,1,0,0,0,17,1
35419,1,0,0,0,17,0
121924,1,0,7,-7,4,1
71148,2,19,3,16,16,0
41978,4,38,6,32,2,1
139217,1,3,6,-3,12,1
248733,2,17,7,10,9,0
206688,2,0,7,-7,7,1
4456,1,7,3,4,2,0
418511,4,24,12,12,16,1
301046,3,17,3,14,15,0
251689,2,14,3,11,10,0
80898,1,3,0,3,3,1
389451,1,3,0,3,3,1
164171,2,17,7,10,5,0
380970,4,9,14,-5,16,0
399686,4,19,9,10,8,1
88796,3,13,10,3,6,0
130031,2,10,20,-10,8,0
348138,4,24,22,2,1,0
147043,4,34,0,34,15,1
220137,3,26,13,13,13,1
309106,2,9,3,6,1,0
202001,4,10,7,3,5,1
355145,3,26,16,10,4,1
164241,4,41,38,3,5,0
96864,2,10,0,10,10,0
265899,2,0,9,-9,16,1
79226,4,23,13,10,2,1
68801,2,6,7,-1,15,1
165022,2,7,10,-3,6,1
332448,2,16,3,13,12,1
133160,2,10,17,-7,9,0
259693,1,3,0,3,14,0
273637,3,13,6,7,2,0
68794,2,6,0,6,15,0
385027,4,24,16,8,1,1
377448,4,7,13,-6,15,1
267226,2,10,7,3,17,0
371531,1,0,0,0,12,0
129051,1,14,14,0,7,0
225221,3,3,7,-4,15,1
397174,3,6,0,6,6,0
237125,4,8,33,-25,3,1
105335,1,7,7,0,14,0
347454,2,6,13,-7,1,1
355949,1,0,0,0,5,0
190518,2,10,6,4,17,0
33582,4,17,10,7,16,0
408432,2,0,0,0,12,1
245552,2,34,0,34,7,0
333641,2,0,0,0,12,0
74917,1,7,0,7,17,1
195841,4,27,21,6,2,1
150738,2,13,9,4,17,0
370898,3,13,10,3,12,0
134169,2,0,10,-10,10,1
324431,3,14,6,8,8,0
194917,3,7,10,-3,2,1
205256,4,23,19,4,6,0
335323,3,3,16,-13,13,0
150777,4,13,9,4,17,1
142672,4,20,20,0,13,1
147297,3,0,31,-31,15,1
11624,1,14,0,14,6,0
280626,4,23,9,14,5,0
162015,2,14,3,11,4,0
83411,3,10,20,-10,4,1
209843,2,10,13,-3,8,1
216271,1,0,0,0,12,1
221682,1,3,0,3,14,1
308279,4,13,16,-3,1,0
235043,1,0,0,0,2,0
320669,1,13,10,3,6,1
267161,4,10,10,0,17,1
169305,1,0,0,0,8,0
301712,1,0,3,-3,15,0
408253,1,0,0,0,12,0
319495,3,3,10,-7,6,0
220557,3,10,20,-10,13,0
2367,2,7,3,4,2,0
209070,2,3,10,-7,8,0
143933,2,0,3,-3,14,1
252057,4,14,23,-9,10,0
353219,1,7,7,0,4,0
244163,1,0,7,-7,6,1
371195,3,11,19,-8,12,1
41052,3,3,13,-10,2,1
269346,2,7,7,0,1,0
120225,2,7,0,7,3,0
42133,5,27,27,0,2,0
164322,2,13,0,13,5,1
86354,1,0,0,0,5,0
20878,4,28,16,12,10,0
278460,2,22,0,22,4,0
183981,3,22,3,19,14,0
278209,3,24,21,3,4,1
326466,2,17,3,14,9,0
96763,3,7,10,-3,10,1
280697,2,0,3,-3,5,0
333242,3,6,14,-8,12,0
369177,4,19,20,-1,11,1
299999,2,0,20,-20,14,1
9247,4,10,37,-27,5,1
173586,2,0,10,-10,10,0
204890,3,3,13,-10,6,1
80847,4,3,3,0,3,1
399853,1,0,0,0,8,1
4482,2,14,12,2,2,0
258994,3,3,16,-13,13,1
1064,2,7,22,-15,1,0
4223,2,10,6,4,2,1
385797,3,27,3,24,1,0
295032,4,31,24,7,12,0
53406,3,3,14,-11,8,0
162525,3,35,10,25,4,0
365651,4,45,35,10,9,1
187558,3,13,16,-3,16,1
360387,1,0,0,0,7,0
187822,2,7,10,-3,16,0
329849,4,24,23,1,11,0
322927,2,13,0,13,7,0
20216,4,24,10,14,10,0
405657,4,24,28,-4,10,0
385679,5,27,24,3,1,0
268336,3,20,3,17,17,0
21463,4,12,14,-2,11,1
293993,4,7,28,-21,12,1
156065,4,20,24,-4,2,0
223634,1,6,3,3,15,1
191852,3,17,10,7,1,1
253357,1,7,7,0,11,1
333143,1,0,0,0,12,0
133169,2,10,17,-7,9,1
325800,3,6,10,-4,9,0
220905,1,0,0,0,14,0
99369,4,23,10,13,11,1
109462,4,9,13,-4,16,0
74903,4,23,20,3,17,1
385045,4,24,24,0,1,1
330102,3,0,13,-13,11,1
235940,4,23,21,2,3,0
7685,1,3,0,3,4,0
375707,1,0,0,0,14,1
70985,1,3,0,3,16,0
407062,1,0,3,-3,11,0
313227,4,26,16,10,3,0
245660,1,3,0,3,7,0
185458,4,17,13,4,15,0
299517,1,0,0,0,14,0
292006,2,6,3,3,11,0
90425,2,0,13,-13,7,0
175276,3,15,10,5,10,0
418848,2,0,10,-10,16,1
96950,4,22,10,12,10,0
133155,2,10,17,-7,9,1
91049,3,9,0,9,7,0
415281,2,0,7,-7,15,0
4761,2,13,0,13,3,1
310662,4,13,33,-20,2,0
317871,4,15,10,5,5,1
110596,2,17,7,10,16,1
286574,3,10,31,-21,8,1
43132,4,13,27,-14,3,1
117031,2,0,17,-17,2,1
274469,4,10,17,-7,3,1
208150,2,0,0,0,8,1
19673,1,0,0,0,10,1
155276,4,28,21,7,1,0
420888,1,0,0,0,17,1
134399,1,0,0,0,10,1
309725,3,19,6,13,1,1
376702,3,3,0,3,14,0
162949,2,6,0,6,5,0
25377,2,6,0,6,12,0
188397,2,3,3,0,16,0
310624,3,13,30,-17,2,1
145519,4,26,17,9,14,0
335748,3,10,7,3,13,1
300225,4,37,10,27,14,1
22880,2,0,13,-13,11,0
203037,3,20,3,17,5,0
224598,2,6,7,-1,15,1
154988,1,0,0,0,1,0
51624,3,21,13,8,7,0
384806,1,6,3,3,1,1
245397,2,9,3,6,7,1
250315,2,7,7,0,9,0
81131,3,13,14,-1,3,1
239032,4,35,18,17,4,1
361011,1,3,2,1,7,1
179499,1,0,13,-13,12,1
168997,2,10,14,-4,7,1
201970,3,3,0,3,5,1
102049,3,21,3,18,12,0
236344,3,7,23,-16,3,1
122350,4,13,19,-6,4,1
114269,4,10,24,-14,1,1
415896,3,10,20,-10,15,1
14982,1,0,0,0,7,0
116227,1,3,0,3,1,0
115639,1,0,0,0,1,1
178642,2,3,10,-7,12,1
28045,2,7,7,0,13,1
334686,2,15,3,12,13,1
317393,3,7,10,-3,5,1
316456,3,16,17,-1,4,1
35461,2,7,7,0,17,0
167318,2,16,10,6,7,0
208000,2,14,0,14,8,1
82999,4,20,19,1,4,0
254298,3,6,16,-10,11,0
202078,1,6,0,6,5,1
233473,4,23,10,13,2,1
156469,2,0,3,-3,2,0
280292,3,16,16,0,5,1
341238,3,16,10,6,16,1
166992,1,0,7,-7,7,0
384619,4,10,52,-42,1,0
381572,4,35,16,19,17,0
94695,4,24,36,-12,9,1
60233,3,10,13,-3,11,1
117794,2,6,6,0,2,1
195284,4,23,24,-1,2,0
240326,3,7,23,-16,5,1
165101,4,10,24,-14,6,0
397034,3,21,9,12,6,1
4282,4,27,6,21,2,1
277434,4,34,17,17,4,0
285063,2,0,0,0,7,1
266578,1,0,0,0,16,0
338975,2,13,0,13,15,1
412820,3,21,27,-6,14,1
352732,4,24,6,18,3,0
301922,3,11,13,-2,15,1
228505,3,20,7,13,17,0
4710,1,0,0,0,3,0
385405,2,14,7,7,1,1
116952,4,28,13,15,2,1
48265,2,10,10,0,5,0
136709,2,6,10,-4,11,1
79920,3,10,16,-6,2,0
365997,2,23,7,16,10,0
88236,4,31,17,14,6,0
383799,2,3,7,-4,1,0
26787,4,13,33,-20,13,0
183412,3,24,3,21,14,0
67000,1,0,0,0,14,0
130508,3,10,3,7,8,0
174500,2,7,7,0,10,0
338139,4,12,7,5,14,0
331911,4,0,16,-16,12,1
118127,3,16,20,-4,2,0
21476,4,15,14,1,11,0
307891,1,0,0,0,1,1
187685,2,7,6,1,16,1
367008,3,3,31,-28,10,0
86229,1,0,10,-10,5,1
413417,2,3,31,-28,14,1
388343,3,17,12,5,2,1
170366,1,7,0,7,8,1
33508,2,14,0,14,16,1
340472,2,0,13,-13,15,0
221874,2,6,7,-1,14,1
331085,1,0,0,0,11,0
216695,3,24,6,18,12,1
323427,4,23,0,23,7,0
89625,1,3,0,3,7,1
58372,2,21,0,21,10,1
348092,3,0,19,-19,1,1
3688,1,0,0,0,2,1
73214,3,7,6,1,16,0
168406,2,0,3,-3,7,1
238317,1,3,9,-6,4,1
220707,3,10,6,4,13,1
353841,2,7,14,-7,4,1
60072,2,7,3,4,11,0
34117,2,3,0,3,16,0
347955,3,0,21,-21,1,0
164939,3,0,9,-9,6,1
60201,2,3,7,-4,11,0
162999,3,9,3,6,5,0
88701,4,26,20,6,6,1
14136,2,0,14,-14,7,1
275736,2,7,0,7,3,1
314067,3,16,14,2,3,1
294715,4,6,14,-8,12,1
184049,1,0,0,0,14,1
19592,3,14,21,-7,10,1
278432,1,15,0,15,4,0
189601,2,6,3,3,17,1
384957,2,7,0,7,1,0
224376,4,19,12,7,15,0
24304,4,13,17,-4,12,1
333325,1,10,7,3,12,0
212923,2,7,7,0,10,1
251280,4,13,27,-14,10,1
407805,4,17,7,10,11,1
273264,1,7,0,7,2,1
356668,2,16,10,6,5,1
124581,3,6,14,-8,5,0
34209,1,7,0,7,16,1
35647,3,20,3,17,17,1
370167,3,17,3,14,12,1
184499,2,14,13,1,14,0
341346,2,0,10,-10,16,0
65429,2,0,14,-14,13,1
413531,2,0,10,-10,14,1
227800,4,6,21,-15,16,1
337103,4,26,15,11,14,1
207817,1,0,0,0,8,0
206930,4,17,23,-6,7,1
338151,1,7,0,7,14,0
403454,2,17,9,8,9,0
159072,2,17,0,17,3,1
127461,2,3,10,-7,6,1
9963,4,3,3,0,5,1
265887,2,0,9,-9,16,1
185731,2,20,3,17,15,0
417354,2,10,3,7,16,0
299876,2,13,8,5,14,0
142226,5,11,13,-2,13,1
72235,4,24,17,7,16,0
19396,1,6,7,-1,10,1
398867,1,3,0,3,7,0
283262,2,10,9,1,7,0
227353,4,20,37,-17,16,0
208081,4,21,19,2,8,1
174864,4,19,17,2,10,0
357572,3,13,13,0,5,1
336612,4,7,0,7,14,0
146912,4,41,0,41,15,0
57505,3,21,10,11,10,1
219532,3,9,21,-12,13,1
106643,4,46,7,39,14,0
27419,1,0,0,0,13,1
190685,3,28,14,14,17,0
210574,2,6,13,-7,9,0
358695,2,7,7,0,6,0
417502,3,24,21,3,16,0
383819,2,3,7,-4,1,1
266855,4,17,17,0,16,1
96603,2,3,3,0,10,0
66313,2,0,14,-14,14,1
315025,2,21,0,21,4,0
170748,3,24,6,18,8,1
67888,2,13,3,10,14,1
268115,2,3,7,-4,17,1
66131,1,0,0,0,13,1
181636,4,23,6,17,13,1
224372,4,19,12,7,15,0
215841,4,51,20,31,11,1
342318,4,20,6,14,16,0
196375,2,10,0,10,2,0
408326,2,3,7,-4,12,1
373581,4,23,33,-10,13,0
106384,1,0,0,0,14,1
177210,1,7,0,7,11,0
77401,3,14,21,-7,1,1
108679,2,27,10,17,15,0
3982,4,32,20,12,2,1
131488,1,0,3,-3,8,0
75279,3,7,16,-9,17,1
205222,4,20,13,7,6,1
356593,5,9,9,0,5,0
130283,1,0,0,0,8,0
393400,2,21,17,4,5,0
249169,1,2,0,2,9,0
375049,4,28,27,1,14,1
284924,2,7,14,-7,7,0
343272,4,22,0,22,16,0
97092,3,31,6,25,10,1
206447,3,17,0,17,7,1
185155,4,0,23,-23,15,1
297358,2,6,10,-4,13,1
257881,4,16,12,4,13,0
378893,3,13,20,-7,15,1
224657,3,16,10,6,15,0
74185,1,3,0,3,17,0
43828,3,14,16,-2,3,1
370306,3,7,35,-28,12,0
150020,3,14,6,8,16,1
83992,2,17,3,14,4,1
396227,1,0,3,-3,6,0
228000,1,0,0,0,17,1
99556,1,0,0,0,11,1
192463,2,0,17,-17,1,1
398686,4,0,9,-9,7,1
18340,4,22,17,5,9,1
67764,3,21,0,21,14,0
335668,1,7,0,7,13,1
9081,4,28,13,15,4,0
128718,4,13,30,-17,7,1
46649,3,10,0,10,4,0
392733,1,0,0,0,4,0
377305,4,21,14,7,15,0
108347,2,0,7,-7,15,0
1398,3,10,0,10,1,0
139978,3,25,3,22,12,1
185162,4,0,23,-23,15,0
306336,3,24,10,14,17,1
133201,3,13,17,-4,9,1
406470,1,0,6,-6,11,1
367739,4,13,13,0,10,0
74332,1,0,3,-3,17,1
173205,3,20,24,-4,9,1
296997,4,32,14,18,13,0
51001,2,0,7,-7,6,0
268806,4,31,10,21,17,1
409974,3,6,28,-22,12,0
374543,2,17,6,11,14,0
80900,1,6,0,6,3,1
318901,4,21,22,-1,5,1
172953,1,6,0,6,9,1
222905,2,7,3,4,14,0
147961,1,0,0,0,15,1
103276,4,3,10,-7,13,1
253791,4,24,17,7,11,1
289200,3,20,10,10,9,0
151620,2,16,13,3,17,1
177228,2,7,7,0,11,0
140615,3,31,10,21,12,0
419356,4,3,23,-20,16,1
177943,1,6,0,6,12,1
335425,2,13,6,7,13,0
190709,4,42,17,25,17,0
214093,2,3,3,0,11,1
343114,4,12,20,-8,16,0
24878,4,13,6,7,12,0
333842,3,20,21,-1,12,1
214979,1,3,0,3,11,0
211684,3,23,9,14,9,1
88136,1,0,3,-3,6,1
53836,1,0,0,0,8,0
62724,2,7,0,7,12,1
362412,4,30,20,10,8,1
93134,2,0,0,0,9,1
333870,4,28,21,7,12,0
148486,3,21,3,18,16,1
262721,2,21,0,21,15,0
49540,3,7,3,4,6,1
48736,3,10,19,-9,5,1
340780,2,17,10,7,15,0
339736,3,21,6,15,15,1
339541,2,7,7,0,15,1
268606,3,7,6,1,17,0
199257,3,17,24,-7,4,0
172882,3,24,17,7,9,0
136408,2,3,7,-4,11,1
322939,3,13,0,13,7,0
295857,2,7,14,-7,12,0
338710,4,27,10,17,14,0
91481,2,18,0,18,8,1
301378,4,17,10,7,15,1
131342,1,7,3,4,8,1
232500,2,20,3,17,1,0
223850,3,9,3,6,15,0
398993,1,0,2,-2,7,0
257226,3,19,16,3,12,0
253805,1,0,0,0,11,0
366358,1,6,0,6,10,0
23846,4,24,7,17,12,0
165105,4,10,24,-14,6,1
177174,4,40,20,20,11,1
163927,3,23,10,13,5,0
126851,3,10,6,4,6,1
384323,3,16,3,13,1,1
240698,1,0,0,0,5,1
172596,4,17,24,-7,9,0
337660,3,24,13,11,14,0
146805,2,10,0,10,15,0
292333,3,12,13,-1,11,0
358359,1,6,7,-1,6,1
22210,4,10,15,-5,11,0
300938,4,17,27,-10,15,0
177035,1,0,0,0,11,0
170417,2,14,3,11,8,1
282122,3,22,8,14,6,1
229609,4,33,13,20,17,0
346943,1,0,3,-3,1,1
287020,2,13,20,-7,8,0
42450,1,0,3,-3,3,1
174847,3,16,17,-1,10,0
286296,3,16,16,0,8,1
280782,4,14,14,0,5,0
132202,1,0,0,0,9,0
189159,2,21,0,21,16,1
7764,3,30,3,27,4,0
96529,4,17,24,-7,10,0
166832,1,0,3,-3,6,0
196500,1,7,3,4,2,1
163693,1,0,6,-6,5,0
93917,4,24,6,18,9,0
235810,1,0,7,-7,3,1
321456,3,21,20,1,7,0
84473,3,13,10,3,4,1
336618,4,7,0,7,14,0
78149,3,20,3,17,2,0
34490,4,48,3,45,16,0
407524,1,3,0,3,11,1
94230,4,24,24,0,9,0
248458,3,10,6,4,8,0
410359,1,0,0,0,13,0
228292,1,0,0,0,17,0
363772,1,0,7,-7,8,1
200137,2,7,24,-17,4,1
49838,3,21,10,11,6,1
60658,2,7,3,4,11,1
395163,1,3,7,-4,5,1
193919,4,31,17,14,1,0
131224,2,14,17,-3,8,1
66240,4,38,3,35,13,1
204247,2,0,7,-7,6,1
47947,2,0,21,-21,5,1
331325,3,0,27,-27,11,1
225943,3,27,7,20,16,1
2406,3,21,13,8,2,1
132590,3,12,32,-20,9,0
354372,3,45,3,42,4,0
23061,3,10,17,-7,11,1
245478,4,23,6,17,7,1
26601,3,10,6,4,13,1
368550,2,9,0,9,11,1
203667,3,14,20,-6,6,0
397003,2,14,3,11,6,1
215863,1,0,0,0,11,0
388702,1,0,0,0,3,1
182437,1,7,0,7,14,1
51393,1,0,0,0,7,0
307656,3,14,17,-3,17,0
90606,3,17,19,-2,7,0
273900,2,0,3,-3,2,1
142984,4,10,13,-3,13,0
278713,1,0,0,0,5,0
379005,2,7,3,4,15,0
420462,2,0,21,-21,17,0
67308,2,14,3,11,14,0
118703,3,17,6,11,2,0
169972,2,20,10,10,8,1
351148,1,7,0,7,3,0
194059,4,27,7,20,1,0
229486,1,0,0,0,17,0
119560,2,7,0,7,3,1
102869,1,0,0,0,13,0
251836,2,7,10,-3,10,1
104781,3,20,25,-5,14,0
396067,1,10,3,7,6,1
150809,4,20,9,11,17,1
108760,1,0,0,0,15,0
13777,3,7,27,-20,7,1
249307,1,3,0,3,9,1
150179,3,6,26,-20,16,1
327894,4,30,24,6,10,0
181228,2,0,0,0,13,0
137172,1,0,0,0,11,0
360272,2,0,6,-6,7,1
190853,4,24,10,14,17,0
622,1,0,0,0,1,0
157346,1,0,0,0,2,1
101483,1,7,0,7,12,0
208601,2,6,3,3,8,1
297780,1,7,0,7,13,0
131863,3,24,7,17,8,0
50089,2,0,14,-14,6,1
226033,5,34,34,0,16,0
381152,4,31,28,3,16,0
41884,2,7,3,4,2,1
206285,3,10,6,4,7,1
120269,3,17,6,11,3,1
103407,4,10,20,-10,13,0
241452,4,10,42,-32,5,1
200824,1,0,0,0,4,1
111858,4,13,10,3,17,0
189671,4,17,6,11,17,1
372849,1,0,0,0,13,1
173889,2,6,10,-4,10,1
216239,4,17,17,0,12,0
369785,4,45,50,-5,11,1
406595,4,20,37,-17,11,1
381675,3,17,7,10,17,0
103177,2,0,0,0,13,0
28542,3,24,7,17,14,1
230299,3,19,10,9,17,0
335411,2,7,3,4,13,0
14790,3,38,3,35,7,1
294728,4,13,20,-7,12,0
213416,3,10,41,-31,10,1
183858,4,37,28,9,14,0
153717,2,2,21,-19,1,1
373533,3,7,19,-12,13,1
191657,2,0,3,-3,17,0
296378,4,13,28,-15,13,0
263115,1,0,7,-7,15,0
113638,4,9,13,-4,17,1
154560,2,7,7,0,1,1
115871,3,7,16,-9,1,1
358764,4,14,17,-3,6,0
361175,1,0,7,-7,7,1
135514,2,7,6,1,10,1
394216,4,33,17,16,5,0
38793,2,3,10,-7,1,0
403199,3,17,17,0,9,0
46984,1,0,0,0,5,1
78312,3,17,21,-4,2,0
320090,2,10,0,10,6,1
79000,2,3,7,-4,2,1
15678,4,37,10,27,8,0
330006,4,7,13,-6,11,0
40590,2,23,7,16,2,1
95774,1,3,0,3,10,1
88852,4,13,16,-3,6,0
220127,3,26,13,13,13,1
290083,3,10,9,1,10,1
80851,4,6,3,3,3,0
118785,1,10,0,10,2,0
33704,3,28,0,28,16,1
349204,4,27,14,13,2,0
319907,1,13,7,6,6,0
144372,2,0,3,-3,14,0
284643,3,14,20,-6,7,1
261897,4,6,27,-21,14,0
90476,3,0,20,-20,7,0
140541,1,0,0,0,12,1
160675,3,10,0,10,4,0
292059,4,15,19,-4,11,0
44885,3,7,23,-16,4,0
184668,3,10,24,-14,15,0
279899,4,24,13,11,5,1
179875,2,16,9,7,13,1
408208,3,13,3,10,12,0
154175,3,7,13,-6,1,1
185539,2,10,3,7,15,0
37211,2,3,14,-11,17,1
288161,4,19,14,5,9,0
373653,2,0,9,-9,13,0
22510,4,31,37,-6,11,1
147386,2,7,7,0,15,1
117442,1,7,7,0,2,1
262252,2,3,6,-3,15,1
330179,1,0,0,0,11,0
310622,3,13,30,-17,2,1
7857,1,3,7,-4,4,1
125364,4,38,3,35,5,0
255145,1,0,0,0,12,1
294595,1,0,0,0,12,1
100450,1,0,7,-7,12,0
115647,1,0,3,-3,1,1
365627,4,35,27,8,9,0
230365,1,0,0,0,1,1
237867,3,7,27,-20,4,0
210807,4,24,10,14,9,0
246614,2,14,3,11,8,0
9062,3,28,13,15,4,0
378633,4,23,23,0,15,1
386459,1,0,0,0,2,0
358090,1,14,0,14,6,0
72273,4,27,33,-6,16,1
380130,5,38,38,0,16,0
393610,4,7,26,-19,5,0
223248,3,3,6,-3,15,1
316121,3,24,16,8,4,1
207820,1,0,0,0,8,0
72533,3,16,24,-8,16,1
222266,4,13,27,-14,14,1
33297,4,23,3,20,16,1
51513,4,34,30,4,7,0
352081,2,3,10,-7,3,0
142214,5,11,13,-2,13,1
319291,2,10,3,7,6,0
234473,2,17,13,4,2,0
310594,2,10,20,-10,2,1
52787,1,0,23,-23,7,0
32166,1,7,0,7,15,1
155999,2,10,14,-4,2,1
138828,3,3,33,-30,12,1
51195,3,24,6,18,7,0
135583,4,28,6,22,10,0
354415,1,0,0,0,4,1
379414,1,0,0,0,16,0
337763,2,20,6,14,14,0
376852,3,21,14,7,15,1
263038,3,10,3,7,15,1
194027,3,14,7,7,1,1
132535,2,2,26,-24,9,0
37689,4,30,0,30,17,1
205781,1,7,0,7,7,1
334810,1,7,0,7,13,1
128900,1,2,3,-1,7,1
311268,4,6,3,3,2,1
162439,1,0,0,0,4,1
306758,3,16,20,-4,17,0
268743,2,16,3,13,17,1
54647,3,14,22,-8,8,0
2403,2,21,13,8,2,0
359885,2,20,21,-1,6,0
149580,4,14,23,-9,16,0
281548,4,20,16,4,6,0
366442,3,26,10,16,10,1
48698,2,7,16,-9,5,0
111758,1,3,0,3,17,1
328368,4,3,37,-34,10,0
357918,1,0,0,0,6,0
301186,2,13,14,-1,15,1
375984,4,20,15,5,14,1
207082,4,38,10,28,7,1
413899,4,17,9,8,14,1
26937,4,13,6,7,13,1
298852,3,21,9,12,14,1
168204,4,29,15,14,7,0
231659,4,17,13,4,1,0
268699,1,0,0,0,17,0
45974,4,20,3,17,4,0
130800,2,13,6,7,8,0
254416,2,13,0,13,11,1
216367,3,14,16,-2,12,1
210715,2,14,0,14,9,0
188237,2,7,7,0,16,0
103718,4,3,17,-14,13,0
234344,3,17,0,17,2,0
87269,3,17,17,0,6,0
417946,1,7,14,-7,16,1
226039,1,0,0,0,16,1
59893,1,3,0,3,11,0
163894,2,16,10,6,5,0
347567,1,0,0,0,1,0
161345,5,20,19,1,4,0
389975,3,28,25,3,3,1
351146,1,7,0,7,3,0
280717,3,0,6,-6,5,1
281002,2,14,13,1,6,1
103122,4,34,7,27,13,1
40674,1,0,0,0,2,1
297008,1,0,0,0,13,1
199377,2,7,10,-3,4,0
86279,3,13,20,-7,5,0
341388,3,0,10,-10,16,0
128133,4,13,6,7,7,0
122924,4,37,6,31,4,0
322364,3,14,13,1,7,1
133762,2,13,7,6,9,0
33641,2,13,0,13,16,1
354947,2,7,3,4,4,0
353872,2,10,21,-11,4,1
1447,4,19,7,12,1,1
172205,2,6,6,0,9,1
264820,4,17,37,-20,16,1
80563,4,16,10,6,3,0
244917,1,0,0,0,7,0
120328,4,24,13,11,3,1
254783,3,17,10,7,11,0
51230,4,32,25,7,7,1
149047,1,0,7,-7,16,0
148326,3,14,3,11,16,1
191733,3,16,17,-1,17,0
297200,2,0,0,0,13,1
229367,1,3,0,3,17,0
228513,3,20,7,13,17,0
336212,4,24,10,14,13,0
411079,4,17,17,0,13,0
196366,2,10,0,10,2,1
403808,4,18,30,-12,9,1
53529,2,7,6,1,8,0
219497,2,3,21,-18,13,1
262057,4,24,31,-7,14,0
381522,2,14,7,7,17,1
82687,4,12,13,-1,3,1
397285,2,0,20,-20,6,0
165063,3,10,17,-7,6,0
253291,4,10,13,-3,11,0
213491,2,0,7,-7,10,1
386050,2,14,0,14,1,0
189612,2,7,3,4,17,1
381232,3,14,10,4,16,1
384020,3,10,23,-13,1,1
160957,2,10,7,3,4,0
291650,4,23,20,3,11,1
266013,1,6,0,6,16,1
336616,4,7,0,7,14,0
309916,1,0,0,0,2,0
2870,4,31,31,0,2,0
74459,1,0,0,0,17,1
367647,1,0,0,0,10,0
43632,2,7,3,4,3,0
34380,1,7,0,7,16,1
383279,3,38,17,21,17,1
113283,2,13,21,-8,17,0
328610,2,17,27,-10,10,0
338920,1,3,0,3,15,1
309778,1,0,0,0,1,1
303412,2,10,0,10,16,0
122289,3,6,19,-13,4,0
129078,2,17,21,-4,7,1
386696,4,17,13,4,2,0
386912,2,7,13,-6,2,0
164335,2,20,0,20,5,0
301681,4,17,6,11,15,0
5308,1,0,0,0,3,1
190607,1,6,0,6,17,1
158350,3,13,17,-4,3,1
385433,3,21,7,14,1,0
266566,4,10,22,-12,16,1
306407,1,0,10,-10,17,0
147184,4,17,49,-32,15,1
65145,2,0,0,0,13,1
126346,2,7,14,-7,6,0
33387,2,13,10,3,16,1
406451,1,0,0,0,11,0
83525,2,0,7,-7,4,1
200698,1,7,0,7,4,0
234999,3,16,17,-1,2,0
320907,4,3,14,-11,6,1
326268,4,17,48,-31,9,0
36647,2,13,3,10,17,0
75436,3,17,7,10,17,0
71156,2,19,9,10,16,0
198600,2,0,0,0,3,1
177842,2,14,16,-2,12,1
159383,2,7,10,-3,3,0
293431,4,29,24,5,11,1
140178,4,13,3,10,12,0
80923,2,6,0,6,3,0
354106,4,19,0,19,4,1
296296,2,3,10,-7,13,0
420137,2,0,3,-3,17,1
224364,4,16,12,4,15,1
354595,1,0,7,-7,4,1
285893,1,13,0,13,8,0
180166,3,10,0,10,13,1
224987,4,10,22,-12,15,1
244098,4,20,34,-14,6,0
98363,1,0,0,0,11,0
38702,4,17,14,3,1,0
164418,1,6,0,6,5,1
94722,4,38,43,-5,9,0
180220,4,19,14,5,13,1
27512,3,23,9,14,13,1
340897,2,0,10,-10,15,1
4280,4,27,6,21,2,1
280440,3,16,24,-8,5,1
317235,3,7,16,-9,5,1
147459,4,23,10,13,15,0
169552,4,10,35,-25,8,1
18093,2,3,14,-11,9,1
213264,4,17,24,-7,10,1
397818,1,0,0,0,7,1
276547,4,22,7,15,4,0
40809,4,17,35,-18,2,1
10102,4,41,7,34,5,1
222642,2,7,7,0,14,0
116346,4,40,13,27,1,1
396282,3,3,6,-3,6,1
335618,4,19,10,9,13,1
125073,4,3,39,-36,5,1
184418,4,24,6,18,14,0
238221,3,3,16,-13,4,1
172598,4,17,24,-7,9,0
212470,3,10,3,7,10,1
45709,1,0,0,0,4,1
394365,4,31,17,14,5,0
32604,4,27,13,14,15,1
76449,1,0,7,-7,1,0
164810,4,26,21,5,6,1
365335,4,17,19,-2,9,1
283764,3,11,3,8,7,1
247783,4,10,6,4,8,0
293267,4,26,7,19,11,0
96247,4,3,29,-26,10,1
419593,2,20,10,10,17,1
204004,4,16,7,9,6,1
352437,3,35,24,11,3,1
46045,2,14,14,0,4,1
346935,1,0,3,-3,1,0
287288,1,3,0,3,8,0
149027,1,0,0,0,16,0
178809,3,24,14,10,12,0
36075,3,31,0,31,17,0
134321,2,16,14,2,10,0
2781,1,7,0,7,2,0
291024,4,20,13,7,10,1
318004,3,10,13,-3,5,1
335165,3,20,7,13,13,1
26844,1,10,0,10,13,0
100335,2,9,17,-8,12,0
165961,2,10,7,3,6,0
69203,4,20,17,3,15,0
388447,2,0,13,-13,2,1
82183,3,13,3,10,3,1
330514,2,7,7,0,11,0
165846,3,6,16,-10,6,0
127553,1,0,0,0,6,0
194124,1,0,0,0,1,0
115735,3,13,13,0,1,0
304149,1,0,0,0,16,0
242614,3,10,0,10,6,0
58909,3,13,25,-12,10,0
340092,4,20,15,5,15,1
275471,3,20,17,3,3,0
291819,1,0,0,0,11,1
242696,1,0,0,0,6,1
261655,2,0,0,0,14,1
362336,2,10,7,3,8,0
336667,1,0,0,0,14,0
234525,4,20,20,0,2,0
74883,4,20,20,0,17,1
215893,2,3,7,-4,11,0
130100,4,17,36,-19,8,0
202226,1,3,0,3,5,1
138434,2,7,6,1,12,0
291513,1,0,0,0,11,1
279336,1,0,0,0,5,1
119145,3,10,7,3,3,0
73333,2,13,0,13,17,0
397036,3,21,9,12,6,1
384384,1,14,0,14,1,0
141286,1,0,0,0,13,0
327074,1,0,0,0,9,1
292984,1,0,0,0,11,1
201063,4,41,7,34,5,1
321901,3,14,21,-7,7,1
312838,3,7,0,7,3,0
390460,4,21,33,-12,3,1
355148,3,26,16,10,4,1
183909,1,7,3,4,14,1
18663,1,0,0,0,9,0
273424,1,0,0,0,2,0
209670,2,6,0,6,8,0
325622,2,10,7,3,9,1
418286,2,6,7,-1,16,1
30398,1,0,13,-13,14,1
170700,2,14,6,8,8,1
196235,2,14,10,4,2,1
375203,4,17,17,0,14,0
32327,1,7,0,7,15,0
339594,3,17,14,3,15,1
361468,1,7,0,7,7,0
285447,3,33,8,25,8,0
280012,3,3,20,-17,5,1
331370,4,8,33,-25,11,1
68763,1,3,0,3,15,1
13235,1,0,0,0,7,1
240501,3,3,7,-4,5,1
414241,2,14,21,-7,14,1
411394,4,20,13,7,13,0
76829,4,33,0,33,1,0
226251,2,6,0,6,16,0
327686,2,3,10,-7,10,0
9363,4,28,7,21,5,1
234378,4,17,10,7,2,0
134226,3,3,23,-20,10,0
255341,2,14,0,14,12,0
284906,2,0,13,-13,7,0
66179,2,17,3,14,13,1
36741,1,0,7,-7,17,1
311623,2,6,0,6,2,0
106413,2,13,0,13,14,0
257068,3,7,14,-7,12,0
316338,4,24,26,-2,4,0
409856,3,23,0,23,12,0
264041,1,7,7,0,15,1
133684,4,24,35,-11,9,1
96261,1,0,6,-6,10,0
170428,2,21,3,18,8,0
153082,2,0,10,-10,1,1
169143,1,0,0,0,7,1
207419,2,7,6,1,7,0
53522,2,7,6,1,8,0
251840,2,7,10,-3,10,1
46062,3,14,14,0,4,1
183259,3,10,20,-10,14,0
417171,2,3,10,-7,16,0
189990,4,16,7,9,17,0
254644,4,28,21,7,11,0
163820,4,17,22,-5,5,1
44361,1,0,0,0,3,0
75905,3,29,7,22,1,0
142639,3,13,13,0,13,0
269263,4,3,19,-16,17,1
19278,2,7,14,-7,10,0
26436,3,17,16,1,13,1
19568,2,7,14,-7,10,1
297656,2,7,3,4,13,1
193595,4,0,17,-17,1,1
286016,1,0,0,0,8,1
238485,2,6,0,6,4,1
275541,4,32,36,-4,3,1
11072,2,10,7,3,5,0
404447,2,14,7,7,10,1
30328,3,3,10,-7,14,1
405282,3,14,7,7,10,1
132315,4,31,17,14,9,1
73613,2,0,0,0,17,1
63348,3,17,3,14,12,1
306889,2,3,13,-10,17,1
121934,1,3,7,-4,4,0
149615,4,17,26,-9,16,0
304805,2,0,0,0,16,0
286698,2,10,7,3,8,0
325201,4,13,23,-10,8,1
285740,2,0,3,-3,8,0
64273,1,0,3,-3,13,1
9396,1,0,0,0,5,0
163622,3,21,19,2,5,0
46696,1,0,0,0,4,1
9778,3,2,10,-8,5,0
390361,2,7,7,0,3,0
123554,4,16,16,0,4,0
1244,3,10,6,4,1,1
82343,3,12,10,2,3,1
206987,2,21,0,21,7,0
13978,1,0,0,0,7,0
383163,4,26,24,2,17,1
23199,3,23,13,10,11,1
46760,3,7,13,-6,4,1
351432,4,20,16,4,3,0
250373,4,21,20,1,9,0
192029,4,24,20,4,1,0
207925,4,35,14,21,8,0
397851,2,0,0,0,7,1
283037,4,28,3,25,6,0
419788,4,17,20,-3,17,1
229772,4,20,17,3,17,1
63178,3,14,20,-6,12,0
2218,2,7,0,7,1,0
56571,3,16,17,-1,9,1
302971,3,20,13,7,16,0
271198,4,21,20,1,1,0
95205,1,0,0,0,10,1
120181,4,22,6,16,3,1
410467,4,9,20,-11,13,1
98292,3,21,27,-6,11,0
11155,4,30,27,3,5,1
45998,1,0,7,-7,4,1
6358,2,0,10,-10,3,0
145270,1,14,6,8,14,1
39548,2,0,3,-3,1,0
52822,2,0,37,-37,7,1
7223,2,0,13,-13,4,1
248440,2,10,6,4,8,1
332035,3,3,3,0,12,1
52916,1,0,0,0,7,1
354521,4,33,28,5,4,0
170091,2,7,0,7,8,1
58622,4,13,17,-4,10,1
21871,3,21,0,21,11,1
146618,1,0,7,-7,15,1
183993,4,22,10,12,14,1
170941,4,31,20,11,8,1
261643,1,0,0,0,14,1
371873,2,21,10,11,12,0
268245,1,0,0,0,17,1
78443,3,17,0,17,2,1
269809,2,13,7,6,1,0
72396,4,17,23,-6,16,1
101699,2,10,0,10,12,0
368248,2,3,3,0,11,1
347166,3,23,17,6,1,1
255641,2,3,7,-4,12,1
179955,1,0,6,-6,13,0
98940,4,7,17,-10,11,1
406706,4,27,0,27,11,0
394807,4,24,6,18,5,0
176130,1,14,7,7,11,0
23304,2,3,10,-7,11,1
173915,2,13,16,-3,10,1
265205,2,6,6,0,16,1
323385,3,17,0,17,7,1
239014,4,29,15,14,4,0
149665,2,17,0,17,16,0
368646,1,0,3,-3,11,1
119738,2,10,3,7,3,0
377552,2,10,9,1,15,1
14545,4,34,45,-11,7,1
56410,2,0,28,-28,9,1
208362,3,17,27,-10,8,1
325359,4,15,20,-5,8,0
139889,4,23,24,-1,12,0
83728,3,22,20,2,4,0
109193,1,0,0,0,15,0
277885,3,7,17,-10,4,0
190905,1,6,0,6,17,0
157784,4,20,10,10,2,0
54659,3,14,22,-8,8,1
100184,2,14,0,14,12,0
199163,4,14,45,-31,4,0
68221,3,10,14,-4,14,1
360897,2,14,0,14,7,1
85685,3,24,14,10,5,0
167749,4,26,23,3,7,1
187551,3,13,16,-3,16,0
193858,3,24,7,17,1,1
56683,1,0,0,0,9,0
184755,1,14,6,8,15,0
383171,4,26,24,2,17,0
109478,4,12,13,-1,16,0
388706,1,0,0,0,3,1
299156,3,10,16,-6,14,1
226902,3,3,10,-7,16,0
655,2,0,10,-10,1,1
141540,3,24,10,14,13,1
387525,2,3,0,3,2,0
74691,3,7,17,-10,17,0
187141,4,13,0,13,16,1
420328,3,17,3,14,17,1
186271,2,13,3,10,15,1
290999,3,20,13,7,10,0
68561,4,13,28,-15,14,0
83030,1,3,0,3,4,0
304925,2,7,3,4,16,0
14694,1,0,0,0,7,1
14468,3,24,16,8,7,1
371752,3,14,14,0,12,1
259264,1,13,0,13,13,0
16339,2,7,0,7,8,0
30817,1,0,7,-7,15,0
247907,3,17,6,11,8,0
152710,4,27,13,14,17,1
28122,4,27,10,17,13,0
399363,3,27,7,20,7,0
233922,3,17,13,4,2,0
114291,1,0,6,-6,1,1
295336,1,0,0,0,12,1
104078,2,10,13,-3,13,1
125976,4,22,23,-1,6,1
314378,4,10,17,-7,3,0
368734,3,14,16,-2,11,0
120612,3,3,20,-17,3,1
228830,3,6,17,-11,17,1
208615,2,6,3,3,8,0
46268,4,24,31,-7,4,0
136749,2,13,10,3,11,1
24877,4,13,6,7,12,0
386253,4,14,17,-3,2,1
269438,4,21,20,1,1,0
211008,2,13,0,13,9,1
267568,3,27,27,0,17,1
265967,4,0,33,-33,16,1
336495,4,20,17,3,14,0
194359,4,23,6,17,2,1
339081,1,0,0,0,15,1
89457,4,24,20,4,7,1
22879,2,0,13,-13,11,1
312388,3,13,27,-14,3,1
299630,4,20,16,4,14,0
298319,1,0,0,0,14,0
51873,2,6,10,-4,7,1
113290,2,13,24,-11,17,0
391378,1,7,3,4,4,0
319186,3,2,10,-8,5,1
251122,3,10,14,-4,10,0
410749,3,17,6,11,13,1
147461,4,23,10,13,15,0
172518,2,0,0,0,9,0
124082,2,3,14,-11,5,0
313567,2,3,17,-14,3,1
365450,3,10,19,-9,9,0
119843,4,24,19,5,3,0
165938,1,3,7,-4,6,0
262088,1,7,0,7,15,0
326586,1,3,0,3,9,0
27756,2,14,7,7,13,0
120102,2,9,0,9,3,1
324226,1,3,0,3,8,1
106691,1,0,2,-2,14,1
182685,4,11,19,-8,14,0
185161,4,0,23,-23,15,0
67293,2,14,0,14,14,0
270199,1,3,7,-4,1,1
245557,2,34,0,34,7,0
215015,2,10,0,10,11,0
347326,4,7,21,-14,1,0
104807,3,27,33,-6,14,1
76450,1,0,7,-7,1,1
193294,4,3,23,-20,1,1
280320,4,16,22,-6,5,1
355117,2,14,16,-2,4,0
165771,1,0,0,0,6,0
418187,4,24,6,18,16,0
265592,2,0,8,-8,16,1
314478,2,14,0,14,3,0
65533,1,0,0,0,13,1
146783,1,7,0,7,15,0
94973,3,6,9,-3,9,1
120305,4,24,13,11,3,0
411775,3,0,20,-20,13,1
33934,2,0,24,-24,16,0
34897,3,27,10,17,16,0
252818,3,9,13,-4,11,1
138706,4,21,35,-14,12,0
163434,3,7,20,-13,5,0
94325,2,10,7,3,9,1
7936,4,3,20,-17,4,0
338522,3,20,14,6,14,0
330610,1,0,0,0,11,0
154319,3,13,14,-1,1,1
353383,2,12,0,12,4,1
52519,2,10,0,10,7,0
310856,1,3,0,3,2,0
121571,4,22,13,9,4,1
164578,1,0,0,0,5,0
265603,2,6,8,-2,16,0
413690,2,14,13,1,14,0
50411,2,7,7,0,6,1
50892,3,14,24,-10,6,1
300596,2,7,0,7,15,1
34497,4,48,10,38,16,0
328500,3,9,3,6,10,0
165000,1,7,3,4,6,0
89727,4,16,20,-4,7,0
259917,3,17,10,7,14,1
274367,2,3,7,-4,3,0
329335,2,6,20,-14,10,1
206644,4,10,16,-6,7,1
42033,2,13,7,6,2,1
199668,2,7,7,0,4,1
341545,3,13,10,3,16,0
262455,3,7,21,-14,15,0
377165,4,13,17,-4,15,1
115378,1,7,0,7,1,1
364720,3,6,3,3,9,0
177633,4,24,20,4,11,0
87802,1,3,0,3,6,1
243629,4,23,14,9,6,0
215452,2,7,3,4,11,1
265988,4,0,33,-33,16,1
352887,4,14,16,-2,3,1
393799,1,0,3,-3,5,1
45407,1,7,0,7,4,0
33391,2,20,10,10,16,0
41546,4,18,7,11,2,1
345173,4,15,9,6,17,1
252810,3,9,6,3,11,0
183799,2,10,21,-11,14,1
171497,3,17,10,7,9,0
344652,2,3,10,-7,17,0
160765,1,10,0,10,4,0
239267,2,3,7,-4,4,0
261824,2,6,10,-4,14,0
377332,4,24,14,10,15,0
11414,3,26,0,26,6,0
359660,4,37,7,30,6,1
131353,2,7,10,-3,8,0
115672,2,3,3,0,1,1
27947,3,14,10,4,13,1
209448,4,17,17,0,8,0
331692,1,0,13,-13,12,1
153949,1,7,0,7,1,0
42284,4,37,7,30,2,0
332076,4,10,9,1,12,1
109930,4,23,13,10,16,0
319011,2,7,22,-15,5,0
419380,4,3,26,-23,16,1
417386,3,13,17,-4,16,1
92015,4,27,23,4,8,0
420250,1,0,0,0,17,1
205855,4,20,0,20,7,1
175510,2,0,0,0,11,1
266876,1,0,0,0,17,0
371564,2,3,0,3,12,0
333838,3,14,21,-7,12,1
114421,4,41,20,21,1,1
91188,3,10,17,-7,8,1
304052,2,3,20,-17,16,1
224671,4,16,10,6,15,1
296311,2,3,13,-10,13,1
168360,4,24,24,0,7,0
182811,3,25,10,15,14,1
304639,2,14,7,7,16,0
340286,1,3,0,3,15,0
378268,2,0,3,-3,15,0
335554,2,3,0,3,13,1
310949,3,3,23,-20,2,1
413302,3,17,0,17,14,1
322258,4,0,27,-27,7,0
65912,3,17,14,3,13,0
236031,3,20,3,17,3,1
356572,4,9,9,0,5,0
103323,1,7,10,-3,13,1
72167,2,3,3,0,16,0
417709,4,35,12,23,16,0
227307,3,13,20,-7,16,0
89932,1,0,7,-7,7,0
79976,1,0,0,0,2,1
200845,1,7,0,7,4,0
291158,3,18,16,2,10,0
250286,2,7,0,7,9,1
5462,1,0,0,0,3,0
379877,2,14,0,14,16,1
307602,2,0,6,-6,17,0
17756,4,24,21,3,9,1
144921,4,20,7,13,14,1
172142,4,13,18,-5,9,0
293791,2,17,3,14,12,0
84032,3,27,15,12,4,1
116698,2,6,9,-3,2,0
352838,3,14,3,11,3,1
143764,2,3,0,3,14,0
156190,3,14,10,4,2,0
372298,3,17,7,10,13,0
18357,4,25,20,5,9,1
375855,4,20,7,13,14,0
365433,2,7,19,-12,9,1
226402,1,0,7,-7,16,1
392086,4,18,33,-15,4,0
123662,3,7,22,-15,4,1
392676,3,16,0,16,4,0
409262,3,13,13,0,12,0
385847,4,33,3,30,1,0
306236,4,30,3,27,17,0
95729,4,13,9,4,10,1
60994,3,34,16,18,11,1
116083,1,0,0,0,1,1
293143,1,0,0,0,11,0
332963,4,31,3,28,12,0
387484,1,0,0,0,2,0
165693,3,7,7,0,6,0
295629,1,0,0,0,12,0
175359,1,14,0,14,11,0
51365,4,19,20,-1,7,1
158666,3,14,7,7,3,0
237795,1,0,10,-10,4,0
352445,4,38,24,14,3,1
149882,4,6,16,-10,16,0
167524,3,0,10,-10,7,1
339235,2,13,0,13,15,1
104259,2,10,0,10,13,0
409930,1,0,7,-7,12,0
147643,1,3,0,3,15,1
312539,3,23,0,23,3,1
132143,3,10,3,7,9,0
133955,4,13,6,7,9,1
392047,3,10,17,-7,4,0
339710,2,7,6,1,15,1
72613,1,7,0,7,16,1
137527,2,14,17,-3,11,1
347800,3,10,0,10,1,0
146786,1,7,0,7,15,1
184522,3,24,14,10,14,1
393250,3,14,20,-6,5,0
46464,2,14,6,8,4,1
372348,4,24,17,7,13,0
26659,1,0,0,0,13,0
252958,3,9,7,2,11,0
382406,3,0,21,-21,17,1
378884,3,13,13,0,15,0
208866,1,7,0,7,8,0
106478,3,22,9,13,14,1
351498,2,0,24,-24,3,0
226045,1,0,0,0,16,1
303554,1,7,3,4,16,1
374045,4,24,10,14,13,0
129881,3,13,0,13,7,0
280960,1,0,0,0,6,1
301576,1,7,0,7,15,0
292267,1,0,7,-7,11,1
213573,4,17,14,3,10,0
260279,4,24,3,21,14,1
113755,3,3,17,-14,17,0
177501,4,27,17,10,11,0
209697,2,9,3,6,8,1
48048,4,10,34,-24,5,1
114496,2,17,17,0,1,0
106157,3,0,0,0,14,1
38249,3,13,14,-1,1,1
116293,3,17,10,7,1,0
272077,3,10,6,4,2,1
250498,3,16,7,9,9,1
76823,3,33,0,33,1,1
232803,3,16,14,2,2,0
353360,2,3,0,3,4,1
13779,3,7,27,-20,7,1
281754,1,0,0,0,6,0
412742,1,0,7,-7,14,0
111030,1,7,0,7,16,0
11328,1,14,0,14,6,1
136261,2,15,7,8,11,1
232080,4,0,33,-33,1,1
178779,2,21,7,14,12,0
231016,2,10,0,10,1,1
347139,3,16,10,6,1,0
168158,3,16,5,11,7,1
381595,1,0,0,0,17,1
18162,3,13,20,-7,9,1
51865,2,6,7,-1,7,0
299068,1,3,0,3,14,0
290789,2,3,0,3,10,1
254914,2,24,7,17,12,0
34803,4,20,6,14,16,1
284077,4,13,10,3,7,0
227761,3,3,14,-11,16,0
366691,2,17,10,7,10,1
259188,4,14,25,-11,13,0
94996,3,6,16,-10,9,1
205403,4,27,0,27,6,1
397690,1,3,0,3,7,1
24488,1,0,7,-7,12,0
381873,4,25,28,-3,17,1
194776,3,3,16,-13,2,1
299020,4,16,18,-2,14,0
175897,3,23,27,-4,11,0
66079,3,10,3,7,13,0
236221,4,27,16,11,3,0
211400,4,10,13,-3,9,1
285959,3,29,7,22,8,0
189994,4,16,7,9,17,0
362828,3,7,21,-14,8,0
280411,2,6,10,-4,5,0
191282,4,10,17,-7,17,1
129966,1,0,0,0,8,0
141582,4,34,18,16,13,0
68596,4,20,28,-8,14,1
344264,3,7,13,-6,17,1
280929,4,21,10,11,6,1
35830,4,10,17,-7,17,1
173003,2,14,0,14,9,0
82972,3,13,16,-3,4,0
206742,4,7,24,-17,7,1
270209,1,3,7,-4,1,0
304533,4,10,21,-11,16,1
100878,1,0,0,0,12,1
36834,4,24,26,-2,17,0
410393,2,6,7,-1,13,0
70444,2,14,17,-3,15,0
96541,1,0,0,0,10,0
315054,2,30,14,16,4,1
371404,1,7,7,0,12,0
325540,4,28,19,9,8,1
152756,2,0,0,0,17,0
300892,2,10,7,3,15,0
193204,2,3,0,3,1,1
133622,3,10,7,3,9,0
212681,4,9,31,-22,10,1
241767,4,7,15,-8,5,1
66415,1,0,0,0,14,0
356600,5,9,9,0,5,1
163903,2,16,10,6,5,1
53651,1,0,0,0,8,1
339929,4,33,0,33,15,0
417022,1,3,0,3,15,1
382669,2,0,6,-6,17,1
53007,4,27,24,3,7,0
58980,1,0,0,0,10,0
184564,4,42,21,21,14,1
417047,2,17,0,17,15,0
147431,3,23,10,13,15,1
373633,1,0,9,-9,13,1
58340,1,7,0,7,10,0
81184,1,0,0,0,3,0
192230,1,0,0,0,1,1
116682,1,3,3,0,2,1
135160,1,0,0,0,10,0
221785,4,13,21,-8,14,1
195490,1,0,0,0,2,0
116518,1,0,0,0,2,1
91973,3,13,23,-10,8,0
14800,4,45,3,42,7,0
42196,2,7,0,7,2,1
360787,3,24,30,-6,7,1
334416,3,10,10,0,13,0
156795,2,20,13,7,2,0
247915,4,17,6,11,8,1
152876,1,0,7,-7,1,1
273138,2,10,0,10,2,0
185369,2,0,3,-3,15,1
298685,3,13,14,-1,14,1
306545,1,0,0,0,17,0
243497,4,10,30,-20,6,0
346313,1,0,3,-3,1,1
48054,4,10,34,-24,5,0
17202,2,7,21,-14,9,0
151287,1,7,7,0,17,1
110675,4,23,10,13,16,0
381526,3,14,13,1,17,0
399830,4,11,27,-16,8,1
212560,1,7,3,4,10,0
188791,4,7,20,-13,16,0
213531,3,10,14,-4,10,0
210847,1,0,0,0,9,0
361358,2,3,7,-4,7,1
409903,4,37,8,29,12,0
294990,4,24,14,10,12,1
298601,4,13,10,3,14,0
219554,4,21,21,0,13,0
209838,2,10,13,-3,8,1
116250,1,10,0,10,1,0
116929,3,21,10,11,2,0
31724,1,0,0,0,15,0
234177,2,10,10,0,2,1
108216,2,6,0,6,15,1
103596,1,0,0,0,13,1
354711,4,17,20,-3,4,0
419404,1,3,0,3,16,1
287218,4,13,23,-10,8,1
252004,2,14,20,-6,10,0
212632,3,7,31,-24,10,1
55557,3,17,7,10,9,0
416494,3,21,17,4,15,1
398002,1,7,0,7,7,0
40076,4,20,14,6,1,0
379981,1,0,0,0,16,1
84595,2,13,10,3,4,1
223204,2,3,3,0,15,0
250955,2,3,6,-3,10,1
176787,2,3,7,-4,11,1
184302,4,37,14,23,14,0
221240,2,0,16,-16,14,0
334340,1,0,3,-3,13,1
342795,4,7,14,-7,16,1
14477,3,24,16,8,7,0
218231,4,37,3,34,12,0
60550,3,30,27,3,11,1
375067,4,28,30,-2,14,0
141869,4,24,14,10,13,0
73156,1,7,0,7,16,0
551,3,7,20,-13,1,1
32538,3,20,3,17,15,0
133677,4,24,35,-11,9,1
398493,3,14,9,5,7,1
220590,4,16,26,-10,13,0
145780,3,13,10,3,15,0
199345,2,0,0,0,4,0
400360,2,17,10,7,8,0
293896,1,0,14,-14,12,1
306351,4,31,10,21,17,0
317277,4,14,19,-5,5,0
418555,2,14,0,14,16,0
245694,2,3,10,-7,7,0
97911,1,0,0,0,11,1
391987,2,0,7,-7,4,0
2640,1,3,0,3,2,0
61317,4,31,28,3,11,1
368771,4,21,22,-1,11,0
285680,5,27,27,0,8,0
356410,4,31,20,11,5,1
207433,2,7,14,-7,7,1
379942,4,21,6,15,16,1
159079,2,17,0,17,3,1
41749,2,0,7,-7,2,1
283782,4,18,3,15,7,1
3947,4,19,14,5,2,1
244556,4,25,16,9,7,1
319312,2,10,10,0,6,1
30502,4,31,43,-12,14,1
29712,2,10,3,7,14,1
416080,4,21,6,15,15,0
69787,1,7,0,7,15,0
247514,1,3,3,0,8,1
61512,2,7,7,0,11,1
286107,3,10,17,-7,8,1
298035,1,0,0,0,13,0
405733,2,10,7,3,10,0
176830,3,10,10,0,11,0
69912,4,27,16,11,15,0
335545,2,3,0,3,13,1
184646,2,10,10,0,15,0
398218,3,28,10,18,7,0
6209,2,10,0,10,3,1
160017,2,10,23,-13,3,1
335641,4,19,10,9,13,0
214687,1,0,0,0,11,1
126780,1,0,3,-3,6,1
405127,3,3,10,-7,10,1
125370,4,38,3,35,5,1
120419,3,19,9,10,3,1
347200,4,23,27,-4,1,1
394543,1,0,0,0,5,1
396329,1,0,0,0,6,1
11976,3,17,7,10,6,0
181248,2,0,3,-3,13,1
132776,4,20,31,-11,9,1
231962,4,14,41,-27,1,1
305490,1,6,0,6,17,0
81577,3,17,24,-7,3,1
204937,4,13,27,-14,6,1
142768,3,12,10,2,13,1
237833,2,7,13,-6,4,0
365502,4,10,25,-15,9,1
412339,3,10,17,-7,13,0
16363,2,14,7,7,8,1
160778,1,10,7,3,4,1
382623,1,0,0,0,17,1
81717,3,17,17,0,3,1
234134,1,0,0,0,2,0
79776,3,20,7,13,2,0
217148,3,3,9,-6,12,0
270385,2,3,0,3,1,1
320246,2,14,7,7,6,1
194533,4,29,10,19,2,0
127265,1,3,0,3,6,0
221131,3,0,6,-6,14,0
216962,2,3,3,0,12,1
58389,2,34,0,34,10,0
310373,4,29,6,23,2,0
35458,2,7,7,0,17,1
56793,4,17,13,4,9,0
245617,4,40,13,27,7,0
308365,2,0,6,-6,1,1
118923,1,0,7,-7,3,1
316111,2,24,13,11,4,0
51427,2,3,10,-7,7,0
295407,3,10,10,0,12,0
353471,4,25,12,13,4,1
27590,1,7,3,4,13,1
321492,4,24,30,-6,7,0
334107,2,16,0,16,13,0
336281,2,10,0,10,13,1
186721,1,0,0,0,15,1
132564,2,2,29,-27,9,1
165173,1,0,0,0,6,1
45933,3,17,3,14,4,1
351126,4,37,37,0,3,0
80510,3,5,10,-5,3,0
133841,1,0,0,0,9,1
44343,4,24,23,1,3,0
273160,2,10,0,10,2,1
232078,3,0,33,-33,1,1
290798,2,10,0,10,10,0
132689,2,3,10,-7,9,1
140918,3,17,13,4,13,1
30678,1,3,0,3,15,0
181701,2,7,7,0,13,1
158139,1,0,0,0,3,1
165131,4,17,24,-7,6,1
220649,1,7,0,7,13,0
206518,1,0,0,0,7,1
58350,1,7,0,7,10,1
157042,1,0,0,0,2,0
29196,4,3,26,-23,14,0
229376,2,3,0,3,17,1
163847,1,0,6,-6,5,0
39130,3,13,10,3,1,1
136381,1,0,0,0,11,0
79155,2,3,6,-3,2,0
225031,1,0,7,-7,15,1
415348,4,14,21,-7,15,0
144230,2,9,7,2,14,0
146705,3,7,32,-25,15,1
225768,2,10,7,3,16,0
12994,2,6,7,-1,6,1
325932,3,13,7,6,9,0
362808,3,7,21,-14,8,0
370955,4,27,30,-3,12,0
175963,1,0,0,0,11,0
216055,3,17,12,5,11,1
179351,1,0,0,0,12,1
288602,4,23,38,-15,9,0
368436,3,23,14,9,11,1
186901,2,7,3,4,15,1
345825,1,0,7,-7,17,0
387925,4,10,28,-18,2,0
323892,4,16,33,-17,8,1
12959,1,0,0,0,6,0
212827,4,24,21,3,10,0
338810,2,10,0,10,15,0
209931,4,37,23,14,8,1
95976,2,0,0,0,10,0
85894,1,7,7,0,5,0
101690,2,10,0,10,12,1
374989,2,21,26,-5,14,0
407719,2,3,0,3,11,1
85362,3,28,9,19,5,0
383630,1,0,7,-7,17,0
359257,1,0,3,-3,6,0
149878,3,3,16,-13,16,1
347927,3,0,21,-21,1,1
207326,3,13,14,-1,7,0
313714,2,14,3,11,3,0
125526,4,30,7,23,5,1
107187,2,0,21,-21,15,0
84734,2,10,14,-4,4,0
290566,4,23,20,3,10,0
73321,1,13,0,13,17,1
131739,4,24,25,-1,8,1
149752,4,55,0,55,16,0
67801,4,31,0,31,14,0
318816,1,7,0,7,5,0
336426,2,10,10,0,14,1
253048,2,7,0,7,11,0
234138,1,0,0,0,2,0
12253,3,0,3,-3,6,1
307842,4,27,28,-1,1,1
318627,4,10,13,-3,5,1
108924,1,6,0,6,15,1
25994,3,10,16,-6,13,1
332169,2,3,10,-7,12,0
112152,3,10,27,-17,17,1
214070,1,0,0,0,11,1
210756,3,21,10,11,9,1
404612,2,13,10,3,10,0
373092,3,3,21,-18,13,1
256452,3,12,21,-9,12,0
82874,1,0,0,0,4,0
390359,2,7,7,0,3,0
131299,4,21,24,-3,8,1
298849,3,21,9,12,14,0
20710,4,17,20,-3,10,1
207661,4,42,16,26,7,0
312116,3,33,10,23,2,0
182320,3,17,7,10,14,0
178109,5,26,26,0,12,0
399918,2,0,6,-6,8,1
362965,3,27,9,18,8,0
287503,3,14,26,-12,9,0
409479,1,0,0,0,12,1
265760,2,3,3,0,16,1
394343,3,24,17,7,5,1
375072,4,28,30,-2,14,0
125202,3,31,13,18,5,0
2983,2,10,17,-7,2,1
230358,1,0,0,0,1,0
284165,2,6,13,-7,7,0
6851,3,10,28,-18,3,1
127126,2,3,9,-6,6,1
141277,4,10,24,-14,13,1
76540,3,7,34,-27,1,1
291862,2,6,7,-1,11,1
95098,2,0,10,-10,9,1
326205,2,10,27,-17,9,0
42606,1,0,0,0,3,0
408201,3,13,3,10,12,0
377733,4,32,7,25,15,1
288764,4,3,13,-10,9,1
362457,1,0,3,-3,8,0
331676,1,0,0,0,12,0
194544,1,0,0,0,2,1
224927,3,3,9,-6,15,1
103566,4,33,0,33,13,0
259266,1,13,0,13,13,0
258856,3,14,13,1,13,0
340874,1,0,0,0,15,0
179671,5,31,30,1,12,1
406009,1,0,0,0,11,0
49782,2,7,7,0,6,0
244146,1,0,7,-7,6,1
98937,4,7,17,-10,11,0
372558,1,0,0,0,13,1
232000,1,0,7,-7,1,1
29939,1,0,0,0,14,1
413659,1,7,3,4,14,0
114854,3,16,30,-14,1,0
1038,1,7,0,7,1,0
28836,2,10,7,3,14,1
281851,4,13,6,7,6,0
93767,4,3,16,-13,9,1
139522,2,6,0,6,12,1
328942,3,9,7,2,10,0
198749,1,3,3,0,3,1
103233,3,3,7,-4,13,0
218982,1,13,0,13,13,1
386787,2,7,7,0,2,1
308402,3,0,18,-18,1,1
374784,1,0,0,0,14,1
259697,1,3,0,3,14,0
288709,3,0,7,-7,9,0
123298,2,13,7,6,4,1
343346,2,0,20,-20,16,0
220363,1,6,0,6,13,0
322038,2,12,0,12,7,1
25277,3,27,7,20,12,1
315709,4,16,16,0,4,1
421689,2,17,7,10,17,0
14013,2,3,14,-11,7,1
404191,3,9,9,0,10,0
49448,5,20,20,0,6,0
6268,3,13,14,-1,3,0
158095,4,22,9,13,3,1
97037,2,19,3,16,10,1
308287,4,13,23,-10,1,1
406001,4,21,7,14,11,0
416640,3,31,7,24,15,0
276783,2,17,10,7,4,0
279008,4,13,30,-17,5,0
416166,2,10,9,1,15,0
243473,4,10,23,-13,6,0
372265,2,10,7,3,13,1
93356,4,30,6,24,9,0
69201,4,20,17,3,15,0
384832,2,6,10,-4,1,0
3516,4,17,30,-13,2,0
3874,2,16,7,9,2,1
317524,3,10,27,-17,5,1
343391,4,6,34,-28,16,1
61350,1,0,0,0,11,1
79438,2,9,7,2,2,0
241256,2,3,0,3,5,0
33554,3,17,3,14,16,1
122709,2,7,10,-3,4,0
363691,3,8,10,-2,8,1
248342,3,24,10,14,8,1
386479,2,7,0,7,2,1
420305,2,14,0,14,17,0
414290,3,21,28,-7,14,0
154264,1,3,7,-4,1,1
258497,4,30,21,9,13,0
394646,4,17,21,-4,5,0
7484,3,29,6,23,4,0
161514,4,17,6,11,4,0
7908,3,3,17,-14,4,0
47479,2,10,3,7,5,0
255934,2,6,3,3,12,0
84310,3,14,27,-13,4,0
125756,2,7,14,-7,5,0
48367,1,0,10,-10,5,1
397093,1,0,0,0,6,0
232334,2,6,9,-3,1,0
352664,2,7,0,7,3,0
103315,1,7,3,4,13,0
84467,3,13,10,3,4,1
5171,1,0,0,0,3,0
416245,4,10,39,-29,15,1
410078,1,14,7,7,13,0
100353,3,9,20,-11,12,1
214791,4,10,20,-10,11,0
53943,4,14,19,-5,8,1
233144,3,29,3,26,2,1
113696,1,0,10,-10,17,1
401720,3,10,14,-4,8,1
260872,4,43,15,28,14,1
119973,3,16,24,-8,3,1
186666,3,27,3,24,15,0
386309,1,7,0,7,2,1
342470,4,20,3,17,16,1
125085,1,0,0,0,5,1
199192,1,7,7,0,4,1
397408,2,0,10,-10,6,0
249346,2,10,9,1,9,1
43766,1,14,0,14,3,1
316536,1,0,3,-3,4,1
256782,3,13,13,0,12,0
79863,2,3,13,-10,2,1
113494,4,3,7,-4,17,1
278244,4,34,28,6,4,0
199073,2,7,14,-7,4,0
96710,2,0,7,-7,10,0
188486,1,0,0,0,16,1
206350,1,0,0,0,7,1
131967,2,0,7,-7,8,0
107198,3,6,28,-22,15,0
126403,4,20,17,3,6,1
351584,4,0,27,-27,3,1
130459,2,3,3,0,8,1
348081,3,0,16,-16,1,0
311121,4,13,10,3,2,0
241261,2,3,0,3,5,0
265003,1,0,0,0,16,1
97471,1,13,0,13,10,0
396462,4,26,25,1,6,1
372236,1,0,0,0,13,1
33253,3,10,0,10,16,1
135515,2,7,6,1,10,1
30236,1,0,0,0,14,1
153682,1,2,14,-12,1,1
316937,3,17,18,-1,4,1
257413,4,20,14,6,13,1
367775,1,0,0,0,10,0
120638,4,3,27,-24,3,1
127362,4,10,20,-10,6,1
120037,4,30,38,-8,3,1
294966,3,17,7,10,12,0
221249,2,0,16,-16,14,0
303389,1,7,0,7,16,1
412928,2,9,3,6,14,0
420638,2,13,16,-3,17,1
269542,3,13,31,-18,1,1
257410,4,20,14,6,13,1
175108,2,14,10,4,10,1
122784,4,10,27,-17,4,0
308031,1,0,0,0,1,1
415910,3,10,20,-10,15,0
101295,4,17,20,-3,12,1
354449,2,7,14,-7,4,1
180226,4,22,14,8,13,0
194577,2,14,0,14,2,1
142477,3,14,10,4,13,0
72735,1,6,0,6,16,1
94126,1,3,0,3,9,1
208292,2,0,14,-14,8,1
204828,1,0,0,0,6,1
235867,2,0,14,-14,3,0
99202,3,17,16,1,11,0
336136,2,10,3,7,13,1
324212,1,0,0,0,8,1
281977,3,21,14,7,6,0
261782,1,0,0,0,14,1
359635,3,24,7,17,6,1
407314,4,23,19,4,11,0
9203,3,3,23,-20,5,0
135440,4,31,27,4,10,0
146073,2,19,10,9,15,1
155981,2,10,14,-4,2,0
180327,2,12,7,5,13,1
287824,3,28,17,11,9,0
45662,4,13,13,0,4,1
101378,2,6,0,6,12,0
240092,1,0,0,0,5,0
320819,1,0,4,-4,6,1
328033,3,17,9,8,10,0
345226,2,7,14,-7,17,1
251348,2,21,14,7,10,0
25613,4,30,10,20,12,1
410918,3,14,15,-1,13,0
228619,2,10,14,-4,17,0
17840,3,16,10,6,9,0
171042,3,17,23,-6,8,0
67650,4,7,35,-28,14,0
54660,3,14,22,-8,8,0
334919,4,30,10,20,13,0
49278,4,20,17,3,6,1
205895,4,29,7,22,7,0
419287,2,0,10,-10,16,1
156697,4,14,17,-3,2,1
172943,4,55,31,24,9,0
128402,4,14,13,1,7,1
407281,3,17,16,1,11,0
402141,2,12,0,12,9,1
246745,2,3,3,0,8,1
162209,2,13,20,-7,4,1
286684,2,10,7,3,8,1
280730,3,7,6,1,5,1
246667,3,31,3,28,8,1
401058,1,7,3,4,8,0
31560,1,7,3,4,15,0
146189,2,0,3,-3,15,0
262944,4,14,32,-18,15,0
382132,3,27,3,24,17,1
395333,2,14,0,14,5,0
302345,2,7,3,4,15,1
79249,1,9,0,9,2,0
52339,2,3,3,0,7,0
216343,2,7,13,-6,12,1
357989,3,24,13,11,6,1
112009,4,28,21,7,17,0
319308,2,10,10,0,6,1
274523,2,14,9,5,3,1
156240,4,24,23,1,2,0
244746,4,31,29,2,7,1
162785,2,0,0,0,5,0
28890,4,23,10,13,14,1
21766,4,31,23,8,11,0
299154,3,10,16,-6,14,1
169865,4,20,17,3,8,1
297244,3,21,6,15,13,0
360029,2,3,26,-23,7,0
11518,3,6,10,-4,6,1
287099,1,0,0,0,8,1
158944,2,14,15,-1,3,0
164505,3,17,0,17,5,0
142308,2,0,0,0,13,0
155090,3,6,33,-27,1,1
169612,1,6,0,6,8,1
44795,4,16,19,-3,3,1
160757,1,3,0,3,4,0
293292,4,26,15,11,11,1
75011,4,27,17,10,17,0
307091,4,24,6,18,17,0
212705,1,0,7,-7,10,0
194434,2,9,0,9,2,1
374458,3,32,7,25,14,1
281319,2,14,13,1,6,1
130433,1,0,0,0,8,1
83495,1,0,6,-6,4,0
218745,2,0,13,-13,13,0
38771,2,0,3,-3,1,0
295108,3,7,14,-7,12,1
55702,3,23,20,3,9,0
421368,2,6,10,-4,17,1
162324,2,3,7,-4,4,1
360255,1,0,3,-3,7,0
263616,2,14,10,4,15,1
153531,2,2,7,-5,1,1
316284,3,10,16,-6,4,1
44440,3,17,7,10,3,1
345484,4,16,22,-6,17,1
148219,4,16,28,-12,16,0
416223,4,10,25,-15,15,0
187722,3,16,13,3,16,0
97880,4,20,27,-7,11,1
143220,3,10,13,-3,13,0
147115,3,17,31,-14,15,1
215856,1,0,0,0,11,0
148481,3,21,3,18,16,0
405355,4,17,12,5,10,0
8272,1,0,0,0,4,0
66177,2,17,3,14,13,1
229109,2,16,7,9,17,0
233993,1,14,0,14,2,1
402018,4,3,19,-16,9,1
306804,4,19,36,-17,17,1
48798,1,0,0,0,5,0
105990,3,17,3,14,14,1
189524,4,20,0,20,17,0
107180,2,0,21,-21,15,1
344790,2,7,7,0,17,1
161041,4,30,7,23,4,1
11331,1,14,0,14,6,1
34043,1,0,0,0,16,0
392992,4,12,10,2,4,0
68912,1,0,0,0,15,0
91752,2,0,0,0,8,1
5609,1,0,7,-7,3,1
178417,4,38,41,-3,12,1
7142,3,34,21,13,4,0
81644,1,7,0,7,3,0
355695,1,7,3,4,5,0
354064,2,16,0,16,4,1
327053,4,14,17,-3,9,1
23168,2,20,0,20,11,1
297265,4,24,6,18,13,0
140732,2,12,14,-2,12,1
166767,3,20,9,11,6,1
369207,4,22,20,2,11,0
184383,3,21,6,15,14,0
60970,2,21,6,15,11,0
351131,5,37,37,0,3,0
113945,4,20,10,10,17,0
127932,2,22,0,22,6,1
84274,2,7,14,-7,4,0
73751,1,3,0,3,17,0
297574,4,21,7,14,13,1
278447,2,22,0,22,4,1
45049,3,23,13,10,4,1
38530,2,24,3,21,1,0
412043,2,14,0,14,13,0
180183,3,13,0,13,13,0
58421,3,41,10,31,10,0
203229,4,10,17,-7,5,0
373469,1,0,7,-7,13,1
232867,4,23,23,0,2,0
242208,4,23,7,16,6,0
157544,2,0,0,0,2,1
387993,2,3,3,0,2,0
16400,4,21,13,8,8,0
274082,3,10,0,10,3,1
394066,4,9,16,-7,5,0
123007,3,0,13,-13,4,0
211344,3,10,10,0,9,1
28811,2,3,0,3,14,1
158218,3,24,0,24,3,1
48575,3,14,17,-3,5,0
234784,2,0,3,-3,2,0
26485,4,30,22,8,13,1
263775,3,0,21,-21,15,0
59600,2,14,3,11,11,0
179787,4,6,24,-18,12,0
129467,4,26,26,0,7,1
15214,3,13,0,13,8,0
402287,3,13,16,-3,9,1
290505,2,14,7,7,10,1
131635,1,0,13,-13,8,0
66946,4,18,7,11,14,0
82573,1,0,3,-3,3,0
92416,2,17,10,7,8,1
288361,2,7,0,7,9,0
154375,4,34,24,10,1,0
262467,3,7,28,-21,15,0
16502,2,13,7,6,8,1
55906,1,0,0,0,9,0
232407,4,20,25,-5,1,1
319743,1,0,0,0,6,0
140202,4,13,10,3,12,0
120423,3,19,9,10,3,1
387684,2,0,7,-7,2,0
39618,4,27,6,21,1,0
256165,4,27,22,5,12,0
236647,2,10,0,10,3,0
288551,3,20,31,-11,9,1
310013,3,9,10,-1,2,0
20036,3,19,6,13,10,0
256386,2,6,7,-1,12,1
39681,2,3,0,3,1,1
39306,4,10,27,-17,1,1
197519,1,0,0,0,3,0
381861,4,18,21,-3,17,1
64089,4,27,24,3,13,1
60488,2,14,7,7,11,0
259873,2,7,7,0,14,1
270707,2,3,3,0,1,1
362991,3,33,16,17,8,0
253382,2,7,21,-14,11,1
77792,2,7,14,-7,1,1
321147,2,3,16,-13,6,1
366787,1,0,0,0,10,1
295430,3,10,13,-3,12,0
421888,4,20,26,-6,17,1
313882,2,21,19,2,3,1
197818,1,6,0,6,3,1
360016,2,3,26,-23,7,0
165636,2,0,0,0,6,1
121154,2,0,13,-13,3,1
252316,2,0,16,-16,10,0
224347,4,16,12,4,15,1
131378,2,7,13,-6,8,0
96330,3,3,16,-13,10,0
413937,1,3,0,3,14,0
55689,3,20,14,6,9,1
9972,4,3,3,0,5,0
6394,3,3,13,-10,3,0
226399,1,0,7,-7,16,1
176755,1,0,0,0,11,1
321056,4,16,14,2,6,0
324667,1,0,7,-7,8,1
293508,2,10,10,0,11,1
133846,1,0,0,0,9,0
92380,2,10,0,10,8,0
278689,4,24,10,14,4,0
318663,4,10,16,-6,5,1
298159,4,10,41,-31,13,0
317467,2,10,3,7,5,0
18027,4,22,28,-6,9,0
52726,4,6,23,-17,7,1
274244,3,17,7,10,3,1
213852,3,48,7,41,10,1
259603,2,0,3,-3,13,1
49478,1,0,0,0,6,0
130774,2,13,3,10,8,0
55014,1,0,0,0,8,0
163404,2,0,6,-6,5,0
89894,4,30,20,10,7,1
5198,2,7,3,4,3,0
346466,1,7,7,0,1,1
149381,2,6,6,0,16,1
151251,4,24,26,-2,17,0
200724,2,7,0,7,4,1
79314,3,15,3,12,2,0
346828,2,10,3,7,1,1
318752,3,10,23,-13,5,1
295287,3,14,5,9,12,1
77748,1,0,0,0,1,1
89902,4,30,20,10,7,1
104987,4,17,22,-5,14,0
398932,4,10,10,0,7,1
59927,2,3,3,0,11,0
327430,3,3,17,-14,9,0
16860,1,0,0,0,8,0
379469,3,16,0,16,16,1
188097,2,0,3,-3,16,1
185569,2,10,17,-7,15,0
365639,4,38,35,3,9,1
417325,2,7,3,4,16,1
229859,3,13,7,6,17,1
419548,1,7,7,0,17,0
288778,4,10,13,-3,9,0
221503,4,10,41,-31,14,1
183128,3,7,6,1,14,1
182354,3,24,17,7,14,1
4269,4,20,6,14,2,0
333817,3,14,14,0,12,0
171218,4,9,14,-5,8,1
215314,2,14,7,7,11,0
340934,3,0,10,-10,15,1
43916,1,0,7,-7,3,0
185805,4,25,3,22,15,1
392576,4,10,27,-17,4,1
38165,1,3,0,3,1,1
164934,3,0,6,-6,6,0
358021,4,24,16,8,6,0
355182,4,29,26,3,4,1
165767,1,0,0,0,6,1
351406,4,13,13,0,3,0
264307,3,10,29,-19,15,0
278090,4,13,17,-4,4,0
418857,2,6,10,-4,16,1
41849,4,28,14,14,2,1
276951,3,17,17,0,4,0
140113,2,7,0,7,12,1
351195,2,14,3,11,3,1
153258,2,2,0,2,1,0
196750,4,54,13,41,3,1
134635,3,31,17,14,10,0
152217,2,21,0,21,17,0
281391,4,28,19,9,6,0
407101,2,0,20,-20,11,1
155495,1,7,0,7,2,1
5602,1,0,0,0,3,0
155081,3,6,33,-27,1,1
40972,4,19,27,-8,2,1
139809,2,7,10,-3,12,0
122069,1,0,7,-7,4,1
106855,1,6,0,6,14,0
259927,3,17,10,7,14,1
170197,4,24,30,-6,8,1
256307,4,14,17,-3,12,1
41722,1,0,0,0,2,0
214644,4,3,16,-13,11,1
292467,2,10,6,4,11,0
298595,4,13,10,3,14,1
226780,4,7,20,-13,16,1
152901,2,7,7,0,1,0
227740,2,3,14,-11,16,1
334993,2,16,7,9,13,0
57835,4,22,10,12,10,1
108332,1,0,7,-7,15,1
139199,1,0,6,-6,12,0
19373,1,0,0,0,10,1
29425,2,7,14,-7,14,0
160688,3,10,0,10,4,1
10563,4,40,0,40,5,1
281071,4,31,16,15,6,1
241662,1,0,0,0,5,0
100988,4,13,16,-3,12,0
282215,2,3,0,3,6,1
76511,3,7,20,-13,1,0
1393,3,10,0,10,1,1
47342,2,3,10,-7,5,0
174074,3,0,33,-33,10,0
113797,4,13,17,-4,17,1
170649,1,0,0,0,8,1
288174,1,0,0,0,9,1
89019,1,0,0,0,6,1
231528,4,29,29,0,1,1
128872,1,0,0,0,7,1
215603,2,14,3,11,11,1
263815,4,7,24,-17,15,0
70294,2,10,10,0,15,0
61448,4,16,17,-1,11,0
96473,3,10,17,-7,10,1
338463,1,7,0,7,14,0
241817,2,3,3,0,5,1
418552,2,14,0,14,16,0
32869,4,6,7,-1,15,1
231512,4,23,20,3,1,0
285658,4,27,27,0,8,1
87449,4,20,10,10,6,0
370225,1,0,0,0,12,0
218611,3,7,23,-16,13,1
25341,1,0,0,0,12,0
44749,3,7,12,-5,3,1
294243,3,20,14,6,12,0
299821,1,3,0,3,14,1
378987,1,0,0,0,15,1
292736,2,13,10,3,11,0
155228,2,21,7,14,1,0
188335,1,0,0,0,16,0
267731,4,16,34,-18,17,1
412788,2,14,17,-3,14,1
107016,1,10,0,10,15,1
261919,1,0,0,0,14,0
98956,4,7,24,-17,11,1
4740,2,10,0,10,3,0
41833,4,21,14,7,2,1
251852,2,14,10,4,10,1
183510,1,7,3,4,14,1
232458,2,3,0,3,1,1
253132,4,21,20,1,11,1
344123,3,20,3,17,17,0
31353,3,7,3,4,15,1
417764,5,35,35,0,16,0
198919,2,6,16,-10,3,1
203487,3,21,3,18,6,1
246694,4,38,10,28,8,1
29867,3,9,16,-7,14,0
252413,1,0,0,0,10,0
269834,3,22,10,12,1,0
188809,4,7,33,-26,16,1
271294,3,6,14,-8,1,0
291573,2,13,3,10,11,0
159699,1,7,7,0,3,0
186838,4,29,14,15,15,0
299018,4,16,18,-2,14,0
87852,2,10,9,1,6,1
178255,4,6,13,-7,12,0
419673,1,0,0,0,17,0
2,1,0,0,0,1,1
7138,3,34,21,13,4,1
185090,2,0,10,-10,15,0
373511,2,0,13,-13,13,0
407402,2,7,7,0,11,1
195471,1,0,0,0,2,1
278710,4,24,10,14,4,1
405450,3,21,10,11,10,1
78171,3,20,3,17,2,1
19658,1,0,0,0,10,0
352380,2,27,7,20,3,1
334654,1,2,0,2,13,0
249197,2,9,0,9,9,0
303331,3,34,0,34,16,0
89354,1,3,6,-3,7,0
149921,1,0,0,0,16,1
145491,4,16,17,-1,14,1
336430,2,10,10,0,14,1
400185,1,0,3,-3,8,1
275435,2,13,10,3,3,1
399585,1,0,0,0,8,1
322756,2,3,14,-11,7,0
271774,3,30,10,20,2,0
344597,4,0,6,-6,17,0
397410,2,0,13,-13,6,0
230407,2,7,0,7,1,1
137338,1,3,0,3,11,0
151605,2,7,10,-3,17,0
179308,4,33,11,22,12,1
202129,3,13,3,10,5,1
390454,4,21,33,-12,3,0
304687,3,14,7,7,16,1
40702,1,7,7,0,2,1
211447,1,3,7,-4,9,1
302167,1,14,0,14,15,0
146764,1,0,0,0,15,1
164061,3,3,6,-3,5,0
92916,4,34,7,27,8,0
155373,2,10,3,7,2,1
2224,2,7,7,0,1,1
271480,3,14,0,14,1,1
358755,4,14,17,-3,6,1
416589,1,7,0,7,15,0
187293,4,10,13,-3,16,1
6546,3,3,3,0,3,0
333853,4,21,21,0,12,0
385231,1,0,3,-3,1,0
219070,4,31,13,18,13,0
42340,2,7,9,-2,2,0
377177,4,16,17,-1,15,0
183092,2,7,3,4,14,1
341427,4,0,13,-13,16,1
313119,2,0,3,-3,3,1
30421,2,10,13,-3,14,0
250023,2,17,13,4,9,1
333295,1,0,0,0,12,1
175414,3,17,6,11,11,0
59249,4,28,58,-30,10,0
95937,1,0,0,0,10,1
189877,1,0,7,-7,17,1
287048,3,19,24,-5,8,1
70033,3,31,10,21,15,0
45924,3,17,3,14,4,1
320939,1,0,0,0,6,0
374702,2,0,23,-23,14,0
12171,4,20,28,-8,6,1
193993,2,14,7,7,1,1
141499,2,7,3,4,13,1
397646,4,6,27,-21,7,0
124849,2,0,6,-6,5,1
96509,4,17,24,-7,10,1
382739,4,9,20,-11,17,1
185234,2,10,6,4,15,1
46379,4,6,17,-11,4,1
172639,1,0,0,0,9,1
50575,2,0,6,-6,6,0
159884,3,24,0,24,3,1
231398,1,0,0,0,1,0
322308,2,7,0,7,7,0
386796,2,10,7,3,2,0
18285,2,10,17,-7,9,1
190024,1,7,0,7,17,1
33192,1,7,0,7,16,0
166345,4,20,9,11,6,0
401009,4,22,15,7,8,0
100651,2,14,14,0,12,1
184566,4,42,21,21,14,1
59950,3,3,23,-20,11,0
332359,4,16,13,3,12,1
172495,1,0,0,0,9,1
60989,3,27,16,11,11,1
224687,4,19,17,2,15,1
205673,3,17,12,5,7,0
358462,4,32,27,5,6,1
60950,2,14,6,8,11,0
37634,2,17,0,17,17,0
370777,3,19,10,9,12,0
322188,2,0,20,-20,7,1
174081,3,0,36,-36,10,1
75123,3,7,6,1,17,1
304769,2,0,0,0,16,0
389750,1,10,3,7,3,1
308716,3,7,13,-6,1,0
2647,1,3,0,3,2,0
251023,4,3,6,-3,10,1
123251,4,19,21,-2,4,1
248707,1,3,0,3,9,0
266021,1,7,0,7,16,1
16293,4,25,29,-4,8,1
208335,2,17,24,-7,8,1
11077,2,10,10,0,5,1
296681,4,10,16,-6,13,0
288271,3,10,35,-25,9,0
103882,4,26,0,26,13,0
246304,2,7,3,4,7,0
42405,4,14,19,-5,2,1
178268,1,0,0,0,12,1
162733,4,29,24,5,5,0
17008,4,34,23,11,8,0
122103,2,10,14,-4,4,1
62916,4,17,10,7,12,0
194897,2,0,10,-10,2,1
318248,2,3,0,3,5,0
157130,3,16,20,-4,2,0
254123,2,3,6,-3,11,0
314455,2,7,0,7,3,0
272759,4,15,10,5,2,0
97060,2,19,3,16,10,0
234978,3,13,3,10,2,0
340940,3,7,10,-3,15,0
334742,4,25,9,16,13,1
214545,1,0,0,0,11,1
98534,1,0,0,0,11,1
163254,2,6,6,0,5,1
227702,1,0,0,0,16,1
304961,3,7,14,-7,16,1
187146,4,16,0,16,16,0
401795,1,7,0,7,9,1
142086,1,0,7,-7,13,1
406683,3,21,0,21,11,0
239698,2,7,10,-3,4,0
92655,1,0,0,0,8,0
194522,4,26,10,16,2,1
176806,2,10,7,3,11,1
383563,3,21,13,8,17,0
206546,2,0,3,-3,7,1
348965,2,14,0,14,2,1
158105,4,25,9,16,3,0
89688,3,6,17,-11,7,1
201462,2,12,0,12,5,0
312596,4,44,7,37,3,1
53085,2,19,7,12,7,0
316750,2,10,0,10,4,1
210735,2,14,0,14,9,0
45955,4,17,3,14,4,1
160120,1,7,0,7,3,1
216977,2,3,3,0,12,1
262644,4,26,10,16,15,0
67059,3,10,9,1,14,0
68556,3,13,28,-15,14,0
147236,2,0,21,-21,15,0
68662,2,10,0,10,15,0
134886,1,7,7,0,10,1
179084,2,6,6,0,12,1
122835,2,10,3,7,4,0
42625,2,0,7,-7,3,0
76397,4,29,6,23,1,1
55362,1,7,7,0,9,1
421165,4,44,16,28,17,1
240887,1,7,3,4,5,1
311961,3,35,10,25,2,1
285302,3,14,9,5,7,1
135444,4,31,27,4,10,0
63154,2,14,10,4,12,0
323369,2,17,0,17,7,0
378814,1,0,0,0,15,0
201794,2,13,0,13,5,0
399060,3,10,19,-9,7,0
143814,3,6,7,-1,14,1
342811,1,0,0,0,16,1
61780,1,0,10,-10,12,1
50193,4,6,31,-25,6,0
360524,1,0,7,-7,7,1
347219,1,0,0,0,1,1
257364,2,17,0,17,13,1
269359,2,7,14,-7,1,0
48261,2,3,10,-7,5,1
272877,3,20,17,3,2,1
327641,1,0,0,0,10,0
409851,3,23,0,23,12,1
361537,3,10,7,3,7,1
47721,4,6,17,-11,5,1
129566,3,6,17,-11,7,1
58539,2,10,3,7,10,0
235666,2,0,3,-3,3,0
241645,1,0,0,0,5,0
104108,2,17,13,4,13,0
108818,2,0,10,-10,15,1
186861,1,0,0,0,15,1
253494,1,0,0,0,11,0
179844,2,3,0,3,13,1
349242,1,0,14,-14,2,1
110315,3,3,17,-14,16,1
101853,2,3,3,0,12,1
192007,3,17,20,-3,1,1
25212,1,0,0,0,12,1
339931,4,33,0,33,15,0
398645,3,0,0,0,7,0
10165,2,6,0,6,5,0
340132,1,6,7,-1,15,1
306417,2,0,10,-10,17,0
7281,3,14,13,1,4,1
20860,3,27,9,18,10,1
410505,4,18,26,-8,13,1
143861,4,12,7,5,14,0
300683,4,24,3,21,15,0
355780,4,10,9,1,5,1
123793,2,10,3,7,5,0
361401,4,17,14,3,7,0
72561,4,19,31,-12,16,0
8400,4,30,10,20,4,1
181808,1,0,0,0,13,0
262522,4,28,35,-7,15,1
30161,3,10,17,-7,14,0
200001,3,17,17,0,4,1
87719,3,6,20,-14,6,0
171198,3,6,7,-1,8,0
415620,3,23,13,10,15,1
65290,2,3,21,-18,13,1
101447,4,18,10,8,12,0
192594,1,3,7,-4,1,1
335780,4,24,14,10,13,0
112646,4,38,41,-3,17,1
254769,3,10,10,0,11,1
300315,3,0,7,-7,14,0
257083,3,7,14,-7,12,1
38365,2,7,9,-2,1,0
246848,4,13,20,-7,8,1
59713,1,0,0,0,11,0
265193,2,6,3,3,16,1
62883,3,10,3,7,12,1
104233,1,3,0,3,13,0
116824,1,7,0,7,2,0
411504,4,13,24,-11,13,1
137977,1,7,7,0,11,0
230748,3,9,27,-18,1,1
75470,3,31,7,24,17,0
171908,2,7,7,0,9,0
312333,2,7,17,-10,3,1
416637,3,31,7,24,15,1
103651,2,0,7,-7,13,0
382915,2,0,7,-7,17,1
409761,4,13,9,4,12,1
417457,1,3,7,-4,16,0
284974,4,16,20,-4,7,0
24287,4,13,17,-4,12,0
326103,4,30,3,27,9,0
310293,2,23,0,23,2,1
331242,1,0,0,0,11,0
13882,2,14,0,14,7,1
246440,1,7,0,7,8,1
28413,3,13,3,10,14,0
28265,3,17,14,3,13,1
194799,4,10,23,-13,2,0
121080,4,17,31,-14,3,1
290827,3,10,14,-4,10,1
149315,4,20,27,-7,16,1
64634,4,20,23,-3,13,0
392500,2,3,17,-14,4,0
214812,4,10,27,-17,11,0
362654,3,3,7,-4,8,1
183197,1,0,0,0,14,1
378109,1,14,0,14,15,1
369057,4,20,19,1,11,0
285396,2,17,0,17,8,0
223265,3,3,9,-6,15,1
113381,1,0,0,0,17,0
385737,2,7,0,7,1,1
411559,1,0,10,-10,13,0
218838,1,7,3,4,13,0
169521,3,3,28,-25,8,1
272726,3,12,3,9,2,1
116521,1,0,0,0,2,0
121553,3,16,10,6,4,1
139332,4,20,13,7,12,1
9550,5,20,20,0,5,1
329883,1,0,7,-7,11,1
82056,4,17,7,10,3,0
26170,3,0,26,-26,13,1
297413,4,23,24,-1,13,1
400897,1,6,0,6,8,0
359733,2,17,9,8,6,1
411851,1,0,0,0,13,1
410238,2,7,0,7,13,1
206753,4,7,24,-17,7,1
365546,1,14,7,7,9,0
172311,5,24,23,1,9,1
211214,3,14,17,-3,9,0
119505,4,14,24,-10,3,0
218640,4,10,30,-20,13,0
181692,2,0,7,-7,13,1
228916,1,7,9,-2,17,1
226022,4,34,34,0,16,1
191171,1,0,0,0,17,0
398569,1,0,0,0,7,1
117519,3,17,17,0,2,1
300346,3,9,7,2,14,1
133878,2,3,6,-3,9,0
213648,2,7,14,-7,10,1
163070,1,0,3,-3,5,0
145130,2,17,0,17,14,0
342114,2,12,6,6,16,0
149197,1,0,0,0,16,1
242031,3,7,3,4,5,0
242570,1,3,0,3,6,0
356658,2,16,3,13,5,0
248627,3,14,10,4,9,0
348909,4,9,21,-12,2,0
199803,2,3,3,0,4,1
104597,2,7,3,4,14,0
242137,2,13,7,6,6,0
363489,1,0,2,-2,8,0
251684,2,6,3,3,10,1
183690,3,6,14,-8,14,0
139467,4,27,10,17,12,1
347876,1,0,0,0,1,1
191445,4,0,34,-34,17,0
260330,2,0,0,0,14,0
258878,4,20,14,6,13,1
213780,1,14,0,14,10,1
197739,3,14,10,4,3,0
230950,1,0,0,0,1,0
236560,4,10,9,1,3,0
305656,1,3,7,-4,17,0
386352,2,17,6,11,2,0
350329,3,21,3,18,2,1
4123,4,23,28,-5,2,1
122840,2,10,3,7,4,1
338862,3,13,14,-1,15,0
224719,1,3,0,3,15,0
354597,1,0,7,-7,4,1
88211,4,17,17,0,6,0
415890,3,10,20,-10,15,0
125206,4,31,14,17,5,1
257379,3,17,0,17,13,1
233631,4,23,41,-18,2,0
364434,3,35,14,21,9,0
276051,2,13,3,10,3,1
46741,2,7,3,4,4,1
285515,1,0,0,0,8,0
299151,3,10,16,-6,14,1
404523,4,31,27,4,10,0
339739,3,21,6,15,15,1
330021,1,0,0,0,11,1
99194,2,17,10,7,11,0
145679,4,42,7,35,14,0
82853,4,18,16,2,3,0
151111,4,24,10,14,17,0
46029,2,14,14,0,4,1
178922,2,3,3,0,12,1
5257,3,24,24,0,3,0
124400,2,6,0,6,5,0
237707,4,20,14,6,4,0
4021,1,7,7,0,2,1
384293,3,6,0,6,1,1
341301,1,0,0,0,16,0
176849,3,17,13,4,11,1
290361,2,13,3,10,10,0
55092,3,16,3,13,8,1
102147,2,13,0,13,13,1
113770,3,3,17,-14,17,1
17504,2,13,0,13,9,1
397904,3,7,6,1,7,0
118934,1,0,7,-7,3,0
204791,4,28,21,7,6,0
1674,2,7,0,7,1,1
390996,3,20,21,-1,4,0
415190,3,10,24,-14,15,1
10172,2,6,3,3,5,1
189498,3,17,0,17,17,0
6775,1,3,0,3,3,1
120145,3,10,6,4,3,0
82711,1,0,0,0,3,0
8935,3,28,0,28,4,0
168491,4,9,24,-15,7,1
31586,2,7,3,4,15,1
364590,3,15,34,-19,9,1
6568,4,13,6,7,3,0
50464,3,17,10,7,6,1
153032,1,0,0,0,1,0
143103,3,17,24,-7,13,1
321051,4,10,14,-4,6,1
344799,2,7,7,0,17,0
392683,4,16,0,16,4,1
26047,4,13,19,-6,13,0
219515,3,9,21,-12,13,0
330532,3,7,7,0,11,0
122623,4,27,7,20,4,0
254796,3,20,10,10,11,0
285459,4,33,8,25,8,1
87431,3,17,7,10,6,1
333748,4,21,14,7,12,1
320686,1,14,17,-3,6,1
38167,1,3,0,3,1,1
163586,3,7,19,-12,5,1
3748,2,13,3,10,2,0
357490,1,0,3,-3,5,0
64508,4,31,16,15,13,1
325295,2,6,3,3,8,0
276269,4,31,17,14,3,0
1027,1,7,0,7,1,0
232460,2,3,0,3,1,1
347387,5,21,21,0,1,1
217875,3,17,21,-4,12,1
113680,1,0,0,0,17,0
159077,2,17,0,17,3,0
337473,2,7,9,-2,14,0
104202,1,0,0,0,13,0
49417,4,20,20,0,6,1
224161,2,0,20,-20,15,0
227772,3,3,14,-11,16,1
24310,1,0,0,0,12,0
132286,3,24,7,17,9,0
358724,3,14,14,0,6,0
243915,3,19,6,13,6,0
397138,2,3,0,3,6,0
183761,1,7,14,-7,14,0
400286,4,24,9,15,8,0
9373,4,31,7,24,5,0
64520,4,34,16,18,13,1
298117,3,3,31,-28,13,0
226172,4,28,35,-7,16,1
49498,2,7,3,4,6,0
141820,2,10,14,-4,13,0
382249,3,17,3,14,17,0
16863,1,0,0,0,8,0
331970,1,0,0,0,12,1
115119,3,3,20,-17,1,0
419050,3,7,20,-13,16,0
3273,2,3,0,3,2,0
200154,3,7,24,-17,4,1
385823,4,30,3,27,1,1
223107,3,31,17,14,14,1
403486,3,17,12,5,9,0
232469,2,10,0,10,1,0
160752,1,3,0,3,4,0
344633,1,0,10,-10,17,1
228906,1,7,0,7,17,0
197833,1,6,0,6,3,0
187476,1,0,3,-3,16,1
190795,2,13,3,10,17,1
1478,1,0,3,-3,1,0
404588,1,0,10,-10,10,0
131234,2,14,17,-3,8,1
121564,4,22,10,12,4,0
62056,4,26,10,16,12,1
300878,2,3,7,-4,15,0
73383,3,23,3,20,17,0
6013,4,17,36,-19,3,0
404281,1,0,3,-3,10,1
93106,1,0,0,0,9,1
306761,3,16,20,-4,17,0
278705,4,24,10,14,4,0
292185,3,21,7,14,11,0
136158,3,10,10,0,10,0
211526,3,36,14,22,9,0
179591,3,14,23,-9,12,1
124446,3,9,7,2,5,0
4097,3,16,28,-12,2,1
173454,2,0,7,-7,10,1
388488,3,3,16,-13,2,0
419946,4,19,18,1,17,0
393059,2,0,3,-3,4,1
147759,4,24,24,0,15,0
179017,4,19,3,16,12,1
55396,2,13,7,6,9,0
78121,2,7,3,4,2,0
234323,2,17,0,17,2,0
144396,2,0,3,-3,14,0
13571,2,3,0,3,7,0
287496,3,14,20,-6,9,0
330075,2,0,3,-3,11,1
299340,4,28,16,12,14,1
241609,4,6,27,-21,5,1
354748,2,6,3,3,4,1
269086,4,13,16,-3,17,1
187319,1,6,0,6,16,1
163780,3,10,12,-2,5,1
142684,4,20,20,0,13,0
153123,3,13,17,-4,1,1
33313,4,30,3,27,16,1
420545,4,10,42,-32,17,1
353317,4,38,28,10,4,0
174973,2,6,14,-8,10,0
56718,2,0,10,-10,9,0
376891,4,28,21,7,15,0
261872,3,6,20,-14,14,0
240779,3,10,7,3,5,0
5706,4,0,24,-24,3,1
346788,1,3,0,3,1,1
404075,4,10,49,-39,10,1
394949,4,10,17,-7,5,0
18196,4,23,20,3,9,0
288829,2,10,17,-7,9,0
13443,2,3,20,-17,7,0
184644,2,10,10,0,15,0
153879,3,7,3,4,1,0
256041,4,25,12,13,12,0
389788,2,10,6,4,3,0
33602,5,17,16,1,16,0
164217,3,27,35,-8,5,0
418584,2,14,3,11,16,1
332248,4,10,16,-6,12,0
235967,1,7,0,7,3,0
17103,3,23,3,20,9,0
195714,4,14,13,1,2,0
188285,3,14,13,1,16,1
14260,1,0,7,-7,7,1
218062,4,21,24,-3,12,0
289165,2,20,7,13,9,0
79284,2,12,3,9,2,1
113735,2,3,10,-7,17,0
184965,3,7,17,-10,15,0
359823,1,0,0,0,6,0
69180,4,17,17,0,15,0
277448,4,41,25,16,4,0
50968,1,0,7,-7,6,0
121129,1,0,3,-3,3,0
288187,1,3,7,-4,9,1
420405,4,20,20,0,17,0
236927,2,26,7,19,3,1
62958,1,0,7,-7,12,1
27183,2,13,7,6,13,0
269556,4,21,31,-10,1,1
265086,3,13,3,10,16,0
290091,4,10,9,1,10,1
182064,4,17,21,-4,13,1
91952,2,3,23,-20,8,1
86910,4,23,26,-3,5,0
279780,1,0,3,-3,5,1
178582,1,0,0,0,12,0
221117,2,0,6,-6,14,1
398413,4,10,37,-27,7,1
67525,4,39,14,25,14,1
103874,4,26,0,26,13,0
391783,4,10,13,-3,4,0
296582,1,0,0,0,13,1
131662,2,0,22,-22,8,1
57954,3,13,17,-4,10,0
244897,1,0,0,0,7,1
89557,3,0,26,-26,7,0
328470,3,6,3,3,10,1
201329,3,28,13,15,5,1
2249,3,10,10,0,1,0
158636,2,7,7,0,3,1
12873,3,13,6,7,6,0
363013,4,33,26,7,8,0
354858,4,33,41,-8,4,0
277126,4,10,17,-7,4,1
217720,2,7,0,7,12,0
102985,4,18,38,-20,13,1
324144,3,3,10,-7,8,0
231166,3,10,7,3,1,0
33042,1,0,0,0,16,1
284868,1,0,0,0,7,1
319551,4,22,23,-1,6,0
72641,2,13,0,13,16,0
290324,1,6,0,6,10,0
111097,3,24,0,24,16,0
65644,4,6,19,-13,13,1
351693,3,14,17,-3,3,0
201436,1,9,0,9,5,1
143283,1,0,0,0,14,0
235437,3,28,25,3,3,1
351793,2,17,14,3,3,1
110659,4,23,10,13,16,0
311751,2,0,13,-13,2,1
201273,1,7,0,7,5,1
386883,1,7,0,7,2,1
7710,2,10,0,10,4,0
384477,4,28,0,28,1,0
61426,3,16,3,13,11,0
148683,4,10,9,1,16,0
47182,3,6,3,3,5,0
228701,3,19,23,-4,17,1
73302,1,7,0,7,17,0
372323,3,24,10,14,13,0
384170,4,27,20,7,1,1
372847,1,0,0,0,13,1
224171,3,0,20,-20,15,0
132638,1,0,0,0,9,0
127716,1,0,7,-7,6,1
103287,4,3,10,-7,13,1
248735,2,17,7,10,9,1
354744,1,6,3,3,4,1
368875,3,31,3,28,11,0
34015,4,17,27,-10,16,0
245436,3,9,6,3,7,0
364896,4,13,20,-7,9,0
254585,2,7,13,-6,11,0
201281,2,14,0,14,5,0
173927,3,13,16,-3,10,0
295892,3,10,14,-4,12,1
337615,2,14,7,7,14,0
158345,2,13,17,-4,3,1
176550,4,19,17,2,11,0
203385,4,27,33,-6,6,0
359048,4,10,6,4,6,0
294907,1,0,7,-7,12,1
170422,2,21,3,18,8,0
404560,1,0,0,0,10,0
110383,4,27,24,3,16,1
239758,4,13,13,0,4,1
148183,3,6,21,-15,16,1
279273,3,19,13,6,5,0
178644,2,3,10,-7,12,0
343222,3,16,0,16,16,0
370360,4,20,35,-15,12,1
221590,3,20,18,2,14,1
165953,2,10,7,3,6,0
351833,3,20,14,6,3,1
402608,3,17,16,1,9,0
37382,3,17,0,17,17,1
7363,5,20,19,1,4,0
386602,1,0,7,-7,2,1
213628,1,7,7,0,10,1
92019,4,27,26,1,8,1
304576,4,31,31,0,16,0
186822,3,29,7,22,15,0
416665,4,34,7,27,15,1
401523,2,0,14,-14,8,1
255205,2,10,13,-3,12,0
187676,2,7,3,4,16,0
42371,3,13,9,4,2,1
419948,4,19,21,-2,17,0
147984,2,0,3,-3,15,1
6803,2,3,14,-11,3,1
347655,3,17,17,0,1,1
260212,2,10,3,7,14,1
207018,2,28,0,28,7,0
223525,2,7,10,-3,15,0
142032,4,20,14,6,13,1
280155,3,28,0,28,5,0
116012,3,13,0,13,1,1
285738,1,0,3,-3,8,0
175801,1,14,0,14,11,0
331251,1,0,0,0,11,0
216076,3,17,12,5,11,1
45585,2,7,13,-6,4,0
243374,1,0,7,-7,6,1
304648,2,14,7,7,16,0
379157,2,6,3,3,16,0
396691,2,7,7,0,6,1
412347,3,10,17,-7,13,1
101706,2,10,0,10,12,1
303255,1,10,0,10,16,0
111378,2,0,7,-7,16,0
243315,4,14,10,4,6,0
218739,2,0,13,-13,13,0
193998,2,14,7,7,1,0
247071,1,2,3,-1,8,0
328780,3,17,13,4,10,0
74216,2,3,7,-4,17,0
233825,4,32,40,-8,2,0
28956,2,0,7,-7,14,0
125650,4,21,24,-3,5,0
268010,3,14,9,5,17,1
130861,4,20,15,5,8,1
193096,3,13,6,7,1,0
156948,2,7,10,-3,2,0
245395,2,9,3,6,7,1
106796,4,26,22,4,14,1
95844,3,6,10,-4,10,1
87974,1,3,0,3,6,0
283578,2,6,17,-11,7,1
219557,4,21,21,0,13,1
156025,3,17,17,0,2,1
184630,2,10,10,0,15,1
266238,3,31,19,12,16,1
123427,1,0,0,0,4,0
161016,4,16,7,9,4,1
407865,2,6,7,-1,11,0
237218,2,3,0,3,3,1
308380,2,0,6,-6,1,1
285756,2,7,10,-3,8,1
46008,1,7,7,0,4,1
235972,1,7,0,7,3,1
390192,1,0,3,-3,3,1
301386,4,17,10,7,15,0
210349,4,16,17,-1,9,0
396432,3,20,25,-5,6,1
307542,4,38,25,13,17,0
222893,1,0,3,-3,14,1
2324,4,20,17,3,1,0
235981,1,10,0,10,3,0
128360,3,7,9,-2,7,0
8430,1,3,0,3,4,0
297653,2,7,3,4,13,1
10501,2,20,0,20,5,0
184347,2,7,6,1,14,0
237915,4,14,27,-13,4,0
137471,1,0,0,0,11,1
395467,2,7,0,7,6,0
42925,2,14,16,-2,3,0
395777,2,0,0,0,6,0
85579,4,20,22,-2,5,1
179190,1,7,0,7,12,0
372929,3,22,7,15,13,1
48289,3,13,13,0,5,0
366133,2,7,21,-14,10,0
301039,2,17,3,14,15,0
234115,1,0,0,0,2,0
353832,2,7,14,-7,4,0
80191,2,14,10,4,2,0
387176,4,10,41,-31,2,0
78718,2,13,7,6,2,1
251769,4,30,9,21,10,1
354912,1,0,0,0,4,1
231274,1,0,3,-3,1,1
133343,3,14,9,5,9,1
83077,2,6,14,-8,4,0
164110,4,12,6,6,5,1
322411,4,17,26,-9,7,0
128053,2,3,6,-3,7,0
292746,2,19,10,9,11,0
84780,4,13,31,-18,4,0
120491,5,39,41,-2,3,1
184402,3,24,6,18,14,1
10226,3,6,10,-4,5,1
175613,4,36,14,22,11,0
185226,2,10,6,4,15,1
146694,3,7,29,-22,15,0
373436,4,17,17,0,13,0
265110,3,13,10,3,16,1
55097,3,16,3,13,8,1
332413,1,7,3,4,12,0
212796,3,17,21,-4,10,1
12492,1,0,0,0,6,0
419101,1,0,0,0,16,1
108747,4,44,19,25,15,1
204712,2,7,13,-6,6,0
136517,1,0,6,-6,11,0
295779,4,24,24,0,12,1
389726,1,3,0,3,3,0
373031,2,0,0,0,13,1
163338,4,22,23,-1,5,1
209107,3,9,27,-18,8,1
53812,5,10,10,0,8,1
400178,1,0,3,-3,8,0
105764,4,37,10,27,14,1
373227,3,3,13,-10,13,1
84597,3,13,10,3,4,0
84500,4,20,17,3,4,1
306841,1,0,3,-3,17,0
403565,2,17,0,17,9,0
301896,2,0,13,-13,15,1
43628,1,7,3,4,3,0
17753,4,24,21,3,9,1
223299,4,6,12,-6,15,0
259626,3,6,3,3,13,0
408089,4,20,17,3,12,0
206917,4,10,23,-13,7,1
133108,1,0,0,0,9,0
370026,3,10,7,3,12,0
203838,4,24,24,0,6,0
238237,3,3,16,-13,4,0
202985,1,14,0,14,5,1
80087,4,24,22,2,2,0
349208,4,27,21,6,2,1
234774,2,0,3,-3,2,0
154194,4,10,13,-3,1,0
403775,3,12,16,-4,9,1
275908,3,13,12,1,3,0
45490,3,27,20,7,4,0
273153,2,10,0,10,2,0
420936,2,7,14,-7,17,1
266721,1,0,0,0,16,0
140428,2,7,7,0,12,0
163541,2,7,3,4,5,0
401555,2,14,14,0,8,1
30939,4,17,24,-7,15,0
353621,1,0,0,0,4,1
319577,1,0,0,0,6,1
284316,2,6,10,-4,7,0
182657,3,0,12,-12,14,1
100956,3,10,10,0,12,0
46018,2,14,7,7,4,0
344418,3,28,24,4,17,1
185274,3,27,9,18,15,0
32211,2,14,7,7,15,1
348252,3,16,39,-23,1,1
223306,4,6,12,-6,15,1
186677,4,27,3,24,15,0
125139,2,14,7,7,5,0
87867,2,10,12,-2,6,0
151874,1,10,0,10,17,1
4606,2,10,7,3,2,0
291586,3,20,3,17,11,1
38254,3,13,14,-1,1,0
133552,1,0,0,0,9,0
173763,2,10,3,7,10,0
149816,2,3,10,-7,16,0
90923,4,48,7,41,7,1
323783,2,6,3,3,8,0
386811,3,10,7,3,2,0
84987,2,16,7,9,4,1
379991,1,0,0,0,16,1
202867,2,14,0,14,5,1
332420,2,7,3,4,12,1
386216,3,9,10,-1,2,1
376929,1,3,3,0,15,0
346927,1,0,3,-3,1,1
89664,2,6,10,-4,7,1
269664,3,10,0,10,1,0
406434,4,31,7,24,11,0
417671,3,21,6,15,16,1
70496,4,30,20,10,15,0
123634,2,0,9,-9,4,1
130913,1,0,7,-7,8,0
51318,2,16,17,-1,7,0
120535,1,0,6,-6,3,1
379039,2,7,6,1,15,0
73212,2,7,6,1,16,1
291603,3,23,3,20,11,0
138085,4,49,24,25,11,1
118613,1,0,0,0,2,0
223344,1,0,3,-3,15,0
261862,3,6,20,-14,14,0
227817,4,6,35,-29,16,1
199351,2,0,3,-3,4,1
73802,3,6,0,6,17,1
3260,2,3,0,3,2,1
193336,1,7,0,7,1,0
104122,3,17,20,-3,13,0
226811,4,14,23,-9,16,1
322311,2,7,7,0,7,1
162764,1,0,0,0,5,0
234813,2,0,3,-3,2,0
381241,3,14,10,4,16,1
89410,3,10,20,-10,7,0
115866,2,7,13,-6,1,0
353443,4,25,3,22,4,0
378655,5,23,23,0,15,0
240776,2,10,7,3,5,1
205178,2,7,10,-3,6,1
172218,2,7,13,-6,9,1
177490,4,27,17,10,11,0
40203,4,34,7,27,2,1
59710,1,0,0,0,11,0
42589,1,0,0,0,3,0
404673,4,20,29,-9,10,1
391314,3,17,3,14,4,1
238017,3,10,13,-3,4,1
341091,3,14,17,-3,15,0
277921,4,7,26,-19,4,0
343482,2,7,7,0,16,1
157006,4,13,13,0,2,0
220693,3,10,3,7,13,0
216034,2,10,12,-2,11,1
282117,3,16,8,8,6,1
309851,3,14,7,7,1,1
19927,4,16,21,-5,10,1
332204,3,10,16,-6,12,1
190363,2,7,0,7,17,0
52239,3,7,16,-9,7,1
399159,1,0,3,-3,7,1
139544,2,6,0,6,12,0
30068,4,46,7,39,14,0
133022,3,9,14,-5,9,1
395703,4,18,34,-16,6,0
12591,4,3,24,-21,6,0
231568,1,7,3,4,1,0
262892,3,14,23,-9,15,1
333137,1,0,0,0,12,1
252430,1,0,0,0,10,1
359295,2,3,13,-10,6,1
249710,3,21,14,7,9,0
15206,2,6,0,6,8,1
269947,2,16,10,6,1,0
286877,2,9,7,2,8,0
330669,2,6,3,3,11,1
196949,2,14,0,14,3,0
225837,4,24,21,3,16,0
163446,3,7,23,-16,5,1
303857,1,0,0,0,16,0
418776,4,14,21,-7,16,0
262028,3,24,24,0,14,1
96457,2,10,14,-4,10,0
147289,3,0,31,-31,15,1
232643,2,0,0,0,1,1
76866,1,0,0,0,1,0
414317,4,21,42,-21,14,0
221562,2,20,12,8,14,0
413528,2,0,3,-3,14,0
284669,4,14,27,-13,7,0
102707,1,0,0,0,13,0
297428,4,30,24,6,13,1
214265,2,14,10,4,11,0
363129,3,7,3,4,8,1
67549,1,0,0,0,14,0
85990,3,14,16,-2,5,1
123829,3,10,3,7,5,1
18109,2,3,17,-14,9,0
202317,3,13,3,10,5,1
62837,1,3,0,3,12,1
147974,1,0,0,0,15,0
332805,4,28,16,12,12,1
213428,4,10,41,-31,10,0
395241,3,10,13,-3,5,0
327513,1,0,7,-7,10,1
96645,4,3,10,-7,10,0
278484,3,36,0,36,4,0
387357,1,14,0,14,2,1
51039,3,0,20,-20,6,1
273570,1,0,3,-3,2,1
191320,1,0,0,0,17,1
58463,4,48,17,31,10,0
184403,3,24,6,18,14,0
57507,3,21,10,11,10,1
240390,5,24,23,1,5,1
43272,4,24,10,14,3,0
390842,2,0,28,-28,3,1
417561,4,31,28,3,16,0
383531,3,14,13,1,17,1
22862,2,0,10,-10,11,0
395289,4,13,19,-6,5,0
87327,4,24,24,0,6,1
337127,1,0,0,0,14,1
160852,4,34,24,10,4,1
174924,1,0,7,-7,10,1
309262,2,0,10,-10,1,1
139491,1,0,0,0,12,1
85302,2,7,3,4,5,1
159568,3,17,6,11,3,1
334745,4,25,9,16,13,1
142142,3,0,7,-7,13,1
51125,1,7,0,7,7,0
58159,4,23,17,6,10,1
107944,3,6,6,0,15,1
265957,3,0,30,-30,16,0
172124,4,13,18,-5,9,1
396163,4,24,23,1,6,0
187171,1,0,0,0,16,1
195927,2,0,17,-17,2,0
11648,2,14,0,14,6,0
47469,1,3,0,3,5,0
396418,3,20,18,2,6,1
203381,4,27,33,-6,6,0
328698,1,0,0,0,10,1
392816,3,17,6,11,4,0
400575,4,13,24,-11,8,0
163251,2,3,6,-3,5,1
367803,1,3,7,-4,10,1
271326,4,9,24,-15,1,1
297923,2,10,0,10,13,0
290045,2,7,6,1,10,1
398942,4,16,10,6,7,0
81201,1,0,0,0,3,0
1912,1,0,0,0,1,0
240233,4,16,18,-2,5,0
37625,2,10,0,10,17,0
125858,1,3,9,-6,6,0
264393,2,3,14,-11,15,0
351517,2,0,27,-27,3,0
411231,4,11,23,-12,13,0
391066,1,0,0,0,4,0
24248,3,13,17,-4,12,1
134002,1,0,0,0,9,1
364132,3,24,3,21,9,1
72979,4,38,15,23,16,1
388361,4,17,12,5,2,0
402704,2,3,0,3,9,1
74248,3,3,10,-7,17,0
339052,4,20,10,10,15,0
158501,2,10,10,0,3,0
92950,1,0,0,0,8,1
16973,4,27,20,7,8,0
307961,3,7,6,1,1,0
129996,2,0,10,-10,8,0
24510,2,7,7,0,12,1
325558,1,0,0,0,9,1
279109,3,21,16,5,5,0
42071,3,20,10,10,2,1
135486,1,7,6,1,10,1
132358,1,0,0,0,9,1
44496,4,27,20,7,3,0
142181,4,2,10,-8,13,0
164013,1,0,3,-3,5,0
7215,2,0,13,-13,4,1
223885,3,30,6,24,15,0
127158,3,10,9,1,6,0
294693,3,6,14,-8,12,0
117099,4,7,24,-17,2,0
58765,3,10,23,-13,10,0
266135,4,17,13,4,16,0
54621,2,14,6,8,8,0
84365,4,28,30,-2,4,1
324430,3,14,3,11,8,0
93502,4,3,31,-28,9,0
179763,3,6,17,-11,12,0
262121,2,14,3,11,15,1
401921,1,0,0,0,9,0
303303,3,27,0,27,16,1
222710,4,14,24,-10,14,1
213342,2,10,6,4,10,0
275075,4,34,20,14,3,0
36319,2,7,7,0,17,0
377369,2,0,0,0,15,0
354180,2,3,7,-4,4,1
228559,4,20,14,6,17,0
238218,3,3,16,-13,4,1
314297,1,0,14,-14,3,1
304930,2,7,3,4,16,0
103730,4,3,23,-20,13,1
372162,2,9,10,-1,13,1
124213,1,0,14,-14,5,1
376415,4,15,9,6,14,1
40523,4,7,20,-13,2,0
370346,4,20,35,-15,12,0
5725,4,0,24,-24,3,0
360499,4,17,12,5,7,0
172536,2,0,7,-7,9,0
55045,1,7,0,7,8,1
184067,1,6,0,6,14,0
97124,4,34,6,28,10,1
331366,4,8,33,-25,11,1
182328,3,17,7,10,14,0
297105,3,24,0,24,13,1
245181,4,17,28,-11,7,1
8437,1,3,0,3,4,0
45847,1,0,0,0,4,1
344219,2,7,3,4,17,0
370734,2,12,7,5,12,0
182613,2,0,6,-6,14,1
342712,2,0,7,-7,16,0
234897,1,0,0,0,2,1
31369,4,7,3,4,15,0
158506,3,10,10,0,3,0
36429,1,0,0,0,17,0
218395,1,3,7,-4,13,0
380642,2,7,7,0,16,0
163344,4,22,23,-1,5,0
174954,2,6,13,-7,10,0
251806,1,0,7,-7,10,1
210944,4,26,16,10,9,1
238589,4,23,20,3,4,0
148870,1,0,6,-6,16,1
188352,1,0,0,0,16,1
396642,1,0,0,0,6,0
413746,4,24,16,8,14,0
4417,4,14,14,0,2,0
406667,2,14,0,14,11,0
211818,2,14,7,7,9,0
53354,1,3,7,-4,8,0
310652,3,13,30,-17,2,0
167151,1,6,0,6,7,0
63236,4,17,33,-16,12,1
374919,4,14,25,-11,14,0
289142,2,13,6,7,9,0
362478,2,7,6,1,8,0
60734,4,28,3,25,11,0
323415,4,20,0,20,7,1
392969,3,9,9,0,4,0
195318,1,0,0,0,2,1
415229,1,0,0,0,15,0
28832,2,10,7,3,14,1
232263,4,18,12,6,1,0
151217,3,17,20,-3,17,0
31060,3,13,13,0,15,1
7495,4,29,6,23,4,0
392951,2,6,3,3,4,1
251997,2,13,13,0,10,1
240161,3,16,3,13,5,1
218111,1,7,0,7,12,1
383833,3,3,7,-4,1,0
97795,2,7,9,-2,11,0
175123,2,27,10,17,10,1
121732,4,21,28,-7,4,0
409863,3,23,0,23,12,0
279818,2,7,6,1,5,1
215148,1,7,3,4,11,1
414362,1,7,3,4,14,0
405170,4,12,16,-4,10,0
365294,3,10,16,-6,9,1
290026,2,7,0,7,10,0
185233,2,10,6,4,15,1
97992,3,17,10,7,11,1
9281,1,7,0,7,5,1
90174,3,3,0,3,7,1
278697,4,24,10,14,4,1
24346,2,3,0,3,12,0
365106,2,0,7,-7,9,1
206214,2,0,3,-3,7,1
212848,5,24,24,0,10,0
34891,3,20,10,10,16,1
2443,4,28,13,15,2,0
291026,4,20,13,7,10,1
402822,1,0,0,0,9,1
198057,4,3,30,-27,3,0
100357,3,9,20,-11,12,0
315469,1,0,0,0,4,1
112171,4,13,27,-14,17,0
392798,2,17,3,14,4,1
106187,4,0,10,-10,14,1
406583,4,20,37,-17,11,1
65396,1,0,7,-7,13,0
46914,3,20,20,0,5,0
74787,2,6,3,3,17,1
99889,2,0,3,-3,12,0
320868,3,3,14,-11,6,1
409475,1,0,0,0,12,0
411491,3,13,17,-4,13,0
36639,2,10,3,7,17,1
238518,3,13,6,7,4,1
23217,3,23,13,10,11,1
352253,3,3,3,0,3,0
253036,1,0,0,0,11,1
232292,1,3,0,3,1,0
237783,1,0,7,-7,4,0
331677,1,0,0,0,12,0
76946,3,14,13,1,1,1
55147,4,29,17,12,8,0
221932,4,19,19,0,14,1
8393,4,30,10,20,4,1
277233,2,0,13,-13,4,0
290582,4,26,20,6,10,0
418730,2,0,7,-7,16,1
227493,3,19,10,9,16,0
277667,1,7,0,7,4,1
181139,4,24,14,10,13,1
251901,4,14,19,-5,10,1
30123,2,10,7,3,14,0
142372,4,7,6,1,13,1
337788,2,23,6,17,14,1
255527,3,30,7,23,12,0
86426,3,20,7,13,5,1
75719,2,21,10,11,1,0
86550,2,23,3,20,5,0
68951,2,14,7,7,15,0
123536,3,13,10,3,4,0
78169,3,20,3,17,2,1
160322,3,3,14,-11,4,0
418305,3,6,14,-8,16,0
268620,3,7,12,-5,17,0
197065,1,0,6,-6,3,0
269074,3,13,16,-3,17,0
145744,2,7,10,-3,15,0
73900,1,13,0,13,17,1
324148,3,3,10,-7,8,0
362294,1,0,0,0,8,0
54754,2,3,0,3,8,1
75871,2,14,7,7,1,0
194712,1,0,0,0,2,0
124810,1,0,3,-3,5,0
346495,2,17,17,0,1,1
296842,4,21,13,8,13,1
196221,2,7,9,-2,2,0
114241,4,10,17,-7,1,1
307907,1,0,0,0,1,0
258309,3,21,19,2,13,1
171201,3,6,14,-8,8,1
289209,4,20,13,7,9,1
333171,1,0,0,0,12,1
268446,2,14,9,5,17,0
5003,1,0,0,0,3,1
419256,1,0,0,0,16,0
339252,2,21,0,21,15,0
381285,4,24,20,4,16,1
183314,4,22,20,2,14,1
90084,1,0,0,0,7,1
336004,3,13,18,-5,13,0
156285,1,3,0,3,2,1
239790,4,20,20,0,4,0
184742,1,7,0,7,15,0
148887,1,3,6,-3,16,1
158042,2,3,6,-3,3,1
194669,4,34,7,27,2,0
106879,2,9,0,9,14,0
178084,5,23,23,0,12,1
230758,3,9,27,-18,1,1
285270,2,14,6,8,7,1
400723,4,16,17,-1,8,1
345207,1,7,7,0,17,0
66101,4,10,6,4,13,1
341086,3,14,17,-3,15,0
191881,4,29,10,19,1,0
33744,1,0,0,0,16,1
63238,4,17,33,-16,12,1
327366,2,0,7,-7,9,0
355345,4,14,26,-12,4,1
122764,4,10,27,-17,4,0
411875,1,7,0,7,13,1
56310,3,3,26,-23,9,1
286789,4,20,31,-11,8,1
363109,2,7,3,4,8,0
158067,3,22,9,13,3,0
255069,3,6,21,-15,12,0
252923,2,6,0,6,11,0
198606,2,0,0,0,3,0
91241,4,20,17,3,8,1
137999,2,13,14,-1,11,0
283154,3,13,9,4,7,0
18371,4,25,20,5,9,0
235222,2,12,0,12,3,0
368810,1,0,0,0,11,1
194200,4,6,17,-11,1,1
270400,2,10,0,10,1,0
12513,2,0,17,-17,6,1
339578,2,10,14,-4,15,1
414808,1,7,0,7,15,0
282492,2,7,3,4,6,0
200871,2,14,0,14,4,1
162958,2,6,0,6,5,1
28918,1,0,0,0,14,0
65053,4,3,17,-14,13,1
125141,2,14,7,7,5,0
192350,4,27,27,0,1,1
239161,3,13,16,-3,4,1
96956,4,22,10,12,10,1
258771,4,3,37,-34,13,0
301450,2,16,3,13,15,1
3209,4,16,9,7,2,1
236436,1,0,0,0,3,1
251721,3,24,3,21,10,0
369547,2,11,0,11,11,1
117428,1,0,0,0,2,1
141299,1,0,7,-7,13,0
403051,4,24,24,0,9,0
335241,1,0,0,0,13,0
28931,1,0,0,0,14,1
8992,1,0,0,0,4,1
295923,4,13,23,-10,12,0
293887,1,0,7,-7,12,1
63649,4,20,33,-13,12,0
138916,1,0,3,-3,12,1
104910,2,3,3,0,14,0
96007,2,6,7,-1,10,1
150890,2,0,7,-7,17,1
33647,2,14,0,14,16,0
94103,1,0,0,0,9,1
289216,4,23,13,10,9,1
318566,2,10,0,10,5,0
384935,1,0,0,0,1,1
225118,4,16,14,2,15,0
338892,4,13,25,-12,15,1
134694,4,37,31,6,10,0
360813,4,24,36,-12,7,0
286485,1,0,0,0,8,1
372212,4,9,25,-16,13,1
212999,1,0,0,0,10,1
350351,3,24,10,14,2,1
183090,2,7,3,4,14,1
243867,2,12,3,9,6,1
281525,4,17,13,4,6,1
182772,2,10,3,7,14,1
304127,4,16,30,-14,16,1
215007,2,10,0,10,11,1
132818,2,3,7,-4,9,1
144033,4,21,16,5,14,0
15274,4,30,7,23,8,0
389925,2,15,10,5,3,1
19836,1,10,7,3,10,0
137868,2,17,6,11,11,0
307404,1,0,0,0,17,0
46770,3,7,20,-13,4,1
110280,2,0,17,-17,16,1
409959,2,3,21,-18,12,1
18081,1,0,14,-14,9,1
160185,3,27,7,20,3,1
401927,1,0,3,-3,9,1
116848,2,7,7,0,2,1
93440,3,3,14,-11,9,0
207149,2,7,10,-3,7,1
150553,1,3,3,0,17,0
153951,1,7,0,7,1,0
282704,4,6,20,-14,6,1
96640,4,3,10,-7,10,1
119392,1,0,14,-14,3,0
84130,2,7,0,7,4,0
74679,3,7,17,-10,17,1
138362,4,30,7,23,11,0
250006,2,7,6,1,9,1
199523,2,17,0,17,4,0
350784,4,17,3,14,2,0
191418,3,0,31,-31,17,0
129128,4,34,28,6,7,0
272967,1,3,0,3,2,0
14725,2,14,0,14,7,1
391720,3,3,10,-7,4,1
115183,4,13,30,-17,1,1
365513,4,17,25,-8,9,1
41013,2,3,10,-7,2,0
224330,3,16,12,4,15,1
390871,3,9,28,-19,3,1
244187,2,13,7,6,6,1
9837,4,20,17,3,5,1
209592,4,41,34,7,8,1
260725,1,0,0,0,14,1
395013,2,0,14,-14,5,0
150083,4,34,12,22,16,1
417857,3,10,10,0,16,1
35100,4,15,27,-12,16,0
92509,1,7,0,7,8,1
233610,3,20,41,-21,2,1
17428,4,17,7,10,9,0
172242,3,14,13,1,9,1
24217,2,10,7,3,12,0
337102,4,26,15,11,14,1
355355,1,3,0,3,4,0
12428,3,10,6,4,6,0
360339,3,7,20,-13,7,0
44399,2,3,0,3,3,0
405279,3,14,7,7,10,0
162210,3,13,20,-7,4,1
348088,3,0,19,-19,1,1
155261,4,28,14,14,1,0
253351,1,7,0,7,11,0
3902,2,19,7,12,2,1
372108,1,3,7,-4,13,1
276195,3,24,3,21,3,1
77382,3,7,14,-7,1,0
161374,1,0,0,0,4,0
388399,1,0,0,0,2,0
160095,4,23,39,-16,3,0
291721,2,0,6,-6,11,0
366799,1,0,0,0,10,1
54265,4,0,6,-6,8,1
308221,2,7,10,-3,1,0
120205,1,7,0,7,3,0
88642,3,20,10,10,6,1
209880,3,16,16,0,8,0
299781,4,17,17,0,14,1
32503,2,13,3,10,15,1
149938,1,7,0,7,16,0
326376,3,20,10,10,9,0
86266,2,13,17,-4,5,0
193922,4,31,17,14,1,0
108368,2,0,14,-14,15,0
353478,4,31,12,19,4,0
376570,3,15,6,9,14,1
86124,2,28,3,25,5,1
11165,1,0,0,0,6,0
256190,4,30,22,8,12,1
149806,2,3,7,-4,16,0
317795,2,9,3,6,5,1
12496,1,0,0,0,6,0
206547,2,0,3,-3,7,0
236143,2,0,10,-10,3,1
158311,2,6,14,-8,3,1
6115,3,7,10,-3,3,1
302291,1,0,0,0,15,1
372103,1,3,6,-3,13,0
405675,1,0,0,0,10,1
69675,1,0,7,-7,15,1
262677,1,0,0,0,15,1
109755,4,13,0,13,16,0
121623,1,0,0,0,4,0
374453,3,32,0,32,14,0
126755,4,13,13,0,6,0
155973,2,3,14,-11,2,1
36343,2,13,10,3,17,0
64117,1,0,0,0,13,0
36024,1,7,0,7,17,0
347858,4,16,8,8,1,1
232227,3,15,12,3,1,0
54237,3,0,3,-3,8,0
179654,5,31,30,1,12,1
143825,3,12,7,5,14,0
236058,3,36,10,26,3,1
154823,4,24,23,1,1,1
75957,4,35,7,28,1,1
189811,3,17,17,0,17,1
122209,1,3,7,-4,4,0
338939,1,3,0,3,15,1
57012,2,7,10,-3,9,0
149326,4,20,27,-7,16,1
336125,2,10,3,7,13,1
163270,2,6,6,0,5,1
262614,3,23,9,14,15,0
55061,2,13,3,10,8,1
194787,3,10,16,-6,2,0
222484,2,6,14,-8,14,1
232664,3,7,0,7,1,0
131204,2,7,10,-3,8,1
9518,4,13,13,0,5,1
60288,4,17,19,-2,11,0
170830,1,7,0,7,8,0
17886,4,24,17,7,9,0
219978,3,6,21,-15,13,1
140236,5,13,13,0,12,0
260234,3,10,3,7,14,1
42318,1,0,9,-9,2,0
94354,3,17,7,10,9,0
135240,3,13,3,10,10,0
319935,2,23,7,16,6,0
359418,1,0,0,0,6,0
339771,4,24,6,18,15,0
291799,4,9,23,-14,11,1
93166,2,0,3,-3,9,0
19059,4,10,6,4,10,1
315955,2,0,7,-7,4,0
397030,3,21,9,12,6,1
145434,2,9,14,-5,14,0
255949,2,6,6,0,12,0
159031,1,0,0,0,3,1
204162,4,16,17,-1,6,1
358227,1,0,7,-7,6,0
320086,2,10,0,10,6,0
161366,1,0,0,0,4,1
230659,1,0,7,-7,1,1
124292,3,34,17,17,5,0
119871,5,24,24,0,3,1
158068,3,22,9,13,3,0
120338,1,0,0,0,3,0
386684,4,17,13,4,2,1
370862,2,3,3,0,12,1
202961,1,0,0,0,5,1
27456,2,10,0,10,13,0
252623,2,6,3,3,10,1
408469,2,7,3,4,12,1
110558,1,10,0,10,16,0
261714,3,14,7,7,14,1
138047,3,29,17,12,11,0
202764,3,16,17,-1,5,0
33304,4,23,3,20,16,1
44538,1,0,7,-7,3,1
347512,4,12,30,-18,1,1
190149,4,30,3,27,17,0
391303,3,17,3,14,4,0
273813,3,10,7,3,2,1
42373,3,14,9,5,2,0
49042,3,10,10,0,6,0
199054,2,0,14,-14,4,1
63084,4,23,42,-19,12,1
226060,1,0,7,-7,16,1
190121,3,27,3,24,17,1
357492,1,0,6,-6,5,1
184483,2,7,7,0,14,1
251609,4,19,20,-1,10,0
57907,2,10,10,0,10,1
250643,2,3,12,-9,10,0
397870,2,0,3,-3,7,0
93183,3,0,3,-3,9,1
344484,1,0,0,0,17,0
267651,2,0,21,-21,17,1
5753,1,7,0,7,3,1
291912,4,17,10,7,11,1
18489,4,17,14,3,9,0
74783,2,3,3,0,17,1
56995,1,0,10,-10,9,1
28309,1,0,0,0,14,1
325100,1,3,0,3,8,1
249416,4,18,15,3,9,0
188984,1,0,0,0,16,1
418164,3,24,3,21,16,0
300748,2,7,6,1,15,0
173513,4,10,27,-17,10,1
68846,3,6,17,-11,15,0
167567,4,3,17,-14,7,1
99804,3,0,21,-21,12,0
141290,1,0,0,0,13,0
171806,3,23,14,9,9,0
182214,4,33,7,26,13,0
67255,4,7,3,4,14,1
284245,4,16,33,-17,7,1
387618,4,13,6,7,2,0
336527,2,0,0,0,14,1
235968,1,7,0,7,3,0
336711,2,3,3,0,14,1
153708,2,2,21,-19,1,1
180658,3,24,6,18,13,1
82150,2,3,3,0,3,1
192922,2,7,10,-3,1,0
213553,3,10,14,-4,10,1
348629,1,0,0,0,2,0
238449,1,0,0,0,4,1
318622,4,10,13,-3,5,0
151419,1,7,0,7,17,0
262514,4,28,35,-7,15,0
318494,4,31,7,24,5,1
150189,3,6,26,-20,16,0
252678,4,6,9,-3,10,0
5470,1,0,3,-3,3,1
334388,2,7,10,-3,13,0
304020,2,0,13,-13,16,1
35623,2,7,3,4,17,1
308998,3,0,17,-17,1,1
417924,1,0,0,0,16,0
386778,2,7,7,0,2,1
8415,1,0,0,0,4,1
304163,1,0,0,0,16,1
17029,1,7,0,7,9,0
241334,1,0,0,0,5,0
365428,2,7,12,-5,9,0
374133,2,16,7,9,13,1
266431,1,0,0,0,16,0
108062,2,6,14,-8,15,1
308218,2,7,10,-3,1,0
400710,4,16,10,6,8,0
317251,4,7,16,-9,5,1
153803,4,2,27,-25,1,1
293505,2,10,10,0,11,0
405264,2,14,7,7,10,1
181320,4,3,23,-20,13,0
135382,3,21,17,4,10,0
301495,3,20,12,8,15,1
209636,1,0,0,0,8,1
181061,2,7,0,7,13,0
230351,4,26,17,9,17,0
249317,1,3,0,3,9,1
315061,3,30,14,16,4,1
242703,1,7,0,7,6,1
325429,1,13,0,13,8,0
102801,3,10,3,7,13,0
67750,3,21,0,21,14,1
316157,4,24,26,-2,4,0
327242,2,6,3,3,9,0
5543,3,16,10,6,3,0
137218,2,7,3,4,11,1
225998,4,34,20,14,16,0
292461,2,10,6,4,11,0
154276,2,6,14,-8,1,1
181149,4,24,14,10,13,1
169059,3,26,14,12,7,1
159765,4,7,13,-6,3,0
203729,1,0,0,0,6,0
53489,1,0,0,0,8,1
324808,1,0,0,0,8,1
173890,2,6,10,-4,10,1
130710,4,7,45,-38,8,0
407026,4,11,34,-23,11,0
5188,1,0,3,-3,3,1
33489,1,7,0,7,16,1
122624,4,27,7,20,4,0
215234,4,10,16,-6,11,1
70952,4,15,39,-24,15,0
8675,4,7,10,-3,4,0
233808,4,19,37,-18,2,1
90295,2,7,14,-7,7,0
303435,2,16,7,9,16,1
150401,1,7,0,7,16,0
234383,4,17,10,7,2,1
392763,2,14,3,11,4,0
147444,4,23,10,13,15,1
135093,3,17,6,11,10,1
302586,1,0,0,0,15,1
301573,1,7,0,7,15,0
172626,5,24,24,0,9,1
198108,1,0,0,0,3,0
296930,3,19,0,19,13,1
117093,4,7,24,-17,2,1
163817,4,17,22,-5,5,1
362385,4,30,20,10,8,1
99576,1,0,0,0,11,0
191859,3,20,10,10,1,0
60656,2,7,3,4,11,1
174784,2,13,7,6,10,0
202974,1,7,0,7,5,0
50107,2,0,17,-17,6,1
89817,2,6,3,3,7,0
379191,3,9,10,-1,16,0
250421,1,0,0,0,9,0
129457,4,23,23,0,7,0
33824,3,0,31,-31,16,1
192496,3,14,17,-3,1,0
163178,4,28,28,0,5,1
322089,3,26,0,26,7,0
368857,2,24,0,24,11,0
52186,2,0,3,-3,7,1
145592,2,21,0,21,14,0
142176,4,2,10,-8,13,1
65876,2,7,7,0,13,1
371952,1,0,0,0,13,1
184748,1,7,0,7,15,1
317951,2,10,3,7,5,0
90954,1,0,0,0,7,0
287666,3,9,10,-1,9,1
278405,1,0,0,0,4,0
132108,2,10,0,10,9,0
281498,3,10,10,0,6,0
60343,2,3,0,3,11,0
219357,3,16,13,3,13,1
413833,2,14,0,14,14,0
215094,4,19,7,12,11,1
401680,2,0,14,-14,8,1
362163,1,3,0,3,8,1
313427,2,14,7,7,3,0
199887,4,10,24,-14,4,1
408139,2,3,0,3,12,1
124353,1,0,0,0,5,0
13660,4,19,17,2,7,1
170105,2,7,3,4,8,0
195150,1,0,0,0,2,0
232352,3,6,15,-9,1,1
340726,1,0,0,0,15,0
309373,2,0,0,0,1,1
87346,1,0,0,0,6,0
375782,2,13,0,13,14,1
339567,2,10,7,3,15,1
213516,2,10,7,3,10,0
147363,1,0,0,0,15,0
94531,3,3,10,-7,9,0
275573,1,14,0,14,3,0
107568,1,0,7,-7,15,1
209545,2,34,17,17,8,0
213690,3,14,17,-3,10,0
266812,3,10,14,-4,16,1
58509,1,0,3,-3,10,0
418797,4,14,24,-10,16,1
370667,4,21,14,7,12,1
36699,4,20,10,10,17,1
300646,3,10,3,7,15,1
341829,2,13,9,4,16,0
398602,2,0,0,0,7,0
212136,2,3,14,-11,10,0
293373,2,7,10,-3,11,1
137373,2,3,14,-11,11,1
247535,2,6,10,-4,8,1
172095,3,10,9,1,9,0
165604,1,0,0,0,6,0
198593,2,0,0,0,3,0
261521,2,9,0,9,14,1
160235,4,37,14,23,3,1
104453,2,0,10,-10,13,1
202717,2,6,10,-4,5,0
296295,2,3,10,-7,13,0
86660,1,7,0,7,5,1
229533,2,17,6,11,17,1
42462,1,0,5,-5,3,1
55827,2,0,7,-7,9,1
79592,2,14,0,14,2,0
403101,5,34,34,0,9,1
316526,1,0,0,0,4,0
139188,4,19,13,6,12,1
206511,1,0,0,0,7,0
323370,2,17,0,17,7,0
217989,2,14,10,4,12,1
389696,4,27,16,11,3,0
374963,1,7,6,1,14,0
120213,1,7,0,7,3,1
222403,4,24,10,14,14,0
17828,2,13,10,3,9,1
151622,3,16,13,3,17,1
364921,4,16,23,-7,9,0
376906,1,0,0,0,15,0
244221,2,13,7,6,6,1
214454,3,7,14,-7,11,0
230205,4,3,32,-29,17,0
65028,3,0,17,-17,13,0
387687,2,0,7,-7,2,0
137350,1,3,7,-4,11,0
124528,1,6,0,6,5,0
370003,2,10,7,3,12,0
193483,4,33,20,13,1,1
324466,4,17,6,11,8,0
321600,2,10,6,4,7,0
271689,1,6,3,3,2,0
156452,2,0,3,-3,2,0
391209,4,10,24,-14,4,0
264430,3,3,28,-25,15,1
23501,3,14,14,0,11,0
227409,1,0,7,-7,16,1
235486,1,0,0,0,3,1
227662,4,42,7,35,16,1
212604,2,7,17,-10,10,0
202031,4,17,17,0,5,1
121637,1,0,7,-7,4,1
409382,2,10,3,7,12,1
200653,4,35,28,7,4,0
59192,2,14,41,-27,10,0
216650,2,14,6,8,12,0
104516,4,14,31,-17,13,1
144061,1,7,0,7,14,1
389435,1,0,0,0,3,1
321361,4,29,22,7,6,1
360237,1,0,0,0,7,0
196462,4,20,28,-8,2,1
276253,4,31,17,14,3,0
203121,1,0,7,-7,5,1
192055,4,31,27,4,1,0
396931,4,34,33,1,6,1
294026,2,7,7,0,12,1
222616,2,7,7,0,14,0
285916,2,20,0,20,8,1
280124,2,21,0,21,5,0
373808,2,13,0,13,13,0
88081,4,24,3,21,6,1
43417,4,21,24,-3,3,1
14878,2,7,0,7,7,0
4841,4,34,3,31,3,1
230115,2,3,10,-7,17,0
38956,2,23,0,23,1,0
151971,4,33,27,6,17,1
218237,1,0,0,0,12,1
257271,4,19,26,-7,12,1
390687,2,3,3,0,3,1
239388,2,3,7,-4,4,1
101261,3,10,7,3,12,0
72622,2,13,0,13,16,0
185292,4,34,22,12,15,0
408745,2,10,7,3,12,1
373316,1,0,0,0,13,1
390746,4,13,20,-7,3,1
306174,3,10,3,7,17,1
172231,3,7,13,-6,9,1
44473,4,17,12,5,3,0
331171,3,7,13,-6,11,1
29445,3,7,14,-7,14,0
136460,3,10,13,-3,11,1
245415,2,9,3,6,7,0
151057,3,10,10,0,17,1
3570,2,14,7,7,2,1
122123,2,17,14,3,4,0
283532,1,6,7,-1,7,0
358661,1,0,0,0,6,0
345571,3,14,20,-6,17,0
230890,3,14,10,4,1,1
403211,4,24,17,7,9,0
330031,1,0,0,0,11,0
180946,3,17,7,10,13,0
381849,3,18,21,-3,17,0
93816,1,0,0,0,9,1
123507,2,7,3,4,4,0
367321,4,6,17,-11,10,0
98435,2,14,7,7,11,0
92830,2,14,0,14,8,1
221504,4,10,41,-31,14,1
274679,2,7,9,-2,3,1
164351,3,20,0,20,5,0
38782,2,0,10,-10,1,1
249304,1,0,0,0,9,1
259198,4,14,32,-18,13,1
349987,1,3,7,-4,2,1
148606,2,7,9,-2,16,0
319770,2,7,6,1,6,0
305412,3,20,3,17,17,0
197779,4,21,17,4,3,0
273708,4,31,20,11,2,0
244364,2,0,17,-17,7,1
244043,2,20,17,3,6,0
112487,1,0,0,0,17,1
95305,4,17,24,-7,10,0
240454,2,3,7,-4,5,0
41577,1,0,0,0,2,0
25429,3,13,10,3,12,1
344343,1,7,0,7,17,1
122408,2,0,20,-20,4,0
260055,2,3,7,-4,14,1
354695,4,17,17,0,4,1
130333,2,7,0,7,8,1
236617,1,0,0,0,3,1
241337,1,0,0,0,5,0
283937,4,31,17,14,7,1
131391,3,7,13,-6,8,1
120636,4,3,27,-24,3,1
196384,2,10,0,10,2,0
15648,3,21,10,11,8,0
57467,2,14,3,11,10,0
43257,4,24,10,14,3,1
420598,2,0,10,-10,17,1
220655,1,7,0,7,13,1
103128,4,34,7,27,13,0
107582,1,6,7,-1,15,0
317470,2,10,9,1,5,0
76636,2,10,0,10,1,0
412318,2,7,13,-6,13,1
345803,1,0,6,-6,17,0
299138,3,3,16,-13,14,1
47716,3,6,17,-11,5,0
204956,4,13,27,-14,6,1
40503,4,7,20,-13,2,1
417835,2,10,0,10,16,0
97420,4,16,23,-7,10,0
207719,2,0,13,-13,7,1
215228,4,10,16,-6,11,0
419143,2,10,3,7,16,1
286455,4,17,10,7,8,0
349622,4,13,28,-15,2,0
175658,2,3,3,0,11,0
285884,1,6,0,6,8,1
352336,1,6,0,6,3,1
91624,2,14,7,7,8,1
77505,2,7,7,0,1,1
79353,4,32,3,29,2,0
283350,4,10,16,-6,7,1
378685,1,7,7,0,15,1
344830,3,20,10,10,17,1
276156,1,10,0,10,3,1
288798,1,3,7,-4,9,0
150899,2,7,7,0,17,0
206553,2,7,3,4,7,0
55306,4,20,10,10,9,0
416384,4,16,13,3,15,1
107626,3,13,7,6,15,0
189319,2,3,7,-4,16,0
239679,2,7,10,-3,4,1
4014,1,7,0,7,2,0
280269,2,12,13,-1,5,1
45755,3,10,7,3,4,1
322110,4,26,0,26,7,1
318782,4,17,26,-9,5,0
183729,4,34,20,14,14,1
364560,2,15,21,-6,9,0
161048,1,0,0,0,4,0
84796,4,13,31,-18,4,1
137381,2,3,14,-11,11,0
19000,2,7,0,7,10,0
68383,3,3,14,-11,14,1
397936,4,10,9,1,7,0
339388,1,0,3,-3,15,0
78036,4,12,23,-11,1,1
195716,4,14,16,-2,2,1
312018,1,0,0,0,2,1
292003,2,6,3,3,11,1
379484,4,23,3,20,16,1
232461,2,3,0,3,1,1
280787,4,14,17,-3,5,0
170367,1,7,0,7,8,1
5150,4,19,14,5,3,1
164051,2,3,3,0,5,1
399004,1,7,9,-2,7,0
36237,3,10,24,-14,17,0
332696,1,7,0,7,12,1
355834,2,13,0,13,5,0
218003,2,21,10,11,12,1
2998,3,13,31,-18,2,1
276814,3,20,17,3,4,0
147119,3,17,31,-14,15,1
200502,4,26,18,8,4,0
387487,1,0,0,0,2,0
364608,4,21,37,-16,9,1
75768,3,35,26,9,1,1
151403,4,34,20,14,17,1
148797,3,13,16,-3,16,1
141866,3,24,14,10,13,0
329836,4,17,23,-6,11,1
79758,3,20,7,13,2,0
297918,1,10,0,10,13,1
301424,1,3,0,3,15,0
131750,4,24,28,-4,8,1
110465,3,17,0,17,16,0
111446,4,0,20,-20,16,1
116878,2,7,7,0,2,1
243849,1,3,0,3,6,1
255552,4,30,7,23,12,1
30018,3,23,0,23,14,1
279267,3,19,13,6,5,0
32510,2,14,3,11,15,1
315270,4,20,19,1,4,1
23801,3,17,0,17,12,0
301304,2,14,7,7,15,0
135393,3,28,17,11,10,0
100312,2,9,7,2,12,0
115680,2,3,3,0,1,1
62738,2,14,0,14,12,0
330120,4,0,13,-13,11,0
262018,3,24,24,0,14,0
221479,4,3,41,-38,14,0
279747,4,30,6,24,5,1
29677,1,0,0,0,14,0
233173,4,29,3,26,2,0
90684,1,0,0,0,7,0
22498,4,31,29,2,11,0
44099,2,0,13,-13,3,0
284439,2,7,9,-2,7,0
28735,4,10,16,-6,14,1
352836,3,14,3,11,3,1
58131,3,20,10,10,10,0
210566,2,6,7,-1,9,1
379853,1,7,0,7,16,1
191444,4,0,31,-31,17,0
339664,1,0,0,0,15,1
50526,1,0,3,-3,6,1
75656,4,13,6,7,17,1
199946,1,3,10,-7,4,1
116565,2,3,0,3,2,0
50679,1,0,7,-7,6,1
198453,2,10,3,7,3,1
147548,2,6,0,6,15,0
278395,4,17,24,-7,4,1
63035,3,16,21,-5,12,1
282515,3,17,3,14,6,0
373676,2,0,15,-15,13,0
402780,4,30,14,16,9,1
366391,2,26,0,26,10,0
178514,3,16,13,3,12,1
20490,2,0,0,0,10,0
36359,3,13,13,0,17,0
21679,2,3,7,-4,11,0
394998,1,0,7,-7,5,0
398814,4,21,24,-3,7,0
407515,1,3,0,3,11,1
335947,1,0,9,-9,13,0
179650,5,31,30,1,12,0
72146,1,0,3,-3,16,1
175386,2,14,3,11,11,1
113395,1,0,0,0,17,0
184492,2,13,7,6,14,1
33039,1,0,0,0,16,0
187845,3,7,13,-6,16,0
348969,2,14,0,14,2,1
240338,3,7,23,-16,5,1
264299,3,10,23,-13,15,1
154478,3,14,10,4,1,1
353528,2,10,0,10,4,1
311138,4,13,13,0,2,0
373313,1,0,0,0,13,0
277820,2,7,7,0,4,0
346287,4,47,3,44,1,1
258453,4,21,13,8,13,0
214789,4,10,20,-10,11,0
360924,3,24,3,21,7,1
192147,2,0,6,-6,1,0
387047,1,0,7,-7,2,1
34542,2,0,0,0,16,1
77278,4,16,10,6,1,1
24296,4,13,17,-4,12,1
253163,1,0,0,0,11,0
359340,3,3,13,-10,6,0
40327,3,6,7,-1,2,0
200019,3,24,17,7,4,1
66478,2,7,10,-3,14,0
49023,2,10,7,3,6,0
128730,1,0,0,0,7,1
179833,1,0,0,0,13,1
343398,4,6,34,-28,16,0
357397,2,17,17,0,5,0
402099,2,6,0,6,9,0
38185,2,3,7,-4,1,0
299029,4,16,18,-2,14,1
219800,2,38,0,38,13,0
332968,4,31,3,28,12,0
282911,1,7,0,7,6,0
13118,1,3,7,-4,6,1
214275,3,14,10,4,11,1
190906,1,6,0,6,17,0
356845,3,3,16,-13,5,1
348979,2,14,0,14,2,1
99337,3,20,3,17,11,0
148635,3,10,9,1,16,0
306307,2,17,7,10,17,1
377981,2,0,7,-7,15,1
358913,4,6,35,-29,6,1
415371,4,21,24,-3,15,0
414542,2,14,3,11,14,1
195141,1,0,0,0,2,0
47542,3,37,6,31,5,0
420935,2,7,14,-7,17,1
105278,4,10,24,-14,14,0
119405,2,0,14,-14,3,1
287655,3,3,10,-7,9,1
372424,2,6,7,-1,13,0
378413,2,7,0,7,15,0
179582,3,7,23,-16,12,1
345020,4,23,23,0,17,0
380568,4,21,24,-3,16,0
79849,1,0,6,-6,2,1
23617,2,7,10,-3,12,0
7726,2,17,3,14,4,1
119965,3,9,24,-15,3,1
253179,1,0,0,0,11,0
372540,5,26,27,-1,13,1
238827,3,27,0,27,4,0
162320,2,3,6,-3,4,0
322918,2,13,0,13,7,0
254419,2,13,0,13,11,1
249047,2,21,10,11,9,0
307659,3,14,17,-3,17,0
193247,3,3,10,-7,1,0
152848,1,0,0,0,1,0
60548,3,30,27,3,11,1
41614,2,14,0,14,2,0
407675,1,0,0,0,11,0
338668,2,13,7,6,14,0
313184,3,20,16,4,3,1
329632,2,10,7,3,11,1
89070,2,6,6,0,6,1
254598,3,7,14,-7,11,1
342676,1,0,0,0,16,0
28287,4,24,14,10,13,1
220841,3,7,21,-14,14,1
238941,2,14,6,8,4,1
400551,3,13,24,-11,8,1
11209,2,7,14,-7,6,0
237655,2,3,7,-4,4,1
377276,3,14,6,8,15,1
103581,4,33,7,26,13,0
224240,1,6,3,3,15,1
150854,1,0,6,-6,17,0
125741,2,7,14,-7,5,1
185395,2,0,10,-10,15,1
333098,4,17,18,-1,12,1
30587,2,10,0,10,14,1
408587,2,14,0,14,12,0
362369,3,23,14,9,8,1
228915,1,7,9,-2,17,1
169445,1,0,0,0,8,0
283660,4,23,33,-10,7,1
253809,1,0,0,0,11,1
301762,2,0,24,-24,15,1
345901,3,10,23,-13,17,1
32415,3,31,6,25,15,1
353650,1,3,0,3,4,1
366398,2,26,0,26,10,0
23987,4,23,6,17,12,1
219122,1,0,0,0,13,0
230131,2,3,16,-13,17,1
16794,3,3,24,-21,8,1
283489,4,23,14,9,7,0
147230,2,0,21,-21,15,1
144853,2,14,0,14,14,1
203319,2,14,24,-10,6,0
357891,4,13,34,-21,6,1
271148,2,7,10,-3,1,0
189491,3,17,0,17,17,0
174600,4,13,21,-8,10,1
85658,2,24,7,17,5,0
27377,3,24,10,14,13,1
21796,5,34,31,3,11,1
63261,1,0,0,0,12,0
273257,1,0,0,0,2,1
40786,3,17,28,-11,2,1
166588,2,15,14,1,6,0
238848,3,34,0,34,4,1
367525,1,7,3,4,10,1
366475,4,34,22,12,10,1
315848,3,9,19,-10,4,1
304654,3,14,7,7,16,1
79440,2,9,7,2,2,0
286516,1,3,13,-10,8,0
297352,2,3,10,-7,13,1
29963,1,13,0,13,14,1
420965,3,7,21,-14,17,1
230223,1,6,0,6,17,0
20306,2,10,3,7,10,0
111598,1,0,0,0,16,0
156538,4,14,6,8,2,0
330841,2,10,17,-7,11,1
95155,3,23,20,3,9,0
334642,1,0,0,0,13,0
214561,2,3,0,3,11,0
420048,4,24,14,10,17,1
213300,1,0,0,0,10,1
228504,3,20,7,13,17,0
102613,2,12,6,6,13,0
151834,4,28,16,12,17,1
395836,3,3,17,-14,6,1
8124,4,27,20,7,4,0
363140,3,14,3,11,8,1
83778,1,0,0,0,4,1
338754,4,27,17,10,14,0
23121,1,0,0,0,11,0
417758,5,35,35,0,16,1
5405,3,20,16,4,3,0
94360,3,17,7,10,9,0
23876,1,0,0,0,12,1
320359,1,7,0,7,6,0
192987,4,17,17,0,1,1
115644,1,0,0,0,1,0
368422,3,20,7,13,11,1
385469,4,35,10,25,1,1
365420,2,7,12,-5,9,1
285655,4,27,27,0,8,1
187173,1,0,0,0,16,1
309542,2,6,0,6,1,0
200927,4,40,7,33,4,0
408744,2,10,7,3,12,1
359641,3,27,7,20,6,1
275382,4,10,22,-12,3,0
239733,3,10,13,-3,4,1
90276,2,0,7,-7,7,0
171300,2,0,3,-3,9,1
80902,1,6,0,6,3,0
63364,4,17,3,14,12,0
108222,2,6,0,6,15,1
24084,3,7,7,0,12,0
420881,4,17,34,-17,17,1
13651,4,13,10,3,7,0
267089,2,3,3,0,17,0
269811,3,13,7,6,1,0
109472,4,9,13,-4,16,1
401808,2,7,7,0,9,1
254705,1,3,0,3,11,0
235757,4,13,27,-14,3,0
329777,2,17,13,4,11,1
313361,4,13,34,-21,3,1
54234,3,0,3,-3,8,1
26080,1,0,10,-10,13,1
82821,4,12,16,-4,3,1
200528,1,0,0,0,4,1
61322,4,31,28,3,11,0
326917,1,2,0,2,9,0
33665,2,21,0,21,16,0
328174,3,14,14,0,10,0
107039,2,17,0,17,15,1
168520,1,0,0,0,7,0
144621,4,20,22,-2,14,1
135977,2,3,3,0,10,0
3645,4,20,28,-8,2,0
10542,4,40,0,40,5,0
362461,1,0,6,-6,8,1
228026,2,0,0,0,17,1
241929,4,23,27,-4,5,1
177689,2,10,14,-4,12,1
161122,2,3,19,-16,4,0
357061,1,6,7,-1,5,1
147859,3,3,17,-14,15,0
393688,2,0,0,0,5,0
367471,4,36,24,12,10,0
117528,3,17,17,0,2,1
303252,1,10,0,10,16,0
79183,3,17,10,7,2,0
378155,3,21,15,6,15,0
421722,3,17,17,0,17,1
58640,4,20,17,3,10,0
397721,2,9,7,2,7,0
408743,2,10,7,3,12,1
330069,2,0,3,-3,11,0
19038,3,7,6,1,10,0
349618,4,13,28,-15,2,0
199537,2,20,3,17,4,0
145254,1,7,6,1,14,1
168546,2,7,10,-3,7,1
413847,2,14,6,8,14,0
328158,3,6,14,-8,10,0
392680,4,16,0,16,4,1
202157,3,13,6,7,5,1
226330,4,22,7,15,16,0
113003,2,7,10,-3,17,1
19048,4,7,6,1,10,1
382198,1,0,3,-3,17,1
170066,1,0,0,0,8,0
32887,4,19,7,12,15,0
76308,1,10,3,7,1,0
152598,1,0,0,0,17,0
364684,2,3,0,3,9,1
263045,3,10,3,7,15,0
149604,4,17,26,-9,16,1
227329,4,20,34,-14,16,1
154954,4,29,24,5,1,1
235581,3,27,13,14,3,0
383045,1,3,7,-4,17,1
158906,1,14,0,14,3,0
94190,3,17,7,10,9,0
363916,1,0,0,0,8,0
311888,2,7,6,1,2,0
69533,1,0,0,0,15,1
9035,2,14,13,1,4,1
244331,1,0,7,-7,7,0
52530,3,13,0,13,7,1
402650,4,23,23,0,9,1
275715,1,0,0,0,3,0
18875,3,9,6,3,9,0
259620,3,6,3,3,13,0
386857,4,19,28,-9,2,1
91132,1,3,7,-4,8,0
295297,4,14,5,9,12,0
101512,1,10,7,3,12,1
289970,4,6,9,-3,10,1
287887,1,0,0,0,9,0
204459,3,7,24,-17,6,0
273898,2,0,3,-3,2,1
295720,3,10,9,1,12,0
105713,3,28,3,25,14,1
398039,2,14,14,0,7,0
275179,3,14,16,-2,3,1
98293,3,21,27,-6,11,0
228889,4,9,17,-8,17,0
224664,4,16,10,6,15,1
409558,3,35,3,32,12,0
60508,2,27,7,20,11,0
356000,2,14,7,7,5,0
322350,2,14,7,7,7,1
411915,2,17,3,14,13,0
274518,2,14,6,8,3,0
16475,2,9,0,9,8,1
410392,2,6,7,-1,13,0
202491,4,9,16,-7,5,0
128361,3,7,10,-3,7,1
347117,2,10,3,7,1,1
258469,4,21,21,0,13,0
172332,1,0,0,0,9,0
372112,1,3,7,-4,13,0
156206,4,16,10,6,2,1
248227,4,12,10,2,8,0
285873,1,6,0,6,8,1
6875,4,10,31,-21,3,1
47466,1,3,0,3,5,0
312128,4,33,16,17,2,1
190647,2,14,7,7,17,1
35552,4,30,7,23,17,1
135203,2,10,3,7,10,1
212842,5,24,24,0,10,1
132394,2,0,7,-7,9,0
175917,4,23,27,-4,11,1
131102,2,20,6,14,8,0
142721,2,9,7,2,13,0
374308,3,14,13,1,13,1
727,4,6,24,-18,1,0
96015,3,13,7,6,10,1
321515,4,24,30,-6,7,1
1823,3,16,7,9,1,0
20465,2,0,0,0,10,0
393601,3,7,26,-19,5,1
304022,2,0,13,-13,16,0
371152,2,0,9,-9,12,0
222848,4,24,13,11,14,0
125933,3,16,13,3,6,1
167886,3,20,16,4,7,1
317139,1,0,0,0,5,0
60130,4,27,19,8,11,0
15504,3,16,6,10,8,0
240726,1,0,7,-7,5,1
278955,2,7,23,-16,5,1
16726,1,0,0,0,8,0
339855,2,16,0,16,15,0
171739,1,3,7,-4,9,1
48693,2,7,10,-3,5,1
374483,4,32,7,25,14,0
100130,1,0,0,0,12,1
217075,1,0,0,0,12,0
17352,2,17,0,17,9,0
9368,4,31,7,24,5,0
386134,1,0,0,0,2,1
102614,2,12,6,6,13,0
316377,1,13,0,13,4,0
380830,3,9,24,-15,16,0
259850,1,7,7,0,14,0
105476,1,13,0,13,14,0
155040,2,6,12,-6,1,0
19990,2,9,3,6,10,1
389061,2,20,0,20,3,0
99625,2,7,3,4,11,1
74834,3,13,13,0,17,1
270460,4,10,7,3,1,1
202438,2,3,10,-7,5,1
197104,2,7,17,-10,3,1
416403,4,16,20,-4,15,1
371914,4,27,17,10,12,1
7315,4,20,19,1,4,1
274286,4,29,16,13,3,1
221618,4,20,21,-1,14,1
195774,2,3,7,-4,2,1
316802,4,16,7,9,4,1
211132,1,0,3,-3,9,1
1904,1,0,0,0,1,0
359824,1,0,0,0,6,0
378224,1,0,0,0,15,1
255747,1,0,0,0,12,1
234135,1,0,0,0,2,0
397113,1,3,0,3,6,0
87877,3,10,12,-2,6,1
300311,2,0,7,-7,14,0
157374,2,3,0,3,2,0
183269,3,13,20,-7,14,0
93187,3,0,3,-3,9,0
160366,4,3,21,-18,4,0
149438,4,13,27,-14,16,1
78863,2,10,0,10,2,1
283672,1,0,0,0,7,0
285164,5,3,3,0,7,1
416309,2,10,3,7,15,1
29994,2,17,0,17,14,1
337695,4,24,13,11,14,0
287837,3,28,17,11,9,0
175964,1,0,0,0,11,0
325577,1,7,0,7,9,0
38727,4,24,17,7,1,1
146235,3,3,16,-13,15,1
20403,4,10,13,-3,10,0
397239,4,16,0,16,6,0
391076,1,0,7,-7,4,1
173447,2,0,7,-7,10,1
299784,4,17,17,0,14,1
32483,1,7,3,4,15,0
173550,1,0,7,-7,10,1
108251,3,6,0,6,15,0
338043,2,0,0,0,14,0
356022,3,21,10,11,5,1
88809,3,13,13,0,6,1
244374,2,0,17,-17,7,1
170121,2,7,10,-3,8,1
96024,3,13,7,6,10,1
374305,3,14,13,1,13,1
57435,1,7,0,7,10,0
327226,2,0,3,-3,9,1
262719,2,14,0,14,15,1
99419,1,0,0,0,11,0
338143,1,0,0,0,14,0
138060,3,36,17,19,11,0
389679,4,24,16,8,3,1
140887,3,17,7,10,13,0
273721,1,0,0,0,2,1
11881,4,41,20,21,6,1
420122,1,0,0,0,17,0
308549,2,6,9,-3,1,0
204137,3,9,10,-1,6,1
212265,1,7,3,4,10,1
347423,1,3,6,-3,1,0
285800,3,7,24,-17,8,1
250692,4,10,22,-12,10,1
146933,1,7,0,7,15,0
190620,1,7,7,0,17,1
77683,3,10,17,-7,1,0
240372,4,21,23,-2,5,1
3023,4,20,34,-14,2,0
398692,1,0,0,0,7,0
283840,1,7,0,7,7,0
183324,1,0,0,0,14,1
39792,4,12,7,5,1,0
296943,3,26,0,26,13,1
164628,3,7,17,-10,5,1
168533,1,0,3,-3,7,1
142717,1,0,7,-7,13,1
386983,3,7,21,-14,2,1
355424,3,13,10,3,4,0
101802,5,13,13,0,12,1
201772,2,6,0,6,5,1
35421,1,0,0,0,17,0
123337,2,21,14,7,4,1
375491,3,26,7,19,14,0
72424,1,7,0,7,16,1
112527,2,10,9,1,17,0
19553,2,6,7,-1,10,1
233426,2,17,3,14,2,0
329292,1,0,7,-7,10,1
418039,4,28,35,-7,16,0
10423,1,0,0,0,5,1
297359,2,6,10,-4,13,0
84478,3,20,10,10,4,0
290226,3,17,3,14,10,0
285531,1,7,7,0,8,0
39603,3,27,6,21,1,0
380751,1,3,0,3,16,0
332784,3,28,9,19,12,1
241850,2,13,6,7,5,0
128922,2,15,3,12,7,0
24861,4,13,3,10,12,1
351866,4,27,14,13,3,0
388755,2,11,0,11,3,1
138516,4,31,30,1,12,1
148760,2,13,6,7,16,1
257355,2,17,0,17,13,1
244118,4,20,34,-14,6,1
276874,4,26,20,6,4,1
104375,4,45,38,7,13,1
158051,2,15,6,9,3,0
304270,4,33,25,8,16,0
269182,1,3,3,0,17,0
98873,2,7,7,0,11,1
149545,3,14,9,5,16,0
109064,4,23,41,-18,15,1
379838,1,0,0,0,16,1
327420,3,3,17,-14,9,0
193542,2,0,7,-7,1,1
7000,4,10,7,3,3,1
13820,4,7,36,-29,7,1
9884,2,0,0,0,5,1
208194,3,0,10,-10,8,1
272849,2,20,0,20,2,1
136278,2,15,7,8,11,0
389202,2,21,7,14,3,0
115541,2,0,3,-3,1,1
126631,1,0,0,0,6,1
285140,4,3,0,3,7,0
373618,1,0,0,0,13,1
217896,3,17,21,-4,12,0
2049,1,0,0,0,1,1
77811,2,7,14,-7,1,0
170602,3,34,9,25,8,1
303388,1,7,0,7,16,1
409021,1,0,0,0,12,1
289058,4,32,28,4,9,1
402713,2,10,0,10,9,1
23485,2,14,14,0,11,1
170317,4,0,12,-12,8,0
151780,3,14,6,8,17,0
32932,2,0,7,-7,15,0
143088,3,17,17,0,13,0
304433,1,0,0,0,16,0
350563,1,10,0,10,2,1
54125,4,20,10,10,8,1
98081,1,0,0,0,11,1
288191,1,3,7,-4,9,1
78253,2,0,0,0,2,0
305304,4,42,21,21,16,0
333765,1,6,0,6,12,0
175267,3,15,7,8,10,0
198750,2,3,3,0,3,1
247380,1,3,6,-3,8,1
115475,4,39,28,11,1,1
50037,4,31,17,14,6,1
102059,3,21,10,11,12,1
324543,2,7,9,-2,8,1
152084,3,6,7,-1,17,0
115330,4,20,15,5,1,0
112243,2,14,7,7,17,0
376036,1,0,0,0,14,1
416692,4,44,15,29,15,0
264158,4,27,27,0,15,0
206689,2,0,7,-7,7,1
205982,3,13,10,3,7,0
272498,1,7,0,7,2,0
373783,1,0,0,0,13,1
360206,4,20,13,7,7,0
37359,3,17,0,17,17,0
57635,2,10,3,7,10,1
63515,4,31,19,12,12,1
100953,3,10,10,0,12,1
167777,5,26,26,0,7,1
42106,4,27,20,7,2,1
332480,3,23,6,17,12,0
308519,2,0,9,-9,1,1
277912,4,7,20,-13,4,0
91338,3,7,7,0,8,1
158023,2,0,6,-6,3,0
97685,3,3,10,-7,11,1
325821,4,6,17,-11,9,1
348903,4,9,21,-12,2,1
129453,4,23,20,3,7,0
126215,3,21,6,15,6,0
269874,4,22,10,12,1,1
355303,3,14,17,-3,4,0
288343,2,7,0,7,9,0
266537,4,10,22,-12,16,1
288189,1,3,7,-4,9,1
393276,4,24,26,-2,5,0
1441,4,19,0,19,1,0
309488,1,0,0,0,1,1
155248,3,28,13,15,1,0
112728,2,10,0,10,17,0
73490,2,3,21,-18,17,0
325145,2,13,7,6,8,1
283239,2,10,0,10,7,0
130996,4,10,30,-20,8,1
416806,3,13,10,3,15,0
304485,2,0,14,-14,16,1
157447,3,16,17,-1,2,0
371396,1,7,7,0,12,0
144841,2,14,0,14,14,1
297066,2,20,0,20,13,1
10619,2,0,10,-10,5,1
306224,4,20,3,17,17,0
207853,2,7,0,7,8,1
207680,1,0,0,0,7,0
145358,4,45,26,19,14,0
366468,4,34,16,18,10,0
246624,2,17,3,14,8,0
309421,3,0,3,-3,1,1
234036,2,20,0,20,2,0
222337,3,14,3,11,14,1
401802,1,7,0,7,9,0
362659,3,3,7,-4,8,0
47207,3,9,6,3,5,0
318165,3,16,16,0,5,0
125175,3,17,7,10,5,1
393010,4,12,10,2,4,1
335371,4,3,23,-20,13,1
354612,2,3,7,-4,4,0
269765,1,7,0,7,1,1
31878,1,6,0,6,15,1
347327,4,7,21,-14,1,0
29986,2,17,0,17,14,1
48805,1,0,0,0,5,0
282048,1,3,6,-3,6,0
245185,4,17,28,-11,7,0
107937,3,6,3,3,15,0
76118,4,13,30,-17,1,0
304291,1,0,0,0,16,0
165782,1,3,0,3,6,1
313104,1,0,0,0,3,0
218724,2,0,10,-10,13,1
55571,3,17,7,10,9,1
239365,1,0,7,-7,4,0
151222,3,17,20,-3,17,0
11502,2,6,7,-1,6,0
237336,2,0,0,0,3,0
263264,1,0,0,0,15,1
131294,4,21,24,-3,8,1
414426,3,7,23,-16,14,1
65462,3,9,14,-5,13,1
156925,2,7,10,-3,2,0
8730,1,0,0,0,4,1
41519,3,15,7,8,2,0
87522,2,14,0,14,6,1
40406,1,0,7,-7,2,1
124053,2,0,7,-7,5,0
176811,2,10,7,3,11,0
301309,2,14,7,7,15,1
214062,1,0,0,0,11,1
320594,3,31,6,25,6,0
249086,3,21,17,4,9,0
297402,3,16,24,-8,13,1
264178,4,34,27,7,15,0
99477,2,0,10,-10,11,1
80669,3,17,19,-2,3,1
81608,4,30,24,6,3,0
271439,2,14,0,14,1,0
318530,1,0,0,0,5,1
169209,3,10,6,4,7,0
41544,4,18,7,11,2,1
130808,3,13,12,1,8,1
135047,2,14,3,11,10,0
153238,1,2,0,2,1,0
131434,4,7,19,-12,8,1
162332,2,3,7,-4,4,1
160635,2,7,0,7,4,1
289949,4,6,6,0,10,1
356455,2,0,3,-3,5,1
230937,4,31,10,21,1,0
143831,4,12,7,5,14,1
339919,4,32,0,32,15,1
191151,4,28,27,1,17,0
133049,4,12,14,-2,9,0
261646,1,0,0,0,14,1
75727,2,21,16,5,1,1
48695,2,7,10,-3,5,1
197377,1,0,0,0,3,1
340240,4,29,31,-2,15,0
352184,1,0,0,0,3,1
273762,2,6,7,-1,2,1
272147,4,24,16,8,2,0
37681,3,30,0,30,17,0
285849,4,14,30,-16,8,1
421353,2,3,10,-7,17,1
131010,4,17,30,-13,8,0
25930,1,3,0,3,13,0
52175,2,0,3,-3,7,1
308329,1,0,0,0,1,0
220423,3,23,14,9,13,0
320371,1,7,0,7,6,1
347506,3,12,23,-11,1,0
383064,2,17,7,10,17,0
297224,2,7,6,1,13,0
238840,3,34,0,34,4,0
301152,2,10,11,-1,15,1
249740,3,21,21,0,9,1
391926,4,23,27,-4,4,1
46163,2,7,14,-7,4,0
126277,1,0,0,0,6,0
283750,3,11,3,8,7,0
259705,1,10,7,3,14,0
169054,3,26,14,12,7,1
288350,2,7,0,7,9,1
255235,3,13,14,-1,12,0
407182,4,17,34,-17,11,1
172301,4,24,23,1,9,1
296498,3,23,3,20,13,0
82512,3,10,20,-10,3,1
279188,1,0,3,-3,5,1
360494,4,17,6,11,7,0
393598,3,7,26,-19,5,1
266789,3,3,14,-11,16,1
139239,2,10,6,4,12,0
229473,4,13,9,4,17,1
238590,4,23,20,3,4,0
389920,2,15,10,5,3,0
372565,1,7,0,7,13,0
100179,2,7,0,7,12,1
159802,4,7,27,-20,3,1
219281,1,10,0,10,13,0
285057,2,0,0,0,7,0
320602,3,31,6,25,6,1
212289,2,7,3,4,10,1
398827,4,21,24,-3,7,0
217888,3,17,21,-4,12,0
244095,4,20,34,-14,6,1
212928,2,7,7,0,10,0
153760,4,2,21,-19,1,0
146358,2,3,3,0,15,0
208459,2,10,0,10,8,1
360728,2,16,7,9,7,1
59689,4,31,6,25,11,0
89622,1,3,0,3,7,0
89389,2,10,20,-10,7,1
387541,2,3,0,3,2,0
195954,3,0,17,-17,2,1
415460,3,23,3,20,15,1
303172,4,24,28,-4,16,1
332831,1,0,0,0,12,0
389445,1,3,0,3,3,0
73731,1,0,0,0,17,1
367931,1,0,7,-7,11,0
395412,4,28,3,25,5,1
235180,4,7,20,-13,2,0
222701,4,14,24,-10,14,0
415973,1,0,0,0,15,0
313752,3,28,3,25,3,0
217298,2,0,7,-7,12,1
404502,3,21,27,-6,10,1
33108,3,10,21,-11,16,1
272384,2,24,0,24,2,0
349830,1,0,0,0,2,0
5069,2,10,0,10,3,1
257474,1,0,3,-3,13,0
308231,2,7,10,-3,1,1
4483,2,14,12,2,2,1
318909,4,24,22,2,5,1
66202,2,24,3,21,13,0
201811,3,13,10,3,5,0
292517,4,10,12,-2,11,0
145252,1,7,6,1,14,0
293371,2,7,10,-3,11,0
322394,4,17,19,-2,7,0
58724,2,10,17,-7,10,0
23357,3,12,10,2,11,1
130922,2,0,14,-14,8,1
168030,3,3,17,-14,7,1
388048,4,20,6,14,2,0
141172,2,3,14,-11,13,0
165968,2,10,14,-4,6,1
27925,2,7,10,-3,13,1
180208,4,19,7,12,13,0
321272,2,6,10,-4,6,1
228028,2,0,0,0,17,1
119058,1,0,0,0,3,0
135660,2,7,10,-3,10,1
402329,4,23,24,-1,9,1
142666,4,20,13,7,13,1
124678,2,0,3,-3,5,1
186762,2,20,0,20,15,1
18359,4,25,20,5,9,1
255240,3,13,14,-1,12,0
122232,1,3,10,-7,4,0
64586,2,10,14,-4,13,0
297691,3,10,13,-3,13,1
85160,2,0,10,-10,4,1
29878,3,9,23,-14,14,1
412933,2,9,3,6,14,0
187095,3,10,0,10,16,1
416332,3,16,3,13,15,0
286192,5,24,30,-6,8,0
3520,4,17,30,-13,2,1
326548,4,44,22,22,9,1
306835,1,0,3,-3,17,1
373470,1,0,7,-7,13,0
359003,2,10,0,10,6,1
235695,2,0,10,-10,3,1
344292,4,16,13,3,17,1
127681,4,30,26,4,6,1
65588,2,6,6,0,13,1
97640,2,3,3,0,11,0
283763,3,11,3,8,7,1
177654,1,7,0,7,12,0
110756,2,3,3,0,16,0
186516,4,17,20,-3,15,0
402748,3,17,7,10,9,1
119749,2,10,3,7,3,0
331575,2,17,20,-3,11,0
197599,3,19,0,19,3,0
76413,4,29,12,17,1,1
252607,2,3,3,0,10,0
142293,2,0,0,0,13,1
56512,1,10,0,10,9,0
339385,1,0,3,-3,15,1
91451,2,9,0,9,8,0
197603,3,19,0,19,3,1
223202,2,3,3,0,15,0
153798,4,2,27,-25,1,1
64632,4,20,17,3,13,0
336373,1,0,3,-3,14,0
291308,3,21,22,-1,10,1
360246,1,0,3,-3,7,1
54606,1,7,6,1,8,0
294213,2,0,7,-7,12,1
350368,4,24,13,11,2,1
141805,2,10,13,-3,13,0
200788,4,31,10,21,4,0
209386,3,14,7,7,8,0
292027,3,15,9,6,11,0
297499,2,5,0,5,13,0
162312,1,3,0,3,4,0
338946,2,6,0,6,15,0
261172,1,0,0,0,14,1
179641,4,31,30,1,12,0
122539,1,13,0,13,4,1
297286,4,24,6,18,13,1
190757,1,3,0,3,17,0
135085,3,17,6,11,10,1
267957,2,0,3,-3,17,1
414053,4,10,45,-35,14,0
20635,2,0,7,-7,10,1
294170,1,0,7,-7,12,1
297448,4,38,24,14,13,1
361789,2,21,7,14,7,0
334366,2,0,9,-9,13,0
49714,4,21,31,-10,6,1
245958,4,21,37,-16,7,1
411565,1,0,10,-10,13,1
174539,3,10,14,-4,10,0
21642,1,0,0,0,11,1
308826,2,3,3,0,1,0
229133,3,19,7,12,17,1
104332,2,45,21,24,13,0
393812,1,7,10,-3,5,0
205619,1,7,6,1,7,1
45576,2,7,13,-6,4,1
173597,2,0,13,-13,10,1
407867,2,6,7,-1,11,0
39279,3,3,19,-16,1,0
47695,3,3,17,-14,5,1
97710,4,9,10,-1,11,0
248974,4,27,3,24,9,1
27059,3,10,6,4,13,1
414467,4,16,23,-7,14,0
272432,4,31,16,15,2,0
385984,4,24,21,3,1,1
288625,4,23,41,-18,9,0
377041,4,22,29,-7,15,0
244539,3,25,13,12,7,0
228167,2,7,17,-10,17,0
169262,4,23,6,17,7,0
383368,2,0,6,-6,17,0
160779,1,10,7,3,4,1
62184,4,13,17,-4,12,1
158275,1,0,0,0,3,0
266407,4,36,8,28,16,1
59546,4,13,35,-22,11,0
269146,5,16,16,0,17,0
41031,2,3,10,-7,2,1
207387,1,0,0,0,7,1
379806,4,9,27,-18,16,1
197775,4,21,17,4,3,0
81155,4,16,14,2,3,0
24428,4,16,7,9,12,0
247956,1,0,0,0,8,0
301520,4,20,18,2,15,1
189774,2,17,6,11,17,0
145000,2,3,3,0,14,0
172290,4,24,20,4,9,0
332130,1,0,0,0,12,0
371077,4,13,20,-7,12,0
69959,1,21,0,21,15,0
120054,1,3,0,3,3,0
100806,3,9,3,6,12,0
82459,2,7,14,-7,3,0
289960,4,6,6,0,10,0
273298,2,21,0,21,2,1
377287,3,14,14,0,15,1
118456,4,20,10,10,2,1
285808,3,7,24,-17,8,1
421786,1,0,0,0,17,0
382297,4,20,3,17,17,0
320381,2,7,0,7,6,1
165008,1,7,10,-3,6,1
143389,3,7,26,-19,14,0
100389,4,9,20,-11,12,0
101957,4,9,13,-4,12,0
335770,4,17,7,10,13,0
356330,2,17,0,17,5,1
328246,5,17,17,0,10,0
307156,2,0,10,-10,17,1
23900,2,3,0,3,12,1
150672,1,0,0,0,17,0
279938,1,0,7,-7,5,0
20559,4,17,0,17,10,0
125204,3,31,14,17,5,1
19008,2,7,3,4,10,0
261901,4,6,27,-21,14,0
351393,3,10,13,-3,3,1
23512,3,14,17,-3,11,1
207869,2,7,7,0,8,1
225533,4,6,24,-18,15,1
44386,1,0,0,0,3,1
345483,4,16,22,-6,17,1
2738,4,9,7,2,2,1
201102,1,0,0,0,5,1
331314,3,0,24,-24,11,0
133385,4,21,9,12,9,1
76497,2,0,20,-20,1,1
327251,2,6,10,-4,9,1
319182,3,2,10,-8,5,1
132417,2,0,21,-21,9,1
145871,1,0,0,0,15,0
51667,4,27,20,7,7,1
268970,4,6,36,-30,17,0
40733,2,17,7,10,2,0
53906,3,7,13,-6,8,1
65176,3,3,3,0,13,0
355271,3,14,14,0,4,0
154420,2,7,0,7,1,1
101987,1,0,0,0,12,1
268054,4,24,9,15,17,0
110064,4,48,16,32,16,0
259591,2,0,3,-3,13,0
131259,3,14,17,-3,8,1
21980,2,7,3,4,11,0
68298,1,0,0,0,14,1
50430,3,10,7,3,6,1
212500,4,10,13,-3,10,1
391834,2,10,3,7,4,1
172913,4,34,24,10,9,0
386974,3,7,21,-14,2,1
192923,2,7,10,-3,1,1
137075,2,14,3,11,11,1
8948,4,28,7,21,4,0
30584,2,10,0,10,14,1
369398,2,17,0,17,11,0
170524,1,7,0,7,8,0
225902,2,7,0,7,16,1
320197,1,0,0,0,6,1
218434,2,10,14,-4,13,1
323326,1,0,0,0,7,0
246114,1,0,0,0,7,0
310901,2,3,3,0,2,1
182177,3,26,7,19,13,1
205154,2,7,7,0,6,0
143620,2,10,10,0,14,1
385295,3,7,20,-13,1,1
369393,2,10,0,10,11,1
247946,4,20,6,14,8,0
92713,2,3,17,-14,8,1
223484,1,7,3,4,15,0
2119,3,10,13,-3,1,1
215786,3,29,6,23,11,1
109056,4,23,41,-18,15,0
257578,4,19,13,6,13,0
66473,2,7,10,-3,14,1
6171,1,0,0,0,3,0
256584,2,7,0,7,12,1
346488,2,17,14,3,1,0
285589,3,13,10,3,8,0
252324,3,0,19,-19,10,1
205061,3,19,20,-1,6,0
97232,3,12,6,6,10,0
126001,1,0,0,0,6,0
411322,2,10,10,0,13,0
296046,3,3,7,-4,13,0
242910,3,21,13,8,6,0
88944,3,26,3,23,6,1
155625,1,0,0,0,2,1
155769,4,27,30,-3,2,1
411099,1,0,0,0,13,0
244306,1,0,0,0,7,1
421489,2,0,3,-3,17,1
105796,1,3,3,0,14,0
168523,1,0,0,0,7,0
40364,4,9,10,-1,2,0
307356,3,16,22,-6,17,0
199801,2,3,3,0,4,0
344828,3,20,10,10,17,1
46557,1,0,0,0,4,0
149093,2,14,17,-3,16,0
168911,4,17,6,11,7,0
34773,4,20,3,17,16,0
71076,4,27,0,27,16,1
182412,1,0,0,0,14,1
115356,1,0,0,0,1,0
235091,2,0,7,-7,2,0
174603,4,19,21,-2,10,0
162187,2,7,7,0,4,1
219437,1,0,0,0,13,0
256957,4,32,27,5,12,0
300029,3,0,20,-20,14,0
334063,1,0,0,0,13,0
400835,3,24,13,11,8,0
255889,1,0,0,0,12,1
5710,4,0,24,-24,3,1
137371,2,3,14,-11,11,1
309349,1,0,0,0,1,1
263425,2,3,13,-10,15,1
164347,3,20,0,20,5,0
84203,4,17,10,7,4,1
45593,2,7,13,-6,4,0
94150,2,10,7,3,9,0
141846,3,17,14,3,13,1
179359,1,0,6,-6,12,1
142488,3,27,10,17,13,0
402305,3,20,16,4,9,1
402377,1,0,7,-7,9,0
7482,3,29,6,23,4,1
122753,4,10,24,-14,4,0
1501,2,3,6,-3,1,1
224717,1,3,0,3,15,1
308406,3,0,18,-18,1,1
195076,3,7,23,-16,2,0
299503,1,0,0,0,14,1
172624,5,24,24,0,9,1
256529,1,0,0,0,12,1
93937,4,24,15,9,9,0
352612,1,0,0,0,3,0
281890,4,16,17,-1,6,1
31267,1,0,0,0,15,0
188172,4,17,10,7,16,0
235324,4,25,14,11,3,1
185030,1,0,0,0,15,1
350219,4,27,0,27,2,1
29752,3,34,3,31,14,0
83951,1,7,0,7,4,1
405196,1,0,7,-7,10,0
394212,4,33,17,16,5,0
117398,4,34,10,24,2,0
326741,1,0,7,-7,9,0
389386,4,30,13,17,3,0
164155,1,14,7,7,5,1
120116,3,10,3,7,3,0
225326,2,7,21,-14,15,0
312463,1,3,0,3,3,1
417143,1,0,10,-10,16,1
309985,2,3,10,-7,2,1
38664,2,7,0,7,1,0
153101,2,6,10,-4,1,0
226052,1,0,0,0,16,0
135200,2,10,3,7,10,1
166773,3,20,16,4,6,1
333169,1,0,0,0,12,1
151048,3,10,3,7,17,0
236243,4,27,22,5,3,1
259086,1,0,0,0,13,0
101089,2,10,10,0,12,0
349164,3,27,7,20,2,1
304266,4,33,22,11,16,0
208810,4,6,22,-16,8,0
124,4,7,10,-3,1,1
377835,2,17,0,17,15,0
198759,2,3,3,0,3,0
3890,2,19,7,12,2,1
42965,4,31,23,8,3,1
49884,4,28,20,8,6,0
173325,3,14,24,-10,10,0
272853,2,20,0,20,2,0
252996,4,18,13,5,11,1
209446,4,17,17,0,8,0
169592,1,3,0,3,8,0
252305,2,0,16,-16,10,1
132606,4,12,35,-23,9,0
286139,4,16,17,-1,8,1
328634,3,20,35,-15,10,0
62072,1,0,0,0,12,1
247176,4,27,6,21,8,0
242092,1,0,0,0,6,1
410091,2,14,7,7,13,0
164219,3,27,35,-8,5,0
189302,2,3,7,-4,16,1
384178,4,29,20,9,1,1
112615,4,31,34,-3,17,1
387807,1,10,0,10,2,0
33093,2,3,14,-11,16,0
325541,4,28,19,9,8,1
297689,3,10,13,-3,13,1
349410,2,0,7,-7,2,1
330663,2,6,3,3,11,0
414237,2,14,14,0,14,0
390937,1,7,0,7,4,1
142708,1,0,7,-7,13,1
11763,1,0,0,0,6,1
135599,1,0,0,0,10,1
386706,4,17,19,-2,2,1
324887,3,17,13,4,8,0
206579,3,10,13,-3,7,1
248968,4,27,3,24,9,0
409485,1,0,0,0,12,0
112016,4,35,21,14,17,0
110794,3,6,10,-4,16,0
14741,2,21,0,21,7,1
253093,3,14,7,7,11,1
116356,4,40,13,27,1,1
228792,2,3,14,-11,17,1
150244,1,0,0,0,16,0
1361,2,7,0,7,1,0
182855,4,36,20,16,14,0
263594,2,7,7,0,15,0
248151,2,3,10,-7,8,1
189772,2,10,6,4,17,1
388283,2,3,3,0,2,1
14840,1,0,0,0,7,0
255279,4,13,17,-4,12,1
286876,2,9,7,2,8,0
247082,2,2,3,-1,8,0
251041,1,0,0,0,10,0
415834,1,0,13,-13,15,1
124155,4,19,21,-2,5,0
279324,4,29,23,6,5,1
345875,2,3,14,-11,17,0
84673,1,0,0,0,4,1
233190,4,43,18,25,2,0
356386,4,31,14,17,5,0
164301,1,13,0,13,5,0
323798,2,6,9,-3,8,0
178456,2,7,3,4,12,1
238013,3,10,13,-3,4,0
263089,4,10,13,-3,15,0
363893,4,20,29,-9,8,1
184023,4,29,10,19,14,0
339048,4,20,10,10,15,0
302838,3,9,23,-14,15,1
369264,2,14,14,0,11,0
224110,1,0,7,-7,15,1
317839,3,9,10,-1,5,1
281107,1,0,0,0,6,0
391813,1,3,0,3,4,1
141313,1,0,7,-7,13,1
254182,4,3,18,-15,11,0
204295,3,0,10,-10,6,0
362185,2,3,0,3,8,0
19409,2,14,7,7,10,0
132547,2,2,29,-27,9,1
398525,4,28,16,12,7,1
141931,1,7,0,7,13,1
333646,2,0,0,0,12,1
49795,2,7,7,0,6,1
5595,4,26,10,16,3,1
172021,1,0,0,0,9,0
411051,3,17,14,3,13,0
208217,4,3,10,-7,8,0
140736,2,15,14,1,12,0
95620,4,12,13,-1,10,0
387039,1,0,0,0,2,0
61951,1,0,0,0,12,0
106080,1,0,0,0,14,0
175740,4,37,13,24,11,1
114210,2,3,7,-4,1,1
252478,2,7,22,-15,10,0
312153,4,33,23,10,2,1
340170,2,20,7,13,15,0
325667,4,24,7,17,9,0
128017,1,0,0,0,7,0
238493,2,13,0,13,4,0
113837,1,0,0,0,17,0
292677,4,22,16,6,11,1
116804,4,34,33,1,2,1
33974,3,10,27,-17,16,0
86465,4,30,21,9,5,0
246142,1,7,0,7,7,0
107637,3,13,20,-7,15,0
11081,2,10,10,0,5,0
241651,1,0,0,0,5,1
209703,2,9,3,6,8,0
413199,1,0,0,0,14,1
334978,2,3,7,-4,13,1
98602,3,7,7,0,11,1
150408,1,7,0,7,16,1
395688,4,16,34,-18,6,1
63861,2,3,14,-11,12,0
298335,1,0,0,0,14,0
242825,4,21,34,-13,6,1
332637,3,27,13,14,12,0
210055,4,17,17,0,8,0
339260,2,21,0,21,15,1
337823,3,30,6,24,14,0
14169,3,0,24,-24,7,0
174203,3,3,23,-20,10,0
101913,3,6,13,-7,12,1
387720,3,0,16,-16,2,0
17137,4,30,17,13,9,1
352586,4,34,20,14,3,0
199881,4,10,24,-14,4,0
305968,1,0,0,0,17,1
215097,4,19,7,12,11,1
191517,2,14,14,0,17,0
369093,1,3,0,3,11,1
301437,2,10,3,7,15,0
58152,4,23,17,6,10,0
56395,2,0,21,-21,9,1
203911,1,0,7,-7,6,1
303989,1,0,0,0,16,0
171938,3,13,7,6,9,1
264398,2,3,21,-18,15,1
70016,3,24,10,14,15,1
191310,4,17,20,-3,17,1
166134,2,14,6,8,6,0
348973,2,14,0,14,2,0
277320,1,0,0,0,4,0
298840,3,21,9,12,14,0
284513,4,24,15,9,7,1
45122,2,7,0,7,4,0
121326,2,0,0,0,3,1
50580,2,0,6,-6,6,1
148620,3,7,9,-2,16,0
116944,4,28,13,15,2,0
56963,4,43,7,36,9,0
9450,2,10,0,10,5,1
176322,2,13,14,-1,11,0
257824,2,7,3,4,13,0
330929,1,0,0,0,11,0
199404,3,16,10,6,4,0
115962,1,7,0,7,1,0
200423,2,10,18,-8,4,0
175851,2,20,24,-4,11,1
222319,2,7,3,4,14,1
245213,1,0,0,0,7,0
82173,3,13,3,10,3,1
339354,1,0,0,0,15,0
312783,1,0,0,0,3,0
408597,2,21,0,21,12,0
413790,1,0,0,0,14,1
180969,3,23,21,2,13,1
159586,3,20,9,11,3,1
253158,4,21,23,-2,11,1
189645,3,10,6,4,17,0
167871,2,14,16,-2,7,0
215135,1,7,0,7,11,0
163746,2,0,9,-9,5,0
318450,3,24,7,17,5,0
348928,1,0,0,0,2,0
120670,1,3,0,3,3,0
66994,1,0,0,0,14,1
410942,4,14,29,-15,13,1
231605,2,14,10,4,1,1
312854,3,7,0,7,3,1
364352,1,0,0,0,9,1
223405,3,10,19,-9,15,1
400265,3,17,9,8,8,1
335152,2,20,0,20,13,1
140376,4,17,29,-12,12,1
115494,1,0,0,0,1,1
115264,3,7,9,-2,1,0
153134,3,20,17,3,1,0
214442,3,7,14,-7,11,0
178144,1,0,7,-7,12,0
37942,3,10,14,-4,1,0
39195,1,0,0,0,1,1
15781,2,0,12,-12,8,1
290834,3,17,14,3,10,0
284208,4,9,23,-14,7,0
336483,4,17,17,0,14,1
53103,2,19,21,-2,7,0
9754,2,2,7,-5,5,1
413620,4,9,24,-15,14,1
287593,1,0,3,-3,9,0
325825,4,6,17,-11,9,1
212224,4,3,24,-21,10,1
382588,4,0,24,-24,17,1
325282,2,3,3,0,8,1
95727,4,13,9,4,10,1
51459,2,13,24,-11,7,1
348451,1,0,0,0,2,0
302111,4,27,27,0,15,0
382330,1,0,0,0,17,1
302239,3,28,13,15,15,1
202227,1,3,0,3,5,1
378335,4,9,6,3,15,1
277735,3,7,3,4,4,0
7102,2,21,14,7,4,0
292929,3,7,0,7,11,1
209315,1,0,7,-7,8,1
173826,4,20,3,17,10,0
139665,1,0,0,0,12,1
97203,2,6,6,0,10,1
6290,4,16,17,-1,3,1
211984,2,3,13,-10,9,1
47374,3,3,13,-10,5,1
120592,3,0,20,-20,3,1
361943,3,10,3,7,7,1
302075,3,20,24,-4,15,0
328974,3,30,7,23,10,0
395550,4,27,14,13,6,0
178131,1,0,6,-6,12,0
23549,4,17,17,0,11,0
32378,2,14,6,8,15,1
184439,4,31,6,25,14,0
18240,1,0,14,-14,9,1
171538,4,30,10,20,9,0
179419,3,6,13,-7,12,0
359155,2,7,0,7,6,1
390577,4,17,21,-4,3,1
374354,1,0,0,0,14,1
14205,4,0,31,-31,7,1
243132,4,7,15,-8,6,1
207479,4,21,14,7,7,1
403627,3,24,19,5,9,0
347381,5,21,21,0,1,0
246727,1,3,0,3,8,0
157078,2,10,7,3,2,0
100752,1,6,0,6,12,1
404959,3,6,13,-7,10,0
389065,2,20,0,20,3,1
300068,4,7,40,-33,14,1
335998,3,13,18,-5,13,1
312798,2,0,0,0,3,1
169608,1,6,0,6,8,0
280788,1,0,0,0,6,1
169199,2,10,6,4,7,0
44276,3,17,20,-3,3,0
161359,5,20,19,1,4,0
389530,4,20,16,4,3,0
66225,3,31,3,28,13,0
178725,4,11,26,-15,12,0
232372,4,13,15,-2,1,1
122107,2,10,14,-4,4,0
219663,3,10,7,3,13,1
66785,3,10,6,4,14,1
283804,4,21,3,18,7,0
295971,1,0,0,0,13,1
82824,4,12,16,-4,3,0
280574,3,17,6,11,5,0
388526,4,3,23,-20,2,0
219666,3,10,7,3,13,0
118902,4,27,14,13,2,0
164258,4,48,41,7,5,0
365323,4,17,16,1,9,0
97245,3,12,13,-1,10,1
411279,1,0,3,-3,13,0
98017,4,17,17,0,11,1
113936,3,17,10,7,17,0
50842,2,7,14,-7,6,0
191990,3,10,20,-10,1,1
48450,4,17,20,-3,5,1
108371,2,0,14,-14,15,0
1685,2,13,0,13,1,1
372271,2,10,7,3,13,1
70603,3,10,10,0,15,1
115270,3,7,9,-2,1,1
394994,1,0,7,-7,5,1
278015,2,3,10,-7,4,1
27267,1,7,0,7,13,0
43464,1,0,0,0,3,1
169192,2,10,6,4,7,1
163237,1,3,3,0,5,1
86831,2,9,13,-4,5,0
41840,4,28,14,14,2,0
338296,4,34,43,-9,14,1
259642,4,9,6,3,13,0
400046,2,14,3,11,8,0
70923,4,15,36,-21,15,1
280101,2,14,0,14,5,0
118928,1,0,7,-7,3,1
376094,3,0,3,-3,14,0
22074,4,24,24,0,11,0
206712,3,0,14,-14,7,1
290149,1,0,0,0,10,1
403208,4,23,17,6,9,1
258184,4,13,13,0,13,1
252044,4,14,20,-6,10,1
268283,2,10,3,7,17,1
91512,3,19,3,16,8,0
320815,1,0,2,-2,6,1
226838,1,0,0,0,16,1
302449,1,3,3,0,15,0
34844,2,10,0,10,16,0
233776,3,13,34,-21,2,1
183867,4,43,28,15,14,1
26851,1,10,0,10,13,1
295271,3,14,5,9,12,1
101095,2,10,10,0,12,0
348147,4,24,22,2,1,1
396157,3,24,23,1,6,1
20669,2,10,17,-7,10,1
147395,2,13,7,6,15,1
36833,3,24,26,-2,17,0
161437,2,7,3,4,4,1
112891,3,13,6,7,17,1
283040,4,28,3,25,6,0
247109,2,13,3,10,8,0
64828,1,0,0,0,13,1
161142,3,3,26,-23,4,0
164914,2,0,3,-3,6,0
397,3,28,17,11,1,1
409168,4,3,17,-14,12,1
191255,3,7,17,-10,17,1
160201,3,30,7,23,3,1
174367,3,17,3,14,10,1
404708,1,0,0,0,10,0
63755,2,7,15,-8,12,1
132705,2,3,10,-7,9,1
330318,1,0,0,0,11,0
34640,4,24,10,14,16,1
263523,4,20,26,-6,15,1
127170,3,10,9,1,6,1
346214,2,20,0,20,1,1
409369,2,10,3,7,12,0
212477,3,10,3,7,10,0
377792,1,0,0,0,15,0
311886,2,7,0,7,2,1
378369,1,0,0,0,15,0
85997,3,14,16,-2,5,0
362783,2,7,14,-7,8,0
315785,2,0,3,-3,4,0
210124,2,0,0,0,9,1
50376,1,0,0,0,6,0
220586,4,10,26,-16,13,1
331016,3,39,7,32,11,0
400868,4,31,19,12,8,0
336200,4,24,10,14,13,1
167813,1,0,13,-13,7,1
47365,3,3,13,-10,5,0
346400,3,9,13,-4,1,0
354896,5,41,42,-1,4,1
109488,4,12,16,-4,16,1
64640,4,20,24,-4,13,1
115772,4,20,16,4,1,0
122023,4,16,13,3,4,1
85407,4,38,17,21,5,0
189893,1,0,7,-7,17,0
401012,4,22,15,7,8,1
273096,1,0,0,0,2,0
136282,2,15,7,8,11,1
387873,3,10,28,-18,2,1
112076,2,7,7,0,17,1
244127,4,20,34,-14,6,1
64922,4,10,6,4,13,0
39633,4,27,6,21,1,1
356693,3,19,13,6,5,0
36072,2,31,0,31,17,0
206063,1,7,3,4,7,1
173916,2,13,16,-3,10,1
40992,1,3,7,-4,2,1
360961,4,31,5,26,7,0
405040,1,0,0,0,10,1
386497,2,7,7,0,2,1
95775,1,3,0,3,10,0
113266,2,7,14,-7,17,1
63558,1,10,0,10,12,0
1396,3,10,0,10,1,0
405124,3,0,10,-10,10,1
333040,2,3,12,-9,12,0
111167,1,0,0,0,16,1
3547,1,0,7,-7,2,1
216625,1,0,3,-3,12,0
382202,1,3,3,0,17,0
398018,2,14,7,7,7,0
409813,2,10,0,10,12,1
19549,2,0,7,-7,10,1
298405,3,7,14,-7,14,0
32993,3,6,37,-31,15,1
233566,2,14,20,-6,2,0
311126,4,13,13,0,2,1
231737,2,3,13,-10,1,0
191064,2,7,0,7,17,1
344230,2,7,10,-3,17,1
323861,4,16,23,-7,8,0
223812,2,6,0,6,15,1
50624,4,10,6,4,6,1
43633,2,7,3,4,3,0
179370,2,3,6,-3,12,1
110075,1,0,0,0,16,1
221762,3,10,14,-4,14,0
323776,2,6,3,3,8,0
259313,3,13,13,0,13,0
348988,2,14,0,14,2,0
375099,1,0,0,0,14,1
40210,4,34,7,27,2,0
96801,4,7,17,-10,10,0
171799,3,23,14,9,9,1
9577,1,0,0,0,5,1
206699,2,0,14,-14,7,0
183192,1,0,0,0,14,1
130455,1,3,3,0,8,1
211700,3,23,9,14,9,0
145764,2,10,10,0,15,1
246063,3,16,13,3,7,1
333849,4,21,21,0,12,1
218126,2,7,3,4,12,1
32333,1,7,0,7,15,1
114718,4,15,10,5,1,1
278089,4,13,17,-4,4,1
163275,2,6,6,0,5,1
115122,3,3,20,-17,1,0
280563,2,14,6,8,5,0
184745,1,7,0,7,15,0
345936,4,20,23,-3,17,1
351993,3,28,21,7,3,1
270530,2,3,7,-4,1,1
254032,3,7,13,-6,11,1
154331,3,20,17,3,1,1
143600,1,7,3,4,14,1
190555,3,17,20,-3,17,0
66132,1,0,0,0,13,1
13343,3,7,27,-20,7,0
377454,4,14,13,1,15,0
48453,4,17,20,-3,5,1
90909,3,41,7,34,7,1
375715,1,3,0,3,14,0
334354,1,0,3,-3,13,1
320391,2,14,0,14,6,0
106659,4,46,9,37,14,0
53124,3,19,31,-12,7,0
184590,1,0,0,0,15,1
134509,4,3,33,-30,10,1
419734,2,10,10,0,17,0
383384,3,3,9,-6,17,0
239519,1,3,0,3,4,0
359766,3,27,16,11,6,0
179024,1,0,0,0,12,1
36989,4,0,32,-32,17,0
106778,3,20,21,-1,14,0
244983,3,0,20,-20,7,1
20569,4,17,0,17,10,0
294269,4,28,21,7,12,0
24277,4,13,17,-4,12,1
293549,3,13,17,-4,11,1
391278,2,14,0,14,4,0
398082,3,21,28,-7,7,1
296414,1,7,0,7,13,1
20084,4,22,16,6,10,0
243950,4,25,13,12,6,0
185788,4,25,3,22,15,1
381777,2,0,0,0,17,1
167353,3,23,16,7,7,1
342041,4,20,3,17,16,0
111455,4,7,20,-13,16,0
153228,1,2,0,2,1,0
283828,1,7,0,7,7,1
182035,3,14,14,0,13,0
251171,1,7,7,0,10,1
10673,4,10,17,-7,5,0
319669,3,26,3,23,6,1
153042,1,0,0,0,1,1
97774,1,7,0,7,11,0
166082,1,7,0,7,6,1
52887,4,14,58,-44,7,1
221497,4,10,41,-31,14,1
177329,1,0,0,0,11,1
293058,3,10,13,-3,11,1
345230,2,7,14,-7,17,1
306101,4,27,13,14,17,0
185374,2,0,3,-3,15,0
18722,2,3,7,-4,9,1
104961,4,10,16,-6,14,0
13016,3,14,7,7,6,0
339297,3,38,7,31,15,0
192932,2,7,17,-10,1,1
123877,1,0,0,0,5,0
345998,1,0,3,-3,1,1
61566,3,28,7,21,11,1
344938,2,9,7,2,17,1
156392,4,38,20,18,2,0
401354,1,0,0,0,8,1
214831,1,0,3,-3,11,1
370488,3,20,9,11,12,1
62047,4,24,10,14,12,0
309155,3,35,3,32,1,1
66200,2,24,3,21,13,0
192616,2,3,7,-4,1,1
52451,1,0,0,0,7,1
276726,4,30,27,3,4,0
305838,2,0,14,-14,17,0
31245,4,33,40,-7,15,0
373932,1,0,0,0,13,1
195181,1,10,0,10,2,1
182246,1,0,0,0,14,1
43134,1,0,0,0,3,0
48026,4,10,27,-17,5,0
121838,2,0,7,-7,4,0
380835,4,9,24,-15,16,1
20017,3,19,6,13,10,1
30298,2,3,10,-7,14,0
190161,4,30,3,27,17,0
31835,4,16,24,-8,15,1
253653,1,0,0,0,11,0
316556,2,3,3,0,4,0
176652,2,14,12,2,11,0
411305,2,0,10,-10,13,1
290778,1,0,0,0,10,1
325899,2,3,0,3,9,1
333126,4,27,30,-3,12,0
307994,4,14,12,2,1,1
385026,4,24,16,8,1,1
245082,1,7,0,7,7,0
274854,2,0,10,-10,3,0
3774,3,20,10,10,2,1
183740,1,0,7,-7,14,1
255222,3,13,14,-1,12,1
95598,4,12,10,2,10,0
359050,4,10,12,-2,6,0
404003,1,0,14,-14,10,1
124569,3,6,7,-1,5,0
198041,3,3,30,-27,3,0
348281,4,16,46,-30,1,1
326687,4,16,6,10,9,0
92022,4,27,26,1,8,0
244085,3,20,27,-7,6,0
417757,5,35,35,0,16,1
142511,4,27,13,14,13,1
79660,4,24,21,3,2,0
138191,3,7,9,-2,11,1
253938,4,44,14,30,11,0
324344,4,31,10,21,8,1
342785,4,7,14,-7,16,0
45401,1,7,0,7,4,0
410275,2,7,13,-6,13,1
348008,1,0,0,0,1,1
407522,1,3,0,3,11,1
264850,1,0,0,0,16,0
130603,1,7,7,0,8,0
259486,3,28,10,18,13,1
415320,3,6,14,-8,15,1
294146,1,0,0,0,12,0
332668,4,34,20,14,12,0
41898,2,14,3,11,2,1
391353,4,24,3,21,4,1
372085,1,0,0,0,13,1
418545,1,14,0,14,16,0
413570,3,6,17,-11,14,1
336239,1,3,0,3,13,1
402351,4,26,24,2,9,1
407240,2,0,9,-9,11,0
331162,3,7,13,-6,11,1
204706,2,7,7,0,6,0
333278,4,6,24,-18,12,1
111767,1,3,7,-4,17,1
418613,3,14,17,-3,16,0
208577,1,3,0,3,8,0
20926,1,7,7,0,10,1
378668,1,0,0,0,15,1
79630,3,21,14,7,2,0
151835,4,28,16,12,17,1
129072,2,17,21,-4,7,0
120497,5,39,41,-2,3,1
283272,2,10,9,1,7,1
11458,1,0,7,-7,6,1
106514,4,36,9,27,14,0
385166,3,14,17,-3,1,1
274972,1,7,0,7,3,0
304179,2,7,0,7,16,0
252042,4,14,20,-6,10,0
374089,1,7,0,7,13,1
183953,2,14,3,11,14,0
175405,2,17,6,11,11,0
180061,4,28,20,8,13,1
16550,4,30,13,17,8,1
229544,2,17,6,11,17,1
30478,4,31,35,-4,14,1
260806,3,9,12,-3,14,0
285979,4,29,14,15,8,1
357875,3,13,31,-18,6,0
230343,4,19,17,2,17,1
50926,4,17,27,-10,6,1
110636,3,20,10,10,16,0
277227,2,0,13,-13,4,0
294108,4,7,27,-20,12,1
98652,4,14,10,4,11,0
67074,4,10,9,1,14,1
130865,4,20,15,5,8,0
224520,4,18,10,8,15,0
244840,3,7,10,-3,7,1
349233,1,0,7,-7,2,0
315579,4,7,14,-7,4,0
365875,2,7,14,-7,9,1
297103,3,24,0,24,13,1
278766,2,0,0,0,5,0
360998,1,0,2,-2,7,1
148205,4,16,21,-5,16,0
258395,2,14,6,8,13,1
4403,4,7,14,-7,2,1
59819,4,15,13,2,11,1
361261,4,14,29,-15,7,1
206182,1,0,0,0,7,0
243486,4,10,30,-20,6,1
229060,1,3,0,3,17,0
286852,2,3,7,-4,8,0
181516,1,0,0,0,13,1
242431,2,0,7,-7,6,0
230042,4,13,6,7,17,0
39001,4,30,17,13,1,1
194055,4,27,7,20,1,0
297930,2,10,6,4,13,0
148873,1,0,6,-6,16,1
81345,1,0,7,-7,3,0
189449,2,7,0,7,17,1
306887,2,3,13,-10,17,0
84729,2,10,14,-4,4,0
148590,2,0,6,-6,16,1
354339,2,35,3,32,4,0
66148,1,3,0,3,13,0
417199,2,10,17,-7,16,0
257428,4,23,14,9,13,0
197976,2,0,10,-10,3,0
399717,1,0,3,-3,8,0
212306,2,10,3,7,10,0
72542,4,16,24,-8,16,1
268301,2,17,3,14,17,0
78159,3,20,3,17,2,0
245877,2,3,30,-27,7,1
286459,4,17,10,7,8,1
125344,3,24,3,21,5,1
175971,1,0,0,0,11,1
413392,2,3,21,-18,14,1
103591,1,0,0,0,13,1
318946,1,0,0,0,5,0
230371,1,0,0,0,1,1
306789,4,19,33,-14,17,0
54501,3,7,7,0,8,0
28874,4,23,7,16,14,0
283666,1,0,0,0,7,1
75068,1,0,0,0,17,0
305364,2,14,3,11,17,0
215179,2,7,9,-2,11,0
258368,1,7,0,7,13,0
194069,4,27,14,13,1,1
8562,1,0,0,0,4,1
147061,1,0,7,-7,15,0
237637,2,3,7,-4,4,0
193981,1,14,0,14,1,0
336457,3,10,17,-7,14,0
363653,2,0,10,-10,8,1
284603,2,14,7,7,7,0
222792,2,10,7,3,14,0
175041,4,20,28,-8,10,1
157555,2,2,0,2,2,1
97934,1,0,7,-7,11,0
229291,3,24,24,0,17,1
281622,2,21,0,21,6,1
127935,3,23,0,23,6,0
178218,3,6,10,-4,12,0
105306,4,10,26,-16,14,1
161065,1,3,0,3,4,1
93508,4,3,31,-28,9,1
128959,2,28,3,25,7,1
91658,3,21,14,7,8,0
417380,3,13,17,-4,16,1
333328,2,10,7,3,12,1
351082,3,21,23,-2,3,1
221560,2,20,12,8,14,1
223505,2,7,10,-3,15,0
39436,3,10,10,0,1,1
14179,3,0,24,-24,7,1
407386,2,0,7,-7,11,1
322728,1,0,14,-14,7,1
288611,4,23,41,-18,9,1
364652,1,0,0,0,9,1
417748,5,35,35,0,16,1
83649,1,0,3,-3,4,1
278141,2,7,7,0,4,0
244353,2,0,10,-10,7,1
325975,4,22,7,15,9,0
305848,2,0,14,-14,17,1
69700,2,7,7,0,15,1
360053,3,3,33,-30,7,1
335404,1,0,3,-3,13,1
144413,2,0,13,-13,14,1
84346,4,28,30,-2,4,0
149487,1,0,6,-6,16,1
341134,4,21,24,-3,15,0
235875,3,0,14,-14,3,0
198474,3,17,3,14,3,1
81798,1,0,7,-7,3,1
142936,3,3,10,-7,13,0
267097,2,3,3,0,17,1
205094,4,22,27,-5,6,1
109271,3,6,0,6,15,1
174585,4,13,14,-1,10,0
40098,1,0,0,0,2,1
136882,2,0,10,-10,11,1
286591,3,17,31,-14,8,0
29656,1,0,0,0,14,1
337237,4,16,23,-7,14,0
267739,4,16,34,-18,17,1
359983,1,0,13,-13,7,1
50291,3,13,16,-3,6,0
279032,4,13,33,-20,5,0
69509,1,0,0,0,15,1
349938,4,10,12,-2,2,1
196224,2,7,10,-3,2,1
208536,4,47,15,32,8,0
164488,3,17,0,17,5,1
146389,3,10,3,7,15,1
26021,4,10,19,-9,13,0
72627,2,13,0,13,16,1
97960,2,0,10,-10,11,1
377038,4,22,29,-7,15,1
122425,2,6,20,-14,4,1
394368,4,31,17,14,5,1
241879,3,13,13,0,5,1
283139,3,6,9,-3,7,1
379289,2,0,3,-3,16,1
9806,3,9,17,-8,5,1
312928,1,0,0,0,3,1
305233,2,14,14,0,16,0
271760,3,23,10,13,2,0
336318,3,20,10,10,13,1
249061,2,21,17,4,9,1
402346,4,26,24,2,9,0
241362,2,7,6,1,5,0
13811,4,7,36,-29,7,1
15489,3,16,0,16,8,1
131537,3,6,16,-10,8,0
282678,3,6,17,-11,6,1
229808,1,6,0,6,17,0
117251,4,30,24,6,2,1
257141,5,24,24,0,12,0
163227,1,0,3,-3,5,1
120964,1,5,7,-2,3,1
53491,1,6,0,6,8,1
195417,4,24,3,21,2,1
65797,4,27,33,-6,13,1
5393,3,13,13,0,3,0
391036,4,27,34,-7,4,1
233161,3,29,3,26,2,0
365295,3,10,16,-6,9,1
224722,1,3,0,3,15,0
305157,4,24,10,14,16,1
146124,4,25,17,8,15,0
142303,2,0,0,0,13,0
366901,4,3,16,-13,10,1
103851,3,19,0,19,13,0
99475,2,0,10,-10,11,1
164026,2,0,3,-3,5,1
356973,3,17,3,14,5,0
323965,2,17,10,7,8,0
157928,3,9,15,-6,3,1
190369,2,7,0,7,17,1
240851,4,39,10,29,5,0
24224,3,10,10,0,12,0
62148,3,7,14,-7,12,1
409156,4,3,17,-14,12,1
282999,3,14,3,11,6,1
136718,2,13,10,3,11,0
331322,3,0,27,-27,11,1
325157,2,13,14,-1,8,1
20328,2,10,13,-3,10,0
78895,3,17,7,10,2,0
9014,2,7,7,0,4,0
209611,4,50,34,16,8,0
145914,2,7,7,0,15,1
166777,3,20,16,4,6,0
6595,4,22,12,10,3,0
72992,1,0,0,0,16,1
336291,3,17,3,14,13,1
22323,3,0,3,-3,11,0
168246,1,0,7,-7,7,1
233226,1,0,0,0,2,1
3356,4,3,6,-3,2,1
285034,1,0,0,0,7,1
43245,4,24,10,14,3,1
264461,4,20,34,-14,15,0
137538,2,17,17,0,11,1
263984,4,23,7,16,15,0
34557,2,7,0,7,16,1
362716,4,3,13,-10,8,1
10649,3,10,17,-7,5,0
121963,2,3,7,-4,4,1
50778,4,24,21,3,6,0
150656,4,17,22,-5,17,0
72606,1,7,0,7,16,0
222409,4,24,10,14,14,0
402926,4,17,9,8,9,1
294619,1,0,0,0,12,0
50470,4,17,10,7,6,0
395115,4,24,34,-10,5,0
72847,4,38,17,21,16,1
285895,2,13,0,13,8,0
106700,1,0,5,-5,14,1
258287,3,21,12,9,13,0
193995,2,14,7,7,1,1
329829,4,17,20,-3,11,0
51336,3,16,20,-4,7,1
230791,4,17,27,-10,1,0
156134,2,7,7,0,2,1
261128,4,21,24,-3,14,0
105077,2,25,14,11,14,1
373133,4,10,21,-11,13,1
279613,4,10,16,-6,5,1
57030,2,7,17,-10,9,1
263902,2,6,0,6,15,1
300754,2,7,13,-6,15,1
115712,3,10,3,7,1,1
224460,2,9,10,-1,15,0
137562,3,17,27,-10,11,1
131495,2,0,3,-3,8,0
219262,4,22,10,12,13,1
315750,1,0,0,0,4,0
67571,2,0,7,-7,14,0
104697,1,0,0,0,14,1
408695,4,41,17,24,12,0
100554,4,20,20,0,12,1
23856,4,24,7,17,12,1
298806,2,14,6,8,14,1
294156,1,0,6,-6,12,0
376946,2,3,13,-10,15,1
2235,2,7,7,0,1,1
319953,2,30,10,20,6,0
385969,4,24,21,3,1,0
198353,4,20,14,6,3,1
381585,4,42,16,26,17,1
85066,4,31,16,15,4,1
383841,3,3,7,-4,1,0
72257,4,27,17,10,16,1
222079,4,27,10,17,14,0
143018,1,0,0,0,13,0
139513,1,6,0,6,12,0
224115,1,0,7,-7,15,0
175423,3,17,20,-3,11,0
151940,3,20,17,3,17,1
266207,2,24,6,18,16,1
259436,2,6,3,3,13,0
382655,2,0,0,0,17,1
296056,3,3,7,-4,13,1
129537,2,3,14,-11,7,0
221081,1,0,0,0,14,0
392255,4,10,16,-6,4,1
163638,4,21,22,-1,5,1
110643,3,20,10,10,16,0
303376,1,0,0,0,16,1
217858,2,10,14,-4,12,0
36821,3,17,26,-9,17,1
88006,2,17,0,17,6,0
105850,3,16,10,6,14,1
230643,1,0,0,0,1,0
7072,1,7,14,-7,4,0
312722,4,28,14,14,3,1
4063,2,13,21,-8,2,1
90215,4,6,3,3,7,1
405113,3,0,10,-10,10,0
133646,3,10,27,-17,9,0
51956,4,13,16,-3,7,0
143717,4,19,17,2,14,0
193359,2,7,10,-3,1,1
194303,2,10,3,7,2,1
40600,2,24,7,17,2,0
199954,2,10,10,0,4,0
125239,4,31,21,10,5,0
403984,1,0,7,-7,10,1
228375,3,7,17,-10,17,0
279560,3,10,13,-3,5,0
153223,1,2,0,2,1,0
12172,4,20,28,-8,6,1
63310,2,10,3,7,12,0
245422,3,9,6,3,7,1
385910,2,3,7,-4,1,0
272342,1,14,0,14,2,1
220775,1,0,0,0,14,1
352094,2,3,13,-10,3,0
134801,3,41,17,24,10,1
367330,4,6,20,-14,10,1
303613,3,28,13,15,16,0
190465,1,7,0,7,17,0
405971,4,14,7,7,11,1
410751,3,17,6,11,13,0
188315,4,20,13,7,16,1
79187,3,17,10,7,2,1
363812,2,13,10,3,8,1
174140,1,0,0,0,10,0
231000,2,10,0,10,1,0
302564,4,3,16,-13,15,0
267905,4,29,24,5,17,1
198634,3,3,14,-11,3,1
65960,4,24,21,3,13,0
149264,3,10,20,-10,16,1
124424,3,6,7,-1,5,1
341079,3,7,17,-10,15,0
9176,2,3,16,-13,5,1
33999,4,10,27,-17,16,0
356274,1,7,0,7,5,0
69947,1,14,0,14,15,0
343699,4,18,10,8,17,1
15394,4,10,24,-14,8,1
231570,1,7,3,4,1,1
291665,1,0,0,0,11,0
80783,2,3,0,3,3,1
363517,2,3,2,1,8,1
24031,1,0,0,0,12,1
182566,1,0,3,-3,14,0
361365,3,10,7,3,7,1
8399,4,30,10,20,4,1
346293,4,47,3,44,1,0
169346,2,3,14,-11,8,1
385614,4,6,17,-11,1,0
241317,4,13,14,-1,5,1
18940,1,0,0,0,10,0
331362,4,8,33,-25,11,1
136921,3,0,13,-13,11,0
67350,3,20,6,14,14,1
49561,4,14,3,11,6,1
231310,2,3,3,0,1,0
295432,3,10,13,-3,12,0
266133,4,17,13,4,16,0
59612,2,14,3,11,11,1
32486,1,7,3,4,15,1
116697,2,6,3,3,2,0
48674,2,7,7,0,5,0
134401,1,0,0,0,10,1
396073,1,17,3,14,6,0
46585,2,3,0,3,4,1
54637,2,14,19,-5,8,0
12835,2,13,3,10,6,1
93659,4,23,13,10,9,0
22752,3,3,21,-18,11,1
399553,4,0,33,-33,7,1
382041,1,0,0,0,17,1
5220,2,14,17,-3,3,1
223792,1,6,0,6,15,1
121836,2,0,7,-7,4,0
180273,1,6,0,6,13,0
44391,2,0,0,0,3,1
190243,2,7,13,-6,17,0
271656,4,29,37,-8,2,1
375808,3,20,0,20,14,0
75341,4,21,33,-12,17,1
284742,2,6,10,-4,7,0
156070,4,20,24,-4,2,0
76799,3,33,0,33,1,0
404050,3,10,28,-18,10,1
111969,3,14,21,-7,17,1
262360,4,16,19,-3,15,1
182897,1,0,16,-16,14,0
239485,4,22,24,-2,4,1
227097,1,0,0,0,16,0
371081,4,13,20,-7,12,0
375442,1,7,7,0,14,1
17958,2,13,21,-8,9,1
297410,4,23,24,-1,13,0
128798,3,13,13,0,7,0
285430,3,27,0,27,8,0
297212,2,0,3,-3,13,0
6345,1,0,3,-3,3,0
398770,3,14,17,-3,7,0
153695,2,2,14,-12,1,1
415383,1,0,0,0,15,1
376447,4,23,23,0,14,1
58820,4,18,36,-18,10,0
290067,3,7,6,1,10,1
35557,1,7,0,7,17,0
77345,2,7,7,0,1,0
94141,2,3,7,-4,9,0
208991,1,0,0,0,8,0
1844,3,16,7,9,1,0
13120,1,3,7,-4,6,1
378585,3,17,13,4,15,1
413017,4,16,18,-2,14,1
6192,1,7,0,7,3,0
251287,4,13,30,-17,10,1
302779,2,3,13,-10,15,1
401939,1,0,3,-3,9,0
224162,2,0,20,-20,15,0
270735,3,6,3,3,1,1
219045,3,24,7,17,13,0
411766,2,0,17,-17,13,0
355600,3,24,10,14,5,1
92347,1,0,0,0,8,1
123562,4,16,17,-1,4,1
190454,1,0,0,0,17,1
91390,4,21,14,7,8,1
337812,3,30,6,24,14,0
138077,4,42,24,18,11,1
14159,2,0,21,-21,7,0
249398,3,18,15,3,9,1
76863,1,0,0,0,1,1
49464,1,0,0,0,6,0
77791,2,7,14,-7,1,0
88864,4,20,16,4,6,0
6375,2,0,13,-13,3,0
151209,3,10,20,-10,17,1
246126,1,7,0,7,7,0
206982,2,21,0,21,7,1
43321,1,14,7,7,3,0
246822,4,10,20,-10,8,1
215185,2,7,9,-2,11,1
3821,4,23,10,13,2,0
411517,4,13,31,-18,13,1
363903,1,0,0,0,8,0
101607,4,13,37,-24,12,0
252237,4,26,24,2,10,0
239979,2,0,10,-10,5,0
221526,1,6,9,-3,14,1
115978,2,10,0,10,1,0
122092,2,7,7,0,4,1
376621,1,0,0,0,14,0
368977,2,7,7,0,11,1
117585,1,0,0,0,2,0
313542,2,0,7,-7,3,0
384268,2,6,0,6,1,0
383076,2,20,7,13,17,0
4688,4,20,20,0,2,1
392052,4,10,24,-14,4,1
270715,3,6,3,3,1,1
86862,3,9,23,-14,5,1
361053,3,16,2,14,7,1
75690,1,7,0,7,1,1
16858,4,26,38,-12,8,1
395145,1,0,0,0,5,1
393597,3,7,26,-19,5,0
399180,2,10,6,4,7,1
58790,4,10,29,-19,10,1
130346,2,7,0,7,8,0
55598,4,27,7,20,9,0
227491,3,19,10,9,16,0
146845,3,24,0,24,15,0
171289,2,0,3,-3,9,0
346846,3,10,3,7,1,0
404728,1,7,3,4,10,0
184419,4,24,6,18,14,0
126508,2,0,6,-6,6,1
315690,3,10,13,-3,4,0
324410,2,14,3,11,8,1
148493,3,24,3,21,16,1
317745,1,0,0,0,5,0
116166,3,7,10,-3,1,0
220614,4,16,29,-13,13,0
179891,3,17,9,8,13,1
234183,2,10,10,0,2,0
174075,3,0,33,-33,10,0
242537,4,25,13,12,6,0
273216,4,40,7,33,2,0
217529,1,0,0,0,12,1
275188,3,14,16,-2,3,1
94844,4,6,13,-7,9,1
124051,1,0,7,-7,5,0
49486,2,0,3,-3,6,1
308113,3,13,16,-3,1,0
366553,2,20,7,13,10,1
220212,1,17,0,17,13,0
407794,4,16,7,9,11,1
77816,2,7,14,-7,1,1
291016,4,20,13,7,10,0
302458,1,3,3,0,15,1
132026,4,3,24,-21,8,0
366226,1,7,0,7,10,0
182907,2,0,23,-23,14,0
76528,3,7,26,-19,1,0
90337,4,14,26,-12,7,0
238610,1,6,0,6,4,1
347464,2,12,13,-1,1,0
322834,4,3,40,-37,7,1
105253,3,10,24,-14,14,0
176778,1,3,0,3,11,1
28435,4,13,6,7,14,1
292885,2,7,0,7,11,0
162881,4,13,6,7,5,0
125356,4,31,3,28,5,1
265231,3,6,6,0,16,1
10834,4,21,14,7,5,1
211429,1,0,0,0,9,1
238190,2,3,16,-13,4,1
261301,4,38,0,38,14,0
299071,1,3,0,3,14,0
368800,1,0,0,0,11,1
302140,4,34,48,-14,15,1
309512,1,3,0,3,1,0
302231,3,28,13,15,15,1
293612,1,7,0,7,12,0
213199,2,3,10,-7,10,0
46200,3,14,20,-6,4,0
359490,3,0,14,-14,6,0
234414,1,0,0,0,2,1
269465,1,3,3,0,1,1
84920,4,41,17,24,4,1
239486,4,22,24,-2,4,1
25241,2,7,0,7,12,0
126963,2,3,10,-7,6,1
26648,4,24,20,4,13,0
115908,4,7,23,-16,1,0
320737,3,14,23,-9,6,0
378569,2,17,13,4,15,1
212824,4,23,21,2,10,1
32953,2,0,17,-17,15,0
219735,1,0,0,0,13,1
343454,2,7,7,0,16,1
312843,3,7,0,7,3,1
276929,2,14,14,0,4,1
62815,4,20,0,20,12,0
358905,3,6,35,-29,6,1
204107,2,3,10,-7,6,0
404703,1,0,0,0,10,1
95801,2,6,3,3,10,0
214475,4,7,17,-10,11,0
194539,1,0,0,0,2,1
223585,4,24,13,11,15,0
354807,3,13,28,-15,4,1
153128,3,13,17,-4,1,1
376667,2,3,0,3,14,1
324386,2,7,3,4,8,0
391921,4,23,27,-4,4,0
389217,3,21,7,14,3,0
321341,4,22,19,3,6,0
105351,2,7,7,0,14,0
259560,1,0,0,0,13,1
356147,2,10,0,10,5,0
257912,4,23,19,4,13,1
22776,3,3,21,-18,11,1
421624,1,3,0,3,17,0
132293,3,24,13,11,9,0
292389,4,12,16,-4,11,1
255197,2,7,7,0,12,1
142989,4,10,13,-3,13,0
194118,1,0,0,0,1,1
169376,3,6,14,-8,8,0
405981,4,14,7,7,11,1
254531,1,0,0,0,11,1
167322,2,16,10,6,7,1
25187,4,20,3,17,12,1
137012,5,23,20,3,11,1
59967,3,3,24,-21,11,0
243096,3,7,9,-2,6,0
221016,4,21,20,1,14,0
42382,3,14,15,-1,2,0
235416,3,28,17,11,3,0
29985,2,14,0,14,14,1
301969,4,20,20,0,15,0
49689,3,14,21,-7,6,0
218455,3,24,14,10,13,0
377819,2,7,0,7,15,1
132879,3,6,14,-8,9,1
240917,2,14,3,11,5,0
73617,2,0,0,0,17,0
302172,1,14,0,14,15,1
351460,1,0,7,-7,3,1
314722,1,13,0,13,4,1
40597,2,24,7,17,2,0
42960,3,31,23,8,3,0
293705,4,10,13,-3,12,0
218097,1,0,0,0,12,1
232022,2,0,10,-10,1,1
337531,4,7,26,-19,14,1
82483,3,10,17,-7,3,1
421765,4,31,24,7,17,1
288993,2,16,7,9,9,1
189080,4,21,30,-9,16,1
365995,2,23,7,16,10,0
114888,4,24,40,-16,1,1
200211,4,14,37,-23,4,0
26904,3,10,6,4,13,1
84233,1,0,0,0,4,0
55499,1,10,0,10,9,1
419041,3,7,20,-13,16,1
105954,2,10,0,10,14,0
140096,2,0,0,0,12,1
190253,3,7,14,-7,17,1
231840,1,0,13,-13,1,1
129426,3,23,13,10,7,1
49625,1,0,7,-7,6,1
384364,4,16,17,-1,1,0
392416,4,40,45,-5,4,0
43051,2,3,7,-4,3,1
386184,2,6,3,3,2,0
73773,2,3,0,3,17,1
38755,1,0,3,-3,1,1
229099,2,13,7,6,17,0
405707,2,10,0,10,10,0
297489,1,2,0,2,13,1
269342,2,7,7,0,1,0
24129,4,14,14,0,12,1
265031,2,7,3,4,16,1
355980,2,7,7,0,5,0
301752,2,0,17,-17,15,0
321614,3,17,6,11,7,0
81587,4,17,24,-7,3,0
103365,3,10,17,-7,13,0
325024,3,20,21,-1,8,0
255437,1,0,0,0,12,0
297889,1,3,0,3,13,1
214784,3,3,20,-17,11,1
282629,2,3,7,-4,6,1
398790,3,14,24,-10,7,1
421526,3,10,3,7,17,0
122128,3,17,14,3,4,0
21932,4,35,9,26,11,0
361345,2,3,0,3,7,0
371628,3,17,17,0,12,0
321131,2,0,10,-10,6,1
142968,4,10,13,-3,13,0
321604,2,10,6,4,7,1
296871,1,3,0,3,13,1
398634,3,0,0,0,7,0
121423,4,7,12,-5,3,0
142385,1,0,0,0,13,0
222330,2,14,3,11,14,0
270539,2,10,7,3,1,0
100045,2,3,3,0,12,0
325426,1,13,0,13,8,0
5947,3,14,23,-9,3,1
188525,2,3,3,0,16,0
224443,2,9,10,-1,15,0
263191,3,9,17,-8,15,1
56977,1,0,7,-7,9,0
236697,3,24,7,17,3,0
149252,2,7,13,-6,16,1
232375,4,13,15,-2,1,0
373108,4,10,21,-11,13,1
262101,2,14,3,11,15,1
242057,4,10,9,1,5,1
38235,3,13,14,-1,1,0
88222,4,17,17,0,6,1
173129,1,10,7,3,9,0
118260,2,9,7,2,2,1
201350,3,28,13,15,5,0
165329,1,0,0,0,6,1
111873,4,16,10,6,17,0
96364,4,9,30,-21,10,1
22869,2,0,10,-10,11,0
73277,4,14,23,-9,16,0
30319,3,3,10,-7,14,0
256977,4,39,30,9,12,1
29424,2,6,14,-8,14,1
44338,4,24,23,1,3,1
198205,4,10,9,1,3,1
236475,2,7,3,4,3,1
124330,4,41,20,21,5,0
194806,4,10,23,-13,2,0
313416,2,7,6,1,3,0
273158,2,10,0,10,2,1
327466,4,10,30,-20,9,0
164681,4,21,27,-6,5,1
365465,3,10,19,-9,9,1
164525,4,23,10,13,5,1
300886,2,10,7,3,15,0
285675,5,27,27,0,8,1
153651,1,0,0,0,1,0
250277,1,7,0,7,9,0
187687,2,7,6,1,16,1
208805,3,6,22,-16,8,0
22674,4,30,24,6,11,1
275001,2,24,3,21,3,0
338776,1,7,0,7,15,0
153939,1,0,0,0,1,0
319557,5,22,23,-1,6,0
208294,2,7,14,-7,8,0
180007,2,7,13,-6,13,0
136189,4,13,10,3,10,1
28356,2,3,0,3,14,0
301095,4,33,13,20,15,1
288145,4,19,7,12,9,1
129811,1,7,0,7,7,1
110449,2,17,0,17,16,0
265208,2,6,6,0,16,1
183693,3,6,14,-8,14,1
56491,4,7,41,-34,9,0
220063,1,13,0,13,13,0
315004,1,7,0,7,4,1
310199,4,24,10,14,2,1
287798,2,21,10,11,9,1
260919,2,0,0,0,14,0
173622,3,7,13,-6,10,0
390970,2,13,7,6,4,0
205237,4,23,13,10,6,1
149918,4,6,23,-17,16,1
98526,1,0,0,0,11,0
104989,4,17,22,-5,14,0
341669,2,17,13,4,16,0
198461,3,17,3,14,3,0
340736,1,0,7,-7,15,1
165754,4,23,7,16,6,0
252539,4,29,32,-3,10,1
180254,1,0,0,0,13,1
363612,4,18,15,3,8,0
137422,3,6,21,-15,11,0
3076,1,0,0,0,2,1
137758,4,10,34,-24,11,0
382008,4,0,30,-30,17,1
35542,4,30,7,23,17,1
247053,1,0,3,-3,8,1
81601,4,30,24,6,3,0
362805,3,7,21,-14,8,1
122542,2,14,0,14,4,0
277043,1,3,0,3,4,0
320895,3,3,14,-11,6,1
67040,3,10,3,7,14,0
391051,4,27,34,-7,4,1
375379,4,14,24,-10,14,0
124644,1,0,0,0,5,1
262417,2,7,7,0,15,1
258830,2,7,7,0,13,0
232069,3,0,30,-30,1,0
267883,4,26,24,2,17,0
225884,1,7,0,7,16,1
324584,3,16,9,7,8,0
280170,3,28,0,28,5,1
61421,3,16,3,13,11,0
373089,3,3,20,-17,13,0
150314,2,24,7,17,16,1
116928,3,21,10,11,2,1
108621,1,0,0,0,15,0
379857,1,7,0,7,16,0
292671,4,22,16,6,11,0
231342,3,9,16,-7,1,0
119668,4,17,18,-1,3,0
155282,4,28,27,1,1,0
217302,2,0,7,-7,12,0
306680,1,0,0,0,17,1
85114,1,0,0,0,4,0
239847,2,7,3,4,4,1
144117,3,23,0,23,14,0
173501,3,3,20,-17,10,1
282802,2,0,13,-13,6,1
334374,2,0,10,-10,13,1
306769,3,16,27,-11,17,1
75563,2,7,0,7,17,0
156023,3,17,17,0,2,1
257205,2,10,16,-6,12,1
192952,3,7,17,-10,1,1
356544,4,9,6,3,5,1
375322,2,7,13,-6,14,0
232141,1,3,0,3,1,0
374636,4,23,27,-4,14,0
82223,4,16,10,6,3,0
338161,1,7,7,0,14,1
376683,3,3,0,3,14,1
84327,3,21,27,-6,4,0
292963,4,10,6,4,11,0
294527,3,17,13,4,12,0
360865,1,0,0,0,7,1
368600,4,16,6,10,11,0
140499,4,21,26,-5,12,0
397863,2,0,3,-3,7,1
36684,4,20,3,17,17,0
15847,4,8,12,-4,8,1
31702,1,0,0,0,15,1
308217,2,7,10,-3,1,0
176138,2,14,7,7,11,1
382225,2,10,3,7,17,0
402503,4,26,18,8,9,0
316655,4,12,12,0,4,1
57493,2,21,10,11,10,0
335471,4,13,12,1,13,0
274830,1,0,0,0,3,0
165981,2,17,14,3,6,0
61947,1,0,0,0,12,1
139893,4,23,24,-1,12,0
185181,1,0,0,0,15,0
171428,1,0,0,0,9,1
146771,1,7,0,7,15,0
211850,3,22,10,12,9,1
121535,3,9,7,2,4,1
256681,1,0,0,0,12,0
270473,4,13,7,6,1,1
310879,2,3,3,0,2,0
319394,4,23,28,-5,6,1
76793,3,33,0,33,1,0
106334,3,14,19,-5,14,1
199206,2,10,7,3,4,0
268790,3,31,10,21,17,1
228156,1,7,10,-3,17,0
194656,4,31,7,24,2,0
272163,1,0,0,0,2,1
261510,2,6,0,6,14,1
305254,2,21,21,0,16,0
399317,2,14,7,7,7,1
128591,1,0,0,0,7,1
187012,1,0,0,0,16,0
211929,1,0,3,-3,9,1
205835,3,20,0,20,7,0
404690,4,27,32,-5,10,0
346812,2,10,3,7,1,0
200408,2,10,12,-2,4,1
317994,3,10,10,0,5,0
417285,1,0,0,0,16,1
134955,3,7,22,-15,10,1
61120,3,0,7,-7,11,1
53654,1,0,0,0,8,1
167395,4,37,33,4,7,0
7372,1,0,0,0,4,1
324174,4,3,17,-14,8,1
317150,1,0,0,0,5,0
188480,4,10,17,-7,16,0
401216,1,0,7,-7,8,1
233000,3,10,10,0,2,1
88466,2,10,7,3,6,1
393592,3,7,26,-19,5,1
275886,2,10,6,4,3,1
3648,4,20,28,-8,2,1
280555,2,14,3,11,5,0
150440,2,20,3,17,16,1
171758,2,3,7,-4,9,1
37999,1,0,0,0,1,1
135432,4,28,27,1,10,1
128687,4,6,17,-11,7,0
36583,1,3,0,3,17,1
286346,1,0,0,0,8,0
187895,4,7,23,-16,16,1
379525,1,0,3,-3,16,1
146678,2,7,26,-19,15,1
77988,2,3,13,-10,1,1
71411,2,14,0,14,16,1
341399,3,0,13,-13,16,1
334221,1,3,0,3,13,1
66061,3,7,3,4,13,1
355806,1,6,0,6,5,1
27627,2,7,10,-3,13,0
117235,4,23,17,6,2,1
35264,1,0,0,0,16,1
190625,1,14,7,7,17,0
247337,4,42,48,-6,8,1
399731,2,0,3,-3,8,0
262334,4,13,9,4,15,0
145322,3,28,12,16,14,1
89108,3,16,6,10,6,1
351642,2,7,7,0,3,0
287722,1,0,0,0,9,1
232405,4,20,25,-5,1,0
32089,3,14,13,1,15,0
34510,1,0,0,0,16,0
216346,2,14,13,1,12,0
82464,2,7,14,-7,3,0
213730,4,31,17,14,10,0
194813,4,10,26,-16,2,1
170076,1,0,0,0,8,1
239800,1,0,0,0,4,1
100033,2,3,3,0,12,0
286751,3,20,21,-1,8,1
42551,4,10,24,-14,3,1
138306,2,20,0,20,11,0
337658,3,24,13,11,14,0
333573,4,16,16,0,12,1
421651,2,3,7,-4,17,1
259630,3,6,6,0,13,0
244453,1,0,0,0,7,1
71567,1,3,7,-4,16,0
388477,3,3,16,-13,2,0
407309,4,23,19,4,11,1
385378,1,6,7,-1,1,1
373680,2,0,15,-15,13,1
826,3,14,6,8,1,0
348083,3,0,16,-16,1,0
179018,4,19,3,16,12,1
137892,3,17,8,9,11,0
218247,1,0,0,0,12,0
16704,4,21,33,-12,8,1
193409,3,10,20,-10,1,1
52416,4,12,17,-5,7,0
246851,5,20,20,0,8,0
273826,4,17,7,10,2,0
274957,1,0,0,0,3,1
81662,1,7,7,0,3,0
335973,2,0,15,-15,13,1
314757,2,14,0,14,4,1
222127,1,0,0,0,14,1
26926,4,13,6,7,13,0
127412,1,0,0,0,6,1
140514,4,21,29,-8,12,1
327627,4,10,22,-12,10,1
377879,3,20,10,10,15,1
49494,2,7,3,4,6,0
53722,3,7,0,7,8,0
141484,2,7,0,7,13,1
395473,2,7,0,7,6,1
401800,1,7,0,7,9,0
283819,1,6,0,6,7,1
98743,3,28,6,22,11,0
95492,1,0,0,0,10,1
105028,1,0,7,-7,14,0
66175,2,17,3,14,13,1
104856,1,0,3,-3,14,1
29785,4,47,3,44,14,1
293537,3,10,17,-7,11,1
227265,2,3,13,-10,16,1
245495,1,0,0,0,7,1
146743,4,22,35,-13,15,1
240230,4,16,12,4,5,0
371878,2,21,10,11,12,1
164780,3,26,14,12,6,0
406795,2,0,17,-17,11,0
256950,4,26,27,-1,12,1
154800,4,21,23,-2,1,1
312523,2,20,0,20,3,1
397701,1,6,0,6,7,0
380040,2,21,14,7,16,0
229563,3,26,6,20,17,1
94257,4,24,37,-13,9,1
178252,4,6,13,-7,12,1
170016,4,28,17,11,8,1
371407,1,7,7,0,12,0
35307,2,13,0,13,16,0
271345,4,16,31,-15,1,1
169922,1,7,0,7,8,1
27556,4,23,18,5,13,1
375153,2,17,10,7,14,1
234233,4,20,17,3,2,1
312202,2,7,14,-7,2,1
15673,4,34,10,24,8,1
264028,1,7,0,7,15,0
156601,2,0,0,0,2,1
62297,3,21,19,2,12,1
31641,3,24,9,15,15,1
374612,4,20,20,0,14,0
351634,2,0,7,-7,3,0
193523,1,0,0,0,1,1
376413,4,9,9,0,14,1
160304,2,3,7,-4,4,0
28673,2,3,7,-4,14,0
143763,2,3,0,3,14,0
172326,1,0,0,0,9,0
404319,2,0,6,-6,10,1
413800,1,7,0,7,14,1
337830,4,30,6,24,14,0
308744,3,10,20,-10,1,1
158713,4,31,7,24,3,1
71915,3,15,13,2,16,1
254371,4,13,30,-17,11,0
195634,1,7,6,1,2,0
308973,2,0,3,-3,1,0
370331,4,14,35,-21,12,1
344887,1,0,0,0,17,0
300024,2,0,20,-20,14,0
418520,1,0,0,0,16,1
417769,5,35,35,0,16,1
146800,2,10,0,10,15,0
300739,2,7,6,1,15,0
173097,4,24,27,-3,9,1
355969,1,0,7,-7,5,0
77383,3,7,14,-7,1,0
349353,4,30,42,-12,2,0
144862,2,14,0,14,14,0
47126,1,3,0,3,5,0
8813,3,19,0,19,4,1
119389,1,0,14,-14,3,0
412297,1,7,7,0,13,0
49035,2,10,10,0,6,0
267217,1,3,7,-4,17,1
55195,1,7,0,7,9,0
198607,2,0,0,0,3,0
57179,3,10,0,10,10,0
420054,4,24,14,10,17,0
148398,1,0,0,0,16,1
318775,4,17,26,-9,5,1
384515,1,0,6,-6,1,0
297982,3,30,7,23,13,0
300825,4,13,33,-20,15,0
202186,4,13,14,-1,5,0
319014,2,7,23,-16,5,1
155926,4,17,16,1,2,1
276371,3,25,35,-10,3,0
128296,1,0,0,0,7,0
86214,1,0,7,-7,5,1
379918,3,14,6,8,16,1
406316,1,0,0,0,11,1
131231,2,14,17,-3,8,1
333259,4,6,21,-15,12,0
228231,3,10,27,-17,17,0
407375,1,0,7,-7,11,1
371825,1,0,10,-10,12,1
326227,3,10,34,-24,9,1
176387,4,19,28,-9,11,0
29636,4,14,21,-7,14,1
401176,4,51,13,38,8,0
117117,4,7,27,-20,2,0
150414,1,14,0,14,16,0
216331,2,7,13,-6,12,0
97938,2,0,7,-7,11,1
287281,1,0,0,0,8,1
194071,4,27,14,13,1,1
342477,4,20,3,17,16,0
331476,3,9,23,-14,11,1
282305,4,28,17,11,6,1
4648,3,13,13,0,2,1
391944,4,30,27,3,4,0
4412,4,14,14,0,2,0
235431,3,28,25,3,3,1
151289,1,7,7,0,17,0
249488,1,7,3,4,9,0
125385,1,0,0,0,5,0
295185,1,0,0,0,12,1
64637,4,20,24,-4,13,1
154873,2,3,3,0,1,1
409397,2,13,3,10,12,1
41508,3,15,7,8,2,0
45706,1,0,0,0,4,1
197284,2,6,0,6,3,1
163100,2,13,12,1,5,0
267020,4,22,17,5,17,1
363404,3,14,13,1,8,1
315099,4,44,14,30,4,0
284343,3,6,17,-11,7,1
8139,1,0,6,-6,4,0
419260,1,0,0,0,16,0
40857,1,0,3,-3,2,1
158548,4,10,17,-7,3,1
249414,4,18,15,3,9,1
120805,1,0,6,-6,3,0
201372,4,28,15,13,5,0
307984,3,14,6,8,1,0
245943,4,13,37,-24,7,1
86988,3,14,6,8,5,1
333258,4,6,21,-15,12,1
123162,2,3,21,-18,4,1
289036,3,26,21,5,9,0
230424,3,14,3,11,1,1
23437,1,7,0,7,11,0
415308,3,0,14,-14,15,1
322938,3,13,0,13,7,0
418431,2,14,3,11,16,1
211478,2,19,7,12,9,1
238486,2,6,0,6,4,1
144420,3,3,13,-10,14,0
1648,2,0,0,0,1,0
194536,1,0,0,0,2,1
285262,2,14,6,8,7,0
327830,2,10,10,0,10,0
107702,1,0,0,0,15,0
30207,4,13,24,-11,14,0
267363,2,0,7,-7,17,0
216194,3,14,3,11,12,1
107732,2,7,7,0,15,1
13126,2,10,7,3,6,0
327765,4,16,23,-7,10,0
615,1,0,0,0,1,0
413321,4,20,0,20,14,0
419250,1,0,0,0,16,1
133119,1,0,3,-3,9,1
155366,2,10,3,7,2,0
52809,2,0,30,-30,7,0
351050,2,14,13,1,3,1
357334,1,0,0,0,5,0
252793,2,6,6,0,11,0
115059,1,0,0,0,1,1
158182,2,10,0,10,3,0
327763,4,13,23,-10,10,1
298249,3,20,13,7,14,0
206693,2,0,13,-13,7,0
363474,1,0,0,0,8,0
346523,3,24,30,-6,1,0
129982,1,0,3,-3,8,0
8235,3,9,10,-1,4,0
358875,3,6,21,-15,6,0
353085,2,7,16,-9,3,0
275793,4,16,3,13,3,1
138667,3,6,28,-22,12,1
174959,2,6,14,-8,10,1
337972,4,23,0,23,14,0
277187,1,0,7,-7,4,1
48993,1,9,7,2,6,1
317407,4,7,16,-9,5,0
107985,4,6,20,-14,15,0
22476,3,30,27,3,11,1
248427,2,10,3,7,8,0
310788,3,6,10,-4,2,1
187863,3,7,20,-13,16,0
158783,2,7,3,4,3,1
234290,1,7,0,7,2,1
394520,4,10,25,-15,5,1
183915,1,7,3,4,14,0
75053,1,0,0,0,17,1
151011,2,0,0,0,17,0
32077,3,14,13,1,15,0
296339,3,6,16,-10,13,0
302915,1,13,0,13,16,0
230357,1,0,0,0,1,0
381472,1,14,0,14,17,0
104922,3,3,6,-3,14,1
238572,4,16,20,-4,4,0
409135,4,3,17,-14,12,1
265727,1,3,0,3,16,0
77942,2,3,0,3,1,0
71223,4,19,20,-1,16,1
315923,1,0,0,0,4,1
52511,2,10,0,10,7,0
127698,4,37,26,11,6,0
400346,2,10,3,7,8,0
90646,4,20,33,-13,7,0
130780,2,13,3,10,8,1
325807,3,6,10,-4,9,1
377951,1,0,0,0,15,0
225342,2,10,21,-11,15,0
68685,3,17,0,17,15,1
85625,2,10,0,10,5,1
406937,2,0,13,-13,11,0
343550,4,10,10,0,16,1
46521,4,37,6,31,4,1
302272,4,38,13,25,15,0
396143,3,24,23,1,6,0
257351,2,17,0,17,13,0
202862,2,14,0,14,5,0
255123,4,14,31,-17,12,1
312370,2,13,24,-11,3,1
315990,3,0,24,-24,4,0
216262,4,24,20,4,12,0
29889,3,16,23,-7,14,1
61143,3,0,7,-7,11,1
25051,4,24,24,0,12,1
376625,1,0,0,0,14,1
91655,3,21,14,7,8,0
333063,3,10,12,-2,12,1
89998,3,5,20,-15,7,0
243133,4,7,15,-8,6,1
416268,1,7,3,4,15,0
15706,1,0,0,0,8,1
314329,2,7,17,-10,3,1
203608,2,0,7,-7,6,1
122433,2,6,26,-20,4,1
7136,3,31,21,10,4,1
235264,3,15,6,9,3,1
254916,3,24,7,17,12,1
75138,3,7,6,1,17,1
92700,2,3,10,-7,8,0
78160,3,20,3,17,2,0
287636,3,3,10,-7,9,0
28088,3,21,10,11,13,1
174970,2,6,14,-8,10,0
82333,3,6,10,-4,3,1
366339,4,28,16,12,10,0
132916,4,6,21,-15,9,1
404248,4,19,16,3,10,0
322235,4,0,27,-27,7,1
395338,2,14,3,11,5,1
392959,3,9,3,6,4,0
50857,2,7,14,-7,6,0
299192,4,17,19,-2,14,0
396993,2,7,3,4,6,0
21882,3,21,0,21,11,1
298377,2,7,14,-7,14,1
387480,4,21,16,5,2,1
284038,3,10,3,7,7,0
275588,2,14,0,14,3,1
174100,4,8,36,-28,10,1
368705,2,7,16,-9,11,0
281781,2,3,0,3,6,1
421085,2,13,3,10,17,1
269570,4,21,31,-10,1,1
330195,2,7,0,7,11,0
392890,1,0,0,0,4,1
312387,3,13,27,-14,3,1
96605,2,3,3,0,10,1
105885,4,19,10,9,14,0
217437,2,9,0,9,12,0
101090,2,10,10,0,12,0
145200,4,49,0,49,14,1
405012,4,9,23,-14,10,1
395947,2,24,10,14,6,0
96281,1,0,9,-9,10,0
36913,2,0,14,-14,17,0
190850,4,16,10,6,17,1
161152,3,3,33,-30,4,1
310001,3,6,10,-4,2,1
416778,3,10,10,0,15,1
222030,2,14,3,11,14,1
371617,3,17,17,0,12,0
335497,4,13,12,1,13,0
365130,2,7,14,-7,9,0
75168,4,10,6,4,17,1
181832,2,14,7,7,13,1
209450,4,17,17,0,8,0
281803,2,10,0,10,6,1
372538,5,26,27,-1,13,1
341104,4,14,17,-3,15,1
409656,2,10,0,10,12,0
397295,2,0,21,-21,6,1
362899,1,0,0,0,8,1
156420,1,0,0,0,2,0
383631,1,0,7,-7,17,0
19523,1,0,0,0,10,0
106962,4,19,6,13,14,1
267794,1,10,7,3,17,0
323143,1,0,0,0,7,1
271923,3,17,20,-3,2,1
357888,4,13,34,-21,6,0
111684,3,28,10,18,16,0
140169,4,10,3,7,12,1
239210,1,0,0,0,4,0
102249,1,7,0,7,13,0
256513,1,0,0,0,12,1
127207,4,13,16,-3,6,0
126,4,7,10,-3,1,1
99046,2,9,0,9,11,0
12897,4,13,13,0,6,0
89574,3,7,27,-20,7,0
75188,4,13,6,7,17,0
14519,4,34,36,-2,7,0
306060,3,17,13,4,17,0
46279,1,0,7,-7,4,1
336232,1,3,0,3,13,0
61104,2,0,7,-7,11,0
297783,1,7,7,0,13,1
218047,3,21,17,4,12,0
304999,4,17,20,-3,16,1
191739,4,16,17,-1,17,1
98758,3,34,6,28,11,0
377870,3,20,7,13,15,0
362714,4,3,13,-10,8,1
379573,2,13,6,7,16,1
270310,4,17,27,-10,1,1
143502,3,14,21,-7,14,0
49251,4,17,10,7,6,0
247120,2,20,6,14,8,0
159068,2,17,0,17,3,1
217740,3,10,7,3,12,0
144353,1,0,0,0,14,0
374870,3,14,3,11,14,1
144785,4,10,17,-7,14,0
215541,4,13,3,10,11,0
81638,1,7,0,7,3,0
198886,1,3,13,-10,3,1
142249,1,0,0,0,13,1
362010,1,0,0,0,8,0
182538,4,35,21,14,14,0
105469,1,6,0,6,14,1
122356,4,13,19,-6,4,1
297060,2,14,0,14,13,1
114424,4,41,20,21,1,1
51934,4,13,16,-3,7,1
408836,4,16,28,-12,12,0
206174,1,0,0,0,7,1
256810,4,13,13,0,12,0
309620,4,16,3,13,1,1
193184,1,0,0,0,1,0
44780,4,13,19,-6,3,1
349777,4,23,21,2,2,1
76250,4,12,27,-15,1,0
372896,2,16,0,16,13,0
177405,2,17,10,7,11,1
58518,1,7,3,4,10,0
336331,4,20,10,10,13,0
337668,3,24,13,11,14,1
226125,3,7,17,-10,16,1
270119,3,17,10,7,1,0
258511,1,0,0,0,13,1
270674,2,3,0,3,1,0
181649,4,23,6,17,13,0
264609,4,12,17,-5,16,0
409737,4,13,6,7,12,1
98926,4,7,17,-10,11,1
29797,1,0,0,0,14,1
178355,3,21,17,4,12,0
183840,3,34,21,13,14,0
42931,3,17,16,1,3,1
362370,3,23,14,9,8,1
300373,4,10,7,3,14,0
28599,4,33,7,26,14,0
286854,2,3,7,-4,8,0
375658,3,17,20,-3,14,1
199330,1,0,0,0,4,1
121882,4,0,23,-23,4,0
194396,1,0,0,0,2,1
63383,4,17,3,14,12,0
131589,4,9,26,-17,8,1
351941,2,14,7,7,3,0
232898,1,0,0,0,2,0
58069,1,7,10,-3,10,0
247681,2,7,6,1,8,1
365128,2,7,14,-7,9,0
111861,4,13,10,3,17,0
350526,4,17,19,-2,2,1
80813,3,3,0,3,3,1
329916,2,7,10,-3,11,0
145844,4,13,33,-20,15,1
154380,4,34,24,10,1,0
411047,3,17,14,3,13,0
186798,3,26,7,19,15,0
135798,2,7,14,-7,10,1
80083,4,24,22,2,2,1
181670,1,0,0,0,13,1
294731,4,13,27,-14,12,1
300057,3,0,40,-40,14,1
327734,3,6,13,-7,10,0
310478,3,17,9,8,2,1
379456,3,16,0,16,16,0
2093,2,7,13,-6,1,1
60477,1,7,0,7,11,0
318328,4,9,19,-10,5,0
60948,2,13,6,7,11,1
190856,4,24,10,14,17,0
414872,3,21,7,14,15,1
37520,3,10,7,3,17,0
221223,1,0,10,-10,14,0
21228,1,3,0,3,11,1
116859,2,7,7,0,2,1
231705,1,0,7,-7,1,1
232631,2,0,0,0,1,1
203209,3,10,17,-7,5,1
394785,3,21,0,21,5,1
79221,4,23,10,13,2,0
140586,2,23,7,16,12,1
231370,4,9,16,-7,1,0
36261,4,24,27,-3,17,0
13782,3,7,27,-20,7,0
253606,4,9,17,-8,11,1
185113,3,0,16,-16,15,1
385957,4,24,21,3,1,0
281307,2,14,6,8,6,1
276152,1,10,0,10,3,0
124758,4,3,9,-6,5,1
233726,2,13,21,-8,2,0
109918,4,23,13,10,16,0
391165,3,10,24,-14,4,1
107194,3,0,28,-28,15,0
20256,4,27,10,17,10,1
216752,4,27,9,18,12,1
324606,4,16,9,7,8,1
205497,3,14,10,4,6,0
151181,2,3,17,-14,17,0
414826,2,13,0,13,15,0
317841,3,9,10,-1,5,0
408545,4,10,16,-6,12,1
107156,1,0,13,-13,15,0
141219,3,3,21,-18,13,1
132318,4,31,17,14,9,1
33071,2,3,7,-4,16,1
265399,4,14,20,-6,16,0
250497,3,16,7,9,9,1
414437,3,13,23,-10,14,0
17378,3,17,0,17,9,1
317230,3,7,16,-9,5,0
289323,2,28,17,11,9,0
64698,2,14,0,14,13,1
58082,2,10,10,0,10,0
25360,1,3,0,3,12,1
109402,2,3,10,-7,16,1
88747,2,3,3,0,6,1
314045,2,6,7,-1,3,1
27141,1,0,7,-7,13,1
238154,1,3,9,-6,4,0
78029,4,12,16,-4,1,1
86265,2,13,17,-4,5,0
143826,4,12,7,5,14,0
182010,2,14,7,7,13,0
127278,1,10,7,3,6,0
109855,2,17,0,17,16,1
53071,2,10,7,3,7,1
370405,1,7,0,7,12,1
370774,3,19,10,9,12,0
49241,4,17,10,7,6,1
213481,1,0,7,-7,10,1
238260,4,10,24,-14,4,1
346966,2,7,3,4,1,1
37870,1,0,0,0,1,0
160259,1,0,0,0,4,1
278532,4,36,7,29,4,1
204278,2,0,7,-7,6,0
278834,4,14,21,-7,5,0
393648,1,0,0,0,5,0
271677,1,0,3,-3,2,1
132240,2,7,7,0,9,1
259785,4,20,13,7,14,1
127335,3,10,20,-10,6,1
343141,1,0,0,0,16,0
344068,1,0,3,-3,17,1
396489,1,0,7,-7,6,1
334493,1,6,14,-8,13,1
274184,1,3,0,3,3,0
138216,3,10,12,-2,11,1
182145,2,19,7,12,13,0
8387,4,30,10,20,4,0
352343,1,7,0,7,3,1
407891,3,9,10,-1,11,0
296686,4,10,16,-6,13,1
253765,4,24,10,14,11,0
161830,1,0,0,0,4,1
41998,1,0,0,0,2,1
258194,4,20,20,0,13,1
409005,4,31,31,0,12,0
286922,4,16,13,3,8,1
223895,4,30,6,24,15,1
266571,1,0,0,0,16,1
57086,4,21,27,-6,9,0
133305,2,7,0,7,9,0
92111,2,3,17,-14,8,1
41982,4,38,6,32,2,0
121066,3,11,31,-20,3,1
12031,4,27,14,13,6,0
295787,5,24,24,0,12,1
198900,2,3,13,-10,3,0
373864,3,27,10,17,13,0
198216,4,13,9,4,3,1
384765,4,19,40,-21,1,1
320625,4,31,18,13,6,1
165694,3,7,7,0,6,0
410212,1,7,0,7,13,0
297319,1,0,3,-3,13,1
164350,3,20,0,20,5,0
17431,4,17,7,10,9,1
416152,2,3,9,-6,15,1
53086,2,19,7,12,7,0
406530,3,14,23,-9,11,1
406985,3,3,20,-17,11,1
407892,3,9,10,-1,11,0
346360,2,3,13,-10,1,1
85636,2,17,0,17,5,1
218392,1,3,7,-4,13,1
333250,3,6,14,-8,12,0
190364,2,7,0,7,17,1
92493,4,25,17,8,8,0
227154,3,10,7,3,16,0
300361,4,10,7,3,14,0
50584,2,0,6,-6,6,1
31550,1,0,3,-3,15,1
220240,2,17,6,11,13,0
149558,3,14,16,-2,16,0
252015,3,14,20,-6,10,1
150768,3,13,9,4,17,1
103030,1,0,0,0,13,1
386116,4,24,9,15,1,0
22634,3,23,10,13,11,1
162109,4,48,13,35,4,0
327018,4,8,10,-2,9,0
295503,1,7,7,0,12,1
95093,2,0,7,-7,9,0
173092,4,24,27,-3,9,0
118298,3,19,7,12,2,0
127766,2,7,21,-14,6,1
107378,4,19,6,13,15,0
255630,2,0,7,-7,12,1
31050,3,10,6,4,15,0
274204,2,10,0,10,3,1
293699,4,10,13,-3,12,1
185937,4,22,30,-8,15,1
84538,1,0,0,0,4,0
204156,3,10,17,-7,6,1
26287,3,10,21,-11,13,1
394663,4,17,21,-4,5,1
338369,3,3,0,3,14,0
268372,4,29,6,23,17,0
128209,3,14,7,7,7,0
190558,3,17,20,-3,17,1
84635,4,23,13,10,4,0
81338,1,0,7,-7,3,1
287708,4,16,13,3,9,0
305836,2,0,14,-14,17,0
224703,1,0,0,0,15,0
300050,3,0,34,-34,14,1
319313,2,10,10,0,6,1
144885,3,14,7,7,14,1
185859,2,9,3,6,15,0
366083,1,0,0,0,10,0
105951,1,10,0,10,14,1
308412,3,0,18,-18,1,1
157941,4,9,22,-13,3,1
10093,3,41,7,34,5,0
146079,2,19,10,9,15,1
109806,1,9,0,9,16,1
378637,4,23,23,0,15,0
255386,3,21,6,15,12,1
266714,4,49,10,39,16,0
259930,3,20,10,10,14,0
353393,2,13,0,13,4,1
184648,2,10,10,0,15,0
110606,2,17,7,10,16,0
285011,4,16,27,-11,7,1
394242,4,40,32,8,5,1
25560,2,17,7,10,12,1
421316,4,28,10,18,17,1
308778,4,18,20,-2,1,0
293172,1,6,0,6,11,0
261538,3,12,6,6,14,0
395402,4,28,3,25,5,1
373651,2,0,9,-9,13,0
366333,4,28,16,12,10,1
373141,1,0,0,0,13,0
100499,3,7,17,-10,12,1
376123,4,0,9,-9,14,1
379385,4,10,22,-12,16,0
81394,3,7,10,-3,3,1
206194,1,0,3,-3,7,1
88134,1,0,3,-3,6,1
35411,5,30,30,0,16,1
400462,1,0,0,0,8,0
208345,3,17,24,-7,8,0
170278,2,0,12,-12,8,0
153921,4,7,12,-5,1,1
105031,1,0,7,-7,14,0
314349,3,10,17,-7,3,1
13039,3,14,7,7,6,0
385415,2,14,7,7,1,1
235684,2,0,3,-3,3,0
351008,1,7,7,0,3,0
237454,1,0,0,0,3,1
101896,3,6,13,-7,12,1
160255,1,0,0,0,4,0
262050,4,24,31,-7,14,0
325883,1,0,0,0,9,1
213103,4,20,3,17,10,0
157233,2,7,3,4,2,1
26683,1,0,7,-7,13,1
120726,2,17,0,17,3,0
332450,2,16,3,13,12,0
124500,1,0,0,0,5,1
189276,1,3,0,3,16,0
168706,2,10,3,7,7,0
412757,1,6,10,-4,14,1
174090,3,8,36,-28,10,0
195879,1,0,0,0,2,0
340332,2,17,7,10,15,0
89628,1,3,0,3,7,1
351410,4,13,16,-3,3,1
269339,2,7,7,0,1,0
331686,1,0,6,-6,12,0
378171,3,24,16,8,15,0
328049,4,17,17,0,10,0
15840,4,8,12,-4,8,0
333056,3,10,12,-2,12,0
301425,1,3,0,3,15,0
298042,1,0,7,-7,13,0
362573,4,33,12,21,8,0
312965,2,0,0,0,3,0
398562,4,30,23,7,7,0
221751,3,10,7,3,14,0
154523,1,0,0,0,1,1
309950,1,0,3,-3,2,1
155717,3,10,20,-10,2,1
412052,2,21,0,21,13,0
219270,1,0,0,0,13,1
188521,2,3,3,0,16,1
402070,1,0,0,0,9,1
272167,1,0,0,0,2,0
123199,3,6,21,-15,4,0
385918,2,3,14,-11,1,1
413860,3,14,6,8,14,1
274713,3,10,12,-2,3,0
281895,4,16,17,-1,6,0
126545,3,10,6,4,6,1
395513,3,21,14,7,6,1
323104,4,26,14,12,7,0
221265,2,0,19,-19,14,0
365399,2,7,6,1,9,0
93092,5,20,20,0,8,1
220626,1,0,0,0,13,1
352886,4,14,16,-2,3,1
88148,2,7,3,4,6,0
213468,1,0,0,0,10,0
125511,4,30,7,23,5,0
142391,1,0,0,0,13,1
63721,2,7,9,-2,12,0
353859,2,7,14,-7,4,0
271641,4,23,30,-7,2,1
115605,4,30,9,21,1,0
321346,4,22,22,0,6,1
338259,4,27,31,-4,14,1
195522,2,3,0,3,2,1
88381,4,24,10,14,6,0
254739,2,3,3,0,11,0
365468,3,10,19,-9,9,0
250217,4,24,16,8,9,0
99759,2,0,0,0,12,0
57345,3,13,3,10,10,1
60673,2,21,3,18,11,0
22405,1,3,23,-20,11,0
63523,4,31,19,12,12,0
249409,4,18,15,3,9,1
41073,4,3,16,-13,2,0
372654,3,14,9,5,13,0
106470,3,16,9,7,14,1
161571,2,9,10,-1,4,1
234541,4,20,20,0,2,1
318097,2,9,7,2,5,1
234527,4,20,20,0,2,0
180018,2,7,20,-13,13,1
377588,4,17,12,5,15,1
412067,3,21,0,21,13,1
317774,1,3,0,3,5,0
367438,3,20,21,-1,10,1
11187,1,0,0,0,6,0
228197,2,10,27,-17,17,0
215636,3,14,6,8,11,1
326783,2,3,14,-11,9,0
137631,5,37,34,3,11,0
419052,3,7,20,-13,16,1
313285,2,6,14,-8,3,1
298279,3,20,13,7,14,1
116778,4,16,26,-10,2,1
386959,3,7,21,-14,2,1
95058,1,0,0,0,9,0
148100,4,14,10,4,15,1
297087,3,24,0,24,13,0
12658,1,10,0,10,6,0
102380,4,16,20,-4,13,1
108902,4,17,17,0,15,1
98247,2,7,17,-10,11,0
365575,2,21,14,7,9,1
21031,4,21,31,-10,10,0
376960,2,3,16,-13,15,1
184373,2,14,6,8,14,1
117793,2,6,6,0,2,1
361830,3,37,10,27,7,1
274901,3,14,16,-2,3,0
171738,1,3,7,-4,9,1
35522,4,30,7,23,17,0
124436,3,6,7,-1,5,1
254001,2,0,6,-6,11,0
131055,1,10,0,10,8,0
415814,1,0,0,0,15,0
404083,4,10,49,-39,10,0
81899,3,0,30,-30,3,1
33468,1,0,0,0,16,0
410481,4,9,23,-14,13,0
201745,1,3,0,3,5,0
160749,1,0,0,0,4,1
21607,4,7,31,-24,11,0
189429,1,7,0,7,17,0
35491,3,24,7,17,17,0
362979,3,27,16,11,8,0
246496,2,19,0,19,8,0
64971,1,0,0,0,13,0
160677,3,10,0,10,4,0
215460,2,7,3,4,11,1
284668,4,14,27,-13,7,0
117020,2,0,10,-10,2,1
168327,3,17,24,-7,7,1
237277,4,26,0,26,3,0
237609,1,0,0,0,4,0
316699,1,0,0,0,4,1
315646,2,3,7,-4,4,1
104227,1,3,0,3,13,0
204249,2,0,7,-7,6,1
135284,4,31,17,14,10,1
308592,3,9,16,-7,1,0
70165,3,20,7,13,15,1
59042,2,3,10,-7,10,0
282391,3,10,23,-13,6,1
308889,4,10,20,-10,1,1
124534,2,6,0,6,5,1
410525,1,7,0,7,13,0
275799,4,16,3,13,3,0
284176,3,9,20,-11,7,0
113678,4,9,13,-4,17,1
47292,1,0,7,-7,5,1
343038,2,6,0,6,16,0
131518,2,6,6,0,8,0
287332,2,13,0,13,8,0
353806,1,7,0,7,4,0
33852,4,9,40,-31,16,0
13018,3,14,7,7,6,0
71985,1,0,3,-3,16,0
290274,4,17,12,5,10,1
145402,1,0,7,-7,14,1
259103,1,0,0,0,13,1
283028,4,21,3,18,6,1
59355,3,0,9,-9,11,0
271449,3,14,0,14,1,0
270828,2,6,7,-1,1,1
361681,3,7,32,-25,7,1
171017,2,7,10,-3,8,1
405670,1,0,0,0,10,1
87768,4,6,20,-14,6,1
129244,3,14,13,1,7,1
335816,1,7,7,0,13,1
122982,2,0,3,-3,4,0
101228,2,7,7,0,12,1
173349,4,28,27,1,10,0
3222,1,0,0,0,2,0
421311,4,28,10,18,17,1
36271,4,24,27,-3,17,0
323397,3,20,0,20,7,0
225617,2,0,7,-7,16,0
168086,1,6,0,6,7,0
45572,2,7,13,-6,4,1
99011,1,6,0,6,11,0
381724,4,26,31,-5,17,1
57035,2,7,17,-10,9,0
394601,2,17,0,17,5,0
123910,2,0,0,0,5,1
199386,3,13,10,3,4,0
106857,1,6,0,6,14,1
168279,2,10,7,3,7,1
232624,2,0,0,0,1,0
121355,3,7,0,7,3,0
248604,2,7,3,4,9,1
4815,4,27,3,24,3,0
203568,1,0,0,0,6,0
56929,3,34,7,27,9,1
363482,1,0,0,0,8,0
29699,2,10,0,10,14,0
412984,3,16,12,4,14,0
208097,4,21,19,2,8,0
217913,4,25,28,-3,12,0
258414,3,21,13,8,13,1
72162,1,0,3,-3,16,1
152121,4,13,13,0,17,0
148665,4,10,9,1,16,0
175233,2,12,0,12,10,1
391461,4,10,20,-10,4,0
400616,1,0,0,0,8,0
331079,4,52,24,28,11,1
29773,4,41,3,38,14,1
323974,3,17,13,4,8,1
351493,2,0,24,-24,3,1
261421,4,10,24,-14,14,1
123955,3,10,0,10,5,1
58457,4,48,17,31,10,0
32721,3,7,21,-14,15,0
66207,3,24,3,21,13,0
331594,3,17,23,-6,11,1
394702,1,7,0,7,5,0
413254,2,10,0,10,14,0
157480,4,16,37,-21,2,1
324990,2,13,21,-8,8,1
356965,2,17,3,14,5,0
277542,2,3,14,-11,4,0
111626,2,7,10,-3,16,1
117806,2,6,6,0,2,1
161762,3,24,6,18,4,1
129396,3,16,10,6,7,0
323332,2,0,0,0,7,1
394036,3,9,13,-4,5,0
321877,2,7,14,-7,7,1
289721,1,0,7,-7,10,0
102396,4,19,34,-15,13,1
359512,4,0,21,-21,6,0
328230,4,14,17,-3,10,1
222618,2,7,7,0,14,1
206111,3,20,6,14,7,1
265181,1,0,3,-3,16,1
219163,2,0,3,-3,13,0
183425,3,24,6,18,14,0
242518,4,18,13,5,6,0
20514,3,3,0,3,10,0
127703,1,0,0,0,6,1
197472,3,13,9,4,3,0
416500,3,28,17,11,15,0
340910,2,0,10,-10,15,0
145495,4,16,17,-1,14,1
202808,1,0,0,0,5,0
223487,2,7,3,4,15,0
187504,2,3,10,-7,16,0
14830,1,0,0,0,7,1
295166,4,10,21,-11,12,0
413647,1,0,0,0,14,0
192401,1,0,7,-7,1,1
282475,1,7,0,7,6,0
131455,4,20,22,-2,8,1
308638,4,34,22,12,1,1
39553,2,0,3,-3,1,0
334281,3,9,7,2,13,0
213009,1,0,0,0,10,1
370854,2,3,0,3,12,0
201216,4,20,24,-4,5,0
138630,2,3,14,-11,12,1
186968,4,10,12,-2,15,0
204734,2,14,14,0,6,1
323735,1,0,0,0,8,0
124257,2,10,17,-7,5,0
320747,3,14,23,-9,6,1
137717,2,7,20,-13,11,1
130217,3,3,26,-23,8,0
109763,4,13,0,13,16,0
47944,2,0,14,-14,5,0
336807,4,10,30,-20,14,1
291606,3,23,3,20,11,0
224594,2,6,7,-1,15,1
153758,3,2,21,-19,1,0
38108,4,6,6,0,1,1
348849,3,3,14,-11,2,1
179079,2,3,6,-3,12,1
156410,1,0,0,0,2,1
75321,4,14,26,-12,17,0
54960,3,3,3,0,8,1
314262,4,17,23,-6,3,1
400943,2,13,7,6,8,1
104273,2,17,0,17,13,0
140162,3,10,3,7,12,0
318003,3,10,13,-3,5,1
243054,2,0,9,-9,6,1
285636,4,27,24,3,8,1
348794,1,0,7,-7,2,1
140013,4,28,10,18,12,1
417569,4,31,31,0,16,1
50435,3,10,7,3,6,1
147250,2,0,21,-21,15,1
382820,2,21,3,18,17,1
290917,1,7,0,7,10,0
295609,4,31,32,-1,12,1
235876,3,0,14,-14,3,0
356254,4,29,14,15,5,1
197174,3,27,27,0,3,0
27874,1,0,0,0,13,1
233201,4,43,18,25,2,0
143040,2,0,7,-7,13,1
389252,4,31,7,24,3,0
283544,2,6,7,-1,7,0
298985,3,9,9,0,14,0
192426,2,0,14,-14,1,0
299146,3,10,16,-6,14,0
52290,4,27,19,8,7,1
167445,1,0,0,0,7,1
16957,3,27,20,7,8,1
155323,1,10,0,10,2,0
354769,2,6,17,-11,4,1
179088,2,6,6,0,12,0
23537,4,17,17,0,11,0
231945,4,14,41,-27,1,0
38572,4,38,6,32,1,0
291678,1,0,3,-3,11,0
316970,4,37,18,19,4,1
6752,1,0,0,0,3,0
36031,1,7,0,7,17,1
294991,4,24,14,10,12,1
214686,1,0,0,0,11,1
299031,4,16,18,-2,14,0
292017,2,6,9,-3,11,1
44790,4,16,19,-3,3,1
379290,2,0,3,-3,16,0
332798,4,28,16,12,12,1
283475,4,23,14,9,7,0
286069,2,10,3,7,8,1
294737,4,13,27,-14,12,1
62983,2,6,7,-1,12,0
251329,1,7,7,0,10,1
401517,1,0,13,-13,8,0
415590,3,7,10,-3,15,1
150938,4,13,7,6,17,0
53828,1,0,0,0,8,0
128951,2,25,3,22,7,1
269546,3,21,31,-10,1,0
200133,2,7,24,-17,4,1
380501,2,0,14,-14,16,1
146042,2,10,0,10,15,0
344933,2,3,7,-4,17,1
39107,2,13,7,6,1,0
286008,4,29,20,9,8,1
155942,1,0,0,0,2,1
302411,4,16,16,0,15,0
175376,2,14,3,11,11,0
368197,4,24,21,3,11,0
249454,4,18,18,0,9,1
318777,4,17,26,-9,5,1
353166,4,20,29,-9,3,1
204480,4,10,24,-14,6,0
375600,2,7,14,-7,14,1
9767,2,2,7,-5,5,0
104630,3,7,3,4,14,1
133578,2,3,7,-4,9,1
361725,1,0,0,0,7,1
354579,1,0,0,0,4,0
397509,4,20,22,-2,6,0
57732,1,0,0,0,10,1
32447,4,31,6,25,15,1
190871,4,27,17,10,17,0
337917,2,10,0,10,14,1
46866,2,13,3,10,5,1
50869,2,7,17,-10,6,0
132790,1,0,0,0,9,0
124808,1,0,3,-3,5,0
246883,1,0,6,-6,8,0
302487,2,3,10,-7,15,0
177873,3,21,16,5,12,0
214201,4,22,9,13,11,1
129045,1,0,7,-7,7,1
234989,3,13,16,-3,2,0
410551,2,7,7,0,13,1
378544,2,7,6,1,15,1
263213,3,17,17,0,15,0
129751,3,17,17,0,7,0
186007,2,10,27,-17,15,1
7887,2,3,14,-11,4,1
194313,3,10,3,7,2,0
317346,2,0,0,0,5,1
103920,2,3,0,3,13,1
9305,2,7,0,7,5,1
370394,1,7,0,7,12,0
53980,4,37,25,12,8,0
134079,3,20,13,7,9,1
316541,2,0,3,-3,4,1
330831,2,10,17,-7,11,0
408121,1,0,0,0,12,1
15599,2,14,3,11,8,0
300112,1,7,3,4,14,1
275163,3,14,16,-2,3,1
37184,2,3,7,-4,17,1
115969,1,7,0,7,1,1
419610,2,20,16,4,17,1
67700,1,7,0,7,14,1
248823,4,37,22,15,9,1
369300,3,14,17,-3,11,0
25865,3,24,10,14,12,0
116154,3,7,10,-3,1,0
197171,3,27,27,0,3,1
133541,1,0,0,0,9,0
390177,1,0,0,0,3,0
64040,3,20,10,10,13,0
302446,1,3,3,0,15,0
65003,2,0,14,-14,13,1
347257,2,0,0,0,1,0
280547,2,14,3,11,5,0
22326,3,0,3,-3,11,0
319894,1,6,0,6,6,0
329021,1,0,0,0,10,0
60378,3,13,7,6,11,1
100723,4,28,24,4,12,0
38461,1,0,0,0,1,1
17370,2,17,0,17,9,0
195241,3,16,17,-1,2,1
419484,3,10,9,1,16,1
185319,4,41,30,11,15,1
239072,1,0,0,0,4,0
284365,4,14,17,-3,7,1
26004,3,10,16,-6,13,0
80388,3,27,16,11,2,1
113155,3,41,7,34,17,0
393916,4,23,20,3,5,1
171044,3,17,23,-6,8,0
362479,2,7,6,1,8,0
231867,2,7,20,-13,1,0
384612,3,10,49,-39,1,0
262329,4,13,9,4,15,0
215705,1,3,0,3,11,0
416654,3,31,7,24,15,1
214044,4,43,14,29,10,0
20349,2,10,13,-3,10,0
274826,1,0,0,0,3,0
220036,4,24,35,-11,13,1
35028,2,9,3,6,16,1
242066,4,17,16,1,5,1
85670,3,24,14,10,5,0
214135,3,3,6,-3,11,1
44691,1,0,9,-9,3,0
95073,1,0,7,-7,9,0
229736,3,13,17,-4,17,1
84549,1,0,0,0,4,0
312330,1,7,14,-7,3,0
176446,1,0,7,-7,11,0
353673,2,3,0,3,4,0
332292,2,3,6,-3,12,0
51217,4,32,25,7,7,0
382280,3,17,3,14,17,0
325568,1,7,0,7,9,0
308179,1,0,6,-6,1,0
401946,2,0,3,-3,9,1
70616,3,17,16,1,15,0
365696,1,7,3,4,9,0
236387,4,14,23,-9,3,0
272052,2,10,3,7,2,0
319956,2,30,10,20,6,0
315039,2,24,7,17,4,1
167817,1,0,13,-13,7,1
287290,1,3,0,3,8,0
407961,4,17,24,-7,11,1
371009,2,7,7,0,12,0
172573,3,14,24,-10,9,0
307581,1,0,0,0,17,1
140515,4,21,29,-8,12,1
243895,2,16,6,10,6,0
295563,3,23,19,4,12,0
183599,1,0,0,0,14,0
4622,2,10,10,0,2,1
334095,2,7,0,7,13,1
221084,1,0,0,0,14,1
420022,3,10,7,3,17,0
382276,3,17,3,14,17,1
142946,3,3,13,-10,13,1
211870,4,29,17,12,9,1
58683,1,7,7,0,10,1
235864,2,0,14,-14,3,1
319678,3,33,3,30,6,0
108605,4,26,21,5,15,0
289425,1,0,0,0,10,1
390024,1,0,0,0,3,0
186209,4,23,13,10,15,0
68370,3,3,14,-11,14,0
368058,4,27,24,3,11,1
362292,1,0,0,0,8,0
77396,3,14,21,-7,1,1
187353,2,14,7,7,16,0
25502,1,0,0,0,12,1
139577,3,9,14,-5,12,1
330686,3,6,3,3,11,0
51132,2,7,3,4,7,1
224880,1,0,3,-3,15,0
237852,3,7,20,-13,4,0
135501,2,7,6,1,10,1
404603,2,7,10,-3,10,0
75306,3,14,26,-12,17,0
292520,4,10,19,-9,11,1
219363,3,23,13,10,13,0
124090,2,3,21,-18,5,1
302058,2,13,17,-4,15,0
42102,4,27,20,7,2,0
365982,2,20,7,13,10,0
73854,4,13,7,6,17,1
162867,4,12,3,9,5,1
159149,4,31,7,24,3,0
153632,4,15,14,1,1,0
112846,2,7,3,4,17,0
167051,3,13,17,-4,7,0
407983,1,0,0,0,12,1
43609,1,0,0,0,3,0
271273,2,6,7,-1,1,1
294055,2,7,14,-7,12,0
58883,2,3,18,-15,10,1
263883,1,6,0,6,15,0
264343,1,0,0,0,15,1
329218,3,17,13,4,10,0
336948,4,21,21,0,14,1
242831,1,0,0,0,6,1
256619,3,21,0,21,12,0
230393,2,6,0,6,1,1
395425,4,31,3,28,5,1
7702,1,10,0,10,4,0
394342,3,24,17,7,5,1
403360,4,19,3,16,9,1
349083,1,7,0,7,2,0
31694,5,24,24,0,15,0
15786,3,0,12,-12,8,0
389046,2,20,0,20,3,0
124077,2,0,14,-14,5,1
61591,4,35,7,28,11,1
411471,3,10,17,-7,13,0
39424,3,10,10,0,1,1
67954,4,22,6,16,14,1
104954,4,10,9,1,14,0
119481,3,14,17,-3,3,1
234284,1,7,0,7,2,0
341533,3,6,7,-1,16,0
261482,1,3,0,3,14,1
121814,2,0,7,-7,4,0
126157,1,0,3,-3,6,1
106285,2,0,6,-6,14,0
197004,3,20,17,3,3,0
413841,2,14,6,8,14,1
225049,2,0,14,-14,15,1
240021,3,10,20,-10,5,1
21368,1,0,7,-7,11,1
29441,3,7,14,-7,14,0
2419,3,21,13,8,2,0
343024,2,3,0,3,16,1
256623,3,21,7,14,12,1
15457,2,6,0,6,8,1
181253,2,0,6,-6,13,0
375206,4,17,17,0,14,1
256288,3,14,17,-3,12,1
208295,2,7,14,-7,8,0
138462,3,21,14,7,12,0
106443,2,16,0,16,14,1
33028,4,12,44,-32,15,0
216143,1,7,0,7,12,0
31032,2,10,6,4,15,0
277823,2,7,7,0,4,1
26202,4,0,33,-33,13,1
57696,4,24,24,0,10,1
261087,3,7,14,-7,14,1
37968,4,16,14,2,1,1
107196,3,6,28,-22,15,0
245918,3,6,37,-31,7,1
421307,4,19,10,9,17,0
201775,2,6,0,6,5,1
323467,1,0,3,-3,7,1
17437,4,17,7,10,9,0
80903,1,6,0,6,3,0
337207,3,16,13,3,14,0
303603,3,28,13,15,16,0
285069,2,0,0,0,7,1
328795,3,17,13,4,10,1
193092,2,13,6,7,1,0
18216,1,0,0,0,9,0
238326,2,3,9,-6,4,0
362376,3,30,14,16,8,0
275620,2,24,3,21,3,1
341162,1,3,0,3,16,0
29149,3,0,19,-19,14,1
146600,4,21,38,-17,15,0
261838,2,6,10,-4,14,0
285662,5,27,27,0,8,0
160655,2,10,0,10,4,1
262546,1,0,0,0,15,1
389297,1,0,0,0,3,0
391942,4,30,27,3,4,0
24279,4,13,17,-4,12,1
307946,2,7,6,1,1,0
399277,1,0,0,0,7,0
206874,3,3,17,-14,7,1
66714,1,0,3,-3,14,0
319247,1,0,0,0,6,0
90474,3,0,20,-20,7,0
89764,1,0,0,0,7,1
174049,2,0,26,-26,10,1
84950,1,0,0,0,4,1
43012,1,0,0,0,3,1
197356,4,30,10,20,3,0
127285,2,10,7,3,6,0
133495,3,27,17,10,9,0
349786,4,29,21,8,2,0
124269,2,24,17,7,5,0
219008,2,14,0,14,13,1
254441,2,20,0,20,11,0
421692,2,17,7,10,17,0
21646,1,0,0,0,11,0
193659,1,3,6,-3,1,0
298174,1,0,3,-3,14,0
166558,1,6,7,-1,6,1
410886,3,14,12,2,13,0
307921,2,0,0,0,1,1
42217,2,17,0,17,2,1
320631,4,38,18,20,6,0
126457,1,0,3,-3,6,0
245037,4,14,27,-13,7,0
358099,2,14,0,14,6,1
23436,1,7,0,7,11,0
229170,4,19,7,12,17,0
305404,3,20,3,17,17,1
361678,3,7,32,-25,7,1
99749,2,0,0,0,12,0
203731,1,0,0,0,6,0
88651,3,20,10,10,6,0
76612,2,7,0,7,1,0
226591,2,10,3,7,16,1
120408,2,16,9,7,3,1
29423,2,0,14,-14,14,1
106725,2,7,12,-5,14,1
269463,1,3,3,0,1,1
29862,3,9,16,-7,14,0
296451,2,14,0,14,13,1
126478,2,0,6,-6,6,0
19298,2,14,14,0,10,0
311678,4,6,6,0,2,0
85465,2,14,3,11,5,1
397221,4,13,0,13,6,1
75035,4,34,17,17,17,0
295423,3,10,13,-3,12,1
302613,2,3,3,0,15,1
403770,3,12,13,-1,9,0
231883,2,7,27,-20,1,1
152928,2,14,14,0,1,0
141452,1,0,0,0,13,1
20087,4,22,22,0,10,0
164715,1,6,0,6,6,0
140773,3,22,21,1,12,0
212743,2,10,14,-4,10,0
182659,3,0,12,-12,14,0
887,1,0,0,0,1,0
325475,3,19,3,16,8,1
267354,1,0,7,-7,17,1
185461,4,17,20,-3,15,1
47197,3,9,3,6,5,0
216029,2,10,12,-2,11,0
342077,1,3,3,0,16,1
404563,1,0,0,0,10,0
5341,2,10,0,10,3,0
307257,4,10,13,-3,17,0
236148,2,6,10,-4,3,1
289541,1,0,0,0,10,1
395497,2,14,14,0,6,1
140712,2,6,14,-8,12,1
113978,4,20,20,0,17,0
331238,1,0,0,0,11,1
65725,2,7,16,-9,13,0
391031,4,27,34,-7,4,1
112672,1,3,0,3,17,0
86157,3,31,10,21,5,0
50288,3,13,16,-3,6,1
29255,2,14,0,14,14,1
176088,4,24,16,8,11,0
235779,4,20,27,-7,3,1
146702,3,7,32,-25,15,0
1057,2,7,22,-15,1,1
329620,2,10,7,3,11,1
217696,1,7,0,7,12,0
307734,1,7,0,7,1,0
31296,2,7,3,4,15,1
101125,4,13,17,-4,12,0
115143,3,10,20,-10,1,1
17229,3,7,31,-24,9,0
310672,4,13,36,-23,2,1
53634,1,0,0,0,8,1
216713,3,24,6,18,12,1
309682,2,3,3,0,1,0
350619,3,13,0,13,2,0
346191,2,17,0,17,1,1
354625,2,3,7,-4,4,1
178570,4,16,13,3,12,0
73726,1,0,0,0,17,0
318029,4,17,16,1,5,1
201226,4,20,24,-4,5,1
41999,1,3,0,3,2,1
192603,2,3,7,-4,1,1
343341,2,0,17,-17,16,0
139082,2,6,3,3,12,1
237805,2,0,10,-10,4,0
133478,3,20,17,3,9,0
290352,2,6,3,3,10,0
9065,3,28,13,15,4,0
363132,3,13,3,10,8,1
209627,4,50,34,16,8,0
336763,3,10,10,0,14,1
6646,2,0,10,-10,3,1
83120,4,6,30,-24,4,1
225664,3,14,10,4,16,0
171410,5,19,20,-1,9,1
196038,1,0,14,-14,2,1
150214,4,6,26,-20,16,0
383454,4,16,12,4,17,1
7393,1,3,0,3,4,1
83255,3,9,10,-1,4,1
194283,2,10,0,10,2,0
27722,1,0,0,0,13,1
364376,2,14,0,14,9,0
303228,1,0,0,0,16,0
176145,2,14,7,7,11,0
69542,2,0,0,0,15,0
166001,3,17,21,-4,6,1
25981,2,10,9,1,13,1
205646,2,13,9,4,7,1
211068,3,30,0,30,9,0
126218,3,21,6,15,6,0
216769,4,27,9,18,12,1
280623,4,23,9,14,5,1
170268,2,0,12,-12,8,1
27978,4,21,17,4,13,1
227115,1,0,0,0,16,1
141007,2,7,0,7,13,1
192046,4,24,27,-3,1,1
164060,3,3,6,-3,5,0
351136,5,37,37,0,3,0
267972,2,0,6,-6,17,1
238717,4,19,17,2,4,1
140416,1,0,7,-7,12,1
195681,3,7,10,-3,2,1
26922,3,13,6,7,13,0
191005,4,19,3,16,17,1
56323,4,3,26,-23,9,0
241381,2,7,14,-7,5,1
269560,4,21,31,-10,1,0
162973,2,6,3,3,5,0
67127,1,0,0,0,14,0
419016,2,7,14,-7,16,0
18151,3,13,17,-4,9,0
344819,2,14,10,4,17,1
83005,4,20,19,1,4,1
236855,4,6,12,-6,3,0
168038,3,6,17,-11,7,0
78085,1,7,3,4,2,0
244071,3,20,27,-7,6,1
207581,2,21,3,18,7,0
169499,2,0,28,-28,8,1
238350,2,10,16,-6,4,0
164402,4,33,3,30,5,0
237102,3,8,26,-18,3,0
230571,2,10,10,0,1,1
135239,3,13,3,10,10,1
14412,1,14,3,11,7,0
294875,4,49,21,28,12,0
138775,1,0,0,0,12,0
28154,1,0,0,0,13,1
89776,1,3,0,3,7,1
126475,1,0,6,-6,6,1
113133,2,34,0,34,17,0
125591,2,14,10,4,5,0
226308,3,19,7,12,16,0
287814,3,21,17,4,9,1
266972,3,19,10,9,17,0
109735,3,13,0,13,16,0
254157,3,3,12,-9,11,0
2866,3,31,31,0,2,1
223153,4,43,30,13,14,0
206211,2,0,3,-3,7,0
269233,3,3,6,-3,17,0
158491,2,3,10,-7,3,1
99800,3,0,21,-21,12,0
167239,4,30,17,13,7,0
386450,1,0,0,0,2,0
117867,4,9,20,-11,2,1
23003,2,0,7,-7,11,0
125990,4,26,23,3,6,1
78131,2,14,3,11,2,1
347007,3,7,3,4,1,1
176777,1,3,0,3,11,1
410397,2,6,7,-1,13,0
421144,3,30,16,14,17,1
344606,1,0,0,0,17,0
335281,2,0,6,-6,13,1
381815,2,0,14,-14,17,1
209971,1,0,3,-3,8,0
277963,1,0,0,0,4,1
326671,3,16,6,10,9,0
301709,1,0,3,-3,15,0
137314,1,0,0,0,11,1
159190,1,7,7,0,3,1
284297,2,3,9,-6,7,0
336843,1,7,7,0,14,1
348330,1,7,7,0,1,1
61895,4,27,23,4,12,0
232073,3,0,30,-30,1,0
233959,4,24,19,5,2,1
275660,4,30,3,27,3,1
406282,4,21,35,-14,11,1
310944,3,3,23,-20,2,1
91709,4,21,24,-3,8,1
360846,1,0,0,0,7,0
62509,5,16,16,0,12,1
230534,2,3,7,-4,1,1
329671,3,23,14,9,11,0
100274,1,6,0,6,12,0
151092,4,17,10,7,17,1
199714,3,28,7,21,4,0
83748,4,25,23,2,4,1
11116,3,10,13,-3,5,1
219722,4,13,14,-1,13,1
408171,2,6,0,6,12,1
167280,1,3,0,3,7,0
353183,4,27,29,-2,3,1
223702,3,20,13,7,15,1
389773,2,10,6,4,3,1
271741,2,13,10,3,2,1
198662,3,15,21,-6,3,1
287573,1,0,0,0,9,1
58703,2,7,10,-3,10,1
296358,4,13,25,-12,13,1
159930,4,38,10,28,3,0
13149,2,13,16,-3,6,1
268860,1,0,10,-10,17,1
288912,4,19,31,-12,9,1
393338,1,7,7,0,5,1
13006,2,7,7,0,6,1
178039,4,13,23,-10,12,1
293709,4,10,13,-3,12,0
110409,1,7,0,7,16,1
420468,2,0,21,-21,17,0
179098,2,6,6,0,12,1
349625,4,13,28,-15,2,0
195819,3,20,14,6,2,1
146677,2,7,26,-19,15,1
276946,3,17,17,0,4,0
14312,3,2,7,-5,7,0
208332,2,14,24,-10,8,1
226819,1,0,0,0,16,1
360441,2,10,0,10,7,1
303980,4,21,40,-19,16,0
22839,1,0,0,0,11,0
135943,1,0,3,-3,10,1
397726,2,9,14,-5,7,1
316192,4,30,35,-5,4,1
268066,4,24,16,8,17,1
263417,1,0,13,-13,15,1
303463,3,22,10,12,16,0
237886,4,7,27,-20,4,0
214127,3,3,6,-3,11,0
181437,3,24,24,0,13,1
61034,4,34,16,18,11,0
179187,1,0,0,0,12,1
85725,4,24,28,-4,5,0
997,4,0,6,-6,1,1
114237,3,10,17,-7,1,0
16160,1,0,0,0,8,0
224473,3,9,10,-1,15,1
275255,1,10,0,10,3,0
14058,3,3,24,-21,7,1
85352,3,21,3,18,5,1
243615,3,20,14,6,6,0
167882,3,14,16,-2,7,1
411636,3,20,28,-8,13,1
57025,2,7,16,-9,9,0
252574,1,0,0,0,10,0
76967,3,17,13,4,1,0
118421,3,20,10,10,2,0
257409,4,20,14,6,13,1
14885,2,7,0,7,7,1
370662,4,21,14,7,12,0
406859,4,13,23,-10,11,0
173467,2,0,10,-10,10,1
149557,3,14,16,-2,16,1
156398,4,38,20,18,2,1
228380,3,7,17,-10,17,1
400678,3,9,7,2,8,1
244220,2,13,7,6,6,1
354362,3,38,3,35,4,1
191676,2,7,10,-3,17,0
297838,3,14,10,4,13,1
277686,2,7,0,7,4,1
249609,4,27,16,11,9,1
35974,4,6,7,-1,17,0
230635,4,16,30,-14,1,0
311503,3,17,10,7,2,0
86676,2,10,0,10,5,1
245482,4,23,6,17,7,0
352477,1,0,0,0,3,1
379919,3,14,6,8,16,1
593,1,0,0,0,1,1
10866,4,27,21,6,5,1
262691,1,7,0,7,15,0
18452,3,7,7,0,9,0
41365,3,14,12,2,2,1
359712,1,10,6,4,6,1
270509,1,0,7,-7,1,1
180828,4,17,20,-3,13,0
86628,4,47,3,44,5,1
85783,2,13,7,6,5,1
111208,2,7,3,4,16,1
70354,4,10,33,-23,15,1
303049,1,0,0,0,16,1
127364,4,10,20,-10,6,0
167598,1,0,0,0,7,1
411518,4,13,31,-18,13,1
371657,4,24,17,7,12,0
291788,4,9,23,-14,11,1
72425,1,7,0,7,16,1
43152,1,0,0,0,3,1
368577,3,9,0,9,11,1
151775,3,14,6,8,17,0
146924,1,0,0,0,15,1
134925,2,7,16,-9,10,0
158447,1,0,7,-7,3,1
332328,3,13,6,7,12,1
203635,2,7,10,-3,6,1
166260,2,0,3,-3,6,1
181481,4,31,24,7,13,0
359388,4,13,20,-7,6,0
172678,2,7,3,4,9,1
140124,2,10,0,10,12,1
360435,2,10,0,10,7,0
248308,2,17,7,10,8,1
347003,3,7,3,4,1,0
340640,2,16,3,13,15,0
271654,4,23,37,-14,2,1
237541,3,30,7,23,3,1
324599,4,16,9,7,8,1
102772,2,10,3,7,13,1
239225,1,0,7,-7,4,1
225616,2,0,7,-7,16,0
364755,4,12,6,6,9,0
180366,4,15,14,1,13,0
91748,1,0,0,0,8,0
302648,2,17,6,11,15,1
310281,2,17,0,17,2,0
176202,3,14,24,-10,11,0
342274,3,13,0,13,16,0
399813,4,11,24,-13,8,0
20271,1,7,0,7,10,1
418021,4,21,35,-14,16,0
337083,4,26,0,26,14,1
294385,3,16,3,13,12,0
32878,4,12,7,5,15,1
264620,4,12,17,-5,16,1
298628,1,3,0,3,14,1
258163,4,13,13,0,13,1
174225,3,3,26,-23,10,1
312417,4,26,34,-8,3,0
388989,4,24,27,-3,3,0
257114,4,17,21,-4,12,0
115945,1,0,0,0,1,0
213153,1,0,0,0,10,1
89233,3,6,0,6,7,1
288379,2,7,0,7,9,1
211538,3,36,21,15,9,1
116884,2,7,7,0,2,0
285332,4,24,9,15,7,0
301159,2,10,11,-1,15,1
382838,3,21,3,18,17,1
378441,3,10,0,10,15,1
183895,1,0,0,0,14,1
107510,4,3,23,-20,15,1
378914,3,13,30,-17,15,1
416149,1,3,6,-3,15,0
145302,2,14,12,2,14,1
391973,1,0,0,0,4,0
221402,2,3,17,-14,14,0
34745,3,13,3,10,16,0
342117,2,12,6,6,16,0
104173,4,27,27,0,13,1
61578,3,28,7,21,11,1
110589,2,17,7,10,16,0
175188,4,49,17,32,10,1
78510,1,0,0,0,2,0
292897,2,7,0,7,11,0
194489,4,23,10,13,2,0
205257,4,23,20,3,6,1
353556,2,17,0,17,4,1
283073,1,3,0,3,7,0
194970,4,14,22,-8,2,0
40330,3,6,7,-1,2,1
411073,4,17,17,0,13,1
119799,3,17,6,11,3,0
188,2,3,3,0,1,0
248206,4,12,10,2,8,0
26632,4,16,13,3,13,1
170820,1,7,0,7,8,0
403552,1,7,0,7,9,1
367789,1,3,0,3,10,0
352597,4,34,23,11,3,0
379220,4,12,13,-1,16,0
249243,3,19,14,5,9,1
372007,2,10,0,10,13,1
85317,2,21,3,18,5,0
132330,4,31,17,14,9,1
259396,1,0,0,0,13,1
271,4,12,24,-12,1,0
59444,2,3,10,-7,11,0
158813,3,17,3,14,3,0
221060,1,0,0,0,14,1
372818,4,6,0,6,13,0
90784,4,20,7,13,7,0
299268,2,20,0,20,14,1
193823,2,10,0,10,1,0
325249,1,0,3,-3,8,1
369483,4,48,7,41,11,0
224553,1,0,0,0,15,1
143047,2,3,7,-4,13,0
71473,3,30,7,23,16,1
287729,1,6,0,6,9,1
104968,4,10,22,-12,14,0
211787,1,0,7,-7,9,1
401309,4,20,24,-4,8,0
143173,1,7,3,4,13,0
285282,3,14,6,8,7,0
406515,2,7,16,-9,11,0
176206,3,14,24,-10,11,1
183365,2,14,3,11,14,0
177217,2,7,0,7,11,0
357471,1,0,0,0,5,0
184705,4,17,24,-7,15,1
128723,4,19,30,-11,7,1
139605,4,9,14,-5,12,1
161554,2,6,3,3,4,1
183973,3,22,3,19,14,1
312215,2,7,14,-7,2,1
274795,5,24,23,1,3,0
93404,1,3,7,-4,9,1
379859,1,7,0,7,16,0
124309,4,34,20,14,5,1
72306,1,0,0,0,16,0
177178,1,0,0,0,11,0
177557,2,10,0,10,11,0
30140,2,10,10,0,14,1
6861,4,10,31,-21,3,1
272719,3,12,3,9,2,0
26828,1,0,0,0,13,1
212520,4,13,16,-3,10,1
359214,4,21,21,0,6,0
152716,1,0,0,0,17,1
66462,2,7,7,0,14,0
92473,4,23,10,13,8,0
372713,1,0,0,0,13,0
206617,4,10,16,-6,7,1
348462,1,0,0,0,2,1
18961,1,0,0,0,10,1
58279,3,17,13,4,10,1
145965,4,10,21,-11,15,0
190741,1,0,0,0,17,1
241082,2,13,0,13,5,1
324041,1,0,0,0,8,1
101434,4,18,7,11,12,0
101297,4,17,20,-3,12,1
99976,4,17,19,-2,12,1
290577,4,26,20,6,10,0
340962,4,10,17,-7,15,1
280220,1,3,0,3,5,1
73342,2,13,0,13,17,0
63332,3,17,3,14,12,1
262996,2,7,0,7,15,1
179135,3,9,13,-4,12,1
244576,4,25,16,9,7,1
291700,2,0,3,-3,11,0
300763,2,10,13,-3,15,0
365794,4,24,17,7,9,1
329522,3,31,7,24,10,0
261040,1,0,7,-7,14,1
348293,4,16,46,-30,1,0
37368,3,17,0,17,17,0
198437,2,3,3,0,3,1
407471,4,17,10,7,11,0
85913,1,7,14,-7,5,1
148799,3,13,16,-3,16,0
4728,1,7,0,7,3,1
160004,2,3,23,-20,3,1
233722,2,13,21,-8,2,0
142213,5,11,13,-2,13,0
147582,3,12,0,12,15,0
345031,1,0,0,0,17,0
207697,2,0,7,-7,7,0
229181,4,19,7,12,17,0
255421,4,24,6,18,12,0
393336,1,7,7,0,5,1
55504,1,10,0,10,9,0
182999,4,10,44,-34,14,1
158282,1,0,0,0,3,1
282955,2,7,3,4,6,1
115372,1,7,0,7,1,0
336506,1,0,0,0,14,1
100707,4,21,24,-3,12,1
410653,1,0,0,0,13,0
340620,2,6,3,3,15,1
136319,3,18,7,11,11,0
299846,2,10,0,10,14,1
364791,1,0,0,0,9,0
397585,2,6,20,-14,7,0
220756,4,13,16,-3,13,0
396857,2,17,10,7,6,1
292955,4,10,0,10,11,1
32984,3,6,24,-18,15,0
310674,4,13,36,-23,2,1
7465,3,29,6,23,4,0
221352,1,0,0,0,14,0
279824,2,7,6,1,5,0
101012,4,20,16,4,12,1
379176,3,9,10,-1,16,1
333492,2,3,0,3,12,1
23886,1,3,0,3,12,1
303804,4,20,17,3,16,1
224515,4,15,10,5,15,1
54185,2,0,3,-3,8,1
40133,2,13,0,13,2,0
222706,4,14,24,-10,14,1
259111,2,6,0,6,13,1
107849,4,23,30,-7,15,0
42720,4,7,20,-13,3,1
350339,3,24,3,21,2,0
372376,4,24,17,7,13,0
328742,2,7,6,1,10,1
48791,4,24,28,-4,5,1
192284,2,24,3,21,1,1
309700,2,10,6,4,1,1
86731,3,17,14,3,5,1
288021,1,0,0,0,9,0
350605,2,10,0,10,2,1
405594,3,14,17,-3,10,0
35356,3,23,12,11,16,0
333245,3,6,14,-8,12,0
126107,4,23,9,14,6,1
73,2,7,7,0,1,1
59651,3,21,6,15,11,1
121421,4,7,12,-5,3,1
277500,1,0,0,0,4,1
366186,4,7,48,-41,10,0
99250,4,31,20,11,11,1
19056,4,10,6,4,10,0
7236,2,0,13,-13,4,1
176473,2,0,10,-10,11,1
236794,2,3,9,-6,3,0
36826,3,17,26,-9,17,0
271971,4,23,27,-4,2,1
75915,3,29,7,22,1,1
331003,3,36,7,29,11,1
411895,2,14,3,11,13,1
124636,4,13,17,-4,5,0
139790,1,0,3,-3,12,1
34670,1,0,3,-3,16,1
346720,4,24,13,11,1,1
139941,2,10,3,7,12,0
402860,2,10,3,7,9,1
266814,3,10,14,-4,16,0
334324,1,0,0,0,13,0
75178,4,13,6,7,17,1
105219,2,7,24,-17,14,1
248307,2,17,7,10,8,1
195036,2,7,17,-10,2,1
184090,2,9,7,2,14,0
100006,1,3,0,3,12,0
48260,2,3,10,-7,5,0
210834,1,0,0,0,9,1
66197,2,24,3,21,13,1
193786,1,0,0,0,1,0
318799,4,17,29,-12,5,0
27520,3,23,9,14,13,0
266053,2,10,3,7,16,1
141527,3,24,10,14,13,0
175127,3,28,10,18,10,0
375349,3,7,17,-10,14,1
404263,1,0,0,0,10,0
76858,4,33,7,26,1,1
169033,2,26,14,12,7,0
172569,3,13,24,-11,9,1
184198,1,7,0,7,14,1
277786,1,0,0,0,4,1
17498,2,10,0,10,9,1
125111,1,7,0,7,5,0
193927,4,31,17,14,1,0
4991,4,24,17,7,3,1
146459,1,0,0,0,15,0
256911,3,14,18,-4,12,0
21005,3,14,24,-10,10,0
282161,4,30,15,15,6,0
322069,3,23,0,23,7,1
373042,2,0,0,0,13,1
101232,2,7,7,0,12,1
40712,2,7,7,0,2,1
302384,3,16,13,3,15,0
39140,3,20,10,10,1,0
401803,1,7,0,7,9,0
21936,4,35,9,26,11,1
260033,1,0,7,-7,14,1
14704,1,7,0,7,7,0
224282,2,6,9,-3,15,1
40279,2,6,0,6,2,1
343518,3,10,10,0,16,0
408277,1,0,0,0,12,1
300379,4,10,7,3,14,0
6360,2,0,13,-13,3,0
159260,3,17,24,-7,3,1
156426,1,0,3,-3,2,1
350546,1,7,0,7,2,1
24361,2,3,0,3,12,0
201265,1,7,0,7,5,0
184021,4,29,10,19,14,0
162858,4,6,3,3,5,1
107013,1,7,0,7,15,1
312603,1,0,0,0,3,0
383715,4,16,24,-8,17,0
321855,1,7,13,-6,7,0
354987,3,7,12,-5,4,0
177519,1,0,0,0,11,1
118685,2,14,6,8,2,0
341983,3,6,3,3,16,1
193753,4,10,27,-17,1,1
23138,1,6,0,6,11,1
277728,3,7,3,4,4,0
247062,1,2,3,-1,8,0
329367,3,9,27,-18,10,1
227075,4,20,9,11,16,0
46061,3,14,14,0,4,1
29129,2,0,16,-16,14,0
364373,1,14,0,14,9,0
245644,4,43,26,17,7,1
340404,4,24,13,11,15,0
225669,4,14,10,4,16,0
383596,4,24,24,0,17,1
63006,2,6,14,-8,12,0
153173,4,20,17,3,1,0
182367,4,24,17,7,14,0
323886,4,16,30,-14,8,1
313034,3,20,0,20,3,0
119276,3,14,3,11,3,1
151358,3,31,14,17,17,0
261583,4,12,15,-3,14,1
170753,4,24,6,18,8,0
342710,2,0,7,-7,16,1
245726,2,13,10,3,7,1
113728,2,3,10,-7,17,1
153638,4,15,14,1,1,0
10371,3,10,35,-25,5,0
143495,2,14,21,-7,14,0
408484,3,7,10,-3,12,1
138683,3,6,28,-22,12,1
397236,4,16,0,16,6,0
143520,3,17,21,-4,14,1
194147,2,3,3,0,1,0
132433,3,0,21,-21,9,0
206152,4,27,19,8,7,0
35059,3,15,10,5,16,0
95403,2,21,7,14,10,1
398503,3,21,16,5,7,1
372224,4,15,25,-10,13,0
302824,3,9,20,-11,15,0
122844,2,10,3,7,4,1
328543,4,15,9,6,10,0
163810,4,17,19,-2,5,1
192667,3,13,7,6,1,1
231877,2,7,20,-13,1,0
411913,2,17,3,14,13,1
303965,4,14,34,-20,16,0
417413,4,24,17,7,16,0
31742,2,0,10,-10,15,1
229802,1,0,0,0,17,0
344355,2,14,0,14,17,0
397330,3,0,24,-24,6,1
250209,4,17,16,1,9,1
182970,3,10,37,-27,14,1
202883,3,21,0,21,5,1
7429,2,20,3,17,4,0
56906,3,27,7,20,9,1
272503,1,7,0,7,2,1
107348,3,16,6,10,15,0
30313,3,3,10,-7,14,1
98329,4,35,27,8,11,0
339784,4,24,13,11,15,1
353551,2,17,0,17,4,1
319162,2,2,3,-1,5,1
25968,2,10,6,4,13,0
397847,2,0,0,0,7,0
298486,1,10,0,10,14,1
79474,3,12,14,-2,2,0
204549,1,0,21,-21,6,0
241576,3,3,20,-17,5,1
178750,1,14,0,14,12,0
233981,1,7,0,7,2,1
139616,4,9,14,-5,12,1
398328,2,3,10,-7,7,0
162821,2,3,3,0,5,0
326851,4,10,17,-7,9,0
277996,2,3,10,-7,4,1
66267,1,0,0,0,14,0
359277,1,0,6,-6,6,1
286453,4,17,10,7,8,1
360310,3,0,13,-13,7,1
62532,5,16,16,0,12,0
172544,2,6,21,-15,9,1
266014,1,7,0,7,16,0
416987,4,10,17,-7,15,1
88428,1,6,0,6,6,1
314037,2,6,0,6,3,0
7711,2,10,0,10,4,0
22737,2,3,14,-11,11,0
274375,2,3,10,-7,3,0
268538,1,7,3,4,17,0
115229,2,0,3,-3,1,1
245975,1,0,0,0,7,1
53911,3,7,13,-6,8,1
297709,3,17,13,4,13,0
255902,1,3,0,3,12,0
1277,4,17,16,1,1,1
119025,4,7,32,-25,3,0
21823,1,0,0,0,11,1
105056,2,6,14,-8,14,0
163620,3,21,19,2,5,0
89820,2,6,3,3,7,0
112663,1,0,0,0,17,1
325169,3,13,14,-1,8,1
177840,2,14,16,-2,12,1
152526,3,24,7,17,17,0
93064,4,20,12,8,8,0
19529,1,0,0,0,10,1
234511,3,20,20,0,2,0
138602,1,3,0,3,12,1
63906,3,6,21,-15,12,0
353667,2,3,0,3,4,1
207006,2,27,0,27,7,1
91044,3,6,0,6,7,1
65228,4,10,10,0,13,0
2371,2,7,9,-2,2,0
370673,4,24,14,10,12,0
251423,4,46,14,32,10,0
203250,4,17,24,-7,5,0
118504,1,14,0,14,2,1
173868,1,6,7,-1,10,1
34895,3,26,10,16,16,1
76496,2,0,20,-20,1,1
13990,2,3,0,3,7,1
264135,3,20,27,-7,15,1
332555,1,3,3,0,12,0
208825,4,6,22,-16,8,0
216287,1,0,0,0,12,1
163124,2,16,19,-3,5,0
303933,3,14,24,-10,16,0
218293,2,10,14,-4,12,1
56022,4,10,23,-13,9,1
419713,2,0,10,-10,17,1
308368,2,0,6,-6,1,0
273765,2,7,7,0,2,0
202806,1,0,0,0,5,0
137078,2,14,3,11,11,1
122247,2,3,10,-7,4,0
292475,3,10,9,1,11,0
299869,2,13,5,8,14,0
260246,3,10,3,7,14,1
194819,4,10,26,-16,2,1
34145,3,10,3,7,16,1
282698,3,6,20,-14,6,1
156110,1,7,7,0,2,1
174618,1,3,0,3,10,1
79971,1,0,0,0,2,1
156930,2,7,10,-3,2,1
276401,4,32,44,-12,3,0
254917,3,24,7,17,12,1
295903,3,10,17,-7,12,1
421772,4,31,24,7,17,0
193489,4,33,20,13,1,0
40884,2,13,10,3,2,0
52410,4,12,17,-5,7,0
206345,1,0,0,0,7,1
359800,4,30,33,-3,6,1
364960,1,7,0,7,9,0
98172,4,21,19,2,11,1
253477,4,17,44,-27,11,1
362586,1,0,0,0,8,0
86939,1,7,0,7,5,0
393126,3,24,3,21,4,0
40218,4,34,7,27,2,0
257248,4,19,23,-4,12,0
80771,2,3,0,3,3,1
266998,4,19,17,2,17,1
355836,2,13,0,13,5,0
294221,3,13,7,6,12,0
219908,1,3,0,3,13,1
351787,2,17,14,3,3,0
49871,4,21,17,4,6,1
395315,1,14,0,14,5,0
356336,2,17,0,17,5,1
291292,3,14,19,-5,10,1
391455,3,10,20,-10,4,1
135937,1,0,3,-3,10,0
273203,3,33,7,26,2,0
251389,3,27,14,13,10,1
26295,3,13,21,-8,13,1
7775,3,30,3,27,4,0
321289,2,9,13,-4,6,1
127962,3,23,13,10,6,0
262542,1,0,0,0,15,1
84747,3,10,24,-14,4,1
296086,4,9,14,-5,13,0
247702,2,7,6,1,8,0
71538,1,0,0,0,16,1
87914,4,19,15,4,6,1
187847,3,7,20,-13,16,1
41028,2,3,10,-7,2,1
383189,1,14,0,14,17,0
117789,2,6,6,0,2,0
236460,2,7,0,7,3,1
286000,4,29,20,9,8,1
293869,1,0,0,0,12,1
293953,3,7,21,-14,12,1
342637,4,22,27,-5,16,0
200536,1,7,0,7,4,0
8602,2,6,10,-4,4,1
33963,3,3,27,-24,16,1
317891,1,0,0,0,5,1
87739,3,6,20,-14,6,0
237103,3,8,26,-18,3,0
364713,3,6,3,3,9,1
220095,2,19,3,16,13,0
155585,4,23,10,13,2,0
334341,1,0,3,-3,13,1
211144,2,0,9,-9,9,0
186350,3,29,17,12,15,0
363746,4,26,27,-1,8,1
81130,3,13,14,-1,3,1
129341,1,14,7,7,7,0
237509,2,17,7,10,3,1
1816,2,16,0,16,1,0
29462,3,10,14,-4,14,0
26106,2,0,10,-10,13,0
390145,4,20,35,-15,3,0
149886,4,6,16,-10,16,0
348921,4,9,21,-12,2,1
122919,4,34,6,28,4,1
401564,3,17,14,3,8,1
406222,2,14,17,-3,11,1
55173,1,0,0,0,9,1
412651,2,10,10,0,14,1
103327,1,7,10,-3,13,0
282014,4,28,28,0,6,0
220633,1,0,0,0,13,0
328600,2,16,14,2,10,1
242523,4,18,13,5,6,0
68244,3,20,17,3,14,0
10424,1,0,0,0,5,1
391689,2,0,3,-3,4,1
151539,4,42,7,35,17,1
17109,3,23,10,13,9,0
99988,4,17,19,-2,12,1
146847,3,24,0,24,15,1
151954,3,27,24,3,17,1
373604,4,30,40,-10,13,1
308977,2,0,3,-3,1,0
173298,2,14,16,-2,10,0
390868,3,9,28,-19,3,0
287646,3,3,10,-7,9,1
292339,3,12,13,-1,11,1
218493,4,31,17,14,13,1
300504,3,23,16,7,14,0
140417,1,0,7,-7,12,1
267011,4,22,17,5,17,0
237285,4,26,0,26,3,1
380392,3,10,17,-7,16,1
129529,2,3,7,-4,7,0
166154,3,21,12,9,6,0
324152,3,3,10,-7,8,1
245762,4,16,17,-1,7,0
344040,4,23,9,14,17,1
168551,2,7,10,-3,7,1
149415,3,13,27,-14,16,1
244227,2,16,7,9,6,1
121843,3,0,10,-10,4,1
189306,2,3,7,-4,16,1
296604,2,3,7,-4,13,1
194771,3,3,16,-13,2,0
137997,2,7,14,-7,11,0
420381,4,20,13,7,17,0
407306,4,17,19,-2,11,1
137,4,10,10,0,1,1
254884,2,7,7,0,12,1
316882,2,9,2,7,4,0
278664,3,17,3,14,4,1
182130,2,16,0,16,13,0
237778,1,0,7,-7,4,1
48420,3,17,17,0,5,0
335495,4,13,12,1,13,0
397301,3,0,21,-21,6,0
398347,2,3,13,-10,7,1
335439,2,13,9,4,13,1
72526,3,16,17,-1,16,1
45123,2,7,6,1,4,0
35492,3,24,7,17,17,0
49078,4,13,13,0,6,0
321347,4,28,22,6,6,1
415224,4,17,38,-21,15,0
298970,3,9,9,0,14,1
401156,4,44,13,31,8,0
8527,4,15,10,5,4,1
198179,3,10,6,4,3,1
270434,3,10,7,3,1,1
382682,3,3,6,-3,17,1
33870,4,9,41,-32,16,0
77559,4,20,14,6,1,0
215970,4,20,34,-14,11,0
231776,3,10,20,-10,1,1
151768,2,14,6,8,17,1
33654,2,14,0,14,16,0
197042,4,30,33,-3,3,0
285870,1,6,0,6,8,1
41800,3,10,14,-4,2,1
265605,2,6,8,-2,16,0
228742,4,26,33,-7,17,1
16387,3,21,13,8,8,1
234213,3,20,10,10,2,1
296133,1,10,6,4,13,0
360700,1,0,7,-7,7,0
334090,2,6,0,6,13,1
370547,1,0,0,0,12,1
60061,2,7,3,4,11,1
282273,3,25,14,11,6,0
261949,2,7,3,4,14,0
149250,2,7,13,-6,16,1
408158,2,6,0,6,12,0
116891,2,7,10,-3,2,0
315869,4,9,19,-10,4,1
230282,2,16,10,6,17,1
20532,4,3,0,3,10,1
60537,3,30,20,10,11,0
387961,1,3,0,3,2,0
31882,1,6,0,6,15,1
304815,3,0,3,-3,16,1
338750,4,27,17,10,14,0
310103,1,7,0,7,2,0
139586,3,9,14,-5,12,0
393265,3,21,26,-5,5,1
271538,1,0,3,-3,2,0
52115,4,19,19,0,7,1
90035,4,5,21,-16,7,1
271473,3,14,0,14,1,0
406087,3,0,20,-20,11,1
252370,4,0,22,-22,10,0
361719,4,10,39,-29,7,0
321676,1,0,0,0,7,0
324947,1,0,7,-7,8,1
116695,2,6,3,3,2,1
28955,2,0,7,-7,14,0
200539,1,7,0,7,4,0
77754,1,7,0,7,1,0
66978,1,0,0,0,14,1
5547,3,16,10,6,3,1
95752,4,20,9,11,10,1
115547,2,3,3,0,1,0
109547,2,0,7,-7,16,0
67229,4,0,3,-3,14,1
287035,3,19,24,-5,8,0
265355,2,7,10,-3,16,0
170082,1,7,0,7,8,0
84572,2,7,7,0,4,1
294609,1,0,0,0,12,0
96485,3,17,17,0,10,0
49975,3,21,7,14,6,1
226095,2,7,14,-7,16,0
410204,1,0,0,0,13,1
414915,4,42,21,21,15,1
229919,4,27,14,13,17,1
22904,3,3,19,-16,11,0
339921,4,33,0,33,15,0
42623,2,0,7,-7,3,0
180515,3,21,20,1,13,0
392537,4,3,20,-17,4,0
265923,2,0,16,-16,16,1
169310,1,0,0,0,8,0
282178,1,3,0,3,6,0
52709,3,3,20,-17,7,1
262684,1,0,0,0,15,1
96321,2,0,16,-16,10,1
390219,2,0,6,-6,3,1
229002,3,14,16,-2,17,1
273701,4,22,20,2,2,1
327852,3,16,10,6,10,0
385601,3,3,17,-14,1,1
82098,1,0,0,0,3,0
409122,3,3,10,-7,12,1
325488,3,19,6,13,8,1
395296,1,6,0,6,5,1
268661,4,20,20,0,17,1
199795,2,3,3,0,4,1
225194,2,3,7,-4,15,1
175088,2,7,10,-3,10,1
189327,2,3,10,-7,16,0
66216,3,24,3,21,13,1
283349,4,10,16,-6,7,1
34400,2,14,0,14,16,0
375361,3,14,17,-3,14,0
399994,4,12,13,-1,8,1
270785,1,0,0,0,1,1
13339,3,7,27,-20,7,1
414301,4,21,42,-21,14,1
238386,3,10,30,-20,4,1
181862,2,21,14,7,13,1
209800,1,0,6,-6,8,0
223874,3,23,6,17,15,0
19756,3,9,12,-3,10,0
169105,4,39,30,9,7,1
354257,4,20,17,3,4,1
412993,4,16,12,4,14,0
243513,1,0,0,0,6,0
11428,4,26,0,26,6,0
247056,1,0,3,-3,8,0
330556,3,7,7,0,11,1
89426,3,17,20,-3,7,0
131719,3,24,22,2,8,1
272773,4,15,10,5,2,0
1748,4,28,0,28,1,0
105474,1,13,0,13,14,0
138289,2,10,0,10,11,1
35701,1,0,0,0,17,1
37761,2,7,0,7,1,0
416697,4,44,15,29,15,0
257601,5,19,20,-1,13,0
411832,4,7,34,-27,13,1
227461,3,13,10,3,16,0
267063,2,3,0,3,17,1
421083,2,13,3,10,17,1
158987,4,21,29,-8,3,1
322768,2,3,20,-17,7,0
329415,4,16,41,-25,10,1
132071,1,6,0,6,9,1
222967,3,13,13,0,14,1
109905,4,23,0,23,16,0
341727,4,26,13,13,16,0
273682,4,22,13,9,2,1
61781,1,0,10,-10,12,1
58793,4,18,29,-11,10,0
170894,3,7,20,-13,8,1
334976,2,3,7,-4,13,0
174028,2,0,13,-13,10,1
47421,5,13,13,0,5,0
282352,2,7,7,0,6,0
253839,2,14,14,0,11,1
322462,2,12,0,12,7,0
170534,1,14,0,14,8,0
12972,1,0,0,0,6,0
57389,4,14,3,11,10,1
243173,4,23,22,1,6,0
292515,4,10,12,-2,11,0
96862,2,10,0,10,10,0
140639,3,37,10,27,12,1
35545,4,30,7,23,17,0
400901,1,6,0,6,8,0
75983,1,7,7,0,1,1
318606,3,10,10,0,5,0
317567,4,24,27,-3,5,0
354041,2,13,0,13,4,1
286394,2,14,0,14,8,0
405691,1,3,0,3,10,1
58420,3,41,10,31,10,0
368928,1,0,0,0,11,0
317843,3,9,10,-1,5,0
376897,1,0,0,0,15,1
157652,1,0,0,0,2,1
173640,3,10,20,-10,10,1
295556,3,23,13,10,12,1
105692,3,28,3,25,14,0
103381,3,10,20,-10,13,0
122858,3,10,6,4,4,0
228267,4,17,27,-10,17,0
295755,4,17,16,1,12,0
105012,1,0,7,-7,14,1
124290,3,27,17,10,5,1
154850,1,3,0,3,1,1
324635,4,19,15,4,8,0
153752,3,2,21,-19,1,1
271736,2,13,10,3,2,0
161661,4,39,24,15,4,1
72415,4,24,23,1,16,0
387229,2,6,7,-1,2,0
209030,2,3,0,3,8,0
375815,3,20,7,13,14,1
133689,4,32,35,-3,9,0
5880,1,0,0,0,3,0
146820,2,17,0,17,15,0
149587,4,14,26,-12,16,1
170179,4,17,27,-10,8,1
110495,3,20,6,14,16,1
10562,4,40,0,40,5,1
114116,4,21,7,14,17,0
111353,2,0,7,-7,16,1
207279,2,0,7,-7,7,1
186140,2,3,3,0,15,1
152991,4,35,17,18,1,1
392380,3,20,31,-11,4,0
165816,2,3,6,-3,6,0
396559,2,17,10,7,6,1
417782,1,0,0,0,16,1
212122,2,3,7,-4,10,0
99929,3,10,6,4,12,0
411325,3,10,10,0,13,1
181560,2,13,0,13,13,0
123368,3,21,17,4,4,0
372129,2,9,7,2,13,0
11400,3,23,0,23,6,1
314682,4,14,21,-7,3,1
121669,2,7,7,0,4,0
276113,4,34,3,31,3,0
327949,1,0,0,0,10,0
283783,4,18,3,15,7,1
386010,1,7,0,7,1,1
305180,4,33,10,23,16,0
127975,4,23,20,3,6,0
369938,4,16,22,-6,12,0
282556,4,17,24,-7,6,1
123938,2,7,0,7,5,1
248203,4,12,10,2,8,0
267129,3,10,10,0,17,0
19255,1,7,7,0,10,1
201723,4,30,20,10,5,0
55515,1,10,0,10,9,0
77072,2,7,17,-10,1,1
238825,2,27,0,27,4,0
261633,1,0,0,0,14,1
203766,2,14,7,7,6,0
308023,4,21,12,9,1,1
178954,3,9,3,6,12,1
339419,2,7,10,-3,15,1
203674,3,14,23,-9,6,1
23935,2,16,0,16,12,1
98598,3,7,7,0,11,1
283854,2,7,3,4,7,0
374162,3,23,7,16,13,0
403582,2,17,7,10,9,0
137986,2,7,14,-7,11,1
180090,4,31,20,11,13,0
152563,4,24,14,10,17,1
383054,1,10,7,3,17,1
251634,1,3,0,3,10,1
171761,2,6,7,-1,9,0
105562,3,29,20,9,14,0
399106,4,10,29,-19,7,0
20191,3,17,3,14,10,0
16306,1,0,0,0,8,0
91209,4,10,17,-7,8,1
74829,3,13,12,1,17,0
188985,1,0,0,0,16,1
3897,2,19,7,12,2,1
303785,3,20,17,3,16,0
81824,1,0,14,-14,3,0
27193,3,16,7,9,13,1
279347,1,0,0,0,5,1
94395,4,17,21,-4,9,0
117901,1,0,0,0,2,0
297522,2,11,0,11,13,1
80603,1,0,10,-10,3,1
267293,4,17,17,0,17,0
55963,2,10,7,3,9,1
93293,2,21,3,18,9,0
387932,1,0,0,0,2,0
324653,1,0,0,0,8,0
308766,4,10,20,-10,1,1
155622,4,30,24,6,2,1
196446,4,20,21,-1,2,0
256355,1,3,0,3,12,1
165043,2,10,17,-7,6,0
104707,1,0,6,-6,14,1
50724,3,14,14,0,6,0
202891,3,21,0,21,5,1
411943,3,17,10,7,13,0
295230,2,14,5,9,12,1
88888,1,9,0,9,6,1
78198,4,41,3,38,2,1
82672,4,12,13,-1,3,0
204532,1,0,13,-13,6,0
286825,1,3,7,-4,8,1
26583,2,10,6,4,13,0
33150,4,10,42,-32,16,0
92474,4,23,10,13,8,0
120794,4,26,6,20,3,1
141606,1,0,0,0,13,1
297362,2,6,10,-4,13,0
43740,1,0,0,0,3,1
393740,3,7,7,0,5,1
130269,4,9,29,-20,8,1
226797,4,14,20,-6,16,0
346767,1,0,0,0,1,1
137793,1,0,0,0,11,0
355342,4,14,26,-12,4,1
151767,2,14,6,8,17,1
264826,4,24,37,-13,16,0
52404,4,12,17,-5,7,0
184782,2,17,14,3,15,1
223824,2,9,0,9,15,0
76175,2,9,12,-3,1,0
200204,4,14,37,-23,4,1
116200,4,22,19,3,1,1
163027,4,19,3,16,5,0
124639,4,13,17,-4,5,1
219949,2,6,7,-1,13,0
242836,1,0,0,0,6,1
248184,3,9,10,-1,8,1
417177,2,3,10,-7,16,0
326761,2,3,7,-4,9,0
339016,4,20,3,17,15,1
277837,2,7,14,-7,4,1
80196,3,14,10,4,2,0
253354,1,7,7,0,11,1
100256,4,24,14,10,12,0
276782,2,17,10,7,4,0
355858,2,13,10,3,5,1
12758,4,59,0,59,6,0
318101,2,9,7,2,5,1
266439,1,0,0,0,16,0
133640,3,10,21,-11,9,1
377496,1,0,0,0,15,1
201200,3,20,24,-4,5,1
359670,4,40,7,33,6,1
402611,3,17,16,1,9,1
258094,2,13,6,7,13,0
405298,3,14,7,7,10,1
193955,1,7,0,7,1,1
332651,4,27,20,7,12,0
239765,4,20,13,7,4,0
209088,3,3,20,-17,8,0
226394,1,0,0,0,16,0
48379,2,3,10,-7,5,0
197129,2,21,20,1,3,0
41092,4,3,16,-13,2,0
266365,3,24,0,24,16,0
229231,2,3,7,-4,17,1
37588,1,7,0,7,17,0
182904,2,0,17,-17,14,0
6706,4,3,20,-17,3,0
221486,4,3,41,-38,14,1
271303,3,6,17,-11,1,0
300419,1,2,0,2,14,0
59918,2,3,0,3,11,0
390666,2,3,3,0,3,0
36032,1,7,0,7,17,1
296015,2,3,7,-4,13,1
346841,3,10,3,7,1,1
113178,3,41,7,34,17,0
342745,3,0,7,-7,16,1
172851,2,17,3,14,9,0
199591,4,41,17,24,4,0
27264,1,0,0,0,13,1
322920,2,13,0,13,7,0
77430,4,27,21,6,1,0
174105,4,8,36,-28,10,0
326142,1,0,6,-6,9,0
9277,1,7,0,7,5,1
265822,4,20,12,8,16,0
14226,4,0,38,-38,7,1
161487,4,10,6,4,4,0
100593,1,0,0,0,12,0
138760,1,0,0,0,12,0
166729,2,7,3,4,6,0
33667,2,21,0,21,16,0
227851,1,7,6,1,16,1
329998,4,7,13,-6,11,1
178086,5,23,23,0,12,1
102379,4,16,20,-4,13,1
207547,1,14,0,14,7,1
306868,2,0,6,-6,17,0
231562,1,7,0,7,1,0
348619,4,34,23,11,2,0
358984,2,7,0,7,6,0
311274,4,6,3,3,2,1
171443,1,7,0,7,9,0
356476,2,0,3,-3,5,1
72466,2,7,10,-3,16,1
108905,5,17,17,0,15,0
13767,3,7,20,-13,7,0
32150,4,24,24,0,15,1
10946,2,9,21,-12,5,1
361284,4,21,32,-11,7,1
191168,1,0,0,0,17,1
385338,4,17,20,-3,1,0
384287,2,6,0,6,1,1
360848,1,0,0,0,7,0
42338,2,7,9,-2,2,0
397601,3,6,20,-14,7,1
239621,4,20,17,3,4,0
293615,1,7,0,7,12,0
346045,2,3,6,-3,1,1
183558,3,7,10,-3,14,0
157518,1,0,0,0,2,0
239798,1,0,0,0,4,0
117780,2,3,6,-3,2,1
2021,4,13,12,1,1,0
57208,3,13,7,6,10,1
200982,1,14,0,14,5,0
272793,1,0,0,0,2,1
92685,2,3,10,-7,8,0
57595,1,3,3,0,10,1
323846,3,16,15,1,8,0
385799,3,27,3,24,1,1
360137,2,10,3,7,7,0
294528,3,17,13,4,12,0
375420,1,0,7,-7,14,1
251085,2,10,14,-4,10,1
316312,3,10,19,-9,4,1
80400,4,27,16,11,2,1
383888,4,3,10,-7,1,1
395394,3,28,3,25,5,0
156965,3,7,10,-3,2,0
319634,2,16,3,13,6,1
37351,2,17,0,17,17,0
90577,2,14,7,7,7,0
404785,3,17,13,4,10,0
127300,2,10,14,-4,6,0
109527,1,0,7,-7,16,0
353404,3,18,0,18,4,0
123472,2,0,0,0,4,0
314381,4,10,17,-7,3,0
240321,3,7,17,-10,5,1
29210,1,0,0,0,14,1
145384,4,52,26,26,14,0
141487,2,7,0,7,13,0
63768,3,14,18,-4,12,1
91267,1,7,0,7,8,1
220763,4,13,16,-3,13,0
295591,4,23,32,-9,12,1
316521,1,0,0,0,4,0
144080,2,10,0,10,14,1
173064,4,24,12,12,9,1
370630,3,14,14,0,12,0
406172,1,7,0,7,11,0
188998,2,7,7,0,16,1
140912,3,17,10,7,13,0
138511,4,31,30,1,12,0
212291,2,7,3,4,10,1
330284,4,30,21,9,11,1
19267,2,7,14,-7,10,0
221705,2,10,0,10,14,0
155072,3,6,26,-20,1,1
218580,2,7,17,-10,13,1
139125,3,12,6,6,12,0
281043,3,17,13,4,6,1
94619,1,7,19,-12,9,1
55889,4,19,22,-3,9,1
70529,4,39,23,16,15,1
189561,1,0,0,0,17,0
386753,1,0,0,0,2,1
205197,3,14,13,1,6,1
347784,2,7,0,7,1,1
290099,4,13,15,-2,10,1
127137,2,10,9,1,6,1
200119,2,7,17,-10,4,1
194563,1,7,0,7,2,0
205735,4,27,25,2,7,1
168538,1,0,3,-3,7,1
378098,1,7,0,7,15,1
406381,3,10,7,3,11,1
219885,1,0,0,0,13,1
129967,1,0,0,0,8,0
79239,4,26,13,13,2,1
209035,2,3,0,3,8,0
329738,1,3,0,3,11,0
33677,2,28,0,28,16,0
137596,4,27,34,-7,11,1
150821,1,0,0,0,17,0
29530,1,0,7,-7,14,0
400931,2,13,7,6,8,1
156831,3,23,20,3,2,0
54053,3,10,3,7,8,0
244717,4,21,26,-5,7,1
420499,3,3,35,-32,17,0
123970,3,10,7,3,5,1
530,3,7,20,-13,1,1
110653,4,20,10,10,16,1
94632,2,14,19,-5,9,0
321075,1,0,0,0,6,1
243270,2,7,10,-3,6,1
215376,4,24,20,4,11,0
237538,3,24,7,17,3,0
167966,1,0,7,-7,7,0
696,3,0,17,-17,1,1
79750,3,20,7,13,2,1
148951,3,10,12,-2,16,0
142466,3,7,10,-3,13,0
47171,2,6,0,6,5,1
374005,3,10,7,3,13,1
344736,4,13,34,-21,17,0
165460,1,0,0,0,6,1
246415,1,0,0,0,8,1
260127,4,6,35,-29,14,1
334231,2,3,0,3,13,0
159671,1,0,6,-6,3,0
51507,4,34,24,10,7,1
398659,3,0,3,-3,7,0
151110,4,24,10,14,17,0
108650,2,13,0,13,15,1
223904,4,30,6,24,15,0
51629,3,21,20,1,7,1
212239,4,3,24,-21,10,0
197066,1,7,7,0,3,0
219457,2,0,7,-7,13,0
65686,1,0,7,-7,13,0
137134,4,31,6,25,11,0
229110,2,16,7,9,17,0
254172,3,3,12,-9,11,1
371653,4,24,17,7,12,1
334171,4,23,14,9,13,1
234894,4,10,19,-9,2,0
251003,4,3,6,-3,10,0
190573,4,17,20,-3,17,1
176858,4,17,16,1,11,0
235943,4,23,28,-5,3,1
120195,1,0,0,0,3,1
59290,1,0,0,0,11,0
329790,3,17,20,-3,11,0
352329,1,0,0,0,3,1
39411,2,3,10,-7,1,1
305269,3,28,21,7,16,0
309627,4,19,3,16,1,0
397875,2,0,3,-3,7,0
397029,3,21,9,12,6,1
95453,4,34,7,27,10,1
36184,2,10,14,-4,17,0
267016,4,22,17,5,17,0
6821,3,3,21,-18,3,1
247784,4,10,6,4,8,0
442,4,45,26,19,1,1
180994,4,31,31,0,13,1
331831,1,0,0,0,12,1
142923,2,3,10,-7,13,1
20434,1,0,0,0,10,0
140107,2,7,0,7,12,1
214766,3,3,13,-10,11,0
342684,1,0,0,0,16,0
176294,2,6,14,-8,11,1
175425,3,17,20,-3,11,0
114366,3,24,13,11,1,1
226177,4,28,35,-7,16,1
138360,4,30,7,23,11,1
125414,2,7,0,7,5,1
229650,1,0,7,-7,17,1
305830,2,0,14,-14,17,1
297000,4,32,14,18,13,0
87751,4,6,20,-14,6,1
195431,4,24,10,14,2,1
120886,3,14,24,-10,3,1
389522,3,20,10,10,3,0
276535,4,22,7,15,4,0
331936,4,6,28,-22,12,0
192140,2,0,6,-6,1,0
202721,2,6,10,-4,5,1
176461,1,0,10,-10,11,0
24414,4,16,7,9,12,0
416663,4,34,7,27,15,1
238943,2,14,6,8,4,1
135718,4,17,29,-12,10,1
55550,2,17,7,10,9,0
225439,1,0,0,0,15,1
117096,4,7,24,-17,2,1
23019,2,0,14,-14,11,1
223184,1,3,0,3,15,0
149268,3,10,20,-10,16,1
230658,1,0,7,-7,1,1
299077,1,3,3,0,14,1
394869,2,0,14,-14,5,1
311480,2,10,3,7,2,1
69673,1,0,7,-7,15,1
221640,4,23,21,2,14,0
364209,1,0,0,0,9,1
345981,1,0,0,0,1,1
409389,2,13,3,10,12,1
411651,4,26,28,-2,13,1
341546,3,13,10,3,16,0
5604,1,0,0,0,3,0
101723,3,10,7,3,12,1
58417,3,34,10,24,10,1
216836,2,7,7,0,12,1
193128,4,13,6,7,1,1
1266,3,17,13,4,1,1
192567,1,0,0,0,1,1
9301,2,7,0,7,5,0
183855,4,34,28,6,14,1
411914,2,17,3,14,13,0
19603,3,17,21,-4,10,1
307128,1,0,0,0,17,0
142686,4,20,20,0,13,0
34928,4,27,24,3,16,0
290077,3,10,6,4,10,0
359966,1,0,6,-6,7,1
313731,2,14,3,11,3,1
147882,3,3,31,-28,15,1
38428,4,31,16,15,1,0
197465,3,13,9,4,3,1
73004,1,0,0,0,16,0
172049,2,7,0,7,9,0
356452,1,0,3,-3,5,1
120457,4,19,19,0,3,0
109244,2,6,0,6,15,0
271416,2,7,0,7,1,1
96142,2,0,16,-16,10,0
147499,1,0,0,0,15,0
87038,4,14,22,-8,5,0
352950,2,13,0,13,3,1
209913,4,30,16,14,8,1
302722,4,26,20,6,15,0
250996,4,3,6,-3,10,1
311686,4,6,9,-3,2,0
132140,3,10,3,7,9,0
295650,1,0,0,0,12,1
182916,2,0,30,-30,14,0
229442,4,10,6,4,17,0
345952,4,27,23,4,17,0
106818,4,34,28,6,14,0
345057,1,0,0,0,17,0
354874,4,33,42,-9,4,1
24357,2,3,0,3,12,1
148751,2,13,3,10,16,0
5328,1,7,0,7,3,1
32847,3,6,7,-1,15,1
110006,3,20,10,10,16,0
415806,4,27,31,-4,15,1
78563,2,13,7,6,2,1
271331,4,16,24,-8,1,0
308781,1,0,0,0,1,0
305890,4,14,14,0,17,0
354860,4,33,42,-9,4,1
249657,1,3,7,-4,9,1
157572,2,5,0,5,2,1
168330,3,17,24,-7,7,0
211610,1,0,3,-3,9,1
25772,5,17,17,0,12,0
25349,1,3,0,3,12,1
10305,1,7,14,-7,5,0
301837,1,0,0,0,15,1
54247,4,0,3,-3,8,1
173652,4,13,20,-7,10,1
113625,3,6,13,-7,17,1
197804,1,0,0,0,3,1
357629,5,16,16,0,5,1
263247,4,17,23,-6,15,1
285115,3,3,0,3,7,0
349193,4,27,14,13,2,0
65375,4,13,28,-15,13,0
154528,1,0,0,0,1,0
28393,3,13,3,10,14,0
421597,4,16,9,7,17,1
130511,3,10,6,4,8,1
282485,2,7,0,7,6,0
366911,4,3,16,-13,10,1
358576,2,13,9,4,6,1
86070,1,14,0,14,5,1
328578,2,10,7,3,10,0
32740,4,7,24,-17,15,0
5137,4,13,7,6,3,1
205765,1,7,0,7,7,0
1486,1,0,6,-6,1,1
91997,3,20,23,-3,8,0
56098,2,14,7,7,9,1
195449,4,24,10,14,2,0
336652,5,7,7,0,14,1
133668,4,23,35,-12,9,1
280796,1,0,0,0,6,1
129686,2,7,3,4,7,0
57633,2,10,3,7,10,1
41158,2,0,7,-7,2,1
238622,1,6,0,6,4,1
107266,1,0,0,0,15,1
80673,3,17,19,-2,3,0
403641,3,24,20,4,9,1
126220,3,21,6,15,6,0
176865,4,17,16,1,11,0
334739,3,25,9,16,13,0
17124,4,23,17,6,9,1
25173,4,20,3,17,12,0
128855,4,20,16,4,7,1
51311,2,9,17,-8,7,1
250058,4,17,13,4,9,1
194062,4,27,7,20,1,0
44063,1,0,3,-3,3,0
193508,1,0,0,0,1,1
109366,1,0,7,-7,16,1
313383,1,7,0,7,3,0
275069,4,34,20,14,3,1
218820,1,0,3,-3,13,0
110021,3,27,10,17,16,0
381319,1,6,0,6,16,0
176650,2,14,12,2,11,0
358552,2,10,3,7,6,1
148539,4,24,10,14,16,1
100299,1,6,7,-1,12,0
267854,3,26,17,9,17,1
416095,4,21,13,8,15,1
93230,4,3,27,-24,9,1
317008,2,0,10,-10,4,1
180802,4,10,20,-10,13,0
207041,3,35,3,32,7,1
322701,5,9,9,0,7,0
169420,4,6,31,-25,8,1
354894,5,41,42,-1,4,1
348731,4,24,10,14,2,0
38957,2,23,0,23,1,0
205725,4,27,19,8,7,0
110076,1,0,0,0,16,1
146287,4,10,30,-20,15,0
169252,4,20,6,14,7,1
355419,2,13,10,3,4,1
89637,1,3,3,0,7,0
376952,2,3,13,-10,15,0
230976,1,0,0,0,1,0
204199,4,24,20,4,6,0
255851,4,20,0,20,12,0
206297,4,10,6,4,7,0
272378,2,21,0,21,2,1
297258,3,21,6,15,13,1
367286,3,3,17,-14,10,1
330407,3,13,20,-7,11,1
203394,4,27,33,-6,6,1
236998,4,45,7,38,3,1
30386,1,0,13,-13,14,1
262776,4,28,17,11,15,1
185290,4,33,22,11,15,1
405584,2,14,14,0,10,0
397061,4,21,9,12,6,0
312325,1,7,14,-7,3,0
135311,1,0,0,0,10,0
411070,4,17,17,0,13,1
330619,1,0,0,0,11,1
333145,1,0,0,0,12,0
361482,2,7,0,7,7,0
136839,1,0,0,0,11,1
178309,2,7,3,4,12,1
38439,4,31,16,15,1,1
259960,4,20,20,0,14,0
335299,3,3,9,-6,13,0
331056,4,52,17,35,11,0
272532,2,7,3,4,2,1
211827,2,22,10,12,9,0
120022,4,23,38,-15,3,1
354997,3,7,19,-12,4,1
307480,3,35,13,22,17,0
71110,1,6,0,6,16,0
376009,4,26,21,5,14,0
180136,2,7,0,7,13,0
199249,3,17,24,-7,4,1
109908,4,23,0,23,16,0
264778,3,10,23,-13,16,1
86809,1,6,6,0,5,1
144536,2,7,10,-3,14,1
358257,2,0,14,-14,6,1
130298,1,7,0,7,8,0
181112,3,24,7,17,13,0
222101,4,34,17,17,14,0
303398,1,10,0,10,16,0
252615,2,3,3,0,10,1
101463,4,25,13,12,12,0
279685,2,23,3,20,5,1
89002,4,39,10,29,6,0
378580,3,17,13,4,15,1
215764,2,29,3,26,11,0
223819,2,9,0,9,15,1
268433,2,14,3,11,17,0
42964,4,31,23,8,3,1
90716,2,7,0,7,7,1
160499,3,20,7,13,4,0
234321,2,10,0,10,2,1
377204,1,0,0,0,15,0
362724,4,6,20,-14,8,1
87582,3,17,3,14,6,0
16050,2,16,0,16,8,1
213524,2,10,14,-4,10,0
89411,3,10,20,-10,7,0
162121,4,51,13,38,4,0
85370,4,28,10,18,5,1
104724,1,3,13,-10,14,1
36233,3,10,24,-14,17,1
132049,4,3,24,-21,8,1
144593,3,14,19,-5,14,1
1601,4,16,20,-4,1,0
336002,3,13,18,-5,13,1
282427,4,10,26,-16,6,0
255494,2,10,7,3,12,1
229525,2,17,6,11,17,0
172717,3,14,10,4,9,0
90356,4,14,32,-18,7,1
70868,2,7,17,-10,15,1
324117,2,0,7,-7,8,0
392479,2,3,16,-13,4,0
302674,3,17,13,4,15,0
248705,1,3,0,3,9,0
19414,2,14,7,7,10,1
108140,4,13,42,-29,15,1
385943,3,10,21,-11,1,1
63579,2,13,7,6,12,0
118002,3,20,6,14,2,0
198716,1,0,0,0,3,0
414409,2,7,20,-13,14,1
132932,4,13,21,-8,9,0
3259,2,3,0,3,2,1
346433,4,15,19,-4,1,0
4608,2,10,7,3,2,0
355012,4,10,19,-9,4,0
128260,4,20,7,13,7,0
357714,3,33,13,20,5,0
27443,1,3,0,3,13,1
22418,2,10,24,-14,11,1
32306,4,30,36,-6,15,1
220414,3,23,14,9,13,1
283052,1,0,0,0,7,0
173869,1,6,7,-1,10,1
510,2,7,6,1,1,1
380446,4,10,24,-14,16,1
340812,3,24,16,8,15,0
291375,1,7,7,0,10,1
208207,4,3,10,-7,8,1
133836,4,19,24,-5,9,0
580,4,14,34,-20,1,1
53511,2,7,3,4,8,1
371464,3,14,17,-3,12,1
136611,3,15,16,-1,11,1
418518,1,0,0,0,16,1
230863,2,7,7,0,1,0
320991,2,7,0,7,6,0
316126,3,24,16,8,4,0
7288,4,17,13,4,4,1
347298,3,7,7,0,1,0
371071,4,13,20,-7,12,1
415937,4,10,30,-20,15,1
304615,2,14,7,7,16,0
235897,3,7,14,-7,3,1
262766,3,28,10,18,15,1
336456,3,10,17,-7,14,0
314560,4,27,10,17,3,0
366935,1,0,7,-7,10,0
399966,4,12,13,-1,8,1
131335,1,7,0,7,8,0
81548,2,7,21,-14,3,1
411817,4,0,34,-34,13,1
184452,4,31,13,18,14,1
201384,4,28,22,6,5,1
225597,2,0,7,-7,16,0
392878,4,24,23,1,4,0
21958,1,7,0,7,11,0
192361,4,27,27,0,1,0
77842,3,14,21,-7,1,1
85271,1,0,0,0,5,0
273420,1,0,0,0,2,0
241152,4,20,10,10,5,1
243533,1,3,0,3,6,0
366588,4,20,14,6,10,1
352451,4,38,24,14,3,0
258835,2,7,7,0,13,0
180326,2,9,7,2,13,1
67047,3,10,6,4,14,1
74548,3,0,3,-3,17,1
10498,2,13,0,13,5,1
1475,1,0,3,-3,1,1
231906,3,7,34,-27,1,0
83370,2,7,14,-7,4,1
33315,1,0,0,0,16,1
363595,4,10,15,-5,8,0
4281,4,27,6,21,2,1
394759,2,14,0,14,5,1
156875,4,30,29,1,2,1
156941,2,7,10,-3,2,1
170912,3,14,20,-6,8,1
311355,3,21,10,11,2,0
160724,4,10,3,7,4,0
258390,2,14,6,8,13,0
180929,2,10,7,3,13,1
283785,4,18,3,15,7,1
271906,3,10,13,-3,2,1
353189,4,27,29,-2,3,0
400283,4,24,9,15,8,0
67289,1,13,0,13,14,1
393005,4,12,10,2,4,1
227113,1,0,0,0,16,0
217805,1,0,0,0,12,0
28188,2,3,0,3,13,1
289352,3,28,17,11,9,0
76013,2,7,13,-6,1,1
195287,4,23,24,-1,2,1
255617,2,0,7,-7,12,1
402826,1,7,0,7,9,0
259234,4,28,32,-4,13,0
141280,4,10,24,-14,13,0
108743,4,44,19,25,15,1
249277,4,33,14,19,9,0
113608,3,6,3,3,17,0
119618,3,10,9,1,3,1
368068,1,0,0,0,11,1
206582,3,10,13,-3,7,0
202147,3,13,3,10,5,1
388222,4,6,13,-7,2,1
265869,1,0,9,-9,16,0
348112,4,10,19,-9,1,0
99886,2,0,3,-3,12,0
190874,4,27,17,10,17,1
264016,1,0,0,0,15,1
298157,4,10,41,-31,13,0
225971,3,34,20,14,16,0
283751,3,11,3,8,7,0
353968,5,34,31,3,4,0
145534,4,26,17,9,14,0
144473,4,17,33,-16,14,0
122045,4,19,13,6,4,0
298476,1,7,0,7,14,1
358917,4,12,35,-23,6,1
240794,3,10,10,0,5,1
420023,3,10,13,-3,17,0
114463,1,3,10,-7,1,1
116235,1,3,0,3,1,1
16706,4,21,33,-12,8,1
219707,4,13,14,-1,13,0
36204,2,10,17,-7,17,1
48201,1,0,0,0,5,1
122205,1,0,7,-7,4,1
282679,3,6,17,-11,6,1
326662,3,16,6,10,9,0
98935,4,7,17,-10,11,0
372949,4,25,7,18,13,1
154682,1,0,0,0,1,1
41352,3,14,12,2,2,1
244672,3,7,23,-16,7,0
244845,3,7,10,-3,7,1
381457,4,26,14,12,16,1
204542,1,0,14,-14,6,0
298234,2,20,3,17,14,0
39160,4,20,10,10,1,0
13403,1,3,7,-4,7,0
5219,2,14,17,-3,3,1
231060,4,24,8,16,1,1
109909,4,23,0,23,16,0
176679,3,29,12,17,11,0
27165,2,6,7,-1,13,1
396842,2,17,7,10,6,0
257938,1,0,0,0,13,0
354413,1,0,0,0,4,1
352663,2,7,0,7,3,0
19728,2,6,6,0,10,1
251471,1,16,3,13,10,0
270740,3,6,3,3,1,1
45196,4,7,10,-3,4,1
162150,1,0,0,0,4,1
148934,2,3,9,-6,16,0
111379,2,0,13,-13,16,0
131698,3,10,22,-12,8,1
133537,1,0,0,0,9,1
196076,2,3,21,-18,2,1
363244,2,21,7,14,8,0
413107,3,27,28,-1,14,1
234350,3,17,3,14,2,1
292597,2,6,16,-10,11,1
272284,4,12,10,2,2,0
149418,3,13,27,-14,16,1
328523,4,15,3,12,10,0
111316,1,0,6,-6,16,0
19694,2,3,6,-3,10,0
38749,1,0,3,-3,1,0
186870,1,7,0,7,15,0
71001,2,10,0,10,16,0
160287,2,3,0,3,4,1
407289,3,17,16,1,11,1
157774,4,17,10,7,2,1
179682,1,0,0,0,12,0
141198,2,3,21,-18,13,0
338586,4,36,38,-2,14,0
248466,3,10,6,4,8,1
405603,3,14,20,-6,10,1
139525,2,6,0,6,12,0
196918,1,0,0,0,3,1
306035,3,10,10,0,17,0
214608,3,3,9,-6,11,0
1312,4,38,23,15,1,0
183591,1,0,0,0,14,1
364594,3,15,34,-19,9,1
193837,2,17,0,17,1,0
169474,1,0,14,-14,8,1
108858,3,7,17,-10,15,0
95384,2,20,0,20,10,1
172591,4,17,24,-7,9,1
166800,4,30,16,14,6,0
37283,4,13,21,-8,17,0
222233,4,13,24,-11,14,1
245035,4,14,27,-13,7,0
136888,2,0,10,-10,11,0
257023,2,0,14,-14,12,1
365551,2,14,14,0,9,1
31804,3,13,17,-4,15,1
34568,2,14,0,14,16,1
396445,3,20,25,-5,6,1
254928,3,31,7,24,12,0
92356,1,7,0,7,8,0
389344,2,20,6,14,3,1
385048,4,24,24,0,1,1
237500,2,17,7,10,3,0
250477,2,13,7,6,9,1
364961,1,7,0,7,9,0
58347,1,7,0,7,10,1
239253,2,0,7,-7,4,0
103013,1,0,0,0,13,0
196777,1,0,7,-7,3,1
231829,4,33,26,7,1,0
13631,3,13,10,3,7,1
277518,2,3,7,-4,4,0
337800,3,23,6,17,14,1
13442,2,3,14,-11,7,0
181775,4,7,17,-10,13,1
265680,4,12,18,-6,16,0
333939,2,7,7,0,12,0
93640,4,23,6,17,9,0
161099,2,3,15,-12,4,0
374033,4,17,10,7,13,0
285390,2,10,0,10,8,1
329992,4,7,10,-3,11,0
32605,4,27,13,14,15,1
384493,4,28,6,22,1,0
115984,2,10,0,10,1,1
146338,1,3,3,0,15,1
91374,4,21,7,14,8,1
60073,2,7,3,4,11,0
238925,1,7,3,4,4,1
207182,3,14,13,1,7,0
291827,1,0,0,0,11,0
225067,3,10,14,-4,15,0
230482,4,28,14,14,1,1
251424,4,46,14,32,10,0
32832,3,6,7,-1,15,1
260007,1,0,0,0,14,1
6314,4,19,25,-6,3,1
370009,2,10,7,3,12,1
186831,4,29,14,15,15,1
403494,3,17,12,5,9,1
197524,1,0,0,0,3,0
64874,3,10,3,7,13,1
109901,4,23,0,23,16,1
195701,3,14,13,1,2,1
47139,1,3,0,3,5,1
108416,3,6,21,-15,15,1
284128,1,0,3,-3,7,0
327278,3,9,20,-11,9,1
183012,4,10,44,-34,14,0
313906,3,28,26,2,3,1
209331,2,7,7,0,8,0
340893,2,0,10,-10,15,1
360744,2,17,14,3,7,0
99665,4,26,3,23,11,0
7137,3,31,21,10,4,1
863,4,14,12,2,1,1
356181,3,19,0,19,5,1
418671,1,0,0,0,16,1
233553,2,7,14,-7,2,1
133306,2,7,0,7,9,0
221426,3,3,24,-21,14,1
61444,4,16,17,-1,11,1
144264,3,15,7,8,14,1
12281,3,6,6,0,6,1
200425,2,10,18,-8,4,0
237722,4,20,17,3,4,1
214285,3,14,10,4,11,0
215494,3,10,3,7,11,1
332844,1,7,0,7,12,0
63217,4,17,23,-6,12,0
298959,2,6,9,-3,14,1
118807,2,13,0,13,2,0
327709,3,6,10,-4,10,0
287927,2,14,10,4,9,0
381586,4,42,16,26,17,1
170328,4,0,15,-15,8,1
220205,1,10,0,10,13,0
134791,3,34,17,17,10,1
100453,1,0,7,-7,12,1
371110,1,0,0,0,12,0
153875,3,7,3,4,1,0
281255,1,0,0,0,6,1
303843,1,0,0,0,16,0
127237,5,16,16,0,6,0
23550,4,17,17,0,11,0
281323,2,14,13,1,6,1
52781,1,0,23,-23,7,1
222138,1,0,0,0,14,1
341072,3,7,17,-10,15,1
337883,1,10,0,10,14,1
391032,4,27,34,-7,4,1
34273,3,17,9,8,16,1
76681,4,13,7,6,1,1
252740,1,0,3,-3,11,1
55091,3,16,3,13,8,1
130568,4,13,13,0,8,0
104668,4,7,3,4,14,1
369603,4,20,6,14,11,0
417206,2,10,17,-7,16,1
77805,2,7,14,-7,1,1
137477,1,7,0,7,11,0
128354,3,7,3,4,7,1
272130,4,23,9,14,2,1
171953,3,14,14,0,9,0
345206,1,7,7,0,17,0
212734,2,3,14,-11,10,1
217111,2,0,7,-7,12,0
138180,2,7,9,-2,11,1
418821,1,0,3,-3,16,1
119020,4,7,26,-19,3,0
383401,3,3,9,-6,17,1
403336,3,12,0,12,9,0
360382,1,0,0,0,7,1
31167,2,23,20,3,15,1
310420,2,14,0,14,2,0
213720,4,24,17,7,10,1
199337,1,0,0,0,4,0
360050,3,3,33,-30,7,1
325708,1,0,0,0,9,1
367687,2,0,6,-6,10,0
320952,1,0,0,0,6,1
269941,2,13,10,3,1,1
411407,1,0,0,0,13,0
133619,3,10,7,3,9,0
285484,4,36,8,28,8,0
10974,3,9,28,-19,5,1
389310,2,6,6,0,3,1
354543,4,33,31,2,4,1
67391,4,30,13,17,14,1
203256,4,17,27,-10,5,1
217568,2,3,9,-6,12,1
372417,2,6,7,-1,13,0
368407,2,14,7,7,11,0
395218,2,10,13,-3,5,0
32867,3,6,7,-1,15,1
94925,1,0,3,-3,9,1
412105,4,31,3,28,13,1
97693,3,9,10,-1,11,1
408131,1,3,0,3,12,0
172961,1,7,0,7,9,1
407445,3,14,10,4,11,0
415415,2,9,0,9,15,1
262453,3,7,21,-14,15,1
60171,1,0,0,0,11,1
185325,4,48,30,18,15,0
408967,3,31,24,7,12,1
407949,4,17,24,-7,11,0
370569,2,14,7,7,12,1
345100,2,9,3,6,17,1
335981,2,7,15,-8,13,1
109096,2,7,0,7,15,0
136744,2,13,10,3,11,1
159869,2,17,0,17,3,0
106498,4,35,9,26,14,1
130190,2,0,19,-19,8,1
114968,2,7,12,-5,1,1
114072,2,21,0,21,17,0
88735,1,3,3,0,6,0
187358,2,14,7,7,16,1
348444,4,13,32,-19,1,1
390581,4,17,21,-4,3,0
104730,1,3,13,-10,14,1
24970,2,10,14,-4,12,0
86454,3,30,14,16,5,0
65800,4,27,33,-6,13,1
153333,4,2,16,-14,1,0
349285,2,13,21,-8,2,0
67822,1,0,3,-3,14,0
256292,3,14,17,-3,12,0
91815,3,17,0,17,8,1
312262,4,10,23,-13,2,1
363180,4,24,10,14,8,0
380452,4,10,24,-14,16,0
316831,4,16,10,6,4,0
357905,4,13,34,-21,6,0
356799,2,0,0,0,5,0
338362,2,3,0,3,14,0
152434,4,38,3,35,17,0
229150,4,19,7,12,17,1
176655,2,20,12,8,11,0
195992,4,7,27,-20,2,0
171152,2,3,0,3,8,0
320440,3,17,10,7,6,0
416751,2,7,6,1,15,0
334639,1,0,0,0,13,0
285112,3,3,0,3,7,1
337619,2,14,7,7,14,0
150508,4,41,6,35,16,0
391399,2,10,10,0,4,0
39087,2,13,0,13,1,0
261790,1,0,7,-7,14,1
384043,4,20,29,-9,1,0
219449,2,0,6,-6,13,0
17366,2,17,0,17,9,1
252076,4,14,30,-16,10,1
75527,1,7,0,7,17,0
268366,4,20,6,14,17,1
324177,4,3,17,-14,8,0
375287,1,7,0,7,14,0
177066,1,3,3,0,11,0
3274,2,3,0,3,2,0
27723,1,0,0,0,13,1
280664,1,0,3,-3,5,0
380695,3,7,7,0,16,1
160850,4,34,24,10,4,1
383541,3,14,13,1,17,1
279231,2,13,13,0,5,1
371276,1,0,10,-10,12,1
313384,1,7,0,7,3,1
308803,1,0,3,-3,1,1
167004,2,0,14,-14,7,1
199018,1,0,0,0,4,0
61394,2,13,3,10,11,0
98121,2,14,10,4,11,1
50455,3,10,10,0,6,0
308847,3,10,10,0,1,0
20315,2,10,10,0,10,1
133847,1,0,0,0,9,0
383832,3,3,7,-4,1,0
324422,3,14,3,11,8,1
350598,2,10,0,10,2,0
215595,2,14,3,11,11,0
196429,3,20,7,13,2,0
186747,1,14,0,14,15,0
402368,1,0,7,-7,9,1
271989,1,0,0,0,2,0
337391,4,21,14,7,14,0
93658,4,23,13,10,9,0
401127,3,27,13,14,8,1
195316,1,0,0,0,2,1
340202,3,23,21,2,15,0
73236,3,7,16,-9,16,1
121305,1,0,0,0,3,0
130035,2,10,20,-10,8,0
54872,4,26,3,23,8,1
239921,4,13,9,4,4,0
339157,4,20,13,7,15,0
90014,3,5,21,-16,7,0
376284,4,17,14,3,14,0
378408,2,7,0,7,15,1
85098,4,31,16,15,4,0
118836,3,20,7,13,2,1
93128,1,0,0,0,9,1
203384,4,27,33,-6,6,0
70665,4,17,22,-5,15,1
337303,1,7,7,0,14,0
1281,4,17,16,1,1,1
183507,1,7,0,7,14,0
79563,2,0,0,0,2,1
93933,4,24,9,15,9,0
321242,1,3,0,3,6,0
44309,4,24,20,4,3,0
266587,1,0,0,0,16,1
315294,5,20,19,1,4,0
387658,1,0,7,-7,2,0
29187,4,3,26,-23,14,1
264936,3,20,17,3,16,1
363703,3,8,13,-5,8,0
380704,4,7,7,0,16,0
141903,4,27,21,6,13,0
293889,1,0,7,-7,12,0
336186,4,17,10,7,13,1
212783,3,10,21,-11,10,1
89992,3,5,14,-9,7,0
188238,2,7,7,0,16,0
287465,2,7,13,-6,9,1
274140,4,27,0,27,3,0
327970,2,7,0,7,10,1
306651,4,14,27,-13,17,1
282121,3,16,8,8,6,1
296241,4,28,26,2,13,0
218319,3,17,14,3,12,0
199201,2,10,7,3,4,1
120730,3,23,0,23,3,1
179155,4,12,13,-1,12,0
301333,3,17,7,10,15,1
130330,2,7,0,7,8,1
316198,1,0,0,0,4,1
410730,3,17,6,11,13,1
19943,1,0,0,0,10,0
125528,4,30,7,23,5,0
67758,3,21,0,21,14,1
258868,3,14,14,0,13,1
62178,4,10,17,-7,12,0
222853,4,24,13,11,14,1
217865,2,10,21,-11,12,1
97421,4,16,23,-7,10,0
347413,1,0,6,-6,1,1
126393,4,20,14,6,6,0
242561,1,3,0,3,6,1
127691,4,37,26,11,6,0
339262,2,21,0,21,15,0
19764,4,9,12,-3,10,1
185069,2,0,3,-3,15,1
83049,2,6,14,-8,4,1
82560,1,0,0,0,3,0
176547,4,12,17,-5,11,1
198866,1,0,6,-6,3,1
395629,2,7,17,-10,6,1
43219,3,14,10,4,3,1
91842,4,24,13,11,8,1
391536,2,10,21,-11,4,0
120238,2,7,3,4,3,1
59711,1,0,0,0,11,0
307009,2,10,0,10,17,0
45403,1,7,0,7,4,0
260817,3,22,12,10,14,0
225645,3,7,10,-3,16,1
201389,4,28,22,6,5,0
359255,1,0,0,0,6,0
220837,3,7,21,-14,14,1
5908,2,0,9,-9,3,0
85355,3,28,3,25,5,0
76453,1,0,7,-7,1,1
48362,1,0,7,-7,5,0
106110,2,0,0,0,14,1
23,1,0,0,0,1,1
311253,4,6,0,6,2,0
258241,1,7,0,7,13,0
73516,3,3,31,-28,17,0
6936,2,0,0,0,3,0
245325,4,16,13,3,7,1
395735,4,26,37,-11,6,1
152712,4,27,13,14,17,1
151885,2,13,0,13,17,1
307405,1,0,0,0,17,1
5413,4,20,16,4,3,1
343759,1,7,3,4,17,1
59361,3,0,9,-9,11,0
360533,1,0,7,-7,7,0
242609,2,10,0,10,6,0
84964,1,6,7,-1,4,1
317360,2,0,0,0,5,0
232545,4,20,17,3,1,1
305408,3,20,3,17,17,1
312669,2,27,7,20,3,1
348879,3,6,14,-8,2,1
41596,1,7,0,7,2,0
222603,1,7,0,7,14,0
216641,2,7,3,4,12,0
103655,2,0,7,-7,13,0
340494,2,0,27,-27,15,1
140268,1,7,0,7,12,0
5607,1,0,6,-6,3,0
219229,4,13,3,10,13,1
192364,4,27,27,0,1,0
2691,3,6,7,-1,2,0
298311,4,20,13,7,14,0
136942,3,3,13,-10,11,1
78094,1,7,3,4,2,0
136675,1,0,0,0,11,0
189683,4,20,6,14,17,0
420510,3,3,35,-32,17,0
277737,3,7,3,4,4,0
249472,1,0,0,0,9,0
412477,2,10,7,3,14,1
354142,1,0,0,0,4,0
241787,1,0,0,0,5,0
336250,2,10,0,10,13,0
94187,3,17,7,10,9,0
133443,2,14,14,0,9,0
26525,1,3,0,3,13,0
271115,2,0,10,-10,1,1
401020,4,29,15,14,8,0
348522,2,28,7,21,2,0
186640,3,24,3,21,15,0
233878,2,14,6,8,2,0
194739,2,0,10,-10,2,1
356898,1,0,0,0,5,1
104726,1,3,13,-10,14,1
166499,4,23,17,6,6,0
266802,3,10,14,-4,16,0
159129,4,31,7,24,3,0
418959,1,7,7,0,16,1
8106,4,24,20,4,4,1
208711,1,0,0,0,8,1
65911,3,17,14,3,13,0
47419,5,13,13,0,5,0
208686,4,9,6,3,8,0
40,2,0,0,0,1,1
335046,4,16,13,3,13,0
347054,4,27,17,10,1,0
18154,3,13,17,-4,9,0
229987,2,0,3,-3,17,0
294761,1,0,7,-7,12,0
284320,2,6,10,-4,7,1
13918,3,21,7,14,7,1
174931,2,3,7,-4,10,0
350078,4,27,13,14,2,1
168276,2,10,7,3,7,1
295914,3,13,17,-4,12,0
2979,2,10,10,0,2,0
95189,4,23,30,-7,9,1
379939,4,21,6,15,16,0
108370,2,0,14,-14,15,0
26442,3,20,16,4,13,1
140778,3,22,21,1,12,0
401557,2,14,14,0,8,1
273034,3,6,3,3,2,0
354747,1,6,3,3,4,1
220954,2,7,7,0,14,0
75322,4,14,26,-12,17,0
25395,2,6,3,3,12,0
332984,1,0,0,0,12,0
284119,1,0,3,-3,7,0
384973,2,14,6,8,1,1
387859,2,10,28,-18,2,1
44941,4,14,38,-24,4,1
14684,4,33,21,12,7,1
62358,1,0,0,0,12,0
182885,1,0,3,-3,14,0
264785,3,17,23,-6,16,0
356902,1,3,0,3,5,1
92765,4,6,17,-11,8,1
401751,4,24,14,10,8,1
68900,4,13,27,-14,15,1
375424,1,0,7,-7,14,1
287316,2,6,0,6,8,0
9756,2,2,7,-5,5,1
386557,4,14,24,-10,2,0
92630,4,17,10,7,8,1
204531,1,0,7,-7,6,0
392486,2,3,17,-14,4,1
274960,1,0,0,0,3,1
329259,4,31,13,18,10,0
157840,1,6,9,-3,3,0
47289,1,0,7,-7,5,0
185056,1,0,3,-3,15,0
203844,4,30,31,-1,6,1
133287,2,7,0,7,9,0
88255,1,0,0,0,6,1
28241,3,17,0,17,13,1
158916,2,14,3,11,3,1
78329,4,24,21,3,2,0
206430,3,10,0,10,7,1
45500,4,27,23,4,4,0
184941,2,0,17,-17,15,1
161818,4,37,13,24,4,0
215797,3,32,6,26,11,0
197391,1,7,0,7,3,1
271168,3,7,17,-10,1,1
159761,3,7,13,-6,3,0
52076,3,13,10,3,7,0
101138,4,19,24,-5,12,1
393042,1,0,3,-3,4,1
368575,3,9,0,9,11,1
96395,1,0,0,0,10,0
295067,1,0,0,0,12,0
364017,4,6,12,-6,8,0
170728,3,21,6,15,8,0
231108,1,3,0,3,1,0
384943,1,0,0,0,1,1
280318,4,16,22,-6,5,1
226542,1,0,0,0,16,1
155483,1,7,0,7,2,1
155162,1,7,0,7,1,1
309002,3,0,17,-17,1,0
260841,3,29,15,14,14,1
379876,2,14,0,14,16,1
348267,4,16,46,-30,1,1
98261,2,7,24,-17,11,1
186971,4,10,12,-2,15,0
157050,1,0,0,0,2,0
37176,1,0,7,-7,17,1
8766,2,6,0,6,4,0
365073,1,0,0,0,9,0
107666,4,13,29,-16,15,0
222969,3,13,13,0,14,1
150832,1,0,0,0,17,1
238535,3,16,13,3,4,0
138648,2,3,28,-25,12,1
131370,2,7,13,-6,8,1
342381,2,0,3,-3,16,1
358502,1,0,0,0,6,1
150621,3,10,16,-6,17,0
37060,2,13,7,6,17,1
181870,3,21,14,7,13,0
302561,4,3,16,-13,15,0
319488,3,3,10,-7,6,1
191805,1,3,7,-4,1,1
407536,2,10,0,10,11,0
258915,4,20,32,-12,13,1
171063,3,17,30,-13,8,0
130366,3,7,3,4,8,1
261730,3,14,7,7,14,0
90626,3,17,27,-10,7,0
111162,1,0,0,0,16,1
283147,3,13,9,4,7,0
370163,3,17,3,14,12,0
191756,4,16,23,-7,17,0
416243,4,10,39,-29,15,0
387800,1,3,0,3,2,1
18755,3,13,10,3,9,1
394652,4,17,21,-4,5,0
218337,4,17,23,-6,12,0
176853,3,17,13,4,11,1
5940,3,14,23,-9,3,1
241495,1,0,0,0,5,0
407388,2,0,7,-7,11,1
171264,1,0,0,0,9,0
188853,2,3,0,3,16,0
74946,2,17,7,10,17,0
352623,1,0,0,0,3,1
367825,2,10,7,3,10,0
235218,2,12,0,12,3,0
97190,2,3,6,-3,10,0
295500,1,7,6,1,12,0
152259,4,21,0,21,17,1
278887,1,0,0,0,5,0
68529,3,7,28,-21,14,1
388335,3,17,6,11,2,1
412273,1,0,0,0,13,1
370131,2,10,3,7,12,1
346655,2,14,6,8,1,1
399212,3,13,13,0,7,0
327154,3,21,17,4,9,0
255722,4,3,20,-17,12,1
241416,3,7,28,-21,5,0
112913,4,16,6,10,17,0
266266,4,38,19,19,16,1
305337,1,0,0,0,17,1
320786,4,17,23,-6,6,0
143946,2,0,10,-10,14,1
63031,3,16,21,-5,12,1
106942,3,12,3,9,14,0
290295,4,17,15,2,10,0
352624,1,0,0,0,3,1
41503,3,8,7,1,2,1
7763,3,30,3,27,4,0
401320,4,27,24,3,8,0
182121,2,16,0,16,13,0
281729,4,38,38,0,6,1
126331,2,7,7,0,6,1
56217,1,3,0,3,9,0
118501,1,14,0,14,2,0
271958,4,23,20,3,2,0
416405,4,16,20,-4,15,1
390432,4,14,27,-13,3,1
266286,1,0,0,0,16,0
240929,2,14,6,8,5,0
62632,3,9,17,-8,12,1
390282,4,17,13,4,3,1
282952,2,7,3,4,6,1
25347,1,0,0,0,12,1
324387,2,7,3,4,8,0
305351,1,7,0,7,17,0
351362,2,10,7,3,3,1
99561,1,0,0,0,11,0
221708,2,10,0,10,14,0
92436,3,17,10,7,8,1
107636,3,13,20,-7,15,1
141626,1,10,7,3,13,0
121408,4,7,12,-5,3,1
298816,2,14,9,5,14,1
14120,1,0,13,-13,7,0
230072,4,19,6,13,17,1
314213,3,14,20,-6,3,0
128909,2,15,3,12,7,0
104085,2,10,13,-3,13,0
219151,2,0,3,-3,13,0
295476,1,0,0,0,12,0
292855,1,7,0,7,11,1
77546,3,20,14,6,1,1
396618,4,20,10,10,6,1
394402,1,0,0,0,5,0
367167,3,29,23,6,10,0
43218,3,14,10,4,3,1
351564,4,0,27,-27,3,1
322772,2,3,20,-17,7,1
189904,2,0,7,-7,17,0
333496,2,6,0,6,12,0
197280,2,0,0,0,3,1
257478,2,6,3,3,13,0
392637,2,7,0,7,4,1
281344,3,21,13,8,6,1
363116,3,7,3,4,8,1
339682,1,7,0,7,15,0
168646,4,17,16,1,7,1
313739,2,21,3,18,3,0
40818,4,24,35,-11,2,0
10671,4,10,17,-7,5,0
68547,3,10,28,-18,14,1
251530,2,16,13,3,10,1
406032,1,0,3,-3,11,1
87845,2,10,9,1,6,0
55228,2,7,0,7,9,0
381581,4,42,16,26,17,0
159528,2,7,6,1,3,1
14362,4,2,17,-15,7,1
383844,3,3,7,-4,1,1
105675,2,14,3,11,14,1
102259,1,7,0,7,13,0
200817,4,38,17,21,4,1
69275,2,13,0,13,15,0
144981,1,0,0,0,14,0
108247,3,6,0,6,15,1
92857,2,24,0,24,8,0
256856,1,0,3,-3,12,0
224300,2,9,12,-3,15,0
71553,1,3,0,3,16,1
24916,1,0,7,-7,12,1
125920,3,16,10,6,6,0
413036,4,22,21,1,14,1
164091,4,12,6,6,5,0
55524,2,10,0,10,9,0
210155,2,0,7,-7,9,0
410789,4,22,6,16,13,1
208970,4,20,21,-1,8,0
88513,4,19,14,5,6,0
110468,3,17,0,17,16,1
306404,1,0,10,-10,17,0
56274,3,3,17,-14,9,1
144916,4,20,7,13,14,1
253385,2,13,21,-8,11,1
83110,3,6,30,-24,4,1
4064,2,13,21,-8,2,1
53349,1,3,7,-4,8,1
177534,2,7,0,7,11,0
75878,2,14,7,7,1,1
283633,4,20,20,0,7,1
208221,4,3,10,-7,8,1
223554,3,10,13,-3,15,1
384395,1,14,0,14,1,0
398829,4,21,27,-6,7,0
30607,3,17,0,17,14,1
231279,1,3,3,0,1,0
302109,4,27,27,0,15,0
68083,3,3,10,-7,14,1
328402,1,0,0,0,10,1
263738,2,0,0,0,15,1
273452,2,7,3,4,2,0
29639,4,14,21,-7,14,0
51048,3,3,20,-17,6,1
245625,4,40,20,20,7,1
192674,4,13,7,6,1,0
116832,1,7,0,7,2,1
355612,3,24,10,14,5,1
22884,2,0,13,-13,11,1
165399,3,6,23,-17,6,0
8376,3,30,3,27,4,0
166369,1,3,0,3,6,0
68953,2,14,7,7,15,0
55403,2,13,7,6,9,0
34980,1,0,0,0,16,1
61072,1,0,0,0,11,1
362868,4,14,28,-14,8,0
201367,4,28,15,13,5,0
393055,1,0,3,-3,4,1
58224,2,0,3,-3,10,1
153078,2,0,10,-10,1,1
175408,3,17,6,11,11,0
92084,2,3,10,-7,8,0
69652,1,0,0,0,15,0
196329,1,7,0,7,2,0
163071,1,0,3,-3,5,0
65434,2,0,14,-14,13,1
201343,3,28,13,15,5,1
401609,4,24,31,-7,8,1
265439,1,0,6,-6,16,0
112249,2,14,10,4,17,1
298860,4,21,9,12,14,0
34319,4,20,9,11,16,1
236127,1,0,3,-3,3,0
217095,1,0,0,0,12,0
213405,3,10,34,-24,10,1
314325,2,7,17,-10,3,1
274902,3,14,16,-2,3,1
68841,3,6,17,-11,15,1
93972,1,0,7,-7,9,0
388049,4,20,6,14,2,0
64243,1,0,0,0,13,1
342988,1,0,0,0,16,0
272550,2,13,3,10,2,1
263015,2,10,0,10,15,1
313813,1,0,0,0,3,1
170403,2,14,3,11,8,1
342395,2,0,3,-3,16,1
30799,4,31,35,-4,15,1
288197,1,3,7,-4,9,1
23339,3,9,10,-1,11,1
77455,1,0,0,0,1,1
78420,2,14,0,14,2,1
408137,2,3,0,3,12,1
233951,4,24,13,11,2,0
133830,4,19,24,-5,9,1
365042,4,17,6,11,9,0
158903,1,14,0,14,3,1
337425,1,0,0,0,14,1
260147,1,0,0,0,14,1
166596,2,22,14,8,6,1
77445,4,27,21,6,1,0
343932,2,14,0,14,17,0
164817,4,26,21,5,6,0
131161,4,27,12,15,8,1
195758,1,0,0,0,2,1
1593,4,16,20,-4,1,0
275977,4,26,21,5,3,0
226362,4,25,13,12,16,0
128636,2,3,10,-7,7,1
297021,1,7,0,7,13,0
243185,5,23,22,1,6,0
290801,2,10,0,10,10,0
51328,3,16,17,-1,7,0
138585,1,0,0,0,12,1
417302,1,0,3,-3,16,1
12954,1,0,0,0,6,0
43348,2,14,7,7,3,0
57829,4,22,10,12,10,0
150840,1,0,0,0,17,0
244774,1,0,0,0,7,1
268794,3,31,10,21,17,1
345556,2,7,20,-13,17,0
18060,4,36,28,8,9,0
346194,2,17,0,17,1,1
174678,3,9,7,2,10,0
97488,2,13,0,13,10,1
419887,3,6,17,-11,17,0
144354,1,0,0,0,14,0
273438,2,0,0,0,2,0
339386,1,0,3,-3,15,0
184949,3,7,17,-10,15,0
172488,1,0,0,0,9,1
387423,3,21,16,5,2,1
115861,2,7,13,-6,1,1
238715,4,19,17,2,4,1
269166,1,0,3,-3,17,1
65732,2,7,16,-9,13,0
309834,2,14,7,7,1,0
153592,3,12,14,-2,1,0
419167,3,10,6,4,16,0
99790,3,0,13,-13,12,0
401251,2,7,14,-7,8,1
282377,3,10,13,-3,6,0
85556,4,17,22,-5,5,0
247008,4,20,31,-11,8,1
285627,4,20,24,-4,8,1
203173,2,7,17,-10,5,0
362689,4,3,10,-7,8,0
106429,2,13,0,13,14,1
25195,4,20,3,17,12,0
21489,4,15,17,-2,11,0
84834,1,0,3,-3,4,0
412964,3,16,12,4,14,1
197944,1,0,0,0,3,0
142611,2,13,3,10,13,0
1035,1,7,0,7,1,1
325857,4,13,20,-7,9,1
363292,3,27,7,20,8,0
244694,3,21,23,-2,7,0
12473,4,13,9,4,6,0
264757,3,10,16,-6,16,0
251140,4,10,20,-10,10,1
156583,1,0,0,0,2,0
242410,1,0,6,-6,6,0
410246,2,7,0,7,13,0
300391,4,10,7,3,14,1
10822,3,21,7,14,5,1
217612,3,19,9,10,12,0
274075,2,10,0,10,3,1
243946,4,25,13,12,6,0
248302,2,17,7,10,8,1
229408,2,3,3,0,17,1
109520,1,0,7,-7,16,1
99125,1,0,0,0,11,1
13581,2,3,7,-4,7,1
13311,3,7,20,-13,7,0
372616,2,7,6,1,13,1
112114,2,7,20,-13,17,0
191930,1,0,3,-3,1,0
206636,4,10,16,-6,7,1
117514,3,17,17,0,2,1
243700,1,14,3,11,6,0
74576,4,10,3,7,17,0
80892,1,3,0,3,3,1
357329,4,14,22,-8,5,1
749,1,0,0,0,1,0
405209,1,0,7,-7,10,0
348821,2,3,14,-11,2,1
197445,2,13,6,7,3,0
110321,3,3,17,-14,16,1
343836,3,21,3,18,17,1
69104,2,7,7,0,15,0
271038,4,18,28,-10,1,1
85828,3,13,13,0,5,1
285128,4,3,0,3,7,0
289557,1,0,6,-6,10,1
76733,1,0,0,0,1,1
382296,4,20,3,17,17,0
50560,2,0,6,-6,6,0
234317,2,10,0,10,2,1
389935,2,24,10,14,3,1
386469,1,0,0,0,2,1
263709,1,0,0,0,15,1
71763,3,31,23,8,16,0
228855,4,9,17,-8,17,0
185418,3,10,10,0,15,0
173388,4,34,27,7,10,0
21431,3,12,14,-2,11,1
163308,3,13,16,-3,5,1
221031,4,21,35,-14,14,1
196538,2,10,6,4,2,1
362647,2,3,7,-4,8,0
65916,3,17,14,3,13,1
204680,1,7,0,7,6,0
353668,2,3,0,3,4,1
362773,2,7,14,-7,8,1
30449,3,17,28,-11,14,1
230444,3,21,11,10,1,1
410570,2,10,7,3,13,0
326096,3,30,3,27,9,0
101400,3,12,7,5,12,1
221924,3,19,16,3,14,0
67103,4,10,17,-7,14,1
252622,2,3,3,0,10,1
355704,2,7,3,4,5,1
181408,3,17,17,0,13,0
271813,4,36,27,9,2,1
274528,2,14,9,5,3,1
267277,3,17,14,3,17,0
233077,1,0,0,0,2,1
412053,2,21,0,21,13,0
150859,2,0,7,-7,17,1
372084,1,0,0,0,13,1
335462,3,13,9,4,13,0
369182,4,19,20,-1,11,1
104512,3,14,31,-17,13,0
179141,3,12,13,-1,12,0
43725,4,24,17,7,3,0
386262,4,14,17,-3,2,1
413775,4,27,16,11,14,0
326130,4,30,10,20,9,1
325562,1,6,0,6,9,1
14610,2,10,7,3,7,1
55583,3,24,7,17,9,1
64512,4,34,16,18,13,0
310767,3,6,3,3,2,0
154781,3,13,16,-3,1,0
56594,3,19,17,2,9,0
186950,3,7,9,-2,15,0
85472,2,14,3,11,5,0
259598,2,0,3,-3,13,1
143307,1,0,10,-10,14,1
163915,3,23,10,13,5,0
331800,4,23,27,-4,12,0
35620,2,7,3,4,17,1
291235,1,7,6,1,10,1
254526,4,29,13,16,11,1
220439,3,23,14,9,13,0
68661,2,10,0,10,15,1
186877,1,7,0,7,15,1
359970,1,0,6,-6,7,1
61276,3,21,14,7,11,1
421626,1,3,0,3,17,1
390499,2,7,0,7,3,1
237967,2,3,3,0,4,0
54376,3,17,19,-2,8,0
141125,1,0,7,-7,13,1
199039,1,0,7,-7,4,0
136668,1,0,0,0,11,1
215192,2,7,9,-2,11,1
71627,3,3,31,-28,16,0
342682,1,0,0,0,16,1
49956,2,21,0,21,6,0
141865,3,24,14,10,13,0
103668,3,0,10,-10,13,0
89758,4,16,23,-7,7,0
58309,4,27,13,14,10,0
402166,3,19,7,12,9,0
280924,4,21,10,11,6,0
173581,2,0,10,-10,10,1
413314,4,20,0,20,14,1
80789,2,3,0,3,3,0
51928,3,13,10,3,7,1
354046,2,13,0,13,4,1
265276,4,9,6,3,16,1
416336,3,16,3,13,15,1
252005,2,14,20,-6,10,0
416785,3,10,10,0,15,0
262086,1,7,0,7,15,0
53325,4,24,16,8,8,0
35343,3,16,6,10,16,1
411885,2,14,0,14,13,0
22592,2,13,3,10,11,1
303481,3,25,10,15,16,0
186759,2,20,0,20,15,1
406634,1,0,0,0,11,0
57883,1,3,3,0,10,0
226653,4,17,13,4,16,0
202552,2,7,6,1,5,1
243739,2,17,3,14,6,0
260973,3,10,3,7,14,0
68952,2,14,7,7,15,0
119789,3,17,6,11,3,0
66644,3,7,17,-10,14,1
353117,3,10,29,-19,3,1
166595,2,22,14,8,6,0
379620,3,19,13,6,16,0
329322,2,6,17,-11,10,1
287861,4,28,20,8,9,0
358771,4,14,20,-6,6,0
415376,1,0,0,0,15,0
196015,4,7,30,-23,2,1
356710,3,19,16,3,5,0
161697,1,10,0,10,4,1
286580,3,10,31,-21,8,1
147929,4,31,38,-7,15,0
334822,2,10,0,10,13,0
124186,4,22,27,-5,5,1
88820,4,13,13,0,6,0
98323,4,28,27,1,11,1
346593,1,0,0,0,1,1
331678,1,0,0,0,12,0
305913,4,21,21,0,17,1
395052,3,0,17,-17,5,1
220418,3,23,14,9,13,1
15103,4,10,26,-16,7,1
145026,3,12,3,9,14,1
202484,4,9,16,-7,5,1
175080,1,7,3,4,10,0
320012,4,43,24,19,6,1
41600,1,7,0,7,2,0
101994,2,7,0,7,12,0
7297,4,17,13,4,4,0
123787,2,10,3,7,5,0
213498,2,7,7,0,10,0
93700,2,0,3,-3,9,1
90801,4,33,7,26,7,1
398149,1,7,3,4,7,0
2567,3,10,17,-7,2,0
403225,4,24,17,7,9,0
249194,1,9,0,9,9,0
345553,2,7,17,-10,17,0
204289,3,0,10,-10,6,1
57997,5,20,20,0,10,0
381954,2,0,13,-13,17,0
410239,2,7,0,7,13,1
114621,2,3,3,0,1,0
261085,2,6,14,-8,14,1
108328,1,0,7,-7,15,0
272855,2,20,6,14,2,0
421535,3,10,3,7,17,0
360767,3,17,21,-4,7,1
191042,1,0,0,0,17,0
127523,4,3,23,-20,6,1
138942,2,7,3,4,12,0
260146,1,0,0,0,14,1
12320,4,6,9,-3,6,0
329431,1,0,0,0,10,0
150042,4,24,6,18,16,1
290739,4,47,25,22,10,1
213815,2,35,0,35,10,1
129327,1,7,7,0,7,0
188874,2,10,7,3,16,0
114460,1,3,7,-4,1,0
146316,1,0,0,0,15,0
267242,2,10,14,-4,17,0
418262,2,6,0,6,16,0
144631,4,23,22,1,14,1
363204,1,0,7,-7,8,1
256353,1,3,0,3,12,0
31818,4,16,24,-8,15,1
353757,4,20,17,3,4,0
209048,2,3,3,0,8,0
75392,2,10,0,10,17,0
335144,2,17,0,17,13,1
309316,4,3,23,-20,1,1
84190,4,17,10,7,4,0
149036,1,0,7,-7,16,0
247692,2,7,6,1,8,1
85527,3,14,12,2,5,1
229054,1,0,0,0,17,1
181652,4,23,6,17,13,0
211821,2,14,10,4,9,1
45296,2,7,7,0,4,0
5983,4,17,29,-12,3,0
87338,4,27,24,3,6,1
372901,2,16,0,16,13,1
298417,3,7,21,-14,14,0
269487,2,10,10,0,1,1
128675,3,6,17,-11,7,0
167936,4,21,22,-1,7,1
58084,2,10,10,0,10,0
195369,2,10,3,7,2,0
73670,3,13,6,7,17,1
398551,4,28,23,5,7,0
319764,2,7,0,7,6,0
399379,3,27,10,17,7,1
351329,2,7,7,0,3,1
55162,4,29,17,12,8,0
147403,2,14,7,7,15,0
401761,4,27,14,13,8,0
156623,2,3,0,3,2,0
124928,1,0,0,0,5,1
393403,3,21,17,4,5,0
34644,4,31,10,21,16,0
252362,3,0,22,-22,10,1
273453,2,7,3,4,2,0
204902,3,10,13,-3,6,0
310159,3,21,7,14,2,0
384093,1,0,10,-10,1,1
421111,2,20,10,10,17,1
146478,1,7,0,7,15,0
391562,2,10,21,-11,4,0
95597,4,12,10,2,10,0
411057,3,17,17,0,13,1
350888,2,0,14,-14,3,0
217745,3,10,7,3,12,1
395039,2,0,17,-17,5,1
159534,2,14,6,8,3,0
391481,4,10,30,-20,4,0
282300,4,28,17,11,6,0
168413,2,0,3,-3,7,0
4046,2,10,14,-4,2,0
40019,2,20,7,13,1,0
119444,3,7,14,-7,3,0
349539,1,0,14,-14,2,1
287570,1,0,0,0,9,1
154612,3,21,14,7,1,0
6282,4,13,17,-4,3,1
128949,2,25,3,22,7,1
15800,3,0,12,-12,8,1
292819,4,29,24,5,11,0
105679,2,21,3,18,14,0
132333,4,31,17,14,9,0
143897,1,0,0,0,14,1
147977,1,0,3,-3,15,1
12589,4,3,24,-21,6,0
413019,4,19,18,1,14,0
37302,1,7,0,7,17,1
336437,3,10,17,-7,14,1
64886,3,10,3,7,13,0
333394,3,20,10,10,12,1
191559,3,14,24,-10,17,0
168436,3,0,17,-17,7,0
314952,4,0,13,-13,4,1
207229,4,20,20,0,7,0
277945,4,7,27,-20,4,0
53764,4,10,10,0,8,1
60838,3,17,16,1,11,0
205694,3,20,19,1,7,0
284960,3,13,20,-7,7,1
347096,2,3,3,0,1,1
366530,2,13,7,6,10,0
243091,3,0,9,-9,6,1
202618,3,24,13,11,5,0
102358,4,13,13,0,13,1
178073,4,23,23,0,12,0
242568,1,3,0,3,6,0
205316,2,17,0,17,6,0
195776,2,10,7,3,2,0
284736,1,6,7,-1,7,0
173646,4,10,20,-10,10,1
363887,4,20,29,-9,8,0
58401,2,34,7,27,10,1
241072,1,7,0,7,5,0
205520,3,14,17,-3,6,0
138877,4,12,47,-35,12,1
103363,2,10,17,-7,13,0
214783,3,3,20,-17,11,1
217595,2,3,9,-6,12,1
123975,3,10,7,3,5,0
374058,4,24,10,14,13,1
107186,2,0,21,-21,15,0
116807,4,40,33,7,2,1
393491,1,0,0,0,5,0
263579,1,0,7,-7,15,1
265016,1,0,0,0,16,1
26374,1,7,0,7,13,0
191400,3,0,31,-31,17,1
114350,2,17,13,4,1,1
231529,4,30,29,1,1,0
141630,1,10,7,3,13,1
99267,1,7,0,7,11,0
212118,1,3,7,-4,10,0
226874,2,0,7,-7,16,0
60682,3,21,3,18,11,1
342045,4,20,3,17,16,1
134855,1,0,0,0,10,1
229488,1,0,0,0,17,0
267548,3,20,21,-1,17,0
293695,4,10,13,-3,12,0
248190,3,9,10,-1,8,1
409769,1,0,0,0,12,0
138037,3,22,17,5,11,1
199063,2,6,14,-8,4,1
371090,4,13,27,-14,12,0
419589,2,20,10,10,17,0
157646,4,29,3,26,2,1
171209,4,6,14,-8,8,1
63466,3,21,13,8,12,1
332970,4,31,3,28,12,0
226246,2,6,0,6,16,1
192961,3,10,17,-7,1,1
74429,4,10,20,-10,17,1
45564,2,6,13,-7,4,1
350027,2,13,7,6,2,1
154724,2,3,7,-4,1,0
312760,4,31,28,3,3,1
147565,3,9,0,9,15,1
66977,1,0,0,0,14,1
394740,2,14,0,14,5,0
407597,3,10,17,-7,11,1
118221,1,9,0,9,2,1
268993,1,0,3,-3,17,0
220002,4,16,35,-19,13,1
186772,2,23,0,23,15,0
89527,2,0,10,-10,7,1
107684,4,13,36,-23,15,1
117491,3,7,17,-10,2,0
290074,3,10,6,4,10,0
216430,1,7,0,7,12,0
17752,4,24,19,5,9,0
21089,1,0,0,0,10,0
109545,2,0,7,-7,16,0
388020,3,6,6,0,2,1
314338,3,10,17,-7,3,0
37936,3,10,14,-4,1,1
70734,2,7,10,-3,15,0
54257,4,0,3,-3,8,0
225086,3,13,14,-1,15,0
163175,4,22,28,-6,5,1
233295,3,7,17,-10,2,0
226390,1,0,0,0,16,0
299084,1,3,3,0,14,0
24888,4,16,6,10,12,0
380514,2,7,14,-7,16,0
129530,2,3,7,-4,7,0
183075,2,7,0,7,14,0
101273,3,10,7,3,12,1
99292,2,10,0,10,11,1
137557,3,17,27,-10,11,1
350731,2,7,0,7,2,1
62957,1,0,7,-7,12,1
287424,1,7,0,7,9,0
208648,3,6,6,0,8,0
321465,3,21,27,-6,7,1
110783,3,3,10,-7,16,1
134154,1,0,3,-3,10,1
2343,1,0,3,-3,2,1
132755,4,20,24,-4,9,1
42506,3,10,12,-2,3,0
183242,2,10,14,-4,14,1
346677,3,21,6,15,1,0
21338,4,14,17,-3,11,0
27211,3,19,7,12,13,1
406801,2,0,17,-17,11,0
264181,4,34,27,7,15,0
172866,2,24,10,14,9,0
160543,4,23,14,9,4,1
208089,4,21,19,2,8,0
253362,2,7,13,-6,11,0
77000,4,17,20,-3,1,1
177625,4,23,20,3,11,1
171909,2,7,7,0,9,0
155839,2,7,10,-3,2,0
270856,3,9,13,-4,1,1
16604,2,7,14,-7,8,0
257106,4,14,21,-7,12,1
209528,2,34,10,24,8,0
324409,2,14,3,11,8,0
279650,1,14,0,14,5,0
381937,2,0,13,-13,17,1
188002,3,20,14,6,16,1
130273,4,9,29,-20,8,1
34933,4,27,24,3,16,1
36068,2,24,0,24,17,1
11515,3,6,10,-4,6,1
111897,1,0,0,0,17,0
162903,1,0,0,0,5,0
127392,4,17,23,-6,6,1
136435,2,10,7,3,11,1
79334,3,21,3,18,2,1
26364,1,0,0,0,13,1
201735,1,0,0,0,5,0
399356,3,27,7,20,7,1
188588,3,12,13,-1,16,1
203681,4,14,23,-9,6,0
354513,3,27,28,-1,4,0
345077,2,6,3,3,17,1
155492,1,7,0,7,2,0
22649,4,23,10,13,11,1
120658,1,0,0,0,3,1
250568,4,19,22,-3,9,0
369100,2,6,0,6,11,0
287741,1,14,0,14,9,0
212960,3,14,7,7,10,1
142624,3,13,6,7,13,0
307050,3,17,0,17,17,1
188367,1,0,0,0,16,1
318644,4,10,13,-3,5,1
106162,3,0,0,0,14,0
118741,4,27,12,15,2,0
165739,4,14,7,7,6,1
262180,4,31,13,18,15,0
206006,4,16,10,6,7,0
118318,4,26,7,19,2,0
270196,1,3,6,-3,1,0
365327,4,17,19,-2,9,1
354365,3,44,3,41,4,1
175461,4,20,23,-3,11,0
352741,4,24,13,11,3,0
299693,2,17,3,14,14,0
192775,2,0,9,-9,1,0
330833,2,10,17,-7,11,0
415600,3,14,10,4,15,0
383338,1,0,0,0,17,0
374928,4,14,28,-14,14,1
141183,2,3,21,-18,13,1
390182,1,0,3,-3,3,1
132677,2,3,9,-6,9,0
100692,4,21,21,0,12,0
390462,4,21,33,-12,3,1
188688,1,0,14,-14,16,0
59272,1,0,0,0,11,1
187434,4,41,14,27,16,1
297437,4,38,24,14,13,0
141535,3,24,10,14,13,0
137819,1,0,6,-6,11,1
82760,2,6,6,0,3,0
286772,4,20,28,-8,8,0
311381,3,28,13,15,2,0
116572,2,3,0,3,2,1
218584,2,7,17,-10,13,0
353908,3,17,28,-11,4,0
281825,3,10,0,10,6,1
189991,4,16,7,9,17,0
180723,1,0,0,0,13,0
214287,3,14,10,4,11,0
128323,2,0,3,-3,7,1
128449,1,13,0,13,7,1
330470,1,0,7,-7,11,1
199331,1,0,0,0,4,1
218232,4,37,3,34,12,0
269024,2,10,3,7,17,1
255643,2,3,7,-4,12,1
34633,4,24,10,14,16,1
61345,1,0,0,0,11,1
306297,2,17,0,17,17,0
150571,2,3,10,-7,17,1
183469,4,27,6,21,14,1
120496,5,39,41,-2,3,1
278510,3,36,0,36,4,0
20004,2,9,6,3,10,0
155021,1,6,12,-6,1,0
53202,1,0,0,0,8,1
249552,3,14,10,4,9,0
47636,1,3,17,-14,5,1
76434,1,0,0,0,1,0
196745,4,54,0,54,3,0
231498,4,23,12,11,1,0
71361,4,10,20,-10,16,1
163097,2,13,12,1,5,0
241010,4,27,30,-3,5,1
249306,1,0,0,0,9,1
253785,4,24,17,7,11,1
155244,3,28,7,21,1,0
165075,3,10,24,-14,6,0
276326,2,14,14,0,3,0
182410,1,0,0,0,14,1
131536,3,6,13,-7,8,0
121403,4,7,6,1,3,0
40506,4,7,20,-13,2,1
221348,1,0,0,0,14,0
344378,2,21,14,7,17,0
72638,2,13,0,13,16,0
130963,3,7,24,-17,8,1
403728,2,9,3,6,9,1
391103,1,7,14,-7,4,0
309246,2,0,7,-7,1,0
85741,1,7,0,7,5,0
142637,3,13,13,0,13,0
315209,3,17,10,7,4,0
283933,4,31,17,14,7,0
2466,4,28,20,8,2,0
177268,3,14,17,-3,11,1
144272,3,16,7,9,14,1
58726,2,10,17,-7,10,0
318094,2,9,7,2,5,0
178563,4,16,13,3,12,0
406102,3,0,20,-20,11,0
353191,1,0,0,0,4,0
184173,1,0,0,0,14,1
301679,4,17,6,11,15,0
386210,3,9,10,-1,2,1
140822,1,7,0,7,13,1
23630,2,7,13,-6,12,0
128253,4,20,7,13,7,0
233829,1,0,0,0,2,1
288672,2,0,7,-7,9,1
276,4,12,27,-15,1,1
387023,4,14,28,-14,2,0
246360,3,17,10,7,7,1
118524,2,17,0,17,2,0
354423,1,7,0,7,4,0
378287,2,3,3,0,15,1
163930,3,23,10,13,5,0
147670,2,10,0,10,15,0
23084,4,10,17,-7,11,0
261924,1,0,3,-3,14,1
405807,4,21,24,-3,10,1
10487,2,6,0,6,5,0
15384,4,10,17,-7,8,1
179534,2,0,16,-16,12,0
19193,3,21,13,8,10,0
374192,4,23,28,-5,13,1
16349,2,7,7,0,8,1
172202,2,0,6,-6,9,1
21475,4,15,14,1,11,0
312781,1,0,0,0,3,1
190019,1,7,0,7,17,0
208300,2,7,21,-14,8,1
200728,2,10,0,10,4,0
405435,3,21,10,11,10,0
32386,3,20,6,14,15,1
88173,2,14,10,4,6,1
113297,2,13,24,-11,17,1
3311,3,3,6,-3,2,0
319354,3,16,21,-5,6,0
195253,3,23,17,6,2,0
318376,1,7,0,7,5,0
101616,4,13,38,-25,12,0
227437,2,10,7,3,16,1
66788,3,10,6,4,14,1
405787,4,18,21,-3,10,1
234852,3,0,12,-12,2,1
141786,1,7,7,0,13,1
213917,1,10,0,10,10,0
21706,2,10,7,3,11,1
367127,2,21,13,8,10,1
157831,1,0,9,-9,3,1
247206,1,0,6,-6,8,0
198024,3,0,30,-30,3,0
218995,2,14,0,14,13,1
154835,1,0,0,0,1,1
331226,4,17,20,-3,11,1
209123,4,9,30,-21,8,0
227085,1,0,0,0,16,1
305609,4,23,10,13,17,0
213976,2,29,7,22,10,0
117463,2,7,13,-6,2,0
66394,4,21,27,-6,14,0
36426,1,0,0,0,17,0
264541,2,10,14,-4,16,0
22166,3,10,9,1,11,1
130550,4,13,6,7,8,0
311254,4,6,0,6,2,0
407806,4,17,7,10,11,1
23993,4,26,6,20,12,0
61214,1,7,0,7,11,1
191233,2,7,17,-10,17,0
177021,4,26,13,13,11,0
208619,2,6,3,3,8,0
176995,3,13,6,7,11,1
277345,1,7,0,7,4,1
22410,1,9,24,-15,11,1
410986,1,7,7,0,13,0
400815,2,17,13,4,8,1
139019,4,21,12,9,12,0
134734,2,10,0,10,10,1
243213,1,0,0,0,6,0
51243,4,39,32,7,7,1
83399,3,10,17,-7,4,1
375388,4,14,24,-10,14,1
91901,1,0,0,0,8,0
325597,2,10,7,3,9,0
188556,2,3,10,-7,16,0
225202,2,3,7,-4,15,1
212873,1,0,0,0,10,0
262259,2,3,6,-3,15,1
409000,4,31,31,0,12,0
55590,4,24,7,17,9,1
130412,4,7,6,1,8,1
383109,3,20,14,6,17,1
253103,3,21,7,14,11,1
396132,3,17,23,-6,6,0
50850,2,7,14,-7,6,1
200499,4,26,18,8,4,0
306827,1,0,3,-3,17,1
76792,3,33,0,33,1,0
191114,3,14,20,-6,17,1
169233,3,17,6,11,7,0
176231,4,14,24,-10,11,0
374300,3,14,13,1,13,0
346368,3,6,13,-7,1,1
188099,2,0,3,-3,16,1
316705,1,0,0,0,4,0
315073,3,30,14,16,4,1
193433,3,20,20,0,1,1
241392,2,7,21,-14,5,1
410495,4,15,26,-11,13,1
301557,1,0,0,0,15,1
185318,4,41,30,11,15,1
184095,2,9,14,-5,14,1
391202,4,10,24,-14,4,1
226698,1,7,3,4,16,1
135285,4,31,17,14,10,1
412351,3,17,17,0,13,1
192090,1,0,3,-3,1,1
250583,1,0,0,0,10,0
276768,2,17,3,14,4,0
312477,1,10,0,10,3,0
214081,1,3,0,3,11,0
204547,1,0,21,-21,6,1
254049,4,14,20,-6,11,1
162290,1,0,0,0,4,1
103597,1,0,0,0,13,1
247461,4,13,12,1,8,0
162763,1,0,0,0,5,1
332207,3,10,16,-6,12,1
384320,3,16,0,16,1,0
43853,4,21,16,5,3,1
189875,1,0,7,-7,17,1
79851,1,3,6,-3,2,1
397269,1,0,14,-14,6,1
59846,4,15,16,-1,11,0
270359,1,0,0,0,1,1
95619,4,12,13,-1,10,0
210687,1,0,0,0,9,1
171733,1,3,0,3,9,0
95226,1,3,0,3,10,0
303025,4,23,19,4,16,0
208242,4,13,10,3,8,0
317032,2,0,10,-10,4,1
233306,3,7,20,-13,2,1
309091,1,9,3,6,1,1
109710,2,10,0,10,16,1
196140,3,31,24,7,2,0
269918,1,7,3,4,1,1
27305,2,13,3,10,13,1
283390,1,7,7,0,7,0
117816,3,9,6,3,2,1
312515,2,20,0,20,3,1
221073,1,0,0,0,14,0
368509,1,0,0,0,11,1
369432,3,31,7,24,11,0
295280,3,14,5,9,12,0
252552,4,29,32,-3,10,0
249117,4,28,20,8,9,0
173226,4,20,24,-4,9,0
275778,3,16,3,13,3,0
372776,3,3,0,3,13,0
226456,3,7,7,0,16,0
298843,3,21,9,12,14,0
396106,2,17,16,1,6,1
190201,2,0,0,0,17,1
92617,4,17,3,14,8,0
222059,3,20,10,10,14,1
320461,3,17,17,0,6,1
240360,4,14,23,-9,5,1
71022,2,17,0,17,16,0
376255,3,10,14,-4,14,0
355760,3,7,6,1,5,1
39809,1,0,0,0,1,1
342665,1,0,0,0,16,0
135379,3,21,17,4,10,1
155600,4,30,17,13,2,0
180171,3,10,0,10,13,1
177115,3,24,13,11,11,1
146363,2,3,3,0,15,1
194730,2,0,10,-10,2,1
212490,3,10,6,4,10,1
40374,4,12,10,2,2,1
395721,4,26,37,-11,6,0
311795,3,10,20,-10,2,1
377837,2,17,6,11,15,0
223695,3,20,13,7,15,1
26823,1,0,0,0,13,1
1522,2,3,13,-10,1,0
263916,2,16,0,16,15,0
334594,4,30,30,0,13,0
1944,2,3,0,3,1,1
114124,4,21,14,7,17,1
171725,1,0,0,0,9,1
229681,2,10,7,3,17,0
38279,4,13,14,-1,1,1
303349,4,41,0,41,16,0
17471,1,0,0,0,9,1
112783,4,20,10,10,17,0
54908,1,0,0,0,8,1
15231,3,16,7,9,8,0
26594,3,10,6,4,13,0
73186,2,7,0,7,16,0
332806,4,28,16,12,12,1
293114,4,10,27,-17,11,0
87154,3,21,10,11,5,1
73637,2,3,0,3,17,1
76780,2,24,0,24,1,1
396361,2,20,6,14,6,0
167133,1,6,0,6,7,0
296668,4,10,16,-6,13,0
50895,3,14,24,-10,6,1
76216,3,12,27,-15,1,1
21308,3,3,14,-11,11,1
132190,1,0,0,0,9,0
310527,4,23,9,14,2,0
228769,1,0,7,-7,17,1
273796,3,10,7,3,2,1
116020,3,13,7,6,1,1
97173,1,0,3,-3,10,1
138173,2,7,9,-2,11,0
147120,3,17,31,-14,15,0
273435,1,0,0,0,2,0
305941,5,21,21,0,17,0
118989,3,0,23,-23,3,1
201881,5,31,30,1,5,1
412088,3,31,0,31,13,0
374237,1,7,0,7,13,0
377934,1,0,0,0,15,0
25996,3,10,16,-6,13,1
178789,2,21,7,14,12,0
173929,3,13,16,-3,10,0
141910,1,0,0,0,13,1
396078,2,17,3,14,6,0
221848,2,6,0,6,14,1
65163,2,3,3,0,13,0
195532,2,6,0,6,2,1
141659,2,20,14,6,13,1
204271,2,0,7,-7,6,1
170582,3,34,6,28,8,0
368868,3,24,3,21,11,0
75312,4,14,26,-12,17,0
186330,3,26,10,16,15,1
142906,2,0,10,-10,13,1
143056,2,3,7,-4,13,0
342180,4,15,19,-4,16,0
124180,4,22,27,-5,5,1
276404,4,32,44,-12,3,0
421137,3,30,16,14,17,1
163238,2,3,3,0,5,1
343175,2,3,0,3,16,0
166427,2,17,7,10,6,0
245388,2,9,3,6,7,0
123342,3,21,14,7,4,0
111506,2,7,0,7,16,1
227415,2,7,7,0,16,1
46518,4,37,6,31,4,1
87969,1,0,0,0,6,1
74336,1,0,3,-3,17,1
258786,1,7,0,7,13,0
370134,2,10,3,7,12,0
374897,4,14,18,-4,14,1
411535,4,13,31,-18,13,0
228755,1,0,6,-6,17,0
333936,2,6,7,-1,12,1
62905,3,10,10,0,12,1
283014,3,21,3,18,6,0
72077,3,10,10,0,16,0
142497,3,27,10,17,13,0
122505,4,20,36,-16,4,1
95725,4,13,9,4,10,0
419128,2,10,3,7,16,0
33572,4,17,10,7,16,1
409200,2,3,0,3,12,0
207332,3,13,14,-1,7,0
149293,4,13,27,-14,16,0
284602,2,14,7,7,7,1
47168,2,6,0,6,5,0
99123,4,23,7,16,11,1
51086,4,3,23,-20,6,0
60354,2,3,7,-4,11,1
257455,1,0,0,0,13,0
47897,4,21,13,8,5,0
113533,1,0,0,0,17,0
30054,4,39,7,32,14,1
236810,3,3,9,-6,3,0
151604,2,6,10,-4,17,1
121228,3,21,27,-6,3,0
179333,1,0,0,0,12,1
362188,2,3,3,0,8,0
238138,1,0,3,-3,4,0
412604,1,3,0,3,14,0
338180,2,7,14,-7,14,0
347043,4,24,17,7,1,1
55400,2,13,7,6,9,0
80762,2,3,0,3,3,1
82300,2,3,10,-7,3,1
30580,2,10,0,10,14,0
65609,3,6,9,-3,13,0
166860,1,0,3,-3,6,1
404466,2,14,13,1,10,1
36378,3,13,19,-6,17,1
413389,2,0,21,-21,14,1
52657,2,3,7,-4,7,0
153628,4,15,14,1,1,1
413598,3,9,17,-8,14,0
392375,3,20,31,-11,4,1
315338,2,3,3,0,4,1
390305,4,17,20,-3,3,1
15676,4,37,10,27,8,0
257294,1,0,0,0,13,0
183595,1,0,0,0,14,1
376135,4,3,9,-6,14,0
116527,1,0,0,0,2,1
202709,2,3,10,-7,5,1
160642,2,7,0,7,4,1
141809,2,10,14,-4,13,1
208205,4,0,10,-10,8,1
157651,1,0,0,0,2,0
387774,4,0,43,-43,2,1
184754,1,14,0,14,15,0
124015,4,13,14,-1,5,1
225322,2,7,21,-14,15,0
94372,3,17,14,3,9,0
338266,4,34,31,3,14,0
396923,4,34,27,7,6,0
267067,2,3,0,3,17,0
92375,2,10,0,10,8,1
146162,1,0,0,0,15,0
374049,4,24,10,14,13,0
239012,4,29,15,14,4,0
369035,4,13,13,0,11,1
117636,2,6,13,-7,2,1
266185,2,21,0,21,16,1
246876,1,0,0,0,8,0
65885,2,7,13,-6,13,0
351489,2,0,23,-23,3,0
46828,4,14,39,-25,4,0
332294,2,3,6,-3,12,0
342603,3,19,20,-1,16,1
180819,4,17,20,-3,13,0
26806,4,13,43,-30,13,1
323102,4,26,14,12,7,0
21908,4,35,3,32,11,0
49259,4,17,10,7,6,1
414137,3,10,13,-3,14,1
245590,3,40,6,34,7,0
39050,1,0,0,0,1,1
336393,1,3,3,0,14,1
419570,1,13,7,6,17,0
343605,2,15,7,8,17,1
1271,4,17,13,4,1,0
33600,4,17,16,1,16,0
266164,1,7,0,7,16,1
192588,1,3,0,3,1,0
156072,4,20,24,-4,2,0
208014,2,21,0,21,8,0
296405,1,7,0,7,13,1
86961,2,14,0,14,5,0
171605,2,3,3,0,9,1
8778,3,6,0,6,4,1
395719,4,26,37,-11,6,0
46131,1,0,7,-7,4,1
130497,2,10,3,7,8,0
414172,4,16,20,-4,14,1
391905,3,23,20,3,4,0
207363,4,13,21,-8,7,0
347363,4,14,21,-7,1,1
136093,1,0,7,-7,10,1
24409,3,16,7,9,12,1
342581,3,12,13,-1,16,1
62269,2,21,7,14,12,0
77237,3,16,0,16,1,0
258979,2,0,16,-16,13,1
339592,3,17,14,3,15,1
199121,3,14,31,-17,4,1
199799,2,3,3,0,4,0
240885,1,7,0,7,5,0
108369,2,0,14,-14,15,0
229246,2,10,14,-4,17,0
231006,2,10,0,10,1,0
130784,2,13,3,10,8,1
259046,4,3,16,-13,13,0
157614,4,18,3,15,2,1
216406,4,21,23,-2,12,1
79768,3,20,7,13,2,1
206438,3,17,0,17,7,0
337019,2,13,0,13,14,1
400342,2,10,3,7,8,0
190179,1,0,0,0,17,1
223638,2,6,3,3,15,1
121484,2,6,0,6,4,1
81744,3,23,17,6,3,1
45854,1,7,0,7,4,0
135131,4,31,6,25,10,0
107574,1,0,7,-7,15,1
381203,2,7,10,-3,16,1
225171,2,3,6,-3,15,0
252548,4,29,32,-3,10,0
85515,3,14,9,5,5,0
51050,3,3,20,-17,6,0
239540,2,10,0,10,4,0
205325,2,17,0,17,6,1
265365,3,13,13,0,16,1
266878,1,0,0,0,17,0
142496,3,27,10,17,13,0
315244,4,20,16,4,4,1
107478,2,3,17,-14,15,1
286887,3,9,7,2,8,0
115895,3,7,23,-16,1,0
236134,2,0,3,-3,3,0
164454,2,14,0,14,5,0
395162,1,3,7,-4,5,1
37361,3,17,0,17,17,0
18163,3,13,20,-7,9,1
286718,2,17,7,10,8,1
305741,3,9,10,-1,17,1
393964,1,3,6,-3,5,0
387838,2,10,7,3,2,0
315345,2,10,9,1,4,0
191222,2,0,17,-17,17,1
332796,4,28,16,12,12,1
75351,4,21,33,-12,17,1
228075,3,3,3,0,17,0
289074,4,41,28,13,9,0
52904,1,0,0,0,7,1
30933,4,10,24,-14,15,1
421397,3,16,20,-4,17,1
410363,1,0,7,-7,13,1
186899,2,7,3,4,15,1
59098,4,10,23,-13,10,0
161745,2,17,6,11,4,1
290604,1,7,0,7,10,0
80052,3,17,3,14,2,0
29300,3,21,7,14,14,0
354883,5,41,42,-1,4,1
64112,1,0,0,0,13,1
318942,1,0,0,0,5,0
261721,3,14,7,7,14,0
177637,4,24,20,4,11,0
24929,1,3,7,-4,12,1
329886,1,0,7,-7,11,0
119979,3,16,24,-8,3,1
109017,3,16,27,-11,15,0
185663,1,7,0,7,15,0
217464,2,9,3,6,12,1
161185,4,3,36,-33,4,1
364156,4,31,3,28,9,1
123180,2,6,21,-15,4,0
51924,3,13,10,3,7,1
138257,4,10,12,-2,11,1
344467,1,0,0,0,17,0
257469,1,0,3,-3,13,0
207191,4,14,20,-6,7,1
368739,3,14,16,-2,11,0
373003,1,0,0,0,13,1
280659,1,0,3,-3,5,0
121084,4,18,31,-13,3,0
351895,1,0,0,0,3,1
357251,2,3,9,-6,5,1
242722,2,7,7,0,6,0
153053,1,0,7,-7,1,1
136170,4,10,10,0,10,1
105251,3,7,24,-17,14,1
247297,3,35,28,7,8,0
189676,4,17,6,11,17,1
13409,1,3,14,-11,7,1
109272,3,6,0,6,15,1
57306,2,7,0,7,10,0
155260,4,28,14,14,1,0
402857,2,10,3,7,9,1
219307,2,13,7,6,13,0
33907,1,0,10,-10,16,1
346401,3,9,13,-4,1,0
175771,4,40,28,12,11,1
56267,2,3,14,-11,9,0
79992,1,7,0,7,2,1
104865,1,0,3,-3,14,0
122270,2,6,13,-7,4,0
397251,1,0,0,0,6,0
14504,4,34,30,4,7,1
408886,1,7,0,7,12,1
1836,3,16,7,9,1,0
231270,1,0,3,-3,1,1
29194,4,3,26,-23,14,1
181133,4,24,14,10,13,1
184341,2,0,6,-6,14,1
90135,2,3,0,3,7,1
28758,1,0,0,0,14,0
14338,3,2,7,-5,7,1
306088,4,17,13,4,17,1
8087,3,17,13,4,4,1
61487,1,0,7,-7,11,0
120025,4,30,38,-8,3,0
155808,1,7,3,4,2,0
398617,2,0,0,0,7,0
86093,2,28,0,28,5,0
182376,4,24,20,4,14,1
269076,3,13,16,-3,17,0
98738,3,28,6,22,11,1
134639,3,31,17,14,10,0
169211,3,10,6,4,7,0
179202,1,7,0,7,12,0
78646,4,30,13,17,2,0
96941,3,22,10,12,10,0
229730,3,13,17,-4,17,0
321252,1,3,3,0,6,1
128940,2,22,3,19,7,1
54827,3,13,0,13,8,0
219413,4,33,27,6,13,0
230856,2,7,7,0,1,0
329863,1,0,0,0,11,1
71316,3,10,20,-10,16,1
148216,4,16,28,-12,16,0
242744,2,7,17,-10,6,1
35646,3,17,3,14,17,1
388842,4,21,17,4,3,0
380441,4,10,24,-14,16,0
95190,4,23,30,-7,9,1
278519,4,36,0,36,4,1
138661,3,6,28,-22,12,0
306738,2,10,17,-7,17,0
15487,3,16,0,16,8,1
103775,1,3,0,3,13,1
406943,2,3,13,-10,11,1
231262,1,0,3,-3,1,1
278143,2,7,7,0,4,0
163109,2,13,19,-6,5,1
270314,4,17,27,-10,1,1
186539,4,24,33,-9,15,1
51212,4,24,25,-1,7,1
143096,3,17,17,0,13,0
30490,4,31,35,-4,14,0
343831,3,21,3,18,17,1
118289,3,12,7,5,2,1
42464,2,0,5,-5,3,1
332854,1,7,0,7,12,1
286297,3,16,16,0,8,1
388453,2,3,13,-10,2,1
351902,1,0,0,0,3,0
142109,2,0,7,-7,13,0
248836,4,37,29,8,9,1
67777,4,21,0,21,14,1
134108,4,27,13,14,9,0
203148,2,0,7,-7,5,1
75826,1,0,0,0,1,1
65532,1,0,0,0,13,1
48305,4,13,13,0,5,1
98145,3,21,10,11,11,0
14757,2,31,0,31,7,0
292209,4,21,17,4,11,1
370077,4,31,20,11,12,0
413157,4,39,42,-3,14,1
11326,1,14,0,14,6,1
180339,3,12,7,5,13,0
2862,3,31,24,7,2,0
208966,4,20,14,6,8,1
380260,4,29,16,13,16,1
173246,4,20,27,-7,9,1
143797,2,6,0,6,14,1
204097,2,3,7,-4,6,0
282786,2,0,10,-10,6,0
196999,3,20,17,3,3,1
46677,4,17,3,14,4,0
151829,4,28,16,12,17,1
250399,4,24,26,-2,9,1
276366,3,17,35,-18,3,1
174321,2,10,0,10,10,0
285971,4,29,14,15,8,0
80728,1,0,0,0,3,1
300977,1,0,0,0,15,0
252714,4,6,10,-4,10,1
95690,3,10,6,4,10,0
109137,3,24,7,17,15,0
130328,2,7,0,7,8,0
74726,4,7,17,-10,17,0
224639,3,16,10,6,15,1
397495,4,13,22,-9,6,1
90588,2,14,10,4,7,1
118223,1,9,0,9,2,1
95185,4,23,30,-7,9,1
176160,2,14,7,7,11,1
120398,2,16,9,7,3,0
298348,1,0,7,-7,14,0
163414,2,0,13,-13,5,1
96116,1,0,13,-13,10,1
98706,2,21,3,18,11,1
209680,2,6,0,6,8,1
151487,3,35,7,28,17,0
311677,3,6,6,0,2,0
344313,4,19,13,6,17,1
129187,2,7,0,7,7,0
11614,1,7,0,7,6,0
352780,1,7,0,7,3,1
170609,3,41,9,32,8,0
41630,2,14,0,14,2,1
405315,4,14,10,4,10,1
78140,2,17,3,14,2,0
275025,3,31,10,21,3,0
124167,4,22,21,1,5,0
181498,5,31,31,0,13,0
321140,2,3,10,-7,6,0
190474,1,7,0,7,17,0
256858,1,0,3,-3,12,0
123742,1,7,3,4,5,0
197958,1,0,3,-3,3,1
171759,2,6,7,-1,9,1
278147,2,7,14,-7,4,1
21413,2,9,7,2,11,1
91619,2,14,7,7,8,0
147240,2,0,21,-21,15,0
404365,4,20,6,14,10,1
32013,1,0,0,0,15,1
370200,4,31,10,21,12,0
323363,2,10,0,10,7,1
133093,1,0,0,0,9,1
189726,1,0,3,-3,17,0
292685,4,22,16,6,11,0
282637,2,6,7,-1,6,0
69607,3,7,17,-10,15,0
31932,3,6,13,-7,15,1
61469,4,24,17,7,11,1
163963,4,26,13,13,5,0
268852,1,0,7,-7,17,0
315615,1,0,0,0,4,1
54997,4,13,10,3,8,1
300746,2,7,6,1,15,1
394099,1,0,0,0,5,0
359297,2,3,13,-10,6,1
230583,3,13,17,-4,1,1
397163,2,6,0,6,6,1
348134,4,17,22,-5,1,1
96294,2,0,9,-9,10,0
392231,4,10,16,-6,4,1
220343,1,3,0,3,13,0
52860,3,14,51,-37,7,0
312481,1,10,0,10,3,1
282112,3,16,8,8,6,0
199020,1,0,0,0,4,0
71621,3,3,31,-28,16,1
298680,3,13,7,6,14,1
39556,2,0,6,-6,1,1
324776,4,26,14,12,8,0
210361,4,22,17,5,9,0
108875,4,14,17,-3,15,0
374373,1,7,0,7,14,1
80562,4,16,10,6,3,0
266267,4,38,19,19,16,0
34299,3,20,9,11,16,0
239050,1,0,0,0,4,0
170515,1,0,0,0,8,1
261304,1,0,0,0,14,1
206427,3,10,0,10,7,0
251127,4,10,17,-7,10,1
33033,1,0,0,0,16,0
390936,1,7,0,7,4,1
402445,3,21,12,9,9,0
338876,4,13,22,-9,15,0
181868,3,21,14,7,13,0
150215,4,6,26,-20,16,0
187196,1,0,0,0,16,1
6184,1,7,0,7,3,0
7206,1,0,0,0,4,0
232082,4,0,33,-33,1,1
386165,2,3,3,0,2,1
414080,1,0,3,-3,14,1
148065,4,14,10,4,15,0
128634,2,3,10,-7,7,1
78123,2,7,3,4,2,1
251785,1,0,0,0,10,0
194350,4,23,6,17,2,0
199211,2,10,13,-3,4,0
305308,4,42,21,21,16,1
237861,3,7,27,-20,4,0
174903,1,0,0,0,10,1
322870,1,0,0,0,7,0
380807,3,9,21,-12,16,1
371569,2,3,0,3,12,0
376718,4,6,0,6,14,0
392003,2,0,7,-7,4,1
23430,1,0,0,0,11,1
340310,2,10,0,10,15,0
145101,1,3,0,3,14,0
22474,3,24,27,-3,11,1
148577,2,0,6,-6,16,1
199996,3,17,17,0,4,1
57755,2,16,3,13,10,1
305356,1,7,3,4,17,1
400877,4,31,19,12,8,0
321025,3,10,7,3,6,0
407503,1,3,0,3,11,1
103856,4,19,0,19,13,1
17900,4,24,17,7,9,0
119971,3,16,24,-8,3,0
227914,3,27,13,14,16,0
191335,1,0,7,-7,17,0
335163,3,20,7,13,13,1
283152,3,13,9,4,7,0
226556,1,3,0,3,16,0
332302,2,3,6,-3,12,1
79601,3,14,7,7,2,1
321480,4,21,30,-9,7,1
407828,1,3,0,3,11,1
53600,4,14,15,-1,8,0
275212,4,17,22,-5,3,0
76033,2,10,13,-3,1,0
360235,1,0,0,0,7,0
206216,2,0,3,-3,7,1
96325,3,3,16,-13,10,1
201533,4,32,14,18,5,1
190761,1,3,3,0,17,1
117453,2,7,7,0,2,1
410553,2,7,7,0,13,1
145881,1,0,0,0,15,0
117089,3,7,24,-17,2,0
86365,1,0,0,0,5,1
406576,4,20,37,-17,11,0
12141,3,14,21,-7,6,0
44683,1,0,0,0,3,0
240124,2,6,3,3,5,1
43565,4,24,3,21,3,0
412732,1,0,0,0,14,0
379065,3,7,6,1,15,1
54655,3,14,22,-8,8,1
75418,2,10,7,3,17,0
325012,2,20,21,-1,8,0
8373,3,30,3,27,4,0
148052,3,7,3,4,15,0
64584,2,10,14,-4,13,0
146946,1,14,0,14,15,0
122329,4,6,19,-13,4,0
354074,3,19,0,19,4,1
160312,2,3,14,-11,4,1
72441,1,7,0,7,16,0
381137,4,24,28,-4,16,1
22797,4,6,21,-15,11,1
169722,4,20,17,3,8,0
405155,4,12,10,2,10,0
416534,4,38,17,21,15,0
104685,4,14,3,11,14,0
32098,3,14,13,1,15,1
416021,2,7,3,4,15,1
341715,4,23,13,10,16,1
232581,1,0,0,0,1,1
296185,3,16,26,-10,13,1
335342,4,3,23,-20,13,1
380071,3,35,20,15,16,0
45866,2,7,3,4,4,1
268612,3,7,6,1,17,0
83950,1,7,0,7,4,1
69955,1,21,0,21,15,0
318720,2,10,23,-13,5,1
278230,4,31,21,10,4,1
362186,2,3,0,3,8,0
412177,2,14,3,11,13,0
180360,3,15,14,1,13,1
15792,3,0,12,-12,8,1
285387,2,10,0,10,8,0
239825,2,0,0,0,4,0
188264,2,14,7,7,16,0
56903,3,27,7,20,9,0
322208,3,0,20,-20,7,1
152518,3,17,7,10,17,0
139680,2,0,0,0,12,0
299679,2,14,0,14,14,0
31190,3,23,27,-4,15,0
321236,1,3,0,3,6,0
404751,2,10,6,4,10,0
254395,1,7,0,7,11,1
23065,3,10,17,-7,11,0
314009,2,3,0,3,3,0
126804,1,0,6,-6,6,0
181109,3,24,7,17,13,0
144259,3,9,7,2,14,1
48270,2,10,13,-3,5,1
135668,2,7,10,-3,10,1
405004,4,9,23,-14,10,1
370049,4,24,13,11,12,1
49960,2,21,0,21,6,1
345069,2,6,0,6,17,0
352165,4,15,27,-12,3,1
327160,4,21,17,4,9,1
176506,2,9,17,-8,11,1
201092,4,41,10,31,5,0
161327,4,20,19,1,4,1
352587,4,34,23,11,3,0
299575,3,10,3,7,14,1
405121,3,0,10,-10,10,1
40977,1,0,7,-7,2,0
268643,4,14,13,1,17,1
200207,4,14,37,-23,4,0
63015,2,6,21,-15,12,1
127871,1,0,0,0,6,1
321553,1,3,3,0,7,0
124152,4,19,21,-2,5,1
365939,4,14,28,-14,9,1
289035,3,26,21,5,9,0
415189,3,10,24,-14,15,1
28219,2,10,0,10,13,1
19685,1,3,6,-3,10,1
226157,4,21,20,1,16,1
407423,3,14,7,7,11,0
107347,3,10,6,4,15,0
154015,3,10,14,-4,1,0
9356,3,28,7,21,5,1
31307,2,7,3,4,15,0
291738,3,0,14,-14,11,1
418597,2,14,10,4,16,0
285252,2,7,6,1,7,0
238964,2,14,9,5,4,0
180312,2,9,7,2,13,1
260455,1,7,0,7,14,1
7625,3,28,3,25,4,0
342010,3,20,3,17,16,0
343331,2,0,10,-10,16,0
188232,1,0,7,-7,16,1
125710,1,0,7,-7,5,0
202499,4,9,16,-7,5,0
330937,1,6,0,6,11,0
76022,2,10,13,-3,1,0
113139,2,34,0,34,17,1
372080,4,13,10,3,13,1
361578,4,19,17,2,7,0
180886,1,0,0,0,13,1
220148,3,26,13,13,13,0
85075,4,31,16,15,4,1
388848,1,0,0,0,3,1
129836,2,10,0,10,7,1
17883,4,24,17,7,9,0
156573,1,0,0,0,2,1
193393,2,7,17,-10,1,1
69291,3,16,3,13,15,0
124880,3,9,6,3,5,0
78558,2,13,7,6,2,0
207917,3,28,14,14,8,1
398355,3,3,13,-10,7,0
44904,4,7,38,-31,4,0
123071,4,14,21,-7,4,1
249530,2,14,3,11,9,0
64068,3,20,23,-3,13,0
179920,3,26,9,17,13,0
225901,2,7,0,7,16,1
138172,2,7,9,-2,11,0
308276,3,13,16,-3,1,1
337027,2,13,0,13,14,1
341275,4,23,13,10,16,0
90367,4,20,32,-12,7,0
400912,1,6,7,-1,8,1
327590,3,10,15,-5,10,0
102904,2,6,14,-8,13,0
398650,3,0,3,-3,7,1
381224,2,14,10,4,16,1
24098,3,7,14,-7,12,1
31194,3,23,27,-4,15,1
27210,3,19,7,12,13,1
383617,1,0,0,0,17,0
354733,1,6,0,6,4,0
275364,4,10,22,-12,3,1
251016,4,3,6,-3,10,0
170063,1,0,0,0,8,1
292031,3,15,9,6,11,0
148653,4,10,9,1,16,0
414478,4,16,23,-7,14,1
134066,3,20,10,10,9,0
251185,1,10,7,3,10,0
94855,4,6,13,-7,9,0
313550,2,0,10,-10,3,1
112832,1,7,0,7,17,0
304597,1,0,7,-7,16,1
18181,4,20,20,0,9,1
247190,4,27,6,21,8,1
186143,2,6,3,3,15,0
37262,4,13,21,-8,17,1
64168,2,28,6,22,13,1
97604,1,0,0,0,11,0
110475,3,17,0,17,16,0
111465,1,7,0,7,16,0
367068,4,10,41,-31,10,0
265132,4,20,10,10,16,0
366112,2,7,14,-7,10,1
202213,1,0,0,0,5,1
313912,3,28,26,2,3,1
403799,4,18,23,-5,9,0
7705,2,10,0,10,4,0
217929,4,32,28,4,12,0
219278,1,7,0,7,13,1
324699,2,7,7,0,8,0
76333,2,13,3,10,1,1
272509,2,7,3,4,2,1
317966,2,10,10,0,5,0
303552,1,7,3,4,16,0
56404,2,0,21,-21,9,0
55151,4,29,17,12,8,1
197750,3,14,17,-3,3,1
279366,2,6,7,-1,5,0
369359,1,0,0,0,11,0
341853,3,13,15,-2,16,1
342451,3,13,3,10,16,0
163727,2,0,9,-9,5,1
266601,1,0,0,0,16,1
329343,2,9,20,-11,10,1
58130,3,20,10,10,10,0
256167,4,27,22,5,12,0
133202,3,13,17,-4,9,1
344989,4,10,23,-13,17,0
231170,3,10,7,3,1,0
411054,3,17,17,0,13,1
313403,2,7,0,7,3,0
9246,4,10,36,-26,5,0
330171,1,0,0,0,11,1
146549,3,14,17,-3,15,0
323188,2,7,0,7,7,0
328601,2,17,14,3,10,0
79837,1,0,3,-3,2,0
360726,2,10,7,3,7,1
86670,2,7,0,7,5,1
395817,3,3,7,-4,6,0
46064,3,14,14,0,4,1
277581,3,6,14,-8,4,1
97626,1,3,0,3,11,1
239789,4,20,20,0,4,1
224441,2,9,10,-1,15,0
5615,1,0,7,-7,3,0
66289,1,0,0,0,14,0
328093,1,0,0,0,10,0
39205,1,0,0,0,1,0
186804,3,26,7,19,15,1
213099,4,20,3,17,10,1
300925,3,10,20,-10,15,1
66488,3,7,17,-10,14,1
276315,2,7,14,-7,3,1
145316,3,21,12,9,14,1
397879,2,0,3,-3,7,1
384676,2,7,17,-10,1,1
351017,2,7,7,0,3,1
68019,2,0,10,-10,14,1
345838,2,0,7,-7,17,1
313670,1,0,0,0,3,1
298015,4,37,7,30,13,1
51440,2,10,17,-7,7,0
70871,2,7,17,-10,15,1
217082,1,0,0,0,12,1
238306,1,3,9,-6,4,0
409752,4,13,9,4,12,1
376307,1,0,0,0,14,0
129000,4,35,10,25,7,0
247067,1,2,3,-1,8,1
69531,1,0,0,0,15,0
96721,2,0,10,-10,10,1
371579,2,9,3,6,12,1
194952,4,14,19,-5,2,0
359502,3,0,21,-21,6,1
372383,1,6,0,6,13,0
265414,4,14,23,-9,16,0
5978,3,17,23,-6,3,0
163306,3,13,16,-3,5,1
66112,4,10,6,4,13,1
349225,1,0,0,0,2,0
343064,3,9,13,-4,16,1
238452,1,3,0,3,4,1
11659,2,14,0,14,6,0
146512,2,7,7,0,15,1
71057,3,26,0,26,16,1
164675,4,21,27,-6,5,1
102873,1,0,7,-7,13,1
328606,2,17,20,-3,10,0
232403,4,20,22,-2,1,0
127569,1,0,6,-6,6,0
86333,4,27,23,4,5,0
205180,2,7,10,-3,6,1
33054,1,3,0,3,16,0
385451,3,28,10,18,1,1
291017,4,20,13,7,10,0
171858,4,26,20,6,9,1
256409,2,9,7,2,12,0
381505,2,14,0,14,17,0
57370,3,14,3,11,10,1
105955,2,10,0,10,14,0
16482,2,10,0,10,8,1
53830,1,0,0,0,8,1
28453,4,13,6,7,14,1
35117,1,0,6,-6,16,0
151839,4,28,16,12,17,1
356858,4,16,16,0,5,0
95773,1,0,0,0,10,1
149770,1,0,0,0,16,1
39489,4,13,19,-6,1,1
160141,2,10,0,10,3,0
216223,3,17,10,7,12,1
303017,4,23,16,7,16,0
389455,1,3,0,3,3,1
125847,1,3,0,3,6,0
26909,3,10,6,4,13,1
47605,1,0,6,-6,5,0
5754,1,7,0,7,3,1
203304,2,0,24,-24,6,1
162699,3,23,24,-1,5,1
41609,2,7,0,7,2,1
38124,4,9,6,3,1,0
118377,2,6,7,-1,2,0
320273,2,14,14,0,6,1
381547,3,28,13,15,17,0
350277,1,13,0,13,2,1
12612,4,3,27,-24,6,1
137762,4,10,37,-27,11,1
24518,2,7,7,0,12,0
183804,2,10,21,-11,14,1
395966,2,24,10,14,6,0
153484,1,0,0,0,1,0
167683,3,16,20,-4,7,0
265460,2,7,7,0,16,0
324274,3,15,0,15,8,0
253248,3,3,7,-4,11,0
390665,2,3,3,0,3,1
77921,1,3,0,3,1,0
137146,4,31,6,25,11,1
372087,1,0,0,0,13,1
98124,2,14,10,4,11,1
366786,1,0,0,0,10,1
336085,1,3,0,3,13,0
383396,3,3,9,-6,17,0
292870,2,7,0,7,11,1
368943,1,0,7,-7,11,1
171238,4,9,14,-5,8,1
24281,4,13,17,-4,12,1
102509,4,31,3,28,13,0
28032,1,7,7,0,13,0
45844,1,0,0,0,4,1
415962,1,0,0,0,15,0
49637,2,0,7,-7,6,1
252696,4,6,10,-4,10,1
335666,1,7,0,7,13,1
184032,1,0,0,0,14,0
305790,1,0,0,0,17,1
208045,3,21,3,18,8,0
126864,3,17,6,11,6,0
418086,1,0,0,0,16,1
196400,2,17,0,17,2,0
211290,1,3,0,3,9,0
365440,2,10,19,-9,9,1
170341,4,0,15,-15,8,1
174491,2,7,7,0,10,1
115571,3,24,9,15,1,1
180665,4,24,6,18,13,1
39996,2,7,7,0,1,0
171919,2,7,7,0,9,0
314759,2,14,0,14,4,1
331758,3,13,27,-14,12,0
204604,3,0,38,-38,6,1
284242,4,16,26,-10,7,0
124915,4,9,16,-7,5,0
215306,2,7,7,0,11,1
178023,3,7,20,-13,12,0
19477,4,17,17,0,10,1
368214,1,0,0,0,11,1
194444,2,9,0,9,2,1
303822,4,20,17,3,16,0
156135,2,7,7,0,2,1
299242,1,10,0,10,14,0
15668,4,34,10,24,8,0
209805,1,0,7,-7,8,1
322260,4,0,27,-27,7,0
47213,3,9,9,0,5,1
126171,2,7,3,4,6,1
143959,3,0,10,-10,14,1
239523,1,3,0,3,4,1
320408,2,14,0,14,6,0
26353,4,19,21,-2,13,1
411896,2,14,3,11,13,1
212268,1,7,3,4,10,1
276610,2,7,3,4,4,0
257059,3,7,14,-7,12,1
258255,2,7,6,1,13,1
137675,1,0,13,-13,11,1
155948,1,0,0,0,2,0
146473,1,0,0,0,15,0
388543,1,0,0,0,3,1
374193,4,23,28,-5,13,1
85877,1,0,0,0,5,0
90710,1,7,0,7,7,0
39783,4,9,7,2,1,1
179369,2,0,6,-6,12,1
369094,1,3,0,3,11,1
402102,2,6,0,6,9,0
9529,4,13,13,0,5,1
95932,1,0,0,0,10,0
41366,3,14,12,2,2,1
121603,4,22,16,6,4,0
56613,4,26,17,9,9,0
241559,2,3,10,-7,5,0
301637,3,10,6,4,15,1
60561,4,30,27,3,11,0
145807,3,13,10,3,15,0
421347,1,3,3,0,17,0
285157,4,3,3,0,7,1
218622,3,10,30,-20,13,1
275902,2,13,6,7,3,1
328336,3,3,30,-27,10,0
393626,4,7,33,-26,5,1
383289,4,45,17,28,17,1
291321,4,24,22,2,10,0
416398,4,16,13,3,15,0
210008,3,7,3,4,8,0
132334,4,31,17,14,9,0
206744,4,7,24,-17,7,0
4944,3,14,17,-3,3,1
266441,1,0,3,-3,16,0
81713,3,17,17,0,3,0
249812,1,6,3,3,9,1
32278,4,27,21,6,15,0
116038,4,13,7,6,1,1
218432,2,10,14,-4,13,1
345119,3,12,3,9,17,1
62887,3,10,3,7,12,0
12952,1,0,0,0,6,0
365929,4,14,21,-7,9,0
56740,3,7,10,-3,9,1
34913,3,27,17,10,16,0
325928,3,13,7,6,9,0
248821,4,37,14,23,9,0
39645,4,30,6,24,1,0
25522,2,7,0,7,12,0
346552,3,24,40,-16,1,0
254046,4,14,20,-6,11,1
420994,4,14,28,-14,17,0
21838,2,0,0,0,11,1
33491,1,13,0,13,16,1
402135,2,12,0,12,9,0
381982,3,0,23,-23,17,0
23135,1,6,0,6,11,0
230711,2,6,27,-21,1,1
29498,4,10,14,-4,14,0
171967,4,14,14,0,9,0
5829,3,27,7,20,3,0
370781,3,19,17,2,12,1
302480,2,3,10,-7,15,1
347685,4,27,24,3,1,0
302789,2,9,13,-4,15,0
102164,2,14,7,7,13,0
374542,2,17,6,11,14,1
338849,3,13,7,6,15,0
90922,3,48,7,41,7,1
289849,1,0,0,0,10,0
134643,3,31,17,14,10,0
372438,2,6,7,-1,13,0
140109,2,7,0,7,12,1
323245,3,7,10,-3,7,1
355577,2,21,3,18,5,1
142552,1,0,0,0,13,0
370645,4,21,14,7,12,0
338350,2,3,0,3,14,0
132137,3,10,3,7,9,1
322183,2,0,20,-20,7,1
148424,2,7,0,7,16,0
105615,4,32,28,4,14,0
350364,4,24,13,11,2,0
245237,1,3,3,0,7,0
244438,4,3,20,-17,7,0
275297,2,10,8,2,3,1
383601,4,24,24,0,17,1
148483,3,21,3,18,16,0
238385,3,10,30,-20,4,1
82809,3,9,16,-7,3,1
36145,1,0,0,0,17,0
68680,3,17,0,17,15,0
148886,1,3,6,-3,16,1
156145,2,7,7,0,2,0
143416,4,13,26,-13,14,0
230947,1,0,0,0,1,0
306450,2,3,17,-14,17,0
219719,4,13,14,-1,13,1
257311,1,3,0,3,13,1
120847,2,7,14,-7,3,0
256586,2,7,0,7,12,1
33257,3,10,0,10,16,1
96887,2,13,7,6,10,1
335880,3,28,14,14,13,0
377354,1,0,0,0,15,0
207912,3,28,7,21,8,0
155988,2,10,14,-4,2,0
26149,3,0,13,-13,13,0
39241,2,3,3,0,1,1
54615,2,7,6,1,8,1
1163,4,10,36,-26,1,1
328007,3,17,3,14,10,0
345774,4,19,10,9,17,1
85854,4,20,16,4,5,1
324979,2,13,14,-1,8,0
49162,1,10,0,10,6,0
421216,2,6,7,-1,17,1
33201,1,7,0,7,16,1
191075,2,7,3,4,17,0
39449,3,13,10,3,1,0
188098,2,0,3,-3,16,1
319901,1,6,6,0,6,0
191597,4,24,24,0,17,0
90696,1,7,0,7,7,0
379800,4,9,24,-15,16,0
361974,4,13,6,7,7,1
90227,4,6,3,3,7,1
247182,4,27,6,21,8,0
156133,2,7,7,0,2,1
34112,2,3,0,3,16,0
115075,1,3,0,3,1,0
201935,2,0,0,0,5,1
224736,2,5,0,5,15,0
246819,4,10,20,-10,8,0
301115,1,0,0,0,15,1
271291,3,6,14,-8,1,0
157492,4,23,40,-17,2,1
49632,2,0,7,-7,6,0
163332,4,22,23,-1,5,0
357247,2,3,9,-6,5,1
225066,3,10,14,-4,15,0
403108,1,0,0,0,9,0
117909,1,0,0,0,2,0
12838,2,13,3,10,6,1
130750,1,7,3,4,8,0
137313,4,13,27,-14,11,0
241361,1,7,0,7,5,0
57077,4,14,27,-13,9,0
214660,4,17,16,1,11,0
362947,2,27,6,21,8,0
163689,1,0,6,-6,5,1
65354,4,13,21,-8,13,0
373191,2,3,3,0,13,0
362253,4,15,17,-2,8,0
114139,4,31,14,17,17,0
262925,4,14,23,-9,15,0
221635,4,23,21,2,14,0
66889,2,6,7,-1,14,0
146707,3,7,32,-25,15,1
255290,1,0,0,0,12,0
352910,1,0,0,0,3,1
99659,3,26,3,23,11,1
11625,1,14,0,14,6,0
110044,4,48,10,38,16,0
99758,2,0,0,0,12,0
420320,3,17,3,14,17,0
309919,1,0,0,0,2,1
236503,2,7,9,-2,3,1
307618,2,7,7,0,17,0
406300,4,27,35,-8,11,1
393803,1,0,3,-3,5,0
38505,2,10,3,7,1,0
253675,2,3,0,3,11,1
302529,3,3,13,-10,15,0
20822,2,14,3,11,10,0
311019,1,10,0,10,2,0
31125,1,3,3,0,15,1
32641,1,0,0,0,15,0
337304,2,7,7,0,14,0
234996,3,13,17,-4,2,1
95311,4,17,24,-7,10,1
132063,4,3,24,-21,8,0
107746,2,7,10,-3,15,0
97307,1,0,0,0,10,0
367374,1,7,14,-7,10,1
149330,1,0,0,0,16,1
107430,1,0,3,-3,15,1
177344,1,3,0,3,11,0
248400,1,10,0,10,8,1
324868,2,10,10,0,8,0
2092,2,7,13,-6,1,1
345583,3,14,20,-6,17,0
392205,3,10,13,-3,4,0
226753,3,7,13,-6,16,0
87586,3,17,3,14,6,0
6383,2,0,13,-13,3,0
354436,1,7,7,0,4,0
211594,1,0,0,0,9,0
104584,2,7,3,4,14,0
207760,3,24,13,11,7,1
388084,1,0,0,0,2,1
137227,2,7,10,-3,11,0
418674,1,0,0,0,16,1
91559,4,26,10,16,8,0
289661,4,13,20,-7,10,0
78480,4,24,0,24,2,0
10661,3,10,17,-7,5,1
60695,3,21,3,18,11,0
241791,1,0,3,-3,5,1
79182,3,17,10,7,2,0
331194,4,10,13,-3,11,1
138990,3,14,9,5,12,0
77949,2,3,10,-7,1,0
261165,1,0,0,0,14,1
242460,2,3,7,-4,6,0
210821,4,24,10,14,9,0
133750,2,0,7,-7,9,1
293021,2,3,13,-10,11,0
343741,1,7,0,7,17,1
222393,4,24,10,14,14,0
209574,3,41,20,21,8,0
383409,3,9,9,0,17,1
219975,3,6,21,-15,13,1
142608,2,6,3,3,13,1
30394,1,0,13,-13,14,1
28043,2,7,7,0,13,1
155566,3,23,3,20,2,1
227137,2,7,7,0,16,0
101693,2,10,0,10,12,1
82979,4,13,19,-6,4,0
89237,3,6,0,6,7,0
252587,1,0,0,0,10,0
47818,2,7,6,1,5,0
209425,4,14,17,-3,8,1
365964,1,13,7,6,10,0
246833,4,10,20,-10,8,1
218774,3,0,16,-16,13,1
249080,3,21,17,4,9,0
381857,4,18,21,-3,17,1
419347,4,3,17,-14,16,0
344717,3,6,27,-21,17,0
95292,3,10,24,-14,10,0
350265,1,6,0,6,2,1
99522,4,10,10,0,11,0
212654,4,7,31,-24,10,1
361824,3,37,10,27,7,0
207273,2,0,7,-7,7,0
266807,3,10,14,-4,16,0
289276,1,7,14,-7,9,1
71596,2,3,17,-14,16,1
68013,1,0,10,-10,14,1
45636,3,13,13,0,4,0
252504,3,16,25,-9,10,1
101621,4,13,38,-25,12,1
23650,3,7,13,-6,12,0
273320,3,21,0,21,2,0
299391,2,0,13,-13,14,1
420877,4,17,34,-17,17,1
388181,3,3,13,-10,2,1
366580,3,20,14,6,10,0
373071,3,3,7,-4,13,1
259382,4,35,41,-6,13,1
243340,4,14,30,-16,6,1
168906,4,17,6,11,7,0
90437,2,0,13,-13,7,0
115138,3,10,20,-10,1,0
326441,1,7,3,4,9,0
393575,3,7,19,-12,5,1
341200,2,10,7,3,16,1
386738,1,0,0,0,2,1
49684,3,14,21,-7,6,0
320136,3,17,6,11,6,0
118040,4,20,13,7,2,0
261272,4,38,0,38,14,1
15612,2,14,10,4,8,0
140082,1,0,0,0,12,0
117762,1,0,6,-6,2,1
122486,4,13,33,-20,4,1
106044,4,24,3,21,14,0
187672,2,7,3,4,16,0
345012,4,16,23,-7,17,1
405194,1,0,7,-7,10,0
2814,2,21,21,0,2,0
245259,2,6,3,3,7,1
66553,4,38,31,7,14,0
270046,1,0,3,-3,1,1
379672,1,0,0,0,16,1
342033,4,20,3,17,16,1
199033,1,0,7,-7,4,1
171935,3,7,7,0,9,1
365841,1,7,0,7,9,0
341897,4,30,15,15,16,1
248484,4,17,6,11,8,1
93049,4,13,12,1,8,1
73786,2,6,0,6,17,1
79565,2,0,0,0,2,1
338358,2,3,0,3,14,0
210117,1,0,0,0,9,1
214980,1,3,0,3,11,0
36282,4,24,30,-6,17,0
146857,3,31,0,31,15,0
340673,3,16,13,3,15,0
229856,2,13,0,13,17,0
292194,3,21,14,7,11,1
158656,3,14,7,7,3,1
34193,1,0,0,0,16,0
251511,2,16,13,3,10,0
289094,1,0,0,0,9,1
286449,4,17,9,8,8,0
406061,2,0,13,-13,11,1
19509,4,33,17,16,10,0
56716,2,0,10,-10,9,1
26662,1,0,0,0,13,0
84495,4,20,17,3,4,0
153337,4,2,16,-14,1,1
71775,3,38,30,8,16,0
421005,4,14,28,-14,17,0
374589,3,20,13,7,14,1
159296,4,27,24,3,3,1
314708,4,17,28,-11,3,0
266166,1,7,0,7,16,1
295735,4,10,16,-6,12,1
149262,3,10,13,-3,16,0
276789,2,17,10,7,4,0
253918,4,41,14,27,11,1
293466,1,0,3,-3,11,0
15860,4,8,19,-11,8,0
87150,3,21,10,11,5,0
344881,4,30,10,20,17,1
307929,2,7,0,7,1,0
195306,1,0,0,0,2,0
358166,3,17,9,8,6,1
22487,4,31,29,2,11,0
343149,1,0,0,0,16,1
130740,1,0,3,-3,8,1
264601,4,12,17,-5,16,0
219879,4,51,0,51,13,0
190540,3,17,13,4,17,0
215654,3,14,6,8,11,0
288099,3,10,7,3,9,0
351603,1,0,7,-7,3,1
334776,4,32,11,21,13,0
289160,2,13,7,6,9,1
241353,1,0,0,0,5,1
220457,4,26,21,5,13,0
262765,3,28,10,18,15,1
286796,4,20,31,-11,8,1
228054,3,3,3,0,17,0
371192,3,11,19,-8,12,0
36633,2,10,3,7,17,0
89985,2,2,14,-12,7,1
395648,3,7,17,-10,6,0
58940,4,20,32,-12,10,1
341188,2,10,0,10,16,0
298815,2,14,9,5,14,1
44676,1,0,0,0,3,1
217043,4,23,3,20,12,0
184568,4,42,21,21,14,1
380985,4,9,14,-5,16,0
313087,1,0,0,0,3,0
309394,2,0,0,0,1,0
194713,1,0,0,0,2,0
401017,4,28,15,13,8,1
124927,1,0,0,0,5,1
112584,3,24,19,5,17,0
43299,1,7,0,7,3,0
307357,3,16,22,-6,17,1
87339,4,27,24,3,6,1
139564,3,6,7,-1,12,1
5855,4,34,7,27,3,1
276622,2,7,6,1,4,1
70426,2,14,17,-3,15,1
158317,2,6,14,-8,3,1
414971,2,10,7,3,15,0
211941,1,0,3,-3,9,1
120817,1,7,7,0,3,0
148442,2,7,3,4,16,1
118579,3,24,9,15,2,0
213234,3,10,16,-6,10,1
204499,4,17,24,-7,6,1
66945,4,18,7,11,14,0
385053,5,24,24,0,1,1
169124,4,39,30,9,7,0
171627,2,6,10,-4,9,0
365541,1,7,7,0,9,1
40380,4,15,10,5,2,0
185953,4,29,37,-8,15,0
43590,4,31,3,28,3,1
264590,3,10,17,-7,16,1
2007,4,13,12,1,1,1
49989,3,21,7,14,6,0
103677,3,0,10,-10,13,1
257580,4,19,13,6,13,0
274644,1,7,0,7,3,0
400232,2,10,6,4,8,1
230417,2,14,0,14,1,0
9194,3,3,16,-13,5,0
341453,1,0,0,0,16,0
323748,1,6,0,6,8,0
118783,1,10,0,10,2,0
9200,3,3,23,-20,5,1
61501,1,7,7,0,11,0
321145,2,3,10,-7,6,1
31062,3,13,13,0,15,0
48046,4,10,33,-23,5,0
271117,2,0,10,-10,1,1
272964,1,3,0,3,2,0
111529,3,14,9,5,16,0
172440,4,13,49,-36,9,1
14360,4,2,17,-15,7,1
80624,2,7,10,-3,3,0
303897,2,7,17,-10,16,0
271831,1,0,0,0,2,0
79779,4,20,7,13,2,0
82137,2,3,0,3,3,0
125250,1,0,0,0,5,1
59552,4,13,35,-22,11,1
146992,3,17,0,17,15,1
267168,4,17,10,7,17,0
398106,4,24,28,-4,7,0
31730,1,0,7,-7,15,1
70196,4,30,20,10,15,0
329890,1,0,7,-7,11,1
318216,1,0,0,0,5,0
213446,4,10,41,-31,10,1
163812,4,17,19,-2,5,0
259081,1,0,0,0,13,1
209522,2,27,10,17,8,0
271445,3,14,0,14,1,1
249362,2,10,12,-2,9,1
178101,5,26,23,3,12,0
123971,3,10,7,3,5,1
343742,1,7,0,7,17,1
16890,1,7,13,-6,8,1
168941,4,31,13,18,7,0
54041,2,10,0,10,8,0
67619,3,0,35,-35,14,0
136234,1,6,0,6,11,1
283449,3,20,14,6,7,1
219664,3,10,7,3,13,1
203138,1,0,7,-7,5,1
19436,2,17,14,3,10,0
208403,4,23,43,-20,8,0
170826,1,7,0,7,8,1
284037,3,10,3,7,7,0
23988,4,23,6,17,12,1
342587,3,12,13,-1,16,0
108337,1,0,7,-7,15,0
421780,1,0,0,0,17,0
363536,3,3,5,-2,8,1
370038,3,17,13,4,12,0
235156,4,0,10,-10,2,1
358407,2,16,13,3,6,1
86473,4,30,24,6,5,1
186196,4,16,13,3,15,1
39464,3,13,10,3,1,0
328768,3,17,13,4,10,0
366993,2,0,31,-31,10,1
367503,1,0,0,0,10,1
197294,2,14,0,14,3,0
168484,4,3,24,-21,7,1
398088,3,24,28,-4,7,0
247655,1,0,0,0,8,1
185275,3,27,9,18,15,0
240277,2,7,7,0,5,0
364978,2,7,3,4,9,0
91475,2,12,0,12,8,1
58515,1,0,3,-3,10,1
368985,2,10,7,3,11,1
223373,2,7,12,-5,15,0
288417,3,13,0,13,9,1
78267,2,0,14,-14,2,1
209911,4,30,16,14,8,1
157391,2,3,7,-4,2,1
388658,4,17,6,11,3,0
189797,3,17,6,11,17,0
194913,3,7,10,-3,2,1
338213,2,14,21,-7,14,1
152765,2,6,7,-1,17,1
30103,1,3,0,3,14,1
86140,3,28,3,25,5,0
295513,2,14,7,7,12,0
246235,4,21,16,5,7,0
97567,4,37,7,30,10,0
137561,3,17,27,-10,11,1
157636,4,22,3,19,2,1
17955,2,13,14,-1,9,0
254451,3,20,7,13,11,1
336585,3,7,0,7,14,0
228914,1,7,3,4,17,1
19583,3,14,21,-7,10,1
253395,2,14,21,-7,11,0
237757,5,20,20,0,4,0
271249,1,3,0,3,1,0
56129,3,17,14,3,9,0
415209,4,17,30,-13,15,1
243780,3,24,17,7,6,0
396414,3,20,18,2,6,0
308186,1,0,7,-7,1,1
120184,4,22,6,16,3,1
50269,2,13,14,-1,6,1
186299,2,19,3,16,15,1
61069,1,0,0,0,11,1
214040,4,43,14,29,10,1
301885,2,0,6,-6,15,0
322922,2,13,0,13,7,1
178802,2,24,14,10,12,0
145703,1,0,7,-7,15,1
247010,4,20,31,-11,8,0
219774,2,21,0,21,13,1
16399,3,21,13,8,8,0
202987,1,14,0,14,5,1
142244,1,0,0,0,13,0
32819,2,6,7,-1,15,1
28216,2,10,0,10,13,1
90469,3,0,20,-20,7,1
151525,4,35,7,28,17,1
162087,3,35,13,22,4,0
292454,2,3,6,-3,11,1
93840,2,7,0,7,9,0
232892,1,0,0,0,2,0
356384,4,31,14,17,5,0
160261,1,3,0,3,4,1
199205,2,10,7,3,4,0
155687,2,10,13,-3,2,1
126608,4,23,20,3,6,0
135227,2,13,3,10,10,1
43063,2,3,7,-4,3,0
18042,4,28,28,0,9,1
387974,2,3,0,3,2,0
157737,3,10,10,0,2,1
44206,1,7,0,7,3,0
145615,2,21,0,21,14,0
303066,1,0,0,0,16,0
13592,2,3,7,-4,7,1
51708,1,0,10,-10,7,1
131320,1,0,0,0,8,1
209975,2,0,3,-3,8,1
78527,1,0,7,-7,2,1
100967,3,10,16,-6,12,0
125608,2,14,17,-3,5,1
403575,2,17,7,10,9,1
287815,3,21,17,4,9,1
256377,2,6,0,6,12,0
291439,3,14,20,-6,10,1
265028,2,7,3,4,16,1
9495,3,13,3,10,5,0
76722,4,16,14,2,1,1
77930,1,3,0,3,1,1
168323,3,17,24,-7,7,0
370037,3,17,13,4,12,0
182414,1,0,0,0,14,1
377120,2,10,10,0,15,0
17068,2,13,3,10,9,1
231216,4,10,16,-6,1,1
110564,1,10,7,3,16,1
268036,4,21,9,12,17,1
293747,1,7,0,7,12,0
388435,2,0,6,-6,2,0
15411,4,10,31,-21,8,1
399111,4,10,36,-26,7,1
248486,4,17,6,11,8,1
180371,4,15,14,1,13,1
57850,4,22,17,5,10,1
204226,1,0,7,-7,6,1
82385,4,13,10,3,3,1
366161,3,7,38,-31,10,0
357392,2,14,17,-3,5,1
327191,4,28,17,11,9,0
120001,4,23,31,-8,3,1
293790,2,17,3,14,12,0
181024,1,7,0,7,13,0
9268,1,7,0,7,5,1
284474,3,14,15,-1,7,1
135071,2,17,3,14,10,0
11788,1,14,0,14,6,0
303383,1,7,0,7,16,1
140251,1,0,0,0,12,1
99428,1,0,0,0,11,1
404057,3,10,35,-25,10,1
174102,4,8,36,-28,10,0
366221,1,0,0,0,10,1
163337,4,22,23,-1,5,0
369433,3,31,7,24,11,0
168274,2,10,7,3,7,0
19159,2,21,10,11,10,0
254818,4,20,10,10,11,0
338186,2,7,14,-7,14,0
398139,1,0,0,0,7,0
364283,3,3,29,-26,9,1
1376,2,7,0,7,1,1
311153,1,0,0,0,2,1
81627,1,0,0,0,3,1
241582,3,3,20,-17,5,1
383210,1,14,3,11,17,1
249209,2,9,7,2,9,1
8652,3,7,10,-3,4,1
32631,1,0,0,0,15,1
160212,4,30,14,16,3,1
187698,3,13,6,7,16,1
178319,2,7,3,4,12,0
365349,4,17,19,-2,9,0
358144,3,17,6,11,6,1
259839,1,6,0,6,14,1
75271,2,7,13,-6,17,0
218597,2,7,20,-13,13,1
203013,2,14,0,14,5,0
399366,3,27,7,20,7,0
268069,4,24,16,8,17,0
168998,2,10,14,-4,7,1
258217,1,0,0,0,13,1
245569,2,40,0,40,7,0
334277,3,9,7,2,13,1
411091,4,17,17,0,13,1
41638,3,17,0,17,2,1
241188,4,23,10,13,5,0
210446,2,9,14,-5,9,1
329092,3,17,7,10,10,0
73299,1,0,0,0,17,1
100084,3,6,6,0,12,1
356183,3,19,0,19,5,0
281194,3,24,13,11,6,0
77340,2,7,7,0,1,0
30879,2,3,14,-11,15,1
65987,1,0,0,0,13,0
335698,2,7,7,0,13,1
276126,1,0,0,0,3,1
379156,2,6,3,3,16,0
279472,1,7,0,7,5,1
51468,3,27,24,3,7,0
269768,2,7,0,7,1,0
181174,4,24,21,3,13,1
270521,2,3,7,-4,1,1
345814,1,0,7,-7,17,0
25644,1,7,0,7,12,0
110583,2,17,7,10,16,0
254734,2,3,3,0,11,1
138236,4,10,12,-2,11,1
241176,4,20,10,10,5,0
200928,4,40,7,33,4,0
143583,1,0,0,0,14,0
4904,2,14,7,7,3,1
178346,3,14,17,-3,12,1
249607,4,21,16,5,9,1
356713,3,19,16,3,5,1
101701,2,10,0,10,12,1
103431,4,17,23,-6,13,0
286159,4,24,24,0,8,0
214198,4,22,9,13,11,1
233543,1,7,13,-6,2,0
345040,1,0,0,0,17,0
225974,3,34,20,14,16,1
195899,1,0,7,-7,2,0
191894,4,29,16,13,1,1
199780,1,3,3,0,4,1
377528,2,0,6,-6,15,1
99642,3,23,3,20,11,0
226535,1,0,0,0,16,0
323234,3,7,10,-3,7,1
68380,3,3,14,-11,14,1
321296,3,9,19,-10,6,1
97557,4,30,7,23,10,1
318050,1,0,0,0,5,1
395148,1,3,0,3,5,0
407429,3,14,7,7,11,1
267452,4,20,24,-4,17,0
226260,2,6,0,6,16,1
267197,1,0,0,0,17,1
206492,4,27,0,27,7,0
194594,2,21,0,21,2,1
244446,1,0,0,0,7,0
405698,1,10,0,10,10,1
248875,1,13,0,13,9,1
97922,1,0,7,-7,11,0
234341,3,17,0,17,2,0
310802,4,13,13,0,2,1
354448,2,7,14,-7,4,1
105248,3,7,24,-17,14,1
10198,3,6,3,3,5,1
65904,3,14,14,0,13,1
342783,4,7,14,-7,16,0
226538,1,0,0,0,16,1
351774,2,10,14,-4,3,0
59739,2,6,7,-1,11,0
102424,1,3,0,3,13,0
351754,1,7,13,-6,3,0
246701,4,45,10,35,8,1
31841,4,23,24,-1,15,0
127018,3,24,20,4,6,1
163247,2,3,6,-3,5,1
180299,2,9,7,2,13,1
156758,1,7,7,0,2,0
89160,1,0,0,0,7,0
347840,4,16,8,8,1,0
384804,1,6,3,3,1,1
221463,3,3,38,-35,14,0
47979,2,3,21,-18,5,0
25279,3,33,7,26,12,1
381598,1,0,0,0,17,0
327240,2,6,3,3,9,0
256186,4,30,22,8,12,0
77865,4,17,28,-11,1,0
338349,2,3,0,3,14,0
3827,4,23,10,13,2,1
254883,2,7,7,0,12,1
197414,2,13,3,10,3,1
232954,2,10,3,7,2,1
100639,2,7,7,0,12,0
370057,4,31,20,11,12,1
156653,3,3,7,-4,2,1
123432,1,0,0,0,4,1
247076,2,2,3,-1,8,1
738,1,0,0,0,1,1
402331,4,26,24,2,9,1
82456,2,6,14,-8,3,1
51476,3,27,24,3,7,1
418862,2,7,10,-3,16,1
375253,1,0,0,0,14,0
32411,3,31,6,25,15,0
296141,1,10,6,4,13,1
107643,3,13,20,-7,15,0
344929,2,3,7,-4,17,1
267460,1,0,7,-7,17,1
273305,2,21,0,21,2,0
336228,1,3,0,3,13,0
402845,2,10,0,10,9,0
230426,3,14,3,11,1,1
126925,1,0,0,0,6,1
130899,1,0,0,0,8,0
282708,4,9,20,-11,6,0
231686,4,24,19,5,1,0
267220,2,10,7,3,17,0
167017,2,0,14,-14,7,1
58375,2,21,0,21,10,1
112830,1,7,0,7,17,0
395676,3,10,27,-17,6,0
50253,2,10,14,-4,6,0
148041,3,7,3,4,15,0
13356,4,7,27,-20,7,0
137085,3,17,3,14,11,1
200086,1,7,3,4,4,0
365418,2,7,12,-5,9,0
208437,1,7,0,7,8,1
80559,4,8,10,-2,3,1
208819,4,6,22,-16,8,1
333105,4,20,18,2,12,1
9333,3,21,7,14,5,1
42330,2,0,9,-9,2,1
97719,4,9,13,-4,11,1
249569,3,14,13,1,9,1
49298,1,0,3,-3,6,1
395501,2,14,14,0,6,1
86575,3,30,3,27,5,0
398433,1,0,0,0,7,1
158440,1,0,0,0,3,0
256392,2,6,7,-1,12,1
186197,4,16,13,3,15,1
159291,4,24,24,0,3,1
337417,5,21,21,0,14,0
247070,1,2,3,-1,8,1
259052,4,3,16,-13,13,0
215321,2,14,7,7,11,0
191146,4,28,27,1,17,0
3557,1,14,7,7,2,0
394689,1,0,0,0,5,1
282198,1,3,0,3,6,0
68600,4,28,28,0,14,0
182228,4,33,7,26,13,1
120065,1,3,0,3,3,1
126373,3,10,14,-4,6,0
88693,4,26,20,6,6,0
389613,2,10,7,3,3,0
337276,4,16,26,-10,14,0
115581,3,27,9,18,1,0
52422,4,12,17,-5,7,0
293876,1,0,0,0,12,0
173795,3,16,3,13,10,1
75,2,7,7,0,1,1
181752,3,7,14,-7,13,1
223250,3,3,6,-3,15,0
285237,1,0,6,-6,7,0
47277,1,0,6,-6,5,0
256192,1,0,0,0,12,1
316907,2,9,14,-5,4,0
349264,2,7,21,-14,2,0
40123,1,6,0,6,2,1
269812,3,13,7,6,1,0
354551,4,36,31,5,4,0
50567,2,0,6,-6,6,0
362351,2,16,13,3,8,0
224156,2,0,20,-20,15,1
155542,3,23,3,20,2,0
13851,1,0,0,0,7,1
68570,4,13,28,-15,14,1
4893,2,14,7,7,3,1
282887,5,23,23,0,6,0
335026,3,16,10,6,13,0
71492,3,33,14,19,16,1
364107,2,14,3,11,9,0
151224,3,17,23,-6,17,0
50192,4,6,31,-25,6,1
30550,2,10,0,10,14,0
412155,2,7,3,4,13,0
125899,2,13,10,3,6,0
94808,3,3,9,-6,9,1
137157,4,31,6,25,11,0
324828,2,3,0,3,8,0
333442,4,26,19,7,12,0
349613,4,13,28,-15,2,1
242581,2,3,0,3,6,0
304201,2,13,7,6,16,1
205337,2,20,0,20,6,0
145337,3,35,19,16,14,0
183171,4,22,19,3,14,0
103201,2,3,0,3,13,1
332529,4,30,16,14,12,1
249770,4,35,28,7,9,0
320749,3,14,23,-9,6,1
393091,2,10,3,7,4,0
33331,1,3,0,3,16,0
352585,4,34,20,14,3,0
264200,1,0,7,-7,15,1
92761,4,6,17,-11,8,0
216435,1,7,0,7,12,1
325900,2,3,0,3,9,1
121293,1,0,0,0,3,1
377170,4,13,17,-4,15,1
305516,2,6,0,6,17,0
275216,4,17,29,-12,3,0
327431,3,3,17,-14,9,0
39823,1,3,0,3,1,0
87961,1,0,0,0,6,0
238728,4,19,17,2,4,0
234887,4,3,19,-16,2,1
35713,1,3,0,3,17,1
308326,1,0,0,0,1,0
227279,2,3,20,-17,16,1
365144,3,7,21,-14,9,0
140676,4,38,10,28,12,0
390422,4,7,27,-20,3,1
314686,4,17,21,-4,3,0
309948,1,0,3,-3,2,0
208446,2,10,0,10,8,1
69975,2,21,0,21,15,0
18550,1,3,3,0,9,1
203279,1,0,10,-10,6,0
224308,3,9,12,-3,15,0
289971,4,6,9,-3,10,1
45009,2,10,10,0,4,0
147419,3,23,7,16,15,0
310498,4,20,9,11,2,1
165434,4,6,36,-30,6,1
167109,4,22,34,-12,7,0
320248,2,14,7,7,6,1
106416,2,13,0,13,14,0
312005,4,35,17,18,2,0
399635,3,13,6,7,8,0
61861,3,13,23,-10,12,1
335396,1,0,3,-3,13,0
256991,1,0,7,-7,12,0
414966,2,10,7,3,15,0
80579,1,0,0,0,3,0
14454,2,24,3,21,7,1
284984,4,16,27,-11,7,1
251606,4,19,20,-1,10,1
33943,2,0,27,-27,16,1
268805,4,31,10,21,17,1
87445,4,20,10,10,6,1
93176,2,0,3,-3,9,0
190297,4,7,14,-7,17,0
417064,2,17,0,17,15,1
54678,4,27,29,-2,8,0
25605,4,30,10,20,12,0
241029,5,30,30,0,5,0
267914,1,0,0,0,17,0
170579,3,34,6,28,8,0
72,2,7,7,0,1,1
277909,4,7,20,-13,4,1
154401,1,0,0,0,1,1
109673,1,3,0,3,16,0
248134,2,3,3,0,8,1
306423,2,0,10,-10,17,1
345131,3,15,3,12,17,0
157814,1,0,3,-3,3,0
365052,4,23,6,17,9,0
396538,2,17,7,10,6,1
381459,1,0,0,0,17,1
187294,4,10,13,-3,16,0
253337,1,7,0,7,11,0
42166,1,7,0,7,2,0
374006,3,10,7,3,13,1
281178,3,21,13,8,6,1
244441,1,0,0,0,7,0
85943,2,7,14,-7,5,0
334295,4,9,14,-5,13,1
75676,1,0,0,0,1,1
409250,3,13,6,7,12,0
69185,4,17,17,0,15,1
356255,4,29,14,15,5,1
256504,1,0,0,0,12,1
236603,1,0,0,0,3,1
120834,2,7,14,-7,3,1
48545,2,11,7,4,5,0
235196,1,2,0,2,3,0
186407,1,3,0,3,15,0
412042,2,13,0,13,13,1
106391,1,0,0,0,14,1
161213,1,0,3,-3,4,0
57981,4,13,20,-7,10,0
329779,2,17,13,4,11,0
72615,2,7,0,7,16,1
347850,4,16,8,8,1,1
293305,1,0,0,0,11,0
141599,1,0,0,0,13,1
85474,2,14,3,11,5,1
36830,3,17,26,-9,17,1
20323,2,10,13,-3,10,1
353078,2,7,16,-9,3,1
31602,2,10,6,4,15,1
29286,2,21,7,14,14,0
90302,2,7,14,-7,7,0
410496,4,15,26,-11,13,1
264220,1,3,7,-4,15,0
44786,4,16,19,-3,3,0
372879,2,10,0,10,13,0
129805,1,7,0,7,7,0
317095,4,17,17,0,4,1
168340,4,24,24,0,7,0
226259,2,6,0,6,16,0
387746,4,0,30,-30,2,1
331808,4,23,30,-7,12,0
143626,2,10,10,0,14,1
397808,4,31,21,10,7,0
30536,1,0,0,0,14,1
390668,2,3,3,0,3,0
294400,4,16,9,7,12,1
173461,2,0,7,-7,10,0
57999,5,20,20,0,10,1
384527,1,0,14,-14,1,0
118447,4,20,10,10,2,1
154327,3,20,14,6,1,0
68160,1,0,7,-7,14,1
420904,1,7,7,0,17,1
36967,3,0,32,-32,17,1
155477,1,0,0,0,2,1
251966,1,0,10,-10,10,1
20969,2,14,24,-10,10,0
388901,2,10,14,-4,3,1
206970,1,14,0,14,7,0
41283,1,0,3,-3,2,1
201192,3,20,21,-1,5,0
204970,1,0,0,0,6,1
230268,2,16,10,6,17,0
387953,1,3,0,3,2,1
173946,3,20,19,1,10,0
180509,3,21,20,1,13,1
175439,4,17,23,-6,11,1
66682,4,10,24,-14,14,0
294750,1,0,0,0,12,0
121899,4,0,32,-32,4,0
160325,3,3,14,-11,4,0
21249,2,3,0,3,11,1
7095,2,21,14,7,4,1
292992,1,0,6,-6,11,1
345253,2,13,14,-1,17,1
200557,2,14,7,7,4,0
411890,2,14,0,14,13,0
294476,2,7,7,0,12,0
147823,2,0,7,-7,15,1
47491,2,10,3,7,5,1
252755,2,3,3,0,11,0
121753,4,27,42,-15,4,1
393939,1,0,0,0,5,0
267042,1,0,0,0,17,1
39361,1,0,0,0,1,0
53294,4,3,10,-7,8,1
230230,1,6,0,6,17,1
135340,2,13,10,3,10,1
183017,1,0,0,0,14,1
208530,4,47,15,32,8,1
273925,2,7,6,1,2,1
195667,2,7,7,0,2,0
336664,1,0,0,0,14,0
297968,3,30,7,23,13,0
137520,2,14,14,0,11,0
358658,1,0,0,0,6,1
226322,3,19,7,12,16,1
2988,3,13,17,-4,2,0
374197,4,23,28,-5,13,1
268281,2,10,3,7,17,0
405830,5,24,24,0,10,0
63614,3,13,26,-13,12,0
133765,2,13,7,6,9,1
192040,4,24,27,-3,1,0
107662,4,13,23,-10,15,0
374372,1,7,0,7,14,1
163170,4,22,28,-6,5,1
292823,4,29,24,5,11,1
276825,3,20,20,0,4,1
57702,4,24,24,0,10,0
324444,3,14,6,8,8,1
419117,1,10,0,10,16,0
367029,3,10,38,-28,10,1
104326,2,38,21,17,13,0
152516,3,17,7,10,17,1
121018,2,8,21,-13,3,0
234038,2,20,0,20,2,0
245521,1,21,0,21,7,0
2005,4,10,12,-2,1,1
45980,4,20,3,17,4,0
304676,3,14,7,7,16,1
232724,1,0,0,0,2,0
249950,1,0,0,0,9,1
132873,3,6,14,-8,9,0
171200,3,6,14,-8,8,1
119487,4,14,17,-3,3,0
403841,1,0,0,0,10,1
311147,5,13,16,-3,2,0
173985,1,0,0,0,10,1
10531,3,34,0,34,5,0
333684,3,14,0,14,12,0
150357,3,27,7,20,16,1
388291,2,3,3,0,2,0
188953,4,26,13,13,16,0
113585,2,3,0,3,17,1
85459,2,14,3,11,5,0
394875,2,0,14,-14,5,0
238536,3,16,13,3,4,0
62303,3,21,19,2,12,0
98859,2,7,0,7,11,0
204351,4,3,17,-14,6,0
334559,3,21,17,4,13,1
177443,3,17,10,7,11,1
318454,3,30,7,23,5,1
412615,2,3,3,0,14,0
421701,3,17,10,7,17,1
223496,2,7,3,4,15,0
162512,3,21,10,11,4,1
408047,3,10,10,0,12,0
300707,1,7,0,7,15,1
103207,2,3,0,3,13,0
340001,2,14,6,8,15,1
51173,2,24,3,21,7,0
383916,1,0,0,0,1,0
343483,2,7,7,0,16,1
159691,1,7,7,0,3,0
198850,4,13,36,-23,3,1
286386,2,7,0,7,8,1
137046,2,7,0,7,11,0
219542,4,21,21,0,13,0
293833,4,17,12,5,12,1
250246,1,0,0,0,9,0
106397,1,7,0,7,14,0
365381,1,7,0,7,9,0
126714,3,7,13,-6,6,1
294444,4,19,12,7,12,1
171023,2,10,16,-6,8,0
162686,3,23,24,-1,5,0
340433,1,0,0,0,15,0
176232,4,14,24,-10,11,0
213164,1,3,0,3,10,0
409834,2,13,0,13,12,0
228608,1,10,14,-4,17,0
128668,3,6,17,-11,7,1
342170,4,15,19,-4,16,0
348440,4,13,26,-13,1,1
17031,1,7,0,7,9,0
84278,2,7,21,-14,4,1
144100,2,13,0,13,14,1
157565,2,5,0,5,2,1
69808,2,7,0,7,15,0
302338,2,7,3,4,15,1
391383,1,7,10,-3,4,1
151414,1,0,0,0,17,1
342222,1,3,0,3,16,1
195996,4,7,27,-20,2,0
51300,2,6,10,-4,7,1
142801,3,12,10,2,13,0
340933,3,0,10,-10,15,1
419833,1,0,3,-3,17,0
284604,2,14,7,7,7,0
168938,4,31,13,18,7,0
123035,3,7,13,-6,4,0
288470,1,0,0,0,9,0
93999,2,0,20,-20,9,0
34939,4,27,24,3,16,0
253047,2,7,0,7,11,0
262750,3,21,0,21,15,0
48952,4,22,20,2,5,0
210961,4,33,23,10,9,1
56832,5,20,20,0,9,1
180283,2,6,7,-1,13,1
151561,1,0,0,0,17,0
175979,1,7,0,7,11,1
37423,4,24,0,24,17,0
288513,2,3,14,-11,9,0
186958,3,7,12,-5,15,1
145919,2,7,7,0,15,1
341490,2,0,7,-7,16,1
418953,1,6,0,6,16,1
410733,3,17,6,11,13,1
102201,3,24,7,17,13,0
1643,1,0,0,0,1,0
85962,3,14,14,0,5,1
261832,2,6,10,-4,14,1
259639,4,9,6,3,13,1
181602,3,16,6,10,13,1
44146,3,10,20,-10,3,1
276821,3,20,17,3,4,0
181641,4,23,6,17,13,1
52110,4,13,19,-6,7,1
210530,1,0,0,0,9,1
231631,3,14,13,1,1,0
125926,3,16,10,6,6,0
72518,3,16,17,-1,16,0
392187,3,3,13,-10,4,1
180914,2,10,7,3,13,1
188697,2,0,17,-17,16,1
26504,4,30,29,1,13,0
74600,4,10,3,7,17,1
344245,2,7,13,-6,17,1
270711,3,6,3,3,1,0
162059,3,21,13,8,4,1
144163,4,23,13,10,14,1
54514,3,14,10,4,8,0
268020,3,21,9,12,17,0
221295,3,6,29,-23,14,0
317643,2,6,3,3,5,0
406467,1,0,3,-3,11,0
218200,3,30,3,27,12,1
92499,1,0,0,0,8,1
20925,1,7,6,1,10,0
9211,3,3,23,-20,5,1
332417,2,7,3,4,12,1
98722,2,21,3,18,11,0
199483,1,6,0,6,4,1
144116,3,23,0,23,14,0
228954,2,14,9,5,17,0
395830,3,3,14,-11,6,0
130658,3,7,35,-28,8,1
87906,3,13,15,-2,6,0
205130,1,0,0,0,6,1
326323,2,0,10,-10,9,1
150260,1,7,0,7,16,0
147805,1,0,7,-7,15,0
209738,3,9,6,3,8,0
369220,1,0,7,-7,11,1
308580,3,9,9,0,1,0
331145,2,7,13,-6,11,0
337913,2,10,0,10,14,1
168435,3,0,17,-17,7,0
28763,1,0,0,0,14,0
10374,3,10,38,-28,5,1
267374,2,0,7,-7,17,0
224898,2,0,6,-6,15,1
71442,2,24,7,17,16,1
46892,2,13,12,1,5,0
282605,1,0,7,-7,6,1
402270,2,10,16,-6,9,1
386437,4,23,17,6,2,1
203084,4,36,17,19,5,1
362421,4,30,20,10,8,0
294940,2,7,7,0,12,1
258006,3,0,28,-28,13,1
244491,2,19,3,16,7,0
235792,1,0,0,0,3,1
7680,1,0,0,0,4,1
357777,1,3,7,-4,6,0
290777,1,0,0,0,10,1
202531,1,0,3,-3,5,1
382221,2,10,3,7,17,1
419412,1,3,0,3,16,0
265491,3,7,7,0,16,1
390013,4,31,25,6,3,0
178832,3,27,14,13,12,1
386776,2,7,7,0,2,1
132679,2,3,10,-7,9,1
35060,3,15,10,5,16,0
68333,2,3,7,-4,14,1
204378,1,0,3,-3,6,1
116315,3,24,13,11,1,0
58599,4,10,17,-7,10,0
171571,1,0,0,0,9,1
183482,1,0,0,0,14,1
327139,3,14,17,-3,9,1
414904,4,35,13,22,15,1
119394,2,0,14,-14,3,0
112100,2,7,17,-10,17,0
345722,3,7,7,0,17,1
230155,3,3,23,-20,17,0
307862,4,27,28,-1,1,0
252672,3,6,3,3,10,0
221065,1,0,0,0,14,1
32946,2,0,14,-14,15,0
169442,4,13,31,-18,8,0
227356,4,20,37,-17,16,0
384757,4,19,37,-18,1,0
84446,2,6,10,-4,4,0
267337,1,0,7,-7,17,1
50171,4,0,24,-24,6,1
347866,1,0,0,0,1,0
20958,2,7,23,-16,10,0
263518,4,20,23,-3,15,0
206513,1,0,0,0,7,0
109013,3,16,27,-11,15,0
176422,4,22,28,-6,11,1
229210,1,0,0,0,17,1
291995,2,6,3,3,11,0
171618,2,6,3,3,9,0
161687,1,7,0,7,4,1
8204,2,0,7,-7,4,0
133276,1,0,0,0,9,0
263189,3,3,17,-14,15,1
54961,3,3,3,0,8,1
359142,2,7,0,7,6,0
162712,4,26,24,2,5,1
107183,2,0,21,-21,15,0
222682,3,14,24,-10,14,0
246514,3,19,7,12,8,1
62137,3,7,7,0,12,0
4394,3,7,14,-7,2,0
87012,3,14,15,-1,5,0
393323,1,0,0,0,5,1
274946,4,17,16,1,3,0
43736,4,24,17,7,3,1
223751,4,40,13,27,15,0
170895,3,7,20,-13,8,1
91887,1,0,0,0,8,0
410413,2,6,10,-4,13,0
4787,3,20,0,20,3,0
134230,3,3,23,-20,10,1
267766,1,0,0,0,17,1
1451,4,19,7,12,1,1
34995,1,6,0,6,16,1
388818,4,14,14,0,3,1
370314,3,7,35,-28,12,1
410075,1,14,7,7,13,1
96985,4,22,17,5,10,1
377406,3,7,13,-6,15,0
112612,4,31,34,-3,17,0
228107,4,13,10,3,17,0
391210,4,10,24,-14,4,0
274887,3,7,16,-9,3,1
95929,5,23,23,0,10,0
16006,4,18,14,4,8,1
126636,1,0,0,0,6,1
128602,1,3,0,3,7,0
239833,2,7,0,7,4,0
142679,4,20,20,0,13,0
403403,1,0,0,0,9,1
376558,3,15,6,9,14,1
169073,3,33,14,19,7,0
187842,3,7,13,-6,16,1
296890,2,10,0,10,13,0
360971,4,37,5,32,7,1
312805,2,0,0,0,3,1
141720,4,30,21,9,13,1
415811,1,0,0,0,15,0
274730,3,17,12,5,3,1
105390,3,23,7,16,14,0
213850,3,45,7,38,10,1
218539,1,0,7,-7,13,1
103141,1,0,0,0,13,0
260367,3,6,0,6,14,0
4921,2,14,7,7,3,0
306078,4,17,13,4,17,1
201831,3,20,23,-3,5,0
312408,4,20,34,-14,3,1
136304,3,18,7,11,11,0
282347,2,7,7,0,6,1
212974,4,21,7,14,10,0
66566,1,0,7,-7,14,0
236184,3,17,16,1,3,0
303462,3,22,10,12,16,1
217824,1,3,7,-4,12,0
356138,2,10,0,10,5,0
278743,1,0,0,0,5,0
53227,2,3,0,3,8,0
52157,1,0,0,0,7,1
320447,3,17,10,7,6,1
53501,1,7,0,7,8,0
322875,1,6,0,6,7,0
352174,4,15,27,-12,3,1
359244,5,28,28,0,6,1
92683,2,3,10,-7,8,0
198748,1,3,3,0,3,0
203044,3,20,3,17,5,1
217780,4,10,10,0,12,0
81081,2,0,14,-14,3,1
33650,2,14,0,14,16,1
50957,1,0,7,-7,6,1
400941,2,13,7,6,8,1
7597,3,21,3,18,4,1
10283,1,0,7,-7,5,1
318423,2,21,7,14,5,1
173037,3,21,6,15,9,1
311092,3,10,3,7,2,1
111495,2,7,0,7,16,0
378985,1,0,0,0,15,1
74406,3,10,10,0,17,0
291069,1,6,0,6,10,0
258904,4,20,26,-6,13,0
392069,4,18,30,-12,4,0
325584,2,7,6,1,9,0
336046,4,16,25,-9,13,0
278132,1,7,7,0,4,0
33578,4,17,10,7,16,0
181496,5,31,31,0,13,0
48228,1,0,3,-3,5,0
168781,4,16,9,7,7,0
303872,1,0,7,-7,16,0
290284,4,17,15,2,10,1
143094,3,17,17,0,13,0
66065,3,7,3,4,13,1
178606,1,3,3,0,12,1
418741,2,7,7,0,16,0
95695,3,10,6,4,10,0
263610,2,14,7,7,15,0
397210,4,13,0,13,6,1
54654,3,14,22,-8,8,0
33737,1,0,0,0,16,1
312080,2,17,7,10,2,0
297209,2,0,3,-3,13,0
309116,2,16,3,13,1,1
260402,4,20,7,13,14,0
144158,4,23,13,10,14,0
18183,4,20,20,0,9,1
50332,4,13,23,-10,6,1
93704,2,0,3,-3,9,1
197927,4,18,7,11,3,0
403020,3,13,21,-8,9,0
302154,1,0,0,0,15,1
33165,4,17,42,-25,16,0
198451,2,10,3,7,3,1
311765,2,7,13,-6,2,1
297134,4,31,6,25,13,1
364056,1,0,0,0,9,0
385569,2,3,17,-14,1,1
179326,4,39,11,28,12,0
180345,3,12,14,-2,13,1
154851,1,3,0,3,1,1
78435,3,17,0,17,2,1
380103,4,35,30,5,16,1
410070,1,13,7,6,13,1
117369,3,34,3,31,2,0
90895,3,34,7,27,7,1
227378,1,0,0,0,16,0
293701,4,10,13,-3,12,1
141905,4,27,21,6,13,0
350793,4,17,10,7,2,1
125609,2,14,17,-3,5,1
311808,3,17,20,-3,2,1
85807,3,13,13,0,5,1
281820,3,10,0,10,6,0
240692,4,36,31,5,5,1
206041,1,0,0,0,7,0
226031,5,34,34,0,16,0
73716,4,20,9,11,17,0
326602,1,10,3,7,9,0
131376,2,7,13,-6,8,1
127527,4,3,23,-20,6,0
220703,3,10,6,4,13,1
177483,4,27,17,10,11,1
332270,1,0,3,-3,12,1
352252,3,3,3,0,3,0
101189,1,0,7,-7,12,0
165138,4,24,24,0,6,0
79930,3,10,16,-6,2,1
11009,4,9,31,-22,5,0
51592,2,7,10,-3,7,1
189267,1,0,0,0,16,1
282088,2,9,8,1,6,1
62981,2,6,7,-1,12,0
26249,2,7,14,-7,13,0
268387,1,0,0,0,17,1
319318,3,10,16,-6,6,0
355720,2,7,3,4,5,0
244400,3,0,17,-17,7,1
220166,4,29,13,16,13,0
381608,1,0,0,0,17,1
393773,4,7,14,-7,5,1
60810,2,10,10,0,11,0
404360,3,20,6,14,10,0
352545,2,20,13,7,3,1
396285,3,3,6,-3,6,1
293753,1,7,0,7,12,0
119237,2,7,3,4,3,0
246734,1,3,0,3,8,0
249077,3,21,17,4,9,0
390576,4,17,21,-4,3,1
164540,4,23,17,6,5,1
181401,2,17,14,3,13,0
386710,4,17,19,-2,2,0
303124,2,7,14,-7,16,1
235693,2,0,10,-10,3,1
385846,4,33,3,30,1,0
64360,4,19,27,-8,13,1
98087,1,0,0,0,11,1
116100,1,0,0,0,1,0
284664,3,14,27,-13,7,0
25528,2,7,7,0,12,1
279017,4,13,33,-20,5,0
264203,1,0,7,-7,15,1
122104,2,10,14,-4,4,1
136115,2,3,10,-7,10,0
216418,4,21,23,-2,12,1
408040,3,10,10,0,12,1
109262,2,6,0,6,15,0
220062,1,13,0,13,13,0
404346,3,20,6,14,10,0
265354,2,7,10,-3,16,0
93095,5,20,20,0,8,1
282885,4,23,23,0,6,0
21847,2,7,0,7,11,0
288907,4,19,31,-12,9,0
125569,1,7,7,0,5,1
392575,4,10,27,-17,4,1
248475,3,10,6,4,8,0
6876,4,10,31,-21,3,1
403518,4,24,19,5,9,0
296820,4,14,7,7,13,0
19587,3,14,21,-7,10,0
317011,2,0,10,-10,4,1
70635,4,17,17,0,15,0
192136,2,0,6,-6,1,0
417076,3,20,0,20,15,1
255261,4,13,17,-4,12,0
369694,2,16,17,-1,11,1
383196,1,14,0,14,17,0
227934,3,27,20,7,16,0
150726,2,13,9,4,17,0
110797,3,6,10,-4,16,1
125051,4,3,19,-16,5,0
243785,4,24,17,7,6,0
266411,4,36,8,28,16,0
342597,3,19,20,-1,16,0
3532,1,0,0,0,2,1
300418,1,2,0,2,14,0
330670,2,6,3,3,11,1
204783,4,21,21,0,6,1
393157,4,27,3,24,4,0
414565,3,21,9,12,14,0
184720,4,17,27,-10,15,1
308037,1,0,0,0,1,1
188354,1,0,0,0,16,0
287015,2,13,14,-1,8,1
150004,3,14,3,11,16,0
123883,1,0,0,0,5,0
420276,2,7,0,7,17,0
360194,4,17,13,4,7,1
117550,4,17,20,-3,2,0
156416,1,0,0,0,2,1
260708,4,13,25,-12,14,0
326014,1,9,0,9,9,0
61340,1,0,0,0,11,1
149175,4,30,31,-1,16,1
234833,3,0,12,-12,2,1
419662,4,30,23,7,17,1
415520,1,0,0,0,15,0
183039,1,7,0,7,14,0
293836,4,24,12,12,12,0
384635,4,10,59,-49,1,0
34982,1,6,0,6,16,0
288939,1,6,0,6,9,0
255919,2,3,3,0,12,1
418312,3,6,21,-15,16,1
190714,4,42,17,25,17,1
181769,4,7,17,-10,13,1
372749,2,0,0,0,13,1
416320,2,13,3,10,15,0
269153,5,16,16,0,17,1
59684,4,24,6,18,11,1
51864,2,6,7,-1,7,0
300378,4,10,7,3,14,1
28242,3,17,0,17,13,1
352716,3,17,6,11,3,1
283456,3,23,14,9,7,0
362909,1,7,0,7,8,1
328540,4,15,3,12,10,0
395616,2,7,10,-3,6,1
206822,2,0,6,-6,7,0
367737,4,13,13,0,10,0
40478,3,7,17,-10,2,0
120924,4,31,31,0,3,1
227062,4,17,9,8,16,1
27542,4,23,12,11,13,1
220311,4,26,9,17,13,0
291114,2,15,13,2,10,0
37525,3,10,7,3,17,0
222283,1,0,0,0,14,0
56776,4,14,13,1,9,0
158534,3,10,17,-7,3,1
331821,1,0,0,0,12,0
236679,3,17,7,10,3,0
276771,2,17,10,7,4,1
389105,3,30,0,30,3,0
101928,4,6,13,-7,12,1
304157,1,0,0,0,16,0
22466,3,24,27,-3,11,0
60268,4,10,16,-6,11,0
129779,4,17,24,-7,7,0
56408,2,0,28,-28,9,1
13687,1,0,0,0,7,0
108555,3,17,14,3,15,0
232401,4,20,22,-2,1,0
245879,2,3,30,-27,7,1
323393,3,17,0,17,7,1
115503,1,0,0,0,1,1
36042,2,10,0,10,17,1
12676,2,24,0,24,6,0
28913,1,0,0,0,14,1
70643,4,17,20,-3,15,1
345508,1,7,10,-3,17,0
132774,4,20,31,-11,9,1
20648,2,6,14,-8,10,1
298063,2,0,14,-14,13,1
321977,1,0,0,0,7,0
242620,3,10,0,10,6,0
173691,4,26,28,-2,10,1
89020,1,0,0,0,6,1
399959,4,12,13,-1,8,0
138024,2,22,17,5,11,0
128005,4,23,33,-10,6,1
6234,2,13,0,13,3,0
201500,3,25,7,18,5,0
359683,1,0,0,0,6,1
122094,2,10,7,3,4,0
71954,4,25,16,9,16,0
198903,2,3,16,-13,3,1
164714,1,6,0,6,6,0
374892,4,14,11,3,14,0
169067,3,33,14,19,7,0
61991,2,3,7,-4,12,1
295212,2,14,0,14,12,0
8076,3,17,7,10,4,0
308029,4,21,12,9,1,1
359663,4,40,7,33,6,0
67994,1,0,0,0,14,0
99418,1,0,0,0,11,1
44413,2,3,0,3,3,1
243154,4,20,22,-2,6,1
264529,2,7,14,-7,16,1
105637,1,7,0,7,14,0
51435,2,3,17,-14,7,1
153396,2,10,10,0,1,0
266675,3,29,3,26,16,1
123668,3,7,22,-15,4,1
190954,2,9,0,9,17,1
221580,3,20,15,5,14,0
374992,2,21,27,-6,14,1
251987,2,6,13,-7,10,1
135320,1,0,10,-10,10,1
93381,1,0,0,0,9,1
246640,2,24,3,21,8,1
54931,2,0,3,-3,8,0
286954,4,26,19,7,8,1
395378,3,28,3,25,5,1
88198,3,14,17,-3,6,0
179961,1,0,6,-6,13,1
84224,1,0,0,0,4,1
291692,2,0,3,-3,11,0
309964,2,3,3,0,2,1
249001,1,0,0,0,9,0
228925,2,7,9,-2,17,0
193090,2,13,6,7,1,0
160960,2,10,7,3,4,0
266541,4,10,22,-12,16,1
60924,1,0,3,-3,11,1
64284,2,3,10,-7,13,1
104680,4,7,3,4,14,1
320760,3,17,23,-6,6,0
49165,2,10,0,10,6,0
352338,1,7,0,7,3,0
249448,4,18,15,3,9,0
228833,3,6,17,-11,17,1
71452,2,30,7,23,16,0
191194,1,0,10,-10,17,1
272474,1,0,0,0,2,1
260674,3,10,22,-12,14,0
265774,3,10,3,7,16,1
173275,1,7,9,-2,10,0
368852,2,24,0,24,11,0
395092,3,10,31,-21,5,1
164606,2,7,17,-10,5,1
286657,1,7,0,7,8,0
160128,1,7,0,7,3,1
401091,2,21,3,18,8,0
122736,3,7,17,-10,4,1
15458,2,6,0,6,8,1
131909,4,34,7,27,8,0
269830,3,15,10,5,1,1
126493,2,0,6,-6,6,1
213424,4,10,41,-31,10,1
373382,3,10,7,3,13,0
124851,2,0,6,-6,5,1
226826,1,0,0,0,16,0
378232,1,0,0,0,15,0
172228,3,7,13,-6,9,1
360688,1,0,0,0,7,0
10959,3,9,28,-19,5,1
346887,4,23,13,10,1,0
201267,1,7,0,7,5,0
296107,4,15,17,-2,13,1
221414,2,3,24,-21,14,1
156121,2,7,7,0,2,1
26902,3,10,6,4,13,1
257295,1,0,0,0,13,0
401355,1,3,0,3,8,1
413778,4,27,16,11,14,0
129959,1,0,0,0,8,0
378235,1,0,0,0,15,1
368434,3,23,7,16,11,0
291867,2,7,7,0,11,0
335059,4,16,20,-4,13,1
139380,2,14,0,14,12,0
68513,2,0,14,-14,14,0
235994,2,10,0,10,3,0
392657,3,13,0,13,4,0
239079,1,0,3,-3,4,1
260772,2,3,6,-3,14,0
357548,3,10,6,4,5,0
12925,5,13,13,0,6,0
401378,2,17,0,17,8,0
158653,2,14,7,7,3,0
141669,2,23,14,9,13,0
189286,1,3,0,3,16,1
387689,2,0,13,-13,2,0
312174,1,0,0,0,2,0
379471,3,16,0,16,16,1
80846,4,3,3,0,3,1
310419,2,14,0,14,2,0
341048,2,7,14,-7,15,0
197606,3,19,0,19,3,1
178059,4,20,23,-3,12,0
254113,2,0,6,-6,11,1
352866,4,14,13,1,3,1
353236,2,14,17,-3,4,1
284950,3,10,14,-4,7,1
240971,4,21,16,5,5,1
365237,1,0,7,-7,9,1
156069,4,20,24,-4,2,0
5664,3,0,14,-14,3,0
333157,1,0,0,0,12,0
408133,2,3,0,3,12,0
118823,2,20,0,20,2,0
56289,3,3,20,-17,9,1
71463,3,30,7,23,16,1
148346,3,14,3,11,16,1
315101,4,44,14,30,4,1
119748,2,10,3,7,3,0
6321,4,19,25,-6,3,0
318817,1,7,0,7,5,0
86375,1,7,0,7,5,1
342537,2,3,6,-3,16,0
269044,2,10,13,-3,17,1
129146,4,34,28,6,7,1
320235,2,14,0,14,6,1
65300,2,3,21,-18,13,1
104442,1,0,10,-10,13,1
153185,4,20,20,0,1,0
284805,3,26,20,6,7,1
279491,2,10,6,4,5,1
417481,2,10,21,-11,16,1
104246,2,3,0,3,13,1
93570,2,6,3,3,9,1
367135,2,29,13,16,10,0
149901,4,6,16,-10,16,0
248597,2,7,3,4,9,1
214003,3,36,7,29,10,0
159392,2,10,13,-3,3,1
419852,2,0,6,-6,17,1
21158,3,0,16,-16,10,1
15663,3,34,10,24,8,0
228290,1,0,0,0,17,0
273007,2,3,3,0,2,1
328162,3,6,14,-8,10,0
7683,1,3,0,3,4,1
414459,4,16,23,-7,14,1
344077,1,3,3,0,17,1
385556,2,0,10,-10,1,0
384481,4,28,0,28,1,0
309064,1,0,0,0,1,1
175703,3,23,6,17,11,0
333967,2,14,10,4,12,1
369161,3,19,7,12,11,1
127236,5,16,16,0,6,0
84325,3,21,27,-6,4,0
322380,3,14,16,-2,7,1
215950,3,13,28,-15,11,1
152439,1,7,0,7,17,0
272097,3,17,6,11,2,0
356053,3,24,10,14,5,0
227404,1,0,7,-7,16,0
130527,3,10,6,4,8,0
230354,4,26,17,9,17,1
194029,3,17,7,10,1,0
84349,4,28,30,-2,4,0
193507,1,0,0,0,1,1
106335,3,14,19,-5,14,1
152105,4,13,10,3,17,0
38980,3,30,10,20,1,1
99751,2,0,0,0,12,0
395234,3,10,13,-3,5,1
414653,1,0,0,0,14,1
150453,2,27,3,24,16,0
104839,4,27,33,-6,14,1
382384,2,0,14,-14,17,0
150333,3,24,7,17,16,1
313006,3,10,0,10,3,0
17503,2,13,0,13,9,0
161932,3,13,16,-3,4,1
245935,4,13,37,-24,7,1
74323,1,0,0,0,17,0
65129,2,0,0,0,13,0
323471,2,0,3,-3,7,1
95256,2,3,10,-7,10,1
397016,3,21,6,15,6,0
416910,2,3,7,-4,15,0
59063,3,3,16,-13,10,0
110003,2,20,10,10,16,0
372544,5,29,27,2,13,1
46854,1,10,3,7,5,1
150154,2,3,13,-10,16,1
55972,2,10,13,-3,9,0
72191,2,10,10,0,16,1
242513,4,15,13,2,6,1
143114,4,24,24,0,13,0
309071,1,3,0,3,1,0
180175,3,10,0,10,13,1
270635,1,0,0,0,1,0
2879,4,31,31,0,2,1
243351,4,20,30,-10,6,1
164384,3,23,3,20,5,1
111595,1,0,0,0,16,0
241439,4,7,35,-28,5,1
128574,4,28,35,-7,7,1
323894,4,16,33,-17,8,1
184741,1,7,0,7,15,0
312419,4,26,40,-14,3,0
114942,2,0,3,-3,1,1
278748,1,0,0,0,5,1
200566,2,14,7,7,4,0
185280,3,27,16,11,15,1
134795,3,41,17,24,10,0
389229,3,21,7,14,3,1
207918,3,28,14,14,8,1
238099,5,13,13,0,4,1
204568,2,0,35,-35,6,0
394381,4,31,17,14,5,1
273838,4,17,14,3,2,0
263779,3,0,21,-21,15,0
42034,2,13,7,6,2,0
89893,4,30,20,10,7,1
251913,4,20,19,1,10,0
202159,3,13,6,7,5,1
186596,2,17,0,17,15,0
116757,3,13,26,-13,2,1
388232,4,14,13,1,2,0
394902,3,0,17,-17,5,0
194612,2,21,7,14,2,1
332521,4,29,16,13,12,1
344645,2,3,10,-7,17,1
381646,2,10,0,10,17,0
346970,2,7,3,4,1,1
250125,1,7,0,7,9,0
341375,3,0,10,-10,16,1
350770,3,10,3,7,2,1
346885,4,23,13,10,1,0
79678,1,0,0,0,2,0
383228,2,21,3,18,17,1
138951,2,7,3,4,12,1
222100,4,33,17,16,14,1
420715,5,21,28,-7,17,1
16729,1,0,0,0,8,0
313855,2,14,10,4,3,0
369247,2,14,7,7,11,1
262115,2,14,3,11,15,1
332654,4,27,20,7,12,0
84186,4,10,10,0,4,1
21361,1,0,0,0,11,0
10402,4,10,45,-35,5,1
63264,1,0,0,0,12,0
12115,3,7,7,0,6,1
396162,4,24,23,1,6,0
6970,3,0,7,-7,3,1
352858,3,14,10,4,3,0
306121,1,0,0,0,17,1
132756,4,20,24,-4,9,1
21266,2,3,7,-4,11,1
254683,1,0,0,0,11,1
234876,4,3,12,-9,2,1
272069,2,10,6,4,2,0
219658,3,10,7,3,13,0
233661,1,0,0,0,2,1
199625,1,0,0,0,4,0
119997,4,23,24,-1,3,0
245465,4,23,6,17,7,0
337147,1,3,0,3,14,1
70344,4,10,33,-23,15,0
175638,1,0,0,0,11,1
7690,1,9,0,9,4,1
15687,4,37,17,20,8,1
89407,3,10,20,-10,7,1
235993,2,10,0,10,3,0
149340,1,0,0,0,16,1
312912,4,21,24,-3,3,1
367893,4,20,20,0,10,1
309699,2,10,6,4,1,1
167495,2,0,3,-3,7,0
325329,3,12,10,2,8,0
239224,1,0,7,-7,4,1
85206,3,10,16,-6,4,0
10246,4,13,10,3,5,0
292153,2,21,0,21,11,0
303304,3,27,0,27,16,1
272325,1,7,0,7,2,0
385667,5,24,24,0,1,1
342692,2,0,0,0,16,1
212563,1,7,3,4,10,0
390436,4,14,27,-13,3,0
337853,4,30,12,18,14,1
242192,3,16,7,9,6,1
323700,4,20,0,20,8,0
187257,3,10,6,4,16,0
318930,4,31,28,3,5,0
90335,4,14,26,-12,7,0
410612,4,17,17,0,13,1
65000,2,0,7,-7,13,0
78663,1,0,0,0,2,1
314981,4,0,20,-20,4,0
294417,4,19,9,10,12,0
411837,4,7,34,-27,13,1
372005,2,10,0,10,13,1
277987,2,3,7,-4,4,1
328643,3,20,35,-15,10,1
7291,4,17,13,4,4,1
270876,3,16,13,3,1,1
126588,4,16,13,3,6,0
269909,1,7,0,7,1,1
165648,2,0,7,-7,6,1
314373,4,10,17,-7,3,1
287662,3,9,10,-1,9,1
317698,4,23,16,7,5,1
262781,4,28,17,11,15,1
100298,1,6,7,-1,12,0
185449,4,17,10,7,15,0
116215,4,31,19,12,1,0
86830,2,9,13,-4,5,1
82787,3,9,9,0,3,1
134880,1,7,0,7,10,0
269163,1,0,0,0,17,0
105507,2,26,7,19,14,0
44732,2,7,12,-5,3,0
278813,3,7,21,-14,5,1
400295,4,31,9,22,8,1
379265,1,0,3,-3,16,1
125014,3,3,3,0,5,0
98570,2,0,7,-7,11,1
272845,2,20,0,20,2,1
331077,4,52,24,28,11,1
102956,3,12,31,-19,13,1
204583,2,0,38,-38,6,0
198673,4,15,21,-6,3,0
112947,1,0,0,0,17,0
254180,3,3,18,-15,11,1
333048,2,9,12,-3,12,1
308324,1,0,0,0,1,0
297582,4,21,7,14,13,0
143904,1,0,0,0,14,0
283312,3,10,9,1,7,1
354364,3,38,3,35,4,1
207686,1,0,7,-7,7,1
181801,1,0,0,0,13,1
197753,3,14,17,-3,3,1
17696,3,14,6,8,9,0
375571,1,0,0,0,14,0
219388,4,23,20,3,13,1
136940,3,3,13,-10,11,1
87746,4,6,20,-14,6,1
71047,3,20,0,20,16,0
67739,2,21,0,21,14,0
11815,2,27,16,11,6,0
237083,3,0,26,-26,3,0
341667,2,17,13,4,16,1
253620,4,9,17,-8,11,1
30735,3,23,21,2,15,1
41425,1,2,0,2,2,0
217648,4,26,16,10,12,0
324225,1,3,0,3,8,0
36706,4,23,10,13,17,0
305083,2,21,7,14,16,0
245403,2,9,3,6,7,0
328901,2,6,0,6,10,0
298861,4,21,9,12,14,0
398199,2,14,10,4,7,1
267213,1,3,7,-4,17,1
336185,4,17,10,7,13,1
271339,4,16,24,-8,1,0
311726,1,0,0,0,2,0
53157,4,19,38,-19,7,1
286292,3,16,16,0,8,0
218959,4,48,27,21,13,0
164763,3,23,14,9,6,1
364809,1,3,0,3,9,0
419630,3,23,16,7,17,0
413180,4,46,45,1,14,0
90305,3,7,17,-10,7,0
347312,3,7,21,-14,1,1
405794,4,21,21,0,10,0
395074,3,3,24,-21,5,1
3001,3,13,31,-18,2,0
183737,1,0,6,-6,14,0
282329,1,7,0,7,6,0
62569,2,3,7,-4,12,0
139825,2,10,10,0,12,0
176579,5,19,20,-1,11,0
138417,1,7,0,7,12,0
265186,2,6,3,3,16,0
212607,2,7,17,-10,10,0
238090,4,13,13,0,4,0
223846,2,9,0,9,15,0
341869,3,16,15,1,16,1
173497,3,3,20,-17,10,1
98597,3,7,7,0,11,1
988,4,0,6,-6,1,0
388518,4,3,23,-20,2,0
65397,1,0,7,-7,13,0
172302,5,24,23,1,9,1
342281,3,13,3,10,16,0
158433,1,0,0,0,3,1
309546,2,6,0,6,1,0
51921,3,13,10,3,7,1
58004,5,20,20,0,10,1
180281,2,6,0,6,13,0
251918,4,20,19,1,10,1
117838,3,9,13,-4,2,1
54281,4,0,6,-6,8,0
288882,3,13,24,-11,9,0
316144,3,24,26,-2,4,1
347429,1,3,13,-10,1,1
54034,2,3,0,3,8,1
355654,4,38,17,21,5,1
126624,5,23,23,0,6,0
96808,4,7,17,-10,10,0
268589,2,7,6,1,17,1
74130,4,23,6,17,17,1
187101,3,10,0,10,16,0
264038,1,7,7,0,15,1
350137,1,0,0,0,2,1
264638,4,20,20,0,16,1
209674,2,6,0,6,8,1
390856,3,3,28,-25,3,1
380918,2,3,0,3,16,1
345417,3,0,10,-10,17,0
72101,4,10,17,-7,16,1
218954,4,48,27,21,13,0
33557,3,17,3,14,16,1
181594,3,13,6,7,13,1
119773,2,10,6,4,3,1
59418,1,0,7,-7,11,1
363185,1,0,0,0,8,0
245571,2,40,0,40,7,1
90960,1,0,0,0,7,0
34804,1,0,0,0,16,0
339281,3,31,0,31,15,1
317281,4,14,19,-5,5,1
190593,4,20,20,0,17,1
215845,4,51,20,31,11,0
311558,1,0,0,0,2,1
384028,4,13,23,-10,1,1
31608,2,17,6,11,15,0
10830,4,21,7,14,5,0
290545,3,17,20,-3,10,1
136987,4,17,20,-3,11,1
178762,1,14,7,7,12,1
216152,1,7,0,7,12,0
189330,3,3,10,-7,16,1
108898,4,17,17,0,15,0
395463,1,6,0,6,6,0
116385,1,0,0,0,1,1
335677,1,7,0,7,13,0
51304,2,9,10,-1,7,1
419145,2,10,3,7,16,1
113357,4,26,38,-12,17,0
358454,4,32,20,12,6,0
132911,4,6,21,-15,9,0
320783,4,17,23,-6,6,0
61391,2,13,3,10,11,0
401926,1,0,3,-3,9,0
397663,4,6,30,-24,7,1
221321,4,6,35,-29,14,1
273041,3,6,3,3,2,1
308228,2,7,10,-3,1,1
395726,4,26,37,-11,6,1
306410,1,0,10,-10,17,1
416621,2,21,7,14,15,1
222288,1,0,0,0,14,0
363572,4,3,15,-12,8,1
119209,1,0,0,0,3,0
199962,2,10,10,0,4,1
40549,1,7,0,7,2,1
158215,3,24,0,24,3,1
178020,3,7,20,-13,12,0
57241,4,20,14,6,10,0
367040,4,10,38,-28,10,1
373379,3,10,7,3,13,1
202541,1,7,3,4,5,0
406253,3,21,27,-6,11,0
39353,1,0,0,0,1,0
90043,4,11,21,-10,7,1
283010,3,21,3,18,6,0
127187,4,13,16,-3,6,1
139460,4,27,10,17,12,0
145632,3,28,0,28,14,0
14693,1,0,0,0,7,1
397798,4,24,14,10,7,0
200424,2,10,18,-8,4,0
210933,4,19,10,9,9,1
266128,4,17,13,4,16,1
200872,2,14,0,14,4,0
269880,4,29,10,19,1,0
320608,4,31,6,25,6,0
32156,1,0,0,0,15,0
128679,3,6,17,-11,7,0
183870,4,44,28,16,14,0
30080,1,0,0,0,14,1
376793,2,14,0,14,15,0
322165,2,0,14,-14,7,0
310722,1,3,3,0,2,1
69061,1,0,0,0,15,1
266061,2,10,3,7,16,0
294893,1,0,0,0,12,0
300981,1,0,0,0,15,1
48139,3,10,6,4,5,1
245615,4,40,13,27,7,0
162191,2,10,7,3,4,1
390071,2,7,7,0,3,1
349875,2,3,3,0,2,0
401902,4,25,28,-3,9,0
338508,2,17,14,3,14,1
83067,2,6,14,-8,4,0
10533,3,34,0,34,5,0
391666,1,0,3,-3,4,0
337058,3,19,0,19,14,1
385311,3,14,20,-6,1,1
217379,4,21,13,8,12,1
89366,2,3,13,-10,7,1
138627,2,3,7,-4,12,0
250829,3,3,9,-6,10,1
194940,4,14,10,4,2,0
122975,2,0,3,-3,4,1
244076,3,20,27,-7,6,0
255713,4,3,19,-16,12,0
27838,4,17,14,3,13,0
324240,2,3,0,3,8,0
398049,2,14,21,-7,7,1
212813,4,17,21,-4,10,1
193042,1,0,0,0,1,0
230940,4,31,10,21,1,1
157339,1,0,0,0,2,0
208633,3,6,3,3,8,0
29843,2,6,10,-4,14,0
178011,3,7,20,-13,12,1
287085,4,26,32,-6,8,1
305878,3,7,14,-7,17,1
349523,1,0,0,0,2,0
338686,3,20,10,10,14,0
186224,4,29,13,16,15,0
162097,4,42,13,29,4,0
354524,4,33,28,5,4,0
209910,4,30,16,14,8,1
130215,3,3,26,-23,8,0
260044,2,3,7,-4,14,0
392986,4,12,10,2,4,0
355863,2,13,10,3,5,0
166765,3,20,9,11,6,1
162264,4,30,20,10,4,0
50804,1,0,7,-7,6,1
383257,2,31,10,21,17,1
46066,3,14,14,0,4,1
122024,4,16,13,3,4,1
95686,2,10,6,4,10,1
185019,4,14,32,-18,15,0
308807,1,0,3,-3,1,1
135425,4,28,27,1,10,1
52747,4,20,23,-3,7,1
63101,1,7,3,4,12,1
269052,2,10,16,-6,17,0
381553,3,28,13,15,17,0
74417,3,10,13,-3,17,0
43451,1,0,0,0,3,1
152926,2,14,14,0,1,0
413351,1,0,0,0,14,1
336210,4,24,10,14,13,1
228043,2,3,3,0,17,0
301739,2,0,10,-10,15,0
215677,4,14,6,8,11,1
74210,2,3,7,-4,17,1
246071,3,19,13,6,7,0
349480,4,6,20,-14,2,1
211969,2,0,10,-10,9,1
243106,3,7,9,-2,6,0
288846,2,10,17,-7,9,0
141406,4,10,17,-7,13,0
238200,2,3,16,-13,4,0
9555,5,20,20,0,5,0
394357,4,24,17,7,5,1
176727,4,39,19,20,11,1
363710,3,14,13,1,8,1
159516,2,7,0,7,3,0
212348,3,10,3,7,10,1
75003,3,27,17,10,17,1
227826,4,6,35,-29,16,1
252501,3,10,25,-15,10,1
370943,4,27,27,0,12,1
380622,1,7,0,7,16,0
216302,1,7,0,7,12,0
111966,2,14,21,-7,17,0
207953,1,0,0,0,8,1
149456,4,13,27,-14,16,1
248042,3,31,13,18,8,0
190861,4,24,10,14,17,0
402944,1,0,6,-6,9,0
366377,2,13,0,13,10,0
30650,4,24,9,15,14,1
125272,1,3,0,3,5,1
67624,3,0,35,-35,14,1
192643,3,10,7,3,1,1
72377,3,10,23,-13,16,1
118701,3,17,6,11,2,0
11956,2,7,0,7,6,0
336977,1,3,0,3,14,1
235171,4,7,17,-10,2,1
227492,3,19,10,9,16,0
319424,1,0,0,0,6,0
128876,1,0,0,0,7,0
40127,1,6,0,6,2,1
12039,4,27,14,13,6,1
127005,3,24,13,11,6,0
284406,1,0,0,0,7,0
47535,3,37,6,31,5,0
259421,1,6,3,3,13,0
2048,1,0,0,0,1,1
355131,3,23,16,7,4,0
88597,2,10,7,3,6,1
94475,2,0,0,0,9,0
123548,4,13,10,3,4,1
149546,3,14,9,5,16,0
81745,3,24,17,7,3,1
2831,2,24,24,0,2,1
287608,2,3,3,0,9,1
260119,4,6,28,-22,14,1
15718,1,0,0,0,8,0
304694,4,14,7,7,16,1
276902,1,7,0,7,4,1
140212,5,13,13,0,12,1
305738,3,9,10,-1,17,0
277318,4,0,16,-16,4,1
350897,2,3,14,-11,3,0
170458,3,21,3,18,8,1
155887,3,14,13,1,2,1
134441,2,0,20,-20,10,1
89459,4,24,20,4,7,1
271910,3,10,13,-3,2,1
258717,3,3,20,-17,13,1
245599,3,40,6,34,7,0
317614,2,3,3,0,5,0
368718,3,7,16,-9,11,1
43807,2,14,13,1,3,1
67878,2,13,3,10,14,0
375643,3,17,17,0,14,0
403309,2,6,0,6,9,1
195334,2,3,3,0,2,1
207626,4,42,10,32,7,0
287304,1,3,0,3,8,0
102381,4,16,20,-4,13,0
374920,4,14,25,-11,14,0
57005,2,0,10,-10,9,0
197843,2,6,7,-1,3,1
80640,2,7,16,-9,3,1
383027,1,0,0,0,17,1
64509,4,31,16,15,13,1
31570,1,7,3,4,15,1
266452,1,0,9,-9,16,1
169270,4,23,6,17,7,1
411710,1,0,3,-3,13,0
107067,3,33,0,33,15,0
245778,4,23,20,3,7,0
373807,2,13,0,13,13,0
232678,3,7,0,7,1,1
8199,2,0,7,-7,4,0
367961,1,3,14,-11,11,1
298924,1,0,6,-6,14,1
366903,4,3,16,-13,10,1
67640,3,7,35,-28,14,1
309119,2,16,3,13,1,1
195847,4,27,21,6,2,1
262369,1,0,0,0,15,0
148846,4,16,23,-7,16,0
310129,2,14,7,7,2,1
91960,3,6,23,-17,8,1
356350,3,24,6,18,5,0
35262,1,0,0,0,16,1
197662,1,0,0,0,3,0
204273,2,0,7,-7,6,0
368396,2,14,7,7,11,1
37816,3,14,9,5,1,1
205119,1,0,0,0,6,1
41499,3,8,7,1,2,1
188987,1,0,0,0,16,1
97154,1,0,0,0,10,0
384340,4,16,10,6,1,1
133048,4,12,14,-2,9,1
221780,4,13,14,-1,14,0
13204,4,22,26,-4,6,0
289340,3,28,17,11,9,1
350424,1,0,3,-3,2,0
249300,1,0,0,0,9,1
202550,2,7,6,1,5,0
368036,4,20,21,-1,11,0
230773,4,9,27,-18,1,1
46664,4,10,3,7,4,1
210165,3,0,14,-14,9,1
197575,2,19,0,19,3,0
61294,4,28,14,14,11,1
91021,2,6,0,6,7,0
379168,2,6,10,-4,16,1
278594,2,7,0,7,4,1
147894,3,10,31,-21,15,1
150582,2,3,13,-10,17,1
255119,4,14,31,-17,12,1
414269,3,21,21,0,14,0
305746,3,9,10,-1,17,0
106779,3,20,22,-2,14,1
261252,3,28,0,28,14,1
90368,4,20,32,-12,7,0
41169,2,0,7,-7,2,0
169494,2,0,21,-21,8,0
210038,3,10,10,0,8,0
184513,2,17,14,3,14,0
304158,1,0,0,0,16,1
278501,3,36,0,36,4,0
256663,4,38,14,24,12,0
230179,3,3,26,-23,17,1
52867,3,14,57,-43,7,0
142977,4,10,13,-3,13,0
413344,1,0,0,0,14,1
73463,1,0,14,-14,17,1
133321,2,7,3,4,9,0
314571,1,7,0,7,3,0
27411,4,27,17,10,13,0
163841,1,0,0,0,5,1
115733,3,13,13,0,1,0
96075,4,16,14,2,10,0
312205,2,7,14,-7,2,1
412832,3,21,35,-14,14,1
404025,2,3,21,-18,10,1
150100,1,0,0,0,16,1
377163,4,13,17,-4,15,1
144929,4,20,7,13,14,0
226537,1,0,0,0,16,1
257202,2,10,16,-6,12,0
259196,4,14,32,-18,13,1
352068,2,3,7,-4,3,0
419579,2,13,7,6,17,1
67052,3,10,6,4,14,0
225256,4,17,7,10,15,1
318563,2,10,0,10,5,0
391940,4,30,27,3,4,0
393108,3,24,3,21,4,0
41719,1,0,0,0,2,0
360703,1,0,7,-7,7,1
336073,1,0,0,0,13,1
23833,4,24,7,17,12,0
185920,4,22,16,6,15,0
151989,4,34,34,0,17,1
248,3,12,23,-11,1,0
413106,3,27,28,-1,14,1
236170,3,10,10,0,3,1
305839,2,0,14,-14,17,0
220277,3,20,9,11,13,1
108965,2,16,14,2,15,0
378025,3,0,7,-7,15,1
378557,2,14,6,8,15,0
17273,4,21,34,-13,9,0
128578,4,28,35,-7,7,1
253314,4,13,13,0,11,0
143609,2,10,3,7,14,0
312059,2,14,7,7,2,0
418678,1,0,6,-6,16,0
339852,2,16,0,16,15,0
380028,2,21,7,14,16,0
252691,4,6,10,-4,10,1
99455,2,0,3,-3,11,1
163886,2,16,10,6,5,0
230741,3,9,27,-18,1,0
127210,4,13,16,-3,6,1
17916,1,0,7,-7,9,1
259324,3,13,20,-7,13,1
95178,4,23,27,-4,9,0
344372,2,21,14,7,17,1
112525,2,10,9,1,17,0
30623,3,17,3,14,14,0
37994,1,0,0,0,1,1
3355,4,3,6,-3,2,1
109452,3,6,13,-7,16,1
144666,1,0,0,0,14,0
231858,1,0,20,-20,1,1
396975,2,7,3,4,6,1
360465,3,10,0,10,7,1
188888,3,10,10,0,16,1
389430,4,33,28,5,3,1
293446,4,42,24,18,11,0
157022,4,13,13,0,2,1
395230,3,10,13,-3,5,1
315637,2,3,0,3,4,0
36948,3,0,25,-25,17,1
188265,2,14,7,7,16,0
55860,3,13,14,-1,9,0
332308,2,6,6,0,12,0
347689,4,27,24,3,1,1
285915,2,20,0,20,8,1
394279,1,3,0,3,5,0
301775,3,0,27,-27,15,1
249580,4,21,13,8,9,1
385654,4,16,24,-8,1,1
43456,1,0,0,0,3,0
108406,3,3,21,-18,15,1
109375,1,3,7,-4,16,0
199315,1,0,0,0,4,0
216853,2,7,14,-7,12,1
404537,4,34,27,7,10,0
160159,2,23,7,16,3,1
118453,4,20,10,10,2,1
323154,1,0,0,0,7,0
1789,2,3,0,3,1,0
99279,1,7,0,7,11,1
91042,3,6,0,6,7,1
29652,1,0,0,0,14,0
234941,2,10,3,7,2,1
355703,2,7,3,4,5,1
399027,2,10,9,1,7,0
368395,2,14,7,7,11,1
214018,3,36,7,29,10,1
179381,2,3,13,-10,12,1
174724,4,9,10,-1,10,0
195439,4,24,10,14,2,0
68850,3,6,17,-11,15,1
175185,4,49,17,32,10,0
221704,2,10,0,10,14,0
303013,4,23,16,7,16,0
387034,1,0,0,0,2,1
315605,1,0,0,0,4,0
199238,3,17,21,-4,4,0
33866,4,9,41,-32,16,0
331315,3,0,24,-24,11,0
338742,4,27,17,10,14,1
204934,4,13,19,-6,6,0
319694,4,33,9,24,6,0
214730,2,3,7,-4,11,0
307884,1,0,0,0,1,1
374085,1,7,0,7,13,0
11701,3,17,10,7,6,1
103419,4,10,23,-13,13,1
179816,1,0,0,0,13,1
142702,1,0,0,0,13,0
382748,4,9,20,-11,17,0
206671,1,0,7,-7,7,1
145656,3,28,7,21,14,1
31738,2,0,10,-10,15,1
10435,1,0,0,0,5,1
144825,1,14,0,14,14,1
321021,3,10,7,3,6,0
140599,2,24,10,14,12,0
146934,1,7,0,7,15,0
120710,2,17,0,17,3,0
343338,2,0,17,-17,16,1
148475,3,14,3,11,16,1
319168,3,2,3,-1,5,0
179270,3,26,3,23,12,1
400100,3,17,23,-6,8,0
13633,3,13,10,3,7,1
40262,2,3,0,3,2,0
367391,2,10,14,-4,10,1
342347,1,0,0,0,16,0
235342,1,7,0,7,3,0
39560,2,0,6,-6,1,1
365037,4,17,6,11,9,1
377208,1,0,0,0,15,1
297332,2,3,3,0,13,0
207009,2,28,0,28,7,0
244555,4,25,16,9,7,1
101234,2,7,7,0,12,0
381400,3,16,0,16,16,1
419528,4,10,23,-13,16,0
116061,4,16,7,9,1,1
82789,3,9,9,0,3,1
298470,1,0,0,0,14,1
30590,2,17,0,17,14,0
345358,1,0,7,-7,17,1
82092,1,0,0,0,3,0
189025,2,7,7,0,16,1
169885,4,27,17,10,8,0
287690,4,9,13,-4,9,0
164803,4,26,21,5,6,0
202005,4,17,7,10,5,0
132709,2,3,10,-7,9,1
302304,1,7,0,7,15,0
409973,3,6,28,-22,12,0
397973,4,10,27,-17,7,1
41756,2,6,7,-1,2,1
58798,4,18,29,-11,10,0
32577,4,27,13,14,15,1
11348,2,14,0,14,6,0
52801,2,0,30,-30,7,0
102943,3,12,24,-12,13,1
69521,1,0,0,0,15,0
282939,2,7,0,7,6,0
73115,4,13,10,3,16,0
412684,3,30,10,20,14,1
241870,3,13,6,7,5,0
334245,2,6,7,-1,13,0
183384,2,17,3,14,14,1
48043,4,10,27,-17,5,0
56910,3,27,7,20,9,1
22693,1,3,0,3,11,1
30227,4,13,34,-21,14,1
127115,2,3,9,-6,6,1
34662,1,0,0,0,16,0
144032,4,21,16,5,14,0
270708,2,3,3,0,1,1
292801,4,29,17,12,11,1
97940,2,0,7,-7,11,0
125395,1,0,0,0,5,1
354208,2,13,10,3,4,0
161675,1,0,0,0,4,0
282553,4,17,24,-7,6,1
87630,1,0,0,0,6,0
33690,3,28,0,28,16,0
53135,3,19,38,-19,7,0
94115,1,0,0,0,9,1
137277,4,7,20,-13,11,0
371012,2,7,7,0,12,0
139313,4,20,13,7,12,1
417216,3,17,17,0,16,0
192706,4,19,7,12,1,0
212904,2,0,7,-7,10,1
218510,4,34,17,17,13,1
286182,5,24,24,0,8,0
137550,3,17,20,-3,11,0
405716,2,10,0,10,10,1
252249,1,0,7,-7,10,1
56078,1,7,0,7,9,0
364234,2,0,13,-13,9,1
159022,1,0,0,0,3,0
299922,4,16,11,5,14,0
106812,4,34,22,12,14,0
19431,2,17,14,3,10,0
41702,4,31,14,17,2,0
235573,3,24,13,11,3,1
235268,3,15,6,9,3,1
177754,4,13,17,-4,12,0
206782,4,14,27,-13,7,0
59211,3,14,45,-31,10,1
2568,3,10,17,-7,2,0
219653,3,10,7,3,13,1
148048,3,7,3,4,15,1
317212,3,7,13,-6,5,0
296102,4,9,17,-8,13,1
245535,2,34,0,34,7,0
192159,3,3,13,-10,1,1
336269,2,10,0,10,13,1
348745,4,31,17,14,2,0
98545,1,0,0,0,11,0
404102,4,13,49,-36,10,1
184894,1,0,7,-7,15,1
9077,4,28,13,15,4,1
78353,4,31,35,-4,2,1
218533,1,0,7,-7,13,1
292221,4,24,17,7,11,0
88908,2,16,3,13,6,1
309175,4,35,9,26,1,1
29948,1,0,0,0,14,0
198691,4,15,27,-12,3,1
324698,2,7,7,0,8,0
1608,4,16,20,-4,1,1
127359,4,10,20,-10,6,0
291173,4,18,23,-5,10,1
245855,2,3,20,-17,7,0
356619,1,0,0,0,5,1
284201,3,9,23,-14,7,1
385975,4,24,21,3,1,0
147025,4,27,0,27,15,1
188224,1,0,7,-7,16,1
358297,3,0,20,-20,6,0
231180,3,10,7,3,1,0
293661,2,10,7,3,12,1
176485,2,3,10,-7,11,1
118142,3,23,20,3,2,0
275958,4,20,21,-1,3,1
333341,2,10,7,3,12,1
294800,2,21,14,7,12,0
84994,2,19,7,12,4,0
50113,2,0,17,-17,6,0
405932,3,14,0,14,11,0
331208,4,10,20,-10,11,1
392869,4,17,23,-6,4,1
107219,3,12,31,-19,15,1
5051,2,7,0,7,3,1
339927,4,33,0,33,15,0
135092,3,17,6,11,10,1
95761,1,0,0,0,10,1
232985,3,10,9,1,2,0
260913,2,0,0,0,14,1
260856,4,36,15,21,14,0
31811,3,16,17,-1,15,0
80572,4,16,10,6,3,1
144331,1,0,0,0,14,1
310824,4,27,13,14,2,0
65548,1,3,0,3,13,1
85161,2,0,10,-10,4,1
68295,1,0,0,0,14,1
121260,4,21,30,-9,3,1
165637,2,0,0,0,6,1
348139,4,24,22,2,1,0
114837,3,13,30,-17,1,1
135176,1,10,0,10,10,1
104620,2,7,3,4,14,1
71643,3,3,31,-28,16,1
118024,4,20,6,14,2,0
214515,4,7,23,-16,11,1
48528,2,11,0,11,5,0
289306,2,21,17,4,9,0
369963,1,7,0,7,12,0
122419,2,6,20,-14,4,0
71646,3,3,31,-28,16,1
68054,2,3,10,-7,14,0
284647,3,14,20,-6,7,0
101176,1,0,0,0,12,0
24028,1,0,0,0,12,1
45218,4,14,10,4,4,0
61201,1,0,0,0,11,1
135435,4,31,27,4,10,0
278555,1,0,0,0,4,0
169204,2,10,6,4,7,1
191272,3,7,17,-10,17,1
331562,2,7,20,-13,11,1
327868,3,16,17,-1,10,0
228248,4,10,27,-17,17,0
367347,1,0,0,0,10,0
193965,1,13,0,13,1,1
151000,1,0,0,0,17,0
411529,4,13,31,-18,13,1
394509,4,10,25,-15,5,0
356815,2,0,7,-7,5,0
349566,2,3,21,-18,2,0
126388,3,13,14,-1,6,1
188972,1,0,0,0,16,0
233456,3,23,10,13,2,1
198658,3,13,21,-8,3,1
346854,3,16,6,10,1,1
203111,1,0,0,0,5,0
236559,4,10,9,1,3,0
115240,2,0,3,-3,1,0
92304,3,20,0,20,8,1
95969,1,0,0,0,10,1
276365,3,17,35,-18,3,1
306119,1,0,0,0,17,0
367020,3,10,31,-21,10,0
355265,2,14,14,0,4,0
284727,1,3,7,-4,7,0
158155,1,6,0,6,3,1
136917,3,0,13,-13,11,0
252664,3,6,3,3,10,1
119637,4,17,12,5,3,1
58787,4,10,29,-19,10,1
101158,4,19,27,-8,12,1
88451,2,7,0,7,6,1
83731,4,22,23,-1,4,1
306875,2,0,13,-13,17,1
71225,4,19,20,-1,16,1
224519,4,18,10,8,15,0
165225,2,7,7,0,6,1
248380,1,3,0,3,8,1
293974,4,7,21,-14,12,1
234879,4,3,12,-9,2,0
398691,1,0,0,0,7,0
229875,3,13,14,-1,17,1
70782,4,20,27,-7,15,1
204191,4,24,20,4,6,1
12797,1,0,3,-3,6,1
419372,4,3,23,-20,16,0
336908,3,7,14,-7,14,1
64818,1,0,0,0,13,0
25297,3,34,14,20,12,1
413894,4,17,9,8,14,0
154930,3,26,10,16,1,0
183179,4,28,26,2,14,1
224867,1,0,3,-3,15,0
39573,2,14,6,8,1,1
351308,1,7,0,7,3,0
385886,2,0,7,-7,1,1
274535,2,21,16,5,3,1
228025,2,0,0,0,17,1
241420,3,7,34,-27,5,0
264394,2,3,14,-11,15,0
245700,2,3,10,-7,7,1
217933,4,39,28,11,12,0
80989,3,20,10,10,3,0
286129,4,16,17,-1,8,1
209584,3,41,34,7,8,1
235789,1,0,0,0,3,1
173909,2,13,10,3,10,1
255194,2,7,7,0,12,1
198874,1,0,6,-6,3,0
405015,4,9,23,-14,10,1
97650,2,3,3,0,11,0
23890,1,3,0,3,12,0
199348,2,0,3,-3,4,1
389545,4,27,17,10,3,0
291671,1,0,0,0,11,0
366858,3,3,6,-3,10,0
265415,4,14,23,-9,16,0
376263,4,10,14,-4,14,0
34855,2,10,7,3,16,1
242096,1,0,0,0,6,1
270597,4,20,14,6,1,0
373713,3,13,18,-5,13,0
339910,3,26,0,26,15,0
49276,4,20,17,3,6,1
163992,1,0,0,0,5,0
392319,2,0,21,-21,4,1
249482,1,0,3,-3,9,1
348425,4,13,23,-10,1,1
345093,2,6,3,3,17,1
208020,2,21,0,21,8,0
302042,2,7,10,-3,15,0
142882,1,0,0,0,13,0
350275,1,7,0,7,2,1
358962,1,0,0,0,6,1
151377,4,31,14,17,17,1
308025,4,21,12,9,1,1
62102,2,7,7,0,12,0
311862,1,7,0,7,2,0
227479,3,16,10,6,16,1
229216,1,3,0,3,17,0
354212,3,13,10,3,4,1
161995,1,7,0,7,4,0
206825,2,0,7,-7,7,1
194867,1,0,10,-10,2,1
158910,2,14,3,11,3,0
190196,1,0,0,0,17,1
61701,3,17,17,0,12,1
332367,4,16,13,3,12,0
141510,2,13,10,3,13,1
263586,1,0,7,-7,15,1
332915,3,24,3,21,12,1
191665,2,0,10,-10,17,0
150037,4,24,6,18,16,0
147327,1,0,0,0,15,1
226501,4,14,17,-3,16,1
20343,2,10,13,-3,10,1
298701,3,13,14,-1,14,0
151685,4,30,44,-14,17,0
102885,1,0,13,-13,13,0
211073,3,30,0,30,9,1
292070,4,22,19,3,11,0
123775,2,10,3,7,5,0
204015,4,16,7,9,6,1
63556,1,10,0,10,12,0
314532,4,24,10,14,3,1
320055,1,0,0,0,6,1
36762,2,7,7,0,17,0
251175,1,7,7,0,10,1
176346,3,16,14,2,11,0
317543,4,10,27,-17,5,0
166483,4,20,17,3,6,0
309170,4,35,3,32,1,0
4474,2,7,12,-5,2,1
148276,1,7,0,7,16,0
340979,4,17,17,0,15,0
185385,2,0,3,-3,15,0
382013,4,7,30,-23,17,0
156338,2,24,0,24,2,0
247884,3,10,3,7,8,1
14569,1,0,7,-7,7,0
420211,4,3,10,-7,17,1
272922,4,20,20,0,2,0
249003,1,0,0,0,9,0
121409,4,7,12,-5,3,1
300213,4,31,3,28,14,0
210524,4,16,28,-12,9,0
179162,4,19,16,3,12,0
137841,2,10,6,4,11,0
25920,4,38,17,21,12,0
251362,2,24,14,10,10,0
40375,4,15,10,5,2,1
152240,3,21,0,21,17,0
262924,4,14,23,-9,15,0
136196,4,13,10,3,10,1
386990,4,7,21,-14,2,1
113856,1,7,0,7,17,0
254042,3,14,13,1,11,0
16179,1,0,0,0,8,1
195731,4,17,16,1,2,0
307853,4,27,28,-1,1,1
284362,4,14,17,-3,7,1
294519,3,17,13,4,12,1
398528,4,28,16,12,7,1
156613,2,3,0,3,2,0
143599,1,7,3,4,14,1
228537,4,20,7,13,17,0
239662,1,0,3,-3,4,1
13135,2,10,7,3,6,0
131032,4,17,30,-13,8,1
241760,4,7,15,-8,5,1
200998,2,14,0,14,5,1
262153,3,27,6,21,15,1
4887,2,14,0,14,3,0
129724,3,14,14,0,7,1
224500,3,15,10,5,15,1
376001,4,23,15,8,14,0
106281,2,0,6,-6,14,1
95871,4,13,20,-7,10,1
186774,2,23,0,23,15,0
325358,4,15,20,-5,8,0
37514,3,10,7,3,17,0
120746,3,23,0,23,3,0
254776,3,10,10,0,11,1
191681,2,7,10,-3,17,0
356912,1,3,0,3,5,1
176977,3,13,6,7,11,1
52645,2,3,7,-4,7,0
194423,2,9,0,9,2,1
319665,3,26,3,23,6,1
376310,1,0,0,0,14,1
364480,4,42,28,14,9,1
287021,2,13,21,-8,8,1
251597,4,19,20,-1,10,0
22787,4,6,21,-15,11,0
198560,1,0,0,0,3,1
94696,4,24,36,-12,9,0
16723,1,0,0,0,8,0
57034,2,7,17,-10,9,0
371045,3,10,10,0,12,0
363897,1,0,0,0,8,0
294058,2,7,14,-7,12,0
121259,4,21,30,-9,3,1
338399,3,24,10,14,14,1
44700,2,0,9,-9,3,1
241982,2,7,0,7,5,1
239742,3,10,13,-3,4,1
279235,2,13,13,0,5,1
338418,4,27,17,10,14,1
76262,4,12,27,-15,1,1
272489,1,7,0,7,2,0
284877,1,0,0,0,7,0
253245,3,3,7,-4,11,1
237899,4,14,27,-13,4,1
174797,2,13,14,-1,10,0
154361,4,27,24,3,1,1
76110,4,13,30,-17,1,0
218648,4,10,33,-23,13,1
177773,4,13,17,-4,12,0
421066,2,6,0,6,17,1
27143,1,0,7,-7,13,1
395445,1,0,0,0,6,1
82207,4,16,3,13,3,0
186301,2,19,3,16,15,0
219428,1,0,0,0,13,1
118880,4,27,7,20,2,0
293845,4,30,19,11,12,1
397314,3,0,24,-24,6,0
414737,3,3,17,-14,14,1
277842,2,7,14,-7,4,0
332235,4,10,16,-6,12,0
91586,1,0,7,-7,8,1
263620,2,14,10,4,15,1
301351,3,17,7,10,15,0
325974,4,22,7,15,9,0
304103,4,13,30,-17,16,1
402036,4,3,19,-16,9,1
281984,3,21,21,0,6,0
151467,2,28,7,21,17,0
127291,2,10,13,-3,6,0
340183,2,20,21,-1,15,1
130830,3,13,12,1,8,1
102403,1,0,0,0,13,0
189105,4,31,30,1,16,1
24625,1,0,0,0,12,1
187977,3,6,14,-8,16,1
83202,2,3,7,-4,4,0
74480,1,0,0,0,17,1
77853,3,17,27,-10,1,0
80604,1,0,10,-10,3,1
19875,3,13,21,-8,10,0
309111,2,15,3,12,1,1
96399,1,0,0,0,10,0
50086,2,0,14,-14,6,1
327428,3,3,17,-14,9,0
230877,2,7,10,-3,1,1
243004,5,34,34,0,6,1
325707,1,0,0,0,9,1
297952,2,20,7,13,13,0
232090,4,0,33,-33,1,1
315802,2,0,13,-13,4,0
219957,2,6,14,-8,13,1
220419,3,23,14,9,13,1
354578,1,0,0,0,4,1
165965,2,10,7,3,6,0
169748,1,0,7,-7,8,1
217388,4,21,13,8,12,1
323138,1,0,0,0,7,0
420046,3,24,14,10,17,0
295890,3,10,14,-4,12,1
382500,1,0,0,0,17,0
49847,4,21,10,11,6,0
227036,3,10,6,4,16,1
214558,2,3,0,3,11,0
408384,4,19,14,5,12,1
185345,1,0,0,0,15,0
161924,3,13,9,4,4,0
153286,3,2,7,-5,1,0
186105,1,0,0,0,15,0
124479,4,16,17,-1,5,0
10167,2,6,0,6,5,0
276524,3,19,7,12,4,1
364502,1,0,0,0,9,0
393213,2,7,6,1,5,1
407029,4,11,34,-23,11,1
214976,1,3,0,3,11,0
38707,4,17,14,3,1,0
343364,3,0,20,-20,16,0
228929,2,7,9,-2,17,1
388693,1,0,0,0,3,1
279801,1,7,3,4,5,0
393389,2,21,14,7,5,0
117783,2,3,6,-3,2,1
371742,3,14,14,0,12,0
54913,2,0,0,0,8,0
238337,2,3,16,-13,4,1
247660,1,7,0,7,8,0
335979,2,7,15,-8,13,0
60678,3,21,3,18,11,0
114572,1,0,0,0,1,0
328308,2,3,14,-11,10,0
140373,4,17,29,-12,12,1
151850,1,3,0,3,17,1
358957,1,0,0,0,6,1
125777,3,7,17,-10,5,0
353377,2,6,0,6,4,1
210840,1,0,0,0,9,1
104759,2,17,16,1,14,1
3820,4,23,10,13,2,0
272263,3,9,3,6,2,0
398086,3,24,28,-4,7,1
47810,2,7,6,1,5,1
420625,2,13,13,0,17,0
51682,1,0,0,0,7,1
407682,1,0,0,0,11,1
10766,2,7,0,7,5,1
12424,3,10,6,4,6,1
190699,3,34,17,17,17,1
205918,1,3,0,3,7,0
171212,4,6,14,-8,8,1
74186,1,3,0,3,17,1
228536,3,20,7,13,17,0
12067,1,7,0,7,6,1
62434,3,0,13,-13,12,1
214142,3,3,6,-3,11,0
68403,4,3,21,-18,14,1
236654,2,10,0,10,3,1
218945,4,48,27,21,13,0
90529,4,0,26,-26,7,0
317005,1,0,10,-10,4,1
295817,1,0,0,0,12,0
98560,2,0,7,-7,11,0
197726,3,7,10,-3,3,1
296312,2,3,13,-10,13,1
24119,4,14,14,0,12,1
146084,3,19,10,9,15,1
324609,4,16,9,7,8,0
47380,4,3,13,-10,5,0
34706,2,3,3,0,16,0
259964,4,20,20,0,14,0
294420,4,19,9,10,12,0
398865,1,3,0,3,7,0
386667,3,14,13,1,2,0
391750,3,10,10,0,4,0
248370,4,29,10,19,8,0
224815,4,11,10,1,15,1
95951,1,0,0,0,10,1
34521,1,0,0,0,16,0
66379,4,14,27,-13,14,1
353707,3,3,10,-7,4,0
189996,4,16,7,9,17,0
219609,1,3,0,3,13,1
361879,1,0,0,0,7,1
38493,2,10,3,7,1,1
268878,2,6,16,-10,17,0
311339,2,14,7,7,2,0
278085,4,13,17,-4,4,1
10539,3,34,0,34,5,0
170585,3,34,6,28,8,1
281082,4,38,16,22,6,1
290918,1,7,0,7,10,0
192708,4,19,14,5,1,1
36678,4,20,3,17,17,1
114991,3,13,12,1,1,0
236203,3,20,16,4,3,0
10518,3,26,0,26,5,1
73166,1,7,0,7,16,0
52988,3,27,17,10,7,0
23748,1,0,0,0,12,1
325046,3,26,24,2,8,1
411357,4,20,10,10,13,0
264044,1,7,14,-7,15,1
10058,2,28,0,28,5,0
299590,3,13,10,3,14,1
87433,3,20,7,13,6,1
201960,2,0,0,0,5,1
177546,2,7,0,7,11,1
347948,3,0,21,-21,1,0
392191,3,10,13,-3,4,0
26376,1,7,0,7,13,0
384653,1,0,7,-7,1,0
337744,1,10,0,10,14,0
146449,4,24,3,21,15,0
212952,3,7,7,0,10,1
171196,3,3,7,-4,8,1
122060,1,0,0,0,4,0
50092,2,0,14,-14,6,0
207756,3,24,13,11,7,0
421238,2,6,7,-1,17,1
412369,3,26,17,9,13,1
106243,1,0,0,0,14,0
251517,2,16,13,3,10,1
45310,3,10,10,0,4,0
267935,1,0,0,0,17,0
371032,3,10,10,0,12,0
378309,3,9,3,6,15,0
112635,4,38,34,4,17,0
27327,2,14,3,11,13,1
219993,4,16,28,-12,13,0
260536,3,27,8,19,14,1
318088,2,9,7,2,5,1
216615,1,0,3,-3,12,0
192701,4,19,7,12,1,1
110775,3,3,3,0,16,0
206377,1,0,0,0,7,1
420527,4,10,42,-32,17,0
95655,2,7,3,4,10,1
149402,3,6,27,-21,16,1
395587,1,0,3,-3,6,1
190366,2,7,0,7,17,1
209178,1,0,7,-7,8,1
8099,4,24,20,4,4,1
279660,2,14,0,14,5,1
187374,2,20,7,13,16,1
182040,3,17,14,3,13,1
236320,2,0,16,-16,3,0
275572,1,13,0,13,3,1
22785,4,6,21,-15,11,0
79306,2,12,3,9,2,1
117187,2,16,10,6,2,1
218429,2,10,14,-4,13,1
162236,3,20,20,0,4,1
311182,2,3,0,3,2,1
246814,3,10,20,-10,8,0
53930,3,14,13,1,8,0
394141,2,13,10,3,5,0
282505,2,14,3,11,6,0
229258,2,10,14,-4,17,1
231070,4,27,8,19,1,0
418747,3,7,14,-7,16,0
219444,1,0,0,0,13,0
360725,2,10,7,3,7,1
404160,2,6,7,-1,10,1
337371,3,21,7,14,14,0
160806,2,17,10,7,4,1
182441,1,7,0,7,14,0
180251,1,0,0,0,13,1
419474,3,10,9,1,16,0
336224,1,0,0,0,13,1
151075,3,17,10,7,17,0
382851,3,28,3,25,17,1
39458,3,13,10,3,1,1
36183,2,10,14,-4,17,0
50388,2,0,7,-7,6,1
224288,2,9,9,0,15,1
362608,1,0,7,-7,8,1
250868,4,10,12,-2,10,0
160948,2,7,7,0,4,1
103534,3,20,0,20,13,1
99425,1,0,0,0,11,1
78494,4,24,0,24,2,1
355081,1,0,13,-13,4,1
103458,1,3,0,3,13,1
371114,1,0,0,0,12,0
401437,3,24,10,14,8,1
226564,2,3,3,0,16,1
88951,3,26,3,23,6,0
317800,2,9,3,6,5,1
348772,1,0,0,0,2,0
351704,4,14,17,-3,3,0
126084,3,20,3,17,6,0
313530,1,0,7,-7,3,1
111158,4,37,10,27,16,0
311608,2,6,0,6,2,0
332020,2,3,3,0,12,1
87236,2,7,14,-7,6,1
381274,4,24,17,7,16,0
75293,3,7,26,-19,17,1
127155,3,10,9,1,6,1
45753,3,10,7,3,4,1
300432,1,2,0,2,14,1
387969,2,3,0,3,2,1
148985,4,13,12,1,16,1
168637,4,17,16,1,7,1
230747,3,9,27,-18,1,1
295014,4,31,21,10,12,0
82643,3,12,10,2,3,0
105161,1,0,0,0,14,1
105979,2,17,3,14,14,1
126365,3,7,14,-7,6,0
208397,4,17,43,-26,8,1
185695,2,10,3,7,15,0
376795,2,14,0,14,15,0
234389,4,17,10,7,2,1
417827,2,10,0,10,16,0
220753,4,13,13,0,13,0
135891,5,24,24,0,10,1
19642,4,23,28,-5,10,1
163409,2,0,12,-12,5,0
259622,3,6,3,3,13,0
414812,1,7,0,7,15,0
155429,4,13,10,3,2,0
369360,1,0,0,0,11,0
126412,4,33,17,16,6,0
213651,2,7,14,-7,10,1
19271,2,7,14,-7,10,0
112095,2,7,17,-10,17,1
140147,3,10,3,7,12,0
184052,1,0,0,0,14,1
246881,1,0,0,0,8,0
23926,2,16,0,16,12,0
49672,3,7,14,-7,6,0
258238,1,7,0,7,13,0
106104,2,0,0,0,14,1
146495,1,7,7,0,15,1
216872,3,10,14,-4,12,1
238120,1,0,0,0,4,1
64188,3,31,6,25,13,0
19199,4,21,19,2,10,1
224964,4,10,16,-6,15,0
210676,4,20,31,-11,9,1
11305,1,0,0,0,6,1
112018,4,35,21,14,17,0
155350,2,10,3,7,2,0
329796,3,17,20,-3,11,1
155141,4,19,33,-14,1,0
323934,2,10,7,3,8,0
89380,2,10,13,-3,7,0
27809,3,14,14,0,13,1
48208,1,0,0,0,5,0
2027,4,19,15,4,1,1
192446,2,0,17,-17,1,0
41014,2,3,10,-7,2,0
76504,2,7,20,-13,1,0
398405,4,3,30,-27,7,1
315857,4,9,19,-10,4,1
317120,1,0,0,0,5,0
288990,2,16,7,9,9,0
80800,3,3,0,3,3,0
155590,4,23,17,6,2,1
218469,3,24,17,7,13,0
227348,4,20,37,-17,16,1
301766,3,0,27,-27,15,1
381398,3,16,0,16,16,1
96681,1,0,0,0,10,0
7637,4,28,3,25,4,0
356639,1,7,3,4,5,0
332523,4,30,16,14,12,0
68343,2,3,7,-4,14,1
359826,1,0,0,0,6,0
116699,2,6,10,-4,2,1
370769,3,12,10,2,12,1
59704,1,0,0,0,11,0
52251,4,10,16,-6,7,0
288919,4,26,31,-5,9,0
136702,1,6,10,-4,11,0
389856,4,24,6,18,3,1
313884,2,21,19,2,3,1
150918,3,10,7,3,17,1
13175,3,19,16,3,6,1
87149,3,21,10,11,5,0
86699,2,10,7,3,5,1
287111,1,0,0,0,8,0
421187,1,0,0,0,17,1
181807,1,0,0,0,13,0
206,2,6,10,-4,1,1
309249,2,0,7,-7,1,1
155460,4,13,10,3,2,1
349921,4,3,12,-9,2,0
278791,2,7,7,0,5,0
299553,2,3,3,0,14,0
371875,2,21,10,11,12,1
252100,1,7,7,0,10,1
86358,1,0,0,0,5,0
380488,1,0,14,-14,16,1
17822,2,13,10,3,9,0
122173,4,24,28,-4,4,1
282174,1,3,0,3,6,0
321648,4,20,13,7,7,0
255468,1,7,0,7,12,1
407743,3,10,0,10,11,0
213930,1,16,7,9,10,0
165572,4,3,35,-32,6,1
132314,4,31,17,14,9,0
179012,4,19,3,16,12,0
342418,2,10,3,7,16,0
131775,1,0,0,0,8,1
333012,2,3,3,0,12,0
240169,3,16,3,13,5,1
120262,3,17,3,14,3,0
390117,3,17,21,-4,3,1
317812,2,9,3,6,5,0
345301,4,19,24,-5,17,1
225387,4,24,35,-11,15,1
285082,2,3,0,3,7,1
209176,1,0,7,-7,8,1
379111,1,0,0,0,16,0
57523,3,21,13,8,10,0
361268,4,14,29,-15,7,1
165800,2,3,3,0,6,0
340077,4,17,15,2,15,1
341124,4,14,24,-10,15,1
195537,3,6,0,6,2,0
322111,4,26,0,26,7,1
340533,3,7,40,-33,15,0
356154,2,10,0,10,5,1
120471,4,26,27,-1,3,1
5508,2,10,10,0,3,0
144977,1,0,0,0,14,0
55252,2,7,10,-3,9,1
2000,4,10,12,-2,1,0
135679,3,7,10,-3,10,1
137731,3,10,27,-17,11,0
85948,2,7,14,-7,5,1
361887,1,0,0,0,7,0
392735,1,0,0,0,4,0
418537,1,7,0,7,16,0
8518,3,15,10,5,4,1
86215,1,0,7,-7,5,0
278324,2,14,7,7,4,0
66643,3,7,17,-10,14,1
308819,2,3,3,0,1,0
72522,3,16,17,-1,16,1
123308,2,14,7,7,4,1
269527,3,13,24,-11,1,1
361731,1,0,0,0,7,1
369226,1,7,7,0,11,0
255111,4,14,31,-17,12,0
107231,4,14,31,-17,15,1
28401,3,13,3,10,14,0
136512,4,20,23,-3,11,1
92526,1,10,0,10,8,0
24491,1,0,7,-7,12,0
195953,3,0,17,-17,2,1
323741,1,6,0,6,8,1
80459,1,2,0,2,3,1
220951,2,7,7,0,14,0
295780,5,24,24,0,12,1
58326,4,27,13,14,10,1
69855,3,14,9,5,15,1
278756,2,0,0,0,5,1
169041,3,26,14,12,7,1
9415,1,0,0,0,5,0
334966,2,3,7,-4,13,0
181070,2,7,7,0,13,1
415861,2,7,20,-13,15,1
89370,2,3,13,-10,7,1
216965,2,3,3,0,12,0
248966,4,27,3,24,9,0
296493,3,20,3,17,13,1
53762,4,10,9,1,8,0
387354,1,14,0,14,2,0
332816,4,35,16,19,12,0
271321,3,9,24,-15,1,0
404357,3,20,6,14,10,0
364498,1,0,0,0,9,0
394001,2,3,10,-7,5,1
401885,4,14,28,-14,9,1
166241,1,0,3,-3,6,1
337651,3,14,13,1,14,1
30393,1,0,13,-13,14,1
96508,4,17,24,-7,10,1
83046,2,6,14,-8,4,1
23073,4,10,17,-7,11,0
276086,3,33,3,30,3,1
225501,3,0,14,-14,15,0
105621,1,0,0,0,14,1
59268,4,28,58,-30,10,0
226080,2,0,14,-14,16,1
292568,1,6,6,0,11,0
249623,1,0,0,0,9,1
303465,3,22,10,12,16,0
421718,3,17,10,7,17,0
345423,3,0,13,-13,17,1
204171,4,17,17,0,6,1
240604,2,13,7,6,5,0
21347,4,14,24,-10,11,1
259403,1,0,3,-3,13,1
219082,4,38,13,25,13,0
174749,1,6,0,6,10,0
209494,1,7,3,4,8,1
310249,1,3,0,3,2,0
325257,1,3,3,0,8,0
208748,2,3,6,-3,8,0
17401,3,17,0,17,9,1
243604,3,20,7,13,6,0
323987,3,17,13,4,8,0
256829,1,0,0,0,12,1
12731,3,52,0,52,6,1
53772,5,10,10,0,8,0
137638,5,37,37,0,11,1
171926,2,7,7,0,9,0
405911,2,14,0,14,11,1
285672,5,27,27,0,8,1
307295,2,14,3,11,17,0
180488,3,14,20,-6,13,1
410623,4,17,17,0,13,0
78145,2,20,3,17,2,1
98201,4,35,26,9,11,0
390426,4,14,27,-13,3,0
311350,2,14,10,4,2,1
249348,2,10,9,1,9,1
221176,4,0,23,-23,14,1
141597,1,0,0,0,13,1
420898,1,6,0,6,17,1
19663,1,0,0,0,10,0
20543,4,17,0,17,10,0
288573,3,23,31,-8,9,0
322200,3,0,20,-20,7,1
58584,3,10,10,0,10,0
148290,2,7,0,7,16,0
269015,2,7,3,4,17,0
123749,2,7,3,4,5,1
246377,4,20,10,10,7,1
195871,4,27,21,6,2,1
138209,3,7,12,-5,11,1
411728,2,0,10,-10,13,1
91397,4,24,14,10,8,0
192228,1,0,0,0,1,1
412870,4,38,35,3,14,0
76503,2,7,20,-13,1,0
308546,2,6,9,-3,1,0
108817,2,0,10,-10,15,0
255850,4,20,0,20,12,0
128150,1,0,0,0,7,1
105107,3,26,14,12,14,1
86313,4,20,23,-3,5,1
284816,4,29,20,9,7,0
237473,1,13,0,13,3,1
287641,3,3,10,-7,9,1
12645,1,0,0,0,6,1
372138,2,9,7,2,13,1
163654,4,21,36,-15,5,1
108816,2,0,10,-10,15,0
9020,2,7,7,0,4,1
281080,4,38,16,22,6,1
288077,2,10,0,10,9,1
158244,4,38,0,38,3,1
117978,3,17,6,11,2,1
21370,1,0,7,-7,11,1
78220,1,0,0,0,2,1
339410,2,7,3,4,15,0
368653,1,0,3,-3,11,0
289586,2,7,13,-6,10,1
162358,3,10,10,0,4,1
294684,3,6,14,-8,12,0
37357,3,17,0,17,17,0
416626,3,28,7,21,15,1
407664,1,0,0,0,11,0
315045,2,24,7,17,4,0
21186,4,0,16,-16,10,0
71992,1,0,10,-10,16,1
320036,4,49,36,13,6,0
181485,4,31,24,7,13,0
236122,1,0,3,-3,3,0
301690,4,17,6,11,15,0
392652,3,13,0,13,4,0
33115,3,10,21,-11,16,0
34467,4,38,3,35,16,1
305154,4,24,10,14,16,1
190776,1,6,3,3,17,0
368647,1,0,3,-3,11,1
82611,2,0,10,-10,3,1
127993,4,23,27,-4,6,1
12427,3,10,6,4,6,0
142867,1,0,0,0,13,1
253195,1,0,7,-7,11,1
43892,1,0,0,0,3,0
414874,3,21,7,14,15,0
329384,3,16,34,-18,10,0
284627,2,14,17,-3,7,1
313448,3,17,7,10,3,1
363623,1,0,0,0,8,0
25531,2,13,7,6,12,1
330221,2,7,13,-6,11,0
270286,4,10,24,-14,1,0
27152,2,0,7,-7,13,0
358022,4,24,16,8,6,0
273907,2,7,3,4,2,1
290213,2,17,0,17,10,0
282929,1,7,0,7,6,0
54667,3,14,28,-14,8,0
359501,3,0,21,-21,6,1
92204,4,10,43,-33,8,1
293310,1,0,0,0,11,1
66596,2,0,14,-14,14,1
91596,1,0,7,-7,8,1
417474,2,10,14,-4,16,0
192292,2,24,3,21,1,1
274603,4,24,26,-2,3,1
379726,2,9,0,9,16,0
183220,2,7,7,0,14,0
298855,4,21,9,12,14,1
30205,4,13,24,-11,14,0
290869,4,17,21,-4,10,0
283632,4,20,20,0,7,1
248388,1,3,0,3,8,1
392518,3,3,20,-17,4,0
171994,4,21,28,-7,9,0
212514,4,13,13,0,10,0
241852,2,13,6,7,5,1
383212,2,14,3,11,17,1
207603,3,34,10,24,7,1
26218,1,0,7,-7,13,1
112930,4,19,6,13,17,0
401411,2,17,7,10,8,0
399261,4,13,30,-17,7,1
86768,4,27,21,6,5,1
197319,3,17,3,14,3,0
354686,4,10,17,-7,4,1
170975,1,7,0,7,8,0
297229,3,7,6,1,13,1
178272,1,0,0,0,12,1
68425,4,3,21,-18,14,0
280253,2,3,13,-10,5,1
421459,1,0,0,0,17,0
155100,3,6,33,-27,1,1
46159,2,7,14,-7,4,1
272330,1,7,0,7,2,1
116206,4,22,19,3,1,1
274059,2,10,0,10,3,1
184490,2,7,7,0,14,1
253560,2,6,7,-1,11,0
30701,2,10,14,-4,15,1
418522,1,0,0,0,16,0
387301,4,6,10,-4,2,0
91990,3,13,23,-10,8,1
51591,2,7,10,-3,7,1
314735,1,14,0,14,4,0
314941,3,0,10,-10,4,0
84259,2,0,7,-7,4,0
103412,4,10,23,-13,13,1
406531,3,14,23,-9,11,0
264002,4,30,7,23,15,0
224701,1,0,0,0,15,0
145951,3,7,21,-14,15,0
253254,3,3,7,-4,11,0
392466,1,0,10,-10,4,1
356485,2,0,3,-3,5,1
128328,2,0,3,-3,7,0
407422,3,14,7,7,11,0
175525,2,3,0,3,11,1
191149,4,28,27,1,17,0
127748,2,0,14,-14,6,1
347942,3,0,21,-21,1,0
320033,4,43,36,7,6,0
45207,4,7,10,-3,4,1
1445,4,19,7,12,1,1
343847,4,24,3,21,17,1
392891,1,0,0,0,4,1
104688,4,14,3,11,14,0
151635,3,23,20,3,17,1
213860,3,48,7,41,10,1
101139,4,19,24,-5,12,0
35263,1,0,0,0,16,1
123649,3,7,16,-9,4,1
5401,3,20,16,4,3,0
301049,3,17,3,14,15,0
161829,1,0,0,0,4,1
347867,1,0,0,0,1,0
292,4,12,34,-22,1,1
334606,4,30,31,-1,13,1
257920,1,0,0,0,13,1
60349,2,3,7,-4,11,1
263573,1,0,0,0,15,0
292725,2,7,7,0,11,0
158220,3,30,0,30,3,1
147220,1,0,21,-21,15,1
368387,2,14,0,14,11,0
54355,2,14,19,-5,8,1
421208,1,6,0,6,17,0
360229,4,20,19,1,7,0
9542,4,13,20,-7,5,1
65820,5,34,33,1,13,0
158988,4,21,29,-8,3,1
246402,4,26,18,8,7,1
317479,2,10,10,0,5,0
204341,4,0,17,-17,6,1
55805,2,0,7,-7,9,0
398033,2,14,14,0,7,0
340139,1,13,7,6,15,0
140269,1,7,0,7,12,0
134860,1,0,0,0,10,0
420484,2,0,35,-35,17,1
288177,1,3,0,3,9,0
411899,2,14,3,11,13,1
224012,2,14,6,8,15,0
65949,4,24,21,3,13,1
382810,2,21,0,21,17,0
6427,4,9,20,-11,3,0
361799,2,24,7,17,7,1
417659,3,21,6,15,16,0
37091,3,13,17,-4,17,0
317840,3,9,10,-1,5,0
393142,4,24,3,21,4,1
172590,4,17,24,-7,9,1
73003,1,0,0,0,16,1
161640,4,36,16,20,4,1
407299,3,17,19,-2,11,0
142112,2,0,7,-7,13,1
162128,4,51,20,31,4,1
94626,2,14,19,-5,9,0
46302,2,3,14,-11,4,1
45453,2,21,7,14,4,0
131039,1,0,0,0,8,1
293581,4,27,20,7,11,0
87007,3,14,15,-1,5,0
376544,3,8,6,2,14,1
282078,2,6,8,-2,6,1
350434,2,0,6,-6,2,1
151348,3,31,14,17,17,0
318812,1,6,0,6,5,1
261627,1,0,0,0,14,0
335187,3,20,13,7,13,1
385657,4,16,24,-8,1,1
116583,2,10,0,10,2,0
263199,3,10,17,-7,15,1
205177,2,7,10,-3,6,1
158186,2,10,0,10,3,0
182773,2,10,3,7,14,1
162777,1,0,0,0,5,1
43096,3,3,17,-14,3,1
44720,2,0,12,-12,3,1
9158,2,0,13,-13,5,0
417777,1,0,0,0,16,1
157632,4,22,3,19,2,1
417017,1,3,0,3,15,1
64073,4,20,24,-4,13,1
21441,3,12,14,-2,11,0
291212,1,7,0,7,10,0
352090,2,3,13,-10,3,1
262164,3,28,6,22,15,1
54824,3,13,0,13,8,1
361,2,21,10,11,1,0
79296,2,12,3,9,2,1
124335,4,41,27,14,5,1
303387,1,7,0,7,16,1
138336,3,27,0,27,11,0
181284,3,3,13,-10,13,0
196028,1,0,7,-7,2,1
215048,3,13,7,6,11,1
342485,4,20,3,17,16,1
161984,1,0,0,0,4,1
23671,3,7,27,-20,12,1
213736,4,38,17,21,10,0
148588,2,0,6,-6,16,0
400215,2,10,6,4,8,1
209003,1,3,0,3,8,0
390720,3,13,10,3,3,0
201402,1,0,0,0,5,0
247047,1,0,3,-3,8,0
347785,2,10,0,10,1,1
130874,4,20,15,5,8,1
285441,3,27,8,19,8,1
48658,1,7,0,7,5,0
90163,3,3,0,3,7,0
322434,1,6,0,6,7,1
253652,1,0,0,0,11,0
284468,2,14,12,2,7,0
139296,3,20,13,7,12,0
262902,3,14,23,-9,15,0
264922,2,17,17,0,16,1
217924,4,25,28,-3,12,1
320314,4,14,24,-10,6,1
301414,1,0,0,0,15,1
203221,4,10,17,-7,5,0
28987,3,7,7,0,14,1
4544,4,24,26,-2,2,1
219055,3,30,13,17,13,1
353511,1,3,0,3,4,1
413187,1,0,0,0,14,0
226281,3,16,0,16,16,0
270619,4,23,14,9,1,1
240785,3,10,7,3,5,0
288508,2,3,14,-11,9,1
352532,2,20,6,14,3,0
29974,2,14,0,14,14,1
113202,4,41,22,19,17,1
5628,2,0,14,-14,3,1
253525,2,0,7,-7,11,1
329258,4,31,13,18,10,0
338592,4,36,38,-2,14,1
124440,3,9,7,2,5,0
360667,4,17,34,-17,7,0
314813,3,28,7,21,4,1
391652,1,0,0,0,4,1
289346,3,28,17,11,9,0
210742,2,14,7,7,9,1
340792,3,17,10,7,15,0
190176,1,0,0,0,17,0
405500,4,24,16,8,10,0
144998,2,3,3,0,14,1
9130,1,0,7,-7,5,1
237573,4,38,22,16,3,1
301,4,19,34,-15,1,0
87021,4,14,22,-8,5,1
415526,1,0,0,0,15,1
179856,2,3,9,-6,13,0
218666,4,10,33,-23,13,1
383493,2,7,3,4,17,0
350707,2,7,0,7,2,1
52700,3,3,20,-17,7,1
200678,4,41,28,13,4,0
288204,2,3,7,-4,9,1
123126,1,3,0,3,4,0
244377,3,0,17,-17,7,0
56603,3,19,17,2,9,1
78690,2,10,0,10,2,1
251772,4,30,9,21,10,1
10256,4,13,10,3,5,0
25892,4,31,17,14,12,0
239488,4,22,24,-2,4,1
57230,4,20,14,6,10,1
262062,4,24,31,-7,14,0
148944,3,10,12,-2,16,0
376700,3,3,0,3,14,0
89922,1,0,0,0,7,0
196411,3,17,7,10,2,1
343372,3,0,20,-20,16,0
128759,2,0,3,-3,7,1
150385,4,33,13,20,16,0
29749,3,33,3,30,14,1
142901,2,0,10,-10,13,0
345058,1,0,0,0,17,0
137294,4,13,27,-14,11,1
395872,4,10,17,-7,6,0
301796,3,3,27,-24,15,0
159666,1,0,0,0,3,0
308052,1,0,7,-7,1,1
41531,4,15,7,8,2,1
202141,3,13,3,10,5,1
93156,2,0,0,0,9,0
228416,4,10,20,-10,17,0
29075,1,0,3,-3,14,0
132057,4,3,24,-21,8,1
406228,2,14,17,-3,11,0
412013,1,7,0,7,13,0
23625,2,7,10,-3,12,0
357675,2,13,3,10,5,0
8657,3,7,10,-3,4,1
352976,3,13,3,10,3,0
358971,1,7,0,7,6,0
350762,3,10,3,7,2,1
151141,1,3,10,-7,17,1
28326,1,0,0,0,14,0
278100,4,13,17,-4,4,1
325007,2,20,21,-1,8,1
218060,4,21,24,-3,12,0
73018,1,0,0,0,16,0
312040,1,7,7,0,2,0
124702,2,0,3,-3,5,1
149144,4,17,31,-14,16,1
342254,2,6,0,6,16,0
317773,1,3,0,3,5,0
206566,2,10,10,0,7,1
306038,3,10,10,0,17,0
415778,4,21,17,4,15,0
122518,1,7,0,7,4,0
409161,4,3,17,-14,12,0
265858,1,0,6,-6,16,0
416670,4,34,7,27,15,1
140397,1,0,0,0,12,1
389553,4,27,17,10,3,0
224563,1,3,6,-3,15,0
271155,3,7,10,-3,1,0
203162,2,0,10,-10,5,1
150240,4,12,26,-14,16,0
325685,4,34,7,27,9,0
400680,3,9,7,2,8,1
263972,3,23,7,16,15,1
185165,4,0,23,-23,15,1
131627,1,0,6,-6,8,0
133747,2,0,7,-7,9,1
54534,4,21,10,11,8,1
186317,3,26,3,23,15,0
227456,2,13,7,6,16,0
241719,3,7,6,1,5,0
306813,4,26,36,-10,17,0
284151,2,3,13,-10,7,1
45765,3,10,14,-4,4,1
50815,1,0,7,-7,6,1
124627,4,13,17,-4,5,1
242097,1,0,0,0,6,1
76812,3,33,0,33,1,0
57263,1,0,0,0,10,0
56721,2,0,10,-10,9,0
247336,4,42,48,-6,8,1
239300,3,3,14,-11,4,1
384365,4,16,17,-1,1,0
8414,1,0,0,0,4,1
178100,5,26,23,3,12,0
308600,3,15,16,-1,1,0
396336,1,7,0,7,6,0
354594,1,0,7,-7,4,1
175252,2,15,0,15,10,0
109526,1,0,7,-7,16,0
355391,2,3,3,0,4,0
166500,4,23,17,6,6,0
291132,3,15,13,2,10,1
210354,4,16,17,-1,9,1
285478,4,36,8,28,8,1
156532,4,7,6,1,2,1
417722,4,35,19,16,16,1
94752,1,3,0,3,9,0
324688,2,0,7,-7,8,1
152833,4,21,18,3,17,1
8172,2,0,7,-7,4,0
322602,2,3,3,0,7,0
195302,1,0,0,0,2,0
264120,3,13,27,-14,15,1
379768,3,9,17,-8,16,1
406137,4,3,29,-26,11,0
324871,2,10,10,0,8,0
187798,1,7,0,7,16,0
157620,4,22,3,19,2,1
272392,2,24,0,24,2,0
168161,3,16,5,11,7,1
47252,4,19,9,10,5,0
2485,1,0,0,0,2,1
308009,4,21,12,9,1,0
383597,4,24,24,0,17,1
192971,3,17,17,0,1,0
204679,1,7,0,7,6,0
408093,4,20,17,3,12,0
120943,1,0,0,0,3,1
120719,2,17,0,17,3,0
368364,1,7,0,7,11,1
31238,4,26,34,-8,15,1
301149,2,10,3,7,15,0
73263,4,14,16,-2,16,0
414633,1,0,0,0,14,1
352763,1,0,0,0,3,1
212504,4,13,13,0,10,1
77946,2,3,7,-4,1,0
174883,4,26,17,9,10,1
240979,4,21,22,-1,5,1
379633,4,26,13,13,16,0
359887,2,20,21,-1,6,0
301547,4,20,24,-4,15,0
133648,3,10,28,-18,9,1
404131,1,6,0,6,10,0
262020,3,24,24,0,14,0
294362,2,13,3,10,12,1
224905,2,0,6,-6,15,0
234026,2,14,0,14,2,0
40829,4,32,35,-3,2,1
77213,2,6,0,6,1,1
325148,2,13,7,6,8,1
16887,1,7,13,-6,8,1
318916,4,24,28,-4,5,1
76526,3,7,20,-13,1,0
244643,2,0,16,-16,7,0
96659,4,3,17,-14,10,1
160464,2,20,7,13,4,0
268147,2,6,14,-8,17,1
154545,1,0,0,0,1,1
23978,4,23,6,17,12,0
242427,1,0,7,-7,6,0
375022,3,21,27,-6,14,0
334905,4,27,10,17,13,0
287581,1,0,0,0,9,0
143356,3,7,13,-6,14,1
260524,3,27,0,27,14,1
75682,1,6,0,6,1,1
160471,2,20,7,13,4,1
10338,2,10,28,-18,5,1
372395,1,6,0,6,13,1
46152,1,7,7,0,4,0
94361,3,17,7,10,9,0
1370,2,7,0,7,1,0
302729,1,0,0,0,15,0
297420,4,30,24,6,13,0
99607,2,0,3,-3,11,1
132416,2,0,20,-20,9,0
268406,1,7,0,7,17,1
236027,3,20,3,17,3,1
307166,2,0,10,-10,17,0
322090,3,26,0,26,7,0
247658,1,7,0,7,8,0
243210,1,0,0,0,6,1
238009,3,10,13,-3,4,0
75836,1,7,0,7,1,1
186847,4,29,20,9,15,1
304953,2,7,6,1,16,1
304260,4,33,22,11,16,1
242915,3,21,13,8,6,0
174052,2,0,26,-26,10,0
300901,3,10,10,0,15,0
47761,1,0,0,0,5,1
396213,1,0,0,0,6,1
257285,4,26,26,0,12,1
50727,3,14,14,0,6,1
329477,2,9,0,9,10,1
276003,1,3,0,3,3,0
100143,1,0,0,0,12,1
418135,2,21,3,18,16,0
421033,1,0,0,0,17,0
410146,3,17,16,1,13,0
246756,2,3,3,0,8,0
248811,4,30,14,16,9,1
187623,1,0,0,0,16,1
295765,4,24,16,8,12,0
217303,2,0,7,-7,12,0
211494,2,19,7,12,9,1
259772,3,17,10,7,14,1
144931,4,20,7,13,14,0
374504,1,6,0,6,14,1
7840,1,0,7,-7,4,0
114779,2,7,10,-3,1,0
227639,4,35,0,35,16,1
83794,1,0,0,0,4,0
74880,4,20,20,0,17,0
129553,2,3,17,-14,7,1
219311,2,13,7,6,13,0
228221,3,10,27,-17,17,1
85563,4,17,22,-5,5,1
36724,1,0,0,0,17,0
207473,3,21,14,7,7,0
284251,4,16,33,-17,7,0
256779,3,13,13,0,12,1
110547,1,0,0,0,16,1
188583,3,10,13,-3,16,1
193528,1,0,0,0,1,0
139357,1,7,0,7,12,0
205064,4,19,20,-1,6,1
382124,3,27,3,24,17,0
360824,4,24,37,-13,7,1
213868,4,48,7,41,10,0
378706,2,14,7,7,15,0
383056,2,16,7,9,17,1
404452,2,14,7,7,10,1
248948,3,20,3,17,9,0
414942,1,0,7,-7,15,1
193838,2,17,0,17,1,1
53503,1,7,3,4,8,1
102725,1,0,0,0,13,0
402881,3,17,6,11,9,0
382599,4,0,24,-24,17,0
2477,4,28,20,8,2,0
69039,4,27,24,3,15,0
237868,3,7,27,-20,4,1
208223,4,3,10,-7,8,1
149193,1,0,0,0,16,1
211626,2,13,3,10,9,0
176351,3,16,21,-5,11,1
125466,3,13,0,13,5,1
46665,4,10,3,7,4,1
342657,1,0,0,0,16,1
254494,4,29,13,16,11,0
226035,5,34,34,0,16,0
204360,4,3,17,-14,6,1
318685,1,3,13,-10,5,1
14449,2,24,3,21,7,0
338693,3,20,10,10,14,1
355525,1,7,0,7,5,0
238056,4,13,13,0,4,1
126607,4,23,20,3,6,0
25532,2,14,7,7,12,1
404425,1,7,0,7,10,0
165832,3,6,9,-3,6,1
120727,2,17,0,17,3,0
128817,3,13,13,0,7,1
377567,3,17,9,8,15,0
295564,3,23,19,4,12,1
180882,1,0,0,0,13,0
122256,2,3,13,-10,4,1
166445,3,17,7,10,6,0
312044,2,7,7,0,2,1
191103,3,7,13,-6,17,1
32837,3,6,7,-1,15,1
26222,1,0,7,-7,13,1
114219,3,3,7,-4,1,0
188946,4,26,13,13,16,0
8956,4,28,13,15,4,1
339455,3,10,23,-13,15,1
380549,3,14,17,-3,16,0
272181,1,0,0,0,2,1
418968,1,7,7,0,16,0
213745,1,0,0,0,10,0
366397,2,26,0,26,10,0
57470,2,14,9,5,10,0
41642,3,17,0,17,2,1
409633,1,0,0,0,12,1
154989,1,0,0,0,1,0
348414,4,13,20,-7,1,0
286812,1,3,0,3,8,0
190584,4,20,20,0,17,1
125820,4,17,23,-6,5,0
32645,2,0,0,0,15,0
127733,1,0,7,-7,6,1
248532,4,23,23,0,8,0
161725,2,10,3,7,4,1
413169,4,40,45,-5,14,1
3300,3,3,3,0,2,1
351208,2,21,10,11,3,1
99407,1,0,0,0,11,0
354964,2,7,9,-2,4,1
106531,1,7,0,7,14,0
17621,1,0,0,0,9,0
216676,2,21,6,15,12,0
120541,1,0,6,-6,3,0
82786,3,9,9,0,3,1
416012,2,7,0,7,15,1
92011,4,27,23,4,8,0
231242,1,0,0,0,1,1
9727,1,0,7,-7,5,1
280314,4,16,22,-6,5,1
324617,4,16,15,1,8,0
194681,4,40,10,30,2,1
208830,4,6,22,-16,8,0
393933,5,23,23,0,5,1
324716,2,13,7,6,8,0
128899,1,2,3,-1,7,1
41819,4,21,14,7,2,0
57248,4,20,21,-1,10,1
195872,4,30,21,9,2,1
315533,3,7,14,-7,4,1
302724,4,26,20,6,15,0
246836,4,13,20,-7,8,1
328938,3,9,7,2,10,0
95139,3,9,17,-8,9,1
396183,4,24,31,-7,6,0
202356,4,20,13,7,5,1
253513,1,0,7,-7,11,0
85396,4,31,10,21,5,0
40428,2,7,7,0,2,0
44864,2,0,17,-17,4,1
168518,1,0,0,0,7,1
370481,3,20,9,11,12,0
97167,1,0,3,-3,10,1
181688,2,0,7,-7,13,1
298587,4,13,7,6,14,0
122193,4,27,28,-1,4,0
374289,3,14,13,1,13,0
358995,2,10,0,10,6,0
126769,4,19,20,-1,6,1
264786,3,17,23,-6,16,0
112103,2,7,17,-10,17,0
256880,2,7,10,-3,12,1
401457,4,24,10,14,8,1
346190,2,17,0,17,1,0
263419,1,0,13,-13,15,1
287696,4,9,13,-4,9,1
129474,5,26,26,0,7,1
19269,2,7,14,-7,10,0
167950,1,0,0,0,7,0
212857,5,24,24,0,10,1
297972,3,30,7,23,13,0
13741,2,0,17,-17,7,1
193880,3,24,7,17,1,0
305109,2,21,10,11,16,0
170109,2,7,3,4,8,1
3868,2,16,7,9,2,1
418601,3,14,17,-3,16,1
312904,4,21,21,0,3,0
301852,1,0,0,0,15,1
130869,4,20,15,5,8,0
113729,2,3,10,-7,17,1
372754,2,0,0,0,13,1
370838,1,0,0,0,12,0
139279,3,13,13,0,12,1
143039,1,0,7,-7,13,1
398658,3,0,3,-3,7,1
325603,2,10,7,3,9,1
179783,4,6,24,-18,12,0
101585,3,13,31,-18,12,0
288404,3,10,0,10,9,1
221539,2,13,12,1,14,1
177824,2,7,10,-3,12,1
276611,2,7,3,4,4,0
224727,2,3,0,3,15,1
175888,3,20,27,-7,11,1
46791,3,14,27,-13,4,1
42752,1,3,0,3,3,0
10341,2,10,28,-18,5,0
88514,4,19,14,5,6,0
316553,2,3,3,0,4,0
8260,4,16,13,3,4,1
262571,2,13,0,13,15,0
57454,1,7,3,4,10,1
130355,3,7,3,4,8,1
66511,3,28,24,4,14,0
226423,2,0,7,-7,16,1
284425,1,0,9,-9,7,0
40081,4,20,14,6,1,1
41346,3,14,9,5,2,0
101047,1,0,3,-3,12,1
250612,2,3,0,3,10,0
90236,1,0,0,0,7,0
113415,2,0,7,-7,17,0
133318,2,7,3,4,9,0
254493,4,29,13,16,11,0
340154,2,20,7,13,15,1
7655,4,34,3,31,4,0
397469,3,13,16,-3,6,0
381552,3,28,13,15,17,0
169024,2,19,14,5,7,0
396629,4,23,10,13,6,0
37610,2,7,0,7,17,1
18829,1,3,0,3,9,0
367454,4,26,21,5,10,0
97995,3,17,10,7,11,1
388535,4,3,23,-20,2,0
40480,3,7,17,-10,2,0
323469,1,0,3,-3,7,1
384541,2,0,21,-21,1,0
58526,2,7,3,4,10,1
689,3,0,17,-17,1,0
341822,2,10,9,1,16,1
404966,3,6,13,-7,10,1
200916,3,27,7,20,4,1
22090,5,24,24,0,11,1
12537,2,3,17,-14,6,0
202906,3,28,0,28,5,1
325440,2,13,3,10,8,1
410429,3,9,17,-8,13,0
217883,3,17,21,-4,12,1
79702,1,7,7,0,2,1
168963,1,0,0,0,7,1
45831,1,0,0,0,4,0
211801,2,0,7,-7,9,1
191708,3,10,17,-7,17,1
268871,2,6,10,-4,17,0
383278,3,38,17,21,17,1
220251,2,17,9,8,13,1
319544,4,16,23,-7,6,0
138370,4,32,7,25,11,0
285773,2,7,10,-3,8,0
228046,2,3,3,0,17,1
56765,3,14,13,1,9,1
188324,4,23,13,10,16,0
5712,4,0,24,-24,3,1
219523,3,9,21,-12,13,1
153898,3,7,6,1,1,1
78516,1,0,0,0,2,0
40372,4,12,10,2,2,1
57315,2,7,0,7,10,0
71741,2,17,20,-3,16,0
323320,1,0,0,0,7,0
139222,1,3,6,-3,12,0
120734,3,23,0,23,3,1
20474,2,0,0,0,10,0
348528,2,28,7,21,2,1
210126,2,0,0,0,9,1
286022,1,0,0,0,8,1
357125,3,6,14,-8,5,0
293942,3,7,21,-14,12,0
190726,4,42,17,25,17,1
146224,2,0,10,-10,15,1
182869,1,0,0,0,14,0
107648,3,13,20,-7,15,1
332357,4,16,13,3,12,1
2690,3,6,7,-1,2,0
171717,1,0,0,0,9,1
7657,4,34,3,31,4,0
108584,4,26,14,12,15,0
105099,3,26,14,12,14,0
28312,1,0,0,0,14,1
145300,2,14,9,5,14,0
199619,1,0,0,0,4,0
74376,2,7,10,-3,17,0
44136,3,10,13,-3,3,0
143471,2,14,14,0,14,0
243036,1,0,3,-3,6,1
206178,1,0,0,0,7,1
328609,2,17,21,-4,10,0
271904,2,10,13,-3,2,0
6086,2,7,10,-3,3,0
207301,2,10,14,-4,7,0
113346,4,26,38,-12,17,1
332487,3,23,9,14,12,0
160370,4,3,21,-18,4,1
173245,4,20,27,-7,9,1
262059,4,24,31,-7,14,0
390410,3,7,27,-20,3,0
253283,4,3,13,-10,11,1
355613,3,24,10,14,5,1
37506,3,7,7,0,17,1
348103,3,3,19,-16,1,1
26779,3,6,33,-27,13,0
390604,4,20,27,-7,3,1
136677,1,0,0,0,11,0
243722,2,17,3,14,6,0
313962,1,0,0,0,3,1
29638,4,14,21,-7,14,0
165309,4,17,31,-14,6,1
12448,4,13,6,7,6,1
333653,2,7,0,7,12,0
156534,4,7,6,1,2,1
356907,1,3,0,3,5,0
103106,3,34,7,27,13,1
224879,1,0,3,-3,15,0
104870,1,0,3,-3,14,0
336896,3,7,14,-7,14,1
387349,1,7,0,7,2,1
125914,2,13,10,3,6,1
186290,2,13,3,10,15,1
316293,3,10,16,-6,4,1
72820,3,31,17,14,16,1
50638,4,17,9,8,6,0
123972,3,10,7,3,5,0
15695,4,37,17,20,8,0
305423,3,20,3,17,17,0
260944,2,7,0,7,14,1
241287,3,10,0,10,5,0
350587,2,10,0,10,2,1
357932,1,6,6,0,6,1
124864,3,3,6,-3,5,0
318092,2,9,7,2,5,0
386290,1,0,0,0,2,0
147022,4,27,0,27,15,1
401582,3,17,14,3,8,0
9423,1,0,0,0,5,1
123252,4,22,21,1,4,1
384098,2,0,10,-10,1,1
193172,1,0,0,0,1,0
240086,1,0,0,0,5,0
379934,4,21,6,15,16,1
322033,2,6,0,6,7,1
225614,2,0,7,-7,16,0
35285,2,3,0,3,16,1
50259,2,10,14,-4,6,0
40079,4,20,14,6,1,0
96083,4,16,21,-5,10,1
49839,3,21,10,11,6,1
210113,1,0,0,0,9,1
48685,2,7,10,-3,5,1
179407,3,6,13,-7,12,1
394679,4,24,21,3,5,1
289682,4,13,23,-10,10,1
107072,3,33,0,33,15,1
281274,1,7,3,4,6,0
337214,3,16,16,0,14,1
277044,1,3,0,3,4,1
389572,1,0,0,0,3,1
123765,2,10,3,7,5,0
12181,1,0,0,0,6,0
21737,3,24,14,10,11,0
66423,1,0,0,0,14,0
139232,2,3,6,-3,12,0
275530,4,26,36,-10,3,1
369959,1,7,0,7,12,0
94761,1,3,3,0,9,1
317413,4,7,17,-10,5,0
29768,4,41,3,38,14,0
116321,3,24,13,11,1,1
375709,1,0,0,0,14,1
185746,3,23,3,20,15,0
413317,4,20,0,20,14,1
250075,4,17,13,4,9,1
328900,2,6,0,6,10,0
19191,3,21,13,8,10,0
316251,2,7,13,-6,4,0
154996,1,6,0,6,1,0
247925,4,20,6,14,8,1
374353,1,0,0,0,14,1
71125,1,12,0,12,16,1
65014,2,0,14,-14,13,0
403943,4,20,17,3,10,0
284101,1,0,0,0,7,0
174403,4,17,3,14,10,0
30898,3,3,17,-14,15,0
216686,2,21,6,15,12,1
165900,4,6,19,-13,6,0
182260,1,7,0,7,14,0
280430,3,16,23,-7,5,0
267839,3,26,14,12,17,0
292288,2,6,10,-4,11,1
151050,3,10,3,7,17,0
289294,2,14,17,-3,9,1
157601,3,12,0,12,2,0
336683,1,0,3,-3,14,1
189397,4,33,24,9,16,0
120295,4,24,13,11,3,1
102196,3,23,7,16,13,1
324104,2,0,7,-7,8,0
250167,2,17,0,17,9,0
210373,4,22,17,5,9,0
254051,4,14,20,-6,11,0
165638,2,0,0,0,6,1
255422,4,24,6,18,12,0
403172,2,16,14,2,9,1
370572,2,14,7,7,12,0
112598,3,31,26,5,17,0
191943,1,0,6,-6,1,1
309225,1,0,6,-6,1,0
373024,2,0,0,0,13,0
115348,1,0,0,0,1,1
415795,4,27,24,3,15,0
45926,3,17,3,14,4,1
215774,3,29,6,23,11,0
165059,3,10,17,-7,6,1
184267,3,31,7,24,14,0
140207,5,13,13,0,12,1
168708,2,10,3,7,7,1
156619,2,3,0,3,2,1
60044,2,7,3,4,11,1
43081,3,3,10,-7,3,1
251480,1,16,3,13,10,1
20100,1,0,0,0,10,1
274838,1,0,7,-7,3,0
263851,4,14,24,-10,15,0
127640,3,24,9,15,6,0
66260,4,45,3,42,13,1
103399,4,10,20,-10,13,0
260430,4,20,14,6,14,0
143515,3,17,21,-4,14,0
393461,4,34,27,7,5,0
273401,1,0,0,0,2,0
235748,4,10,27,-17,3,1
271766,3,23,10,13,2,1
325484,3,19,6,13,8,0
165870,4,6,19,-13,6,1
119670,4,17,19,-2,3,1
311160,1,3,0,3,2,1
216723,3,27,6,21,12,1
47331,2,0,10,-10,5,1
330328,1,0,3,-3,11,1
269002,1,0,3,-3,17,0
407925,4,17,24,-7,11,1
135326,1,7,10,-3,10,0
59084,3,3,17,-14,10,0
255769,2,3,0,3,12,1
133948,4,13,6,7,9,1
408218,4,13,3,10,12,1
124865,3,9,6,3,5,0
5546,3,16,10,6,3,1
326903,1,0,0,0,9,1
21084,1,0,0,0,10,1
250218,4,24,16,8,9,0
384225,1,0,0,0,1,1
45054,4,23,13,10,4,0
61887,4,20,23,-3,12,1
317723,5,23,23,0,5,1
202371,1,0,0,0,5,1
159215,2,14,14,0,3,0
173248,1,0,0,0,10,1
44452,3,17,7,10,3,0
152998,4,42,17,25,1,0
70943,4,15,39,-24,15,1
103962,3,3,10,-7,13,1
135225,2,13,3,10,10,0
366831,2,0,3,-3,10,1
65567,2,6,3,3,13,0
194547,1,0,0,0,2,1
372272,2,10,7,3,13,0
395829,3,3,14,-11,6,0
250098,1,0,0,0,9,0
181154,4,24,14,10,13,0
358197,4,23,17,6,6,0
230170,3,3,26,-23,17,1
12545,2,3,17,-14,6,0
300869,2,0,7,-7,15,1
405656,4,24,28,-4,10,1
85447,1,7,3,4,5,0
264328,4,17,36,-19,15,0
395465,1,7,0,7,6,0
268692,1,0,0,0,17,1
214404,2,7,7,0,11,0
208637,3,6,3,3,8,0
37380,3,17,0,17,17,0
237360,2,6,13,-7,3,0
229316,4,24,27,-3,17,1
73124,4,13,17,-4,16,1
245864,2,3,23,-20,7,1
306138,2,0,0,0,17,1
62797,4,17,0,17,12,1
103622,2,0,0,0,13,0
143063,2,3,14,-11,13,1
274746,4,24,20,4,3,1
85545,4,17,19,-2,5,0
271440,2,14,0,14,1,0
155573,3,23,3,20,2,0
169664,3,20,17,3,8,1
207962,1,0,0,0,8,1
227256,2,3,10,-7,16,0
366271,3,14,10,4,10,1
293678,3,10,10,0,12,1
252276,2,0,10,-10,10,0
60095,3,7,12,-5,11,0
357144,4,6,14,-8,5,0
394596,2,14,0,14,5,1
225567,1,0,0,0,16,0
21892,3,28,0,28,11,0
215900,2,3,7,-4,11,1
399608,2,3,3,0,8,1
366633,1,0,0,0,10,1
188085,2,0,3,-3,16,0
216439,1,7,0,7,12,1
369738,3,29,30,-1,11,1
174296,1,7,0,7,10,1
342188,4,15,19,-4,16,1
212693,1,0,0,0,10,0
84711,2,10,7,3,4,0
191412,3,0,31,-31,17,1
383708,3,9,24,-15,17,1
131118,3,20,9,11,8,1
265345,2,7,7,0,16,0
205307,2,10,0,10,6,0
258276,2,14,12,2,13,1
402034,4,3,19,-16,9,0
159344,1,0,0,0,3,0
397407,2,0,10,-10,6,0
368277,3,6,3,3,11,0
363029,4,33,26,7,8,0
5125,4,13,7,6,3,1
28209,2,3,0,3,13,1
139872,4,23,17,6,12,1
209686,2,9,0,9,8,0
166420,2,17,7,10,6,1
229654,1,7,7,0,17,0
108833,3,7,10,-3,15,1
309162,3,35,3,32,1,0
287888,1,0,0,0,9,0
213969,2,23,7,16,10,1
370094,1,0,0,0,12,1
114445,1,0,6,-6,1,0
168403,2,0,3,-3,7,1
142365,4,7,6,1,13,0
72229,3,17,17,0,16,1
123755,2,7,3,4,5,0
108201,1,6,0,6,15,0
42047,2,19,7,12,2,1
105758,4,35,10,25,14,1
2756,1,0,0,0,2,0
225647,3,13,10,3,16,1
378708,2,14,7,7,15,0
334584,4,27,24,3,13,1
229462,4,13,9,4,17,1
90773,3,20,7,13,7,1
140093,2,0,0,0,12,1
235079,2,0,7,-7,2,0
327848,2,16,10,6,10,0
370377,1,0,0,0,12,1
306963,4,6,43,-37,17,0
387459,4,21,16,5,2,0
177184,1,0,0,0,11,1
405746,3,10,7,3,10,1
147669,2,10,0,10,15,0
22886,3,0,13,-13,11,0
90813,4,34,7,27,7,1
341195,2,10,7,3,16,1
161219,1,0,3,-3,4,1
415106,1,0,14,-14,15,0
387060,1,7,14,-7,2,1
112326,4,45,17,28,17,1
153377,2,0,10,-10,1,1
89300,4,15,7,8,7,0
26267,2,7,14,-7,13,1
311841,4,20,20,0,2,0
269674,3,10,3,7,1,0
53315,4,24,10,14,8,0
16703,4,21,33,-12,8,1
270534,2,3,7,-4,1,1
120399,2,16,9,7,3,0
247789,4,10,13,-3,8,0
157141,4,16,20,-4,2,1
203485,2,21,3,18,6,0
236371,3,7,23,-16,3,1
159913,3,31,7,24,3,1
137737,3,10,27,-17,11,0
68653,2,7,0,7,15,1
186918,2,7,3,4,15,0
79156,2,3,7,-4,2,1
421656,2,10,7,3,17,0
317662,3,9,6,3,5,0
260155,1,0,0,0,14,1
42474,2,0,5,-5,3,0
100002,1,0,0,0,12,1
323829,3,13,15,-2,8,1
29512,1,0,0,0,14,1
142924,2,3,10,-7,13,1
25624,4,36,10,26,12,1
190140,4,30,3,27,17,0
158419,4,16,27,-11,3,1
363996,3,6,9,-3,8,0
259413,1,3,3,0,13,0
380470,1,0,7,-7,16,1
34535,1,0,0,0,16,0
205486,2,14,3,11,6,0
168451,3,0,24,-24,7,0
145406,1,0,7,-7,14,1
192695,4,19,7,12,1,0
333000,1,3,3,0,12,0
126966,2,3,10,-7,6,1
89092,3,13,6,7,6,1
7322,4,20,19,1,4,0
47294,1,0,7,-7,5,1
11436,4,26,0,26,6,1
173181,3,17,17,0,9,1
139462,4,27,10,17,12,0
284859,5,29,30,-1,7,1
349747,3,20,7,13,2,0
93406,2,3,7,-4,9,1
289853,1,0,3,-3,10,1
282949,2,7,3,4,6,1
180185,3,13,7,6,13,1
221468,4,3,41,-38,14,1
84439,2,6,7,-1,4,1
120654,1,0,0,0,3,0
113087,4,16,23,-7,17,1
323843,3,16,15,1,8,0
340878,1,0,3,-3,15,1
283605,3,13,17,-4,7,0
6245,2,13,7,6,3,0
64327,3,6,13,-7,13,0
158414,4,16,27,-11,3,1
226783,4,7,20,-13,16,1
100823,3,9,13,-4,12,1
401317,4,20,24,-4,8,1
77112,3,14,17,-3,1,1
69930,1,0,0,0,15,1
251087,2,10,14,-4,10,1
249096,3,21,20,1,9,0
105183,1,7,0,7,14,1
360878,2,6,0,6,7,0
408424,1,0,0,0,12,0
379470,3,16,0,16,16,1
167334,2,16,16,0,7,1
382100,2,21,3,18,17,1
262457,3,7,21,-14,15,0
236598,1,0,0,0,3,1
417999,3,14,28,-14,16,0
396807,1,3,7,-4,6,1
118292,3,12,7,5,2,1
228508,3,20,7,13,17,0
203478,2,21,3,18,6,0
120583,2,0,20,-20,3,1
99094,4,23,0,23,11,0
253861,2,28,14,14,11,0
401734,4,17,14,3,8,1
255937,2,6,3,3,12,0
293619,1,7,7,0,12,1
306810,4,26,36,-10,17,0
153306,4,2,10,-8,1,0
30318,3,3,10,-7,14,0
220161,4,29,13,16,13,1
34621,4,24,7,17,16,0
215582,1,14,0,14,11,0
86889,4,9,26,-17,5,1
198399,1,3,0,3,3,0
303853,1,0,0,0,16,0
249178,1,9,0,9,9,0
112000,3,20,21,-1,17,1
87929,4,19,15,4,6,0
52071,3,13,10,3,7,1
33161,4,17,42,-25,16,0
39079,2,6,0,6,1,1
269294,4,13,19,-6,17,1
240404,1,0,0,0,5,0
261584,4,12,15,-3,14,1
365857,2,7,7,0,9,1
314808,3,28,7,21,4,0
204116,2,3,10,-7,6,0
118055,1,0,6,-6,2,1
32795,2,0,0,0,15,1
213768,1,7,0,7,10,1
321703,1,3,3,0,7,0
107343,3,10,6,4,15,0
96638,4,3,10,-7,10,1
277020,4,31,20,11,4,0
203523,4,24,3,21,6,1
115441,3,39,14,25,1,1
84070,4,30,25,5,4,1
119726,1,7,3,4,3,0
148029,3,7,3,4,15,0
366925,1,0,0,0,10,0
318349,4,9,22,-13,5,1
58175,4,29,17,12,10,1
253145,4,21,20,1,11,1
55441,3,20,10,10,9,0
382433,3,0,24,-24,17,1
118862,3,27,7,20,2,1
310752,2,3,3,0,2,0
332416,1,7,3,4,12,1
163696,1,0,6,-6,5,0
414487,1,0,0,0,14,0
233151,3,29,3,26,2,0
412608,2,3,3,0,14,1
81396,3,7,10,-3,3,1
119189,4,13,7,6,3,1
103388,3,10,20,-10,13,0
354492,3,27,28,-1,4,1
3252,1,3,0,3,2,0
275639,3,24,3,21,3,1
234266,1,0,0,0,2,0
344237,2,7,10,-3,17,0
147838,2,3,14,-11,15,1
203458,2,14,3,11,6,0
215425,1,7,3,4,11,1
120737,3,23,0,23,3,0
412843,4,28,35,-7,14,1
350361,4,24,13,11,2,1
328161,3,6,14,-8,10,0
264955,3,23,17,6,16,0
311305,1,0,0,0,2,1
279430,4,16,24,-8,5,0
384434,2,21,0,21,1,1
222444,1,3,7,-4,14,0
288216,2,3,14,-11,9,1
376609,4,15,6,9,14,0
419545,1,6,7,-1,17,1
319452,2,0,3,-3,6,1
9015,2,7,7,0,4,0
209013,1,3,0,3,8,1
317665,3,9,6,3,5,0
307018,2,10,0,10,17,0
39512,1,0,0,0,1,0
263880,1,6,0,6,15,0
308363,2,0,6,-6,1,1
299518,1,0,0,0,14,0
307700,4,17,29,-12,17,0
203176,2,7,17,-10,5,0
77519,2,13,14,-1,1,1
28660,2,3,7,-4,14,1
35181,3,0,14,-14,16,0
91147,2,3,14,-11,8,1
333161,1,0,0,0,12,0
277358,2,14,6,8,4,1
390794,1,0,7,-7,3,1
218628,3,10,30,-20,13,1
379640,4,26,13,13,16,0
153332,4,2,13,-11,1,0
58535,2,10,3,7,10,0
229630,4,39,13,26,17,1
306583,2,0,17,-17,17,0
296144,2,10,6,4,13,1
279358,2,0,7,-7,5,1
17928,1,7,7,0,9,0
65986,1,0,0,0,13,0
415922,4,10,23,-13,15,0
159779,4,7,13,-6,3,0
409873,4,30,8,22,12,0
265864,1,0,6,-6,16,0
387519,2,3,0,3,2,0
244017,2,7,10,-3,6,1
138267,1,3,0,3,11,0
300728,2,7,0,7,15,0
307805,3,17,14,3,1,1
51815,4,10,28,-18,7,1
281300,2,14,6,8,6,0
385389,2,7,7,0,1,1
240606,2,13,7,6,5,0
201698,4,24,20,4,5,1
397156,2,6,0,6,6,0
194435,2,9,0,9,2,1
14031,3,3,21,-18,7,0
373174,2,0,3,-3,13,1
61871,3,20,23,-3,12,0
51236,4,39,25,14,7,0
42719,4,7,20,-13,3,1
306001,2,3,10,-7,17,0
116130,2,0,3,-3,1,1
261976,2,14,10,4,14,0
225277,1,0,7,-7,15,1
234020,2,14,0,14,2,1
272559,3,13,3,10,2,1
265662,4,9,15,-6,16,0
287357,3,20,3,17,8,0
292606,2,9,16,-7,11,0
40476,3,7,17,-10,2,0
121117,1,0,0,0,3,0
402026,4,3,19,-16,9,1
152054,2,3,7,-4,17,1
397878,2,0,3,-3,7,1
238769,1,7,0,7,4,1
28654,2,3,7,-4,14,1
336405,2,3,3,0,14,1
302829,3,9,23,-14,15,1
64034,2,17,10,7,13,1
68831,3,6,14,-8,15,0
221124,2,0,6,-6,14,0
234132,1,0,0,0,2,0
34246,2,10,6,4,16,1
237235,3,13,0,13,3,0
251152,4,10,27,-17,10,1
87371,1,7,0,7,6,0
15793,3,0,12,-12,8,1
132659,1,0,3,-3,9,0
156415,1,0,0,0,2,1
60680,3,21,3,18,11,0
173764,2,10,3,7,10,1
172240,3,14,13,1,9,0
12312,4,6,9,-3,6,1
262449,3,7,21,-14,15,0
81782,4,34,24,10,3,0
335609,4,19,7,12,13,0
117000,1,0,3,-3,2,1
395905,1,7,0,7,6,0
8320,2,9,3,6,4,0
278640,3,14,3,11,4,1
74408,3,10,13,-3,17,1
310166,3,21,10,11,2,0
398305,2,3,3,0,7,0
378931,4,16,30,-14,15,0
86408,2,20,7,13,5,0
351716,4,21,17,4,3,0
34956,4,27,27,0,16,1
153289,3,2,7,-5,1,0
421477,1,0,0,0,17,1
288118,3,13,7,6,9,1
347855,4,16,8,8,1,0
108147,4,20,42,-22,15,0
330228,2,7,14,-7,11,1
379254,1,0,3,-3,16,1
383663,2,6,14,-8,17,0
127637,3,24,9,15,6,0
360074,3,10,40,-30,7,0
256099,2,6,10,-4,12,1
184963,3,7,17,-10,15,0
372902,2,16,0,16,13,1
2766,1,0,0,0,2,1
355305,3,14,17,-3,4,0
338499,2,17,7,10,14,0
26618,3,10,6,4,13,1
324395,2,7,3,4,8,1
254110,2,0,6,-6,11,1
48384,2,3,17,-14,5,1
385492,4,35,17,18,1,1
221205,1,0,0,0,14,0
317955,2,10,10,0,5,1
268156,3,9,14,-5,17,0
39617,4,27,6,21,1,0
339050,4,20,10,10,15,0
367337,4,6,20,-14,10,0
253887,3,38,14,24,11,1
129402,3,16,13,3,7,0
316846,1,0,0,0,4,0
42824,3,6,31,-25,3,0
10205,3,6,3,3,5,0
251981,2,0,13,-13,10,1
369616,4,20,14,6,11,1
318672,1,0,7,-7,5,1
73691,4,13,9,4,17,1
337082,4,26,0,26,14,1
333836,3,14,21,-7,12,1
314953,4,0,13,-13,4,1
63974,1,0,0,0,13,1
83463,4,10,23,-13,4,1
69854,3,14,9,5,15,1
269041,2,10,12,-2,17,0
301514,4,20,15,5,15,0
310730,2,3,3,0,2,0
410123,2,17,10,7,13,1
69261,2,6,0,6,15,0
88891,1,9,0,9,6,1
293803,3,17,6,11,12,0
44102,2,0,13,-13,3,0
307998,4,21,12,9,1,0
403489,3,17,12,5,9,1
352855,3,14,10,4,3,0
287969,3,17,13,4,9,1
11271,4,17,28,-11,6,1
227552,1,7,0,7,16,0
158013,2,0,6,-6,3,0
365553,2,14,14,0,9,0
261866,3,6,20,-14,14,1
411931,3,17,10,7,13,0
403046,3,21,24,-3,9,1
73607,1,0,0,0,17,0
237249,3,20,0,20,3,0
352008,4,28,21,7,3,0
206594,3,10,13,-3,7,0
196587,3,20,19,1,2,0
244000,1,7,7,0,6,1
297470,1,0,0,0,13,0
163597,3,7,19,-12,5,1
151578,1,0,3,-3,17,0
270440,3,10,7,3,1,1
162925,1,0,0,0,5,1
200587,2,20,14,6,4,1
252600,1,3,0,3,10,0
357001,4,20,3,17,5,1
415221,4,17,38,-21,15,1
209566,3,41,20,21,8,1
260344,2,0,0,0,14,0
311080,3,10,3,7,2,1
380998,4,9,14,-5,16,1
312115,3,33,10,23,2,0
184954,3,7,17,-10,15,0
27607,2,7,10,-3,13,1
21356,4,17,24,-7,11,1
363104,2,7,3,4,8,1
125050,4,3,19,-16,5,0
207028,3,28,3,25,7,0
371851,2,21,10,11,12,0
362918,2,7,0,7,8,1
46294,1,0,14,-14,4,1
77832,3,14,14,0,1,0
101783,5,13,13,0,12,0
362360,3,16,14,2,8,1
201133,1,6,14,-8,5,0
322196,2,0,20,-20,7,1
76057,3,10,16,-6,1,1
32038,2,7,3,4,15,0
156044,3,20,24,-4,2,1
303050,1,0,0,0,16,1
420193,3,3,3,0,17,0
161253,2,17,3,14,4,1
243266,2,7,10,-3,6,0
381309,4,38,31,7,16,1
336057,4,16,28,-12,13,0
386939,2,7,21,-14,2,1
89208,2,3,0,3,7,0
207916,3,28,14,14,8,1
325253,1,0,3,-3,8,1
398123,4,30,35,-5,7,0
118343,1,0,0,0,2,1
341018,1,0,7,-7,15,1
372734,2,0,0,0,13,0
291766,4,3,17,-14,11,1
349475,3,6,20,-14,2,1
286071,2,10,3,7,8,1
256646,4,35,7,28,12,0
300469,2,16,0,16,14,0
75349,4,21,33,-12,17,1
273448,2,0,3,-3,2,1
102062,3,28,10,18,12,0
257646,2,0,7,-7,13,1
92754,3,3,17,-14,8,1
382003,3,0,30,-30,17,1
395008,2,0,14,-14,5,1
167726,4,26,23,3,7,1
9604,2,6,7,-1,5,0
274675,2,7,3,4,3,1
45268,2,0,0,0,4,1
122570,2,14,7,7,4,1
372594,2,7,6,1,13,0
215877,1,3,7,-4,11,0
339347,4,45,7,38,15,1
212527,4,13,16,-3,10,1
318603,3,10,10,0,5,0
127873,1,0,0,0,6,1
396383,2,20,12,8,6,1
390339,1,0,7,-7,3,1
246547,4,29,7,22,8,1
339504,4,10,26,-16,15,0
207906,3,28,7,21,8,0
310343,4,29,0,29,2,0
19952,1,0,3,-3,10,1
191735,3,16,17,-1,17,0
164461,2,14,0,14,5,1
362700,4,3,13,-10,8,1
95566,3,9,10,-1,10,1
238431,4,17,36,-19,4,1
82271,1,3,0,3,3,1
278893,1,0,7,-7,5,1
262692,1,7,0,7,15,0
340524,3,0,40,-40,15,0
159679,1,0,7,-7,3,0
277732,3,7,3,4,4,0
20932,1,7,7,0,10,0
52265,4,20,19,1,7,0
38516,2,17,3,14,1,0
77978,2,3,10,-7,1,0
74613,1,0,0,0,17,0
159359,1,0,7,-7,3,0
21548,2,7,7,0,11,1
150803,4,20,9,11,17,1
276282,1,0,0,0,3,1
32851,3,6,7,-1,15,0
33137,3,10,35,-25,16,0
297641,2,7,0,7,13,1
220529,2,6,17,-11,13,1
251276,4,13,27,-14,10,0
215642,3,14,6,8,11,0
68563,4,13,28,-15,14,0
360212,4,20,13,7,7,1
176948,2,10,3,7,11,1
66344,3,7,21,-14,14,1
59925,2,3,3,0,11,0
177310,4,20,20,0,11,0
82237,4,16,13,3,3,1
300267,1,0,7,-7,14,1
303842,1,0,0,0,16,0
56735,2,0,10,-10,9,0
363526,2,3,5,-2,8,1
390459,4,21,33,-12,3,1
233640,4,23,41,-18,2,0
239629,4,20,20,0,4,1
414153,3,10,20,-10,14,1
112180,4,26,34,-8,17,1
109169,4,31,7,24,15,1
161470,3,10,3,7,4,0
47445,1,3,0,3,5,1
298493,1,10,0,10,14,1
322798,3,3,27,-24,7,1
316113,2,24,16,8,4,0
187784,1,7,0,7,16,0
74353,2,7,3,4,17,1
42686,3,7,10,-3,3,0
250214,4,24,16,8,9,0
355805,1,0,0,0,5,1
219392,4,30,20,10,13,0
95527,2,3,7,-4,10,1
27892,1,0,0,0,13,0
46344,3,6,17,-11,4,1
14899,2,14,7,7,7,0
239240,1,0,7,-7,4,1
79214,4,23,10,13,2,0
49361,3,7,10,-3,6,1
274451,4,10,17,-7,3,1
81458,4,10,16,-6,3,1
349028,3,14,10,4,2,1
249054,2,21,17,4,9,0
91152,2,3,14,-11,8,0
9476,3,10,3,7,5,0
111839,3,6,10,-4,17,1
73470,1,0,14,-14,17,1
248882,1,14,0,14,9,1
155551,3,23,3,20,2,0
418948,1,0,0,0,16,1
351739,1,0,6,-6,3,0
19305,2,14,17,-3,10,0
110556,1,10,0,10,16,0
228922,2,7,9,-2,17,1
419047,3,7,20,-13,16,0
88655,3,20,10,10,6,0
2013,4,13,12,1,1,0
104218,1,0,0,0,13,1
323216,3,7,3,4,7,1
371808,4,24,17,7,12,1
164037,2,3,3,0,5,0
351113,4,37,30,7,3,0
263753,2,0,0,0,15,0
274716,3,10,12,-2,3,0
256882,2,7,10,-3,12,1
242048,4,10,9,1,5,1
273532,4,21,28,-7,2,1
405146,4,6,10,-4,10,1
301063,3,24,10,14,15,0
339486,4,10,26,-16,15,0
12273,3,6,3,3,6,0
285028,1,0,0,0,7,1
408924,2,17,9,8,12,0
323131,4,29,14,15,7,1
150796,4,20,9,11,17,1
98212,1,0,0,0,11,1
182842,4,29,20,9,14,1
236934,2,26,7,19,3,0
107541,4,3,23,-20,15,1
141375,3,10,17,-7,13,0
232160,2,6,0,6,1,1
30969,1,0,0,0,15,1
267772,1,0,0,0,17,1
408019,2,3,0,3,12,0
351298,1,0,0,0,3,1
84522,4,27,31,-4,4,1
290805,2,10,7,3,10,1
18648,4,20,33,-13,9,1
333854,4,21,21,0,12,0
179174,4,19,16,3,12,0
311658,3,6,6,0,2,1
212867,1,0,0,0,10,0
275828,4,22,3,19,3,0
102895,1,3,14,-11,13,0
317132,1,0,0,0,5,0
125553,1,0,6,-6,5,0
273213,4,39,7,32,2,1
134140,1,0,0,0,10,1
128181,2,7,7,0,7,1
30046,4,33,7,26,14,1
32583,4,27,13,14,15,1
354642,3,10,7,3,4,1
391423,2,10,16,-6,4,0
274807,1,0,0,0,3,0
287569,1,0,0,0,9,1
270640,1,0,0,0,1,1
288332,1,7,0,7,9,0
303602,3,28,13,15,16,0
196953,2,14,0,14,3,1
26987,1,7,0,7,13,1
403071,4,27,24,3,9,0
190029,1,13,0,13,17,1
135509,2,7,6,1,10,1
363649,2,0,7,-7,8,0
21598,3,7,31,-24,11,1
2495,1,0,0,0,2,1
245631,4,43,20,23,7,0
145306,2,14,12,2,14,1
218117,1,7,0,7,12,0
43315,1,13,7,6,3,1
286774,4,20,28,-8,8,0
78277,2,3,14,-11,2,0
258353,1,0,0,0,13,0
399925,3,3,6,-3,8,0
75641,4,13,6,7,17,1
247423,3,10,9,1,8,1
19250,1,7,7,0,10,0
410698,2,10,3,7,13,0
224412,1,0,3,-3,15,1
104598,2,7,3,4,14,1
88199,3,14,17,-3,6,0
204566,2,0,35,-35,6,0
306029,3,10,10,0,17,1
248953,3,20,3,17,9,1
156507,3,7,6,1,2,0
368757,4,21,19,2,11,0
389043,2,20,0,20,3,1
261639,1,0,0,0,14,1
326719,1,0,0,0,9,0
284207,4,9,23,-14,7,0
374573,3,20,13,7,14,0
319290,2,10,3,7,6,0
145295,2,14,9,5,14,0
207660,4,42,10,32,7,0
244790,2,0,0,0,7,0
288304,1,0,0,0,9,1
152693,4,27,6,21,17,0
33270,3,10,0,10,16,1
190044,1,14,0,14,17,1
27413,4,27,17,10,13,0
17874,4,24,17,7,9,1
5023,1,0,0,0,3,1
103835,3,16,0,16,13,1
308494,1,0,6,-6,1,0
51348,4,19,20,-1,7,0
111803,2,3,7,-4,17,0
40471,3,7,17,-10,2,1
354146,1,0,0,0,4,1
320119,2,17,0,17,6,1
353450,4,25,12,13,4,1
6060,2,7,7,0,3,1
357522,2,10,6,4,5,1
96628,3,3,3,0,10,0
162934,2,3,0,3,5,1
3550,1,0,7,-7,2,1
276272,4,31,17,14,3,0
285510,1,0,0,0,8,0
269200,2,3,3,0,17,1
181359,1,14,7,7,13,1
383157,4,26,17,9,17,0
225006,1,0,0,0,15,1
302933,2,13,3,10,16,0
135624,1,7,7,0,10,1
110292,2,0,17,-17,16,0
420161,3,0,3,-3,17,1
364033,4,6,18,-12,8,1
230907,3,21,10,11,1,1
2556,3,10,10,0,2,0
185647,4,20,27,-7,15,1
7152,4,34,21,13,4,0
41420,1,2,0,2,2,1
23579,1,7,0,7,12,0
163517,1,7,3,4,5,1
52799,2,0,30,-30,7,0
158330,2,6,14,-8,3,1
58707,2,7,10,-3,10,1
72500,3,13,17,-4,16,0
419483,3,10,9,1,16,1
144203,1,0,7,-7,14,1
389732,1,3,0,3,3,1
262158,3,28,6,22,15,0
178330,2,14,3,11,12,0
191679,2,7,10,-3,17,0
99559,1,0,0,0,11,0
409075,2,3,10,-7,12,1
319203,4,9,17,-8,5,1
106216,4,7,10,-3,14,0
242822,4,21,34,-13,6,1
239414,2,6,10,-4,4,1
371104,4,13,27,-14,12,1
234731,4,36,33,3,2,1
26450,3,26,16,10,13,1
36256,4,17,27,-10,17,0
414198,1,0,0,0,14,0
147427,3,23,7,16,15,0
304205,2,13,7,6,16,1
18491,4,17,14,3,9,0
310996,1,0,0,0,2,1
421741,4,24,17,7,17,1
144266,3,16,7,9,14,0
387607,4,13,3,10,2,0
255840,3,17,0,17,12,0
23746,1,0,0,0,12,1
5864,4,34,14,20,3,1
214243,2,7,10,-3,11,1
187179,1,0,0,0,16,0
256123,2,14,16,-2,12,1
28214,2,10,0,10,13,0
26751,3,6,24,-18,13,1
349970,1,0,0,0,2,1
228475,2,10,0,10,17,0
101872,2,3,10,-7,12,1
395569,4,35,14,21,6,1
383521,2,14,13,1,17,1
11992,3,24,14,10,6,1
297544,3,14,0,14,13,0
410110,2,14,7,7,13,1
30882,2,3,14,-11,15,0
315138,1,6,7,-1,4,1
354789,3,13,17,-4,4,0
326139,1,0,0,0,9,0
119800,3,17,6,11,3,0
300713,1,7,0,7,15,1
74761,1,0,0,0,17,1
410564,2,10,7,3,13,1
290131,4,21,15,6,10,0
45967,4,17,3,14,4,1
104188,4,27,34,-7,13,1
194804,4,10,23,-13,2,0
109784,4,27,0,27,16,0
229020,4,21,16,5,17,0
360196,4,17,13,4,7,1
312382,3,13,24,-11,3,0
397071,4,21,16,5,6,1
342884,2,16,7,9,16,0
207380,1,0,0,0,7,0
237964,1,3,3,0,4,0
155628,1,0,0,0,2,1
8153,1,0,7,-7,4,1
217713,2,7,0,7,12,0
222023,2,7,3,4,14,1
30388,1,0,13,-13,14,1
105718,3,35,3,32,14,0
254144,2,3,9,-6,11,0
303298,2,20,0,20,16,1
363448,4,28,34,-6,8,0
107247,4,14,31,-17,15,1
169317,1,0,7,-7,8,1
378494,4,23,0,23,15,0
178528,3,16,13,3,12,1
90712,1,7,0,7,7,1
119661,4,17,12,5,3,0
65378,1,0,0,0,13,0
179383,2,3,13,-10,12,1
48222,1,0,3,-3,5,0
21220,1,3,0,3,11,0
5658,2,0,14,-14,3,1
402596,3,10,16,-6,9,0
187448,4,41,14,27,16,0
142751,2,9,10,-1,13,0
114598,1,3,0,3,1,0
391904,3,23,20,3,4,0
47841,3,10,6,4,5,0
311110,4,13,3,10,2,0
226759,3,7,20,-13,16,1
119561,2,7,0,7,3,1
353938,4,23,31,-8,4,0
360978,1,0,0,0,7,0
108504,2,14,7,7,15,0
82085,4,20,17,3,3,1
52452,1,0,0,0,7,1
331450,2,6,7,-1,11,1
25131,2,17,0,17,12,0
134354,3,16,21,-5,10,1
90558,1,7,7,0,7,0
20819,2,14,3,11,10,0
126565,4,13,6,7,6,1
661,2,0,10,-10,1,0
103487,2,6,0,6,13,1
303498,4,25,17,8,16,1
119571,2,10,0,10,3,0
151876,2,13,0,13,17,1
359844,1,10,7,3,6,1
244166,1,6,7,-1,6,1
318068,1,2,0,2,5,0
306665,4,14,35,-21,17,1
275688,4,37,10,27,3,0
346248,3,40,0,40,1,0
219043,3,24,7,17,13,1
345534,2,7,17,-10,17,0
358703,2,7,7,0,6,1
130615,2,7,14,-7,8,1
71251,1,0,0,0,16,1
329521,3,31,7,24,10,0
300047,3,0,27,-27,14,0
236309,2,0,9,-9,3,0
220658,2,7,0,7,13,1
185544,2,10,3,7,15,0
29476,4,10,14,-4,14,1
407371,1,0,0,0,11,0
167298,1,3,10,-7,7,1
341242,3,16,10,6,16,0
258564,2,0,0,0,13,0
123934,2,7,0,7,5,0
51259,1,3,0,3,7,1
382570,4,0,17,-17,17,0
78350,4,31,35,-4,2,1
103163,1,0,0,0,13,0
329253,4,24,13,11,10,1
288674,2,0,7,-7,9,1
237499,2,17,7,10,3,1
149870,3,3,16,-13,16,1
404041,2,10,28,-18,10,0
208308,2,7,21,-14,8,1
112013,4,28,21,7,17,0
31463,2,3,7,-4,15,0
125723,1,7,7,0,5,0
106882,2,9,3,6,14,1
54256,4,0,3,-3,8,0
293740,1,7,0,7,12,0
337626,2,14,10,4,14,1
285486,4,36,8,28,8,0
358252,2,0,14,-14,6,1
290564,4,23,20,3,10,0
402998,2,7,21,-14,9,1
348558,3,28,17,11,2,0
147464,4,29,10,19,15,0
49893,1,0,0,0,6,0
138019,2,19,17,2,11,1
119743,2,10,3,7,3,1
38970,3,30,3,27,1,0
115472,4,39,27,12,1,0
286349,1,0,0,0,8,1
169539,3,3,28,-25,8,0
145752,2,7,10,-3,15,1
161073,1,3,0,3,4,0
388323,3,16,6,10,2,1
385532,1,0,0,0,1,0
14542,4,34,45,-11,7,1
124493,1,0,0,0,5,0
214597,3,3,6,-3,11,0
274126,4,27,0,27,3,0
375207,4,17,17,0,14,1
401193,1,0,0,0,8,1
383797,2,3,7,-4,1,0
376533,2,6,6,0,14,0
253962,1,0,0,0,11,0
42975,4,31,23,8,3,1
295145,4,10,14,-4,12,0
326730,1,0,7,-7,9,1
109363,1,0,7,-7,16,0
385161,3,14,17,-3,1,0
392686,4,16,0,16,4,0
946,3,0,3,-3,1,1
47053,3,17,7,10,5,0
115145,3,10,20,-10,1,0
225408,4,27,38,-11,15,1
209862,2,13,16,-3,8,1
284563,1,7,0,7,7,1
95252,2,3,10,-7,10,0
336167,3,17,3,14,13,1
263100,4,10,16,-6,15,0
25426,3,6,3,3,12,1
67869,2,6,3,3,14,0
393766,4,7,14,-7,5,0
349610,3,13,28,-15,2,0
230241,1,6,7,-1,17,1
37445,1,0,7,-7,17,1
419396,1,3,0,3,16,0
34348,4,23,9,14,16,1
23038,3,7,14,-7,11,1
281901,1,0,0,0,6,1
417194,2,3,17,-14,16,1
317152,1,0,0,0,5,0
373639,1,0,9,-9,13,1
386332,2,10,3,7,2,0
307532,4,38,19,19,17,0
109792,1,0,0,0,16,1
213928,1,16,7,9,10,0
50333,4,13,23,-10,6,1
168312,3,10,21,-11,7,1
83461,4,10,23,-13,4,1
53502,1,7,3,4,8,0
2549,3,10,7,3,2,0
402833,1,7,0,7,9,1
264607,4,12,17,-5,16,0
8469,2,15,0,15,4,0
345982,1,0,0,0,1,1
93913,4,24,6,18,9,0
207203,4,17,20,-3,7,0
310323,3,26,0,26,2,1
63989,1,7,3,4,13,1
128023,1,0,0,0,7,0
252484,3,7,22,-15,10,1
289827,4,17,20,-3,10,0
53840,1,0,0,0,8,1
175361,1,14,0,14,11,0
418687,1,0,7,-7,16,0
55795,2,0,7,-7,9,1
404803,3,20,20,0,10,1
324796,1,0,0,0,8,0
47424,5,13,13,0,5,1
73117,4,13,10,3,16,0
94333,2,10,7,3,9,1
280496,1,0,0,0,5,1
409776,1,7,0,7,12,0
346902,4,23,16,7,1,1
312970,2,0,0,0,3,1
195332,1,3,3,0,2,1
24068,2,7,7,0,12,0
70111,1,10,0,10,15,0
419317,3,0,17,-17,16,0
378375,1,0,0,0,15,1
287783,2,21,10,11,9,0
104750,2,17,13,4,14,0
358492,4,41,27,14,6,0
17888,4,24,17,7,9,1
306644,4,14,27,-13,17,0
132465,4,6,24,-18,9,1
236150,2,7,10,-3,3,0
115624,4,30,9,21,1,0
49460,1,0,0,0,6,0
215211,3,10,16,-6,11,1
54862,4,26,3,23,8,0
170380,1,14,0,14,8,0
390446,4,14,33,-19,3,1
418885,3,13,10,3,16,0
353481,1,0,0,0,4,0
421118,3,20,13,7,17,0
68122,4,6,10,-4,14,0
278769,2,0,0,0,5,1
230413,2,14,0,14,1,0
30818,1,0,7,-7,15,0
97836,3,7,24,-17,11,1
34011,4,17,27,-10,16,0
380196,2,7,9,-2,16,1
404987,4,9,20,-11,10,1
308138,3,16,19,-3,1,0
30707,2,10,14,-4,15,1
1023,1,0,0,0,1,1
350822,1,0,0,0,3,1
111853,4,6,10,-4,17,1
234936,2,10,3,7,2,0
237935,1,0,0,0,4,0
99251,4,31,20,11,11,1
319578,1,0,0,0,6,1
100972,3,10,16,-6,12,1
256558,2,7,0,7,12,0
222104,4,34,17,17,14,0
65737,3,7,16,-9,13,1
77465,1,0,0,0,1,1
387593,4,6,3,3,2,0
205424,1,0,0,0,6,1
115981,2,10,0,10,1,1
299041,4,16,25,-9,14,1
32479,1,7,3,4,15,1
256478,4,19,24,-5,12,0
178795,2,21,14,7,12,1
203585,1,0,0,0,6,0
403314,2,6,0,6,9,1
63234,4,17,33,-16,12,1
302850,4,12,23,-11,15,1
235962,1,7,0,7,3,0
321962,4,28,28,0,7,1
1709,3,21,0,21,1,0
144662,1,0,0,0,14,1
186341,3,29,10,19,15,0
38120,4,9,6,3,1,0
52178,2,0,3,-3,7,1
208842,4,13,25,-12,8,0
185900,3,16,16,0,15,0
23860,1,0,0,0,12,0
104923,3,3,6,-3,14,1
201594,1,7,0,7,5,0
118049,4,20,20,0,2,1
323712,4,26,0,26,8,1
167747,4,26,23,3,7,1
221167,4,0,23,-23,14,0
112037,4,48,21,27,17,0
25233,1,7,0,7,12,1
344101,2,10,3,7,17,1
87736,3,6,20,-14,6,0
313252,1,3,0,3,3,0
253286,4,3,13,-10,11,1
12263,3,3,3,0,6,0
169850,4,20,17,3,8,0
74965,2,17,17,0,17,1
111947,2,7,21,-14,17,1
129561,2,6,17,-11,7,1
50901,3,17,24,-7,6,0
149227,2,7,3,4,16,1
389957,3,28,18,10,3,0
15810,3,0,12,-12,8,0
398375,3,3,27,-24,7,0
281998,4,21,28,-7,6,1
324701,2,7,7,0,8,0
223508,2,7,10,-3,15,0
227345,4,20,37,-17,16,1
130206,3,3,25,-22,8,0
65058,4,3,17,-14,13,1
26740,3,6,14,-8,13,1
310059,4,9,13,-4,2,1
86242,2,6,10,-4,5,1
108703,3,34,13,21,15,0
213336,2,3,6,-3,10,1
137107,3,24,6,18,11,0
119353,4,14,16,-2,3,1
2389,2,14,10,4,2,0
329884,1,0,7,-7,11,1
202093,2,13,0,13,5,0
412045,2,14,0,14,13,0
71310,3,10,13,-3,16,0
258975,2,0,16,-16,13,0
67017,2,0,0,0,14,0
78934,4,20,17,3,2,0
42037,2,13,7,6,2,0
305026,4,31,27,4,16,0
374847,2,7,3,4,14,0
172499,1,0,0,0,9,0
116307,3,17,13,4,1,1
80877,1,0,0,0,3,1
33674,2,27,0,27,16,1
125478,3,16,0,16,5,0
421156,4,44,16,28,17,0
288325,1,0,0,0,9,0
398642,3,0,0,0,7,0
293592,4,27,20,7,11,1
8067,3,17,7,10,4,1
69658,1,0,7,-7,15,1
415928,4,10,23,-13,15,0
109648,4,37,14,23,16,0
127960,3,23,13,10,6,0
38760,1,0,3,-3,1,0
328126,2,6,0,6,10,0
328585,2,10,7,3,10,0
224367,4,16,12,4,15,1
346532,3,24,33,-9,1,1
55134,4,26,17,9,8,1
352272,3,3,6,-3,3,0
247637,4,26,26,0,8,1
381060,2,14,6,8,16,0
399646,3,13,6,7,8,1
271272,2,6,7,-1,1,1
387648,1,0,7,-7,2,1
289622,3,10,13,-3,10,1
40129,1,12,0,12,2,1
132278,3,24,7,17,9,0
360696,1,0,7,-7,7,1
396820,1,3,7,-4,6,1
105445,4,23,31,-8,14,1
200075,1,0,0,0,4,1
299050,1,0,0,0,14,0
275491,3,20,17,3,3,0
82670,4,12,13,-1,3,1
231150,2,3,0,3,1,1
395825,3,3,14,-11,6,1
337487,2,7,12,-5,14,0
10207,3,6,3,3,5,0
335414,2,7,6,1,13,1
175733,4,37,13,24,11,1
362279,4,18,24,-6,8,0
315311,1,3,0,3,4,0
236913,2,26,0,26,3,0
312607,1,0,0,0,3,1
161112,2,3,16,-13,4,0
279505,2,10,6,4,5,1
338923,1,3,0,3,15,1
257099,4,14,21,-7,12,0
26590,3,10,6,4,13,0
320772,4,17,23,-6,6,0
414400,2,7,17,-10,14,0
51389,1,0,0,0,7,0
216291,1,0,0,0,12,1
313058,4,20,0,20,3,0
264962,4,23,17,6,16,1
37313,1,7,0,7,17,1
399732,2,0,3,-3,8,0
390879,4,9,28,-19,3,1
223434,4,20,26,-6,15,0
220766,1,0,0,0,14,0
207241,1,0,0,0,7,0
142065,1,0,0,0,13,0
123688,4,10,25,-15,4,1
59721,1,6,0,6,11,0
254908,2,17,7,10,12,1
324632,4,16,15,1,8,1
205720,4,20,19,1,7,1
116711,2,6,10,-4,2,1
411300,2,0,10,-10,13,1
260671,3,10,22,-12,14,1
2108,3,10,13,-3,1,0
368863,3,24,3,21,11,1
140069,1,0,0,0,12,0
68495,2,0,7,-7,14,0
383194,1,14,0,14,17,0
287172,3,10,13,-3,8,0
420400,4,20,20,0,17,0
252234,4,26,24,2,10,0
164087,3,12,6,6,5,0
302383,3,16,13,3,15,1
20245,4,27,10,17,10,0
28767,1,0,0,0,14,1
313671,1,0,0,0,3,1
219853,4,45,0,45,13,0
14298,2,2,7,-5,7,1
152468,2,10,0,10,17,0
56557,2,16,14,2,9,1
190479,1,7,0,7,17,0
213475,1,0,0,0,10,0
86954,2,14,0,14,5,0
94797,2,3,6,-3,9,0
408212,3,13,3,10,12,1
91833,4,24,6,18,8,0
21955,1,7,0,7,11,1
41909,2,14,6,8,2,0
287479,2,14,20,-6,9,1
104503,3,14,31,-17,13,1
148416,1,6,0,6,16,1
89704,3,9,17,-8,7,0
88959,3,33,10,23,6,1
138174,2,7,9,-2,11,0
307458,2,28,10,18,17,0
195397,3,23,3,20,2,1
206395,2,10,0,10,7,1
193254,3,3,17,-14,1,1
190318,1,0,0,0,17,1
328119,2,6,0,6,10,1
36777,2,7,7,0,17,0
338013,1,0,0,0,14,0
80812,3,3,0,3,3,1
138645,2,3,21,-18,12,0
111481,1,7,0,7,16,1
18344,4,25,17,8,9,0
330997,2,33,7,26,11,1
51258,1,3,0,3,7,1
401783,1,7,0,7,9,1
389955,3,28,18,10,3,0
130856,4,20,12,8,8,0
231068,4,27,8,19,1,0
16213,2,3,0,3,8,0
36736,1,0,7,-7,17,0
383640,2,0,7,-7,17,0
77945,2,3,7,-4,1,1
351732,4,28,17,11,3,0
89766,1,0,0,0,7,1
354610,2,3,7,-4,4,1
383167,4,26,24,2,17,0
325885,1,3,0,3,9,1
52061,3,13,10,3,7,0
390783,1,0,7,-7,3,1
305359,1,13,3,10,17,1
307609,2,0,7,-7,17,1
51390,1,0,0,0,7,0
38881,4,10,15,-5,1,0
176164,2,14,7,7,11,0
168736,3,10,6,4,7,1
94756,1,3,0,3,9,0
214354,1,0,0,0,11,0
169378,3,6,14,-8,8,0
36593,1,3,0,3,17,1
347426,1,3,6,-3,1,0
88106,4,24,3,21,6,1
79665,5,24,24,0,2,1
299161,3,10,16,-6,14,0
251639,1,3,0,3,10,0
195006,1,7,0,7,2,0
407283,3,17,16,1,11,0
231141,2,3,0,3,1,1
143162,1,0,0,0,13,0
159890,3,31,0,31,3,0
156554,4,14,6,8,2,0
396358,1,14,6,8,6,1
419082,4,13,27,-14,16,1
324515,1,0,7,-7,8,1
201759,1,3,0,3,5,1
182713,4,14,26,-12,14,1
212426,1,10,0,10,10,1
103384,3,10,20,-10,13,1
104695,4,14,3,11,14,0
248625,3,14,10,4,9,1
264940,3,23,17,6,16,0
356472,2,0,3,-3,5,0
206199,1,0,3,-3,7,0
37443,1,0,6,-6,17,0
238030,3,10,13,-3,4,0
43153,1,0,0,0,3,1
2618,1,0,0,0,2,1
237157,1,0,0,0,3,0
112157,4,10,27,-17,17,1
115349,1,0,0,0,1,1
238789,2,14,0,14,4,0
183064,2,7,0,7,14,1
195670,2,7,10,-3,2,0
182829,3,29,17,12,14,0
82825,4,12,16,-4,3,0
300270,1,0,7,-7,14,1
314567,1,0,0,0,3,1
140929,4,20,13,7,13,0
159289,4,24,24,0,3,1
119525,1,0,0,0,3,1
257157,1,0,0,0,12,1
344637,1,3,10,-7,17,0
298578,4,13,6,7,14,0
289668,4,13,23,-10,10,1
153339,4,2,16,-14,1,1
270747,4,6,3,3,1,0
189527,4,20,0,20,17,0
286524,2,3,14,-11,8,0
320989,2,7,0,7,6,0
103131,4,34,7,27,13,0
310294,2,23,0,23,2,1
257454,1,0,0,0,13,0
194858,1,0,7,-7,2,0
146022,1,9,0,9,15,1
72481,2,10,10,0,16,1
197008,3,20,20,0,3,1
200011,3,24,17,7,4,0
220464,4,26,21,5,13,0
83024,1,0,0,0,4,1
152944,3,20,17,3,1,1
276073,3,20,3,17,3,1
385054,5,24,24,0,1,1
134410,1,0,0,0,10,0
176110,1,7,0,7,11,0
160672,3,10,0,10,4,0
305630,4,23,17,6,17,0
42754,1,3,7,-4,3,1
336286,2,17,0,17,13,0
119052,1,0,0,0,3,1
340277,1,0,0,0,15,1
246084,4,19,13,6,7,0
329049,2,3,7,-4,10,1
202920,4,31,0,31,5,0
24680,2,20,7,13,12,0
164496,3,17,0,17,5,0
254447,2,20,0,20,11,0
76030,2,10,13,-3,1,1
242018,3,7,3,4,5,1
86619,4,40,3,37,5,1
120333,4,24,13,11,3,1
66420,1,0,0,0,14,1
260066,2,3,7,-4,14,0
235237,2,15,3,12,3,0
73406,4,30,3,27,17,1
72958,4,31,7,24,16,0
205945,2,6,3,3,7,1
192863,4,16,21,-5,1,0
337777,2,23,6,17,14,0
336875,2,7,14,-7,14,0
105945,1,7,0,7,14,1
309899,4,24,21,3,1,0
338189,2,7,21,-14,14,1
169360,2,6,14,-8,8,1
241556,2,3,10,-7,5,1
126643,1,0,0,0,6,0
228386,3,10,17,-7,17,0
18738,2,6,7,-1,9,0
310302,3,26,0,26,2,0
68808,2,6,7,-1,15,0
293215,2,16,7,9,11,0
367042,4,10,38,-28,10,1
386494,2,7,7,0,2,1
372702,1,0,0,0,13,1
244116,4,20,34,-14,6,1
250524,3,16,7,9,9,0
87854,2,10,9,1,6,1
74359,2,7,3,4,17,0
228178,2,7,26,-19,17,0
118302,3,19,7,12,2,0
132553,2,2,29,-27,9,0
385747,2,10,0,10,1,0
344930,2,3,7,-4,17,1
404209,3,12,9,3,10,0
275414,1,6,7,-1,3,0
341915,1,0,0,0,16,0
297202,2,0,0,0,13,0
238902,4,41,21,20,4,0
49851,4,21,17,4,6,1
259828,1,0,0,0,14,0
109069,1,0,0,0,15,0
396802,1,0,7,-7,6,1
39778,4,9,7,2,1,0
142364,4,7,6,1,13,1
40273,2,6,0,6,2,0
259498,3,28,10,18,13,1
70739,2,7,10,-3,15,0
171526,4,17,10,7,9,1
296500,3,23,3,20,13,0
253589,3,6,10,-4,11,1
146683,2,7,29,-22,15,0
5181,1,0,3,-3,3,1
370437,2,10,6,4,12,0
277510,2,0,7,-7,4,1
22176,3,10,15,-5,11,1
70153,2,20,7,13,15,1
119356,4,17,22,-5,3,0
364852,2,6,14,-8,9,0
416811,4,13,10,3,15,0
128715,4,13,30,-17,7,1
337645,3,14,13,1,14,1
158742,1,0,0,0,3,0
421361,2,6,10,-4,17,0
120456,4,19,19,0,3,0
373938,1,7,0,7,13,0
69619,4,7,17,-10,15,1
21850,2,7,0,7,11,1
359409,1,0,0,0,6,1
210486,4,9,14,-5,9,0
285684,5,27,27,0,8,0
58106,2,10,10,0,10,0
142490,3,27,10,17,13,0
368836,2,10,0,10,11,1
204398,2,7,3,4,6,0
345491,1,0,0,0,17,0
176395,4,19,28,-9,11,1
19883,3,13,21,-8,10,0
139351,1,0,0,0,12,1
229603,4,30,13,17,17,1
286472,4,20,10,10,8,0
161390,1,0,0,0,4,1
117866,4,9,20,-11,2,1
342688,1,0,0,0,16,0
303848,1,0,0,0,16,1
164909,2,0,3,-3,6,0
374991,2,21,27,-6,14,1
88534,4,19,14,5,6,1
88315,2,14,7,7,6,1
161678,1,0,0,0,4,1
369754,4,38,30,8,11,0
129111,3,27,28,-1,7,0
201213,4,20,24,-4,5,0
137782,4,17,37,-20,11,0
23616,2,7,7,0,12,0
137641,5,37,37,0,11,0
207807,4,30,22,8,7,0
280261,2,6,13,-7,5,1
411317,2,10,10,0,13,0
265849,1,0,6,-6,16,1
228625,2,10,14,-4,17,1
357805,2,3,14,-11,6,1
269536,3,13,30,-17,1,0
270793,1,0,0,0,1,1
398712,1,0,14,-14,7,1
24025,1,0,0,0,12,1
89713,3,16,20,-4,7,0
191465,4,14,34,-20,17,0
314744,2,14,0,14,4,0
183130,3,7,6,1,14,1
259005,3,3,16,-13,13,0
339514,1,0,0,0,15,1
327708,2,6,10,-4,10,1
246539,4,29,7,22,8,0
260141,4,6,35,-29,14,0
130951,2,7,21,-14,8,0
200987,2,14,0,14,5,1
325567,1,7,0,7,9,0
160648,2,7,0,7,4,1
24668,2,17,6,11,12,0
285444,3,33,8,25,8,0
92851,2,21,0,21,8,1
129901,3,13,0,13,7,1
167637,2,7,13,-6,7,1
130208,3,3,26,-23,8,1
367408,2,17,14,3,10,0
154378,4,34,24,10,1,0
265789,3,17,12,5,16,1
263796,3,0,24,-24,15,0
344138,3,20,3,17,17,1
262422,2,7,7,0,15,1
393966,1,3,7,-4,5,1
261178,1,7,0,7,14,0
294552,4,24,13,11,12,0
286955,4,26,19,7,8,1
410518,1,7,0,7,13,0
149491,1,7,6,1,16,0
345656,1,7,0,7,17,1
337704,4,24,21,3,14,0
88760,2,6,3,3,6,1
282801,2,0,13,-13,6,1
418369,1,0,0,0,16,1
357448,4,31,30,1,5,0
328249,5,17,17,0,10,1
378522,1,7,6,1,15,0
211055,3,27,0,27,9,0
370499,4,27,9,18,12,0
390442,4,14,33,-19,3,1
132263,2,21,7,14,9,0
234405,1,0,0,0,2,1
136883,2,0,10,-10,11,1
213957,2,23,7,16,10,0
175774,1,0,0,0,11,0
250589,1,0,0,0,10,1
58554,2,10,10,0,10,1
266610,2,3,0,3,16,0
322506,3,15,3,12,7,0
61602,4,35,14,21,11,1
291350,1,0,0,0,10,1
160028,3,10,23,-13,3,0
183401,2,17,3,14,14,1
188008,4,23,14,9,16,0
4807,4,27,3,24,3,0
258715,2,3,20,-17,13,1
35923,2,3,0,3,17,1
310127,2,14,6,8,2,0
173784,3,10,3,7,10,0
39110,2,13,7,6,1,0
260768,2,3,6,-3,14,0
331228,4,17,20,-3,11,1
199259,3,17,24,-7,4,0
188286,3,14,13,1,16,1
325315,2,9,10,-1,8,1
384572,2,3,42,-39,1,1
315544,3,7,14,-7,4,1
162115,4,48,13,35,4,1
269246,3,3,13,-10,17,0
340096,4,20,15,5,15,0
122219,1,3,7,-4,4,1
10966,3,9,28,-19,5,1
367132,2,29,13,16,10,0
317101,4,20,17,3,4,1
122655,1,0,0,0,4,0
109566,2,9,7,2,16,1
175034,4,20,28,-8,10,1
384658,1,0,10,-10,1,1
236315,2,0,16,-16,3,0
51588,2,7,3,4,7,0
87162,4,21,10,11,5,0
145124,2,17,0,17,14,0
483,2,0,6,-6,1,1
119916,1,6,14,-8,3,1
187792,1,7,0,7,16,1
36962,3,0,31,-31,17,0
362774,2,7,14,-7,8,1
350809,4,23,10,13,2,1
94583,4,20,17,3,9,0
374028,3,10,10,0,13,1
216572,4,40,11,29,12,0
248596,2,7,3,4,9,1
369415,2,17,7,10,11,1
110170,3,20,23,-3,16,1
223377,2,7,12,-5,15,0
321864,2,7,14,-7,7,0
411863,1,0,0,0,13,1
111688,3,28,13,15,16,1
290034,2,7,3,4,10,0
270140,3,24,13,11,1,1
127612,2,17,9,8,6,0
386750,1,0,0,0,2,1
264256,2,10,17,-7,15,1
216341,2,7,13,-6,12,1
168498,4,10,30,-20,7,1
343822,3,21,3,18,17,1
389313,2,7,6,1,3,0
53016,4,27,24,3,7,0
47797,2,7,0,7,5,1
321280,2,9,10,-1,6,0
329433,1,0,0,0,10,1
308301,4,13,23,-10,1,1
87944,4,19,22,-3,6,1
308796,1,0,3,-3,1,0
211798,2,0,7,-7,9,0
163625,3,21,19,2,5,0
317885,4,15,10,5,5,1
28739,4,10,16,-6,14,1
146879,4,31,0,31,15,1
52730,4,6,23,-17,7,1
374398,2,15,0,15,14,0
408339,3,10,7,3,12,1
242600,2,10,0,10,6,1
93337,3,27,3,24,9,0
187326,1,7,0,7,16,0
19330,3,14,17,-3,10,0
329300,1,3,14,-11,10,1
339576,2,10,13,-3,15,0
23643,3,7,13,-6,12,0
138624,2,3,7,-4,12,0
216764,4,27,9,18,12,1
171619,2,6,9,-3,9,0
315863,4,9,19,-10,4,0
93001,2,10,3,7,8,0
344617,1,0,3,-3,17,0
285986,4,29,14,15,8,0
386408,4,20,17,3,2,1
125563,1,7,7,0,5,0
402016,4,3,19,-16,9,1
335255,2,0,3,-3,13,1
229197,1,0,0,0,17,0
246603,2,7,3,4,8,0
82482,3,10,17,-7,3,1
93223,4,3,20,-17,9,0
88498,3,13,14,-1,6,1
408521,4,10,13,-3,12,1
74146,4,37,6,31,17,0
241786,1,0,0,0,5,0
16125,4,40,17,23,8,0
267177,4,20,10,10,17,1
309807,1,7,0,7,1,0
311964,3,35,10,25,2,0
410403,2,6,10,-4,13,1
200857,2,14,0,14,4,0
181094,3,17,7,10,13,1
117034,2,0,17,-17,2,0
11520,3,6,10,-4,6,0
58219,2,0,3,-3,10,1
130043,3,10,27,-17,8,1
241318,4,13,14,-1,5,1
34918,4,27,24,3,16,1
379756,3,9,17,-8,16,0
178386,4,28,27,1,12,1
133024,3,9,14,-5,9,0
42328,2,0,9,-9,2,1
349678,1,7,7,0,2,1
162288,1,0,0,0,4,1
322029,2,6,0,6,7,0
222737,1,3,0,3,14,0
189934,2,3,7,-4,17,1
108723,3,37,13,24,15,0
344485,1,0,0,0,17,0
305568,3,13,0,13,17,0
59734,2,6,7,-1,11,0
183635,2,0,8,-8,14,1
338447,1,0,0,0,14,0
80413,4,27,16,11,2,1
168136,2,9,5,4,7,1
45165,3,7,10,-3,4,1
129180,1,7,0,7,7,0
302910,1,13,0,13,16,0
53272,3,3,7,-4,8,1
314446,1,7,0,7,3,1
255106,4,6,31,-25,12,1
252625,2,6,3,3,10,0
419310,2,0,17,-17,16,1
321658,4,20,20,0,7,0
24385,3,13,0,13,12,1
116068,4,16,7,9,1,0
91603,2,6,7,-1,8,1
303615,3,28,13,15,16,0
130690,4,7,38,-31,8,0
191308,4,17,20,-3,17,1
115002,3,13,12,1,1,1
229092,2,10,7,3,17,0
37780,2,7,3,4,1,0
10076,3,31,7,24,5,0
291821,1,0,0,0,11,1
16650,3,7,27,-20,8,1
253116,3,21,7,14,11,0
6035,1,0,7,-7,3,1
336925,4,13,21,-8,14,1
110369,4,20,17,3,16,1
240359,4,14,23,-9,5,1
407007,4,3,20,-17,11,0
306468,3,10,17,-7,17,0
407058,1,0,3,-3,11,1
417796,1,7,0,7,16,1
60615,1,0,3,-3,11,1
53928,3,14,13,1,8,1
302012,1,7,0,7,15,0
173364,4,31,27,4,10,0
106402,1,7,0,7,14,0
155549,3,23,3,20,2,1
201859,4,28,30,-2,5,1
185396,2,0,10,-10,15,1
396672,2,7,7,0,6,0
421390,2,13,20,-7,17,1
291311,3,21,22,-1,10,1
156326,2,24,0,24,2,0
203859,4,34,31,3,6,0
270693,2,3,3,0,1,1
14263,1,0,7,-7,7,1
199079,2,7,21,-14,4,1
257538,3,19,10,9,13,1
214277,3,14,10,4,11,1
122949,1,0,0,0,4,0
371168,2,3,19,-16,12,1
3097,1,0,3,-3,2,0
377487,1,0,0,0,15,0
315093,4,37,14,23,4,1
84493,4,20,17,3,4,0
360288,2,0,13,-13,7,1
25146,3,17,3,14,12,1
56862,1,0,0,0,9,1
178496,3,16,6,10,12,0
28966,2,0,7,-7,14,0
331948,1,0,0,0,12,0
236573,4,16,9,7,3,1
52133,1,0,0,0,7,1
306679,1,0,0,0,17,1
165215,2,7,7,0,6,0
30886,2,3,17,-14,15,1
97862,4,14,27,-13,11,0
89152,1,0,0,0,7,1
289981,4,6,9,-3,10,0
401967,2,0,9,-9,9,1
334198,1,0,0,0,13,1
378526,1,7,6,1,15,0
94417,4,17,24,-7,9,1
52976,3,14,17,-3,7,0
258982,2,0,16,-16,13,1
171406,5,19,20,-1,9,0
129430,4,23,13,10,7,1
157988,1,0,0,0,3,0
306744,2,10,17,-7,17,0
316891,2,9,2,7,4,0
75189,4,13,6,7,17,0
398910,3,10,10,0,7,0
398779,3,14,17,-3,7,1
165896,4,6,19,-13,6,0
246075,3,19,13,6,7,0
47718,4,6,17,-11,5,1
347964,3,0,21,-21,1,0
228288,1,0,0,0,17,1
290974,3,20,10,10,10,1
393682,2,0,0,0,5,0
195501,2,0,0,0,2,1
226495,4,14,10,4,16,1
193457,4,23,20,3,1,1
309516,1,3,0,3,1,1
69060,1,0,0,0,15,1
71511,4,33,14,19,16,1
133198,3,13,17,-4,9,1
381687,3,17,14,3,17,1
311867,1,7,0,7,2,1
307745,1,7,7,0,1,1
169113,4,39,30,9,7,0
377218,1,7,0,7,15,0
300289,2,0,7,-7,14,1
50484,4,17,17,0,6,1
317790,2,9,3,6,5,1
160833,3,34,17,17,4,0
95412,2,28,7,21,10,1
69405,2,14,3,11,15,0
379812,4,9,27,-18,16,0
110907,2,7,3,4,16,1
26058,4,13,19,-6,13,0
14890,2,7,0,7,7,0
266787,3,3,14,-11,16,1
203521,4,24,3,21,6,1
312297,1,0,7,-7,3,1
356928,2,3,3,0,5,1
365156,3,7,28,-21,9,1
230540,2,3,7,-4,1,1
179747,3,6,10,-4,12,0
91229,4,20,17,3,8,0
302096,3,20,27,-7,15,1
13359,4,7,33,-26,7,0
83439,4,10,23,-13,4,1
241761,4,7,15,-8,5,1
164692,4,28,27,1,5,0
142378,4,7,6,1,13,1
176523,3,12,17,-5,11,0
224309,3,9,12,-3,15,0
228591,1,7,7,0,17,0
20774,1,0,0,0,10,1
271268,2,6,7,-1,1,1
395238,3,10,13,-3,5,0
86782,1,0,0,0,5,1
93288,2,14,3,11,9,1
274689,2,10,9,1,3,0
86700,2,10,7,3,5,1
166754,3,13,9,4,6,0
78638,4,30,13,17,2,1
62536,1,0,0,0,12,1
118245,2,9,7,2,2,0
34195,1,0,0,0,16,1
373023,1,0,0,0,13,0
91288,2,7,0,7,8,0
141052,3,7,10,-3,13,1
241971,1,7,0,7,5,1
253612,4,9,17,-8,11,0
115763,4,13,16,-3,1,1
55771,1,0,0,0,9,1
348660,2,3,3,0,2,0
142424,2,7,10,-3,13,1
319908,1,13,7,6,6,0
253154,4,21,23,-2,11,0
338578,4,29,38,-9,14,1
167866,2,7,16,-9,7,1
27804,3,14,14,0,13,0
65174,3,3,3,0,13,0
345303,4,19,24,-5,17,1
296285,2,0,10,-10,13,0
170275,2,0,12,-12,8,1
191863,3,20,10,10,1,0
278669,3,17,3,14,4,0
352764,1,0,0,0,3,1
177732,3,13,17,-4,12,0
239813,1,0,0,0,4,0
142469,3,7,10,-3,13,1
76304,1,3,3,0,1,0
17735,4,17,6,11,9,1
420522,3,3,42,-39,17,1
53578,3,14,12,2,8,0
90963,1,0,0,0,7,1
321127,2,0,10,-10,6,1
68265,4,20,30,-10,14,1
355530,1,7,0,7,5,0
321425,2,14,17,-3,7,0
57746,2,16,0,16,10,0
378387,1,7,0,7,15,0
76850,4,33,7,26,1,0
58825,1,0,0,0,10,1
22790,4,6,21,-15,11,1
309658,1,0,3,-3,1,1
105418,4,23,17,6,14,0
346653,2,14,6,8,1,0
200624,3,27,21,6,4,1
385567,2,0,17,-17,1,1
165562,4,3,28,-25,6,1
419772,4,17,17,0,17,1
29179,4,3,19,-16,14,1
178506,3,16,6,10,12,0
386199,2,6,10,-4,2,1
348843,2,3,14,-11,2,1
58986,1,0,7,-7,10,1
35074,4,15,16,-1,16,0
91699,4,21,24,-3,8,1
379638,4,26,13,13,16,0
303169,4,21,28,-7,16,1
140552,1,7,7,0,12,1
131061,2,10,0,10,8,0
45307,2,7,10,-3,4,1
248550,5,26,26,0,8,1
5794,2,21,7,14,3,1
143528,3,20,21,-1,14,0
298755,1,0,0,0,14,1
396905,4,27,20,7,6,0
113989,5,20,20,0,17,1
296926,3,19,0,19,13,1
66265,1,0,0,0,14,0
306163,2,7,3,4,17,0
245853,2,3,20,-17,7,1
35302,2,6,0,6,16,1
73078,3,7,10,-3,16,1
134910,2,7,16,-9,10,0
317056,3,7,10,-3,4,1
411705,1,0,3,-3,13,0
334884,4,27,10,17,13,0
346352,2,3,12,-9,1,0
223220,2,3,6,-3,15,0
237024,1,0,7,-7,3,0
269392,3,7,17,-10,1,0
196189,1,7,0,7,2,0
53796,5,10,10,0,8,1
150946,4,13,14,-1,17,1
409113,3,3,10,-7,12,0
169434,4,13,31,-18,8,1
276590,1,7,0,7,4,0
60649,2,7,3,4,11,1
57515,3,21,10,11,10,0
68726,4,34,0,34,15,0
294608,1,0,0,0,12,0
75435,3,16,7,9,17,1
351290,1,0,0,0,3,0
324451,4,17,6,11,8,0
253174,1,0,0,0,11,1
354650,3,10,7,3,4,0
71831,1,7,0,7,16,0
218095,1,0,0,0,12,1
176049,3,24,0,24,11,1
59250,4,28,58,-30,10,0
112955,1,0,0,0,17,1
206656,1,0,0,0,7,1
270732,3,6,3,3,1,0
220048,1,0,0,0,13,1
84321,3,14,27,-13,4,0
2125,3,10,13,-3,1,0
175709,3,23,6,17,11,1
204575,2,0,38,-38,6,1
271599,3,17,20,-3,2,0
159741,3,7,10,-3,3,0
342836,1,10,0,10,16,0
240817,4,26,10,16,5,0
308601,4,15,16,-1,1,0
55299,4,20,10,10,9,0
46522,4,40,6,34,4,1
109585,3,16,14,2,16,1
399405,4,37,10,27,7,1
355999,2,14,7,7,5,0
258850,3,14,7,7,13,0
181705,2,7,7,0,13,1
298165,1,0,0,0,14,0
361712,4,10,39,-29,7,1
76988,4,17,13,4,1,1
356796,2,0,0,0,5,0
325421,1,13,0,13,8,1
321627,3,17,13,4,7,0
100521,3,10,20,-10,12,1
265876,1,0,9,-9,16,0
160987,3,10,7,3,4,1
46134,1,0,7,-7,4,1
175855,2,20,24,-4,11,0
194528,4,29,10,19,2,0
147276,3,0,24,-24,15,0
404440,2,14,0,14,10,0
16162,1,0,0,0,8,0
271712,2,13,10,3,2,0
177736,3,13,17,-4,12,1
325365,4,15,20,-5,8,1
190837,3,16,3,13,17,1
19437,2,17,14,3,10,0
359990,1,3,13,-10,7,0
87605,4,17,10,7,6,0
304249,4,33,14,19,16,1
82526,4,10,27,-17,3,1
271659,4,30,37,-7,2,0
347190,4,23,24,-1,1,0
62353,4,24,22,2,12,0
241859,3,13,6,7,5,1
261535,3,12,0,12,14,0
130621,2,7,14,-7,8,0
220415,3,23,14,9,13,1
79127,1,0,0,0,2,1
108323,1,0,7,-7,15,1
132526,1,2,19,-17,9,0
308836,2,3,10,-7,1,1
55769,1,0,0,0,9,1
196886,4,10,20,-10,3,0
265652,3,9,15,-6,16,0
180915,2,10,7,3,13,1
37487,2,7,7,0,17,1
408666,4,28,17,11,12,1
70900,3,13,26,-13,15,1
330694,3,6,3,3,11,1
304254,4,33,14,19,16,0
270948,1,0,0,0,1,0
304854,4,6,10,-4,16,1
101260,3,10,7,3,12,1
177801,1,0,0,0,12,0
83131,4,13,30,-17,4,1
19398,1,7,7,0,10,0
205528,4,14,24,-10,6,1
21909,4,35,3,32,11,0
108047,2,3,7,-4,15,1
383561,3,21,13,8,17,0
230629,4,16,24,-8,1,1
130852,4,20,12,8,8,0
273415,1,0,0,0,2,1
171028,2,10,23,-13,8,1
45087,4,23,20,3,4,1
118918,1,0,0,0,3,0
335580,3,9,7,2,13,1
404301,2,0,3,-3,10,1
414090,1,0,10,-10,14,1
71182,3,19,10,9,16,0
308797,1,0,3,-3,1,0
59741,2,6,7,-1,11,0
196731,3,54,0,54,3,0
291277,2,14,12,2,10,0
245230,1,3,0,3,7,0
390565,3,17,14,3,3,0
153400,2,10,10,0,1,1
26785,4,13,33,-20,13,0
135915,5,24,24,0,10,0
318925,4,24,28,-4,5,1
185897,3,16,16,0,15,0
218173,3,14,3,11,12,1
52803,2,0,30,-30,7,0
74890,4,20,20,0,17,0
15553,4,29,6,23,8,1
8292,1,0,0,0,4,1
216039,2,10,12,-2,11,0
337480,2,7,9,-2,14,0
20012,2,16,6,10,10,1
343429,1,0,0,0,16,1
111432,4,0,20,-20,16,1
379331,3,10,13,-3,16,0
218050,3,21,24,-3,12,1
332586,2,17,3,14,12,0
90297,2,7,14,-7,7,0
401368,1,10,0,10,8,1
389524,3,20,10,10,3,0
225767,2,10,7,3,16,0
298299,4,20,13,7,14,0
340405,4,24,13,11,15,0
396255,2,3,3,0,6,0
28583,4,33,7,26,14,0
74979,3,20,17,3,17,0
336729,2,10,10,0,14,1
18535,1,3,0,3,9,0
115670,2,3,3,0,1,0
100993,4,13,16,-3,12,0
51049,3,3,20,-17,6,0
9986,4,3,3,0,5,0
101480,1,0,0,0,12,1
177400,2,17,10,7,11,1
329188,2,3,6,-3,10,0
158715,4,31,7,24,3,1
280756,4,14,14,0,5,1
342305,4,20,3,17,16,0
232656,2,7,0,7,1,0
245936,4,13,37,-24,7,1
148884,1,3,6,-3,16,1
303801,4,20,17,3,16,0
132232,2,7,6,1,9,0
358270,2,0,14,-14,6,1
170129,3,7,10,-3,8,0
335045,4,16,13,3,13,0
91907,1,0,3,-3,8,1
293142,1,0,0,0,11,1
347430,1,3,13,-10,1,1
196385,2,10,0,10,2,0
392404,4,27,45,-18,4,1
361143,5,23,23,0,7,1
84816,1,0,0,0,4,1
95916,5,23,23,0,10,1
391539,2,10,21,-11,4,0
131256,3,14,17,-3,8,1
190293,4,7,14,-7,17,0
188811,4,7,33,-26,16,1
309567,3,16,0,16,1,0
220199,1,7,0,7,13,1
196935,1,7,0,7,3,0
382775,1,13,0,13,17,0
67467,2,27,7,20,14,0
258101,2,13,13,0,13,1
376780,1,7,0,7,15,1
315983,3,0,24,-24,4,0
140943,4,20,13,7,13,1
403857,1,10,0,10,10,1
137393,2,3,21,-18,11,1
235519,2,0,13,-13,3,1
156969,3,7,10,-3,2,0
184310,1,0,0,0,14,0
116291,2,17,10,7,1,1
345085,2,6,3,3,17,0
233229,1,0,0,0,2,1
346290,4,47,3,44,1,1
68722,4,34,0,34,15,1
275548,4,32,36,-4,3,1
221978,1,0,0,0,14,1
70769,3,20,24,-4,15,0
253001,4,18,13,5,11,1
3815,4,23,10,13,2,0
247402,2,3,9,-6,8,1
376456,5,23,23,0,14,1
211419,1,0,0,0,9,1
299917,4,16,11,5,14,1
223282,4,3,9,-6,15,0
91555,4,26,10,16,8,1
352918,1,3,0,3,3,0
313594,3,12,23,-11,3,1
386670,3,14,13,1,2,1
184666,3,10,24,-14,15,1
139607,4,9,14,-5,12,1
418595,2,14,10,4,16,1
176509,2,9,17,-8,11,1
168409,2,0,3,-3,7,1
224715,1,0,0,0,15,1
119752,2,10,3,7,3,0
137497,1,7,7,0,11,1
385519,1,0,0,0,1,1
317549,4,10,27,-17,5,1
316627,4,9,12,-3,4,0
175031,4,20,28,-8,10,0
93042,3,13,9,4,8,0
27129,1,0,0,0,13,0
79324,3,15,3,12,2,0
69485,4,31,23,8,15,0
286675,1,10,0,10,8,0
392372,3,20,28,-8,4,0
373134,4,10,21,-11,13,0
374131,2,13,7,6,13,1
44194,4,13,27,-14,3,1
320666,1,7,10,-3,6,1
283283,2,10,9,1,7,1
368720,3,7,16,-9,11,1
12569,3,3,17,-14,6,1
254704,1,3,0,3,11,0
307623,2,7,7,0,17,1
357911,4,13,34,-21,6,0
209713,3,9,6,3,8,0
163389,2,0,6,-6,5,0
411847,4,7,34,-27,13,1
123682,4,10,25,-15,4,1
53338,1,0,0,0,8,1
267049,1,3,0,3,17,0
123092,5,21,21,0,4,1
129139,4,34,28,6,7,0
322514,4,15,3,12,7,1
77486,1,0,7,-7,1,1
136111,2,3,10,-7,10,0
270607,4,20,14,6,1,1
148403,1,0,0,0,16,0
329298,1,3,14,-11,10,1
178320,2,7,3,4,12,0
403976,4,26,24,2,10,1
21340,4,14,24,-10,11,1
374001,3,10,7,3,13,1
22096,1,0,0,0,11,1
94468,2,0,0,0,9,1
371106,4,13,27,-14,12,0
385328,4,14,20,-6,1,1
340523,3,0,40,-40,15,0
178108,5,26,26,0,12,0
75613,3,7,6,1,17,1
53799,5,10,10,0,8,0
271555,2,7,6,1,2,1
95027,4,20,16,4,9,1
276655,3,20,6,14,4,1
420131,2,0,0,0,17,0
297373,3,9,16,-7,13,0
176401,4,22,28,-6,11,0
215867,1,0,7,-7,11,1
371510,4,24,24,0,12,0
247550,2,13,10,3,8,0
107153,1,0,7,-7,15,0
99421,1,0,0,0,11,0
155181,1,7,7,0,1,1
86200,4,34,10,24,5,0
207132,2,7,7,0,7,0
21580,3,7,17,-10,11,0
17238,3,7,34,-27,9,1
80124,1,0,0,0,2,1
273098,1,0,0,0,2,0
252564,4,32,39,-7,10,0
400535,3,7,17,-10,8,1
302166,1,13,0,13,15,1
277998,2,3,10,-7,4,1
411733,2,0,10,-10,13,1
183110,3,7,6,1,14,1
176407,4,22,28,-6,11,1
3758,3,20,10,10,2,0
85032,2,25,16,9,4,0
397696,1,6,0,6,7,0
408812,3,13,25,-12,12,0
210012,3,7,3,4,8,0
249399,3,18,15,3,9,0
291903,3,17,10,7,11,0
412468,2,10,7,3,14,1
77813,2,7,14,-7,1,0
249752,4,35,21,14,9,0
5173,1,0,0,0,3,0
315303,1,0,0,0,4,1
41461,2,2,7,-5,2,0
309866,3,21,7,14,1,1
216444,1,14,0,14,12,0
118146,3,23,27,-4,2,1
206548,2,6,3,3,7,1
123889,1,0,0,0,5,0
293892,1,0,7,-7,12,0
386137,1,0,0,0,2,1
411023,2,17,14,3,13,0
254830,4,20,13,7,11,0
261939,1,7,3,4,14,0
338683,3,20,10,10,14,0
278348,3,17,14,3,4,0
227997,1,0,0,0,17,0
211492,2,19,7,12,9,1
170900,3,14,20,-6,8,0
13880,2,14,0,14,7,0
342167,4,15,19,-4,16,1
80642,2,10,16,-6,3,1
28067,2,14,10,4,13,0
371037,3,10,10,0,12,0
11289,4,17,28,-11,6,0
66474,2,7,10,-3,14,1
304229,3,33,14,19,16,1
140820,1,7,0,7,13,0
368276,2,6,3,3,11,0
269518,3,13,17,-4,1,0
131195,1,0,3,-3,8,1
49265,4,20,10,10,6,1
409924,1,0,7,-7,12,1
138083,4,49,24,25,11,0
34904,3,27,10,17,16,1
302308,1,7,3,4,15,1
260006,1,0,0,0,14,1
415037,4,10,27,-17,15,0
206665,1,0,7,-7,7,1
55936,2,0,0,0,9,1
298435,4,7,24,-17,14,1
355851,2,13,7,6,5,0
322172,2,0,17,-17,7,1
388007,3,6,3,3,2,1
64287,2,6,10,-4,13,1
208802,3,6,22,-16,8,1
218250,1,0,7,-7,12,1
189966,3,13,7,6,17,1
393456,4,28,27,1,5,1
58621,4,13,17,-4,10,0
162139,1,0,0,0,4,0
205499,3,14,10,4,6,0
73014,1,0,0,0,16,0
357636,1,0,0,0,5,1
277742,3,7,6,1,4,1
43800,2,14,13,1,3,1
54639,2,14,19,-5,8,0
71551,1,3,0,3,16,1
135960,2,3,3,0,10,1
268208,4,12,28,-16,17,1
206037,1,0,0,0,7,0
22863,2,0,10,-10,11,1
17319,1,7,0,7,9,1
80798,2,3,0,3,3,1
254288,2,6,9,-3,11,0
349189,4,27,14,13,2,0
360723,2,10,7,3,7,1
378263,2,0,3,-3,15,1
56796,4,17,13,4,9,0
120241,2,14,3,11,3,0
115305,4,17,15,2,1,1
255044,2,3,18,-15,12,0
243355,4,20,30,-10,6,1
373261,4,13,16,-3,13,0
380866,4,9,31,-22,16,0
42076,3,27,10,17,2,0
375213,4,17,24,-7,14,1
246795,3,3,13,-10,8,0
379454,3,16,0,16,16,0
207813,1,0,0,0,8,1
258712,2,0,20,-20,13,1
108941,1,13,7,6,15,1
87410,3,10,7,3,6,1
127337,3,10,20,-10,6,1
151583,2,0,3,-3,17,0
131825,2,7,7,0,8,1
131005,4,10,30,-20,8,1
46311,2,3,14,-11,4,0
123660,3,7,22,-15,4,1
186118,1,3,0,3,15,0
66256,4,45,3,42,13,1
62521,5,16,16,0,12,0
382242,2,17,3,14,17,0
331217,4,17,20,-3,11,0
297772,1,7,0,7,13,1
276122,4,34,3,31,3,1
419394,1,3,0,3,16,1
203015,2,14,0,14,5,0
360648,4,16,27,-11,7,1
216536,3,34,11,23,12,1
273055,4,9,3,6,2,1
337570,1,0,0,0,14,0
406236,3,14,24,-10,11,1
347757,2,6,0,6,1,1
209916,4,37,16,21,8,0
288450,4,19,7,12,9,0
224949,3,3,9,-6,15,0
107295,2,3,0,3,15,1
83397,3,10,17,-7,4,1
127918,2,16,0,16,6,0
243745,3,17,10,7,6,1
134685,4,34,31,3,10,1
291250,2,7,12,-5,10,1
237578,4,38,22,16,3,0
272835,2,20,0,20,2,0
241260,2,3,0,3,5,0
201718,4,30,20,10,5,0
247636,4,26,26,0,8,1
196178,1,0,0,0,2,1
398663,4,0,3,-3,7,0
410574,2,10,7,3,13,0
213181,2,3,7,-4,10,0
357075,2,6,14,-8,5,1
343085,3,12,13,-1,16,0
97053,2,19,3,16,10,0
414718,3,3,17,-14,14,0
416066,4,21,6,15,15,0
66673,4,7,24,-17,14,1
12499,1,0,7,-7,6,0
236490,2,7,9,-2,3,1
268640,4,14,13,1,17,1
84352,4,28,30,-2,4,0
308011,4,21,12,9,1,1
185271,3,27,9,18,15,1
42729,4,7,20,-13,3,1
199379,2,7,10,-3,4,0
101345,1,6,0,6,12,1
267325,4,17,17,0,17,0
266461,2,0,9,-9,16,1
398133,4,30,42,-12,7,0
244298,4,26,7,19,6,1
113051,4,16,16,0,17,0
411944,3,17,10,7,13,0
286866,2,9,7,2,8,1
385348,4,17,31,-14,1,1
296109,1,0,0,0,13,1
279942,1,0,10,-10,5,0
64703,2,14,0,14,13,0
237928,1,0,0,0,4,1
278557,1,0,0,0,4,0
295996,2,3,0,3,13,1
405138,3,3,10,-7,10,1
202719,2,6,10,-4,5,1
421686,2,17,7,10,17,0
230254,2,6,10,-4,17,1
67520,4,39,14,25,14,0
137628,5,37,34,3,11,0
365632,4,35,35,0,9,1
177337,1,3,0,3,11,1
113744,2,3,16,-13,17,0
330900,4,16,31,-15,11,1
168789,4,16,16,0,7,1
193302,4,10,23,-13,1,0
32825,2,6,7,-1,15,1
69058,4,27,24,3,15,1
115685,2,10,3,7,1,0
97860,4,14,27,-13,11,0
371372,4,45,10,35,12,0
65860,2,7,7,0,13,0
227110,1,0,0,0,16,0
145591,2,21,0,21,14,0
152946,3,21,17,4,1,0
345430,3,0,19,-19,17,0
56336,4,3,33,-30,9,1
399321,2,14,7,7,7,1
318532,1,0,0,0,5,1
103126,4,34,7,27,13,0
17018,1,0,0,0,9,1
414678,2,3,7,-4,14,0
103709,4,3,17,-14,13,0
133642,3,10,21,-11,9,1
371718,2,14,14,0,12,1
162379,3,10,13,-3,4,1
304524,3,10,14,-4,16,0
286116,4,16,17,-1,8,1
179547,2,0,23,-23,12,1
330119,4,0,13,-13,11,0
212286,2,7,3,4,10,0
37217,2,10,14,-4,17,0
365053,4,23,6,17,9,0
58537,2,10,3,7,10,0
378071,4,0,17,-17,15,1
107089,3,40,6,34,15,1
340104,4,20,15,5,15,1
40253,1,0,0,0,2,1
225650,3,14,10,4,16,0
278103,1,0,0,0,4,0
156128,2,7,7,0,2,0
57197,3,13,7,6,10,1
359132,2,7,0,7,6,0
120344,1,0,3,-3,3,0
92804,1,0,0,0,8,1
59878,1,0,0,0,11,0
44421,2,3,0,3,3,0
55063,2,13,3,10,8,1
303914,3,14,24,-10,16,1
114432,4,41,20,21,1,1
316468,4,16,17,-1,4,0
43803,2,14,13,1,3,1
270816,2,3,0,3,1,1
162654,2,16,10,6,5,0
384280,2,6,0,6,1,1
194031,3,17,7,10,1,0
295320,4,14,5,9,12,0
101014,4,20,16,4,12,1
223329,1,0,0,0,15,0
408907,2,17,6,11,12,0
71818,4,38,33,5,16,0
352228,2,3,3,0,3,1
185328,1,0,0,0,15,1
132067,1,0,0,0,9,1
106046,4,24,3,21,14,1
88452,2,7,0,7,6,1
291664,1,0,0,0,11,0
133564,1,0,0,0,9,1
228251,4,10,27,-17,17,1
2402,2,21,13,8,2,0
279971,2,3,10,-7,5,1
228300,1,0,0,0,17,1
366170,3,7,45,-38,10,1
240609,2,13,7,6,5,1
227049,4,17,6,11,16,0
416027,2,7,3,4,15,1
58455,4,48,17,31,10,0
8461,2,15,0,15,4,0
333668,2,14,0,14,12,0
399682,4,19,9,10,8,1
304880,4,12,10,2,16,0
421130,3,27,16,11,17,0
157008,4,13,13,0,2,0
109977,2,10,7,3,16,1
229807,1,0,0,0,17,0
403240,4,24,24,0,9,1
375447,2,7,7,0,14,0
172308,5,24,23,1,9,1
42672,3,6,10,-4,3,1
159009,4,33,29,4,3,0
57998,5,20,20,0,10,0
131080,2,17,6,11,8,0
320061,1,0,0,0,6,1
344450,4,28,24,4,17,1
78062,4,19,23,-4,1,0
143205,2,7,10,-3,13,1
382701,3,3,6,-3,17,0
187271,3,10,6,4,16,0
289708,1,0,0,0,10,0
185856,2,9,3,6,15,0
42929,3,17,16,1,3,1
130411,4,7,6,1,8,1
316524,1,0,0,0,4,1
360953,4,31,5,26,7,1
312793,1,0,0,0,3,1
398674,4,0,6,-6,7,1
241808,1,3,3,0,5,1
298196,1,0,3,-3,14,0
320659,1,7,7,0,6,1
247360,1,0,0,0,8,1
71787,4,38,33,5,16,1
110234,1,0,3,-3,16,0
92066,1,3,7,-4,8,1
342460,4,20,3,17,16,0
168160,3,16,5,11,7,1
15284,1,0,0,0,8,0
342643,4,22,27,-5,16,1
170778,4,27,6,21,8,0
230347,4,26,17,9,17,0
77201,2,6,0,6,1,0
138038,3,22,17,5,11,1
182023,3,14,14,0,13,1
120433,3,19,15,4,3,0
182929,2,0,30,-30,14,1
76356,3,16,3,13,1,0
331220,4,17,20,-3,11,0
298744,4,22,27,-5,14,1
225267,4,17,7,10,15,1
315273,5,20,19,1,4,0
129828,2,10,0,10,7,1
187898,4,7,23,-16,16,1
151870,1,10,0,10,17,1
229683,2,10,7,3,17,0
152627,2,6,6,0,17,1
52415,4,12,17,-5,7,1
144733,3,3,7,-4,14,1
79434,2,9,7,2,2,0
69294,3,16,3,13,15,0
290442,4,35,10,25,10,0
188379,2,3,0,3,16,1
174193,2,3,16,-13,10,1
257541,3,19,10,9,13,1
92306,3,20,0,20,8,0
220267,3,20,9,11,13,0
329413,4,16,41,-25,10,1
418373,1,7,0,7,16,1
143819,3,12,7,5,14,0
156867,4,23,29,-6,2,1
278996,4,7,30,-23,5,1
273890,1,0,3,-3,2,0
158183,2,10,0,10,3,0
161618,3,30,16,14,4,0
353582,3,31,0,31,4,0
404545,4,34,27,7,10,0
24335,1,3,0,3,12,0
312371,2,13,24,-11,3,1
261716,3,14,7,7,14,1
403074,4,27,27,0,9,1
183725,4,34,20,14,14,0
387563,3,6,3,3,2,0
246416,1,0,0,0,8,1
413840,2,14,6,8,14,1
242043,3,7,9,-2,5,1
116667,1,3,0,3,2,1
182017,3,14,14,0,13,0
331751,3,10,27,-17,12,1
194822,4,10,26,-16,2,0
277271,3,0,13,-13,4,0
214298,3,14,10,4,11,0
211893,4,36,17,19,9,0
34750,3,13,3,10,16,1
3824,4,23,10,13,2,0
406591,4,20,37,-17,11,0
99139,1,0,3,-3,11,1
277896,3,7,20,-13,4,0
22682,1,0,0,0,11,1
314250,4,17,23,-6,3,0
84423,2,6,0,6,4,0
408596,2,20,0,20,12,1
372666,4,14,17,-3,13,1
92257,2,10,0,10,8,1
383136,4,23,14,9,17,0
42643,2,0,7,-7,3,0
146870,3,31,0,31,15,0
207164,3,14,10,4,7,0
116555,2,0,0,0,2,1
169367,3,6,14,-8,8,1
197528,1,0,0,0,3,1
297875,4,21,27,-6,13,1
259728,2,10,7,3,14,1
250081,4,17,13,4,9,0
16762,2,3,14,-11,8,0
80755,1,3,0,3,3,0
81302,4,10,14,-4,3,1
126744,4,13,13,0,6,0
303011,4,23,16,7,16,0
350357,4,24,10,14,2,0
369635,4,23,20,3,11,1
296640,3,3,10,-7,13,1
260148,1,0,0,0,14,1
268618,3,7,6,1,17,0
51715,2,0,10,-10,7,1
135931,1,0,0,0,10,0
346974,2,7,3,4,1,0
129524,2,3,7,-4,7,0
177161,4,40,13,27,11,1
285031,1,0,0,0,7,0
118474,4,27,10,17,2,0
251541,3,16,13,3,10,0
314713,1,0,0,0,4,1
381917,1,0,7,-7,17,1
161212,1,0,3,-3,4,0
178175,2,0,7,-7,12,0
260669,3,10,22,-12,14,1
366237,2,7,0,7,10,0
409562,3,35,9,26,12,0
162624,2,3,10,-7,5,1
348693,2,16,10,6,2,1
244973,2,0,20,-20,7,1
13416,2,3,14,-11,7,0
363516,2,3,2,1,8,1
414441,3,13,23,-10,14,0
397494,4,13,22,-9,6,0
407023,4,11,34,-23,11,0
395654,3,7,17,-10,6,1
149619,1,0,0,0,16,0
373035,2,0,0,0,13,0
40347,4,9,7,2,2,0
266651,2,16,3,13,16,1
363260,3,24,7,17,8,1
23700,4,12,27,-15,12,0
179779,3,6,24,-18,12,1
359379,4,13,20,-7,6,0
295215,2,14,2,12,12,1
216489,2,20,8,12,12,1
280342,4,19,29,-10,5,1
314950,4,0,10,-10,4,0
76492,2,0,20,-20,1,1
418935,4,27,17,10,16,0
377410,3,7,13,-6,15,1
2414,3,21,13,8,2,1
408682,4,31,17,14,12,1
404926,2,3,10,-7,10,1
168210,4,29,15,14,7,1
247969,1,0,3,-3,8,1
41218,4,7,13,-6,2,1
91216,4,13,17,-4,8,0
301691,4,17,6,11,15,0
272791,1,0,0,0,2,1
139972,2,25,3,22,12,1
241753,4,7,9,-2,5,1
330361,2,7,13,-6,11,0
380173,2,7,3,4,16,1
19719,2,6,6,0,10,0
153827,1,0,0,0,1,0
105181,1,7,0,7,14,0
244999,3,0,27,-27,7,0
405829,5,24,24,0,10,1
110621,3,17,10,7,16,0
159115,3,24,7,17,3,1
63653,4,20,36,-16,12,1
48961,4,28,20,8,5,0
229655,1,7,7,0,17,0
127738,1,0,7,-7,6,0
223002,4,13,23,-10,14,0
395276,4,10,16,-6,5,0
267652,2,0,21,-21,17,1
420773,2,0,3,-3,17,1
87596,4,17,10,7,6,0
199225,2,17,14,3,4,0
150540,1,0,3,-3,17,1
381025,1,0,3,-3,16,1
239347,4,3,17,-14,4,0
215685,4,14,6,8,11,0
60418,4,23,7,16,11,0
403832,1,0,0,0,10,0
127429,1,3,0,3,6,1
294967,3,17,7,10,12,0
180879,1,0,0,0,13,1
367359,1,0,7,-7,10,1
188159,3,10,10,0,16,1
332264,1,0,0,0,12,0
364187,1,0,0,0,9,0
226498,4,14,10,4,16,0
411371,4,20,10,10,13,0
372830,4,6,0,6,13,0
184276,4,31,14,17,14,1
165706,3,14,7,7,6,0
283736,2,8,3,5,7,0
368993,3,10,7,3,11,1
56018,4,10,23,-13,9,1
147394,2,7,7,0,15,1
187232,2,6,6,0,16,1
36992,4,0,32,-32,17,0
203849,4,31,31,0,6,1
280321,4,16,22,-6,5,1
149282,3,13,20,-7,16,0
321590,2,10,6,4,7,0
17348,2,14,0,14,9,1
174785,2,13,7,6,10,0
138790,2,0,26,-26,12,1
38430,4,31,16,15,1,0
222161,2,7,10,-3,14,1
407390,2,0,7,-7,11,1
348082,3,0,16,-16,1,0
280915,4,21,10,11,6,1
148594,2,0,6,-6,16,1
237864,3,7,27,-20,4,0
77136,4,17,17,0,1,0
118645,1,7,6,1,2,1
344995,4,10,23,-13,17,1
311104,4,10,3,7,2,1
301566,1,7,0,7,15,1
365958,1,0,0,0,10,0
186244,1,3,0,3,15,0
143459,2,14,7,7,14,0
26328,4,19,21,-2,13,1
36518,3,10,20,-10,17,0
189636,3,10,6,4,17,1
39299,3,10,27,-17,1,0
278133,2,7,7,0,4,0
88058,3,24,3,21,6,0
351500,2,0,24,-24,3,0
418295,2,6,13,-7,16,0
265080,3,13,3,10,16,0
410690,2,7,3,4,13,1
34619,4,24,7,17,16,0
24240,3,13,17,-4,12,0
252582,1,0,0,0,10,1
266845,4,17,17,0,16,1
5055,2,10,0,10,3,0
65647,4,6,19,-13,13,1
98608,3,7,7,0,11,1
11671,2,14,0,14,6,0
400635,2,3,0,3,8,1
82141,2,3,3,0,3,1
137547,3,17,20,-3,11,1
56708,2,0,10,-10,9,1
190908,1,6,0,6,17,1
395579,1,0,3,-3,6,1
223335,1,0,3,-3,15,1
155849,2,7,10,-3,2,1
91707,4,21,24,-3,8,1
140347,3,17,26,-9,12,1
102902,2,3,14,-11,13,1
292140,2,21,0,21,11,0
23761,2,9,0,9,12,1
120465,4,26,27,-1,3,0
318587,3,10,10,0,5,1
115609,4,30,9,21,1,1
404667,4,20,29,-9,10,1
381696,3,20,14,6,17,0
385393,2,7,7,0,1,1
397763,4,9,14,-5,7,1
313764,3,28,10,18,3,1
420471,2,0,28,-28,17,1
319866,4,23,10,13,6,1
4343,2,0,7,-7,2,1
384496,4,28,6,22,1,0
270907,4,19,20,-1,1,1
351868,4,27,14,13,3,0
345414,3,0,10,-10,17,0
400528,2,7,11,-4,8,1
348575,3,28,17,11,2,0
391977,1,0,7,-7,4,1
262618,3,23,10,13,15,1
154346,4,27,24,3,1,1
197273,2,0,0,0,3,0
36550,4,20,27,-7,17,1
143464,2,14,7,7,14,0
28252,3,17,0,17,13,0
385235,1,0,3,-3,1,1
108231,2,6,0,6,15,1
289166,2,20,7,13,9,0
272156,1,0,0,0,2,0
160529,3,23,14,9,4,1
153829,1,0,0,0,1,0
217079,1,0,0,0,12,1
308649,1,0,6,-6,1,1
154705,1,0,0,0,1,0
206774,4,14,27,-13,7,1
1326,1,0,0,0,1,0
23337,3,9,10,-1,11,1
195660,2,7,7,0,2,0
93591,2,6,6,0,9,1
63410,1,0,3,-3,12,1
418075,1,0,0,0,16,0
281732,4,38,38,0,6,1
241305,4,13,7,6,5,0
257633,1,0,7,-7,13,1
348963,2,14,0,14,2,0
405952,3,14,7,7,11,1
417772,5,35,35,0,16,1
157695,2,10,3,7,2,0
226058,1,0,0,0,16,0
204216,1,0,7,-7,6,1
175069,1,0,3,-3,10,1
378512,1,0,0,0,15,1
308785,1,0,0,0,1,0
247041,1,0,3,-3,8,1
97783,2,7,3,4,11,1
197648,4,33,7,26,3,0
96935,3,22,7,15,10,0
141823,2,10,14,-4,13,1
115707,3,10,3,7,1,1
395068,3,0,24,-24,5,1
219967,3,6,21,-15,13,1
349389,1,0,0,0,2,1
114012,1,0,0,0,17,1
176820,2,10,10,0,11,1
352,2,14,10,4,1,1
209454,4,17,20,-3,8,1
184650,2,10,17,-7,15,1
346262,4,40,3,37,1,0
106905,2,9,3,6,14,0
280692,2,0,3,-3,5,1
190618,1,7,7,0,17,1
104137,3,24,27,-3,13,0
357473,1,0,0,0,5,0
75934,4,32,7,25,1,0
413968,2,3,7,-4,14,0
274002,4,13,29,-16,2,0
418162,3,24,3,21,16,0
8492,3,15,3,12,4,0
305290,3,35,21,14,16,0
41488,3,5,7,-2,2,1
197854,2,8,7,1,3,1
290574,4,23,20,3,10,1
139826,2,10,10,0,12,0
55652,1,10,14,-4,9,1
171607,2,3,3,0,9,1
220929,1,0,0,0,14,0
16725,1,0,0,0,8,0
241756,4,7,9,-2,5,1
216208,3,14,3,11,12,1
207246,1,0,0,0,7,1
352411,3,35,10,25,3,1
32741,4,7,24,-17,15,0
102427,1,3,0,3,13,0
130343,2,7,0,7,8,0
371226,4,14,19,-5,12,1
274031,1,0,0,0,3,1
355648,4,38,17,21,5,0
185673,1,7,0,7,15,1
120488,4,39,33,6,3,0
123773,2,10,3,7,5,0
159553,2,14,6,8,3,1
309283,3,0,19,-19,1,0
321491,4,24,30,-6,7,0
268922,3,6,33,-27,17,0
408815,4,13,25,-12,12,0
90694,1,7,0,7,7,0
161237,2,7,3,4,4,1
157416,2,9,10,-1,2,1
17136,4,30,17,13,9,0
74016,4,37,0,37,17,0
20588,1,0,0,0,10,0
351438,4,20,16,4,3,0
162960,2,6,0,6,5,0
269151,5,16,16,0,17,1
80912,2,6,0,6,3,1
95501,1,3,0,3,10,0
106199,4,0,10,-10,14,1
147632,1,0,0,0,15,0
62845,1,3,0,3,12,0
310117,2,7,0,7,2,1
261053,2,0,14,-14,14,1
222504,3,9,14,-5,14,1
310855,1,3,0,3,2,0
284206,4,9,23,-14,7,0
393948,1,0,0,0,5,1
241273,3,3,0,3,5,1
418517,4,24,12,12,16,1
125539,1,0,0,0,5,1
1711,3,21,0,21,1,0
231507,4,23,20,3,1,0
149897,4,6,16,-10,16,0
195945,2,0,17,-17,2,1
209273,4,34,7,27,8,0
368474,4,37,35,2,11,1
82157,2,10,3,7,3,1
252274,1,0,10,-10,10,0
235770,4,20,27,-7,3,0
355573,2,21,3,18,5,0
356093,4,34,16,18,5,0
210243,1,0,0,0,9,0
158057,3,15,9,6,3,1
123455,1,0,0,0,4,0
272797,1,6,0,6,2,1
153418,3,13,10,3,1,0
151721,1,7,0,7,17,0
157388,2,3,7,-4,2,1
226544,1,0,0,0,16,1
82374,4,13,10,3,3,0
266283,1,0,0,0,16,1
119680,4,17,19,-2,3,1
327156,3,21,17,4,9,0
194156,2,3,3,0,1,0
412456,2,7,7,0,14,1
407358,1,0,0,0,11,1
229452,4,13,6,7,17,0
242279,1,7,7,0,6,0
264366,1,0,7,-7,15,1
320917,4,10,14,-4,6,0
126662,2,0,3,-3,6,1
170999,2,7,7,0,8,0
90666,4,27,33,-6,7,1
23007,2,0,14,-14,11,1
58737,3,10,17,-7,10,1
15201,2,6,0,6,8,0
411989,1,0,0,0,13,0
126301,1,0,7,-7,6,0
7113,3,28,21,7,4,0
175239,2,15,0,15,10,0
68774,1,6,0,6,15,1
230292,3,19,10,9,17,0
28671,2,3,7,-4,14,0
290108,4,13,15,-2,10,1
292615,3,9,16,-7,11,1
214732,2,3,7,-4,11,0
227011,2,10,6,4,16,0
239564,2,13,3,10,4,1
165100,4,10,24,-14,6,0
140242,1,0,0,0,12,0
260632,2,7,13,-6,14,0
346525,3,24,30,-6,1,0
108950,2,16,7,9,15,1
107244,4,14,31,-17,15,0
88754,2,6,3,3,6,0
183778,2,10,14,-4,14,1
187020,1,0,0,0,16,1
43332,2,14,7,7,3,0
330753,5,9,9,0,11,0
30771,4,31,28,3,15,0
186474,3,10,13,-3,15,1
210018,3,7,10,-3,8,1
25965,2,3,6,-3,13,1
296837,4,21,7,14,13,0
262321,3,13,9,4,15,1
56553,2,16,7,9,9,0
64930,4,10,6,4,13,0
323031,2,7,7,0,7,1
190438,4,14,13,1,17,0
210848,1,0,0,0,9,0
223070,2,17,7,10,14,1
308696,2,7,6,1,1,0
19122,1,7,3,4,10,1
421645,2,3,7,-4,17,1
335429,2,13,6,7,13,0
251411,4,43,14,29,10,0
242079,4,20,16,4,5,0
99039,2,6,0,6,11,1
258196,4,20,20,0,13,1
153039,1,0,0,0,1,0
251919,4,20,19,1,10,1
1455,1,0,0,0,1,1
172747,3,21,10,11,9,1
260282,4,24,3,21,14,1
173896,2,6,10,-4,10,1
71758,3,24,23,1,16,0
163902,2,16,10,6,5,1
242385,4,34,13,21,6,1
82022,3,10,0,10,3,1
415635,4,30,13,17,15,1
153963,1,7,0,7,1,0
369481,4,48,7,41,11,0
369204,4,22,20,2,11,0
293652,2,10,7,3,12,0
328526,4,15,3,12,10,0
157946,4,16,22,-6,3,0
150064,4,31,12,19,16,1
92285,3,19,0,19,8,1
167548,3,0,10,-10,7,1
183279,3,13,20,-7,14,1
368470,4,37,28,9,11,0
278373,4,17,21,-4,4,0
141560,4,34,10,24,13,0
99170,2,3,3,0,11,0
66591,2,0,14,-14,14,1
231716,1,0,7,-7,1,1
404998,4,9,20,-11,10,0
55352,1,7,0,7,9,0
102623,2,12,6,6,13,0
92736,3,3,17,-14,8,1
395936,2,23,3,20,6,1
414639,1,0,0,0,14,0
170227,1,0,3,-3,8,0
321382,1,7,3,4,7,0
224582,2,6,7,-1,15,1
416370,4,16,6,10,15,0
223370,2,0,12,-12,15,1
55012,1,0,0,0,8,0
246563,4,36,7,29,8,1
270656,1,3,0,3,1,0
30232,1,0,0,0,14,1
114380,3,34,13,21,1,0
3548,1,0,7,-7,2,1
82007,2,7,0,7,3,1
359485,3,0,14,-14,6,0
20965,2,7,24,-17,10,1
88822,4,13,13,0,6,0
76058,3,10,16,-6,1,1
9758,2,2,7,-5,5,0
351576,4,0,27,-27,3,1
110900,2,7,3,4,16,0
113721,2,3,10,-7,17,0
68587,4,20,28,-8,14,0
330428,4,13,20,-7,11,0
354050,2,13,0,13,4,0
245505,1,7,0,7,7,1
81667,2,7,13,-6,3,0
99879,1,0,3,-3,12,1
198196,3,10,9,1,3,1
226265,2,9,0,9,16,0
204753,3,14,14,0,6,0
375217,4,17,24,-7,14,1
234619,2,17,10,7,2,0
155932,4,17,16,1,2,1
181565,2,13,0,13,13,0
285874,1,6,0,6,8,1
373195,2,3,3,0,13,0
289741,2,0,10,-10,10,0
221149,3,0,15,-15,14,0
175004,3,13,28,-15,10,1
368751,4,20,19,1,11,1
176684,3,29,12,17,11,1
59752,2,6,10,-4,11,1
225786,2,10,14,-4,16,0
38566,4,38,6,32,1,0
283322,4,10,9,1,7,0
367353,1,0,0,0,10,0
154839,1,3,0,3,1,0
117526,3,17,17,0,2,0
382549,3,0,10,-10,17,0
33220,2,10,0,10,16,0
399653,3,16,6,10,8,0
139415,2,21,0,21,12,1
388490,3,3,16,-13,2,1
140337,3,17,20,-3,12,1
298880,4,21,15,6,14,0
410644,4,17,31,-14,13,1
59379,4,0,16,-16,11,1
78586,3,16,13,3,2,0
249665,2,11,7,4,9,0
201002,2,14,0,14,5,0
336739,3,10,10,0,14,1
296430,2,14,0,14,13,0
135528,2,14,6,8,10,1
158711,4,31,7,24,3,0
408883,1,7,0,7,12,1
309231,1,0,7,-7,1,1
162335,2,3,7,-4,4,0
387863,3,10,28,-18,2,0
331592,3,17,23,-6,11,1
226796,4,14,20,-6,16,0
257847,3,7,9,-2,13,0
70640,4,17,20,-3,15,1
205880,4,20,7,13,7,0
390456,4,21,33,-12,3,1
40653,4,34,7,27,2,0
194688,1,0,0,0,2,0
162275,4,30,20,10,4,1
269855,4,22,10,12,1,0
262200,4,31,16,15,15,1
294747,1,0,0,0,12,0
391560,2,10,21,-11,4,1
316039,4,6,31,-25,4,1
160525,3,20,14,6,4,1
204355,4,3,17,-14,6,1
26856,2,10,3,7,13,0
342160,4,15,19,-4,16,1
193668,1,3,20,-17,1,1
317311,1,0,0,0,5,1
80949,2,13,0,13,3,1
28406,3,13,3,10,14,1
79589,2,14,0,14,2,0
211655,2,16,3,13,9,1
36860,4,24,42,-18,17,1
74422,3,10,20,-10,17,1
317590,1,3,0,3,5,0
46612,2,3,0,3,4,0
411190,3,0,23,-23,13,1
337200,3,9,13,-4,14,1
414651,1,0,0,0,14,1
404379,4,20,6,14,10,0
324446,4,14,6,8,8,1
117554,4,17,20,-3,2,0
306216,4,20,3,17,17,0
98951,4,7,17,-10,11,1
355515,1,7,0,7,5,0
50127,3,0,17,-17,6,0
288241,3,10,21,-11,9,0
41374,4,14,12,2,2,0
297829,3,14,7,7,13,0
273555,4,28,35,-7,2,1
347637,3,17,10,7,1,1
374983,2,21,20,1,14,0
400957,2,16,7,9,8,1
108230,2,6,0,6,15,1
159968,1,0,3,-3,3,1
310336,4,26,0,26,2,1
370795,4,19,17,2,12,1
357586,4,13,13,0,5,1
53999,1,0,0,0,8,1
323005,1,0,0,0,7,1
214834,1,0,3,-3,11,1
281409,1,0,3,-3,6,0
42090,4,27,20,7,2,0
97506,2,16,0,16,10,0
356672,2,19,10,9,5,0
392357,3,17,28,-11,4,1
63368,4,17,3,14,12,1
214509,4,7,23,-16,11,1
37206,2,3,14,-11,17,1
91155,2,3,14,-11,8,0
233927,4,17,13,4,2,1
191742,4,16,17,-1,17,1
181288,4,3,20,-17,13,1
269176,1,0,3,-3,17,1
299461,3,7,20,-13,14,1
158135,1,0,0,0,3,0
32614,1,0,0,0,15,1
189228,3,33,9,24,16,0
344772,1,0,0,0,17,0
321250,1,3,3,0,6,1
406386,3,10,7,3,11,1
259062,4,3,16,-13,13,0
39238,2,3,3,0,1,1
34694,2,3,3,0,16,0
277629,4,27,28,-1,4,1
398920,3,10,10,0,7,0
143986,3,7,10,-3,14,1
16432,4,24,16,8,8,0
262189,4,31,16,15,15,1
240313,3,7,10,-3,5,1
173279,1,7,10,-3,10,1
246993,4,20,24,-4,8,0
125429,2,10,0,10,5,0
261657,2,0,0,0,14,1
309248,2,0,7,-7,1,1
113905,2,10,3,7,17,0
185386,2,0,3,-3,15,0
111338,1,0,7,-7,16,0
115280,3,14,9,5,1,0
367941,1,0,7,-7,11,1
414325,1,0,0,0,14,1
326974,3,2,7,-5,9,1
66999,1,0,0,0,14,0
268876,2,6,10,-4,17,0
47261,4,19,9,10,5,0
94966,2,6,6,0,9,0
137024,1,7,0,7,11,0
415776,4,21,17,4,15,0
330904,4,16,31,-15,11,1
303218,5,31,31,0,16,1
183687,3,6,14,-8,14,0
221171,4,0,23,-23,14,1
20612,1,0,0,0,10,1
161312,4,20,6,14,4,0
347291,3,0,7,-7,1,1
415031,3,10,27,-17,15,1
151091,4,17,10,7,17,1
251091,2,10,14,-4,10,0
149807,2,3,7,-4,16,0
42603,1,0,0,0,3,0
58065,1,7,10,-3,10,1
123876,1,0,0,0,5,0
380135,5,38,38,0,16,0
251782,1,0,0,0,10,0
298897,1,0,0,0,14,0
250021,2,17,6,11,9,0
283918,4,31,17,14,7,0
44286,3,17,20,-3,3,1
39190,1,0,0,0,1,0
221316,4,6,35,-29,14,1
86370,1,7,0,7,5,0
354164,1,3,0,3,4,0
404951,3,6,13,-7,10,1
110770,3,3,3,0,16,1
136167,4,10,10,0,10,1
414470,4,16,23,-7,14,1
356917,1,3,0,3,5,0
352234,2,3,3,0,3,1
146281,4,10,30,-20,15,0
99300,2,13,0,13,11,0
129910,4,13,0,13,7,1
238321,2,3,9,-6,4,0
335201,4,27,20,7,13,1
157143,4,19,20,-1,2,0
215799,3,38,6,32,11,0
325676,4,31,7,24,9,1
160294,2,3,0,3,4,0
94403,4,17,21,-4,9,1
74493,2,0,0,0,17,1
170169,4,10,20,-10,8,1
243114,3,7,9,-2,6,0
345762,4,16,10,6,17,1
92042,4,27,26,1,8,0
369030,4,13,7,6,11,0
355879,3,13,10,3,5,0
299085,2,3,3,0,14,0
284093,1,0,0,0,7,0
267712,3,14,27,-13,17,1
291777,4,9,17,-8,11,1
370654,4,21,14,7,12,1
7752,3,27,3,24,4,1
24958,2,10,14,-4,12,1
95281,3,10,24,-14,10,1
60118,4,20,19,1,11,1
309199,1,0,0,0,1,0
189831,4,27,17,10,17,0
59934,2,3,10,-7,11,1
277152,4,10,27,-17,4,1
182232,4,33,7,26,13,0
113449,3,0,7,-7,17,1
367612,4,28,12,16,10,1
367348,1,0,0,0,10,0
64926,4,10,6,4,13,1
141304,1,0,7,-7,13,0
206934,4,17,23,-6,7,1
36780,2,7,7,0,17,0
22146,2,10,6,4,11,0
205968,3,6,10,-4,7,0
205800,2,7,0,7,7,0
65465,3,16,14,2,13,0
79497,4,12,17,-5,2,0
360055,3,3,33,-30,7,1
263173,2,3,14,-11,15,1
103248,3,3,10,-7,13,1
185967,1,3,7,-4,15,0
17776,1,7,3,4,9,0
227133,2,0,7,-7,16,1
57450,1,7,0,7,10,0
37130,4,16,20,-4,17,1
247904,3,17,6,11,8,0
224003,2,14,6,8,15,1
139839,3,10,10,0,12,1
229645,1,0,0,0,17,0
65484,3,23,14,9,13,0
97803,2,7,10,-3,11,1
162921,1,0,0,0,5,1
271116,2,0,10,-10,1,1
59740,2,6,7,-1,11,0
93873,2,14,3,11,9,1
300929,3,10,27,-17,15,1
376170,1,7,0,7,14,0
388032,3,13,6,7,2,0
152278,4,28,0,28,17,0
181068,2,7,7,0,13,1
379529,1,0,3,-3,16,1
71471,3,30,7,23,16,0
15461,2,6,0,6,8,1
331036,3,45,10,35,11,0
356063,4,27,10,17,5,0
267517,2,13,14,-1,17,0
16917,2,14,13,1,8,1
415361,4,14,24,-10,15,1
285121,4,3,0,3,7,1
147305,4,7,31,-24,15,0
235777,4,20,27,-7,3,1
267824,2,13,14,-1,17,0
90655,4,20,33,-13,7,1
238627,2,6,0,6,4,1
8370,3,30,3,27,4,0
364784,1,0,0,0,9,1
324423,3,14,3,11,8,1
205783,2,7,0,7,7,1
31335,3,7,3,4,15,1
356946,2,3,3,0,5,0
67749,3,21,0,21,14,1
48392,2,3,17,-14,5,1
185220,2,10,6,4,15,1
117384,4,34,3,31,2,1
279541,3,10,6,4,5,0
135878,4,21,24,-3,10,1
283506,1,0,0,0,7,1
131621,1,0,3,-3,8,0
330778,1,0,0,0,11,0
175861,2,20,24,-4,11,0
234557,4,20,20,0,2,1
145150,2,29,0,29,14,0
94020,2,6,21,-15,9,1
57061,3,7,20,-13,9,1
393169,1,0,0,0,5,0
31126,1,3,10,-7,15,1
242828,4,21,34,-13,6,1
302434,1,0,3,-3,15,0
51386,1,0,0,0,7,1
395681,4,10,33,-23,6,0
119585,2,10,0,10,3,0
332379,4,16,20,-4,12,0
368564,3,9,0,9,11,1
87934,4,19,15,4,6,1
292213,4,24,17,7,11,0
346483,2,16,14,2,1,1
283931,4,31,17,14,7,1
229127,3,19,7,12,17,1
75725,2,21,16,5,1,1
286849,2,3,7,-4,8,1
237062,2,0,17,-17,3,0
395960,2,24,10,14,6,0
395961,2,24,10,14,6,0
319789,2,14,7,7,6,0
51313,2,9,17,-8,7,1
235755,4,13,27,-14,3,1
242391,4,34,19,15,6,1
338058,2,0,7,-7,14,0
160723,4,10,3,7,4,0
267158,4,10,10,0,17,1
26288,3,13,21,-8,13,1
147529,2,6,0,6,15,0
357885,4,13,34,-21,6,1
220112,2,25,6,19,13,1
56766,3,14,13,1,9,1
263316,2,17,7,10,15,0
259778,4,20,10,10,14,0
315431,4,29,30,-1,4,1
119503,4,14,24,-10,3,0
7148,4,34,21,13,4,0
381565,4,28,16,12,17,0
155333,1,10,3,7,2,0
385305,3,14,20,-6,1,0
60527,2,30,14,16,11,1
59120,4,26,36,-10,10,0
202893,3,21,0,21,5,1
9747,2,0,7,-7,5,1
239596,3,20,10,10,4,1
94205,3,24,14,10,9,0
84406,2,3,0,3,4,1
198787,2,3,6,-3,3,0
37502,2,7,7,0,17,0
174072,3,0,33,-33,10,0
417539,4,24,28,-4,16,1
145684,4,42,7,35,14,1
227500,4,19,17,2,16,1
327632,4,10,22,-12,10,1
178465,2,10,3,7,12,1
285278,3,14,6,8,7,0
13603,3,10,7,3,7,1
295760,4,17,16,1,12,1
45183,3,7,10,-3,4,0
86487,4,30,24,6,5,1
311311,1,7,0,7,2,0
47629,1,3,17,-14,5,1
172957,1,7,0,7,9,0
326089,3,30,3,27,9,1
178437,1,0,3,-3,12,1
123303,2,14,7,7,4,0
87448,4,20,10,10,6,0
191819,2,10,7,3,1,0
354059,2,13,0,13,4,1
124596,3,6,17,-11,5,1
17524,2,13,0,13,9,1
165426,4,6,36,-30,6,0
280603,4,17,9,8,5,1
252427,1,0,0,0,10,0
23922,2,13,0,13,12,1
306046,3,10,13,-3,17,1
331244,1,0,0,0,11,0
291521,1,3,0,3,11,0
88766,2,6,3,3,6,1
184255,3,24,7,17,14,1
218833,1,0,3,-3,13,1
271978,4,23,27,-4,2,1
309169,4,35,3,32,1,1
37495,2,7,7,0,17,0
142868,1,0,0,0,13,1
174927,1,0,7,-7,10,1
202379,1,0,0,0,5,1
350457,2,0,12,-12,2,1
354660,3,10,10,0,4,1
113925,3,17,10,7,17,0
388000,2,3,3,0,2,1
138074,4,42,24,18,11,1
178829,3,24,14,10,12,1
237855,3,7,27,-20,4,1
226403,1,0,7,-7,16,1
126389,3,13,14,-1,6,1
402648,4,23,23,0,9,0
296677,4,10,16,-6,13,1
229077,2,10,0,10,17,0
14046,3,3,21,-18,7,0
362738,4,12,20,-8,8,1
266136,4,17,13,4,16,0
388348,3,17,12,5,2,1
215463,2,7,3,4,11,1
82250,1,0,0,0,3,1
116326,3,27,13,14,1,1
364223,2,0,7,-7,9,1
12627,1,0,0,0,6,0
66823,4,13,6,7,14,1
1032,1,7,0,7,1,0
9422,1,0,0,0,5,1
169615,1,6,0,6,8,1
367565,2,14,9,5,10,0
97985,3,17,10,7,11,1
415932,4,10,30,-20,15,1
403175,2,17,14,3,9,0
225030,1,0,6,-6,15,0
232961,2,10,3,7,2,0
14476,3,24,16,8,7,0
233701,2,7,21,-14,2,1
369627,4,23,14,9,11,0
172877,3,24,17,7,9,1
354797,3,13,20,-7,4,1
70521,4,39,23,16,15,0
74064,2,9,0,9,17,0
96280,1,0,9,-9,10,0
119709,1,0,0,0,3,1
95032,4,20,16,4,9,1
93282,2,14,3,11,9,0
407589,3,10,17,-7,11,0
244507,2,25,10,15,7,1
186522,4,17,33,-16,15,1
1712,3,27,0,27,1,1
130693,4,7,38,-31,8,0
23675,4,7,27,-20,12,0
312888,4,14,14,0,3,1
13686,1,0,0,0,7,0
328588,2,10,14,-4,10,1
148602,2,0,9,-9,16,1
363334,1,0,0,0,8,0
61103,2,0,7,-7,11,0
110610,3,17,10,7,16,0
15797,3,0,12,-12,8,0
267004,4,19,17,2,17,1
175493,1,0,0,0,11,1
242920,3,21,13,8,6,0
334328,1,0,0,0,13,0
185735,3,20,3,17,15,0
352639,1,0,0,0,3,0
210342,4,16,17,-1,9,1
43509,2,7,3,4,3,1
12525,2,0,17,-17,6,1
376692,3,3,0,3,14,0
17552,3,13,10,3,9,1
201292,2,14,3,11,5,1
293731,1,0,0,0,12,1
337443,1,0,6,-6,14,0
159393,3,10,13,-3,3,1
216761,4,27,9,18,12,0
327298,4,16,20,-4,9,1
232548,4,23,17,6,1,0
278388,4,17,21,-4,4,0
153158,3,20,17,3,1,0
158319,2,6,14,-8,3,1
242178,3,13,7,6,6,1
393970,1,3,7,-4,5,0
237048,2,0,17,-17,3,1
385187,4,21,20,1,1,1
104479,2,14,17,-3,13,1
67479,3,36,7,29,14,0
409576,4,35,17,18,12,1
194785,3,10,16,-6,2,0
56787,4,14,13,1,9,1
415706,2,7,10,-3,15,1
176151,2,14,7,7,11,0
369677,2,16,7,9,11,0
13756,3,0,20,-20,7,1
129035,1,0,7,-7,7,1
35588,1,7,0,7,17,0
192182,3,3,20,-17,1,0
230436,3,21,3,18,1,0
304169,1,0,0,0,16,1
43188,2,7,7,0,3,1
275556,1,7,0,7,3,0
195145,1,0,0,0,2,1
375648,3,17,17,0,14,0
170116,2,7,3,4,8,0
340681,4,16,20,-4,15,1
50703,2,7,7,0,6,1
270981,2,0,14,-14,1,1
88865,4,20,16,4,6,0
352162,4,15,20,-5,3,0
335199,4,27,20,7,13,1
132549,2,2,29,-27,9,1
404244,4,19,16,3,10,0
305700,2,3,7,-4,17,1
173870,1,6,7,-1,10,1
318823,1,7,6,1,5,1
25979,2,10,9,1,13,1
926,2,0,0,0,1,0
300475,2,16,0,16,14,1
167859,2,7,16,-9,7,1
76750,1,10,0,10,1,1
62664,4,24,20,4,12,0
170021,4,28,17,11,8,1
55630,1,7,0,7,9,0
314280,1,0,6,-6,3,0
329569,1,0,0,0,11,1
353602,4,38,0,38,4,1
293655,2,10,7,3,12,1
202549,2,7,6,1,5,0
112080,2,7,13,-6,17,0
226189,4,37,35,2,16,1
198265,1,3,7,-4,3,1
89145,4,23,6,17,6,0
269214,2,3,6,-3,17,1
243443,3,3,17,-14,6,1
348229,3,9,17,-8,1,1
53560,3,14,12,2,8,1
137876,3,17,6,11,11,0
79913,3,3,16,-13,2,1
182409,1,0,0,0,14,1
257293,1,0,0,0,13,0
277802,1,0,7,-7,4,1
367946,1,3,7,-4,11,1
83985,2,17,0,17,4,0
415081,1,0,0,0,15,1
312242,3,7,17,-10,2,1
384196,4,29,20,9,1,1
270462,4,10,7,3,1,1
316062,1,3,3,0,4,1
10190,2,6,3,3,5,0
282290,4,25,17,8,6,1
96877,2,10,7,3,10,1
353119,3,10,29,-19,3,1
314963,4,0,13,-13,4,0
133739,2,0,0,0,9,0
70735,2,7,10,-3,15,0
249833,2,6,10,-4,9,0
163877,2,6,10,-4,5,1
362358,3,16,14,2,8,1
252601,2,3,0,3,10,0
315666,3,10,7,3,4,0
309023,3,0,20,-20,1,1
102711,1,0,0,0,13,1
195865,4,27,21,6,2,0
125347,4,24,3,21,5,1
63229,4,17,26,-9,12,1
4051,2,10,14,-4,2,1
260281,4,24,3,21,14,1
271648,4,23,37,-14,2,1
239651,1,0,0,0,4,0
175118,2,21,10,11,10,1
252208,4,23,24,-1,10,0
124337,4,41,27,14,5,1
361899,2,0,0,0,7,1
111219,2,7,3,4,16,1
215076,3,16,7,9,11,0
185598,3,13,20,-7,15,0
102629,3,15,6,9,13,0
298296,4,20,13,7,14,1
67433,1,7,7,0,14,1
154579,2,14,7,7,1,0
320818,1,0,4,-4,6,1
122455,3,13,26,-13,4,1
149570,3,14,16,-2,16,0
20266,1,7,0,7,10,0
203781,2,17,10,7,6,1
138030,2,22,17,5,11,0
77165,1,0,0,0,1,0
84135,2,7,0,7,4,1
326361,3,17,10,7,9,1
301089,4,33,13,20,15,0
41662,3,24,7,17,2,0
144856,2,14,0,14,14,1
302960,2,20,13,7,16,1
64159,2,21,6,15,13,1
234685,3,30,20,10,2,0
67673,4,7,35,-28,14,0
75561,2,7,0,7,17,0
248617,2,14,3,11,9,0
252684,4,6,10,-4,10,0
92065,1,3,7,-4,8,1
42814,3,6,28,-22,3,1
123683,4,10,25,-15,4,1
340622,2,6,3,3,15,1
38296,4,19,14,5,1,0
133257,1,0,0,0,9,1
87068,1,0,0,0,5,0
89384,2,10,13,-3,7,0
171097,4,24,43,-19,8,1
205229,4,23,13,10,6,1
373757,4,19,21,-2,13,0
168578,2,13,10,3,7,1
169320,1,0,7,-7,8,1
49426,5,20,20,0,6,0
144516,1,0,7,-7,14,1
107059,2,24,0,24,15,0
137693,2,0,13,-13,11,0
347313,3,7,21,-14,1,1
48809,1,0,0,0,5,1
207632,4,42,10,32,7,1
65832,1,0,0,0,13,0
326032,2,9,0,9,9,0
298224,2,20,3,17,14,0
34780,4,20,3,17,16,1
236417,4,17,23,-6,3,0
284200,3,9,23,-14,7,0
254931,3,31,7,24,12,1
105288,4,10,26,-16,14,1
16500,2,13,7,6,8,0
149916,4,6,23,-17,16,0
109703,2,3,0,3,16,1
346251,3,40,0,40,1,0
63600,2,13,20,-7,12,0
324314,4,25,7,18,8,0
7768,3,30,3,27,4,1
325414,1,6,0,6,8,1
261806,2,3,7,-4,14,0
199219,2,10,14,-4,4,1
140518,4,21,29,-8,12,1
66165,1,16,0,16,13,1
381000,4,9,14,-5,16,0
320938,1,0,0,0,6,0
99177,2,3,3,0,11,1
300056,3,0,40,-40,14,1
367648,1,0,3,-3,10,0
149671,2,17,0,17,16,1
204546,1,0,21,-21,6,1
53459,4,10,35,-25,8,1
377094,2,10,7,3,15,0
46837,1,7,0,7,5,0
101292,4,17,14,3,12,0
130151,2,0,16,-16,8,1
416007,2,7,0,7,15,1
83458,4,10,23,-13,4,0
27043,3,10,3,7,13,1
255113,4,14,31,-17,12,0
290204,2,10,0,10,10,1
344643,2,3,10,-7,17,1
59263,4,28,58,-30,10,1
41312,2,7,9,-2,2,1
408818,4,13,28,-15,12,0
174341,2,17,0,17,10,1
145903,2,6,0,6,15,1
399409,4,37,10,27,7,0
48230,1,0,9,-9,5,0
290688,3,35,22,13,10,1
361832,4,37,10,27,7,1
320946,1,0,0,0,6,0
147090,2,7,24,-17,15,0
210578,2,6,14,-8,9,1
383903,4,3,10,-7,1,0
266372,3,30,0,30,16,0
336011,3,13,18,-5,13,0
320470,4,17,17,0,6,1
250430,1,0,0,0,9,1
393205,2,7,6,1,5,1
302222,3,28,13,15,15,1
412873,4,38,35,3,14,0
241772,4,7,15,-8,5,1
173828,4,20,3,17,10,1
410766,3,22,6,16,13,1
242670,4,13,10,3,6,1
310571,1,3,13,-10,2,0
117142,1,6,3,3,2,1
217667,4,26,23,3,12,1
79274,2,12,3,9,2,1
315795,2,0,6,-6,4,0
159086,3,17,0,17,3,1
157835,1,6,9,-3,3,0
199417,4,16,10,6,4,1
58729,2,10,17,-7,10,1
367804,2,3,7,-4,10,1
211408,4,10,13,-3,9,1
53051,1,10,0,10,7,0
185164,4,0,23,-23,15,0
373634,1,0,9,-9,13,1
366758,4,27,10,17,10,0
137125,4,24,6,18,11,1
369448,3,38,7,31,11,0
60259,4,10,16,-6,11,0
66127,4,10,13,-3,13,1
412521,4,24,14,10,14,1
105676,2,20,3,17,14,1
179120,3,9,13,-4,12,1
210662,4,20,24,-4,9,0
220231,2,17,6,11,13,0
45619,3,10,13,-3,4,1
409827,2,10,0,10,12,1
78133,2,14,3,11,2,1
195481,1,0,0,0,2,0
286445,3,17,3,14,8,0
131456,4,20,22,-2,8,1
47496,2,10,3,7,5,1
217273,2,0,7,-7,12,0
89286,4,15,0,15,7,0
394612,3,17,0,17,5,0
187963,2,6,14,-8,16,1
327827,2,10,10,0,10,0
413309,4,20,0,20,14,0
262068,1,0,0,0,15,1
328222,4,14,17,-3,10,1
201810,3,13,10,3,5,0
319718,4,33,9,24,6,0
242922,3,21,16,5,6,0
241969,1,7,0,7,5,0
109899,4,23,0,23,16,1
165911,1,0,0,0,6,0
264593,3,10,17,-7,16,0
311285,4,9,3,6,2,0
162476,2,7,3,4,4,0
199443,4,19,17,2,4,1
350902,3,3,14,-11,3,0
207811,1,0,0,0,8,1
403315,2,6,0,6,9,1
4442,1,0,0,0,2,0
1373,2,7,0,7,1,0
95230,1,3,7,-4,10,1
127885,1,10,0,10,6,1
218725,2,0,10,-10,13,1
396771,4,7,20,-13,6,0
322266,4,0,27,-27,7,1
343519,3,10,10,0,16,0
64533,1,0,0,0,13,1
275534,4,32,36,-4,3,1
281567,1,0,0,0,6,1
178070,4,20,23,-3,12,1
31399,4,7,10,-3,15,1
195539,3,6,0,6,2,0
121211,3,21,20,1,3,0
307225,4,3,10,-7,17,1
21054,4,28,34,-6,10,1
215495,3,10,3,7,11,1
84232,1,0,0,0,4,0
153389,2,9,10,-1,1,1
215462,2,7,3,4,11,1
392630,2,7,0,7,4,1
274512,2,14,6,8,3,0
81590,4,17,24,-7,3,1
242553,1,0,0,0,6,1
314806,3,27,7,20,4,1
79642,4,24,14,10,2,0
30737,3,24,21,3,15,0
80814,3,3,0,3,3,1
240630,3,20,14,6,5,0
118555,3,17,3,14,2,0
332202,3,10,16,-6,12,0
69951,1,14,0,14,15,1
130933,2,7,20,-13,8,0
210118,1,0,0,0,9,0
128457,1,14,0,14,7,0
396465,4,28,25,3,6,0
301909,2,8,13,-5,15,1
273115,1,0,0,0,2,0
398407,4,9,30,-21,7,1
287779,2,21,10,11,9,1
193674,1,3,20,-17,1,1
192215,4,3,33,-30,1,1
105792,1,3,3,0,14,1
269267,4,10,19,-9,17,0
46429,1,0,0,0,4,0
136336,4,18,7,11,11,0
297864,4,21,19,2,13,1
103776,1,3,0,3,13,1
137434,4,6,21,-15,11,0
86778,4,30,21,9,5,0
368888,3,31,3,28,11,1
125241,4,31,21,10,5,1
334080,1,0,0,0,13,1
340100,4,20,15,5,15,0
270650,1,0,0,0,1,1
406341,2,7,7,0,11,1
362693,4,3,10,-7,8,0
402804,4,30,20,10,9,0
385658,4,16,24,-8,1,1
60868,4,17,23,-6,11,0
54216,3,0,3,-3,8,0
82927,2,3,9,-6,4,1
96401,1,0,6,-6,10,0
43215,3,14,10,4,3,1
84807,4,13,31,-18,4,1
222679,3,14,24,-10,14,1
55628,1,7,0,7,9,0
93407,2,3,7,-4,9,1
320564,2,24,0,24,6,0
212288,2,7,3,4,10,0
275718,1,0,0,0,3,1
387253,2,6,7,-1,2,1
230432,3,20,3,17,1,1
403035,3,21,21,0,9,0
18672,1,0,0,0,9,0
318921,4,24,28,-4,5,1
275346,4,10,19,-9,3,1
374672,1,0,6,-6,14,1
100768,2,6,3,3,12,0
107368,4,19,6,13,15,0
399285,1,0,0,0,7,1
249556,3,14,10,4,9,1
178269,1,0,0,0,12,1
294163,1,0,7,-7,12,0
19665,1,0,0,0,10,0
13804,4,7,30,-23,7,1
201080,4,41,10,31,5,1
380195,2,7,9,-2,16,1
181489,4,31,31,0,13,1
16778,2,3,14,-11,8,0
41448,2,2,7,-5,2,1
269598,1,0,0,0,1,0
413251,2,10,0,10,14,0
306151,2,7,0,7,17,1
404813,3,20,20,0,10,0
152919,2,14,14,0,1,0
268670,4,27,20,7,17,0
361406,4,17,14,3,7,0
10534,3,34,0,34,5,0
159300,4,27,24,3,3,0
347665,3,17,17,0,1,1
131232,2,14,17,-3,8,1
193354,1,7,7,0,1,0
123967,3,10,6,4,5,0
30730,3,17,21,-4,15,1
53221,2,3,0,3,8,1
356450,1,0,3,-3,5,0
187005,4,16,15,1,15,0
284680,4,14,27,-13,7,1
80574,4,16,10,6,3,0
118628,1,7,0,7,2,0
247959,1,0,0,0,8,0
269203,2,3,3,0,17,1
199491,1,7,0,7,4,1
136735,2,13,10,3,11,0
300186,3,21,3,18,14,1
278,4,12,27,-15,1,1
383588,4,24,21,3,17,0
118429,3,20,10,10,2,1
263552,4,20,29,-9,15,0
305676,2,3,7,-4,17,0
303472,3,22,10,12,16,1
14738,2,21,0,21,7,1
125854,1,3,3,0,6,1
304661,3,14,7,7,16,1
375220,4,17,24,-7,14,1
17205,2,7,27,-20,9,0
356352,3,24,8,16,5,1
271961,4,23,27,-4,2,1
266179,2,14,0,14,16,1
130048,3,10,27,-17,8,0
65261,1,0,7,-7,13,0
279429,4,16,24,-8,5,1
303722,2,14,10,4,16,0
174823,2,13,17,-4,10,0
171865,1,0,0,0,9,0
142880,1,0,0,0,13,0
168142,2,16,5,11,7,0
5665,3,0,14,-14,3,0
193715,3,3,27,-24,1,1
53132,3,19,38,-19,7,0
53006,4,27,24,3,7,0
242574,2,3,0,3,6,1
166532,1,0,0,0,6,0
353980,5,34,34,0,4,1
287985,4,20,16,4,9,1
390467,4,21,33,-12,3,1
154219,4,10,23,-13,1,1
22963,1,0,0,0,11,0
62477,4,13,13,0,12,0
153288,3,2,7,-5,1,0
389906,2,12,3,9,3,0
286005,4,29,20,9,8,1
207488,4,21,14,7,7,0
172251,3,14,13,1,9,1
26586,2,10,6,4,13,0
369674,1,13,7,6,11,1
322785,3,3,20,-17,7,1
230849,2,0,7,-7,1,1
142612,2,13,3,10,13,0
29374,1,0,0,0,14,0
265085,3,13,3,10,16,0
315364,2,13,10,3,4,0
122824,2,10,3,7,4,0
295338,1,3,0,3,12,1
323661,2,20,0,20,8,1
314139,1,0,7,-7,3,1
15638,3,21,10,11,8,0
214192,4,19,9,10,11,1
220643,1,7,0,7,13,0
23200,3,23,13,10,11,1
139469,4,27,10,17,12,1
310932,3,3,9,-6,2,1
321342,4,22,19,3,6,0
306406,1,0,10,-10,17,0
71694,1,3,0,3,16,0
364165,4,31,3,28,9,1
254536,1,0,0,0,11,0
298153,4,10,41,-31,13,0
241836,2,10,3,7,5,1
162927,1,3,0,3,5,0
190461,1,0,0,0,17,1
302422,1,0,0,0,15,0
187395,3,27,7,20,16,1
42915,2,7,13,-6,3,1
353379,2,6,0,6,4,1
139042,1,0,0,0,12,1
76325,2,13,3,10,1,0
122420,2,6,20,-14,4,0
100699,4,21,24,-3,12,0
5700,4,0,24,-24,3,0
364255,2,0,26,-26,9,1
215542,4,13,3,10,11,0
110201,4,23,33,-10,16,1
106068,1,0,0,0,14,1
8941,3,28,7,21,4,1
302645,2,17,6,11,15,1
115448,4,39,14,25,1,1
310925,3,3,6,-3,2,0
111561,4,35,10,25,16,0
263403,1,0,0,0,15,0
305966,1,0,0,0,17,1
25371,2,6,0,6,12,1
337405,4,21,14,7,14,1
206516,1,0,0,0,7,0
112126,3,7,20,-13,17,0
46918,3,20,20,0,5,0
190358,2,7,0,7,17,1
239620,4,20,17,3,4,0
418636,4,21,31,-10,16,0
349401,1,0,7,-7,2,1
17116,3,23,10,13,9,0
153658,1,2,0,2,1,0
259608,3,3,3,0,13,0
8115,4,27,20,7,4,0
285018,1,0,0,0,7,1
413679,2,7,13,-6,14,1
148318,3,14,3,11,16,0
290260,4,17,3,14,10,0
407443,3,14,10,4,11,0
332653,4,27,20,7,12,0
381066,2,14,6,8,16,0
109317,4,13,3,10,15,1
420753,2,0,3,-3,17,1
232289,1,3,0,3,1,0
344409,3,28,21,7,17,0
300204,4,28,3,25,14,0
376158,1,0,0,0,14,1
298120,3,3,31,-28,13,0
230590,3,13,17,-4,1,1
36577,1,0,0,0,17,1
148667,4,10,9,1,16,0
301479,3,20,9,11,15,0
44622,4,20,21,-1,3,0
295874,2,7,14,-7,12,1
168955,1,0,0,0,7,0
399293,1,14,0,14,7,0
145784,3,13,10,3,15,1
417645,2,21,3,18,16,1
306807,4,19,36,-17,17,1
21561,2,7,10,-3,11,0
48923,4,15,13,2,5,1
310204,4,24,10,14,2,1
157877,2,6,12,-6,3,0
175163,3,35,17,18,10,0
218430,2,10,14,-4,13,1
362534,3,23,12,11,8,0
201284,2,14,0,14,5,0
380562,4,21,24,-3,16,0
247989,2,14,3,11,8,0
269707,4,10,21,-11,1,1
400628,1,0,0,0,8,1
164785,3,26,14,12,6,0
140950,4,23,13,10,13,0
275164,3,14,16,-2,3,1
92478,4,23,10,13,8,0
123513,3,7,3,4,4,1
302016,1,7,0,7,15,0
4054,2,10,14,-4,2,1
171488,3,14,10,4,9,1
232887,1,0,0,0,2,0
244229,3,16,7,9,6,1
142491,3,27,10,17,13,0
387080,2,7,20,-13,2,0
62132,2,7,7,0,12,0
8453,2,9,0,9,4,1
50907,3,17,24,-7,6,0
241269,3,3,0,3,5,0
346700,3,24,6,18,1,1
118906,4,27,21,6,2,1
179067,2,3,6,-3,12,0
121345,2,7,0,7,3,0
390505,2,7,0,7,3,1
221179,4,0,23,-23,14,1
335484,4,13,12,1,13,1
254269,2,6,9,-3,11,1
92848,2,21,0,21,8,1
231265,1,0,3,-3,1,0
187058,2,10,0,10,16,0
339190,4,30,13,17,15,1
306676,1,0,0,0,17,1
92707,2,3,10,-7,8,0
358697,2,7,7,0,6,1
348999,3,14,7,7,2,1
91041,3,6,0,6,7,1
315085,3,37,14,23,4,0
308538,2,6,9,-3,1,0
103690,3,0,10,-10,13,1
102490,3,24,3,21,13,0
265505,3,7,7,0,16,0
66224,3,31,3,28,13,0
256259,2,6,10,-4,12,1
2824,2,21,24,-3,2,1
210450,3,9,14,-5,9,1
245972,1,0,0,0,7,1
136173,4,13,10,3,10,0
417028,2,3,0,3,15,1
121141,1,0,10,-10,3,0
184799,2,17,17,0,15,0
356314,2,17,0,17,5,1
322194,2,0,20,-20,7,0
294537,3,17,13,4,12,1
398541,4,28,16,12,7,0
317488,2,10,10,0,5,0
129950,4,13,0,13,7,0
146947,1,14,0,14,15,0
292846,1,0,0,0,11,1
28371,2,6,0,6,14,0
43249,4,24,10,14,3,1
236701,3,24,7,17,3,0
53899,3,7,13,-6,8,1
3624,3,20,21,-1,2,0
297004,4,32,14,18,13,0
24591,4,10,26,-16,12,1
395680,3,10,27,-17,6,0
127714,1,0,7,-7,6,1
105886,4,19,10,9,14,0
205695,3,20,19,1,7,1
116901,3,7,10,-3,2,1
256017,4,19,12,7,12,1
104026,4,13,13,0,13,0
291689,2,0,3,-3,11,0
231245,1,0,0,0,1,0
225822,4,24,14,10,16,0
53883,2,7,7,0,8,0
228531,3,20,7,13,17,1
372420,2,6,7,-1,13,1
78206,4,48,3,45,2,0
71424,2,17,0,17,16,1
416590,1,7,0,7,15,0
165596,1,0,0,0,6,1
171645,3,19,17,2,9,1
285801,3,7,24,-17,8,1
248941,3,20,3,17,9,0
207658,4,42,10,32,7,0
207346,4,13,21,-8,7,0
281755,1,0,0,0,6,0
388729,1,8,0,8,3,1
266317,2,6,0,6,16,1
77211,2,6,0,6,1,1
86864,3,9,23,-14,5,0
320206,1,7,0,7,6,0
123102,5,21,21,0,4,1
63029,3,16,21,-5,12,1
343059,3,9,13,-4,16,1
70605,3,10,10,0,15,1
284806,3,26,20,6,7,1
16565,4,30,13,17,8,0
140171,4,10,3,7,12,1
317307,1,0,0,0,5,1
118517,2,17,0,17,2,0
325893,2,3,0,3,9,1
165823,2,3,9,-6,6,1
69911,4,27,16,11,15,0
3781,3,20,10,10,2,1
367779,1,0,0,0,10,1
316947,3,30,18,12,4,1
234535,4,20,20,0,2,0
52537,3,16,0,16,7,0
66772,3,10,6,4,14,1
114123,4,21,14,7,17,1
177289,4,14,20,-6,11,1
247982,2,7,3,4,8,1
264045,1,7,14,-7,15,1
353114,2,10,28,-18,3,0
274941,4,17,16,1,3,0
259681,1,0,0,0,14,1
150742,3,13,9,4,17,0
392756,1,7,3,4,4,0
80378,3,27,9,18,2,0
385310,3,14,20,-6,1,1
253827,1,7,7,0,11,1
130439,1,0,0,0,8,1
91681,4,21,21,0,8,1
364240,2,0,13,-13,9,0
75684,1,7,0,7,1,0
209811,1,7,7,0,8,0
396300,4,6,6,0,6,0
82815,4,12,16,-4,3,0
67541,1,0,0,0,14,0
60727,4,28,3,25,11,1
71788,4,38,33,5,16,1
340545,4,7,40,-33,15,0
8297,1,0,0,0,4,0
292679,4,22,16,6,11,0
359113,1,7,0,7,6,0
408410,1,0,0,0,12,0
271500,4,21,0,21,1,1
369285,3,14,14,0,11,0
32727,4,7,21,-14,15,0
370482,3,20,9,11,12,0
228919,1,7,9,-2,17,1
110339,3,17,17,0,16,0
145449,2,9,14,-5,14,0
235227,2,12,3,9,3,1
290891,1,0,0,0,10,1
60430,4,23,17,6,11,1
195989,4,7,27,-20,2,0
362449,1,0,3,-3,8,0
155782,1,0,0,0,2,1
368483,1,0,0,0,11,1
215835,4,51,19,32,11,0
382923,2,0,7,-7,17,0
279116,3,21,17,4,5,0
163662,4,21,36,-15,5,1
374114,2,13,7,6,13,1
167525,3,0,10,-10,7,1
203006,2,14,0,14,5,0
134631,3,24,17,7,10,1
244642,2,0,10,-10,7,0
342528,1,0,6,-6,16,1
70807,4,30,27,3,15,0
308779,4,18,20,-2,1,0
96548,1,0,0,0,10,1
297459,1,0,0,0,13,1
196820,2,0,10,-10,3,0
116412,2,3,3,0,1,0
381223,2,14,10,4,16,1
144241,2,9,7,2,14,1
116550,1,0,0,0,2,1
278899,1,6,7,-1,5,1
46306,2,3,14,-11,4,0
234548,4,20,20,0,2,0
223527,3,7,10,-3,15,1
92601,4,17,3,14,8,1
313388,1,7,0,7,3,1
259428,2,6,3,3,13,0
172198,2,0,6,-6,9,0
237040,1,0,14,-14,3,0
146806,2,10,0,10,15,0
350838,1,0,0,0,3,0
165346,1,0,7,-7,6,1
88883,1,7,0,7,6,1
70859,2,7,10,-3,15,1
222947,3,13,13,0,14,0
360099,4,10,43,-33,7,1
374903,4,14,18,-4,14,0
59492,3,6,20,-14,11,1
322190,2,0,20,-20,7,0
146559,3,14,24,-10,15,0
367655,1,0,3,-3,10,0
234674,3,23,20,3,2,1
104186,4,27,34,-7,13,1
31285,1,7,3,4,15,1
315106,4,53,14,39,4,0
401212,1,0,0,0,8,0
240490,3,3,7,-4,5,0
348703,3,17,10,7,2,1
36069,2,24,0,24,17,1
401333,4,27,24,3,8,1
376607,4,15,6,9,14,0
94111,1,0,0,0,9,1
355927,4,34,17,17,5,1
40048,3,20,7,13,1,1
324970,1,12,14,-2,8,1
337964,4,20,0,20,14,1
237994,2,10,10,0,4,0
420228,4,3,13,-10,17,1
120278,3,17,12,5,3,0
220380,2,13,7,6,13,1
96656,4,3,10,-7,10,0
260228,3,10,3,7,14,0
82675,4,12,13,-1,3,0
313170,3,13,13,0,3,0
398707,1,0,7,-7,7,0
41778,2,7,14,-7,2,1
105123,4,26,14,12,14,1
118921,1,0,7,-7,3,1
183818,2,17,21,-4,14,1
24284,4,13,17,-4,12,0
113611,3,6,3,3,17,0
328271,1,3,7,-4,10,1
214330,4,21,13,8,11,1
303670,4,38,19,19,16,0
334791,1,0,0,0,13,1
242851,1,7,3,4,6,1
92413,2,17,7,10,8,0
216846,2,7,14,-7,12,1
222083,4,27,17,10,14,1
307777,2,17,7,10,1,1
378607,3,20,13,7,15,0
419300,2,0,10,-10,16,0
273593,2,3,3,0,2,1
238048,4,13,13,0,4,0
364810,1,3,0,3,9,0
220983,3,14,10,4,14,1
336659,1,0,0,0,14,0
248300,2,17,7,10,8,1
98487,4,31,21,10,11,1
330921,4,31,31,0,11,0
289038,3,32,21,11,9,0
344551,3,0,0,0,17,1
363831,3,13,17,-4,8,1
213691,3,14,17,-3,10,1
19376,1,0,0,0,10,1
289316,2,21,17,4,9,1
175611,4,36,14,22,11,0
403005,2,7,21,-14,9,1
34703,2,3,3,0,16,0
282477,2,7,0,7,6,1
139679,2,0,0,0,12,0
342666,1,0,0,0,16,0
380584,4,21,27,-6,16,0
46397,4,6,17,-11,4,1
232247,4,15,12,3,1,1
94959,2,3,6,-3,9,1
244599,4,32,30,2,7,0
161417,2,7,3,4,4,0
25748,4,14,17,-3,12,1
31725,1,0,0,0,15,0
142173,4,2,10,-8,13,1
127103,1,3,8,-5,6,0
377308,4,21,14,7,15,0
255768,2,0,0,0,12,1
276707,4,30,20,10,4,0
374064,4,24,10,14,13,1
215151,2,7,3,4,11,0
244814,2,7,3,4,7,1
402029,4,3,19,-16,9,0
261376,2,7,17,-10,14,1
245038,4,14,27,-13,7,0
90938,4,61,7,54,7,0
36538,4,13,20,-7,17,1
100057,2,6,3,3,12,0
266652,2,19,3,16,16,1
287765,2,14,10,4,9,1
262039,4,24,31,-7,14,1
348209,2,6,10,-4,1,1
368167,3,13,21,-8,11,1
42787,2,6,21,-15,3,1
262627,3,26,10,16,15,0
5032,1,0,0,0,3,1
299272,2,23,0,23,14,0
334712,3,18,3,15,13,0
208347,3,17,24,-7,8,0
142458,3,7,10,-3,13,1
108641,1,13,0,13,15,0
173488,3,3,17,-14,10,1
234694,4,30,23,7,2,1
153140,3,20,17,3,1,0
328279,1,3,7,-4,10,0
357178,4,12,20,-8,5,0
351662,2,7,10,-3,3,1
241810,1,3,3,0,5,1
217030,3,20,3,17,12,1
313967,1,0,0,0,3,0
204729,2,14,14,0,6,0
131185,1,0,0,0,8,0
81254,3,10,7,3,3,1
120844,2,7,14,-7,3,1
70756,3,20,17,3,15,0
65670,1,0,0,0,13,0
63824,4,14,34,-20,12,0
106736,2,14,12,2,14,0
287582,1,0,3,-3,9,0
274122,4,20,0,20,3,0
29233,1,14,0,14,14,0
250471,2,13,7,6,9,1
289238,4,30,20,10,9,1
4833,4,34,3,31,3,1
365348,4,17,19,-2,9,0
179121,3,9,13,-4,12,1
132571,3,5,29,-24,9,0
257951,2,0,7,-7,13,0
179147,4,12,13,-1,12,0
25476,4,13,17,-4,12,1
222068,3,20,10,10,14,1
119578,2,10,0,10,3,0
291194,4,30,29,1,10,0
416056,3,21,3,18,15,0
270204,1,3,7,-4,1,1
34683,1,3,3,0,16,0
387071,2,7,14,-7,2,1
219840,3,38,0,38,13,0
180416,1,7,0,7,13,0
119234,1,7,3,4,3,1
114275,4,17,24,-7,1,0
50868,2,7,17,-10,6,1
138757,1,0,0,0,12,1
414558,3,21,9,12,14,1
156775,2,14,7,7,2,1
350566,1,10,0,10,2,0
98564,2,0,7,-7,11,1
204742,2,14,14,0,6,1
269239,3,3,13,-10,17,1
178844,4,27,14,13,12,1
327297,4,16,20,-4,9,0
58146,4,20,17,3,10,1
413353,1,0,0,0,14,1
165180,1,0,0,0,6,0
187500,2,3,10,-7,16,1
227160,3,10,7,3,16,1
329363,3,9,27,-18,10,1
310468,3,17,3,14,2,0
168783,4,16,15,1,7,0
170695,2,13,6,7,8,1
359004,2,10,0,10,6,1
253130,4,21,14,7,11,0
17371,3,17,0,17,9,0
75639,4,10,6,4,17,1
227180,3,13,7,6,16,0
416822,4,19,10,9,15,0
226135,3,14,17,-3,16,0
324126,3,0,10,-10,8,1
267778,1,3,0,3,17,1
399814,4,11,24,-13,8,0
111413,3,0,17,-17,16,0
301067,3,24,10,14,15,0
154616,3,21,14,7,1,1
228890,1,0,0,0,17,0
9575,1,0,0,0,5,1
70732,2,7,10,-3,15,0
96915,3,22,7,15,10,0
371017,2,7,7,0,12,0
53098,2,19,21,-2,7,1
190598,4,20,20,0,17,1
345276,3,13,14,-1,17,0
31054,3,10,13,-3,15,1
191726,3,16,17,-1,17,1
407700,2,0,0,0,11,1
341793,2,3,3,0,16,0
64916,4,10,6,4,13,0
85908,1,7,13,-6,5,0
51121,1,7,0,7,7,0
109804,1,3,0,3,16,1
23155,2,13,0,13,11,1
278750,1,0,0,0,5,0
369887,3,7,9,-2,12,1
47392,4,10,13,-3,5,1
196822,2,0,10,-10,3,1
48389,2,3,17,-14,5,1
229853,2,13,0,13,17,0
401155,4,44,13,31,8,0
245226,1,3,0,3,7,0
361281,4,21,32,-11,7,1
55724,4,23,21,2,9,1
358262,2,0,14,-14,6,0
3347,4,3,6,-3,2,0
261893,4,6,27,-21,14,1
332840,1,0,0,0,12,1
104103,2,17,13,4,13,0
399855,1,0,0,0,8,0
417145,1,0,10,-10,16,1
67656,4,7,35,-28,14,0
230906,3,21,10,11,1,1
199759,1,0,0,0,4,1
389136,4,30,14,16,3,1
40964,4,16,27,-11,2,0
335757,4,10,7,3,13,1
330423,4,13,20,-7,11,1
288276,4,10,35,-25,9,0
151227,3,17,23,-6,17,1
85726,4,24,28,-4,5,0
341722,4,26,13,13,16,1
35026,2,9,3,6,16,0
209951,1,0,0,0,8,0
210172,3,0,14,-14,9,1
150614,3,3,16,-13,17,0
21081,1,0,0,0,10,1
136565,2,3,13,-10,11,1
27444,1,3,0,3,13,1
196730,3,53,0,53,3,1
141381,3,10,17,-7,13,1
406552,3,14,30,-16,11,1
146807,2,10,0,10,15,0
186487,3,17,13,4,15,0
293746,1,7,0,7,12,0
385607,3,6,17,-11,1,0
351223,3,28,10,18,3,0
408006,2,3,0,3,12,0
368528,2,6,0,6,11,1
300265,1,0,7,-7,14,1
76260,4,12,27,-15,1,1
52130,4,23,19,4,7,0
294660,2,3,7,-4,12,0
346529,3,24,33,-9,1,1
269642,2,3,0,3,1,1
414807,1,7,0,7,15,0
259142,2,14,7,7,13,0
240985,4,21,22,-1,5,0
377238,2,7,3,4,15,0
148595,2,0,6,-6,16,0
369691,2,16,10,6,11,1
177363,1,10,0,10,11,0
317569,4,24,27,-3,5,0
245941,4,13,37,-24,7,1
332440,2,13,3,10,12,0
158340,2,13,14,-1,3,0
257826,2,7,3,4,13,0
304374,3,28,14,14,16,0
316833,4,16,10,6,4,0
55532,2,10,0,10,9,0
188942,4,26,13,13,16,1
75540,1,7,0,7,17,0
153224,1,2,0,2,1,0
10509,3,20,0,20,5,0
366909,4,3,16,-13,10,1
15306,1,0,0,0,8,1
168628,4,17,16,1,7,1
421366,2,6,10,-4,17,1
251645,1,3,3,0,10,1
268665,4,20,20,0,17,0
369205,4,22,20,2,11,0
332544,1,0,3,-3,12,1
21688,2,10,7,3,11,0
398379,3,3,27,-24,7,1
109349,1,0,7,-7,16,1
279142,4,21,20,1,5,0
72402,4,17,23,-6,16,1
261537,3,12,0,12,14,0
144202,1,0,7,-7,14,1
174967,2,6,14,-8,10,0
295818,1,0,0,0,12,0
340346,3,17,10,7,15,0
357830,2,6,21,-15,6,1
118781,1,10,0,10,2,1
4879,2,14,0,14,3,1
421198,1,3,0,3,17,1
122995,2,0,3,-3,4,0
295983,1,0,0,0,13,1
38243,3,13,14,-1,1,1
355535,1,7,0,7,5,1
67635,3,7,35,-28,14,0
53668,2,0,0,0,8,1
382031,4,7,33,-26,17,1
267894,4,26,24,2,17,1
62071,4,26,10,16,12,1
173220,4,20,24,-4,9,1
351900,1,0,0,0,3,0
66895,2,6,7,-1,14,1
29792,4,48,3,45,14,1
68701,3,24,0,24,15,1
104437,1,0,7,-7,13,0
33236,2,10,0,10,16,0
155405,3,13,3,10,2,0
76901,2,0,10,-10,1,0
295861,2,7,14,-7,12,0
338167,1,7,7,0,14,0
344935,2,3,7,-4,17,1
12222,2,0,0,0,6,0
76238,4,12,27,-15,1,1
120316,4,24,13,11,3,0
157370,1,3,0,3,2,1
351069,3,21,16,5,3,0
17861,3,24,17,7,9,0
7191,1,0,0,0,4,0
75923,3,32,7,25,1,1
347002,3,7,3,4,1,1
107098,4,40,6,34,15,1
362156,1,0,0,0,8,1
374319,4,22,13,9,13,0
56780,4,14,13,1,9,0
407538,2,10,0,10,11,0
201201,4,20,24,-4,5,1
266501,3,3,15,-12,16,1
317765,1,0,0,0,5,0
69522,1,0,0,0,15,0
395965,2,24,10,14,6,0
339168,4,23,13,10,15,0
37129,4,16,20,-4,17,1
336473,4,16,17,-1,14,1
137333,1,3,0,3,11,0
133143,2,10,10,0,9,0
265004,1,0,0,0,16,1
331048,4,45,17,28,11,1
181301,4,3,20,-17,13,0
337190,2,9,10,-1,14,0
160197,3,30,7,23,3,1
87066,1,0,0,0,5,0
318412,2,21,7,14,5,0
262372,1,0,0,0,15,0
343070,3,12,13,-1,16,0
305357,1,7,3,4,17,1
107075,3,33,0,33,15,1
163799,4,17,12,5,5,0
274637,1,6,0,6,3,1
44649,4,23,24,-1,3,0
41576,1,0,0,0,2,0
395024,2,0,14,-14,5,0
288429,4,19,0,19,9,0
233495,4,26,10,16,2,0
397619,3,6,20,-14,7,1
174930,2,3,7,-4,10,0
378876,2,10,13,-3,15,1
385496,4,35,17,18,1,0
265183,1,6,3,3,16,0
292988,1,0,0,0,11,0
143210,2,10,10,0,13,1
247611,4,19,23,-4,8,1
122503,4,20,36,-16,4,1
198723,1,0,0,0,3,0
200690,1,6,0,6,4,1
116862,2,7,7,0,2,0
268432,2,14,3,11,17,0
367808,2,10,7,3,10,0
415804,4,27,30,-3,15,0
358715,2,7,14,-7,6,1
397833,1,0,0,0,7,0
322695,5,9,9,0,7,0
106730,2,13,12,1,14,1
59177,2,13,35,-22,10,1
246877,1,0,0,0,8,0
204887,2,3,10,-7,6,0
265272,4,9,6,3,16,0
398113,4,24,35,-11,7,1
152074,3,6,7,-1,17,1
190059,2,17,3,14,17,1
3067,1,0,0,0,2,0
108686,2,27,13,14,15,1
113714,2,3,10,-7,17,1
12702,2,38,0,38,6,1
30634,4,17,9,8,14,1
69005,3,21,17,4,15,0
100245,4,17,14,3,12,1
416636,3,31,7,24,15,1
280218,1,0,0,0,5,1
389661,3,24,16,8,3,1
126325,2,7,7,0,6,0
389492,2,13,3,10,3,1
304734,1,0,0,0,16,0
108400,3,3,21,-18,15,1
222888,1,0,0,0,14,0
274349,1,3,7,-4,3,0
96673,1,0,0,0,10,1
36714,4,23,10,13,17,0
19256,1,7,7,0,10,1
187535,2,6,13,-7,16,0
40246,1,0,0,0,2,0
302135,4,34,41,-7,15,0
420407,1,0,0,0,17,0
258180,4,13,13,0,13,0
285244,2,0,6,-6,7,1
137025,1,7,0,7,11,0
330080,2,0,3,-3,11,1
377246,2,7,3,4,15,1
190974,3,12,0,12,17,0
331633,4,23,30,-7,11,1
156261,5,30,23,7,2,1
80716,4,38,33,5,3,1
88403,1,0,0,0,6,0
386489,2,7,0,7,2,0
98825,1,7,0,7,11,0
294778,1,7,7,0,12,0
230216,1,0,0,0,17,1
153564,3,12,14,-2,1,1
87827,2,10,7,3,6,1
200866,2,14,0,14,4,1
112147,3,10,20,-10,17,0
238176,2,3,16,-13,4,0
93602,3,6,6,0,9,1
420203,4,3,10,-7,17,1
253462,4,14,38,-24,11,1
162283,1,0,0,0,4,1
360354,4,7,20,-13,7,1
51857,1,6,6,0,7,0
210173,3,0,14,-14,9,1
414956,1,7,7,0,15,1
262564,2,7,0,7,15,0
36915,2,0,14,-14,17,1
369595,4,14,6,8,11,1
139113,2,9,6,3,12,1
43792,2,14,13,1,3,1
350176,2,11,0,11,2,0
102806,3,10,3,7,13,1
7360,5,20,19,1,4,0
80406,4,27,16,11,2,1
195065,3,7,23,-16,2,0
167270,4,30,23,7,7,1
58266,3,17,10,7,10,0
179387,2,6,13,-7,12,0
322848,4,10,40,-30,7,1
69753,4,19,10,9,15,1
119765,2,10,6,4,3,1
171941,3,14,7,7,9,0
373657,2,0,12,-12,13,1
179465,4,21,20,1,12,0
75848,1,7,0,7,1,1
43753,1,14,0,14,3,0
231727,2,3,7,-4,1,0
260719,4,19,32,-13,14,1
361118,4,23,16,7,7,0
97647,2,3,3,0,11,0
315501,2,0,3,-3,4,1
352715,3,17,6,11,3,1
391785,4,10,13,-3,4,0
292424,1,3,0,3,11,1
261107,3,7,21,-14,14,1
328281,1,3,7,-4,10,0
86896,4,9,26,-17,5,1
239661,1,0,3,-3,4,1
298018,4,37,7,30,13,1
162761,1,0,0,0,5,1
356007,2,14,10,4,5,1
255687,3,3,10,-7,12,1
137518,2,14,14,0,11,0
107383,4,19,6,13,15,1
340162,2,20,7,13,15,0
251694,2,14,3,11,10,1
183674,3,0,8,-8,14,0
363493,1,0,2,-2,8,1
282942,2,7,0,7,6,0
418041,4,28,35,-7,16,0
139514,1,6,0,6,12,0
371932,4,34,17,17,12,1
58984,1,0,7,-7,10,1
307763,2,10,7,3,1,1
301832,4,6,34,-28,15,1
63404,1,0,0,0,12,0
350592,2,10,0,10,2,1
49125,1,0,0,0,6,0
274934,4,17,16,1,3,1
67116,1,0,0,0,14,1
242049,4,10,9,1,5,0
136876,2,0,7,-7,11,0
40205,4,34,7,27,2,1
8459,2,15,0,15,4,0
178715,4,3,26,-23,12,1
87279,3,17,17,0,6,1
188361,1,0,0,0,16,1
121256,4,21,30,-9,3,1
280281,3,13,16,-3,5,0
133769,2,13,7,6,9,1
285145,4,3,0,3,7,1
54604,1,7,6,1,8,0
140538,4,21,29,-8,12,1
297776,1,7,0,7,13,0
155382,2,13,3,10,2,1
140326,3,17,13,4,12,0
263567,1,0,0,0,15,0
327942,1,0,0,0,10,1
247898,3,10,6,4,8,1
345334,1,0,0,0,17,1
196547,2,17,6,11,2,1
12364,2,7,3,4,6,1
245836,2,3,10,-7,7,0
209325,2,0,7,-7,8,1
248562,1,0,0,0,9,1
406375,2,10,7,3,11,0
202648,4,34,20,14,5,0
103148,1,0,0,0,13,1
246317,2,7,3,4,7,0
34124,3,3,3,0,16,1
75250,2,7,10,-3,17,0
29803,1,3,0,3,14,1
353423,3,18,0,18,4,0
103127,4,34,7,27,13,0
57499,3,21,10,11,10,0
416565,1,0,0,0,15,0
381082,3,17,14,3,16,1
360279,2,0,6,-6,7,0
250037,3,17,13,4,9,0
231504,4,23,20,3,1,1
361928,2,7,3,4,7,1
48078,1,0,0,0,5,1
135602,1,0,0,0,10,1
339571,2,10,7,3,15,1
333049,2,10,12,-2,12,0
200356,4,33,14,19,4,0
340418,4,24,13,11,15,0
126992,3,17,10,7,6,0
116573,2,3,0,3,2,1
198411,1,3,3,0,3,1
184328,1,0,3,-3,14,0
105693,3,28,3,25,14,1
174917,1,0,7,-7,10,1
190210,2,7,0,7,17,0
295163,4,10,21,-11,12,0
277506,1,0,7,-7,4,1
212912,2,7,7,0,10,0
402585,3,10,10,0,9,0
1420,4,16,0,16,1,0
59059,3,3,10,-7,10,0
58698,2,7,7,0,10,0
75061,1,0,0,0,17,0
153458,4,20,17,3,1,0
303739,2,17,10,7,16,0
23742,1,0,0,0,12,0
362995,4,33,16,17,8,0
148904,2,3,9,-6,16,1
314667,4,14,20,-6,3,0
121583,4,22,13,9,4,1
264557,2,10,17,-7,16,1
179363,1,0,6,-6,12,1
390830,2,0,21,-21,3,0
20446,1,0,0,0,10,0
216909,4,13,24,-11,12,1
359907,3,23,27,-4,6,1
98696,2,14,3,11,11,1
416079,4,21,6,15,15,0
420913,1,7,7,0,17,0
301684,4,17,6,11,15,0
357781,1,3,7,-4,6,0
61869,3,20,23,-3,12,0
197994,2,0,20,-20,3,1
207757,3,24,13,11,7,0
217505,4,19,3,16,12,1
185448,4,17,10,7,15,0
383863,4,3,7,-4,1,1
115931,4,20,30,-10,1,1
236280,1,0,3,-3,3,1
406096,3,0,20,-20,11,0
417189,2,3,17,-14,16,0
223343,1,0,3,-3,15,0
126074,3,20,3,17,6,0
177670,2,7,7,0,12,1
160888,1,0,0,0,4,1
167062,3,13,24,-11,7,1
311502,3,17,10,7,2,0
218657,4,10,33,-23,13,1
365720,2,10,3,7,9,0
133912,3,6,6,0,9,0
381703,3,20,17,3,17,0
397375,4,17,24,-7,6,0
203954,2,3,7,-4,6,1
126155,1,0,3,-3,6,1
138065,3,36,17,19,11,0
281949,2,14,14,0,6,0
402867,2,17,3,14,9,0
246916,2,14,7,7,8,1
247485,4,20,19,1,8,1
52764,1,0,13,-13,7,0
402030,4,3,19,-16,9,0
283760,3,11,3,8,7,1
383575,4,21,21,0,17,0
198784,2,3,6,-3,3,0
256138,3,21,16,5,12,1
303659,4,38,13,25,16,0
366386,2,19,0,19,10,1
88360,4,24,7,17,6,0
304504,3,3,14,-11,16,1
338599,4,39,38,1,14,0
352053,1,3,0,3,3,0
120527,1,0,6,-6,3,1
273971,4,7,22,-15,2,1
300533,4,23,17,6,14,0
358347,1,6,0,6,6,0
168398,1,0,3,-3,7,1
114043,2,14,0,14,17,0
344952,2,10,14,-4,17,0
387963,1,3,0,3,2,0
397125,1,3,0,3,6,1
391886,3,13,20,-7,4,1
118409,3,13,10,3,2,0
51949,4,13,16,-3,7,0
43266,4,24,10,14,3,0
381515,2,14,0,14,17,0
301898,2,6,13,-7,15,1
370629,3,14,14,0,12,0
404044,3,10,28,-18,10,1
145819,4,13,26,-13,15,0
162818,2,3,0,3,5,0
107393,4,25,13,12,15,1
414305,4,21,42,-21,14,0
330507,2,7,7,0,11,0
410999,2,7,7,0,13,1
360248,1,0,3,-3,7,0
281761,1,0,0,0,6,1
394358,4,24,17,7,5,1
88098,4,24,3,21,6,0
258571,2,13,0,13,13,0
370716,2,3,7,-4,12,0
377423,3,7,13,-6,15,0
394860,2,0,14,-14,5,1
259607,2,3,3,0,13,1
356010,2,14,10,4,5,1
395972,3,24,10,14,6,0
385871,1,0,0,0,1,1
206112,3,20,6,14,7,0
118845,3,20,7,13,2,0
326146,1,0,7,-7,9,1
245973,1,0,0,0,7,1
300824,4,13,33,-20,15,0
409755,4,13,9,4,12,0
26846,1,10,0,10,13,0
37344,2,14,0,14,17,1
12858,3,13,3,10,6,1
44828,1,0,7,-7,4,0
96609,3,3,3,0,10,0
310123,2,14,0,14,2,0
380893,1,0,0,0,16,0
323285,4,7,24,-17,7,1
67330,2,20,6,14,14,0
350753,3,10,3,7,2,1
421870,4,7,19,-12,17,1
265799,4,20,12,8,16,0
198066,4,3,36,-33,3,0
33164,4,17,42,-25,16,0
170963,4,44,20,24,8,0
119941,2,6,14,-8,3,0
32117,4,24,13,11,15,0
268272,2,10,0,10,17,0
214359,1,0,6,-6,11,0
292964,4,10,7,3,11,1
268443,2,14,9,5,17,1
241689,2,7,3,4,5,1
288422,4,19,0,19,9,0
134239,3,3,23,-20,10,0
102675,4,29,20,9,13,0
211907,4,43,23,20,9,0
122409,2,0,20,-20,4,1
284693,4,17,34,-17,7,1
377608,4,20,12,8,15,1
354800,3,13,20,-7,4,0
109596,3,19,14,5,16,1
284154,2,3,13,-10,7,1
98638,4,14,7,7,11,0
236379,4,7,23,-16,3,1
258551,2,0,0,0,13,0
9324,3,21,7,14,5,1
194896,2,0,10,-10,2,1
207567,2,14,3,11,7,0
96905,3,19,7,12,10,0
112340,1,0,0,0,17,1
61989,2,3,7,-4,12,1
39080,2,6,0,6,1,1
397994,1,0,0,0,7,1
240752,2,7,7,0,5,1
230038,4,6,6,0,17,1
287882,1,0,0,0,9,0
83104,3,6,24,-18,4,1
7446,2,20,6,14,4,0
166053,4,20,31,-11,6,1
315783,2,0,3,-3,4,0
233638,4,23,41,-18,2,1
263566,1,0,0,0,15,0
45102,1,0,0,0,4,0
32229,2,21,14,7,15,0
114205,2,3,0,3,1,0
41694,4,31,14,17,2,0
102009,2,7,3,4,12,0
231536,5,30,29,1,1,1
136164,3,10,10,0,10,1
414849,2,21,7,14,15,0
68627,1,7,0,7,15,1
152702,4,27,6,21,17,1
219177,2,0,3,-3,13,1
392308,2,0,14,-14,4,1
108128,4,13,42,-29,15,1
6114,3,7,10,-3,3,1
172568,3,7,24,-17,9,1
117622,2,6,10,-4,2,0
148294,2,7,0,7,16,0
78835,1,0,0,0,2,1
216089,4,24,19,5,11,1
186590,1,14,0,14,15,1
94427,1,0,0,0,9,0
375013,3,21,27,-6,14,1
250451,2,7,0,7,9,1
215474,2,10,3,7,11,1
373326,1,0,0,0,13,1
126926,1,0,0,0,6,1
375777,2,13,0,13,14,0
243047,2,0,9,-9,6,1
73571,4,9,41,-32,17,1
198616,2,0,7,-7,3,0
392662,3,13,0,13,4,1
33822,3,0,31,-31,16,1
136986,4,17,20,-3,11,1
286755,3,20,21,-1,8,0
19849,2,10,14,-4,10,1
12630,1,0,0,0,6,1
69878,3,24,16,8,15,1
316461,3,16,17,-1,4,0
275859,1,3,0,3,3,1
207514,4,31,21,10,7,0
322975,4,13,0,13,7,1
418512,4,24,12,12,16,1
23790,3,17,0,17,12,1
155648,1,3,3,0,2,0
265573,1,0,2,-2,16,0
321169,3,3,19,-16,6,0
267435,4,17,24,-7,17,1
246673,3,31,3,28,8,0
344960,3,10,14,-4,17,1
350416,1,0,3,-3,2,0
371263,1,0,7,-7,12,1
369459,4,45,7,38,11,0
355796,4,10,12,-2,5,1
63209,4,14,23,-9,12,1
364923,4,16,23,-7,9,0
167558,4,3,10,-7,7,0
101866,2,3,10,-7,12,0
36060,2,17,0,17,17,1
207379,1,0,0,0,7,1
383371,2,0,6,-6,17,0
362791,2,7,14,-7,8,0
399080,3,10,26,-16,7,1
243611,3,20,14,6,6,1
342384,2,0,3,-3,16,0
319194,3,9,17,-8,5,1
150210,4,6,26,-20,16,1
312082,2,17,7,10,2,0
35480,2,21,7,14,17,1
282735,4,16,30,-14,6,0
110732,2,3,3,0,16,1
357917,4,13,34,-21,6,1
208016,2,21,0,21,8,0
135117,4,31,6,25,10,0
163020,4,19,3,16,5,1
128408,4,14,13,1,7,0
109446,3,6,13,-7,16,1
105976,2,17,0,17,14,0
359300,2,3,13,-10,6,0
323849,3,16,23,-7,8,1
317209,3,7,13,-6,5,0
326845,4,10,17,-7,9,1
42750,1,3,0,3,3,1
296332,3,6,16,-10,13,0
215880,1,3,7,-4,11,1
16397,3,21,13,8,8,0
251601,4,19,20,-1,10,0
55379,2,10,7,3,9,0
150307,2,17,7,10,16,1
5545,3,16,10,6,3,1
6311,4,19,25,-6,3,1
355775,4,10,9,1,5,0
388448,2,0,13,-13,2,1
251080,2,10,14,-4,10,0
417107,4,34,0,34,15,1
99960,4,17,16,1,12,0
266465,2,0,9,-9,16,0
153975,2,7,7,0,1,0
54804,3,10,0,10,8,1
93535,1,0,0,0,9,1
22651,4,23,10,13,11,1
136738,2,13,10,3,11,0
69490,4,31,24,7,15,1
75019,4,34,17,17,17,0
15009,1,0,7,-7,7,0
119947,2,6,17,-11,3,1
119509,4,14,24,-10,3,0
34842,2,10,0,10,16,0
164953,4,3,16,-13,6,1
192239,1,3,0,3,1,0
389523,3,20,10,10,3,0
374506,1,7,0,7,14,0
213459,1,0,0,0,10,0
332979,1,0,0,0,12,0
403415,1,7,0,7,9,0
70230,4,33,30,3,15,0
196712,3,33,0,33,3,1
419065,4,10,20,-10,16,1
146865,3,31,0,31,15,1
13295,2,0,20,-20,7,0
366620,4,26,14,12,10,1
322690,5,9,9,0,7,1
228862,4,9,17,-8,17,1
275476,3,20,17,3,3,1
116078,1,0,0,0,1,1
302554,4,3,16,-13,15,1
416560,1,0,0,0,15,1
131786,1,0,0,0,8,1
332758,3,21,9,12,12,1
391142,2,7,24,-17,4,1
415561,2,7,7,0,15,0
292865,1,7,0,7,11,0
189619,2,10,3,7,17,1
6971,3,0,7,-7,3,1
387747,4,0,36,-36,2,1
63960,4,6,27,-21,12,0
181390,2,17,14,3,13,1
237516,2,24,7,17,3,0
253160,4,21,23,-2,11,1
110557,1,10,0,10,16,0
191555,3,14,24,-10,17,1
345884,2,3,14,-11,17,0
249293,4,33,17,16,9,1
244443,1,0,0,0,7,0
105200,2,7,14,-7,14,1
287044,3,19,24,-5,8,1
87001,3,14,9,5,5,0
209285,1,0,0,0,8,0
160452,2,6,7,-1,4,1
201679,3,17,20,-3,5,0
68261,4,20,27,-7,14,0
343459,2,7,7,0,16,0
153150,3,20,17,3,1,1
121927,1,0,7,-7,4,1
55817,2,0,7,-7,9,0
263602,2,13,7,6,15,1
304864,4,12,10,2,16,1
245220,1,0,0,0,7,1
72501,3,13,17,-4,16,1
156466,2,0,3,-3,2,1
51419,1,3,10,-7,7,1
93328,3,24,3,21,9,1
36383,3,13,19,-6,17,0
334658,2,2,0,2,13,0
278671,4,17,3,14,4,0
80550,4,8,10,-2,3,1
399478,2,0,24,-24,7,1
303868,1,0,7,-7,16,1
235319,4,25,6,19,3,0
221912,3,19,10,9,14,0
348785,1,0,7,-7,2,1
292832,4,29,24,5,11,0
261308,1,0,0,0,14,1
191046,1,0,0,0,17,0
92678,2,3,10,-7,8,1
398695,1,0,0,0,7,0
384914,4,13,36,-23,1,0
42917,2,14,13,1,3,0
411496,3,13,17,-4,13,0
387722,3,0,16,-16,2,0
411360,4,20,10,10,13,0
414557,3,21,9,12,14,1
409518,2,7,0,7,12,0
349787,4,29,21,8,2,0
374039,4,17,10,7,13,1
232946,2,10,3,7,2,1
97314,1,0,3,-3,10,1
358242,2,0,14,-14,6,1
282517,3,17,3,14,6,0
173850,1,0,7,-7,10,1
403249,4,31,24,7,9,0
197694,1,7,3,4,3,1
125919,2,16,10,6,6,1
96425,2,7,14,-7,10,1
180941,2,17,7,10,13,0
392439,1,0,0,0,4,1
22346,4,0,6,-6,11,1
193795,1,0,0,0,1,1
58803,4,18,29,-11,10,1
271873,2,7,10,-3,2,0
2064,1,0,7,-7,1,1
310561,1,3,12,-9,2,0
358241,2,0,13,-13,6,0
284941,3,10,14,-4,7,0
311548,4,17,19,-2,2,0
329466,2,3,0,3,10,1
295028,4,31,24,7,12,0
138262,1,0,0,0,11,1
238164,2,3,9,-6,4,0
300770,3,10,13,-3,15,1
11575,4,13,16,-3,6,1
314592,2,7,0,7,3,0
302807,3,9,19,-10,15,0
349834,1,0,3,-3,2,1
33049,1,3,0,3,16,0
71959,4,25,16,9,16,0
44938,4,14,38,-24,4,0
308863,3,10,10,0,1,0
420632,2,13,13,0,17,0
405093,2,0,3,-3,10,0
397290,2,0,21,-21,6,1
323939,2,10,7,3,8,0
418823,1,0,3,-3,16,0
355845,2,13,7,6,5,0
103925,2,3,0,3,13,0
419498,3,10,17,-7,16,1
229030,4,23,16,7,17,0
186716,1,0,0,0,15,1
386559,4,14,24,-10,2,0
180533,4,21,20,1,13,0
158411,4,16,27,-11,3,1
200208,4,14,37,-23,4,0
130625,2,7,14,-7,8,0
202367,1,0,0,0,5,0
62470,4,10,13,-3,12,1
298902,1,0,3,-3,14,1
385983,4,24,21,3,1,1
172288,4,24,20,4,9,0
312768,1,0,0,0,3,1
119592,2,10,3,7,3,1
218283,2,7,14,-7,12,1
98107,2,14,7,7,11,1
288767,4,3,13,-10,9,1
385428,3,21,7,14,1,0
149760,4,55,0,55,16,0
298281,4,20,13,7,14,1
56869,2,7,0,7,9,1
271625,3,23,27,-4,2,1
212968,3,14,7,7,10,1
268753,2,24,3,21,17,0
214870,2,0,9,-9,11,0
223624,1,6,0,6,15,0
83317,1,0,0,0,4,0
323643,2,13,0,13,8,0
283280,2,10,9,1,7,1
210730,2,14,0,14,9,0
203719,4,22,37,-15,6,0
306666,4,14,35,-21,17,1
190839,3,16,3,13,17,0
184207,2,7,0,7,14,1
208558,4,50,23,27,8,1
239264,2,0,7,-7,4,1
11256,3,17,21,-4,6,0
319509,3,10,17,-7,6,0
228720,4,25,30,-5,17,1
230459,4,21,14,7,1,0
338950,2,6,0,6,15,1
302996,4,20,16,4,16,0
165567,4,3,28,-25,6,0
42808,3,6,28,-22,3,0
108832,3,7,10,-3,15,1
258333,4,41,39,2,13,1
109677,1,3,0,3,16,0
374355,1,0,0,0,14,1
135103,3,24,6,18,10,0
388880,2,10,14,-4,3,1
347088,1,0,3,-3,1,1
277190,1,0,7,-7,4,1
154432,2,14,0,14,1,0
347411,1,0,0,0,1,1
132463,4,0,24,-24,9,1
250655,3,3,19,-16,10,0
294189,2,0,7,-7,12,0
375674,4,23,20,3,14,0
284082,4,13,17,-4,7,1
190859,4,24,10,14,17,0
177512,1,0,0,0,11,0
207523,1,0,0,0,7,1
167411,4,44,40,4,7,0
354682,4,10,17,-7,4,0
265162,1,0,3,-3,16,0
332067,4,10,9,1,12,1
142288,2,0,0,0,13,0
103064,2,21,7,14,13,1
233352,4,19,26,-7,2,1
243572,2,10,7,3,6,1
41720,1,0,0,0,2,0
337649,3,14,13,1,14,1
203915,1,0,7,-7,6,0
17719,4,17,6,11,9,1
378719,2,14,7,7,15,0
339140,3,10,13,-3,15,1
10444,1,0,0,0,5,1
339525,1,0,0,0,15,1
378148,2,21,6,15,15,0
309211,1,0,0,0,1,1
52027,2,3,10,-7,7,1
217716,2,7,0,7,12,0
178401,4,31,34,-3,12,1
193470,4,23,20,3,1,1
207596,3,27,10,17,7,1
219901,1,0,0,0,13,1
22268,2,0,0,0,11,0
122422,2,6,20,-14,4,0
354607,2,3,7,-4,4,1
50125,3,0,17,-17,6,0
371271,1,0,10,-10,12,0
257182,2,0,9,-9,12,1
60826,2,10,13,-3,11,0
301006,1,9,3,6,15,1
74744,4,14,17,-3,17,1
214019,3,36,7,29,10,0
162704,4,23,24,-1,5,1
265247,3,9,6,3,16,1
22969,1,0,0,0,11,0
72704,4,33,13,20,16,1
220126,3,26,13,13,13,1
268456,3,14,9,5,17,0
327967,2,7,0,7,10,1
289374,4,31,25,6,9,0
162717,4,26,24,2,5,1
404717,1,0,3,-3,10,1
404148,2,6,7,-1,10,1
100716,4,28,24,4,12,0
314203,3,14,20,-6,3,0
120020,4,23,38,-15,3,1
256730,2,0,6,-6,12,0
82695,4,12,19,-7,3,1
253408,3,14,28,-14,11,0
75370,1,0,0,0,17,1
181461,4,31,24,7,13,0
270049,1,3,3,0,1,0
148110,1,0,0,0,16,0
198484,3,17,3,14,3,1
254146,2,3,12,-9,11,0
146649,2,7,17,-10,15,1
172694,2,14,3,11,9,1
197718,2,7,10,-3,3,0
140791,4,22,24,-2,12,1
202567,2,14,6,8,5,0
218451,3,24,14,10,13,0
46033,2,14,14,0,4,0
340832,4,24,16,8,15,0
359745,2,24,9,15,6,0
46635,3,3,0,3,4,1
207372,4,13,21,-8,7,0
338571,4,29,31,-2,14,0
350825,1,0,0,0,3,1
378897,3,13,20,-7,15,0
13288,2,0,20,-20,7,0
321206,4,3,19,-16,6,0
46414,4,12,17,-5,4,1
361362,3,10,7,3,7,1
202851,2,7,0,7,5,1
166252,2,0,3,-3,6,0
393122,3,24,3,21,4,0
306856,2,0,3,-3,17,1
416835,4,19,17,2,15,1
216540,3,34,11,23,12,1
205690,3,20,19,1,7,0
229971,2,0,3,-3,17,1
32421,4,31,6,25,15,0
115282,3,14,9,5,1,0
236502,2,7,9,-2,3,1
36564,4,23,33,-10,17,0
13434,2,3,14,-11,7,1
325500,3,19,13,6,8,1
328580,2,10,7,3,10,0
87291,3,24,17,7,6,1
156993,4,7,13,-6,2,0
324922,4,23,23,0,8,0
231363,4,9,16,-7,1,1
101857,2,3,3,0,12,0
314369,3,10,17,-7,3,0
231294,2,3,3,0,1,0
630,2,0,3,-3,1,0
117858,4,9,20,-11,2,0
166720,2,7,3,4,6,1
364677,2,3,0,3,9,0
226677,1,7,3,4,16,1
72433,1,7,0,7,16,0
361954,3,10,3,7,7,0
119083,1,7,7,0,3,0
373366,2,7,7,0,13,1
97120,4,34,6,28,10,1
137299,4,13,27,-14,11,1
307827,3,24,21,3,1,0
25119,2,10,0,10,12,0
92513,1,7,0,7,8,1
95825,2,6,10,-4,10,1
420546,4,10,42,-32,17,1
395626,2,7,17,-10,6,1
193321,4,10,26,-16,1,1
158167,2,7,0,7,3,0
164522,3,23,3,20,5,0
348765,4,31,24,7,2,0
53887,2,7,7,0,8,0
321766,3,18,6,12,7,1
132979,2,3,14,-11,9,1
352042,1,0,0,0,3,1
116603,3,13,3,10,2,0
257011,2,0,7,-7,12,0
402188,4,19,14,5,9,0
338538,3,20,24,-4,14,1
277177,1,0,0,0,4,0
64498,4,31,16,15,13,1
57445,1,7,0,7,10,0
17197,2,7,21,-14,9,0
231023,3,17,0,17,1,1
54098,4,17,3,14,8,1
26133,2,0,13,-13,13,1
142537,4,30,16,14,13,0
200921,4,27,7,20,4,1
226269,2,15,0,15,16,1
125911,2,13,10,3,6,1
66169,2,17,0,17,13,0
258377,1,7,6,1,13,1
304538,4,10,21,-11,16,1
288695,2,0,7,-7,9,0
163365,1,0,0,0,5,0
351010,1,7,7,0,3,0
388555,1,7,0,7,3,0
104588,2,7,3,4,14,0
81058,1,0,0,0,3,0
281238,4,27,19,8,6,0
70238,1,0,0,0,15,1
23839,4,24,7,17,12,1
396827,2,10,7,3,6,0
178786,2,21,7,14,12,0
5669,3,0,14,-14,3,0
373038,2,0,0,0,13,0
131557,3,9,23,-14,8,1
107606,2,6,7,-1,15,1
146368,2,3,3,0,15,1
313712,2,14,3,11,3,0
361111,4,23,16,7,7,0
263654,3,20,10,10,15,1
167759,4,26,23,3,7,0
287214,4,13,23,-10,8,1
127181,3,13,9,4,6,0
395103,4,17,31,-14,5,0
314160,2,7,7,0,3,0
364207,1,0,0,0,9,0
164375,3,23,3,20,5,0
89214,2,3,0,3,7,1
274023,1,0,0,0,3,1
66734,1,0,3,-3,14,1
228827,3,6,17,-11,17,0
49441,5,20,20,0,6,0
61680,2,14,3,11,12,0
148145,2,3,14,-11,16,1
221457,3,3,38,-35,14,0
4419,4,14,14,0,2,0
85992,3,14,16,-2,5,0
22134,2,10,6,4,11,0
164828,1,0,0,0,6,0
402095,2,3,0,3,9,1
26262,2,7,14,-7,13,0
324475,4,17,12,5,8,1
302252,3,31,13,18,15,1
156214,4,16,10,6,2,0
220477,1,0,0,0,13,1
104743,2,17,13,4,14,0
387476,4,21,16,5,2,1
65583,2,6,6,0,13,1
204155,3,10,17,-7,6,1
52298,1,0,0,0,7,1
269284,4,13,19,-6,17,1
364004,3,6,9,-3,8,0
118648,1,7,6,1,2,1
152283,4,28,0,28,17,1
349712,2,14,7,7,2,0
68864,3,6,17,-11,15,1
242135,2,13,7,6,6,0
320210,1,7,0,7,6,0
234181,2,10,10,0,2,1
117976,3,17,6,11,2,1
239650,1,0,0,0,4,0
174609,1,0,0,0,10,1
46415,4,12,17,-5,4,1
105389,3,23,7,16,14,0
36370,3,13,19,-6,17,1
62482,4,13,13,0,12,0
13952,4,24,21,3,7,1
39005,4,30,17,13,1,1
181280,3,3,13,-10,13,0
73889,1,7,0,7,17,1
186764,2,20,0,20,15,1
83342,2,0,7,-7,4,0
169617,2,6,0,6,8,1
249246,3,19,14,5,9,0
295054,1,0,0,0,12,0
265734,1,3,0,3,16,1
270284,4,10,24,-14,1,0
397067,4,21,16,5,6,1
223756,4,40,13,27,15,1
319017,3,7,23,-16,5,1
59498,3,6,20,-14,11,0
377909,4,23,13,10,15,1
198248,1,0,0,0,3,1
308,1,7,0,7,1,0
362788,2,7,14,-7,8,0
378613,4,20,20,0,15,1
296202,3,16,26,-10,13,0
366533,2,13,7,6,10,1
274596,4,24,26,-2,3,0
299985,2,0,14,-14,14,1
21762,4,31,17,14,11,0
407631,4,10,17,-7,11,1
204738,2,14,14,0,6,1
379027,2,7,6,1,15,1
420921,2,7,7,0,17,0
247682,2,7,6,1,8,1
178306,2,7,3,4,12,0
401758,4,27,14,13,8,0
97397,3,9,16,-7,10,0
190970,3,12,0,12,17,1
76845,4,33,7,26,1,0
298884,4,21,23,-2,14,1
187514,2,6,10,-4,16,1
274099,3,20,0,20,3,0
262535,1,0,0,0,15,0
358520,1,0,3,-3,6,1
219410,4,33,27,6,13,0
215437,1,7,3,4,11,0
1026,1,6,0,6,1,1
344164,4,33,11,22,17,1
400079,2,17,9,8,8,0
183451,4,27,6,21,14,0
311269,4,6,3,3,2,1
41988,4,38,6,32,2,0
300177,3,21,3,18,14,1
8098,4,24,20,4,4,1
291582,3,20,3,17,11,1
216236,4,17,17,0,12,1
277697,2,7,0,7,4,0
369767,4,45,43,2,11,0
213569,4,10,14,-4,10,1
253172,1,0,0,0,11,1
396468,4,28,25,3,6,0
223931,4,30,6,24,15,0
96687,1,0,0,0,10,0
158351,3,13,17,-4,3,1
50446,3,10,10,0,6,1
4757,2,10,0,10,3,1
217445,2,9,0,9,12,1
380803,3,9,21,-12,16,1
246717,1,0,0,0,8,1
228959,2,14,9,5,17,0
415034,4,10,27,-17,15,0
206701,2,0,14,-14,7,0
134774,2,20,10,10,10,1
274073,2,10,0,10,3,1
373522,2,0,13,-13,13,1
322544,4,15,3,12,7,1
304729,4,21,22,-1,16,1
211181,2,0,10,-10,9,1
10584,1,0,7,-7,5,0
187705,3,16,6,10,16,0
131696,3,10,22,-12,8,1
277676,2,7,0,7,4,1
182233,4,33,7,26,13,0
204861,2,3,3,0,6,1
138014,2,19,17,2,11,1
11758,1,0,0,0,6,1
223270,3,3,9,-6,15,0
78953,1,0,0,0,2,1
220571,3,10,23,-13,13,0
403885,2,10,7,3,10,0
258447,3,21,13,8,13,0
309325,4,3,23,-20,1,1
133283,1,6,0,6,9,1
190422,4,7,10,-3,17,0
317460,1,3,3,0,5,1
79495,4,12,17,-5,2,0
164593,2,7,3,4,5,0
189470,3,14,0,14,17,0
170228,1,0,6,-6,8,0
39741,3,9,0,9,1,0
287811,3,21,17,4,9,1
22946,4,3,26,-23,11,0
105421,4,23,17,6,14,0
413297,3,17,0,17,14,1
14145,2,0,14,-14,7,0
19131,2,14,3,11,10,0
341776,1,0,0,0,16,0
171765,2,6,14,-8,9,1
63631,3,13,33,-20,12,1
253920,4,44,14,30,11,1
41731,1,0,0,0,2,0
983,4,0,6,-6,1,0
17391,3,17,0,17,9,1
135278,4,24,17,7,10,0
232945,2,7,3,4,2,1
207244,1,0,0,0,7,1
216944,1,3,0,3,12,1
111996,3,20,21,-1,17,0
131394,3,7,13,-6,8,1
254087,1,0,0,0,11,0
116329,3,33,13,20,1,0
293198,2,13,7,6,11,1
411341,3,17,10,7,13,0
129283,4,17,13,4,7,1
57257,1,0,0,0,10,0
239341,4,3,17,-14,4,0
101595,3,13,31,-18,12,0
419914,4,13,18,-5,17,0
345710,2,7,7,0,17,1
263218,4,17,17,0,15,0
276987,4,24,20,4,4,0
210147,2,0,0,0,9,1
397896,3,7,6,1,7,1
42233,3,24,7,17,2,1
306276,2,16,0,16,17,1
10942,2,9,14,-5,5,0
143280,1,0,0,0,14,0
97015,1,10,0,10,10,1
95191,4,23,30,-7,9,1
35218,4,0,14,-14,16,0
59963,3,3,24,-21,11,0
311473,2,10,3,7,2,1
332933,4,24,3,21,12,1
240450,2,0,7,-7,5,1
41195,3,0,7,-7,2,0
218475,3,24,17,7,13,1
228164,2,7,17,-10,17,0
209326,2,6,7,-1,8,1
419641,4,29,16,13,17,1
125941,3,16,13,3,6,0
166734,2,13,3,10,6,0
421664,2,10,7,3,17,1
174242,4,10,32,-22,10,0
327991,2,10,0,10,10,1
303290,2,20,0,20,16,0
263866,1,0,0,0,15,0
132715,3,3,17,-14,9,1
278313,2,14,0,14,4,0
326326,2,0,10,-10,9,0
25667,2,7,7,0,12,0
22654,4,30,10,20,11,0
380244,3,16,16,0,16,0
334768,4,32,11,21,13,1
242606,2,10,0,10,6,0
381014,1,0,0,0,16,0
413030,4,19,21,-2,14,1
197092,2,7,14,-7,3,0
145524,4,26,17,9,14,1
155491,1,7,0,7,2,0
194853,1,0,7,-7,2,1
139236,2,10,6,4,12,0
226641,4,10,6,4,16,0
395325,1,14,0,14,5,0
9922,3,0,3,-3,5,1
339805,4,24,13,11,15,0
218105,1,7,0,7,12,0
13027,3,14,7,7,6,0
325877,1,0,0,0,9,1
45026,3,13,10,3,4,1
25652,1,7,0,7,12,0
419661,4,30,23,7,17,1
348617,4,34,23,11,2,0
116560,2,3,0,3,2,0
291703,2,0,6,-6,11,0
262742,2,21,0,21,15,1
76744,1,3,0,3,1,0
91991,3,13,23,-10,8,1
360720,2,10,7,3,7,1
398270,1,0,0,0,7,1
327487,1,0,0,0,10,1
133850,1,0,0,0,9,0
111189,1,7,0,7,16,0
119724,1,7,0,7,3,0
388810,4,14,7,7,3,0
224604,2,6,7,-1,15,1
196922,1,0,0,0,3,1
355289,3,14,14,0,4,0
217322,3,0,10,-10,12,1
259662,4,9,9,0,13,0
211275,1,3,0,3,9,1
240703,1,0,0,0,5,0
126337,2,7,13,-6,6,0
29513,1,0,0,0,14,1
268285,2,10,3,7,17,1
320315,4,14,24,-10,6,1
168974,1,0,7,-7,7,1
198135,2,0,3,-3,3,1
277309,4,0,16,-16,4,1
261809,2,3,7,-4,14,0
323911,1,7,0,7,8,1
398298,1,3,3,0,7,1
233028,4,24,10,14,2,0
179411,3,6,13,-7,12,1
342174,4,15,19,-4,16,0
112262,2,17,17,0,17,1
44670,1,0,0,0,3,1
201961,2,0,0,0,5,1
225429,1,0,0,0,15,1
101743,3,13,7,6,12,0
293554,3,13,17,-4,11,0
53287,4,3,7,-4,8,0
408156,2,6,0,6,12,1
393751,4,7,7,0,5,1
404758,2,10,6,4,10,1
400306,1,0,0,0,8,1
27061,3,10,6,4,13,1
344512,2,0,0,0,17,1
133617,2,10,7,3,9,0
244151,1,0,7,-7,6,0
182098,1,0,0,0,13,1
219822,3,38,0,38,13,0
40489,4,7,20,-13,2,1
81838,2,0,21,-21,3,0
279396,3,13,21,-8,5,1
362146,4,42,23,19,8,0
111973,3,14,21,-7,17,1
41065,3,3,13,-10,2,0
388304,2,10,3,7,2,0
59643,3,21,3,18,11,0
185110,3,0,16,-16,15,0
4247,3,13,6,7,2,1
392130,1,0,13,-13,4,0
233623,4,23,41,-18,2,1
76847,4,33,7,26,1,0
267585,4,27,34,-7,17,1
267146,4,10,10,0,17,1
83189,1,3,0,3,4,0
75745,2,28,16,12,1,0
7965,4,9,27,-18,4,1
228739,4,26,33,-7,17,0
149263,3,10,19,-9,16,0
238319,1,3,9,-6,4,1
232134,1,0,0,0,1,1
211057,3,27,0,27,9,0
166043,4,20,28,-8,6,0
362070,2,14,10,4,8,1
90439,2,0,13,-13,7,0
362917,2,7,0,7,8,1
251976,2,0,10,-10,10,0
66466,2,7,7,0,14,0
281661,3,24,10,14,6,1
168560,2,7,10,-3,7,0
83578,3,0,17,-17,4,0
269088,4,13,16,-3,17,1
165332,1,0,0,0,6,1
378894,3,13,20,-7,15,1
124278,3,27,17,10,5,0
54231,3,0,3,-3,8,1
367914,4,23,26,-3,10,0
392902,1,0,0,0,4,0
264300,3,10,23,-13,15,1
318096,2,9,7,2,5,1
130019,2,7,13,-6,8,0
82425,1,0,7,-7,3,0
28470,1,10,0,10,14,0
90089,1,0,0,0,7,1
355110,2,6,16,-10,4,1
123687,4,10,25,-15,4,1
410479,4,9,23,-14,13,0
244150,1,0,7,-7,6,0
244787,2,0,0,0,7,1
323581,1,0,0,0,8,0
351115,4,37,30,7,3,0
150662,4,17,22,-5,17,1
336842,1,7,7,0,14,0
184103,2,15,14,1,14,1
329252,4,24,13,11,10,1
55225,2,7,0,7,9,0
19595,3,14,21,-7,10,1
264998,1,0,0,0,16,0
417392,4,13,17,-4,16,1
92640,4,20,10,10,8,0
248920,2,17,3,14,9,0
281785,2,3,0,3,6,1
374000,3,10,7,3,13,1
388276,2,3,0,3,2,0
145626,3,21,0,21,14,0
253111,3,21,7,14,11,0
187445,4,41,14,27,16,1
84955,1,6,0,6,4,0
388862,1,3,7,-4,3,1
68075,3,3,10,-7,14,1
105270,4,10,24,-14,14,0
162868,4,13,3,10,5,0
330094,3,0,13,-13,11,1
52102,4,13,19,-6,7,0
164835,1,0,3,-3,6,1
196603,4,27,20,7,2,0
45259,1,0,0,0,4,1
39494,4,13,19,-6,1,1
154955,4,29,24,5,1,1
45793,4,13,14,-1,4,0
187537,2,6,16,-10,16,0
326866,4,10,20,-10,9,0
46051,3,14,14,0,4,1
98990,1,0,0,0,11,0
3185,4,13,9,4,2,1
414420,3,7,20,-13,14,0
15724,1,0,0,0,8,0
129919,4,13,0,13,7,1
414370,2,7,9,-2,14,0
40928,3,16,20,-4,2,1
88677,4,23,20,3,6,0
200771,3,31,3,28,4,0
260040,2,3,7,-4,14,0
240837,4,29,10,19,5,1
88277,1,7,0,7,6,0
225929,2,20,7,13,16,1
240382,5,24,23,1,5,0
351009,1,7,7,0,3,0
172973,1,7,0,7,9,1
122125,3,17,14,3,4,0
963,3,0,3,-3,1,0
317403,4,7,10,-3,5,0
335231,1,0,0,0,13,1
202532,1,0,3,-3,5,1
264895,2,16,14,2,16,1
342195,4,22,19,3,16,1
167184,2,22,7,15,7,1
20862,3,28,9,19,10,0
268779,3,31,3,28,17,0
25888,4,31,17,14,12,1
67154,2,0,0,0,14,1
161287,3,20,3,17,4,1
37612,2,10,0,10,17,1
239939,1,0,0,0,5,1
370355,4,20,35,-15,12,1
320533,1,14,0,14,6,0
82209,4,16,3,13,3,1
146553,3,14,24,-10,15,1
290532,3,17,20,-3,10,0
18336,4,22,17,5,9,1
358515,1,0,3,-3,6,1
347315,3,7,21,-14,1,1
134402,1,0,0,0,10,1
98815,1,0,0,0,11,0
296876,1,3,0,3,13,1
397493,4,13,19,-6,6,0
103024,1,0,0,0,13,0
288909,4,19,31,-12,9,0
363727,3,23,13,10,8,0
20655,2,7,14,-7,10,0
280643,1,0,0,0,5,0
175437,4,17,23,-6,11,1
111239,3,10,3,7,16,0
59082,3,3,17,-14,10,0
277239,3,0,13,-13,4,0
327252,2,6,10,-4,9,1
5107,3,13,7,6,3,1
52448,1,0,0,0,7,1
144570,2,7,19,-12,14,1
88849,4,13,16,-3,6,0
119853,4,24,21,3,3,0
30861,2,3,14,-11,15,0
232215,3,9,12,-3,1,1
342634,4,22,27,-5,16,0
58203,1,0,3,-3,10,1
420696,4,21,19,2,17,1
105263,3,10,24,-14,14,1
110161,3,19,17,2,16,1
238571,4,16,20,-4,4,0
97520,2,16,0,16,10,0
277864,2,7,14,-7,4,0
93197,3,0,13,-13,9,1
8431,1,3,0,3,4,0
165866,4,6,16,-10,6,0
115314,4,20,15,5,1,1
150029,3,21,6,15,16,1
50204,1,7,0,7,6,0
205807,2,7,0,7,7,1
408735,1,3,7,-4,12,1
141240,3,10,24,-14,13,0
180782,3,7,13,-6,13,1
22401,1,3,10,-7,11,0
326652,3,16,6,10,9,0
216880,3,13,14,-1,12,0
182508,3,21,14,7,14,1
328672,4,27,38,-11,10,0
414551,2,21,3,18,14,0
80141,1,0,0,0,2,1
131432,4,7,19,-12,8,0
66827,4,13,6,7,14,1
142914,2,3,10,-7,13,0
376385,3,9,0,9,14,1
323912,1,7,0,7,8,0
224567,1,3,7,-4,15,1
92281,3,13,0,13,8,1
254302,3,6,16,-10,11,0
170923,4,21,20,1,8,0
167767,5,26,26,0,7,0
159096,3,24,0,24,3,1
209431,4,14,17,-3,8,1
345810,1,0,7,-7,17,0
40259,1,0,0,0,2,1
389948,3,28,18,10,3,1
207503,4,28,20,8,7,0
147432,3,23,10,13,15,1
108210,2,6,0,6,15,0
19458,3,17,17,0,10,1
268771,3,24,3,21,17,0
106464,3,16,3,13,14,1
258937,1,0,7,-7,13,0
48034,4,10,27,-17,5,1
103717,4,3,17,-14,13,0
262660,4,26,16,10,15,1
129130,4,34,28,6,7,0
155501,2,14,0,14,2,0
1590,4,16,20,-4,1,0
395833,3,3,17,-14,6,0
4186,2,7,6,1,2,1
275592,2,14,0,14,3,0
226999,2,3,6,-3,16,1
122145,3,24,14,10,4,0
232391,4,13,22,-9,1,1
329939,2,7,10,-3,11,0
342831,1,10,0,10,16,1
199062,2,0,14,-14,4,1
207354,4,13,21,-8,7,1
390657,2,3,3,0,3,0
75988,1,7,7,0,1,1
63436,2,14,10,4,12,0
128228,3,20,7,13,7,1
145357,4,45,26,19,14,0
57804,3,19,10,9,10,0
6679,3,3,20,-17,3,1
41561,4,18,14,4,2,1
285182,5,6,6,0,7,1
47852,3,10,6,4,5,0
58128,3,13,10,3,10,1
372368,4,24,17,7,13,1
50385,1,0,0,0,6,0
26989,1,7,0,7,13,1
327567,3,10,15,-5,10,0
166977,1,0,0,0,7,0
58097,2,10,10,0,10,1
87119,2,7,9,-2,5,0
328322,3,3,17,-14,10,0
72601,1,7,0,7,16,0
305052,1,14,0,14,16,0
125984,4,23,23,0,6,0
388483,3,3,16,-13,2,1
31211,4,23,27,-4,15,0
161913,3,13,9,4,4,1
300456,2,16,0,16,14,1
371147,2,0,9,-9,12,0
397323,3,0,24,-24,6,0
210804,4,24,10,14,9,0
371566,2,3,0,3,12,0
156168,3,7,10,-3,2,1
402487,4,26,15,11,9,1
195176,1,7,0,7,2,1
61548,2,21,7,14,11,0
329686,4,30,17,13,11,0
403602,2,17,10,7,9,0
276468,2,10,7,3,4,0
14429,2,17,3,14,7,0
1733,4,28,0,28,1,0
242855,1,7,3,4,6,0
146736,4,22,32,-10,15,0
101645,1,0,0,0,12,1
68679,3,17,0,17,15,0
371283,2,7,10,-3,12,0
227038,3,10,6,4,16,1
99687,4,26,3,23,11,1
352487,1,0,0,0,3,1
358853,2,3,14,-11,6,1
268263,1,3,0,3,17,1
660,2,0,10,-10,1,0
276417,4,32,44,-12,3,1
287828,3,28,17,11,9,1
235975,1,7,0,7,3,1
131873,3,24,7,17,8,0
363685,2,2,10,-8,8,1
248119,1,0,3,-3,8,1
86587,3,30,3,27,5,1
324021,4,20,25,-5,8,0
254487,4,23,13,10,11,1
257189,2,3,16,-13,12,1
280204,4,28,14,14,5,1
320255,2,14,7,7,6,1
272988,2,3,3,0,2,1
77558,4,20,14,6,1,0
173358,4,28,27,1,10,1
256016,4,19,12,7,12,1
214195,4,22,9,13,11,0
178801,2,24,14,10,12,0
171918,2,7,7,0,9,0
303373,1,0,0,0,16,1
43686,3,14,10,4,3,0
411080,4,17,17,0,13,0
227689,1,0,0,0,16,1
103250,3,3,10,-7,13,1
262124,2,21,3,18,15,0
361249,3,14,26,-12,7,1
388686,4,20,7,13,3,0
205806,2,7,0,7,7,1
349587,3,13,28,-15,2,0
136439,2,10,7,3,11,0
44131,3,10,13,-3,3,0
257047,3,7,14,-7,12,0
320207,1,7,0,7,6,0
155447,4,13,10,3,2,0
38334,2,7,3,4,1,0
52176,2,0,3,-3,7,1
409768,1,0,0,0,12,0
65047,3,3,17,-14,13,1
187398,3,27,7,20,16,1
322554,1,0,0,0,7,0
337757,2,13,0,13,14,0
56960,4,43,7,36,9,0
324704,2,7,7,0,8,1
420118,1,0,0,0,17,1
186781,2,23,7,16,15,1
291648,4,23,20,3,11,1
105046,2,0,14,-14,14,1
176008,2,17,0,17,11,0
88631,3,20,10,10,6,0
342923,3,23,17,6,16,1
134945,3,7,22,-15,10,1
5600,1,0,0,0,3,0
341607,4,26,17,9,16,1
114073,2,21,0,21,17,0
53330,4,24,16,8,8,1
380293,4,29,30,-1,16,1
283399,2,13,7,6,7,0
127505,3,3,23,-20,6,0
399609,2,3,3,0,8,1
266649,2,16,3,13,16,1
413292,3,17,0,17,14,1
97671,3,3,3,0,11,0
6534,3,3,3,0,3,1
363844,3,13,20,-7,8,1
417615,2,14,3,11,16,0
341470,1,0,0,0,16,0
303767,3,20,10,10,16,0
53653,1,0,0,0,8,1
170119,2,7,10,-3,8,1
100208,3,17,0,17,12,0
278261,1,0,0,0,4,0
304655,3,14,7,7,16,1
174953,2,6,7,-1,10,0
275594,2,14,3,11,3,0
309184,4,37,9,28,1,1
312081,2,17,7,10,2,0
77031,1,7,7,0,1,0
277274,3,0,13,-13,4,0
19369,4,27,17,10,10,0
254228,1,0,0,0,11,0
257936,1,0,0,0,13,0
66049,2,7,0,7,13,1
175337,1,0,0,0,11,1
174937,2,3,7,-4,10,1
303564,2,14,3,11,16,0
190666,2,28,14,14,17,0
168257,1,7,7,0,7,1
256168,4,27,22,5,12,0
55383,2,10,7,3,9,1
133906,2,3,6,-3,9,1
207921,4,28,14,14,8,1
246283,1,0,0,0,7,0
38878,4,10,13,-3,1,1
256816,4,13,19,-6,12,1
9713,1,0,7,-7,5,1
20042,3,19,9,10,10,1
164530,4,23,10,13,5,0
200035,4,24,20,4,4,1
404285,2,0,3,-3,10,1
208068,4,21,13,8,8,0
318069,1,2,0,2,5,1
57145,2,0,0,0,10,1
271852,1,0,3,-3,2,0
37209,2,3,14,-11,17,1
137480,1,7,0,7,11,1
405457,3,24,10,14,10,1
135246,3,13,3,10,10,1
221374,1,0,17,-17,14,0
321254,1,6,3,3,6,1
202365,4,20,13,7,5,1
68272,4,27,30,-3,14,0
198073,4,10,37,-27,3,0
153516,1,2,0,2,1,0
340931,3,0,10,-10,15,1
407196,1,0,0,0,11,0
296964,4,29,7,22,13,1
330992,2,26,7,19,11,1
292198,3,21,14,7,11,0
417085,3,27,0,27,15,0
297613,1,0,0,0,13,1
190520,2,10,6,4,17,0
300157,2,21,3,18,14,1
244045,2,20,17,3,6,0
240324,3,7,23,-16,5,1
136537,1,0,10,-10,11,1
99213,3,30,17,13,11,1
309660,1,0,3,-3,1,1
371974,1,3,0,3,13,1
392582,1,0,0,0,4,1
247355,4,52,48,4,8,1
184272,4,31,14,17,14,1
6073,2,7,7,0,3,0
19336,3,14,17,-3,10,1
406105,3,0,26,-26,11,1
311935,3,21,10,11,2,1
56231,2,3,7,-4,9,0
206849,2,3,7,-4,7,1
48881,3,9,0,9,5,1
153097,2,6,10,-4,1,0
42950,3,24,23,1,3,1
329282,4,31,21,10,10,1
275704,1,0,0,0,3,1
52228,3,7,16,-9,7,0
157682,1,7,3,4,2,0
332414,1,7,3,4,12,0
384361,4,16,17,-1,1,1
154367,4,34,24,10,1,0
113192,4,41,16,25,17,0
264753,2,10,16,-6,16,0
230369,1,0,0,0,1,1
196998,3,20,17,3,3,1
44185,4,13,27,-14,3,1
263375,4,31,17,14,15,1
39045,1,0,0,0,1,1
313404,2,7,0,7,3,0
343442,1,7,0,7,16,1
238807,2,20,0,20,4,1
168729,3,10,6,4,7,0
413773,4,24,16,8,14,1
257995,3,0,21,-21,13,0
97754,1,0,0,0,11,0
65623,3,6,16,-10,13,0
198702,4,15,27,-12,3,1
18846,2,3,6,-3,9,1
107548,4,9,23,-14,15,1
138570,5,31,37,-6,12,1
109750,3,13,0,13,16,0
108272,4,9,7,2,15,1
304885,1,0,0,0,16,0
389907,2,12,3,9,3,0
76838,4,33,0,33,1,0
195485,1,0,0,0,2,0
106178,4,0,10,-10,14,1
252244,1,0,0,0,10,0
405613,3,21,20,1,10,0
85826,3,13,13,0,5,1
250900,1,0,0,0,10,0
303529,1,0,0,0,16,1
173367,4,31,27,4,10,1
398795,3,14,24,-10,7,1
330464,1,0,0,0,11,0
288106,3,13,7,6,9,1
273304,2,21,0,21,2,1
105202,2,7,14,-7,14,0
231560,1,7,0,7,1,0
26026,4,10,19,-9,13,0
289907,2,6,3,3,10,1
149061,2,7,7,0,16,0
132412,2,0,14,-14,9,0
335967,2,0,15,-15,13,1
247623,4,25,23,2,8,1
240456,2,3,7,-4,5,0
112510,1,3,9,-6,17,1
67947,4,22,6,16,14,0
143030,1,0,7,-7,13,1
145579,2,21,0,21,14,0
276150,1,10,0,10,3,1
327007,3,2,10,-8,9,1
264268,2,10,17,-7,15,0
127120,2,3,9,-6,6,0
312362,2,13,17,-4,3,0
271724,2,13,10,3,2,0
227730,2,3,7,-4,16,1
403955,4,20,17,3,10,0
197471,3,13,9,4,3,0
165454,1,0,0,0,6,1
94725,4,38,43,-5,9,0
84273,2,7,14,-7,4,0
115074,1,3,0,3,1,0
306458,3,3,17,-14,17,0
207960,1,0,0,0,8,1
100784,2,6,3,3,12,0
302841,4,12,23,-11,15,1
18972,2,0,0,0,10,0
280863,3,13,3,10,6,1
203918,1,0,7,-7,6,0
280631,4,23,9,14,5,0
318208,4,22,27,-5,5,1
223403,3,10,19,-9,15,1
339883,3,23,0,23,15,0
228936,2,7,9,-2,17,1
231815,4,26,20,6,1,1
92681,2,3,10,-7,8,1
321997,1,3,0,3,7,0
97286,4,27,20,7,10,0
260764,2,3,6,-3,14,1
18250,1,0,17,-17,9,1
299191,4,17,19,-2,14,0
349827,1,0,0,0,2,1
89220,2,6,0,6,7,0
193875,3,24,7,17,1,1
135801,2,7,14,-7,10,1
180179,3,13,0,13,13,0
376181,1,7,0,7,14,0
275006,2,24,3,21,3,0
224708,1,0,0,0,15,1
266660,3,19,3,16,16,1
362148,1,0,0,0,8,0
234671,3,23,20,3,2,1
305451,4,20,3,17,17,1
57654,3,17,10,7,10,0
45761,3,10,7,3,4,0
238435,4,23,36,-13,4,0
186240,1,0,0,0,15,1
97718,4,9,13,-4,11,1
286703,2,10,7,3,8,1
273239,4,40,7,33,2,0
204693,1,7,7,0,6,0
355239,2,3,14,-11,4,1
13140,2,10,10,0,6,1
316433,2,16,10,6,4,0
32256,3,24,14,10,15,0
234467,2,17,13,4,2,1
11924,1,0,0,0,6,0
160024,3,10,23,-13,3,1
42588,1,0,0,0,3,1
16540,4,30,13,17,8,1
253057,2,7,0,7,11,1
173787,3,10,3,7,10,0
88923,2,23,3,20,6,0
67651,4,7,35,-28,14,0
186984,4,10,12,-2,15,1
88966,3,36,10,26,6,0
414709,3,3,17,-14,14,0
155408,3,13,3,10,2,0
268146,2,6,14,-8,17,1
80190,2,14,10,4,2,0
245355,1,6,0,6,7,1
243337,4,14,30,-16,6,1
29664,1,0,0,0,14,0
200272,2,10,14,-4,4,1
165219,2,7,7,0,6,1
416559,1,0,0,0,15,1
364928,4,16,23,-7,9,1
172980,1,14,0,14,9,0
131229,2,14,17,-3,8,1
98963,4,7,24,-17,11,0
86096,2,28,0,28,5,0
306537,1,0,0,0,17,0
68687,3,17,0,17,15,1
228678,3,16,23,-7,17,1
174676,3,9,7,2,10,0
49315,2,7,3,4,6,0
26048,4,13,19,-6,13,0
28479,1,10,0,10,14,1
79829,1,0,0,0,2,0
160288,2,3,0,3,4,1
137949,4,30,22,8,11,1
240157,2,16,3,13,5,1
362327,2,3,7,-4,8,1
245243,2,3,3,0,7,1
171265,1,0,0,0,9,1
374480,4,32,7,25,14,0
235752,4,10,27,-17,3,1
312327,1,7,14,-7,3,0
193642,1,0,0,0,1,1
229007,4,21,16,5,17,0
261528,2,12,0,12,14,0
43202,2,14,7,7,3,1
221501,4,10,41,-31,14,1
216102,4,24,26,-2,11,1
170878,2,7,7,0,8,1
10327,2,10,14,-4,5,1
339205,1,0,0,0,15,1
343803,2,14,3,11,17,1
336919,3,7,21,-14,14,1
140622,3,31,10,21,12,1
396139,3,17,23,-6,6,1
231578,1,7,3,4,1,0
404500,3,21,19,2,10,0
35820,4,10,10,0,17,0
279664,2,14,0,14,5,1
184189,1,7,0,7,14,0
56702,2,0,7,-7,9,0
123505,2,7,0,7,4,0
194592,2,21,0,21,2,1
271477,3,14,0,14,1,0
320428,2,17,6,11,6,0
140544,1,0,0,0,12,1
132360,1,0,0,0,9,0
345135,3,15,3,12,17,1
338518,3,20,14,6,14,1
173216,4,20,24,-4,9,0
379349,3,10,16,-6,16,1
274079,3,10,0,10,3,1
258694,2,0,14,-14,13,0
153317,4,2,10,-8,1,0
252089,1,0,0,0,10,0
331263,1,0,7,-7,11,0
352899,4,14,16,-2,3,1
167122,4,22,34,-12,7,1
406149,4,3,29,-26,11,0
32934,2,0,14,-14,15,1
10382,3,10,38,-28,5,1
135467,1,0,0,0,10,1
208458,2,10,0,10,8,1
44471,4,17,12,5,3,0
255445,1,0,0,0,12,1
292478,3,10,9,1,11,0
71981,1,0,3,-3,16,1
66411,4,21,30,-9,14,1
112295,3,38,17,21,17,0
118283,3,12,7,5,2,0
167785,5,26,26,0,7,1
46658,4,10,0,10,4,1
126359,3,7,14,-7,6,1
6715,4,3,23,-20,3,0
360810,4,24,30,-6,7,0
162509,3,21,10,11,4,0
317270,4,7,16,-9,5,1
260097,3,6,21,-15,14,1
216798,1,0,0,0,12,0
131451,4,20,19,1,8,0
164389,4,30,3,27,5,1
389581,1,7,0,7,3,1
82391,4,13,10,3,3,0
326746,1,0,7,-7,9,1
42839,4,6,37,-31,3,0
104468,2,14,10,4,13,0
421585,4,16,9,7,17,0
54887,1,0,0,0,8,1
192665,3,13,7,6,1,0
376908,1,0,3,-3,15,1
339291,3,31,0,31,15,0
127642,3,24,12,12,6,0
362028,1,0,6,-6,8,0
419297,2,0,10,-10,16,0
259095,1,0,0,0,13,1
124904,4,9,16,-7,5,1
392679,4,16,0,16,4,0
6285,4,16,17,-1,3,0
240185,3,16,6,10,5,1
404567,1,0,0,0,10,0
296313,2,6,13,-7,13,1
258250,2,7,6,1,13,1
59138,1,0,7,-7,10,0
77605,1,0,7,-7,1,0
172452,4,13,49,-36,9,1
51839,1,0,0,0,7,1
343291,1,0,3,-3,16,1
147511,1,3,0,3,15,0
297003,4,32,14,18,13,0
103358,2,10,17,-7,13,1
91119,1,0,0,0,8,0
132119,2,10,3,7,9,1
94789,2,3,6,-3,9,1
76604,1,7,0,7,1,0
72514,3,13,17,-4,16,1
152999,4,42,17,25,1,0
388244,1,0,0,0,2,1
190446,4,14,13,1,17,1
215203,3,7,16,-9,11,1
318011,4,17,13,4,5,0
98938,4,7,17,-10,11,1
21467,4,12,14,-2,11,1
154790,4,13,23,-10,1,1
175325,4,22,19,3,10,0
311565,1,0,0,0,2,1
176229,4,14,24,-10,11,0
71687,1,0,0,0,16,1
111766,1,3,6,-3,17,0
262726,2,21,0,21,15,0
142876,1,0,0,0,13,0
39422,2,3,10,-7,1,1
333895,1,0,0,0,12,0
34689,2,3,3,0,16,1
305333,1,0,0,0,17,1
89842,3,9,6,3,7,0
203489,3,21,3,18,6,1
278076,4,13,10,3,4,1
251717,3,21,3,18,10,1
36814,3,17,17,0,17,0
94581,4,19,17,2,9,1
210686,1,0,0,0,9,1
106765,3,17,15,2,14,1
246948,2,20,10,10,8,0
150207,4,6,26,-20,16,1
190015,1,0,0,0,17,1
331073,4,52,24,28,11,0
120970,1,5,7,-2,3,1
232002,1,0,7,-7,1,1
245131,2,17,12,5,7,0
406495,2,0,16,-16,11,0
165099,4,10,24,-14,6,0
75952,4,32,7,25,1,0
94933,2,3,3,0,9,0
78282,2,3,21,-18,2,1
212350,3,13,3,10,10,0
168112,1,6,2,4,7,1
194266,2,7,0,7,2,0
215273,1,0,0,0,11,1
323914,1,7,0,7,8,0
411946,3,17,10,7,13,0
419969,1,0,0,0,17,1
104888,2,0,3,-3,14,0
3401,1,3,7,-4,2,0
245548,2,34,0,34,7,0
250681,4,10,22,-12,10,1
276719,4,30,27,3,4,0
177568,3,10,3,7,11,0
159075,2,17,0,17,3,0
366817,2,0,3,-3,10,1
145791,3,13,10,3,15,1
87087,1,0,0,0,5,0
247459,4,13,9,4,8,0
182605,2,0,6,-6,14,0
165047,2,10,17,-7,6,0
110011,3,27,10,17,16,0
40078,4,20,14,6,1,0
405465,4,24,10,14,10,0
392193,3,10,13,-3,4,1
211696,3,23,9,14,9,1
250677,4,10,22,-12,10,0
160490,3,20,7,13,4,1
157482,4,16,37,-21,2,1
35468,2,7,7,0,17,1
150724,2,6,9,-3,17,1
281642,2,21,3,18,6,0
375539,4,33,14,19,14,0
77686,3,10,17,-7,1,0
103548,3,33,0,33,13,0
156361,3,31,0,31,2,0
70107,1,3,0,3,15,1
116039,4,13,7,6,1,1
43518,2,7,3,4,3,1
272880,3,20,17,3,2,0
59807,4,12,13,-1,11,0
92728,3,3,17,-14,8,1
213533,3,10,14,-4,10,0
359561,1,3,0,3,6,1
228016,1,0,0,0,17,1
318125,2,9,7,2,5,0
358217,1,0,0,0,6,0
94222,4,24,24,0,9,1
387429,3,21,16,5,2,1
284064,4,13,3,10,7,0
405583,2,14,14,0,10,0
320582,3,30,0,30,6,1
361967,4,13,6,7,7,0
73232,3,7,15,-8,16,0
354490,3,24,28,-4,4,1
187594,4,13,23,-10,16,0
97688,3,3,10,-7,11,1
110477,3,17,0,17,16,1
413228,2,7,0,7,14,1
55462,4,23,10,13,9,0
55484,1,0,0,0,9,1
52586,4,22,10,12,7,1
226967,1,3,0,3,16,0
49177,2,10,0,10,6,0
332897,3,24,0,24,12,0
195962,3,0,24,-24,2,1
368946,1,7,7,0,11,0
57759,2,16,3,13,10,1
176095,4,24,16,8,11,0
307275,1,7,3,4,17,0
307621,2,7,7,0,17,1
59289,1,0,0,0,11,0
19850,2,10,14,-4,10,1
369021,4,13,7,6,11,1
311914,2,14,7,7,2,1
398061,3,21,21,0,7,0
139204,1,0,6,-6,12,1
80469,2,5,0,5,3,0
243703,2,14,3,11,6,0
282689,3,6,20,-14,6,1
248433,2,10,6,4,8,0
311812,3,17,20,-3,2,0
402690,2,0,0,0,9,1
324372,1,7,0,7,8,0
168732,3,10,6,4,7,0
266663,3,19,3,16,16,1
363803,2,13,7,6,8,0
380736,1,0,0,0,16,0
412086,3,31,0,31,13,0
220091,2,19,3,16,13,0
236171,3,10,10,0,3,1
153656,1,2,0,2,1,1
304507,3,3,14,-11,16,1
61219,1,7,0,7,11,1
344747,4,13,34,-21,17,1
239313,3,3,17,-14,4,1
253339,1,7,0,7,11,0
230267,2,16,10,6,17,0
181457,4,31,24,7,13,1
383558,3,21,13,8,17,0
109057,4,23,41,-18,15,0
54508,3,7,7,0,8,0
351979,3,21,14,7,3,1
50534,1,0,3,-3,6,0
119520,1,0,0,0,3,0
263192,3,10,17,-7,15,0
325137,2,13,7,6,8,0
194424,2,9,0,9,2,0
327436,4,3,17,-14,9,0
197256,2,0,0,0,3,1
296058,3,6,7,-1,13,1
404192,3,9,9,0,10,1
343187,2,3,0,3,16,1
74056,2,3,0,3,17,1
367494,1,0,0,0,10,0
395519,3,21,14,7,6,1
85892,1,7,7,0,5,0
194223,4,12,17,-5,1,1
100667,3,14,14,0,12,1
367835,2,10,10,0,10,1
96627,3,3,3,0,10,0
257994,3,0,21,-21,13,0
264689,1,7,6,1,16,0
39781,4,9,7,2,1,1
206918,4,10,23,-13,7,1
65258,1,0,7,-7,13,0
138348,3,27,7,20,11,1
297975,3,30,7,23,13,1
183750,1,6,7,-1,14,1
158594,1,7,7,0,3,0
177589,3,17,10,7,11,0
377826,2,14,0,14,15,1
234672,3,23,20,3,2,1
334693,2,15,3,12,13,0
143376,3,7,16,-9,14,0
192146,2,0,6,-6,1,0
400654,2,3,0,3,8,1
202603,3,21,13,8,5,1
126587,4,16,13,3,6,0
115514,1,0,3,-3,1,1
75610,3,7,6,1,17,1
140721,2,12,14,-2,12,1
237784,1,0,7,-7,4,0
72805,3,24,14,10,16,0
223841,2,9,0,9,15,0
52177,2,0,3,-3,7,1
5748,1,6,0,6,3,1
38848,4,3,10,-7,1,0
13078,4,21,14,7,6,0
358931,4,14,35,-21,6,0
242059,4,10,9,1,5,1
295488,1,0,0,0,12,0
269148,5,16,16,0,17,0
253277,3,3,13,-10,11,1
400442,4,24,10,14,8,1
235555,3,10,13,-3,3,1
305783,4,16,16,0,17,1
296745,1,0,0,0,13,0
405322,4,14,12,2,10,0
130544,4,13,6,7,8,0
368027,3,17,21,-4,11,1
280086,1,7,0,7,5,0
369703,2,16,17,-1,11,0
295691,2,0,9,-9,12,1
97281,4,27,20,7,10,0
282690,3,6,20,-14,6,1
50707,2,7,7,0,6,0
288178,1,3,0,3,9,0
374801,1,7,0,7,14,1
100844,4,12,19,-7,12,1
267871,4,26,17,9,17,0
264207,1,0,7,-7,15,1
156388,4,38,14,24,2,0
317304,1,0,0,0,5,1
338153,1,7,0,7,14,0
65090,1,0,0,0,13,1
150379,4,33,7,26,16,0
278152,2,14,14,0,4,1
314117,4,33,20,13,3,0
138839,3,5,33,-28,12,1
66291,1,0,0,0,14,0
10784,2,14,0,14,5,0
421003,4,14,28,-14,17,0
45510,4,27,26,1,4,0
352791,1,14,0,14,3,0
368312,4,9,19,-10,11,1
324657,1,0,6,-6,8,0
105596,4,32,28,4,14,1
75813,4,42,33,9,1,1
265719,1,0,0,0,16,1
128276,4,20,7,13,7,0
303936,3,14,30,-16,16,0
166246,1,0,3,-3,6,1
372878,2,10,0,10,13,0
25671,2,7,7,0,12,0
281711,4,31,30,1,6,1
79338,3,22,3,19,2,1
338983,3,13,3,10,15,1
295800,5,27,24,3,12,0
150605,3,3,16,-13,17,1
237465,1,7,0,7,3,1
29641,4,14,21,-7,14,0
271403,2,7,0,7,1,0
64462,3,21,13,8,13,0
56102,2,14,7,7,9,1
203666,3,14,20,-6,6,0
102700,4,32,31,1,13,0
191858,3,20,10,10,1,0
345768,4,19,10,9,17,0
121205,3,21,20,1,3,0
197645,4,33,7,26,3,1
351268,4,28,17,11,3,1
158358,3,16,17,-1,3,1
166653,4,28,20,8,6,1
107966,4,6,13,-7,15,1
27987,4,30,17,13,13,0
40890,2,13,17,-4,2,1
93963,1,0,7,-7,9,1
173124,1,3,7,-4,9,0
225140,1,0,0,0,15,1
360515,4,17,21,-4,7,1
171313,2,7,3,4,9,1
381828,3,7,14,-7,17,1
169529,3,3,28,-25,8,1
68724,4,34,0,34,15,0
55740,4,23,29,-6,9,0
68621,1,7,0,7,15,1
258435,3,21,13,8,13,0
116251,1,10,0,10,1,0
389634,2,17,10,7,3,0
77640,2,0,7,-7,1,0
206966,1,13,0,13,7,1
16692,4,21,30,-9,8,1
32138,4,24,21,3,15,0
398213,3,28,10,18,7,0
92620,4,17,3,14,8,0
249207,2,9,7,2,9,1
322813,3,3,27,-24,7,0
128011,1,0,0,0,7,1
318463,3,31,7,24,5,1
114869,4,16,33,-17,1,0
200703,1,7,0,7,4,1
354646,3,10,7,3,4,0
391681,2,0,3,-3,4,1
406620,1,0,0,0,11,1
26935,4,13,6,7,13,0
15140,1,0,0,0,8,1
23612,2,7,7,0,12,0
409947,2,0,14,-14,12,1
104722,1,3,13,-10,14,1
115890,3,7,23,-16,1,1
285109,3,3,0,3,7,1
312340,2,7,17,-10,3,1
62735,2,14,0,14,12,0
343208,2,10,0,10,16,0
144011,4,21,10,11,14,0
95949,1,0,0,0,10,0
70302,2,10,10,0,15,0
130164,2,0,16,-16,8,1
258792,1,7,0,7,13,0
153106,2,6,10,-4,1,1
324002,4,17,16,1,8,0
392648,3,13,0,13,4,1
340066,4,17,12,5,15,0
111760,1,3,0,3,17,0
25456,4,13,17,-4,12,1
165894,4,6,19,-13,6,1
420369,4,20,13,7,17,0
75028,4,34,17,17,17,1
164033,2,3,3,0,5,0
54573,4,28,18,10,8,0
155581,3,23,10,13,2,1
73216,3,7,6,1,16,0
102274,2,7,7,0,13,1
301552,1,0,0,0,15,1
147141,3,17,46,-29,15,1
111298,4,17,19,-2,16,1
373750,4,19,21,-2,13,0
59124,4,26,39,-13,10,0
207557,2,14,0,14,7,0
16348,2,7,7,0,8,1
52450,1,0,0,0,7,1
355268,3,14,14,0,4,1
156622,2,3,0,3,2,0
327900,4,30,24,6,10,1
272677,2,9,3,6,2,1
36250,4,10,27,-17,17,1
73566,4,9,41,-32,17,0
124120,3,10,21,-11,5,1
301098,4,33,13,20,15,1
374869,3,14,3,11,14,1
278890,1,0,7,-7,5,1
264965,4,23,17,6,16,1
8324,2,9,3,6,4,1
47286,1,0,7,-7,5,0
329447,1,0,0,0,10,1
333625,1,0,0,0,12,1
75885,2,21,7,14,1,0
407368,1,0,0,0,11,0
126501,2,0,6,-6,6,0
62374,1,0,7,-7,12,1
109260,2,6,0,6,15,1
281180,3,21,13,8,6,1
49402,4,17,20,-3,6,0
224693,4,19,17,2,15,0
47957,2,3,21,-18,5,0
128231,3,20,7,13,7,0
2362,1,0,3,-3,2,0
217524,4,19,3,16,12,1
57987,4,13,20,-7,10,1
137273,4,7,20,-13,11,1
284851,4,29,30,-1,7,1
284013,2,3,0,3,7,0
59350,3,0,9,-9,11,0
285821,4,14,24,-10,8,0
373428,4,10,17,-7,13,1
397387,1,0,3,-3,6,0
420130,2,0,0,0,17,0
342164,4,15,19,-4,16,1
262989,2,7,0,7,15,0
148305,2,7,3,4,16,1
307322,2,14,19,-5,17,1
320283,3,14,21,-7,6,1
295520,2,14,7,7,12,1
383985,3,3,13,-10,1,0
286137,4,16,17,-1,8,1
363820,2,13,10,3,8,1
405102,2,0,10,-10,10,1
325675,4,31,7,24,9,1
389302,1,0,6,-6,3,1
349633,4,13,28,-15,2,0
90060,4,18,24,-6,7,0
189440,2,7,0,7,17,1
232615,1,0,0,0,1,1
360396,1,0,0,0,7,1
367593,3,28,12,16,10,0
51658,4,27,20,7,7,0
302862,4,12,23,-11,15,0
254013,2,6,13,-7,11,1
141924,1,7,0,7,13,1
25320,4,39,14,25,12,1
51617,3,14,13,1,7,1
188598,4,20,13,7,16,0
238281,4,10,24,-14,4,1
38099,3,6,6,0,1,1
153979,2,7,7,0,1,0
196517,2,10,3,7,2,1
381538,3,20,13,7,17,1
177186,1,0,0,0,11,0
418173,3,24,6,18,16,0
120883,3,14,24,-10,3,1
98260,2,7,24,-17,11,1
180972,3,24,21,3,13,0
15528,4,23,6,17,8,0
85395,4,31,10,21,5,0
37476,2,7,7,0,17,0
402458,3,21,15,6,9,1
45687,1,0,0,0,4,1
223705,3,23,13,10,15,1
404045,3,10,28,-18,10,1
89340,1,3,6,-3,7,1
110216,1,0,0,0,16,0
136979,4,17,13,4,11,1
84856,2,20,10,10,4,1
271060,4,28,28,0,1,0
49012,2,10,7,3,6,1
66755,2,7,3,4,14,0
347450,2,6,13,-7,1,1
119884,5,24,27,-3,3,0
324928,4,23,23,0,8,1
282216,2,3,0,3,6,1
91325,2,7,7,0,8,0
126392,4,20,14,6,6,0
237333,2,0,0,0,3,0
199599,4,41,17,24,4,0
378729,2,14,7,7,15,0
121771,1,0,0,0,4,0
111364,2,0,7,-7,16,1
409717,3,10,6,4,12,0
73686,4,13,9,4,17,0
253162,1,0,0,0,11,0
88565,1,3,0,3,6,1
217372,4,21,10,11,12,0
139338,4,20,13,7,12,1
49805,2,14,7,7,6,0
67933,3,19,3,16,14,1
350657,4,20,3,17,2,0
369333,4,21,20,1,11,0
225455,2,0,7,-7,15,1
221715,2,10,0,10,14,1
138572,5,31,37,-6,12,0
267740,4,16,34,-18,17,1
36490,2,10,6,4,17,0
348247,3,16,36,-20,1,0
86669,2,7,0,7,5,0
325482,3,19,3,16,8,0
355019,4,10,19,-9,4,0
258089,2,13,6,7,13,0
41532,4,18,7,11,2,1
383451,4,16,12,4,17,0
376105,3,0,3,-3,14,1
233430,2,17,3,14,2,0
107149,1,0,7,-7,15,0
372787,3,3,0,3,13,0
411027,2,17,14,3,13,0
59648,3,21,6,15,11,1
399640,3,13,6,7,8,1
223243,3,3,6,-3,15,0
247486,4,20,19,1,8,1
390349,2,7,7,0,3,1
347372,4,21,21,0,1,1
136569,2,9,13,-4,11,0
53690,2,0,0,0,8,0
79499,4,12,17,-5,2,0
277522,2,3,7,-4,4,1
121897,4,0,26,-26,4,0
321808,4,21,9,12,7,1
379392,1,0,0,0,16,1
42973,4,31,23,8,3,1
259154,3,14,13,1,13,1
378350,4,12,13,-1,15,1
379723,2,6,0,6,16,1
6352,1,0,10,-10,3,1
397887,2,7,3,4,7,0
64420,2,0,6,-6,13,1
171145,2,3,0,3,8,1
168369,4,24,27,-3,7,0
215838,4,51,20,31,11,1
76289,1,3,0,3,1,0
1213,2,10,6,4,1,1
131987,2,0,17,-17,8,1
122504,4,20,36,-16,4,1
53154,4,19,38,-19,7,1
248916,2,17,0,17,9,0
260528,3,27,0,27,14,0
142559,1,0,0,0,13,0
419901,3,6,18,-12,17,0
320860,2,3,14,-11,6,1
349185,4,27,14,13,2,1
173148,2,10,14,-4,9,1
124590,3,6,17,-11,5,0
243776,3,17,17,0,6,1
169324,1,3,7,-4,8,0
84757,3,10,24,-14,4,1
65581,2,6,6,0,13,0
153800,4,2,27,-25,1,1
401798,1,7,0,7,9,0
352287,4,3,6,-3,3,1
358042,4,31,22,9,6,0
298101,3,3,24,-21,13,0
419432,2,10,3,7,16,0
346609,1,7,0,7,1,0
110692,1,0,0,0,16,0
282582,4,23,24,-1,6,1
397736,3,9,14,-5,7,0
14565,1,0,7,-7,7,1
65331,3,3,21,-18,13,1
282937,2,7,0,7,6,0
111360,2,0,7,-7,16,0
255202,2,10,7,3,12,0
204362,1,0,0,0,6,0
102349,3,13,13,0,13,0
176117,1,7,7,0,11,1
299685,2,14,3,11,14,1
188532,2,3,3,0,16,1
137882,3,17,8,9,11,0
203897,5,37,37,0,6,1
341246,3,16,13,3,16,0
272291,4,12,10,2,2,1
318558,2,10,0,10,5,0
350334,3,21,3,18,2,1
261137,4,21,24,-3,14,1
267285,3,17,17,0,17,1
360508,4,17,14,3,7,0
304593,1,0,0,0,16,0
166403,2,10,7,3,6,1
362494,2,7,6,1,8,1
177163,4,40,13,27,11,1
144761,4,3,16,-13,14,0
52919,1,0,0,0,7,1
149966,2,14,3,11,16,0
45537,1,0,0,0,4,0
10558,4,40,0,40,5,1
57024,2,7,10,-3,9,0
361748,1,7,0,7,7,1
363491,1,0,2,-2,8,0
25903,4,38,17,21,12,0
320508,4,26,24,2,6,0
204317,4,0,10,-10,6,0
63623,3,13,26,-13,12,0
393116,3,24,3,21,4,0
134649,4,31,24,7,10,1
333910,1,0,7,-7,12,1
174218,3,3,26,-23,10,1
248991,4,27,3,24,9,0
156668,3,6,7,-1,2,0
295822,1,0,0,0,12,0
389736,1,3,0,3,3,1
417665,3,21,6,15,16,1
262114,2,14,3,11,15,0
228810,2,6,14,-8,17,0
64280,2,3,3,0,13,0
354282,1,7,0,7,4,0
151160,2,3,10,-7,17,1
7869,2,3,14,-11,4,0
394855,1,0,14,-14,5,0
200795,4,31,17,14,4,1
88816,3,13,13,0,6,0
26766,3,6,27,-21,13,0
196200,1,7,0,7,2,0
135802,2,7,14,-7,10,1
43550,3,17,3,14,3,1
97169,1,0,3,-3,10,1
417513,3,24,21,3,16,0
184724,4,20,27,-7,15,0
11322,1,14,0,14,6,0
49796,2,7,7,0,6,1
388613,2,14,0,14,3,0
359468,2,0,14,-14,6,0
121656,2,0,7,-7,4,1
149963,2,14,3,11,16,0
14186,3,0,30,-30,7,0
317898,1,0,0,0,5,0
89762,1,0,0,0,7,1
53962,4,20,25,-5,8,1
300650,3,17,3,14,15,0
404527,4,31,27,4,10,1
70124,2,13,0,13,15,0
188604,4,20,13,7,16,1
122782,4,10,27,-17,4,0
32291,4,30,28,2,15,0
79502,4,12,17,-5,2,1
420368,4,20,13,7,17,0
180353,3,15,14,1,13,1
14914,3,14,17,-3,7,1
221057,4,21,42,-21,14,0
47626,1,3,17,-14,5,1
78724,2,13,7,6,2,0
348087,3,0,19,-19,1,1
203705,4,22,30,-8,6,0
89296,4,15,7,8,7,0
392198,3,10,13,-3,4,0
215876,1,3,7,-4,11,0
212198,3,3,24,-21,10,0
355321,4,14,20,-6,4,0
279385,2,13,14,-1,5,0
419915,4,13,18,-5,17,1
111193,1,7,0,7,16,0
86394,2,7,7,0,5,1
225939,3,27,7,20,16,0
127418,1,0,0,0,6,1
348145,4,24,22,2,1,0
337863,1,0,0,0,14,1
97375,3,9,13,-4,10,1
121522,2,9,7,2,4,1
16755,2,3,7,-4,8,0
44477,4,20,12,8,3,1
161033,4,30,7,23,4,0
240108,1,6,0,6,5,0
105485,1,20,0,20,14,0
225397,4,27,35,-8,15,1
143348,2,7,13,-6,14,0
298720,4,19,21,-2,14,1
195070,3,7,23,-16,2,1
273867,1,0,0,0,2,1
404156,2,6,7,-1,10,1
123909,1,0,0,0,5,1
188655,1,0,0,0,16,0
259623,3,6,3,3,13,0
246957,3,20,16,4,8,0
257408,4,20,14,6,13,1
247381,1,3,6,-3,8,1
334860,3,24,3,21,13,0
291629,4,23,13,10,11,0
59372,4,0,16,-16,11,0
296272,2,0,3,-3,13,0
406542,3,14,30,-16,11,1
113795,4,13,17,-4,17,1
268706,1,0,0,0,17,1
325298,2,6,10,-4,8,1
394877,2,0,14,-14,5,0
106085,1,0,0,0,14,0
180458,2,14,7,7,13,0
286619,4,17,41,-24,8,1
209631,1,0,0,0,8,0
336647,5,7,7,0,14,0
172630,1,0,0,0,9,1
29288,3,21,7,14,14,0
297179,1,0,0,0,13,0
98286,3,14,27,-13,11,1
91283,2,7,0,7,8,1
362813,3,7,21,-14,8,0
64853,2,7,0,7,13,0
90047,4,17,21,-4,7,1
212569,1,7,9,-2,10,0
44956,1,0,0,0,4,1
381297,4,31,28,3,16,1
49068,3,10,13,-3,6,1
79647,4,24,14,10,2,0
233397,1,7,0,7,2,1
101262,3,10,7,3,12,0
342073,1,3,0,3,16,0
278359,3,17,14,3,4,0
210442,2,9,14,-5,9,1
320636,4,38,18,20,6,0
194863,1,0,7,-7,2,0
386920,2,7,14,-7,2,0
91048,3,9,0,9,7,0
1436,4,19,0,19,1,0
47552,3,37,6,31,5,1
413995,3,3,30,-27,14,0
2886,4,31,31,0,2,1
67060,3,10,9,1,14,1
389676,4,24,16,8,3,0
339545,2,7,7,0,15,1
279152,4,21,23,-2,5,0
114444,1,0,0,0,1,0
368305,4,9,12,-3,11,0
330386,3,7,20,-13,11,1
198814,3,6,16,-10,3,0
122100,2,10,13,-3,4,0
229927,4,29,20,9,17,1
254491,4,29,13,16,11,1
397686,1,3,0,3,7,0
339609,3,24,14,10,15,0
376875,4,28,14,14,15,0
1067,2,7,22,-15,1,0
45876,2,7,3,4,4,1
208124,1,0,0,0,8,1
405995,4,21,7,14,11,1
90759,3,17,7,10,7,1
156934,2,7,10,-3,2,0
41182,2,0,7,-7,2,1
134658,4,34,24,10,10,0
120329,4,24,13,11,3,1
270226,2,3,14,-11,1,0
6732,4,3,23,-20,3,1
349487,4,9,20,-11,2,1
224760,2,5,3,2,15,0
148616,3,7,9,-2,16,0
271695,1,6,3,3,2,0
139334,4,20,13,7,12,0
151902,2,13,7,6,17,1
35176,2,0,14,-14,16,0
150233,4,6,26,-20,16,0
335649,1,0,0,0,13,0
190290,4,7,14,-7,17,0
208368,3,17,30,-13,8,0
331499,4,9,35,-26,11,1
353617,4,38,7,31,4,1
421253,3,16,7,9,17,0
363637,1,0,7,-7,8,1
358578,3,13,9,4,6,1
34626,4,24,10,14,16,1
303518,4,37,17,20,16,0
388410,1,0,3,-3,2,0
118787,1,10,0,10,2,1
404374,4,20,6,14,10,1
139283,3,13,13,0,12,0
144036,4,21,22,-1,14,0
226467,3,7,10,-3,16,1
226773,4,7,20,-13,16,0
172238,3,14,13,1,9,0
130522,3,10,6,4,8,1
133865,1,0,3,-3,9,0
398338,2,3,13,-10,7,1
214688,1,0,0,0,11,1
129639,4,23,23,0,7,1
149987,2,14,3,11,16,1
106738,2,14,12,2,14,0
330890,4,13,24,-11,11,1
49813,3,14,10,4,6,0
118808,2,13,0,13,2,0
56668,1,0,0,0,9,0
198370,4,20,14,6,3,0
248311,3,17,7,10,8,0
364286,3,3,29,-26,9,1
185786,4,25,3,22,15,1
234228,4,20,17,3,2,1
182542,4,35,21,14,14,1
408534,4,10,13,-3,12,1
50987,2,0,7,-7,6,0
415644,4,30,13,17,15,0
418324,3,9,21,-12,16,0
222976,3,13,13,0,14,1
23289,2,0,10,-10,11,1
193123,3,13,6,7,1,1
183769,1,7,14,-7,14,1
212326,3,10,3,7,10,1
273354,3,35,0,35,2,0
384903,4,13,36,-23,1,1
134996,4,14,27,-13,10,0
365727,2,10,9,1,9,0
102493,3,24,3,21,13,1
15616,2,14,10,4,8,1
368838,2,17,0,17,11,0
398955,4,23,19,4,7,0
149247,2,7,13,-6,16,1
258292,3,21,12,9,13,0
123869,4,17,3,14,5,1
325874,1,0,0,0,9,0
148349,3,14,3,11,16,1
364682,2,3,0,3,9,1
13797,4,7,27,-20,7,0
12763,4,59,0,59,6,1
290168,1,3,0,3,10,1
215119,1,0,0,0,11,0
36061,2,23,0,23,17,1
395108,4,17,31,-14,5,0
253732,3,10,10,0,11,1
176188,3,14,17,-3,11,1
54859,4,23,3,20,8,1
87745,4,6,20,-14,6,1
230333,4,19,17,2,17,1
330851,3,13,17,-4,11,0
84255,2,0,7,-7,4,1
58107,2,10,10,0,10,0
50148,3,0,17,-17,6,0
349854,2,3,3,0,2,1
113867,2,7,3,4,17,0
241729,3,7,9,-2,5,1
94271,1,0,0,0,9,1
108844,3,7,10,-3,15,1
172241,3,14,13,1,9,1
337377,4,21,7,14,14,0
396365,2,20,6,14,6,0
401537,2,7,14,-7,8,1
196012,4,7,30,-23,2,1
78714,2,13,7,6,2,0
199314,1,0,0,0,4,0
375091,1,0,0,0,14,0
246200,3,20,6,14,7,1
156533,4,7,6,1,2,1
133676,4,24,35,-11,9,1
420271,1,7,0,7,17,1
14302,2,2,7,-5,7,1
247808,1,0,0,0,8,0
235111,2,0,10,-10,2,0
51153,2,17,3,14,7,0
12951,1,0,0,0,6,0
41740,1,0,0,0,2,0
402081,1,3,0,3,9,0
5068,2,10,0,10,3,1
331100,1,0,6,-6,11,1
106825,4,34,29,5,14,0
380583,4,21,27,-6,16,0
170173,4,17,20,-3,8,0
291136,3,15,13,2,10,1
386835,3,13,21,-8,2,1
103706,4,3,17,-14,13,0
1327,1,0,0,0,1,0
130129,1,0,3,-3,8,1
278251,4,34,35,-1,4,1
9435,2,9,0,9,5,1
282275,4,25,14,11,6,0
18211,4,29,20,9,9,0
59415,1,0,7,-7,11,1
290588,4,26,20,6,10,0
194538,1,0,0,0,2,1
187045,1,3,0,3,16,0
205392,4,27,0,27,6,0
347353,4,14,21,-7,1,1
279289,4,19,16,3,5,1
360927,3,24,3,21,7,1
290150,1,3,0,3,10,1
372982,4,28,13,15,13,0
331430,2,6,7,-1,11,1
162390,4,10,19,-9,4,0
64317,3,6,13,-7,13,0
241780,4,10,15,-5,5,0
380360,2,10,10,0,16,1
41686,4,31,7,24,2,0
382906,1,0,7,-7,17,0
4901,2,14,7,7,3,1
396803,1,0,7,-7,6,1
185850,2,3,3,0,15,1
394564,1,0,0,0,5,1
373668,2,0,12,-12,13,1
353397,2,16,0,16,4,0
185730,2,20,3,17,15,0
381722,4,20,31,-11,17,1
263338,3,24,7,17,15,0
218358,4,20,26,-6,12,0
90307,3,7,17,-10,7,0
327564,3,7,15,-8,10,1
168896,3,17,6,11,7,1
224891,2,0,6,-6,15,1
414970,2,10,7,3,15,0
117759,1,0,6,-6,2,1
373380,3,10,7,3,13,1
226473,3,7,10,-3,16,1
360637,4,10,20,-10,7,0
125398,1,0,0,0,5,1
157252,2,7,3,4,2,1
31827,4,16,24,-8,15,0
285280,3,14,6,8,7,0
356745,4,29,24,5,5,0
188395,2,3,0,3,16,0
61866,3,20,23,-3,12,0
369846,2,6,0,6,12,1
234991,3,13,17,-4,2,1
81945,4,7,36,-29,3,0
93069,4,20,20,0,8,1
8080,3,17,7,10,4,0
107588,2,6,7,-1,15,0
326463,2,17,3,14,9,1
84943,4,48,23,25,4,1
374647,1,0,0,0,14,1
10672,4,10,17,-7,5,0
365892,3,14,14,0,9,1
76645,2,10,0,10,1,0
282080,2,6,8,-2,6,1
341380,3,0,10,-10,16,1
413723,3,21,13,8,14,0
238619,1,6,0,6,4,0
288454,4,19,7,12,9,1
342229,2,3,0,3,16,0
186422,1,9,7,2,15,1
293513,2,10,10,0,11,0
251135,4,10,17,-7,10,0
402277,3,13,16,-3,9,0
186243,1,3,0,3,15,0
51045,3,0,20,-20,6,1
146628,1,0,7,-7,15,0
1467,1,0,0,0,1,1
54136,1,0,0,0,8,0
125829,4,17,23,-6,5,1
84555,1,0,7,-7,4,1
152457,1,7,0,7,17,1
356798,2,0,0,0,5,0
285427,3,27,0,27,8,0
401472,4,27,10,17,8,1
415702,2,7,3,4,15,0
240110,1,6,0,6,5,0
375950,3,17,12,5,14,1
215623,2,14,6,8,11,0
184183,1,0,0,0,14,1
4362,3,7,7,0,2,1
2340,1,0,3,-3,2,1
385816,4,30,3,27,1,1
149129,3,17,24,-7,16,1
365300,3,10,16,-6,9,1
326703,4,23,13,10,9,0
589,4,21,34,-13,1,0
204032,4,16,7,9,6,0
138451,2,14,7,7,12,0
142784,3,12,10,2,13,0
85809,3,13,13,0,5,0
348880,4,6,14,-8,2,1
59881,1,0,0,0,11,1
331306,3,0,24,-24,11,1
357622,5,16,16,0,5,0
112350,1,3,0,3,17,0
297356,2,3,10,-7,13,1
159403,3,10,20,-10,3,1
410739,3,17,6,11,13,0
263336,3,24,7,17,15,0
276927,2,14,14,0,4,1
174386,3,17,3,14,10,1
109836,2,10,0,10,16,1
323612,1,7,0,7,8,0
10573,1,0,0,0,5,0
318703,2,3,20,-17,5,1
404719,1,0,3,-3,10,1
364945,1,7,0,7,9,0
79291,2,12,3,9,2,0
69184,4,17,17,0,15,1
185540,2,10,3,7,15,0
5007,1,0,0,0,3,1
134655,4,34,24,10,10,0
343293,1,0,3,-3,16,1
264424,3,3,28,-25,15,0
4044,2,10,14,-4,2,1
398813,4,20,24,-4,7,1
325394,1,0,0,0,8,0
214143,3,3,6,-3,11,0
377114,2,10,10,0,15,0
126316,2,7,7,0,6,0
79953,4,13,23,-10,2,0
91139,2,3,7,-4,8,0
357724,3,40,13,27,5,0
326349,2,14,10,4,9,0
269227,3,3,6,-3,17,1
102478,3,17,3,14,13,1
18180,4,20,20,0,9,1
218220,4,37,3,34,12,0
344436,4,28,24,4,17,0
152351,2,14,3,11,17,0
371229,4,22,19,3,12,0
126344,2,7,14,-7,6,0
152177,1,7,0,7,17,1
411697,1,0,0,0,13,0
334633,1,0,0,0,13,1
95090,2,0,7,-7,9,0
18390,1,0,0,0,9,0
151180,2,3,17,-14,17,0
315460,1,0,0,0,4,0
153746,3,2,21,-19,1,0
363064,1,7,0,7,8,0
403844,1,3,0,3,10,1
38396,3,17,16,1,1,0
376530,2,6,6,0,14,0
331475,3,9,21,-12,11,0
150638,4,10,22,-12,17,0
317263,4,7,16,-9,5,0
396277,3,3,3,0,6,0
40599,2,24,7,17,2,0
232613,1,0,0,0,1,0
153996,2,7,14,-7,1,1
206272,3,10,6,4,7,1
268576,2,7,3,4,17,1
105740,4,35,10,25,14,1
43951,2,3,7,-4,3,1
409640,1,0,0,0,12,0
150437,2,20,3,17,16,0
33916,2,0,17,-17,16,0
56497,1,7,0,7,9,0
230440,3,21,11,10,1,1
21779,4,31,24,7,11,0
80144,1,7,0,7,2,0
143028,1,0,6,-6,13,0
5479,1,0,3,-3,3,1
163390,2,0,6,-6,5,1
404009,2,3,14,-11,10,1
363036,4,33,34,-1,8,1
370133,2,10,3,7,12,0
130730,1,0,0,0,8,1
119024,4,7,26,-19,3,0
82840,4,15,16,-1,3,0
139215,1,3,6,-3,12,1
321568,2,3,6,-3,7,1
172203,2,0,6,-6,9,1
365222,1,0,0,0,9,0
249706,3,21,14,7,9,1
90115,2,0,0,0,7,0
268286,2,10,3,7,17,1
349870,2,3,3,0,2,1
381714,4,20,24,-4,17,0
78052,4,12,23,-11,1,1
275489,3,20,17,3,3,0
377274,3,14,6,8,15,1
270162,4,27,27,0,1,1
276901,1,7,0,7,4,1
119852,4,24,21,3,3,0
415684,1,0,0,0,15,0
317948,2,10,3,7,5,0
14125,1,0,14,-14,7,1
335224,1,0,0,0,13,1
141264,4,10,24,-14,13,1
73770,2,3,0,3,17,0
119982,3,23,24,-1,3,0
359316,2,3,13,-10,6,1
408949,3,24,15,9,12,0
59988,4,3,24,-21,11,0
322275,1,0,0,0,7,1
127116,2,3,9,-6,6,1
392223,4,10,16,-6,4,0
77491,2,0,7,-7,1,1
227035,3,10,6,4,16,1
11423,4,26,0,26,6,1
2893,4,31,31,0,2,0
419540,1,0,7,-7,17,1
305637,1,0,0,0,17,1
82557,4,17,27,-10,3,1
26455,3,27,16,11,13,0
331260,1,0,7,-7,11,1
361916,2,7,0,7,7,0
240492,3,3,7,-4,5,0
90046,4,11,21,-10,7,1
393245,3,14,20,-6,5,1
185076,2,0,3,-3,15,0
388092,1,3,0,3,2,0
239942,1,0,0,0,5,1
247551,2,13,10,3,8,0
305204,1,7,0,7,16,0
340819,4,24,16,8,15,1
182648,3,0,6,-6,14,0
138552,5,31,37,-6,12,0
64685,2,14,0,14,13,0
74089,2,9,0,9,17,1
100387,4,9,20,-11,12,0
32463,1,7,0,7,15,0
320064,1,3,0,3,6,1
288867,3,10,24,-14,9,1
171944,3,14,7,7,9,0
213348,2,10,6,4,10,0
338689,3,20,10,10,14,1
292678,4,22,16,6,11,1
124560,2,6,7,-1,5,1
48159,3,10,13,-3,5,1
218552,1,0,14,-14,13,1
199584,4,34,17,17,4,1
374625,4,23,20,3,14,0
120248,2,14,3,11,3,0
336516,1,0,0,0,14,0
200714,2,7,0,7,4,0
410500,4,18,26,-8,13,1
37422,4,24,0,24,17,0
341444,1,0,0,0,16,1
335681,1,7,6,1,13,0
62180,4,10,17,-7,12,1
108674,2,27,10,17,15,1
354649,3,10,7,3,4,0
71645,3,3,31,-28,16,1
203754,2,13,7,6,6,1
257422,4,23,14,9,13,0
242295,2,10,7,3,6,1
132024,4,3,24,-21,8,1
83706,3,22,20,2,4,0
5817,3,27,7,20,3,0
308590,3,9,16,-7,1,1
177966,2,7,3,4,12,1
340833,4,24,16,8,15,0
418704,2,0,7,-7,16,1
74071,2,9,0,9,17,1
256680,1,0,0,0,12,0
300224,4,31,10,21,14,0
142815,4,12,10,2,13,1
382803,2,21,0,21,17,1
93488,4,3,31,-28,9,0
367889,4,20,20,0,10,0
192612,2,3,7,-4,1,0
285686,5,27,27,0,8,0
308724,3,7,13,-6,1,1
190280,4,7,14,-7,17,0
262056,4,24,31,-7,14,0
68170,1,7,7,0,14,1
243529,1,0,0,0,6,1
263366,4,31,10,21,15,0
234506,3,20,20,0,2,1
352166,4,15,27,-12,3,1
171361,4,16,17,-1,9,1
247885,3,10,3,7,8,1
239045,4,36,21,15,4,1
31183,3,23,27,-4,15,0
34454,3,37,3,34,16,1
191584,4,21,24,-3,17,1
176382,4,16,28,-12,11,1
169443,4,13,31,-18,8,0
200437,2,13,18,-5,4,0
311463,2,3,3,0,2,1
313235,1,0,0,0,3,1
54232,3,0,3,-3,8,1
92229,1,7,0,7,8,0
274834,1,0,7,-7,3,1
106208,4,0,10,-10,14,1
40669,4,41,7,34,2,1
217355,4,21,10,11,12,1
208001,2,14,0,14,8,1
357479,1,0,3,-3,5,1
74228,2,3,7,-4,17,0
395677,3,10,27,-17,6,0
274383,2,3,10,-7,3,1
383899,4,3,10,-7,1,1
162628,2,3,10,-7,5,0
285691,5,27,27,0,8,1
411804,3,0,34,-34,13,0
249916,4,12,20,-8,9,1
397803,4,24,20,4,7,0
268915,3,6,30,-24,17,0
89477,1,0,0,0,7,1
390931,1,7,0,7,4,0
217615,3,19,9,10,12,0
117855,4,9,20,-11,2,1
87563,3,17,3,14,6,1
166189,4,28,19,9,6,1
58655,5,20,20,0,10,1
150984,1,0,0,0,17,0
237760,5,20,20,0,4,0
35943,3,3,7,-4,17,1
50757,4,21,14,7,6,0
357844,2,6,24,-18,6,0
16786,3,3,17,-14,8,0
58158,4,23,17,6,10,1
395627,2,7,17,-10,6,1
417944,1,7,14,-7,16,1
158009,1,0,3,-3,3,0
170335,4,0,15,-15,8,0
110439,2,17,0,17,16,1
250273,1,7,0,7,9,1
330219,2,7,7,0,11,1
346018,2,0,3,-3,1,1
218383,1,0,0,0,13,0
398631,3,0,0,0,7,0
152640,2,7,6,1,17,1
206726,3,7,14,-7,7,0
308116,3,13,19,-6,1,1
202072,1,0,0,0,5,1
340798,3,17,16,1,15,1
320635,4,38,18,20,6,0
200006,3,24,17,7,4,0
237929,1,0,0,0,4,1
365796,4,30,17,13,9,1
64456,3,14,13,1,13,1
349273,2,7,21,-14,2,1
14592,2,3,7,-4,7,0
27926,2,7,10,-3,13,1
220749,4,13,13,0,13,0
138284,1,10,0,10,11,1
105819,2,6,3,3,14,1
350072,4,27,13,14,2,0
159877,2,17,0,17,3,1
93532,1,0,0,0,9,1
334602,4,30,31,-1,13,1
23838,4,24,7,17,12,1
231913,3,7,41,-34,1,1
246185,2,14,3,11,7,0
406417,4,24,7,17,11,1
341111,4,14,17,-3,15,0
321415,2,14,17,-3,7,1
395580,1,0,3,-3,6,1
364314,4,3,32,-29,9,1
219704,4,13,14,-1,13,1
398971,4,23,20,3,7,0
270915,4,19,20,-1,1,0
371429,2,7,7,0,12,0
289422,1,0,0,0,10,1
18912,4,9,13,-4,9,1
48206,1,0,0,0,5,0
114253,4,10,17,-7,1,0
331457,3,9,7,2,11,0
363523,2,3,5,-2,8,1
224645,3,16,10,6,15,1
127274,1,9,7,2,6,1
168460,3,0,24,-24,7,0
403541,1,7,0,7,9,0
352870,4,14,13,1,3,1
97389,3,9,16,-7,10,1
368858,2,24,3,21,11,0
345549,2,7,17,-10,17,0
368554,2,9,0,9,11,0
340303,1,10,0,10,15,0
262673,4,32,16,16,15,1
129798,1,0,0,0,7,1
114575,1,0,0,0,1,1
280296,3,16,16,0,5,0
313249,1,3,0,3,3,0
388959,4,17,27,-10,3,0
372793,3,3,0,3,13,0
37277,4,13,21,-8,17,1
140078,1,0,0,0,12,0
341015,1,0,0,0,15,0
186797,3,26,7,19,15,1
128445,1,7,0,7,7,1
213578,4,17,14,3,10,1
58680,1,7,7,0,10,1
236321,2,0,22,-22,3,0
74854,3,20,20,0,17,0
223539,3,10,10,0,15,1
43981,3,3,14,-11,3,0
102896,2,3,14,-11,13,0
395323,1,14,0,14,5,1
182136,2,16,7,9,13,1
226911,3,3,10,-7,16,1
310560,1,3,6,-3,2,0
588,4,20,34,-14,1,1
57333,2,7,0,7,10,0
4300,1,0,0,0,2,0
121608,4,22,16,6,4,0
127745,2,0,14,-14,6,1
33803,2,0,24,-24,16,0
136686,1,0,7,-7,11,0
264144,4,20,27,-7,15,1
260681,3,10,22,-12,14,0
407861,2,3,7,-4,11,1
112197,4,27,34,-7,17,0
381944,2,0,13,-13,17,1
178960,3,9,3,6,12,1
290614,1,14,0,14,10,0
179224,2,14,3,11,12,1
328285,1,3,7,-4,10,1
49528,3,7,3,4,6,0
413634,4,17,24,-7,14,1
36827,3,17,26,-9,17,0
329314,1,6,14,-8,10,0
393875,3,13,17,-4,5,1
52693,3,3,13,-10,7,0
383363,2,0,6,-6,17,0
114117,4,21,7,14,17,0
261463,1,0,0,0,14,1
64589,2,10,14,-4,13,0
153948,1,6,0,6,1,1
210923,3,19,10,9,9,1
388798,3,14,7,7,3,1
183923,2,7,3,4,14,1
60651,2,7,3,4,11,0
258484,4,21,21,0,13,1
178979,3,12,3,9,12,0
288594,4,23,38,-15,9,0
263153,2,3,7,-4,15,0
234947,2,10,3,7,2,0
395925,2,10,0,10,6,0
310436,2,14,3,11,2,1
88052,3,24,3,21,6,1
297884,4,21,27,-6,13,0
226158,4,21,20,1,16,1
313056,4,20,0,20,3,1
156444,2,0,3,-3,2,0
33211,2,10,0,10,16,0
337755,2,13,0,13,14,0
121094,4,18,31,-13,3,1
230923,4,31,10,21,1,0
152705,4,27,6,21,17,0
111260,3,10,13,-3,16,1
57659,3,17,16,1,10,0
194923,3,7,10,-3,2,1
200158,3,7,31,-24,4,1
243772,3,17,17,0,6,0
347196,4,23,27,-4,1,0
339330,4,45,7,38,15,0
415643,4,30,13,17,15,0
102924,2,9,21,-12,13,1
257717,3,3,17,-14,13,0
400836,3,24,13,11,8,0
91576,1,0,7,-7,8,1
265126,4,20,10,10,16,0
120103,2,10,0,10,3,0
384793,1,6,3,3,1,1
218815,4,3,19,-16,13,1
11951,2,7,0,7,6,0
99327,3,13,3,10,11,1
162266,4,30,20,10,4,0
353886,3,10,21,-11,4,0
178136,1,0,7,-7,12,1
338460,1,7,0,7,14,0
8318,2,9,0,9,4,0
416956,4,10,10,0,15,1
169667,3,20,17,3,8,1
114143,4,31,14,17,17,1
176776,1,3,0,3,11,1
2079,2,0,7,-7,1,1
273792,3,10,7,3,2,0
189873,1,0,0,0,17,0
93055,4,19,12,7,8,1
228894,1,0,0,0,17,0
116731,2,13,17,-4,2,1
238051,4,13,13,0,4,1
332792,4,28,9,19,12,0
272466,4,31,24,7,2,0
245991,1,0,3,-3,7,0
41038,2,3,10,-7,2,0
90844,1,14,0,14,7,1
12839,2,13,3,10,6,1
202178,4,13,14,-1,5,0
63245,1,0,0,0,12,0
408173,3,6,0,6,12,1
219181,2,0,3,-3,13,0
177248,2,14,10,4,11,0
269769,2,7,0,7,1,0
27890,1,0,0,0,13,1
98561,2,0,7,-7,11,0
323020,1,7,0,7,7,0
372707,1,0,0,0,13,0
2135,4,10,16,-6,1,1
408570,1,7,0,7,12,1
262833,1,7,7,0,15,1
149120,3,17,17,0,16,0
361009,1,3,2,1,7,1
399140,1,0,3,-3,7,1
320759,3,17,23,-6,6,0
105386,3,23,7,16,14,0
173422,1,0,7,-7,10,0
209777,4,23,6,17,8,0
387127,3,10,31,-21,2,1
79914,3,3,16,-13,2,1
249456,5,18,18,0,9,0
197447,2,13,6,7,3,0
111841,3,6,10,-4,17,1
133714,1,0,0,0,9,0
411921,2,17,10,7,13,1
212637,3,7,31,-24,10,1
203299,2,0,24,-24,6,1
307979,3,14,6,8,1,0
291607,4,23,6,17,11,0
397265,1,0,14,-14,6,1
403202,3,17,17,0,9,1
371107,4,13,27,-14,12,0
81377,2,7,7,0,3,1
361553,4,13,10,3,7,1
337035,2,16,0,16,14,1
51136,2,10,3,7,7,0
162795,2,0,0,0,5,0
178605,1,3,3,0,12,1
310258,1,3,0,3,2,1
280077,1,6,0,6,5,1
6707,4,3,23,-20,3,0
414525,2,14,3,11,14,0
413750,4,24,16,8,14,0
235641,1,0,0,0,3,0
353324,4,38,31,7,4,1
258365,1,7,0,7,13,0
123346,3,21,14,7,4,0
43074,3,3,10,-7,3,1
139390,2,14,0,14,12,1
402615,3,20,16,4,9,1
334558,3,21,17,4,13,1
292286,2,6,7,-1,11,0
107699,1,0,0,0,15,1
197382,1,0,0,0,3,1
1945,2,3,2,1,1,1
372798,3,3,0,3,13,1
341253,4,16,13,3,16,1
118669,2,14,6,8,2,0
134069,3,20,13,7,9,0
91136,2,3,7,-4,8,0
99909,2,3,3,0,12,1
234574,1,7,0,7,2,1
308941,1,0,3,-3,1,1
252019,3,14,20,-6,10,0
76577,1,0,0,0,1,0
163304,3,13,16,-3,5,1
123942,2,7,0,7,5,1
261656,2,0,0,0,14,1
266920,2,13,0,13,17,0
154126,2,0,6,-6,1,0
98869,2,7,7,0,11,0
96587,2,3,3,0,10,1
102267,1,7,7,0,13,1
140738,2,15,14,1,12,0
79841,1,0,3,-3,2,0
109435,3,6,13,-7,16,1
355680,1,7,0,7,5,0
349265,2,7,21,-14,2,0
416820,4,19,10,9,15,1
283127,2,3,3,0,7,1
293702,4,10,13,-3,12,1
354729,1,6,0,6,4,0
238016,3,10,13,-3,4,1
164739,2,13,14,-1,6,1
236802,3,3,9,-6,3,1
329260,4,31,13,18,10,0
267244,2,10,14,-4,17,1
18460,3,7,7,0,9,0
72239,4,24,17,7,16,1
203315,2,13,24,-11,6,1
205399,4,27,0,27,6,1
249618,4,28,23,5,9,1
268398,1,7,0,7,17,0
130871,4,20,15,5,8,0
109157,3,31,7,24,15,0
138287,2,10,0,10,11,1
287346,3,13,3,10,8,1
76353,3,16,3,13,1,0
301544,4,20,24,-4,15,0
320779,4,17,23,-6,6,1
101745,3,13,10,3,12,0
232067,3,0,24,-24,1,0
258942,1,0,7,-7,13,1
230453,4,21,11,10,1,0
76181,2,9,13,-4,1,0
89486,1,0,0,0,7,1
112521,1,9,9,0,17,1
320573,2,24,0,24,6,0
97601,1,0,0,0,11,1
359829,1,0,7,-7,6,1
383789,2,3,7,-4,1,1
380468,1,0,0,0,16,0
165310,4,17,31,-14,6,1
25386,2,6,0,6,12,0
145892,2,0,0,0,15,0
160782,2,10,7,3,4,0
3059,4,22,41,-19,2,1
235080,2,0,7,-7,2,0
31055,3,10,13,-3,15,1
77952,2,3,10,-7,1,1
369484,4,48,7,41,11,0
80930,2,6,0,6,3,1
266001,1,0,0,0,16,1
185314,4,41,28,13,15,0
41631,2,14,0,14,2,1
8286,1,0,0,0,4,0
84571,2,7,7,0,4,1
329266,4,31,13,18,10,0
57977,4,13,17,-4,10,0
47911,1,0,0,0,5,1
250010,2,10,6,4,9,0
211707,3,23,16,7,9,1
134490,3,3,30,-27,10,1
202688,1,0,7,-7,5,1
11746,4,33,31,2,6,1
53793,5,10,10,0,8,1
178874,4,35,21,14,12,0
25477,4,13,17,-4,12,1
361116,4,23,16,7,7,0
377675,2,19,7,12,15,1
374513,1,7,0,7,14,0
64997,2,0,7,-7,13,0
30368,4,10,20,-10,14,1
235484,1,0,0,0,3,0
142279,2,0,0,0,13,0
318855,2,21,6,15,5,0
332530,4,30,16,14,12,1
78074,1,0,0,0,2,1
209391,3,14,7,7,8,1
76486,2,0,17,-17,1,0
227448,2,10,7,3,16,1
374113,2,13,7,6,13,1
416698,4,44,15,29,15,0
238648,2,6,14,-8,4,1
204834,1,3,0,3,6,0
222445,1,3,7,-4,14,0
288805,1,3,14,-11,9,1
367165,3,29,23,6,10,0
311651,3,6,6,0,2,1
189901,2,0,7,-7,17,0
308511,1,0,9,-9,1,1
6992,3,10,7,3,3,1
260415,4,20,7,13,14,0
197047,4,30,33,-3,3,0
94874,4,13,13,0,9,0
51619,3,21,13,8,7,0
40128,1,6,0,6,2,1
246968,3,20,24,-4,8,1
204046,4,16,14,2,6,0
370704,1,3,7,-4,12,0
209105,3,3,27,-24,8,1
164326,2,20,0,20,5,0
190304,4,7,20,-13,17,1
302699,4,23,20,3,15,0
207676,1,0,0,0,7,0
69894,4,27,16,11,15,1
85641,2,17,0,17,5,0
47918,1,0,0,0,5,1
298429,4,7,21,-14,14,0
66031,2,7,0,7,13,1
109641,4,37,14,23,16,1
230295,3,19,10,9,17,0
114122,4,21,14,7,17,1
403378,4,26,11,15,9,1
161104,2,3,16,-13,4,0
407929,4,17,24,-7,11,0
345963,4,27,23,4,17,0
316318,4,17,19,-2,4,0
228135,1,0,0,0,17,0
58477,4,48,23,25,10,0
419330,3,0,17,-17,16,1
251699,2,14,3,11,10,0
227004,2,3,6,-3,16,1
203535,4,31,3,28,6,0
261344,2,0,14,-14,14,1
343537,4,10,10,0,16,0
61221,1,7,0,7,11,1
143257,4,17,16,1,13,1
382368,2,0,7,-7,17,0
232387,4,13,22,-9,1,1
411351,3,17,10,7,13,1
372569,1,7,0,7,13,0
258148,3,13,13,0,13,1
208450,2,10,0,10,8,0
92638,4,20,10,10,8,0
36575,1,0,0,0,17,1
395439,1,0,0,0,6,0
235788,4,20,27,-7,3,0
383475,1,0,3,-3,17,1
289095,1,0,0,0,9,1
200932,4,40,7,33,4,0
18091,2,0,14,-14,9,1
38502,2,10,3,7,1,1
144867,2,14,6,8,14,0
266540,4,10,22,-12,16,1
187773,1,7,0,7,16,0
56786,4,14,13,1,9,1
93668,1,0,0,0,9,0
386052,2,14,0,14,1,0
362119,4,35,20,15,8,0
188334,1,0,0,0,16,0
165341,1,0,7,-7,6,1
246082,4,19,13,6,7,1
112351,1,3,0,3,17,0
174810,2,13,17,-4,10,0
56808,4,17,20,-3,9,0
311760,2,7,13,-6,2,0
97172,1,0,3,-3,10,1
316985,1,0,7,-7,4,1
158605,2,7,7,0,3,0
400794,2,14,7,7,8,0
20847,3,21,6,15,10,0
264865,1,0,7,-7,16,1
246153,2,7,0,7,7,0
113753,3,3,17,-14,17,0
95551,2,6,10,-4,10,1
259932,3,20,10,10,14,0
119934,2,6,14,-8,3,1
91145,2,3,14,-11,8,1
213011,1,0,0,0,10,1
213025,1,10,0,10,10,1
127288,2,10,7,3,6,0
331701,2,0,13,-13,12,1
44465,3,17,9,8,3,0
254587,2,7,14,-7,11,1
55189,1,7,0,7,9,1
294064,2,7,21,-14,12,0
400052,2,14,3,11,8,0
354132,4,22,0,22,4,1
311977,4,35,17,18,2,1
98059,5,24,24,0,11,0
355205,1,0,7,-7,4,0
27534,4,23,12,11,13,0
150254,1,0,0,0,16,1
341597,4,19,17,2,16,1
173041,3,21,6,15,9,1
113980,4,20,20,0,17,0
366034,3,37,14,23,10,0
100291,1,6,7,-1,12,1
157607,3,12,3,9,2,1
211163,2,0,10,-10,9,1
61694,3,17,10,7,12,0
64086,4,27,24,3,13,1
222784,2,10,7,3,14,1
165090,3,10,24,-14,6,0
104289,2,24,7,17,13,0
315575,4,7,14,-7,4,1
49583,4,21,10,11,6,0
329823,3,17,20,-3,11,0
341137,4,21,24,-3,15,1
121938,1,3,7,-4,4,1
107705,1,0,0,0,15,1
42676,3,7,10,-3,3,0
212702,1,0,7,-7,10,0
420706,4,21,19,2,17,0
356177,3,19,0,19,5,1
13790,3,7,27,-20,7,0
347617,2,14,10,4,1,1
254247,1,6,3,3,11,0
118954,2,0,17,-17,3,1
251756,4,30,9,21,10,0
265751,2,3,3,0,16,1
203333,2,14,27,-13,6,1
183603,1,0,0,0,14,0
108514,2,14,7,7,15,0
179300,4,33,3,30,12,0
234843,3,0,12,-12,2,0
25025,4,16,21,-5,12,0
59665,4,21,6,15,11,0
256508,1,0,0,0,12,0
16139,4,40,17,23,8,0
155553,3,23,3,20,2,0
397865,2,0,3,-3,7,1
398854,1,0,0,0,7,1
39268,3,3,13,-10,1,1
83031,1,3,0,3,4,0
317819,3,9,3,6,5,1
87284,3,17,17,0,6,1
22287,2,0,3,-3,11,1
122459,3,13,26,-13,4,0
62454,3,7,13,-6,12,0
13521,1,0,0,0,7,0
45632,3,13,13,0,4,0
309680,2,3,3,0,1,0
62596,2,6,17,-11,12,1
279990,2,3,13,-10,5,0
331551,2,7,14,-7,11,1
173397,1,0,0,0,10,0
69355,1,0,0,0,15,1
392718,4,16,6,10,4,1
159002,4,27,29,-2,3,0
323394,3,17,0,17,7,1
173001,2,14,0,14,9,0
382101,2,21,3,18,17,1
154534,1,0,0,0,1,1
112314,4,45,17,28,17,1
90830,1,7,0,7,7,0
64118,1,0,0,0,13,0
362224,3,6,17,-11,8,1
133233,4,23,20,3,9,0
187438,4,41,14,27,16,0
194327,3,16,6,10,2,1
322530,4,15,3,12,7,1
217600,3,6,9,-3,12,0
229017,4,21,16,5,17,1
281111,1,0,0,0,6,1
51355,4,19,20,-1,7,0
206626,4,10,16,-6,7,0
398956,4,23,20,3,7,1
139129,3,12,6,6,12,0
377790,1,0,0,0,15,0
30424,2,10,16,-6,14,1
399739,2,0,10,-10,8,1
262174,4,28,13,15,15,1
254612,3,14,14,0,11,1
346697,3,21,6,15,1,1
288667,2,0,7,-7,9,0
155935,4,17,16,1,2,1
260009,1,0,0,0,14,1
333897,1,0,0,0,12,0
370343,4,20,35,-15,12,1
88637,3,20,10,10,6,1
50810,1,0,7,-7,6,1
189885,1,0,7,-7,17,0
50656,1,0,0,0,6,0
209264,4,27,7,20,8,1
72619,2,13,0,13,16,0
333305,1,7,0,7,12,0
143267,4,17,16,1,13,0
50803,1,0,7,-7,6,1
177781,1,0,0,0,12,1
379841,1,7,0,7,16,0
1476,1,0,3,-3,1,1
62711,2,0,0,0,12,1
316122,3,24,16,8,4,1
97574,4,37,7,30,10,1
146952,2,14,0,14,15,1
203625,2,7,7,0,6,0
199840,3,3,17,-14,4,1
299975,1,0,7,-7,14,0
327746,4,6,16,-10,10,1
385186,4,21,20,1,1,1
168774,4,16,9,7,7,0
280576,3,17,6,11,5,1
127753,2,7,14,-7,6,0
205191,3,14,13,1,6,0
109991,2,17,10,7,16,1
270480,1,0,0,0,1,1
35463,2,7,7,0,17,0
355576,2,21,3,18,5,0
95964,1,0,0,0,10,0
218419,2,10,14,-4,13,0
253557,2,6,7,-1,11,0
215609,2,14,3,11,11,1
105700,3,28,3,25,14,0
328495,3,6,3,3,10,1
219972,3,6,21,-15,13,1
74423,4,10,20,-10,17,1
242753,2,7,17,-10,6,1
346299,1,0,0,0,1,0
389342,2,20,6,14,3,0
310593,2,10,20,-10,2,1
49891,4,28,20,8,6,1
330865,3,13,17,-4,11,0
321790,4,21,9,12,7,1
184239,3,24,0,24,14,1
44611,3,20,21,-1,3,0
227871,2,10,6,4,16,0
190126,4,27,3,24,17,0
27829,4,14,14,0,13,1
253614,4,9,17,-8,11,0
96814,4,7,17,-10,10,1
38706,4,17,14,3,1,0
291086,1,12,10,2,10,1
388633,3,14,0,14,3,1
33502,2,14,0,14,16,0
268212,4,12,28,-16,17,1
302396,4,16,13,3,15,0
393292,4,24,29,-5,5,1
163437,3,7,20,-13,5,0
344616,1,0,3,-3,17,0
123884,1,0,0,0,5,1
176996,3,19,6,13,11,1
114177,2,0,0,0,1,1
172956,1,7,0,7,9,0
185256,3,24,9,15,15,0
295399,2,10,10,0,12,1
347530,4,20,37,-17,1,1
40071,4,20,14,6,1,0
108238,2,6,0,6,15,0
389980,3,28,25,3,3,0
385069,1,0,0,0,1,1
57402,4,14,6,8,10,1
354020,1,6,0,6,4,1
133590,2,3,7,-4,9,0
265570,1,0,2,-2,16,0
116948,4,28,13,15,2,1
5332,1,7,0,7,3,0
408473,3,7,3,4,12,0
282246,3,10,14,-4,6,1
280932,4,21,10,11,6,0
264604,4,12,17,-5,16,0
394742,2,14,0,14,5,0
77646,2,0,7,-7,1,0
44211,1,7,7,0,3,1
89488,1,0,0,0,7,1
119351,4,14,16,-2,3,1
228098,4,3,10,-7,17,1
32407,3,31,6,25,15,1
17225,3,7,31,-24,9,0
417799,1,7,0,7,16,0
200144,3,7,24,-17,4,0
52430,4,12,17,-5,7,1
248197,3,9,10,-1,8,1
82935,2,3,9,-6,4,0
223623,1,6,0,6,15,0
69398,2,7,3,4,15,1
118752,4,27,19,8,2,1
215840,4,51,20,31,11,1
142492,3,27,10,17,13,0
37507,3,7,7,0,17,1
393428,3,28,24,4,5,0
46160,2,7,14,-7,4,0
204494,4,17,24,-7,6,0
180177,3,13,0,13,13,1
196493,1,7,3,4,2,0
352405,3,35,10,25,3,1
48181,4,10,13,-3,5,1
45871,2,7,3,4,4,0
290765,1,0,0,0,10,1
213165,1,3,0,3,10,0
281413,1,0,3,-3,6,0
311898,2,7,7,0,2,1
270574,3,13,14,-1,1,1
249220,2,18,7,11,9,1
308652,1,0,6,-6,1,1
52324,1,3,0,3,7,0
51795,4,10,19,-9,7,0
209662,1,6,0,6,8,1
201290,2,14,3,11,5,1
100281,1,6,0,6,12,0
393221,2,14,6,8,5,1
243750,3,17,10,7,6,0
385529,1,0,0,0,1,0
209379,3,13,7,6,8,1
60396,3,13,7,6,11,1
245666,1,3,0,3,7,0
232571,4,26,24,2,1,1
69499,4,31,24,7,15,0
242357,4,33,13,20,6,1
199951,2,10,10,0,4,0
395535,3,21,14,7,6,0
77385,3,7,14,-7,1,0
13890,2,21,0,21,7,0
317240,4,7,16,-9,5,0
228978,3,14,9,5,17,0
6547,3,3,6,-3,3,0
234539,4,20,20,0,2,0
69322,4,19,3,16,15,1
67828,1,0,3,-3,14,0
376065,2,0,3,-3,14,1
359550,1,0,0,0,6,1
137574,4,20,27,-7,11,0
333354,2,17,7,10,12,0
139435,3,24,3,21,12,0
411340,3,17,10,7,13,0
373624,1,0,0,0,13,0
373466,1,0,6,-6,13,0
194737,2,0,10,-10,2,0
157059,1,0,0,0,2,0
226447,2,6,7,-1,16,1
39682,2,3,0,3,1,1
47230,4,12,9,3,5,1
28730,4,10,13,-3,14,0
285847,4,14,30,-16,8,1
33265,3,10,0,10,16,1
41157,2,0,7,-7,2,1
261299,4,38,0,38,14,0
116194,4,20,19,1,1,1
320030,4,43,36,7,6,1
395472,2,7,0,7,6,1
409661,2,10,3,7,12,1
8074,3,17,7,10,4,0
371471,3,14,17,-3,12,1
340987,4,17,17,0,15,0
157377,2,3,7,-4,2,1
315383,3,16,17,-1,4,1
212032,3,10,37,-27,9,0
194131,2,3,0,3,1,1
225389,4,24,35,-11,15,1
227527,4,26,17,9,16,1
388341,3,17,12,5,2,0
215708,1,3,0,3,11,1
305010,4,24,20,4,16,0
31687,4,24,24,0,15,1
139946,2,10,3,7,12,1
93121,1,0,0,0,9,0
123341,3,21,14,7,4,0
111683,3,28,10,18,16,0
249643,1,0,7,-7,9,1
331802,4,23,30,-7,12,1
131330,1,0,0,0,8,1
351435,4,20,16,4,3,0
207247,1,0,0,0,7,1
76032,2,10,13,-3,1,0
49237,3,17,10,7,6,0
362438,1,0,0,0,8,0
260448,1,0,0,0,14,1
43810,2,14,13,1,3,1
71193,3,19,13,6,16,1
260529,3,27,0,27,14,0
34321,4,23,9,14,16,0
113640,4,9,13,-4,17,0
79735,2,17,7,10,2,0
111663,2,20,10,10,16,1
51047,3,0,20,-20,6,1
176362,3,16,21,-5,11,1
356837,3,0,16,-16,5,1
179199,1,7,0,7,12,1
365391,1,7,0,7,9,0
184134,3,16,14,2,14,1
234500,3,20,20,0,2,0
33390,2,20,10,10,16,0
285412,2,24,0,24,8,0
186190,3,16,13,3,15,1
116420,2,3,3,0,1,0
228180,2,7,27,-20,17,1
260457,1,7,0,7,14,1
33044,1,0,0,0,16,1
80684,4,17,26,-9,3,0
266738,1,0,7,-7,16,1
354338,2,35,3,32,4,0
116222,1,0,0,0,1,1
209693,2,9,0,9,8,0
276880,1,0,0,0,4,1
45329,3,17,16,1,4,1
189964,3,13,7,6,17,1
403861,1,10,0,10,10,0
167090,4,16,34,-18,7,1
397903,3,7,6,1,7,0
216392,4,14,23,-9,12,1
381103,3,24,21,3,16,1
399790,3,8,24,-16,8,1
185281,3,27,16,11,15,1
186807,3,26,7,19,15,1
154863,1,3,3,0,1,0
78839,2,7,0,7,2,0
281203,3,24,13,11,6,0
117593,1,0,7,-7,2,1
141020,2,7,7,0,13,1
31250,4,33,41,-8,15,1
148814,3,13,16,-3,16,0
316025,4,0,31,-31,4,0
58652,5,20,20,0,10,0
88895,1,16,0,16,6,0
197331,3,17,10,7,3,1
281848,3,13,0,13,6,0
282412,4,10,23,-13,6,0
417515,3,24,21,3,16,1
238129,1,0,3,-3,4,0
330783,1,0,3,-3,11,1
375515,3,33,7,26,14,0
406868,4,20,23,-3,11,0
162429,4,23,30,-7,4,0
394960,4,10,17,-7,5,0
151515,3,35,7,28,17,1
159283,3,24,24,0,3,0
337234,3,16,23,-7,14,0
389353,3,23,6,17,3,0
382037,4,14,33,-19,17,1
347422,1,3,6,-3,1,1
217955,1,0,0,0,12,1
190162,4,30,3,27,17,0
197789,4,21,20,1,3,0
96483,3,17,17,0,10,0
415459,3,23,3,20,15,0
30038,3,33,0,33,14,0
192980,4,17,17,0,1,0
282941,2,7,0,7,6,0
186265,1,13,3,10,15,0
171260,1,0,0,0,9,0
76183,2,9,13,-4,1,0
336924,4,7,21,-14,14,1
201170,3,13,21,-8,5,0
197474,3,13,9,4,3,1
214426,3,7,14,-7,11,1
156357,3,30,0,30,2,1
206496,1,0,0,0,7,0
340777,2,10,10,0,15,1
347641,3,17,10,7,1,1
409401,3,19,3,16,12,1
402216,1,0,0,0,9,0
145692,4,42,14,28,14,1
58098,2,10,10,0,10,1
149659,2,17,0,17,16,1
212890,1,0,7,-7,10,1
220265,3,20,9,11,13,0
186459,2,10,10,0,15,0
368053,4,27,24,3,11,0
51449,2,10,24,-14,7,1
289886,2,6,3,3,10,1
312943,1,0,0,0,3,1
168881,3,17,3,14,7,1
350199,3,19,0,19,2,0
374959,1,7,6,1,14,1
262554,1,7,0,7,15,0
172382,2,10,28,-18,9,0
30263,2,3,7,-4,14,0
190627,1,14,7,7,17,0
235403,2,21,14,7,3,1
11568,4,13,10,3,6,1
270807,1,3,0,3,1,1
200376,1,0,6,-6,4,1
228599,1,7,14,-7,17,1
126546,3,10,6,4,6,1
419420,1,3,3,0,16,1
18096,2,3,14,-11,9,0
342328,4,23,6,17,16,0
321578,2,10,6,4,7,1
370616,3,14,14,0,12,1
223223,2,3,6,-3,15,0
393771,4,7,14,-7,5,1
32784,1,0,0,0,15,0
220541,2,7,20,-13,13,1
267491,1,3,14,-11,17,1
35657,3,23,3,20,17,0
322140,1,0,7,-7,7,1
305887,4,7,14,-7,17,1
62097,1,7,7,0,12,0
98504,4,31,24,7,11,1
349526,1,0,7,-7,2,1
377575,3,17,12,5,15,1
241740,4,7,9,-2,5,1
58756,3,10,20,-10,10,0
377295,4,14,14,0,15,0
253756,4,24,10,14,11,1
349086,1,7,0,7,2,0
352416,3,35,10,25,3,0
275333,3,10,16,-6,3,0
355451,3,19,13,6,4,1
409468,1,0,0,0,12,0
94501,2,0,0,0,9,1
25859,3,24,10,14,12,0
405456,3,21,10,11,10,1
294644,2,0,7,-7,12,1
250244,4,27,23,4,9,1
215481,2,10,3,7,11,1
253046,2,7,0,7,11,0
103772,1,3,0,3,13,0
85118,1,0,3,-3,4,1
191271,3,7,17,-10,17,1
164961,4,10,16,-6,6,0
125958,4,16,20,-4,6,1
396123,3,17,23,-6,6,0
371551,1,3,0,3,12,0
147955,1,0,0,0,15,1
358247,2,0,14,-14,6,1
221272,3,0,22,-22,14,1
207271,2,0,7,-7,7,0
69435,3,24,3,21,15,0
284717,1,0,7,-7,7,1
194018,2,14,7,7,1,0
33581,4,17,10,7,16,0
61804,2,0,17,-17,12,0
393832,2,7,17,-10,5,0
209718,3,9,6,3,8,1
294710,4,6,14,-8,12,1
338439,4,30,24,6,14,1
320969,1,7,0,7,6,1
239895,3,13,3,10,4,0
317057,3,7,10,-3,4,1
421562,4,16,3,13,17,0
30093,1,0,0,0,14,1
82563,1,0,0,0,3,0
207966,1,7,0,7,8,0
53589,3,14,15,-1,8,0
166068,1,0,0,0,6,1
226408,2,0,7,-7,16,1
202573,2,14,6,8,5,1
18492,4,17,14,3,9,1
246862,5,20,20,0,8,0
366452,4,34,10,24,10,0
240840,4,29,10,19,5,1
258928,1,0,7,-7,13,1
343696,4,18,10,8,17,1
235360,1,14,0,14,3,0
123046,3,7,13,-6,4,0
419195,3,10,6,4,16,1
138816,3,3,33,-30,12,1
227946,4,27,27,0,16,1
100790,2,6,3,3,12,1
50767,4,21,21,0,6,1
362988,3,27,16,11,8,0
183736,1,0,0,0,14,0
226488,4,14,10,4,16,0
275258,1,10,0,10,3,0
278972,3,7,30,-23,5,1
166578,2,15,14,1,6,1
377763,4,39,14,25,15,1
177530,1,7,0,7,11,0
40519,4,7,20,-13,2,0
337733,1,3,0,3,14,0
253289,4,10,13,-3,11,0
57677,4,17,17,0,10,1
313484,4,17,17,0,3,1
124863,3,3,6,-3,5,1
147685,2,10,3,7,15,1
117417,1,0,0,0,2,1
148600,2,0,6,-6,16,0
288519,2,3,14,-11,9,0
119763,2,10,6,4,3,1
32141,4,24,21,3,15,0
266966,3,16,10,6,17,1
341309,1,0,3,-3,16,1
339523,1,0,0,0,15,1
36363,3,13,13,0,17,1
182241,1,0,0,0,14,1
145832,4,13,33,-20,15,0
74594,4,10,3,7,17,0
19823,1,3,7,-4,10,0
145084,4,27,13,14,14,0
301669,4,16,6,10,15,1
200829,1,0,0,0,4,0
354383,3,45,3,42,4,0
165062,3,10,17,-7,6,0
255943,2,6,6,0,12,1
30789,4,31,35,-4,15,0
357460,4,31,33,-2,5,1
100190,2,14,0,14,12,1
238169,2,3,9,-6,4,0
2664,2,3,0,3,2,1
35170,2,0,14,-14,16,0
245621,4,40,20,20,7,1
380888,1,0,0,0,16,1
252529,4,29,25,4,10,0
406219,2,14,10,4,11,0
416657,3,31,7,24,15,1
239918,4,13,9,4,4,0
179107,2,9,6,3,12,0
149170,4,24,31,-7,16,1
187394,2,27,7,20,16,1
25171,4,20,3,17,12,0
293875,1,0,0,0,12,0
350210,3,27,0,27,2,0
229898,4,20,14,6,17,1
227769,3,3,14,-11,16,0
52150,1,0,0,0,7,0
202023,4,17,10,7,5,0
287430,1,7,7,0,9,0
151480,2,28,7,21,17,0
27543,4,23,12,11,13,0
114712,4,15,10,5,1,0
61427,3,16,3,13,11,0
391998,2,0,7,-7,4,0
208870,1,7,0,7,8,0
166333,4,20,9,11,6,0
338971,2,13,0,13,15,0
175401,2,17,3,14,11,0
200508,4,26,18,8,4,0
23186,2,23,6,17,11,0
172670,2,7,3,4,9,0
405512,1,0,0,0,10,1
51633,3,21,20,1,7,1
373837,2,19,0,19,13,1
36685,4,20,3,17,17,0
73296,1,0,0,0,17,1
268857,1,0,10,-10,17,1
393018,4,12,10,2,4,0
315722,4,17,22,-5,4,1
306318,3,24,10,14,17,0
81728,3,17,17,0,3,1
374872,3,14,3,11,14,1
349365,4,36,42,-6,2,1
241383,2,7,14,-7,5,1
12982,2,0,7,-7,6,1
52295,1,0,0,0,7,1
355097,2,6,13,-7,4,0
381353,2,6,0,6,16,1
390892,4,15,28,-13,3,1
278206,3,24,21,3,4,0
339836,1,13,0,13,15,0
155740,4,20,20,0,2,0
95283,3,10,24,-14,10,1
420542,4,10,42,-32,17,0
341458,1,0,0,0,16,1
196,2,3,10,-7,1,1
141896,4,27,21,6,13,1
147346,1,0,0,0,15,1
282123,3,23,8,15,6,0
404938,2,3,13,-10,10,1
248863,1,6,0,6,9,1
406986,3,3,20,-17,11,0
71443,2,24,7,17,16,1
199250,3,17,24,-7,4,1
243244,2,6,7,-1,6,1
114540,4,17,40,-23,1,1
246556,4,36,7,29,8,0
46172,2,7,14,-7,4,1
296485,3,17,3,14,13,1
191234,2,7,17,-10,17,0
178093,5,26,23,3,12,0
184080,2,6,7,-1,14,1
358706,2,7,7,0,6,0
340877,1,0,3,-3,15,1
99070,3,23,0,23,11,0
55846,3,7,7,0,9,0
376100,3,0,3,-3,14,1
318776,4,17,26,-9,5,1
142625,3,13,6,7,13,0
264654,5,20,20,0,16,1
303174,4,24,28,-4,16,0
255881,4,20,14,6,12,0
1145,4,10,36,-26,1,1
146222,2,0,10,-10,15,1
219825,3,38,0,38,13,0
378261,2,0,3,-3,15,1
89742,4,16,23,-7,7,0
244913,1,0,0,0,7,0
316155,4,24,26,-2,4,0
270260,3,3,21,-18,1,1
305943,5,21,24,-3,17,1
282898,5,23,23,0,6,1
285536,2,7,7,0,8,0
19185,3,21,13,8,10,0
2460,4,28,20,8,2,0
341671,2,17,13,4,16,0
334060,1,0,0,0,13,0
285275,3,14,6,8,7,0
44827,1,0,7,-7,4,0
10335,2,10,28,-18,5,1
157721,2,10,3,7,2,0
177230,2,7,7,0,11,0
114129,4,24,14,10,17,0
278039,3,10,10,0,4,0
178408,4,38,34,4,12,0
391439,3,10,17,-7,4,0
77484,1,0,7,-7,1,0
392501,2,3,17,-14,4,0
94900,1,0,0,0,9,0
130857,4,20,12,8,8,0
156650,3,3,7,-4,2,1
344905,1,0,7,-7,17,1
288603,4,23,41,-18,9,0
256832,1,0,0,0,12,1
307722,1,0,0,0,1,1
289584,2,7,13,-6,10,1
354452,2,7,14,-7,4,1
80581,1,0,0,0,3,0
181962,1,7,0,7,13,0
154129,2,0,6,-6,1,1
248255,1,0,0,0,8,1
60958,2,14,6,8,11,1
20155,2,10,0,10,10,0
98467,3,17,14,3,11,1
234576,1,7,0,7,2,1
174812,2,13,17,-4,10,0
66948,4,18,7,11,14,0
309888,4,24,14,10,1,1
193780,4,17,27,-10,1,0
106978,4,22,12,10,14,0
364072,1,6,3,3,9,1
194485,3,16,10,6,2,1
289154,2,13,7,6,9,0
264811,4,17,35,-18,16,0
192343,4,27,20,7,1,0
312492,2,13,0,13,3,0
248997,4,27,3,24,9,0
4096,3,16,28,-12,2,1
364793,1,0,0,0,9,1
272050,2,10,3,7,2,1
330374,2,7,19,-12,11,0
248576,1,7,0,7,9,0
279793,1,7,3,4,5,1
402933,4,24,9,15,9,0
136470,3,17,13,4,11,0
206893,3,10,17,-7,7,0
402079,1,3,0,3,9,0
189394,4,33,24,9,16,0
307067,3,24,6,18,17,1
111776,1,3,7,-4,17,1
63932,4,6,24,-18,12,0
288819,2,10,14,-4,9,0
182393,4,24,20,4,14,1
385445,3,28,10,18,1,0
161707,1,10,0,10,4,0
378908,3,13,23,-10,15,1
326137,1,0,0,0,9,1
211736,4,29,16,13,9,1
106611,3,34,0,34,14,0
390765,1,0,0,0,3,0
101254,3,7,7,0,12,0
204731,2,14,14,0,6,0
327056,1,0,0,0,9,1
133979,4,19,13,6,9,0
363412,3,21,21,0,8,1
271792,4,30,20,10,2,1
246922,2,14,7,7,8,1
278252,4,34,35,-1,4,1
382855,3,28,3,25,17,1
271298,3,6,17,-11,1,1
26572,2,10,6,4,13,0
288735,4,0,7,-7,9,0
276584,1,7,0,7,4,0
312319,1,7,13,-6,3,0
274200,2,10,0,10,3,0
59088,3,3,23,-20,10,0
299330,4,26,16,10,14,0
299490,4,10,23,-13,14,0
200648,4,27,28,-1,4,1
148232,4,16,31,-15,16,1
90179,3,3,0,3,7,0
203396,4,27,33,-6,6,1
272215,2,0,0,0,2,1
65092,1,0,0,0,13,1
418980,2,7,7,0,16,0
83335,1,0,7,-7,4,0
77293,4,26,17,9,1,0
119768,2,10,6,4,3,1
255461,1,7,0,7,12,1
248766,3,27,14,13,9,1
72200,2,10,10,0,16,1
55430,3,20,10,10,9,1
203522,4,24,3,21,6,1
75522,1,0,0,0,17,1
283948,4,31,17,14,7,0
111344,2,0,7,-7,16,1
262141,3,21,3,18,15,0
104842,1,0,0,0,14,0
40531,1,0,0,0,2,1
217912,4,25,28,-3,12,0
364964,2,7,0,7,9,0
280357,1,0,0,0,5,1
32560,3,20,13,7,15,0
180311,2,9,7,2,13,0
301250,4,27,20,7,15,1
273795,3,10,7,3,2,1
75285,3,7,23,-16,17,1
186060,4,31,48,-17,15,1
204237,2,0,7,-7,6,1
355015,4,10,19,-9,4,0
324579,3,13,9,4,8,1
282688,3,6,20,-14,6,1
232843,4,16,17,-1,2,1
156439,1,0,3,-3,2,1
1045,2,7,9,-2,1,1
152226,3,21,0,21,17,0
307402,1,0,0,0,17,0
402920,4,17,9,8,9,0
417187,2,3,17,-14,16,0
287273,1,0,0,0,8,0
128914,2,15,3,12,7,1
413994,3,3,24,-21,14,0
329369,3,16,27,-11,10,0
178583,1,0,0,0,12,0
259027,3,3,16,-13,13,1
417395,4,13,17,-4,16,1
294181,2,0,7,-7,12,1
250920,2,3,3,0,10,0
139683,2,0,0,0,12,0
274590,4,24,26,-2,3,1
228672,3,16,17,-1,17,1
396524,2,17,7,10,6,0
84389,1,3,0,3,4,1
397642,4,6,27,-21,7,1
118444,4,20,10,10,2,0
187272,4,10,6,4,16,0
323089,3,23,14,9,7,1
77457,1,0,0,0,1,0
74003,4,37,0,37,17,1
386291,1,0,0,0,2,0
186992,4,10,15,-5,15,1
178081,5,23,23,0,12,1
177914,4,21,23,-2,12,1
48815,1,3,0,3,5,1
29099,2,0,6,-6,14,0
39030,4,37,24,13,1,1
377916,4,23,13,10,15,0
110102,1,0,3,-3,16,0
83353,2,0,14,-14,4,1
230794,4,17,27,-10,1,0
337931,3,13,0,13,14,1
319530,4,13,17,-4,6,1
157858,2,6,9,-3,3,0
193675,2,3,20,-17,1,1
193107,3,13,6,7,1,0
173490,3,3,17,-14,10,0
397328,3,0,24,-24,6,1
30214,4,13,31,-18,14,1
279094,2,21,7,14,5,0
134215,3,3,23,-20,10,1
288494,1,3,7,-4,9,1
21825,1,0,0,0,11,0
321178,3,3,19,-16,6,0
138181,2,7,9,-2,11,1
74070,2,9,0,9,17,1
416826,4,19,10,9,15,0
330236,3,10,14,-4,11,1
47554,3,37,6,31,5,0
318730,3,10,23,-13,5,1
362499,2,7,6,1,8,1
232530,3,20,10,10,1,0
170048,1,0,0,0,8,1
18673,1,0,0,0,9,0
17256,4,7,34,-27,9,1
384963,2,7,6,1,1,1
161001,3,16,7,9,4,0
54396,4,24,19,5,8,1
376464,1,0,0,0,14,1
304357,3,20,7,13,16,0
285464,4,36,8,28,8,0
129504,1,0,0,0,7,1
268312,2,20,3,17,17,1
12605,4,3,24,-21,6,1
362595,1,0,0,0,8,0
325557,1,0,0,0,9,1
279322,4,29,23,6,5,1
286191,5,24,24,0,8,0
383326,1,0,0,0,17,1
305055,1,14,0,14,16,0
31545,1,0,0,0,15,0
217103,1,0,0,0,12,0
185902,3,22,16,6,15,0
29256,2,14,0,14,14,1
272198,2,0,0,0,2,0
208215,4,3,10,-7,8,0
44639,4,20,24,-4,3,1
201570,1,0,0,0,5,1
271334,4,16,24,-8,1,0
162180,2,7,7,0,4,1
350812,4,23,10,13,2,0
89467,4,27,20,7,7,0
415994,2,7,0,7,15,0
413307,4,20,0,20,14,0
157413,2,9,7,2,2,0
235799,1,0,0,0,3,0
304097,4,13,23,-10,16,0
256985,1,0,6,-6,12,0
349357,4,30,42,-12,2,1
49773,2,7,7,0,6,1
25459,4,13,17,-4,12,1
234854,4,0,12,-12,2,1
231590,2,14,3,11,1,0
367979,2,10,14,-4,11,0
84700,2,3,7,-4,4,0
340782,3,17,10,7,15,0
406491,2,0,13,-13,11,0
197906,3,11,7,4,3,0
207745,3,24,13,11,7,1
116593,3,13,0,13,2,0
180865,5,20,20,0,13,0
405849,1,0,0,0,11,1
289404,1,0,0,0,10,0
37041,2,10,0,10,17,1
330662,2,6,3,3,11,1
296183,3,16,19,-3,13,0
342454,4,13,3,10,16,1
72111,4,10,17,-7,16,1
262723,2,21,0,21,15,0
179296,4,33,3,30,12,0
108273,4,9,7,2,15,1
21948,1,7,0,7,11,0
410603,3,17,17,0,13,1
93473,3,3,28,-25,9,1
330151,4,0,16,-16,11,0
365415,2,7,12,-5,9,1
362637,2,0,7,-7,8,1
330668,2,6,3,3,11,1
352046,1,0,0,0,3,1
95202,1,0,0,0,10,1
85915,2,7,14,-7,5,1
312702,3,28,14,14,3,1
249919,4,18,20,-2,9,0
216457,1,14,0,14,12,1
109287,3,6,0,6,15,0
248384,1,3,0,3,8,1
111863,4,13,10,3,17,1
247701,2,7,6,1,8,0
46605,2,3,0,3,4,0
357181,4,12,27,-15,5,1
180537,4,21,20,1,13,0
299579,3,10,3,7,14,1
411840,4,7,34,-27,13,1
128737,1,0,0,0,7,0
45349,4,20,16,4,4,0
46907,3,13,20,-7,5,1
267474,1,0,7,-7,17,0
258429,3,21,13,8,13,1
317061,3,7,10,-3,4,1
381819,2,0,14,-14,17,1
257244,3,19,23,-4,12,0
419403,1,3,0,3,16,0
319861,4,23,10,13,6,0
374446,3,32,0,32,14,0
414209,1,7,0,7,14,0
420358,4,17,10,7,17,0
105584,4,32,21,11,14,0
157467,4,16,37,-21,2,1
209341,2,7,7,0,8,1
80633,2,7,13,-6,3,0
338292,4,34,37,-3,14,0
135635,2,7,7,0,10,1
100649,2,14,14,0,12,0
87842,2,10,7,3,6,0
339285,3,31,0,31,15,0
398915,3,10,10,0,7,1
254139,2,3,9,-6,11,0
9456,2,10,0,10,5,0
25251,2,13,7,6,12,1
361941,3,10,3,7,7,1
365544,1,14,7,7,9,0
43876,4,27,16,11,3,1
92479,4,23,10,13,8,0
202690,1,3,7,-4,5,0
190033,1,14,0,14,17,0
167284,1,3,0,3,7,1
160810,2,20,10,10,4,0
277593,4,12,14,-2,4,0
173542,4,13,27,-14,10,0
398129,4,30,42,-12,7,1
236356,3,7,23,-16,3,0
353723,3,10,17,-7,4,0
191629,1,0,0,0,17,1
85555,4,17,22,-5,5,0
155189,2,7,7,0,1,1
231808,4,26,20,6,1,0
58245,2,7,10,-3,10,1
221626,4,20,21,-1,14,1
215423,1,7,3,4,11,1
240775,2,7,7,0,5,1
220561,3,10,20,-10,13,0
116148,2,7,10,-3,1,1
158379,3,16,17,-1,3,0
156726,4,17,23,-6,2,1
95432,3,28,7,21,10,0
278493,3,36,0,36,4,1
346823,2,10,3,7,1,1
416378,4,16,6,10,15,0
115302,4,17,12,5,1,0
333680,3,14,0,14,12,0
247903,3,17,6,11,8,0
37799,3,7,9,-2,1,1
387099,2,10,21,-11,2,1
372478,3,22,14,8,13,1
214399,2,0,7,-7,11,1
265649,3,9,15,-6,16,0
243456,3,3,23,-20,6,1
147041,4,34,0,34,15,1
135079,3,17,6,11,10,0
309267,2,0,10,-10,1,1
265447,1,0,7,-7,16,1
167486,2,0,0,0,7,0
380116,4,35,30,5,16,0
403917,3,20,14,6,10,0
14671,4,33,14,19,7,0
6575,4,13,6,7,3,1
163763,3,7,12,-5,5,0
408186,3,13,0,13,12,0
177488,4,27,17,10,11,0
340085,4,20,15,5,15,0
263148,2,3,7,-4,15,1
47057,3,17,7,10,5,0
357899,4,13,34,-21,6,1
167586,4,3,17,-14,7,1
312703,3,28,14,14,3,0
136118,2,3,10,-7,10,1
108925,1,6,0,6,15,0
162304,1,3,0,3,4,1
113458,3,3,7,-4,17,0
100094,4,13,6,7,12,0
300447,2,9,0,9,14,1
228532,3,20,7,13,17,1
63013,2,6,21,-15,12,0
81344,1,0,7,-7,3,0
175271,3,15,7,8,10,1
219818,3,38,0,38,13,1
348905,4,9,21,-12,2,0
380077,4,35,20,15,16,1
289399,1,0,0,0,10,1
273873,1,0,0,0,2,0
98996,1,0,0,0,11,1
95817,2,6,10,-4,10,1
306051,3,10,13,-3,17,1
399456,2,0,17,-17,7,0
327110,2,7,3,4,9,1
267288,3,17,17,0,17,1
96091,4,16,21,-5,10,0
56253,2,3,7,-4,9,0
415787,4,24,24,0,15,0
347456,2,6,13,-7,1,1
401149,3,41,13,28,8,0
115515,1,0,3,-3,1,1
371881,3,24,10,14,12,1
230315,3,19,10,9,17,0
324655,1,0,0,0,8,0
21501,1,0,0,0,11,0
68113,4,3,10,-7,14,1
410259,2,7,7,0,13,1
349223,1,0,0,0,2,1
343963,3,16,6,10,17,1
374713,2,0,30,-30,14,0
322537,4,15,3,12,7,0
239268,2,3,7,-4,4,0
174442,5,17,17,0,10,0
83914,4,23,24,-1,4,1
277621,4,25,21,4,4,1
375522,4,33,7,26,14,0
383875,4,3,7,-4,1,0
191218,2,0,17,-17,17,1
292190,3,21,14,7,11,1
39257,2,3,10,-7,1,1
333153,1,0,0,0,12,1
324597,4,16,9,7,8,1
345737,3,10,7,3,17,1
234211,3,20,10,10,2,1
77240,3,16,0,16,1,0
315557,4,7,14,-7,4,1
412520,4,24,14,10,14,1
293252,3,23,7,16,11,0
275268,2,10,2,8,3,0
362195,2,3,3,0,8,1
204427,2,7,10,-3,6,0
26550,2,3,3,0,13,1
213335,2,3,6,-3,10,0
157247,2,7,3,4,2,1
148975,3,13,12,1,16,1
323037,2,14,7,7,7,0
228398,4,10,20,-10,17,0
259410,1,3,3,0,13,1
328706,1,7,0,7,10,0
81303,4,10,14,-4,3,1
50327,4,13,23,-10,6,0
344959,3,10,14,-4,17,1
223535,3,10,10,0,15,0
298653,2,6,0,6,14,0
373248,3,13,16,-3,13,0
62237,1,7,7,0,12,1
353808,1,7,6,1,4,1
287347,3,13,3,10,8,1
217349,3,21,10,11,12,0
94074,4,6,28,-22,9,0
141797,1,10,7,3,13,0
317894,1,0,0,0,5,1
129556,2,3,17,-14,7,1
266186,2,21,0,21,16,1
309696,2,10,6,4,1,1
119837,4,24,19,5,3,1
287191,3,10,13,-3,8,0
315193,2,10,10,0,4,1
368198,4,24,21,3,11,1
320225,2,7,0,7,6,1
225298,1,0,14,-14,15,1
937,2,0,0,0,1,0
395130,4,24,34,-10,5,1
85402,4,31,10,21,5,0
18205,4,29,20,9,9,0
193578,3,0,10,-10,1,0
172914,4,34,24,10,9,1
386919,2,7,14,-7,2,0
331148,2,7,13,-6,11,0
291519,1,3,0,3,11,0
120034,4,30,38,-8,3,1
11849,3,34,17,17,6,1
349381,1,0,0,0,2,1
256542,2,7,0,7,12,1
215669,4,14,6,8,11,0
145194,3,49,0,49,14,0
406791,2,0,17,-17,11,0
167489,2,0,3,-3,7,1
109347,1,0,0,0,16,0
10638,3,7,17,-10,5,1
119011,3,7,26,-19,3,0
88459,2,7,7,0,6,1
353066,1,7,6,1,3,0
128436,1,7,0,7,7,0
77333,1,7,7,0,1,1
286658,1,7,0,7,8,0
559,4,14,26,-12,1,0
273307,2,21,0,21,2,0
384518,1,0,7,-7,1,1
418148,3,21,3,18,16,1
419799,4,24,20,4,17,0
234214,3,20,10,10,2,0
211058,3,27,0,27,9,0
412230,3,21,3,18,13,0
263461,2,6,13,-7,15,0
172677,2,7,3,4,9,1
203002,2,14,0,14,5,1
415604,3,14,13,1,15,1
281460,2,0,10,-10,6,1
49429,5,20,20,0,6,0
420081,4,31,21,10,17,0
333662,2,7,0,7,12,1
139660,1,0,0,0,12,0
330972,2,23,7,16,11,0
40969,4,16,27,-11,2,1
248522,4,23,20,3,8,0
383247,2,28,10,18,17,1
13213,4,22,26,-4,6,1
110248,1,0,3,-3,16,0
95802,2,6,3,3,10,0
139724,3,7,14,-7,12,1
212639,3,7,31,-24,10,0
68520,2,0,21,-21,14,1
33952,2,0,27,-27,16,1
221071,1,0,0,0,14,0
270157,4,27,19,8,1,1
215409,1,7,0,7,11,0
156980,3,7,13,-6,2,0
113120,1,21,0,21,17,0
1586,4,16,20,-4,1,1
380384,3,10,17,-7,16,0
230068,4,19,6,13,17,0
335622,4,19,10,9,13,0
325591,2,7,7,0,9,1
319227,4,17,17,0,5,0
110008,3,20,10,10,16,1
280805,1,7,0,7,6,0
202780,4,19,17,2,5,0
353193,1,0,0,0,4,0
55341,1,0,0,0,9,1
292837,1,0,0,0,11,1
167332,2,16,16,0,7,1
120885,3,14,24,-10,3,1
330993,2,32,7,25,11,1
346128,4,18,12,6,1,0
292647,4,22,16,6,11,0
5102,3,13,7,6,3,0
88679,4,23,20,3,6,0
293053,3,10,13,-3,11,0
48831,2,3,0,3,5,1
416886,2,0,7,-7,15,1
413920,4,20,15,5,14,1
112260,2,17,10,7,17,0
389023,1,13,0,13,3,0
58093,2,10,10,0,10,0
364171,4,31,3,28,9,1
167819,1,0,13,-13,7,1
290266,4,17,6,11,10,1
136275,2,15,7,8,11,1
152758,2,0,7,-7,17,1
382704,3,3,13,-10,17,1
260357,2,6,0,6,14,1
13580,2,3,7,-4,7,1
323084,3,23,14,9,7,1
281692,3,31,17,14,6,1
20285,1,7,0,7,10,0
179076,2,3,6,-3,12,0
366240,2,7,3,4,10,1
120776,4,23,6,17,3,1
118604,4,31,10,21,2,1
120934,4,31,31,0,3,1
269999,4,19,20,-1,1,0
5223,2,14,17,-3,3,1
188620,4,20,19,1,16,0
109502,4,19,16,3,16,0
206302,4,10,6,4,7,1
357485,1,0,3,-3,5,1
367079,1,7,0,7,10,0
325706,4,34,21,13,9,1
398947,4,16,13,3,7,1
396042,1,0,0,0,6,1
319825,3,17,10,7,6,0
397357,4,10,24,-14,6,0
155567,3,23,3,20,2,1
316804,4,16,7,9,4,1
298070,2,0,14,-14,13,1
95897,4,20,23,-3,10,0
320224,2,7,0,7,6,1
106764,3,17,15,2,14,1
94492,2,0,0,0,9,1
362541,4,23,12,11,8,1
188826,1,0,0,0,16,1
16498,2,13,7,6,8,0
396028,4,38,20,18,6,1
34942,4,27,27,0,16,0
104027,4,13,13,0,13,1
88054,3,24,3,21,6,0
87955,1,0,0,0,6,0
61872,3,20,23,-3,12,0
86342,4,27,23,4,5,0
43859,4,24,16,8,3,0
409067,2,3,7,-4,12,0
255244,4,13,14,-1,12,0
234250,4,20,17,3,2,0
56757,3,7,13,-6,9,1
364339,4,9,39,-30,9,0
51863,2,6,7,-1,7,0
144243,2,9,7,2,14,1
184747,1,7,0,7,15,1
183084,2,7,3,4,14,0
135519,2,7,6,1,10,1
160710,4,10,3,7,4,1
68172,1,7,7,0,14,1
41301,2,0,3,-3,2,1
37049,2,13,0,13,17,0
259226,4,28,32,-4,13,0
194090,1,0,0,0,1,1
415857,2,7,20,-13,15,0
19736,3,9,6,3,10,0
336671,1,0,3,-3,14,1
42293,1,0,0,0,2,1
237321,1,0,0,0,3,0
357036,1,0,0,0,5,1
108054,2,6,7,-1,15,0
164443,1,14,0,14,5,0
214480,4,7,17,-10,11,0
230462,4,21,14,7,1,1
125867,1,6,10,-4,6,1
153058,1,0,7,-7,1,0
239760,4,13,13,0,4,1
217016,3,6,3,3,12,1
333630,1,0,0,0,12,0
160082,4,23,39,-16,3,1
322296,1,7,0,7,7,0
61912,4,27,30,-3,12,1
265124,4,20,10,10,16,0
203572,1,0,0,0,6,0
274111,3,20,0,20,3,0
222252,4,13,27,-14,14,1
293293,4,26,15,11,11,1
201903,1,0,0,0,5,0
135812,2,7,14,-7,10,0
242663,4,13,9,4,6,0
299275,2,23,0,23,14,0
311587,1,3,0,3,2,1
280582,3,17,6,11,5,0
136701,1,0,10,-10,11,0
135302,4,34,24,10,10,1
226200,1,0,0,0,16,1
181749,3,7,13,-6,13,0
253492,1,0,0,0,11,1
83080,2,6,21,-15,4,1
351590,4,6,27,-21,3,0
88267,1,7,0,7,6,0
137212,2,7,3,4,11,0
207922,4,34,14,20,8,1
321529,1,0,0,0,7,0
385758,2,17,0,17,1,0
241599,4,6,27,-21,5,1
171543,4,30,10,20,9,1
381414,3,16,7,9,16,1
393627,4,7,33,-26,5,1
21660,1,3,0,3,11,0
297663,2,7,3,4,13,0
52162,1,0,0,0,7,0
119113,2,10,7,3,3,1
255005,1,0,9,-9,12,1
160595,1,0,0,0,4,1
351509,2,0,27,-27,3,0
188642,5,20,19,1,16,0
364901,4,13,20,-7,9,0
282191,1,3,0,3,6,1
263619,2,14,10,4,15,1
7184,1,0,0,0,4,0
135052,2,14,3,11,10,1
115187,4,13,30,-17,1,0
186485,3,17,13,4,15,0
365228,1,0,7,-7,9,1
419413,1,3,0,3,16,0
209435,4,14,17,-3,8,1
266024,1,7,0,7,16,1
150280,2,14,7,7,16,0
333421,4,23,13,10,12,0
32145,4,24,21,3,15,0
33472,1,0,0,0,16,0
264763,3,10,16,-6,16,1
46203,3,14,21,-7,4,1
148515,4,24,10,14,16,1
60254,3,10,16,-6,11,1
238354,2,10,16,-6,4,1
219511,3,3,21,-18,13,1
334784,1,0,0,0,13,0
282551,4,17,24,-7,6,1
337148,2,3,0,3,14,1
402469,4,24,15,9,9,1
148296,2,7,3,4,16,1
71236,4,22,20,2,16,0
304373,3,28,14,14,16,0
320053,1,0,0,0,6,1
111448,4,0,20,-20,16,1
60645,2,7,3,4,11,1
98769,3,34,6,28,11,0
101547,2,13,21,-8,12,0
350349,3,24,3,21,2,0
67365,3,27,6,21,14,1
389705,4,27,16,11,3,1
222028,2,14,3,11,14,1
323910,1,7,0,7,8,1
132216,1,7,0,7,9,0
227562,1,14,0,14,16,1
172972,1,7,0,7,9,1
113324,3,16,31,-15,17,1
184395,3,21,6,15,14,1
65078,4,6,17,-11,13,1
95286,3,10,24,-14,10,1
237215,2,3,0,3,3,1
164271,4,48,48,0,5,0
147457,4,23,10,13,15,0
316451,3,16,10,6,4,0
231234,4,10,16,-6,1,0
98413,2,14,7,7,11,0
277509,2,0,7,-7,4,1
97246,3,12,13,-1,10,1
109250,2,6,0,6,15,1
162518,3,21,10,11,4,1
175847,2,20,24,-4,11,1
331423,2,6,7,-1,11,1
288155,4,19,14,5,9,1
401202,1,0,0,0,8,1
20210,3,17,10,7,10,0
279304,4,19,23,-4,5,1
253011,1,0,0,0,11,1
309732,3,19,6,13,1,0
103357,2,10,17,-7,13,1
349369,4,37,42,-5,2,0
227910,3,27,13,14,16,0
118059,1,0,6,-6,2,1
179600,4,21,23,-2,12,1
18886,3,9,13,-4,9,0
240411,1,0,0,0,5,1
315243,4,20,16,4,4,1
351339,2,7,7,0,3,1
107027,2,10,0,10,15,1
55966,2,10,7,3,9,0
204722,2,7,14,-7,6,1
226530,1,0,0,0,16,1
421336,1,0,3,-3,17,1
178285,1,0,0,0,12,0
208702,1,0,0,0,8,0
421796,1,0,3,-3,17,0
371395,1,7,7,0,12,0
149101,3,14,17,-3,16,1
416728,1,0,0,0,15,1
152995,4,35,17,18,1,1
5921,2,7,16,-9,3,0
209701,2,9,3,6,8,0
140701,1,3,7,-4,12,0
215461,2,7,3,4,11,1
267316,4,17,17,0,17,0
240044,3,17,20,-3,5,0
386652,3,7,13,-6,2,0
185721,2,17,3,14,15,1
153596,3,12,14,-2,1,1
297924,2,10,0,10,13,1
399851,1,0,0,0,8,1
145285,2,14,9,5,14,1
315814,2,0,19,-19,4,1
285697,5,27,27,0,8,0
71833,1,7,0,7,16,0
328971,3,23,7,16,10,0
90583,2,14,7,7,7,0
38567,4,38,6,32,1,0
105409,3,23,17,6,14,1
70991,2,3,0,3,16,1
236756,1,0,3,-3,3,0
254740,2,3,3,0,11,0
162996,3,9,3,6,5,1
73492,2,3,27,-24,17,0
386898,1,7,7,0,2,1
239302,3,3,14,-11,4,1
419900,3,6,18,-12,17,0
38488,1,10,3,7,1,0
230929,4,31,10,21,1,1
343277,4,22,0,22,16,1
232495,2,13,3,10,1,1
171850,4,26,20,6,9,1
184609,1,7,3,4,15,1
375903,2,14,3,11,14,0
15716,1,0,0,0,8,1
27897,2,0,0,0,13,0
190595,4,20,20,0,17,1
101522,2,10,14,-4,12,0
283639,4,23,20,3,7,1
32813,2,6,0,6,15,0
206835,2,0,7,-7,7,1
406750,1,0,3,-3,11,1
110097,1,0,3,-3,16,0
135936,1,0,0,0,10,0
416296,2,10,3,7,15,1
306209,3,20,3,17,17,1
200243,1,3,0,3,4,1
266982,3,19,16,3,17,0
416041,3,14,3,11,15,1
147678,2,10,0,10,15,0
282175,1,3,0,3,6,0
148278,1,7,0,7,16,0
29459,3,10,14,-4,14,0
74932,1,10,0,10,17,0
353951,4,31,31,0,4,0
245983,1,0,0,0,7,0
66493,3,14,23,-9,14,0
144513,1,0,7,-7,14,0
198960,3,13,23,-10,3,1
196522,2,10,3,7,2,0
322181,2,0,17,-17,7,0
139014,4,14,12,2,12,1
285707,1,0,0,0,8,0
22281,2,0,3,-3,11,0
313082,1,0,0,0,3,1
199047,1,0,7,-7,4,0
111488,1,7,0,7,16,0
12872,3,13,6,7,6,1
155125,4,19,33,-14,1,1
227892,2,17,6,11,16,1
105458,4,23,31,-8,14,0
101272,3,10,7,3,12,1
150531,1,0,0,0,17,0
92092,2,3,10,-7,8,0
361686,3,10,32,-22,7,0
297349,2,3,10,-7,13,1
193636,4,14,17,-3,1,0
346961,2,7,3,4,1,0
54915,2,0,0,0,8,0
227197,4,13,17,-4,16,1
73533,3,3,38,-35,17,1
369090,1,3,0,3,11,1
235491,1,0,0,0,3,0
149813,2,3,7,-4,16,0
412685,3,30,10,20,14,1
338993,3,20,3,17,15,0
396000,4,31,20,11,6,0
275078,4,34,27,7,3,1
283348,4,10,16,-6,7,1
315118,4,56,14,42,4,0
75049,1,0,0,0,17,0
265213,2,6,6,0,16,1
194738,2,0,10,-10,2,0
123810,3,10,3,7,5,1
129360,2,16,7,9,7,0
74300,4,10,30,-20,17,1
114217,3,3,7,-4,1,0
372539,5,26,27,-1,13,1
307942,2,7,3,4,1,0
176380,4,16,28,-12,11,1
102920,2,9,21,-12,13,0
374495,1,0,0,0,14,1
143733,1,0,0,0,14,0
300353,4,10,7,3,14,1
40235,1,0,0,0,2,0
413459,4,17,38,-21,14,1
171405,5,19,20,-1,9,0
72664,3,13,3,10,16,0
267001,4,19,17,2,17,1
196188,1,7,0,7,2,0
291127,2,15,13,2,10,0
218153,2,7,3,4,12,1
209066,2,3,10,-7,8,0
196480,1,0,3,-3,2,0
313564,2,3,17,-14,3,1
8710,1,0,0,0,4,1
145554,1,7,0,7,14,0
4013,1,7,0,7,2,0
216023,2,7,12,-5,11,1
126639,1,0,0,0,6,0
297575,4,21,7,14,13,1
145208,4,49,0,49,14,1
196600,4,27,20,7,2,0
59402,4,0,16,-16,11,1
103026,1,0,0,0,13,0
284820,4,29,20,9,7,0
360646,4,10,27,-17,7,1
146782,1,7,0,7,15,0
133044,3,12,14,-2,9,1
304673,3,14,7,7,16,0
412551,4,31,14,17,14,0
282447,1,0,0,0,6,1
281214,4,24,16,8,6,1
273942,3,7,9,-2,2,1
21235,1,3,0,3,11,1
97919,1,0,7,-7,11,1
366962,2,0,14,-14,10,0
24389,3,13,0,13,12,1
349700,2,14,7,7,2,0
112980,2,7,3,4,17,0
298195,1,0,3,-3,14,0
237071,2,0,23,-23,3,1
187096,3,10,0,10,16,1
63694,1,0,0,0,12,1
19634,4,17,28,-11,10,0
137515,2,14,14,0,11,0
128158,1,7,0,7,7,0
196773,1,0,0,0,3,0
45222,4,14,10,4,4,1
320618,4,31,18,13,6,1
406821,3,0,20,-20,11,1
256323,4,21,17,4,12,0
251524,2,16,13,3,10,0
134541,1,0,0,0,10,0
42013,1,6,0,6,2,0
331649,4,31,33,-2,11,0
94032,2,6,21,-15,9,1
17722,4,17,6,11,9,1
339292,3,31,0,31,15,0
119235,2,7,3,4,3,0
22150,2,10,6,4,11,1
405715,2,10,0,10,10,1
74476,1,0,0,0,17,0
171128,1,3,0,3,8,0
415471,3,23,3,20,15,0
326695,4,16,13,3,9,1
69928,1,0,0,0,15,1
415888,3,10,20,-10,15,0
420365,4,17,13,4,17,1
265707,1,0,0,0,16,1
52215,3,7,13,-6,7,0
102117,1,0,0,0,13,1
20001,2,9,6,3,10,1
304875,4,12,10,2,16,0
156336,2,24,0,24,2,1
407981,1,0,0,0,12,1
368133,2,10,7,3,11,0
396850,2,17,10,7,6,1
24588,4,10,23,-13,12,0
136782,3,13,10,3,11,0
417715,4,35,19,16,16,1
127131,2,3,9,-6,6,1
225699,4,21,13,8,16,1
178694,4,3,20,-17,12,0
69147,3,14,17,-3,15,1
217921,4,25,28,-3,12,1
102549,1,0,0,0,13,1
307890,1,0,0,0,1,1
407,3,31,17,14,1,0
315233,3,20,10,10,4,0
373669,2,0,12,-12,13,1
134977,4,7,27,-20,10,0
64682,2,14,0,14,13,1
227295,2,13,20,-7,16,1
156143,2,7,7,0,2,0
249180,1,9,0,9,9,0
316475,4,16,17,-1,4,1
157404,2,6,7,-1,2,1
40134,2,13,0,13,2,0
94373,3,17,14,3,9,0
2056,1,0,0,0,1,0
409559,3,35,3,32,12,0
400675,2,6,7,-1,8,1
59883,1,0,0,0,11,1
123463,1,0,0,0,4,1
10888,1,0,7,-7,5,1
107820,4,7,23,-16,15,1
335960,2,0,15,-15,13,1
335651,1,0,0,0,13,1
28659,2,3,7,-4,14,1
88435,2,7,0,7,6,0
104934,3,3,6,-3,14,0
405558,2,0,14,-14,10,1
134202,2,0,17,-17,10,1
303294,2,20,0,20,16,0
334900,4,27,10,17,13,1
138111,1,7,0,7,11,1
231,3,12,10,2,1,0
169659,3,20,10,10,8,0
403330,3,9,0,9,9,1
42596,1,0,0,0,3,1
372069,4,13,10,3,13,1
108900,4,17,17,0,15,0
243381,1,3,7,-4,6,0
139131,3,12,6,6,12,0
302473,2,3,10,-7,15,1
359510,4,0,21,-21,6,0
169504,2,0,28,-28,8,0
342268,3,13,0,13,16,1
362896,1,0,0,0,8,0
262844,1,7,13,-6,15,0
73306,1,7,0,7,17,1
32881,4,12,7,5,15,1
7249,2,7,13,-6,4,0
65874,2,7,7,0,13,1
131570,4,9,23,-14,8,0
404697,4,33,32,1,10,1
225492,2,0,14,-14,15,1
86690,2,10,7,3,5,1
90647,4,20,33,-13,7,1
221583,3,20,18,2,14,1
29496,4,10,14,-4,14,0
365278,2,10,13,-3,9,0
419129,2,10,3,7,16,1
30480,4,31,35,-4,14,1
70168,3,27,7,20,15,0
127307,2,10,14,-4,6,0
72562,4,19,31,-12,16,0
40808,4,17,35,-18,2,1
176735,4,39,19,20,11,0
169012,2,19,14,5,7,0
40409,1,0,7,-7,2,1
259592,2,0,3,-3,13,1
312814,2,7,0,7,3,1
137445,4,6,28,-22,11,1
337729,1,3,0,3,14,0
227765,3,3,14,-11,16,1
412922,2,6,3,3,14,1
369774,4,45,43,2,11,0
76539,3,7,34,-27,1,1
248228,4,12,10,2,8,0
157242,2,7,3,4,2,0
197119,2,14,17,-3,3,0
65590,2,6,6,0,13,0
143855,4,12,7,5,14,0
78797,4,16,30,-14,2,1
9458,2,10,0,10,5,0
285878,1,6,0,6,8,0
194615,3,21,7,14,2,0
222857,4,24,13,11,14,0
291466,4,21,20,1,10,0
192214,4,3,33,-30,1,1
245058,4,21,27,-6,7,0
4793,3,26,0,26,3,1
269248,3,3,13,-10,17,1
271748,3,16,10,6,2,0
94994,3,6,16,-10,9,1
154555,2,7,7,0,1,1
177243,2,14,10,4,11,0
289044,4,32,21,11,9,1
85979,3,14,16,-2,5,1
110037,3,34,10,24,16,1
12940,5,13,13,0,6,0
119573,2,10,0,10,3,0
268151,2,9,14,-5,17,1
147160,4,17,46,-29,15,0
348427,4,13,23,-10,1,0
332820,4,35,16,19,12,1
252937,2,9,0,9,11,1
198219,4,13,9,4,3,1
180750,2,7,3,4,13,0
283899,3,28,17,11,7,0
60193,2,3,7,-4,11,1
306143,2,6,0,6,17,1
404669,4,20,29,-9,10,1
196858,3,3,20,-17,3,1
384678,2,7,17,-10,1,1
33186,1,7,0,7,16,1
231127,2,3,0,3,1,0
190078,2,17,3,14,17,0
171773,2,12,14,-2,9,1
153379,2,0,10,-10,1,1
393462,4,34,27,7,5,0
237524,3,24,7,17,3,1
376803,2,14,7,7,15,0
405412,2,14,10,4,10,0
70357,4,10,33,-23,15,1
396816,1,3,7,-4,6,1
401822,2,7,14,-7,9,1
332418,2,7,3,4,12,1
410349,4,15,26,-11,13,0
322694,5,9,9,0,7,0
3530,1,0,0,0,2,1
410151,3,17,17,0,13,1
6438,4,15,20,-5,3,0
344315,4,22,13,9,17,0
153821,1,0,0,0,1,0
14986,1,0,7,-7,7,1
68399,4,3,21,-18,14,0
235390,2,21,7,14,3,1
37039,1,10,0,10,17,1
175645,1,0,0,0,11,1
136945,4,3,13,-10,11,1
409617,1,0,0,0,12,1
20824,2,14,3,11,10,0
248426,2,10,3,7,8,0
97741,4,16,13,3,11,0
405717,2,10,0,10,10,0
352528,2,20,6,14,3,0
149495,1,7,6,1,16,1
113186,3,41,16,25,17,1
353145,3,13,29,-16,3,1
360817,4,24,37,-13,7,1
244514,2,25,10,15,7,0
259372,4,35,34,1,13,0
341331,2,0,10,-10,16,1
379169,2,6,10,-4,16,1
335010,3,16,10,6,13,0
244327,1,0,7,-7,7,0
402350,4,26,24,2,9,0
287098,1,0,0,0,8,1
269173,1,0,3,-3,17,1
160858,4,34,24,10,4,1
268139,2,6,7,-1,17,0
46725,2,7,0,7,4,0
366319,4,28,10,18,10,0
293077,3,10,13,-3,11,1
109369,1,0,7,-7,16,1
62474,4,13,13,0,12,0
115662,1,3,3,0,1,0
319602,1,3,3,0,6,1
59043,2,3,10,-7,10,0
389930,2,18,10,8,3,0
149664,2,17,0,17,16,0
288880,3,10,24,-14,9,1
207438,2,14,14,0,7,0
41154,2,0,7,-7,2,0
162873,4,13,3,10,5,0
183446,4,27,6,21,14,0
29992,2,17,0,17,14,1
102362,4,13,13,0,13,1
357193,4,18,27,-9,5,0
251826,2,7,7,0,10,0
31834,4,16,24,-8,15,1
115698,2,10,3,7,1,1
121005,2,8,21,-13,3,0
20675,3,10,17,-7,10,1
277100,3,10,14,-4,4,1
161204,1,0,3,-3,4,1
223051,2,14,7,7,14,0
328466,3,3,3,0,10,1
365783,4,17,17,0,9,1
265348,2,7,10,-3,16,1
366510,1,7,7,0,10,1
85431,1,7,0,7,5,0
333129,4,27,30,-3,12,0
185260,3,24,9,15,15,1
46293,1,0,14,-14,4,1
280509,1,7,0,7,5,0
142987,4,10,13,-3,13,0
242216,4,23,14,9,6,1
278317,2,14,6,8,4,0
384415,2,14,0,14,1,1
72686,4,20,10,10,16,0
62543,1,0,0,0,12,1
245162,3,17,25,-8,7,0
145901,2,0,0,0,15,1
337632,2,14,10,4,14,0
345597,3,14,23,-9,17,1
388492,3,3,16,-13,2,1
395562,4,35,14,21,6,0
340354,3,17,10,7,15,1
113103,1,6,0,6,17,1
286840,1,3,7,-4,8,0
304354,3,20,7,13,16,0
258707,2,0,20,-20,13,1
26657,1,0,0,0,13,0
96908,3,19,7,12,10,0
126551,3,10,6,4,6,1
29225,1,7,0,7,14,1
33418,3,20,20,0,16,0
388166,3,3,6,-3,2,1
162886,4,13,6,7,5,1
128130,4,13,6,7,7,1
234354,3,17,10,7,2,1
81391,2,7,10,-3,3,0
194722,2,0,3,-3,2,0
365666,1,6,0,6,9,1
310402,1,7,0,7,2,0
279424,3,16,24,-8,5,0
135413,4,28,17,11,10,0
23316,2,6,10,-4,11,1
277146,4,10,24,-14,4,1
114296,1,0,6,-6,1,1
252165,3,20,10,10,10,0
410512,1,0,0,0,13,1
269529,3,13,24,-11,1,0
8234,3,9,10,-1,4,0
53149,4,19,38,-19,7,1
138194,3,7,9,-2,11,1
317678,3,16,6,10,5,0
238910,1,0,0,0,4,1
87267,2,17,17,0,6,1
333645,2,0,0,0,12,1
19194,3,21,13,8,10,0
262845,2,7,19,-12,15,0
70884,2,7,17,-10,15,1
316018,4,0,31,-31,4,1
85554,4,17,22,-5,5,1
273806,3,10,7,3,2,0
128950,2,25,3,22,7,1
395985,3,24,17,7,6,0
143967,3,7,10,-3,14,0
128651,3,6,10,-4,7,0
269451,1,0,0,0,1,0
365340,4,17,19,-2,9,1
52407,4,12,17,-5,7,0
300407,1,2,0,2,14,0
371461,3,14,17,-3,12,0
243099,3,7,9,-2,6,1
114629,2,3,3,0,1,0
231875,2,7,20,-13,1,0
384490,4,28,6,22,1,1
131436,4,7,19,-12,8,1
278233,4,34,21,13,4,0
127826,4,17,42,-25,6,1
217430,2,6,0,6,12,0
275293,2,10,2,8,3,1
357801,2,3,14,-11,6,0
12898,4,13,13,0,6,0
91215,4,13,17,-4,8,0
316835,4,16,10,6,4,0
99589,2,0,3,-3,11,0
50069,1,0,7,-7,6,1
409271,3,13,13,0,12,1
353754,4,20,17,3,4,0
290469,1,7,0,7,10,0
302518,3,3,10,-7,15,0
19886,3,13,21,-8,10,0
273057,4,9,3,6,2,1
234537,4,20,20,0,2,0
223101,3,31,14,17,14,0
169957,2,7,10,-3,8,1
64527,1,0,0,0,13,1
68350,2,3,7,-4,14,0
41309,2,7,3,4,2,0
293497,2,10,10,0,11,1
8800,3,19,0,19,4,0
116137,2,7,3,4,1,0
68861,3,6,17,-11,15,0
324158,4,3,10,-7,8,1
156731,4,23,23,0,2,1
237821,2,7,13,-6,4,0
56162,4,27,21,6,9,1
208424,1,7,0,7,8,0
228177,2,7,20,-13,17,0
201313,2,28,3,25,5,0
417834,2,10,0,10,16,0
256305,4,14,17,-3,12,1
337707,4,24,24,0,14,1
48636,4,27,27,0,5,0
146646,2,7,14,-7,15,0
116286,2,17,3,14,1,0
123460,1,0,0,0,4,1
263922,2,16,0,16,15,1
69043,4,27,24,3,15,1
82037,3,16,7,9,3,1
240672,4,36,24,12,5,0
311606,2,6,0,6,2,1
75789,4,42,26,16,1,0
400187,1,0,3,-3,8,1
157376,2,3,7,-4,2,1
104189,4,27,34,-7,13,1
97062,2,19,3,16,10,0
288691,2,0,7,-7,9,0
410822,1,7,0,7,13,1
182081,4,17,24,-7,13,1
386862,4,26,28,-2,2,0
410402,2,6,10,-4,13,1
205793,2,7,0,7,7,1
335720,2,10,7,3,13,1
216696,3,24,6,18,12,1
373684,2,6,15,-9,13,0
170027,4,34,17,17,8,1
224621,3,15,10,5,15,1
243357,4,20,30,-10,6,1
242661,4,13,3,10,6,0
167985,2,0,14,-14,7,1
402513,1,0,0,0,9,1
24873,4,13,6,7,12,1
67457,2,20,7,13,14,0
55419,3,19,10,9,9,1
15881,1,0,7,-7,8,1
249224,2,19,7,12,9,0
174104,4,8,36,-28,10,0
295136,3,7,14,-7,12,1
284875,1,0,0,0,7,1
372109,1,3,7,-4,13,0
64435,2,7,6,1,13,0
151872,1,10,0,10,17,1
227440,2,10,7,3,16,0
275186,3,14,16,-2,3,1
282376,3,10,13,-3,6,0
100617,2,0,7,-7,12,1
227933,3,27,20,7,16,0
72730,1,0,0,0,16,0
158219,3,24,0,24,3,1
7753,3,27,3,24,4,1
331931,4,6,28,-22,12,0
173666,4,13,22,-9,10,0
22406,1,3,24,-21,11,1
287177,3,10,13,-3,8,1
105697,3,28,3,25,14,0
246559,4,36,7,29,8,0
294841,3,35,21,14,12,0
294929,2,7,7,0,12,0
216935,1,0,0,0,12,1
298450,4,13,27,-14,14,1
301137,1,7,3,4,15,1
248237,4,12,13,-1,8,1
103963,3,3,10,-7,13,1
414916,4,42,21,21,15,1
45405,1,7,0,7,4,0
373890,4,34,16,18,13,1
336184,4,17,10,7,13,1
409732,4,10,6,4,12,1
255499,2,17,7,10,12,0
283656,4,23,33,-10,7,1
402370,1,0,7,-7,9,0
129126,4,34,28,6,7,0
32109,3,21,13,8,15,1
3652,4,20,28,-8,2,1
109727,3,10,0,10,16,1
220725,3,13,6,7,13,0
379987,1,0,0,0,16,0
101554,2,13,24,-11,12,0
245819,1,0,7,-7,7,0
304644,2,14,7,7,16,1
190626,1,14,7,7,17,0
118097,2,3,13,-10,2,1
27525,3,23,12,11,13,1
278755,2,0,0,0,5,0
316395,2,13,0,13,4,1
126214,3,21,6,15,6,1
192472,2,0,17,-17,1,1
340098,4,20,15,5,15,0
77918,1,0,0,0,1,1
210898,3,12,3,9,9,1
273487,3,7,13,-6,2,1
99433,1,0,0,0,11,0
91470,2,9,0,9,8,1
394649,4,17,21,-4,5,0
105002,1,0,0,0,14,0
344636,1,3,10,-7,17,1
288790,1,3,7,-4,9,0
410677,1,0,3,-3,13,1
346476,1,10,7,3,1,0
389484,2,13,0,13,3,0
375312,2,7,6,1,14,0
105287,4,10,26,-16,14,1
57580,1,3,0,3,10,0
324518,1,0,7,-7,8,1
388785,3,14,0,14,3,0
127302,2,10,14,-4,6,0
66912,3,9,7,2,14,1
257574,4,19,13,6,13,1
142775,3,12,10,2,13,0
108976,2,16,17,-1,15,0
236595,1,0,0,0,3,1
68753,1,0,0,0,15,1
160915,1,0,0,0,4,1
156451,2,0,3,-3,2,1
225462,2,0,7,-7,15,0
302750,1,3,3,0,15,1
254534,1,0,0,0,11,1
305251,2,21,21,0,16,0
247172,4,26,6,20,8,1
116214,4,25,19,6,1,0
218639,4,10,30,-20,13,0
60990,3,27,16,11,11,1
263239,4,17,20,-3,15,0
95994,2,6,0,6,10,0
312210,2,7,14,-7,2,0
151753,2,7,6,1,17,0
323418,4,23,0,23,7,0
135489,1,7,6,1,10,1
329583,1,10,0,10,11,0
68234,3,20,14,6,14,0
19309,3,14,17,-3,10,1
353544,2,17,0,17,4,1
281827,3,10,0,10,6,1
123265,1,0,0,0,4,0
44993,2,10,3,7,4,1
68048,2,3,10,-7,14,1
117619,2,6,10,-4,2,1
263559,4,20,29,-9,15,0
77796,2,7,14,-7,1,0
418603,3,14,17,-3,16,1
321542,1,0,3,-3,7,1
96519,4,17,24,-7,10,0
58650,5,20,20,0,10,0
20241,4,27,10,17,10,1
145196,4,49,0,49,14,0
61014,3,34,16,18,11,0
333160,1,0,0,0,12,0
25757,4,17,17,0,12,0
264247,2,10,10,0,15,1
251875,3,14,13,1,10,1
352203,1,0,3,-3,3,0
207193,4,14,20,-6,7,1
270717,3,6,3,3,1,1
283958,1,0,0,0,7,0
180127,2,7,0,7,13,1
339349,4,45,7,38,15,1
335428,2,13,6,7,13,0
217597,2,3,9,-6,12,1
69110,2,7,7,0,15,1
25895,4,31,17,14,12,1
333239,3,6,14,-8,12,1
342799,4,7,14,-7,16,0
124757,3,3,9,-6,5,0
128129,4,13,6,7,7,1
8208,3,0,10,-10,4,0
404370,4,20,6,14,10,0
9731,1,0,7,-7,5,0
178566,4,16,13,3,12,0
353089,2,7,16,-9,3,0
187154,4,16,0,16,16,0
263088,4,10,13,-3,15,0
267267,3,17,14,3,17,0
31123,1,0,3,-3,15,1
401934,1,0,3,-3,9,0
339959,1,7,0,7,15,0
126799,1,0,6,-6,6,0
349064,4,20,17,3,2,0
325466,2,16,3,13,8,0
415362,4,14,24,-10,15,1
262999,2,7,0,7,15,0
189812,3,17,17,0,17,1
371559,2,3,0,3,12,1
73424,4,30,3,27,17,1
288586,4,23,31,-8,9,0
256992,1,0,7,-7,12,0
323042,2,14,7,7,7,0
302607,1,0,3,-3,15,1
58678,1,7,7,0,10,1
157241,2,7,3,4,2,0
46878,2,13,6,7,5,0
315780,2,0,3,-3,4,0
50342,4,13,23,-10,6,0
188692,2,0,17,-17,16,1
250580,1,0,0,0,10,1
263683,4,27,13,14,15,1
377058,1,0,7,-7,15,1
281582,1,7,0,7,6,0
107235,4,14,31,-17,15,1
395574,1,0,0,0,6,0
409037,1,3,0,3,12,0
129970,1,0,0,0,8,0
271478,3,14,0,14,1,1
370385,1,0,0,0,12,1
399412,4,37,10,27,7,0
62418,2,0,10,-10,12,1
161501,4,10,6,4,4,1
187548,3,6,16,-10,16,1
136946,4,9,13,-4,11,1
76703,4,16,7,9,1,0
237017,1,0,7,-7,3,1
152004,1,0,0,0,17,1
231204,4,10,7,3,1,0
154371,4,34,24,10,1,1
338743,4,27,17,10,14,1
153280,3,2,7,-5,1,1
3363,4,10,6,4,2,0
235492,1,0,0,0,3,0
275045,3,34,17,17,3,0
380085,4,35,23,12,16,0
253225,2,0,7,-7,11,1
247404,2,3,9,-6,8,0
393048,1,0,3,-3,4,0
7587,2,14,3,11,4,1
30913,3,3,24,-21,15,0
181576,3,13,3,10,13,0
405755,3,10,7,3,10,1
208678,4,9,6,3,8,0
47543,3,37,6,31,5,0
119887,1,0,7,-7,3,1
23035,3,7,14,-7,11,1
137339,1,3,0,3,11,0
55161,4,29,17,12,8,0
365252,2,3,7,-4,9,0
388547,1,0,0,0,3,1
312456,1,0,0,0,3,1
94907,1,0,0,0,9,0
99850,1,0,0,0,12,1
91110,1,0,0,0,8,1
380018,2,14,0,14,16,0
174243,4,10,33,-23,10,1
57757,2,16,3,13,10,1
105427,4,23,24,-1,14,1
105221,2,7,24,-17,14,0
109081,1,0,0,0,15,1
24090,3,7,7,0,12,0
317029,2,0,10,-10,4,0
34304,3,20,9,11,16,1
103682,3,0,10,-10,13,0
19043,4,7,6,1,10,1
145644,3,28,7,21,14,1
72552,4,19,24,-5,16,0
159440,4,20,20,0,3,0
19879,3,13,21,-8,10,1
142678,4,20,20,0,13,0
349524,1,0,6,-6,2,0
66116,4,10,6,4,13,0
287564,4,20,43,-23,9,1
176077,4,24,8,16,11,0
252398,4,13,29,-16,10,0
175173,4,42,17,25,10,0
340027,3,14,12,2,15,1
123409,4,28,27,1,4,0
142860,1,0,0,0,13,0
132214,1,6,0,6,9,1
410217,1,7,0,7,13,1
256319,4,14,17,-3,12,1
283142,3,6,9,-3,7,1
28,1,0,0,0,1,0
190940,2,9,0,9,17,0
166760,3,20,9,11,6,0
196673,2,27,0,27,3,0
347722,1,0,0,0,1,1
5280,4,24,31,-7,3,1
322739,1,3,14,-11,7,0
320933,4,13,21,-8,6,1
274241,3,17,7,10,3,0
5611,1,0,7,-7,3,1
73477,2,3,14,-11,17,0
86398,2,20,7,13,5,0
344185,1,0,0,0,17,1
375891,1,7,3,4,14,1
394904,3,0,17,-17,5,0
57602,2,3,3,0,10,1
294830,3,35,21,14,12,0
243741,2,17,3,14,6,0
142995,4,10,20,-10,13,1
87767,4,6,20,-14,6,1
279042,1,0,0,0,5,1
188936,4,23,13,10,16,1
159620,4,20,20,0,3,1
410628,4,17,17,0,13,1
44939,4,14,38,-24,4,1
166488,4,20,17,3,6,1
59408,1,0,0,0,11,1
52658,2,3,10,-7,7,0
219256,4,22,10,12,13,0
13301,2,6,20,-14,7,1
202292,3,6,3,3,5,1
97404,3,9,23,-14,10,1
180958,3,17,14,3,13,0
149317,4,20,27,-7,16,1
169421,4,6,31,-25,8,1
139633,4,9,17,-8,12,1
303506,4,37,17,20,16,0
64601,3,20,14,6,13,0
171602,2,3,3,0,9,1
8121,4,27,20,7,4,0
163407,2,0,6,-6,5,0
116367,1,0,0,0,1,1
231899,3,7,34,-27,1,1
281559,4,27,23,4,6,0
275090,1,0,0,0,3,1
369162,3,19,7,12,11,1
205453,1,7,0,7,6,1
235173,4,7,17,-10,2,0
407427,3,14,7,7,11,1
203231,4,10,17,-7,5,0
411717,1,0,3,-3,13,0
63840,1,0,7,-7,12,1
408426,1,0,0,0,12,0
180290,2,6,7,-1,13,1
364346,1,0,0,0,9,1
243029,1,0,0,0,6,0
306709,2,10,3,7,17,0
292283,2,6,7,-1,11,0
315977,3,0,24,-24,4,0
295353,1,3,0,3,12,0
119453,3,7,17,-10,3,1
210233,1,0,0,0,9,0
154491,4,14,10,4,1,0
357936,1,7,6,1,6,0
152538,4,24,7,17,17,1
322831,4,3,40,-37,7,1
96683,1,0,0,0,10,0
251130,4,10,17,-7,10,0
399003,1,7,9,-2,7,0
258836,2,7,7,0,13,1
276664,3,20,6,14,4,1
246406,4,26,18,8,7,0
372854,1,0,0,0,13,1
151005,1,0,0,0,17,1
13423,2,3,14,-11,7,0
98537,1,0,0,0,11,0
131319,1,0,0,0,8,1
335458,3,13,9,4,13,0
219125,1,0,0,0,13,0
263444,2,6,13,-7,15,0
186116,1,3,0,3,15,1
388104,1,3,0,3,2,0
49875,4,28,17,11,6,0
343613,2,15,7,8,17,0
328678,4,27,38,-11,10,1
39808,1,0,0,0,1,1
76037,2,10,13,-3,1,0
346819,2,10,3,7,1,0
177326,1,0,0,0,11,1
61140,3,0,7,-7,11,1
215777,3,29,6,23,11,1
407608,3,10,17,-7,11,0
270225,2,3,14,-11,1,0
326852,4,10,17,-7,9,0
318687,1,3,13,-10,5,0
149398,3,6,20,-14,16,0
318278,2,3,7,-4,5,0
43561,4,24,3,21,3,0
9113,4,30,19,11,4,0
58133,3,20,10,10,10,0
284661,3,14,27,-13,7,0
210875,2,7,3,4,9,1
402134,2,12,0,12,9,0
413964,2,3,7,-4,14,0
205362,3,20,0,20,6,0
122482,4,13,26,-13,4,0
23173,2,23,0,23,11,0
122306,3,6,19,-13,4,0
243886,2,16,6,10,6,0
337760,2,19,6,13,14,1
201188,3,20,21,-1,5,0
187465,1,0,0,0,16,0
241431,3,7,35,-28,5,1
178805,2,24,14,10,12,1
286163,5,24,24,0,8,0
385746,2,10,0,10,1,1
286629,4,17,41,-24,8,0
78583,3,16,10,6,2,0
22661,4,30,17,13,11,0
420230,4,3,13,-10,17,1
232463,2,3,0,3,1,1
297737,4,24,23,1,13,1
49439,5,20,20,0,6,0
316437,3,16,10,6,4,1
6026,1,0,7,-7,3,1
318305,3,9,7,2,5,0
209067,2,3,10,-7,8,0
199710,3,28,7,21,4,0
352757,4,24,13,11,3,0
190154,4,30,3,27,17,1
362761,1,0,0,0,8,1
178905,1,0,3,-3,12,1
252823,3,9,13,-4,11,0
349174,3,27,7,20,2,0
268656,4,20,20,0,17,0
14646,3,17,14,3,7,1
195389,3,17,3,14,2,0
6401,3,9,13,-4,3,1
143841,4,12,7,5,14,1
296381,4,13,28,-15,13,1
10614,2,0,10,-10,5,1
341204,2,13,7,6,16,0
193499,4,33,20,13,1,1
328498,3,6,3,3,10,1
143384,3,7,23,-16,14,0
394607,3,17,0,17,5,0
240030,3,10,20,-10,5,1
300326,3,0,7,-7,14,0
17201,2,7,21,-14,9,0
65803,4,27,33,-6,13,1
30195,3,13,17,-4,14,0
326174,2,7,10,-3,9,0
159545,2,14,6,8,3,1
149537,2,14,9,5,16,1
277055,2,3,0,3,4,0
207023,2,28,3,25,7,0
106316,3,7,12,-5,14,1
104613,2,7,3,4,14,0
299848,2,10,0,10,14,1
64318,3,6,13,-7,13,0
244636,1,0,10,-10,7,0
362680,3,3,10,-7,8,0
297872,4,21,27,-6,13,1
109256,2,6,0,6,15,1
77235,3,16,0,16,1,0
221619,4,20,21,-1,14,1
229704,2,13,7,6,17,0
146772,1,7,0,7,15,0
276211,3,24,10,14,3,1
327210,1,0,3,-3,9,1
109857,2,17,0,17,16,1
251621,4,19,20,-1,10,1
18483,4,10,14,-4,9,1
242905,3,21,13,8,6,0
86544,2,20,3,17,5,1
213203,2,3,10,-7,10,1
339999,2,14,6,8,15,1
226627,3,10,6,4,16,1
213221,3,10,13,-3,10,0
394018,3,6,13,-7,5,1
93446,3,3,14,-11,9,1
308539,2,6,9,-3,1,0
84707,2,3,7,-4,4,1
126464,1,0,3,-3,6,0
282649,2,6,10,-4,6,1
179223,2,14,3,11,12,1
63190,3,14,23,-9,12,0
415688,1,0,0,0,15,0
244641,2,0,10,-10,7,0
363463,4,28,42,-14,8,0
404679,4,27,29,-2,10,0
3431,2,3,16,-13,2,1
255514,3,17,7,10,12,0
284714,1,0,7,-7,7,1
366177,4,7,45,-38,10,0
52281,4,27,19,8,7,1
418080,1,0,0,0,16,1
190661,2,28,14,14,17,0
359395,4,13,23,-10,6,1
234686,3,30,20,10,2,0
189165,2,21,0,21,16,0
14551,1,0,0,0,7,0
278301,2,14,0,14,4,0
13087,4,21,14,7,6,0
156951,2,7,10,-3,2,0
290560,4,23,20,3,10,0
126518,2,7,6,1,6,1
141693,3,23,21,2,13,1
411138,2,0,13,-13,13,0
254851,1,0,0,0,12,0
263255,1,0,0,0,15,0
29774,4,41,3,38,14,1
254571,2,7,7,0,11,0
152207,2,14,0,14,17,1
69397,2,7,3,4,15,1
96316,2,0,16,-16,10,0
331623,4,23,30,-7,11,0
140079,1,0,0,0,12,0
67962,4,29,6,23,14,0
290016,1,7,0,7,10,1
244549,3,25,13,12,7,0
285343,4,27,9,18,7,0
105863,3,16,10,6,14,1
157783,4,20,10,10,2,0
392242,4,10,16,-6,4,1
343976,3,16,6,10,17,0
391281,2,14,0,14,4,0
419875,2,3,11,-8,17,1
273416,1,0,0,0,2,1
59920,2,3,3,0,11,1
293052,3,10,13,-3,11,0
49477,1,0,0,0,6,0
211795,2,0,7,-7,9,1
80795,2,3,0,3,3,0
125850,1,3,0,3,6,0
135114,3,31,6,25,10,0
308104,2,13,16,-3,1,0
394115,1,0,7,-7,5,1
90579,2,14,7,7,7,0
91588,1,0,7,-7,8,0
60563,4,30,34,-4,11,1
191667,2,0,10,-10,17,0
45294,2,7,7,0,4,0
347805,3,10,0,10,1,1
100437,1,0,7,-7,12,1
228785,2,3,7,-4,17,0
295658,2,0,0,0,12,0
115517,1,0,3,-3,1,0
335499,4,13,12,1,13,0
42523,3,10,21,-11,3,1
234085,4,20,7,13,2,0
192488,3,7,17,-10,1,0
71234,4,22,20,2,16,0
276427,1,0,0,0,4,1
233258,2,0,3,-3,2,0
230047,4,19,6,13,17,0
410723,2,17,3,14,13,0
313418,2,7,7,0,3,1
291740,3,3,14,-11,11,0
306109,1,0,0,0,17,1
417083,3,27,0,27,15,0
105023,1,0,7,-7,14,0
225742,1,3,7,-4,16,1
169276,4,23,6,17,7,0
308429,3,7,25,-18,1,1
420191,3,3,3,0,17,0
224844,4,11,16,-5,15,1
296533,4,26,3,23,13,1
275873,2,10,3,7,3,0
71597,2,3,17,-14,16,1
380964,3,9,14,-5,16,1
17102,3,23,3,20,9,0
224011,2,14,6,8,15,0
166298,3,7,9,-2,6,1
143209,2,7,10,-3,13,1
114524,3,17,34,-17,1,1
156634,2,3,0,3,2,1
340510,3,0,34,-34,15,1
307089,4,24,6,18,17,1
60882,4,17,26,-9,11,1
386378,3,17,6,11,2,0
312598,4,44,7,37,3,1
143262,4,17,16,1,13,1
22870,2,0,10,-10,11,0
364807,1,3,0,3,9,0
335809,1,7,0,7,13,0
171087,4,23,40,-17,8,1
241605,4,6,27,-21,5,0
417652,2,21,3,18,16,0
24324,1,0,0,0,12,1
308859,3,10,10,0,1,0
74419,3,10,20,-10,17,1
418427,2,14,3,11,16,0
18497,4,17,14,3,9,1
253015,1,0,0,0,11,0
54415,4,33,25,8,8,0
270253,3,3,21,-18,1,0
186412,1,3,0,3,15,0
60441,4,23,24,-1,11,1
56819,4,17,20,-3,9,1
352225,2,0,3,-3,3,1
361384,3,17,7,10,7,0
229780,4,20,17,3,17,1
104082,2,10,13,-3,13,0
242473,3,3,10,-7,6,1
36853,4,24,35,-11,17,1
331491,4,9,23,-14,11,0
35055,3,15,10,5,16,1
95885,4,13,23,-10,10,1
44685,1,0,9,-9,3,1
336160,3,16,3,13,13,1
377067,1,0,7,-7,15,1
25150,3,20,3,17,12,1
329108,4,24,7,17,10,0
398612,2,0,0,0,7,1
133267,1,0,0,0,9,1
319829,3,17,10,7,6,1
353355,1,3,0,3,4,0
166395,2,3,7,-4,6,1
310806,4,13,13,0,2,0
8916,3,21,0,21,4,0
410581,3,10,7,3,13,1
32404,3,31,6,25,15,1
261310,1,0,0,0,14,0
367287,3,3,17,-14,10,1
91171,2,9,14,-5,8,1
146981,2,17,0,17,15,0
38156,1,0,0,0,1,1
267696,3,14,24,-10,17,0
378966,1,0,0,0,15,1
76893,1,0,10,-10,1,1
367581,3,14,12,2,10,1
20232,4,27,10,17,10,0
336166,3,17,3,14,13,0
131713,3,24,22,2,8,0
27405,4,27,10,17,13,0
198121,1,0,3,-3,3,1
207025,3,28,3,25,7,0
3978,4,29,20,9,2,1
121980,3,13,7,6,4,1
80259,4,35,31,4,2,0
308985,2,0,17,-17,1,1
209773,4,16,6,10,8,0
400359,2,17,10,7,8,0
44547,2,0,7,-7,3,0
277422,4,31,9,22,4,1
33652,2,14,0,14,16,1
4176,1,7,3,4,2,0
296819,4,14,7,7,13,0
14280,2,0,7,-7,7,1
238183,2,3,16,-13,4,1
70609,3,17,10,7,15,0
136603,3,15,16,-1,11,0
345717,3,7,7,0,17,0
260797,2,3,12,-9,14,1
388023,3,6,6,0,2,1
222652,3,7,10,-3,14,1
84946,1,0,0,0,4,1
275276,2,10,2,8,3,1
282639,2,6,7,-1,6,0
106697,1,0,2,-2,14,0
5569,4,19,10,9,3,1
33721,4,35,7,28,16,1
214045,4,43,14,29,10,0
302216,2,28,7,21,15,0
59585,1,0,3,-3,11,1
264606,4,12,17,-5,16,0
365371,1,0,0,0,9,1
420600,2,0,10,-10,17,1
297013,1,0,0,0,13,1
215984,4,20,42,-22,11,1
168922,4,24,6,18,7,0
159709,2,7,7,0,3,0
47984,3,3,24,-21,5,0
349322,3,28,34,-6,2,0
63586,2,13,14,-1,12,1
279565,3,10,13,-3,5,0
157570,2,5,0,5,2,0
288064,2,7,0,7,9,1
69457,3,24,10,14,15,0
33383,2,13,10,3,16,1
402151,3,19,0,19,9,0
105871,3,19,10,9,14,1
302084,3,20,24,-4,15,0
418615,3,14,17,-3,16,0
280016,3,3,20,-17,5,1
31661,4,24,9,15,15,0
342862,2,16,0,16,16,0
295951,4,13,24,-11,12,0
180069,4,28,20,8,13,1
338977,2,13,0,13,15,0
61783,1,0,10,-10,12,1
356923,2,3,0,3,5,0
396226,1,0,3,-3,6,1
158091,4,22,9,13,3,1
106324,3,7,19,-12,14,1
78136,2,14,3,11,2,1
308306,4,16,23,-7,1,0
411216,4,11,23,-12,13,1
313121,2,6,3,3,3,1
76992,4,17,13,4,1,0
277049,1,3,0,3,4,1
325561,1,0,0,0,9,1
196705,3,33,0,33,3,1
126444,1,0,0,0,6,1
168600,3,14,13,1,7,1
82381,4,13,10,3,3,0
58717,2,10,17,-7,10,0
63321,3,17,3,14,12,1
125790,3,14,20,-6,5,0
107616,2,13,7,6,15,0
90679,4,27,33,-6,7,0
407558,2,10,6,4,11,0
8538,4,22,10,12,4,0
275557,1,7,0,7,3,1
38589,4,38,13,25,1,1
371354,4,42,10,32,12,1
140947,4,20,13,7,13,1
121074,4,11,31,-20,3,0
154365,4,34,24,10,1,0
299775,4,17,14,3,14,0
270570,3,13,14,-1,1,0
30096,1,0,0,0,14,0
352147,4,9,20,-11,3,0
151150,2,3,10,-7,17,0
163273,2,6,6,0,5,1
262179,4,31,13,18,15,0
380631,2,7,7,0,16,0
95109,2,3,10,-7,9,0
369200,4,22,20,2,11,1
127718,1,0,7,-7,6,1
227153,3,10,7,3,16,0
372867,1,3,0,3,13,1
369710,2,22,17,5,11,0
77030,1,7,7,0,1,0
184909,1,0,7,-7,15,0
104102,2,17,13,4,13,0
46823,4,14,39,-25,4,0
249360,2,10,12,-2,9,0
31671,4,24,16,8,15,1
221258,2,0,19,-19,14,1
445,4,45,26,19,1,1
72475,2,10,10,0,16,1
194085,4,35,14,21,1,1
378154,2,21,9,12,15,1
96292,2,0,9,-9,10,0
78243,1,0,0,0,2,0
336471,4,10,17,-7,14,1
213327,1,3,3,0,10,0
349902,3,3,6,-3,2,0
208426,1,7,0,7,8,0
54682,4,27,29,-2,8,0
232363,3,13,15,-2,1,0
157861,2,6,9,-3,3,0
206530,1,0,3,-3,7,1
337442,1,0,6,-6,14,0
359847,1,16,7,9,6,1
362373,3,30,14,16,8,0
215417,1,7,0,7,11,0
80220,3,21,24,-3,2,1
339378,1,0,3,-3,15,0
280773,4,14,14,0,5,1
322405,4,17,19,-2,7,0
362307,1,0,7,-7,8,1
265245,3,9,6,3,16,1
417322,2,7,3,4,16,1
190915,1,6,0,6,17,0
37594,1,7,0,7,17,1
200943,4,40,14,26,4,0
324234,2,3,0,3,8,1
120596,3,0,20,-20,3,1
308154,4,16,19,-3,1,0
188119,2,6,10,-4,16,1
336052,4,16,28,-12,13,1
135271,4,24,17,7,10,1
167562,4,3,17,-14,7,1
66641,3,7,17,-10,14,1
304752,1,0,0,0,16,1
138550,5,31,37,-6,12,0
222639,2,7,7,0,14,1
158971,3,14,29,-15,3,1
207174,3,14,13,1,7,1
409932,1,0,14,-14,12,1
392808,3,17,6,11,4,0
90245,1,0,7,-7,7,0
201937,2,0,0,0,5,1
141883,4,24,21,3,13,0
42266,4,30,7,23,2,1
229743,3,13,17,-4,17,1
277210,2,0,10,-10,4,0
366025,3,30,14,16,10,1
314630,3,7,7,0,3,0
38776,2,0,3,-3,1,0
328688,4,30,38,-8,10,0
224298,2,9,9,0,15,0
323484,2,3,10,-7,7,1
410089,2,14,7,7,13,0
96066,4,13,14,-1,10,0
398193,2,14,10,4,7,0
222354,3,21,3,18,14,0
290721,4,44,25,19,10,0
32420,4,31,6,25,15,0
234452,2,10,6,4,2,1
392835,3,17,20,-3,4,1
199589,4,40,17,23,4,1
95913,4,20,23,-3,10,1
289793,3,17,10,7,10,0
342711,2,0,7,-7,16,0
193587,3,0,10,-10,1,1
85642,2,17,0,17,5,0
196365,2,10,0,10,2,1
5507,2,10,10,0,3,0
40789,4,17,28,-11,2,1
198751,2,3,3,0,3,1
238166,2,3,9,-6,4,0
99270,1,7,0,7,11,0
13542,1,0,0,0,7,0
318533,1,0,0,0,5,0
286284,3,13,16,-3,8,1
358479,4,38,27,11,6,1
286700,2,10,7,3,8,0
156762,1,7,7,0,2,1
110936,3,7,10,-3,16,1
268393,1,7,0,7,17,0
375751,2,6,0,6,14,0
407468,4,17,10,7,11,1
63629,3,13,33,-20,12,1
319002,2,6,16,-10,5,1
8305,1,0,0,0,4,1
362264,4,18,24,-6,8,1
345967,4,27,30,-3,17,1
105799,1,3,3,0,14,1
111833,3,6,10,-4,17,0
145261,1,14,6,8,14,0
306707,2,9,3,6,17,1
26527,1,3,0,3,13,0
86708,3,17,7,10,5,0
347296,3,6,7,-1,1,1
236637,2,3,0,3,3,1
71033,2,20,0,20,16,1
5079,3,13,0,13,3,0
416368,4,16,6,10,15,0
186782,2,23,7,16,15,1
178626,2,3,3,0,12,0
420775,2,0,3,-3,17,1
421789,1,0,3,-3,17,1
151920,3,20,10,10,17,0
122118,2,17,14,3,4,0
20059,4,19,16,3,10,0
24476,1,0,0,0,12,0
57717,1,0,0,0,10,0
115222,1,0,3,-3,1,0
189712,1,0,0,0,17,0
57614,2,3,3,0,10,1
487,2,7,6,1,1,0
152188,2,7,0,7,17,1
227230,1,0,0,0,16,0
168490,4,3,24,-21,7,1
324746,3,19,7,12,8,1
46717,1,7,0,7,4,1
38619,1,0,0,0,1,1
66958,4,21,7,14,14,0
36418,4,34,26,8,17,0
132091,1,7,0,7,9,1
165380,2,3,17,-14,6,1
219944,2,6,7,-1,13,0
334110,2,16,0,16,13,0
3973,4,29,14,15,2,0
224585,2,6,7,-1,15,1
116546,1,0,0,0,2,0
174771,1,6,7,-1,10,1
187923,1,0,7,-7,16,0
251752,4,30,9,21,10,0
74886,4,20,20,0,17,1
382210,1,3,3,0,17,1
135741,4,23,29,-6,10,0
5242,3,21,24,-3,3,1
340860,1,0,0,0,15,0
100120,4,16,6,10,12,0
78487,4,24,0,24,2,0
12562,3,3,17,-14,6,0
273398,4,38,14,24,2,1
372546,5,29,27,2,13,0
243403,2,3,10,-7,6,1
75411,2,10,7,3,17,1
120298,4,24,13,11,3,1
319176,3,2,3,-1,5,0
401548,2,14,14,0,8,1
73858,4,13,7,6,17,0
233565,2,14,14,0,2,0
98341,4,41,35,6,11,1
383750,1,0,0,0,1,0
30908,3,3,24,-21,15,0
315393,3,16,17,-1,4,0
277215,2,0,10,-10,4,0
259351,4,28,27,1,13,0
358164,3,17,9,8,6,1
246655,3,31,3,28,8,0
110945,3,7,10,-3,16,1
253738,3,17,10,7,11,1
158316,2,6,14,-8,3,1
255101,4,6,31,-25,12,1
226455,3,7,7,0,16,0
314702,4,17,28,-11,3,1
301147,2,10,3,7,15,1
248695,1,3,0,3,9,1
63020,3,9,21,-12,12,1
137668,1,0,7,-7,11,0
94099,4,6,31,-25,9,1
359352,3,3,20,-17,6,1
112967,1,7,0,7,17,1
99573,1,0,0,0,11,1
326155,1,0,7,-7,9,1
278044,3,10,10,0,4,1
70653,4,17,20,-3,15,0
343705,4,18,10,8,17,0
211164,2,0,10,-10,9,1
315803,2,0,13,-13,4,0
234737,1,0,0,0,2,0
222796,2,10,10,0,14,0
32771,1,0,0,0,15,1
259278,2,13,7,6,13,1
376647,2,0,0,0,14,1
75975,1,7,0,7,1,0
83331,1,0,7,-7,4,1
211259,4,29,26,3,9,0
167390,4,37,33,4,7,1
49025,2,10,7,3,6,0
409260,3,13,13,0,12,0
406109,3,0,26,-26,11,0
204800,4,28,24,4,6,1
421794,1,0,3,-3,17,1
413606,4,9,17,-8,14,0
46671,4,10,3,7,4,0
55159,4,29,17,12,8,0
398488,3,14,9,5,7,1
341675,2,17,13,4,16,1
236772,2,0,9,-9,3,1
20962,2,7,24,-17,10,1
406887,4,27,23,4,11,0
193439,3,23,20,3,1,0
305173,4,27,10,17,16,1
43101,4,3,17,-14,3,1
304116,4,16,30,-14,16,0
187632,1,0,3,-3,16,0
245054,4,14,27,-13,7,1
46902,3,13,20,-7,5,0
349349,4,30,42,-12,2,0
402133,2,12,0,12,9,0
420144,2,0,3,-3,17,0
238193,2,3,16,-13,4,0
208202,3,0,10,-10,8,0
211756,1,0,0,0,9,0
122463,3,13,26,-13,4,1
383801,2,3,7,-4,1,0
152872,1,0,7,-7,1,1
159312,4,27,24,3,3,0
400883,4,31,19,12,8,0
151212,3,10,20,-10,17,1
54140,1,0,0,0,8,1
2112,3,10,13,-3,1,1
373310,1,0,0,0,13,0
190132,4,27,3,24,17,1
98226,1,0,0,0,11,0
14926,3,14,17,-3,7,1
405297,3,14,7,7,10,1
151429,1,14,0,14,17,0
326370,3,17,10,7,9,1
380151,1,0,0,0,16,1
290431,4,35,10,25,10,0
105122,4,26,14,12,14,1
30541,1,0,0,0,14,1
377965,1,0,7,-7,15,1
372958,4,25,7,18,13,0
343015,2,3,0,3,16,0
79,3,7,7,0,1,0
346014,2,0,3,-3,1,1
91776,2,3,0,3,8,1
336464,4,10,17,-7,14,1
148719,1,10,0,10,16,0
158911,2,14,3,11,3,0
122992,2,0,3,-3,4,0
401348,1,0,0,0,8,1
249144,4,28,28,0,9,1
390211,2,0,6,-6,3,1
359013,3,10,0,10,6,1
292948,4,10,0,10,11,0
105684,2,27,3,24,14,1
30380,1,0,6,-6,14,0
248310,2,17,7,10,8,1
202636,4,27,20,7,5,0
283859,2,7,3,4,7,0
246849,4,19,20,-1,8,1
143337,2,0,13,-13,14,1
328087,1,0,0,0,10,0
247864,2,10,3,7,8,0
195117,4,7,29,-22,2,0
197977,2,0,10,-10,3,0
11934,1,0,0,0,6,0
36146,1,0,0,0,17,0
271845,1,0,3,-3,2,1
417627,2,14,3,11,16,1
324860,2,10,10,0,8,1
273894,1,0,3,-3,2,0
14615,2,10,7,3,7,1
10585,1,0,7,-7,5,0
39347,1,0,0,0,1,0
151502,3,35,7,28,17,0
330713,4,6,6,0,11,0
184392,3,21,6,15,14,1
282042,1,3,0,3,6,1
112861,2,7,3,4,17,1
279906,4,24,13,11,5,1
215142,1,7,0,7,11,0
139610,4,9,14,-5,12,1
241616,4,6,27,-21,5,0
10105,4,41,7,34,5,1
190623,1,14,7,7,17,0
381008,1,0,0,0,16,1
263917,2,16,0,16,15,0
353986,5,34,37,-3,4,0
139924,1,7,3,4,12,1
27852,4,17,17,0,13,0
380764,2,3,7,-4,16,0
140340,3,17,20,-3,12,0
302159,1,6,0,6,15,1
288214,2,3,7,-4,9,0
230971,1,0,0,0,1,1
113276,2,10,21,-11,17,1
93416,2,3,14,-11,9,1
321006,2,10,7,3,6,1
384531,1,0,21,-21,1,1
272843,2,20,0,20,2,1
82636,3,12,10,2,3,1
342599,3,19,20,-1,16,1
227954,4,30,27,3,16,1
171800,3,23,14,9,9,1
60628,1,0,3,-3,11,1
395233,3,10,13,-3,5,1
27881,1,0,0,0,13,0
68151,1,0,6,-6,14,0
130344,2,7,0,7,8,0
320329,4,14,24,-10,6,1
135863,4,21,17,4,10,0
113327,3,19,31,-12,17,1
97916,1,0,7,-7,11,1
9297,2,7,0,7,5,0
299358,1,0,0,0,14,0
144411,2,0,13,-13,14,1
241211,1,0,0,0,5,0
217559,2,3,3,0,12,1
384579,2,9,42,-33,1,1
170296,3,0,12,-12,8,0
374158,3,23,7,16,13,0
307208,3,0,10,-10,17,0
112414,3,13,13,0,17,1
154410,1,7,0,7,1,0
126284,1,0,0,0,6,1
202230,1,3,0,3,5,1
136321,3,18,7,11,11,0
188841,1,3,0,3,16,0
416758,2,7,7,0,15,0
66569,1,0,7,-7,14,0
380569,4,21,24,-3,16,0
258505,1,0,0,0,13,0
346527,3,24,30,-6,1,0
164783,3,26,14,12,6,0
270342,5,33,27,6,1,1
139843,3,13,17,-4,12,1
399632,2,6,6,0,8,1
173607,2,0,13,-13,10,1
141315,1,0,7,-7,13,0
229476,4,13,9,4,17,0
362464,1,0,6,-6,8,0
361843,4,44,10,34,7,1
204481,4,10,24,-14,6,0
224265,2,6,9,-3,15,0
353365,2,3,0,3,4,1
111677,3,21,10,11,16,1
316557,2,3,6,-3,4,0
246524,3,22,7,15,8,0
55563,3,17,7,10,9,1
26213,1,0,7,-7,13,1
279387,2,13,20,-7,5,0
353699,3,3,10,-7,4,0
242032,3,7,3,4,5,1
72282,4,27,33,-6,16,1
113998,5,20,20,0,17,1
41331,2,14,9,5,2,1
22350,4,0,6,-6,11,0
324195,1,0,0,0,8,0
420366,4,20,13,7,17,1
304274,4,33,25,8,16,1
82155,2,10,3,7,3,1
214919,3,7,19,-12,11,1
242625,3,10,0,10,6,1
358900,3,6,35,-29,6,1
359534,4,0,21,-21,6,1
22066,4,24,24,0,11,1
326905,1,0,0,0,9,1
221069,1,0,0,0,14,0
254370,4,13,30,-17,11,1
407697,1,0,0,0,11,1
207824,1,0,0,0,8,1
310843,1,0,0,0,2,1
31405,1,0,0,0,15,1
121714,3,21,14,7,4,0
238075,4,13,13,0,4,0
63956,4,6,27,-21,12,1
38758,1,0,3,-3,1,0
383377,2,0,9,-9,17,1
337233,3,16,23,-7,14,0
212556,1,0,3,-3,10,1
420464,2,0,21,-21,17,0
190812,2,13,3,10,17,1
332911,3,24,3,21,12,1
200584,2,14,14,0,4,1
367131,2,29,13,16,10,0
55046,2,7,0,7,8,1
256751,3,3,6,-3,12,0
88646,3,20,10,10,6,0
305553,2,6,0,6,17,1
252476,2,7,19,-12,10,0
382767,1,7,0,7,17,0
58284,3,20,13,7,10,0
381243,3,14,10,4,16,1
113587,2,3,0,3,17,1
333992,3,17,10,7,12,0
24317,1,0,0,0,12,1
155009,1,6,10,-4,1,0
349502,4,12,20,-8,2,0
90534,4,0,26,-26,7,0
313817,1,0,0,0,3,1
279329,1,0,0,0,5,0
357531,2,10,6,4,5,0
50188,4,6,31,-25,6,1
228908,1,7,3,4,17,1
391164,3,10,24,-14,4,1
336032,4,16,25,-9,13,0
347914,2,0,14,-14,1,0
339327,4,45,7,38,15,0
216460,1,14,0,14,12,1
144014,4,21,10,11,14,0
97257,4,20,13,7,10,0
94009,2,0,21,-21,9,0
311128,4,13,13,0,2,1
350472,3,7,12,-5,2,0
299131,3,3,13,-10,14,0
356184,3,19,0,19,5,0
208728,1,0,0,0,8,1
110598,2,17,7,10,16,0
99543,4,10,17,-7,11,1
156407,1,0,0,0,2,1
165036,2,7,17,-10,6,1
327594,4,10,15,-5,10,0
209319,1,0,7,-7,8,1
171372,4,16,17,-1,9,1
224603,2,6,7,-1,15,1
211726,4,29,16,13,9,0
220071,1,13,0,13,13,0
266200,2,24,0,24,16,0
134235,3,3,23,-20,10,0
378834,1,6,3,3,15,1
385987,4,27,27,0,1,0
324994,2,13,21,-8,8,1
303709,1,7,7,0,16,0
116934,4,21,13,8,2,0
399213,3,13,13,0,7,0
197791,4,21,20,1,3,0
232246,4,15,12,3,1,1
336541,2,0,0,0,14,0
191734,3,16,17,-1,17,0
106983,4,28,13,15,14,1
105249,3,7,24,-17,14,1
376594,4,15,6,9,14,1
14538,4,34,45,-11,7,1
318718,2,10,23,-13,5,1
173887,2,6,10,-4,10,1
14348,4,2,14,-12,7,1
146825,2,17,0,17,15,1
359110,1,7,0,7,6,0
148491,3,24,3,21,16,0
118751,4,27,19,8,2,1
29615,4,14,13,1,14,0
174992,3,12,28,-16,10,1
163324,4,13,23,-10,5,1
183925,2,7,3,4,14,1
368796,1,0,0,0,11,0
71430,2,24,0,24,16,0
314756,2,14,0,14,4,1
421057,1,6,0,6,17,0
122752,4,10,24,-14,4,1
418263,2,6,0,6,16,0
64763,4,28,7,21,13,1
176279,1,0,7,-7,11,1
72298,1,0,0,0,16,1
55166,4,29,17,12,8,0
96829,1,0,0,0,10,0
9904,2,0,3,-3,5,1
126297,1,0,7,-7,6,1
323816,3,13,12,1,8,0
22041,4,17,17,0,11,0
55036,1,7,0,7,8,0
182209,4,33,7,26,13,0
300796,3,10,33,-23,15,0
126231,3,28,6,22,6,0
406961,2,3,13,-10,11,1
393345,1,7,7,0,5,0
63995,2,13,3,10,13,1
126554,3,10,6,4,6,1
112985,2,7,3,4,17,1
222296,1,0,0,0,14,1
214575,2,3,3,0,11,0
200663,4,35,28,7,4,1
388213,4,6,13,-7,2,0
103737,4,9,23,-14,13,1
262382,1,0,0,0,15,0
166439,3,17,7,10,6,0
132741,3,13,17,-4,9,1
66557,1,0,6,-6,14,0
249321,1,3,0,3,9,1
55181,1,0,0,0,9,1
50432,3,10,7,3,6,1
131305,4,21,24,-3,8,1
313976,1,0,0,0,3,1
147098,2,7,31,-24,15,1
253027,1,0,0,0,11,0
315064,3,30,14,16,4,1
362246,4,12,17,-5,8,1
27068,3,17,6,11,13,0
327724,3,6,13,-7,10,0
63805,4,14,34,-20,12,0
214941,4,7,26,-19,11,1
375870,1,0,0,0,14,1
120443,3,19,16,3,3,0
301590,2,7,3,4,15,1
295956,4,13,27,-14,12,1
97607,1,0,0,0,11,1
363994,3,6,9,-3,8,0
295013,4,31,21,10,12,0
76225,3,12,27,-15,1,0
341547,3,13,10,3,16,0
64767,4,28,7,21,13,0
246786,3,3,13,-10,8,1
224666,4,16,10,6,15,1
29623,4,14,21,-7,14,1
70599,2,10,10,0,15,0
363836,3,13,17,-4,8,0
242592,2,3,0,3,6,1
37467,2,0,7,-7,17,0
61199,1,0,0,0,11,0
362769,2,7,6,1,8,0
90900,3,34,7,27,7,1
183016,1,0,0,0,14,1
406121,4,0,26,-26,11,1
327458,4,10,27,-17,9,0
227873,2,10,6,4,16,1
142021,4,20,14,6,13,1
115081,2,3,7,-4,1,1
71721,2,10,13,-3,16,1
17451,1,0,0,0,9,1
27733,1,0,7,-7,13,1
405904,2,14,0,14,11,1
143983,3,7,10,-3,14,1
319582,1,3,0,3,6,0
339371,1,0,3,-3,15,0
317472,2,10,10,0,5,1
333024,2,3,9,-6,12,0
44598,3,17,21,-4,3,1
225816,3,17,14,3,16,1
177415,3,17,10,7,11,0
175415,3,17,6,11,11,0
196900,4,10,22,-12,3,0
351238,3,28,17,11,3,0
315175,2,7,7,0,4,0
389299,1,0,6,-6,3,1
286019,1,0,0,0,8,0
176634,2,7,12,-5,11,1
311404,4,42,20,22,2,1
13218,4,22,26,-4,6,1
192232,1,0,0,0,1,1
404839,4,23,20,3,10,0
254435,2,20,0,20,11,1
300677,4,24,3,21,15,1
152888,2,0,7,-7,1,1
217764,3,10,7,3,12,0
55485,1,0,0,0,9,1
268524,4,23,16,7,17,0
420245,1,0,0,0,17,0
24645,1,14,0,14,12,0
216073,3,17,12,5,11,1
143569,5,28,28,0,14,0
284373,4,14,17,-3,7,1
113788,4,13,17,-4,17,0
203262,1,0,0,0,6,0
270831,2,6,7,-1,1,1
91244,1,0,0,0,8,1
370818,4,32,17,15,12,1
412485,3,17,7,10,14,1
384421,2,14,0,14,1,1
117094,4,7,24,-17,2,1
315929,1,0,0,0,4,0
289846,1,0,0,0,10,0
132985,2,3,14,-11,9,0
118935,1,0,7,-7,3,0
34984,1,6,0,6,16,0
239131,2,13,10,3,4,0
164980,4,17,19,-2,6,0
249507,2,14,3,11,9,0
48292,3,13,13,0,5,0
366910,4,3,16,-13,10,1
57057,3,7,20,-13,9,0
321908,3,14,21,-7,7,0
280017,3,3,20,-17,5,1
168299,3,10,14,-4,7,0
150135,2,3,13,-10,16,0
313374,1,0,0,0,3,1
325647,3,17,7,10,9,0
365473,4,10,19,-9,9,1
107676,4,13,30,-17,15,0
306710,2,10,3,7,17,0
211280,1,3,0,3,9,1
368598,4,16,6,10,11,1
87696,2,0,20,-20,6,1
24581,4,10,23,-13,12,1
114042,2,14,0,14,17,0
390961,2,13,7,6,4,1
309483,4,17,9,8,1,1
160061,4,20,26,-6,3,1
61864,3,19,23,-4,12,1
15083,3,10,26,-16,7,1
18032,4,22,28,-6,9,0
80571,4,16,10,6,3,1
95166,4,23,27,-4,9,1
80876,1,0,0,0,3,1
331697,1,0,13,-13,12,0
216506,2,27,8,19,12,0
10072,2,31,7,24,5,1
289022,3,19,21,-2,9,1
208827,4,6,22,-16,8,0
134883,1,7,6,1,10,0
230518,1,3,0,3,1,1
121350,2,7,0,7,3,1
264159,4,27,27,0,15,0
90283,2,0,14,-14,7,1
238544,3,16,13,3,4,1
274428,4,10,17,-7,3,1
114347,2,17,13,4,1,1
98861,2,7,7,0,11,1
282714,4,9,27,-18,6,1
103739,4,10,23,-13,13,0
355560,2,14,3,11,5,0
353937,4,23,28,-5,4,0
186540,4,24,33,-9,15,1
183602,1,0,0,0,14,0
368096,1,7,0,7,11,1
89777,1,3,0,3,7,0
260691,4,10,25,-15,14,1
174235,4,10,26,-16,10,0
42536,4,10,21,-11,3,1
247298,3,35,28,7,8,0
159919,3,38,7,31,3,0
395268,4,10,16,-6,5,1
127397,4,24,23,1,6,0
311372,3,21,13,8,2,1
23045,3,10,14,-4,11,0
401477,4,27,10,17,8,0
646,2,0,3,-3,1,0
368171,3,21,21,0,11,0
340338,2,17,7,10,15,1
63233,4,17,33,-16,12,1
152804,3,14,7,7,17,0
37665,3,30,0,30,17,0
413244,2,10,0,10,14,0
365441,3,10,19,-9,9,0
269080,3,13,16,-3,17,0
246429,1,7,0,7,8,0
362396,4,30,20,10,8,1
93454,3,3,21,-18,9,1
51237,4,39,25,14,7,0
61484,1,0,7,-7,11,0
335680,1,7,0,7,13,0
216852,2,7,14,-7,12,1
317408,4,7,17,-10,5,1
33644,2,14,0,14,16,0
211919,1,0,0,0,9,0
236466,2,7,3,4,3,0
381163,1,0,0,0,16,1
215558,4,13,6,7,11,0
224248,1,6,3,3,15,0
395219,2,10,13,-3,5,1
57042,3,7,20,-13,9,1
101748,4,13,10,3,12,1
399955,3,12,13,-1,8,0
333681,3,14,0,14,12,0
6117,3,7,10,-3,3,1
35991,4,6,21,-15,17,0
123422,4,28,27,1,4,1
255329,2,14,0,14,12,0
237730,4,20,17,3,4,1
327060,1,0,0,0,9,1
348270,4,16,46,-30,1,1
34033,4,17,27,-10,16,1
222670,3,14,24,-10,14,1
100675,3,21,14,7,12,0
291384,2,7,7,0,10,0
330897,4,16,24,-8,11,0
302585,1,0,0,0,15,1
98027,4,17,24,-7,11,0
56561,2,16,14,2,9,0
230585,3,13,17,-4,1,1
183881,4,50,28,22,14,1
376994,3,15,16,-1,15,1
76094,4,13,23,-10,1,0
46074,3,21,14,7,4,0
48596,3,14,24,-10,5,1
144156,4,23,13,10,14,0
110119,2,7,10,-3,16,0
106127,2,0,0,0,14,1
402916,4,17,9,8,9,1
55492,1,10,0,10,9,0
106053,4,24,3,21,14,1
300887,2,10,7,3,15,0
339425,2,7,17,-10,15,1
12682,2,31,0,31,6,0
356100,1,0,0,0,5,0
3066,1,0,0,0,2,0
65969,4,24,28,-4,13,1
289005,3,19,14,5,9,0
393722,3,0,7,-7,5,0
12316,4,6,9,-3,6,0
35767,2,3,3,0,17,1
214234,2,0,10,-10,11,1
420818,3,10,10,0,17,1
308686,2,7,6,1,1,0
267256,3,17,14,3,17,1
200138,2,7,24,-17,4,0
420082,4,31,21,10,17,0
164044,2,3,3,0,5,1
12151,4,14,21,-7,6,0
79596,2,14,7,7,2,1
147504,1,0,0,0,15,1
401442,3,24,10,14,8,0
67039,2,10,3,7,14,0
255204,2,10,7,3,12,0
234670,3,23,20,3,2,0
119246,2,7,3,4,3,1
260073,2,3,14,-11,14,1
373101,3,10,21,-11,13,0
38351,2,7,6,1,1,1
22153,2,10,6,4,11,0
54847,4,23,0,23,8,0
135254,3,16,3,13,10,0
175924,4,30,27,3,11,0
39244,2,3,3,0,1,0
418255,2,0,0,0,16,1
400245,3,10,6,4,8,1
351385,3,10,13,-3,3,1
384755,4,19,37,-18,1,0
166044,4,20,28,-8,6,0
109978,2,16,7,9,16,1
299828,1,3,0,3,14,1
109180,4,34,7,27,15,0
390042,1,0,0,0,3,1
318042,4,20,16,4,5,1
342967,4,37,31,6,16,1
301016,2,10,3,7,15,1
230893,3,14,10,4,1,1
249546,3,14,10,4,9,0
96848,1,10,0,10,10,0
324351,1,0,0,0,8,1
199693,3,21,7,14,4,1
271045,4,21,28,-7,1,0
108595,4,26,21,5,15,1
382011,4,6,30,-24,17,1
8025,2,10,7,3,4,0
130074,4,17,30,-13,8,0
279331,1,0,0,0,5,1
86612,4,40,3,37,5,1
257573,4,19,13,6,13,1
323387,3,17,0,17,7,1
38960,2,23,3,20,1,1
191729,3,16,17,-1,17,1
296977,4,29,7,22,13,0
415693,1,7,3,4,15,0
352796,2,14,0,14,3,0
404221,4,12,9,3,10,1
23768,2,10,0,10,12,0
190180,1,0,0,0,17,1
253124,4,21,14,7,11,1
359344,3,3,13,-10,6,0
119337,4,14,16,-2,3,0
214722,2,3,7,-4,11,1
185995,2,10,20,-10,15,0
124033,1,0,0,0,5,1
117796,2,6,6,0,2,1
314486,2,14,0,14,3,1
28144,4,30,10,20,13,0
291209,1,0,0,0,10,1
298132,4,3,41,-38,13,1
261093,3,7,14,-7,14,0
370497,4,27,9,18,12,0
17094,3,23,3,20,9,0
93966,1,0,7,-7,9,1
393241,3,14,13,1,5,0
56052,5,24,23,1,9,1
311251,3,6,0,6,2,0
186548,4,27,33,-6,15,1
414740,3,9,17,-8,14,1
218685,1,0,0,0,13,0
241064,1,7,0,7,5,1
407395,2,7,7,0,11,0
293829,4,17,12,5,12,1
415201,4,17,24,-7,15,0
8168,1,0,7,-7,4,1
150728,2,13,9,4,17,0
362054,2,14,7,7,8,1
54927,2,0,3,-3,8,1
242419,1,0,7,-7,6,1
362425,4,30,23,7,8,1
205379,3,27,0,27,6,1
329130,4,27,7,20,10,0
403711,1,3,3,0,9,1
171448,2,7,0,7,9,0
150111,1,0,6,-6,16,0
128744,1,0,0,0,7,0
159277,3,17,24,-7,3,1
336979,1,3,0,3,14,0
91611,2,7,7,0,8,1
49750,1,0,0,0,6,0
188331,4,23,13,10,16,0
168133,2,9,5,4,7,1
217470,3,9,3,6,12,0
243942,4,25,13,12,6,0
420819,3,10,10,0,17,1
34957,4,27,27,0,16,1
374100,1,13,6,7,13,0
339310,3,38,7,31,15,0
97042,2,19,3,16,10,0
362331,2,10,7,3,8,0
170152,3,7,13,-6,8,1
163239,2,3,3,0,5,1
277375,2,17,9,8,4,1
155778,4,30,30,0,2,0
358623,4,27,9,18,6,0
154736,2,3,10,-7,1,1
140331,3,17,20,-3,12,0
360962,4,37,5,32,7,1
405817,5,24,24,0,10,0
306630,3,14,27,-13,17,0
266777,2,0,14,-14,16,1
209049,2,3,9,-6,8,0
388144,2,3,6,-3,2,0
257543,3,19,10,9,13,1
56414,2,0,28,-28,9,1
196396,2,17,0,17,2,0
49136,1,0,0,0,6,1
336998,2,9,0,9,14,1
25708,3,14,10,4,12,1
119450,3,7,17,-10,3,1
316600,3,6,9,-3,4,1
310786,3,6,10,-4,2,1
270102,2,17,10,7,1,0
148921,2,3,9,-6,16,1
31497,3,3,17,-14,15,1
121746,4,21,42,-21,4,1
283481,4,23,14,9,7,1
359280,1,3,6,-3,6,1
359248,1,0,0,0,6,1
27836,4,17,14,3,13,0
290203,2,10,0,10,10,1
84258,2,0,7,-7,4,1
85578,4,20,22,-2,5,0
299805,1,0,0,0,14,1
212606,2,7,17,-10,10,0
250720,1,0,0,0,10,1
348027,1,0,7,-7,1,1
361785,2,14,7,7,7,1
156196,3,14,10,4,2,1
6556,3,10,6,4,3,0
205726,4,27,19,8,7,0
7721,2,17,3,14,4,0
240555,1,0,0,0,5,1
226149,4,21,17,4,16,0
39613,3,27,6,21,1,1
348984,2,14,0,14,2,0
378033,3,0,7,-7,15,0
419743,3,10,10,0,17,0
11825,2,27,17,10,6,1
232325,2,6,3,3,1,0
61147,3,0,7,-7,11,0
288451,4,19,7,12,9,0
368700,2,7,16,-9,11,1
189487,3,14,0,14,17,1
282718,4,9,27,-18,6,1
103956,2,3,10,-7,13,0
292904,3,7,0,7,11,0
352878,4,14,13,1,3,0
246038,2,7,13,-6,7,1
22526,4,31,37,-6,11,1
232256,4,18,12,6,1,0
301491,3,20,12,8,15,1
308919,1,0,0,0,1,1
345176,4,15,9,6,17,1
251521,2,16,13,3,10,1
220542,3,7,20,-13,13,0
153278,3,2,7,-5,1,0
330188,1,0,0,0,11,1
415531,1,0,0,0,15,0
311613,2,6,0,6,2,1
90154,3,3,0,3,7,1
117153,1,6,3,3,2,0
72677,3,13,10,3,16,0
167053,3,13,17,-4,7,0
236561,4,10,9,1,3,1
416392,4,16,13,3,15,1
324836,2,3,3,0,8,1
86734,3,17,14,3,5,1
170201,4,31,30,1,8,0
306624,3,14,20,-6,17,0
293236,3,16,7,9,11,1
320285,3,14,21,-7,6,1
299756,4,17,6,11,14,0
215678,4,14,6,8,11,1
351861,4,27,14,13,3,0
90347,4,14,29,-15,7,0
34167,4,10,10,0,16,0
163305,3,13,16,-3,5,1
64193,3,31,6,25,13,1
380647,2,7,7,0,16,1
368588,3,16,6,10,11,1
232939,2,7,3,4,2,1
384079,1,0,7,-7,1,0
107906,2,0,3,-3,15,0
235231,2,12,3,9,3,1
194609,2,21,7,14,2,1
125844,1,0,0,0,6,1
27889,1,0,0,0,13,1
326947,2,2,0,2,9,0
214960,4,7,26,-19,11,1
64551,1,7,0,7,13,0
309791,1,0,0,0,1,1
118771,1,10,0,10,2,0
357639,1,0,0,0,5,1
142835,4,12,17,-5,13,0
138338,3,27,0,27,11,0
333510,2,13,0,13,12,1
291200,4,30,35,-5,10,1
74981,3,20,17,3,17,0
60004,4,3,31,-28,11,0
366183,4,7,48,-41,10,1
268236,1,0,0,0,17,1
367497,1,0,0,0,10,0
85007,2,25,7,18,4,0
377628,1,0,0,0,15,0
353846,2,7,14,-7,4,0
148694,1,0,0,0,16,1
405055,1,0,3,-3,10,1
167440,1,0,0,0,7,0
124669,1,0,0,0,5,0
81243,2,7,7,0,3,1
196113,3,16,21,-5,2,1
396166,4,24,23,1,6,0
136914,3,0,13,-13,11,0
154712,2,0,7,-7,1,1
120581,2,0,13,-13,3,0
239492,4,22,24,-2,4,0
405310,3,14,7,7,10,0
278702,4,24,10,14,4,0
137104,3,17,6,11,11,1
417744,4,35,27,8,16,0
225719,1,0,0,0,16,1
387897,4,10,28,-18,2,0
333995,3,17,10,7,12,0
246971,3,20,24,-4,8,1
191707,3,10,17,-7,17,1
289848,1,0,0,0,10,0
405694,1,10,0,10,10,0
244963,2,0,20,-20,7,1
87904,3,13,15,-2,6,0
203225,4,10,17,-7,5,0
128622,2,3,10,-7,7,0
62231,1,7,7,0,12,1
128420,4,14,16,-2,7,0
325971,4,22,7,15,9,1
204556,1,0,28,-28,6,1
59429,1,0,7,-7,11,0
110175,4,20,23,-3,16,1
173752,2,3,3,0,10,1
272110,3,17,9,8,2,1
94003,2,0,21,-21,9,1
304154,1,0,0,0,16,1
399885,2,0,3,-3,8,1
256188,4,30,22,8,12,1
210535,1,0,0,0,9,1
175922,4,29,27,2,11,1
52137,1,0,0,0,7,0
277155,4,10,27,-17,4,1
7993,1,3,0,3,4,0
43727,4,24,17,7,3,0
121978,2,13,7,6,4,1
112786,4,20,10,10,17,1
167841,2,7,13,-6,7,1
71601,2,3,17,-14,16,0
51271,1,6,0,6,7,0
321534,1,0,0,0,7,0
100463,2,7,7,0,12,0
290322,1,6,0,6,10,0
329283,1,0,0,0,10,0
324093,2,0,7,-7,8,1
119798,3,17,6,11,3,1
18660,4,27,33,-6,9,0
43889,4,30,16,14,3,0
98700,2,20,3,17,11,1
264359,1,0,0,0,15,0
323988,3,17,13,4,8,0
190717,4,42,17,25,17,0
46936,4,20,30,-10,5,1
42976,4,37,23,14,3,1
56481,4,7,41,-34,9,0
118159,4,31,27,4,2,0
89647,2,3,10,-7,7,1
351291,1,0,0,0,3,0
16748,2,3,7,-4,8,1
301908,2,8,13,-5,15,1
53188,1,0,0,0,8,0
349100,1,7,0,7,2,1
410703,2,10,3,7,13,0
239889,3,13,3,10,4,1
228117,4,19,10,9,17,1
271987,1,0,0,0,2,0
2053,1,0,0,0,1,0
357041,1,6,7,-1,5,1
402240,2,3,3,0,9,0
151195,2,10,20,-10,17,0
324380,2,7,3,4,8,1
227234,1,0,3,-3,16,0
179921,3,26,9,17,13,1
174180,2,3,13,-10,10,1
55085,2,16,3,13,8,1
380355,2,10,7,3,16,0
283299,3,10,9,1,7,1
149796,1,3,7,-4,16,0
250943,2,3,6,-3,10,1
270872,3,16,13,3,1,0
102351,3,13,13,0,13,0
91252,1,0,0,0,8,1
171398,5,19,20,-1,9,1
54173,2,0,3,-3,8,1
113524,1,0,0,0,17,1
40221,4,34,7,27,2,0
183400,2,17,3,14,14,1
181812,1,0,0,0,13,1
153181,4,20,20,0,1,1
196711,3,33,0,33,3,0
102839,4,10,10,0,13,1
69630,4,14,17,-3,15,0
216247,4,17,20,-3,12,1
404580,1,0,10,-10,10,1
241710,3,7,3,4,5,0
278984,3,7,30,-23,5,0
313977,1,0,0,0,3,1
319238,1,0,0,0,6,0
8929,3,28,0,28,4,0
322673,4,6,9,-3,7,1
133374,4,21,9,12,9,1
359052,4,10,13,-3,6,1
65868,2,7,7,0,13,0
7630,4,28,3,25,4,1
190198,1,0,0,0,17,1
111748,1,0,0,0,17,0
198497,4,17,3,14,3,1
175620,1,0,0,0,11,1
267720,4,14,34,-20,17,1
212452,2,10,0,10,10,1
370084,4,31,20,11,12,0
248452,3,10,6,4,8,1
97681,3,3,10,-7,11,0
406672,3,14,0,14,11,1
221248,2,0,16,-16,14,0
47775,1,0,0,0,5,0
406918,1,0,6,-6,11,1
320553,2,21,0,21,6,1
222726,1,0,0,0,14,1
21011,3,14,24,-10,10,0
208037,3,21,3,18,8,0
372184,3,9,13,-4,13,0
73210,2,7,6,1,16,1
172389,2,10,28,-18,9,1
229728,3,13,17,-4,17,0
58196,1,0,0,0,10,0
402175,3,19,7,12,9,0
264017,1,0,0,0,15,1
284937,2,7,14,-7,7,1
37757,2,7,0,7,1,0
182351,3,24,10,14,14,0
143642,2,13,10,3,14,1
341403,4,0,13,-13,16,0
249226,2,19,7,12,9,0
309925,1,0,0,0,2,0
119698,5,20,19,1,3,1
15052,2,7,26,-19,7,1
87905,3,13,15,-2,6,0
151566,1,0,3,-3,17,0
344027,4,23,9,14,17,0
404195,3,9,9,0,10,1
92547,2,10,0,10,8,1
101945,4,9,13,-4,12,1
420409,1,0,0,0,17,0
216907,4,13,24,-11,12,1
111078,2,17,0,17,16,1
264407,2,3,21,-18,15,1
281011,2,14,13,1,6,1
384675,1,7,17,-10,1,1
354818,3,20,28,-8,4,1
325008,2,20,21,-1,8,0
317551,4,10,27,-17,5,1
296137,1,10,6,4,13,1
174409,4,17,3,14,10,0
341066,2,7,17,-10,15,0
405122,3,0,10,-10,10,1
157718,2,10,3,7,2,0
395803,2,0,7,-7,6,1
310254,1,3,0,3,2,0
82934,2,3,9,-6,4,0
317799,2,9,3,6,5,0
105309,1,0,0,0,14,0
17613,1,0,0,0,9,1
172291,4,24,20,4,9,0
195044,2,7,17,-10,2,0
131416,3,7,16,-9,8,0
87962,1,0,0,0,6,0
122450,3,12,26,-14,4,1
266602,1,0,0,0,16,1
137897,3,23,8,15,11,1
397877,2,0,3,-3,7,1
345514,1,7,10,-3,17,1
395699,4,18,34,-16,6,0
300815,4,10,33,-23,15,1
83043,2,3,7,-4,4,1
361311,1,0,0,0,7,1
100123,4,16,6,10,12,0
393877,3,13,17,-4,5,1
236189,3,17,16,1,3,0
297679,2,7,6,1,13,1
264457,4,20,28,-8,15,0
79365,4,32,3,29,2,0
174299,1,10,0,10,10,1
26918,3,13,6,7,13,1
156536,4,14,6,8,2,0
241647,1,0,0,0,5,1
1352,2,0,0,0,1,1
162957,2,6,0,6,5,1
128127,4,13,6,7,7,0
152856,1,0,0,0,1,1
119254,2,7,3,4,3,0
151953,3,27,24,3,17,1
96368,4,9,30,-21,10,0
335655,1,7,0,7,13,0
164891,2,0,3,-3,6,0
35223,4,0,14,-14,16,0
230811,1,0,0,0,1,1
384560,2,3,35,-32,1,1
195458,1,0,0,0,2,0
400969,3,19,7,12,8,0
120673,1,3,0,3,3,1
411167,2,0,23,-23,13,1
185410,3,7,10,-3,15,1
260299,1,0,0,0,14,1
96450,2,10,14,-4,10,0
78769,3,13,23,-10,2,1
200720,2,7,0,7,4,1
121744,4,21,42,-21,4,1
296008,2,3,0,3,13,0
266272,4,38,19,19,16,0
410179,4,20,17,3,13,0
278087,4,13,17,-4,4,1
299122,2,3,10,-7,14,0
125934,3,16,13,3,6,1
92039,4,27,26,1,8,0
152345,2,7,3,4,17,1
273143,2,10,0,10,2,0
178242,4,6,10,-4,12,0
392455,1,0,0,0,4,0
215302,2,7,0,7,11,0
157938,4,9,21,-12,3,0
108602,4,26,21,5,15,0
177607,4,17,17,0,11,0
279880,3,17,13,4,5,1
182600,2,0,6,-6,14,1
54453,1,0,0,0,8,1
401843,3,7,21,-14,9,0
374753,4,8,39,-31,14,0
146514,2,7,7,0,15,0
340331,2,17,7,10,15,1
218075,4,21,24,-3,12,1
185898,3,16,16,0,15,0
107837,4,13,30,-17,15,1
319659,3,24,3,21,6,1
141328,2,3,7,-4,13,0
377938,1,0,0,0,15,0
113749,3,3,17,-14,17,1
343220,3,10,0,10,16,1
322900,2,6,0,6,7,1
220242,2,17,6,11,13,0
69330,4,19,3,16,15,0
310121,2,13,0,13,2,1
127777,2,10,21,-11,6,0
152196,2,14,0,14,17,0
183035,1,0,0,0,14,1
10193,2,6,3,3,5,1
266189,2,21,0,21,16,1
247619,4,19,23,-4,8,1
93316,3,24,3,21,9,0
277070,2,3,7,-4,4,0
184624,2,10,3,7,15,0
58762,3,10,23,-13,10,0
58208,1,0,3,-3,10,0
25627,4,36,10,26,12,1
296670,4,10,16,-6,13,0
20481,2,0,0,0,10,1
135912,5,24,24,0,10,1
332172,2,3,10,-7,12,0
98203,4,35,26,9,11,0
274630,1,0,0,0,3,0
415423,2,12,0,12,15,1
235701,2,0,10,-10,3,1
312146,4,33,23,10,2,1
33915,2,0,17,-17,16,1
176941,2,10,3,7,11,1
137318,1,0,0,0,11,0
71159,2,19,10,9,16,1
373199,2,3,10,-7,13,1
409878,4,30,8,22,12,0
187449,4,41,14,27,16,0
90573,2,14,7,7,7,0
202824,1,7,0,7,5,0
278692,4,24,10,14,4,1
92977,2,10,0,10,8,1
303547,1,7,0,7,16,0
166095,1,14,0,14,6,0
69354,1,0,0,0,15,1
312777,1,0,0,0,3,0
216789,1,0,0,0,12,1
282984,2,14,3,11,6,0
167227,3,23,17,6,7,1
235131,3,0,10,-10,2,1
58954,4,20,32,-12,10,0
165189,1,0,7,-7,6,1
252663,3,6,3,3,10,0
218498,4,31,17,14,13,1
126019,1,0,0,0,6,0
79658,4,24,21,3,2,0
53033,4,27,24,3,7,0
298233,2,20,3,17,14,0
217211,4,12,19,-7,12,0
346332,2,3,3,0,1,0
189186,2,24,0,24,16,0
363614,4,18,15,3,8,0
224550,1,0,0,0,15,1
122778,4,10,27,-17,4,1
138418,1,7,0,7,12,0
406177,1,7,0,7,11,0
388773,2,14,0,14,3,0
177814,2,0,3,-3,12,1
142604,2,6,3,3,13,0
108724,3,37,13,24,15,1
266386,3,30,8,22,16,0
282870,4,9,23,-14,6,1
66804,4,10,6,4,14,1
174933,2,3,7,-4,10,0
321858,1,7,14,-7,7,1
294278,4,28,21,7,12,1
353611,4,38,0,38,4,0
289787,3,10,10,0,10,1
190737,1,0,0,0,17,1
100718,4,28,24,4,12,0
260405,4,20,7,13,14,0
324974,1,13,14,-1,8,0
196950,2,14,0,14,3,1
192568,1,0,0,0,1,1
59516,4,6,20,-14,11,1
374643,1,0,0,0,14,0
145238,1,0,0,0,14,1
179040,1,3,0,3,12,0
40921,3,16,20,-4,2,1
321058,4,16,14,2,6,1
256164,4,27,22,5,12,0
328905,2,6,7,-1,10,1
88777,2,13,3,10,6,0
418296,2,6,14,-8,16,1
83666,2,15,10,5,4,1
35000,2,6,0,6,16,1
161766,3,24,6,18,4,0
128846,4,20,13,7,7,0
166725,2,7,3,4,6,0
184974,3,7,20,-13,15,0
392212,3,10,16,-6,4,1
61401,2,13,3,10,11,1
108085,3,13,21,-8,15,1
73095,3,7,10,-3,16,1
195612,1,0,0,0,2,1
261705,3,14,0,14,14,1
179446,4,13,20,-7,12,0
130870,4,20,15,5,8,0
145883,1,0,0,0,15,0
256666,4,38,14,24,12,0
37160,1,0,0,0,17,0
200935,4,40,14,26,4,1
29353,4,21,16,5,14,1
287030,2,19,21,-2,8,0
36195,2,10,17,-7,17,1
7536,1,6,0,6,4,1
90423,2,0,13,-13,7,0
83112,3,6,30,-24,4,1
239861,2,10,3,7,4,1
111036,1,7,0,7,16,1
274374,2,3,7,-4,3,0
297855,4,21,16,5,13,0
274270,3,29,13,16,3,1
270599,4,20,14,6,1,0
389107,3,30,0,30,3,0
53009,4,27,24,3,7,1
79791,4,20,14,6,2,0
175795,1,7,0,7,11,0
346181,2,17,0,17,1,1
288372,2,7,0,7,9,1
100492,2,7,10,-3,12,1
141282,1,0,0,0,13,1
180229,4,22,14,8,13,0
286004,4,29,20,9,8,1
228617,2,10,14,-4,17,1
115346,5,26,23,3,1,0
396472,4,28,25,3,6,0
164698,1,0,0,0,6,1
214320,4,21,10,11,11,0
258005,3,0,28,-28,13,1
299513,1,0,0,0,14,0
14559,1,0,0,0,7,0
319037,3,13,23,-10,5,1
16568,1,0,0,0,8,0
343675,3,15,10,5,17,1
386109,4,21,9,12,1,1
27209,3,19,7,12,13,0
179011,4,19,3,16,12,0
66346,3,7,21,-14,14,1
243042,1,0,3,-3,6,1
83482,1,0,0,0,4,1
200901,3,23,0,23,4,1
407452,3,14,10,4,11,1
349729,3,17,7,10,2,1
407767,4,10,7,3,11,1
101033,1,0,0,0,12,1
293917,2,7,21,-14,12,0
34073,2,0,0,0,16,1
394113,1,0,7,-7,5,1
275694,1,0,0,0,3,0
60712,3,21,3,18,11,0
72997,1,0,0,0,16,0
105141,4,33,14,19,14,1
382256,3,17,3,14,17,1
5092,3,13,7,6,3,0
256676,1,0,0,0,12,1
111889,4,19,16,3,17,0
100191,2,14,0,14,12,1
52922,1,7,0,7,7,0
235646,1,0,3,-3,3,1
184813,3,17,20,-3,15,1
71571,2,3,7,-4,16,0
32944,2,0,14,-14,15,0
143671,3,19,10,9,14,0
309014,3,0,17,-17,1,0
4363,3,7,7,0,2,1
173207,3,20,24,-4,9,1
175798,1,7,0,7,11,1
231027,3,17,0,17,1,1
207251,1,0,0,0,7,0
220143,3,26,13,13,13,1
323466,1,0,3,-3,7,1
235450,4,28,31,-3,3,0
330919,4,31,31,0,11,0
375245,5,27,24,3,14,0
418809,1,0,0,0,16,0
416729,1,0,0,0,15,1
336444,3,10,17,-7,14,0
22270,2,0,0,0,11,0
219686,4,13,14,-1,13,0
196249,2,21,10,11,2,0
300987,1,3,0,3,15,0
374217,1,0,0,0,13,1
91519,4,19,3,16,8,0
210218,4,10,21,-11,9,0
46773,3,14,20,-6,4,0
110038,3,40,10,30,16,1
166902,3,10,6,4,6,1
74214,2,3,7,-4,17,1
404974,3,9,13,-4,10,0
392955,3,9,3,6,4,1
20026,3,19,6,13,10,1
405937,3,14,0,14,11,0
257500,2,9,10,-1,13,1
179574,3,7,23,-16,12,0
205621,2,7,6,1,7,1
321300,3,9,19,-10,6,1
247414,2,3,9,-6,8,1
149017,4,13,19,-6,16,0
307909,1,0,0,0,1,0
59513,3,6,20,-14,11,0
290133,4,21,15,6,10,1
301820,4,6,34,-28,15,1
376416,4,16,9,7,14,0
86639,1,0,0,0,5,0
293981,4,7,28,-21,12,1
307477,3,35,13,22,17,0
99326,3,13,3,10,11,1
356488,2,0,3,-3,5,1
79723,2,10,7,3,2,1
390744,4,13,20,-7,3,0
205201,3,14,13,1,6,1
17380,3,17,0,17,9,1
238428,4,17,36,-19,4,1
170443,3,21,3,18,8,0
134968,4,7,25,-18,10,1
360426,2,7,0,7,7,1
37182,1,0,7,-7,17,1
256984,1,0,0,0,12,0
64226,4,38,6,32,13,1
25543,2,17,7,10,12,0
256369,1,6,0,6,12,1
24444,4,16,7,9,12,0
361205,2,7,10,-3,7,0
102728,1,0,0,0,13,1
379159,2,6,3,3,16,0
142824,4,12,10,2,13,0
402327,4,23,24,-1,9,1
247892,3,10,3,7,8,0
25723,3,14,10,4,12,1
74800,2,6,6,0,17,1
287049,3,19,24,-5,8,1
111169,1,7,0,7,16,0
139590,4,9,14,-5,12,0
118261,2,12,7,5,2,1
27642,3,7,20,-13,13,0
251958,1,0,7,-7,10,0
246553,4,36,7,29,8,0
250290,2,7,0,7,9,0
157276,3,13,3,10,2,1
230492,4,28,14,14,1,0
188503,1,0,0,0,16,0
71075,4,27,0,27,16,1
181669,1,0,0,0,13,0
197372,4,30,17,13,3,0
116476,4,6,16,-10,1,0
158384,4,16,17,-1,3,1
63620,3,13,26,-13,12,1
237685,3,20,14,6,4,1
93260,1,7,0,7,9,1
402668,1,0,0,0,9,1
413085,2,27,21,6,14,1
114842,3,13,30,-17,1,1
301131,1,7,0,7,15,0
160772,1,10,7,3,4,1
220598,4,16,29,-13,13,1
336879,2,7,14,-7,14,1
207670,1,0,0,0,7,1
212247,1,0,0,0,10,0
172947,4,55,31,24,9,0
323901,1,0,0,0,8,1
351709,4,14,17,-3,3,0
37919,3,10,14,-4,1,0
299486,4,10,23,-13,14,0
111305,4,17,19,-2,16,1
85105,1,0,0,0,4,0
157344,1,0,0,0,2,1
309874,4,24,7,17,1,0
213451,4,10,41,-31,10,1
92802,1,0,0,0,8,1
40151,2,13,7,6,2,1
111411,3,0,17,-17,16,0
252477,2,7,19,-12,10,0
279064,1,14,0,14,5,0
143787,2,3,0,3,14,0
201011,2,27,0,27,5,0
157713,2,10,3,7,2,0
27491,3,20,7,13,13,0
182464,2,7,0,7,14,0
231866,2,7,20,-13,1,0
197423,2,13,3,10,3,0
155836,2,7,10,-3,2,0
143518,3,17,21,-4,14,0
53552,2,14,9,5,8,0
326726,1,0,6,-6,9,0
282754,1,0,0,0,6,0
361033,2,16,2,14,7,0
257524,3,19,10,9,13,1
130675,3,7,38,-31,8,1
183775,2,10,14,-4,14,0
157753,3,17,10,7,2,0
252713,4,6,10,-4,10,1
383081,2,20,7,13,17,1
88444,2,7,0,7,6,1
130393,4,7,6,1,8,0
202875,2,21,0,21,5,0
389126,4,30,7,23,3,1
41669,3,24,7,17,2,1
149955,2,7,3,4,16,1
249554,3,14,10,4,9,1
318647,4,10,13,-3,5,0
291131,2,15,13,2,10,1
321505,4,24,30,-6,7,0
203454,2,7,3,4,6,1
187778,1,7,0,7,16,1
105155,1,0,0,0,14,0
251414,4,43,14,29,10,1
190580,4,20,20,0,17,0
283555,2,6,14,-8,7,0
339508,1,0,0,0,15,0
318425,2,21,7,14,5,1
180645,3,24,6,18,13,0
164204,3,20,28,-8,5,0
7760,3,30,3,27,4,0
30978,1,0,0,0,15,0
10184,2,6,3,3,5,1
383981,2,0,13,-13,1,1
359124,2,7,0,7,6,0
123689,4,10,25,-15,4,1
62896,3,10,10,0,12,1
59190,2,14,35,-21,10,0
329208,2,10,13,-3,10,1
36565,4,23,34,-11,17,0
207015,2,28,0,28,7,0
291396,2,7,7,0,10,1
44830,1,0,7,-7,4,0
200821,1,0,0,0,4,1
399579,1,0,0,0,8,0
79869,2,3,13,-10,2,1
310470,3,17,9,8,2,1
155124,4,19,33,-14,1,1
123914,2,0,0,0,5,0
30270,2,3,7,-4,14,0
415689,1,0,3,-3,15,0
360845,1,0,0,0,7,1
202807,1,0,0,0,5,0
414856,2,21,7,14,15,0
165365,2,3,10,-7,6,0
239029,4,29,18,11,4,1
279765,4,30,13,17,5,1
399149,1,0,3,-3,7,0
418700,1,0,7,-7,16,1
297393,3,9,24,-15,13,1
40616,3,31,7,24,2,0
17220,3,7,31,-24,9,1
266168,1,7,0,7,16,1
129440,4,23,13,10,7,0
80942,2,13,0,13,3,1
123734,1,7,0,7,5,0
294111,4,7,27,-20,12,1
362629,2,0,7,-7,8,0
380721,4,7,16,-9,16,1
141568,4,34,18,16,13,0
66871,2,0,7,-7,14,0
272175,1,0,0,0,2,1
346826,2,10,3,7,1,1
242332,3,19,13,6,6,1
412008,1,7,0,7,13,1
258294,3,21,12,9,13,0
16962,3,27,20,7,8,0
328865,1,3,0,3,10,1
25391,2,6,0,6,12,0
370859,2,3,0,3,12,0
155578,3,23,10,13,2,1
86689,2,10,6,4,5,0
402336,4,26,24,2,9,0
388042,4,20,6,14,2,0
340849,4,24,27,-3,15,1
402249,2,3,10,-7,9,1
144049,1,7,0,7,14,0
141077,4,14,10,4,13,1
169835,3,17,17,0,8,0
158390,4,16,17,-1,3,0
304992,4,17,20,-3,16,0
21982,2,7,3,4,11,0
315329,1,3,3,0,4,1
173374,4,34,27,7,10,1
402634,4,20,23,-3,9,0
188136,3,10,10,0,16,0
12542,2,3,17,-14,6,1
253175,1,0,0,0,11,1
172491,1,0,0,0,9,1
121425,4,7,12,-5,3,0
325268,1,3,3,0,8,0
386505,2,7,7,0,2,0
346612,1,7,0,7,1,0
355325,4,14,20,-6,4,0
80071,3,17,12,5,2,0
347178,4,23,17,6,1,0
13233,4,22,33,-11,6,0
371149,2,0,9,-9,12,0
154875,2,3,3,0,1,1
83239,3,9,7,2,4,1
13572,2,3,0,3,7,0
290481,2,14,0,14,10,0
414723,3,3,17,-14,14,1
78943,4,20,24,-4,2,1
354314,2,14,3,11,4,1
216379,3,14,16,-2,12,0
391657,1,0,0,0,4,1
36446,1,0,3,-3,17,1
109474,4,12,13,-1,16,1
259826,1,0,0,0,14,0
361679,3,7,32,-25,7,1
276107,4,34,3,31,3,1
305237,2,14,21,-7,16,1
28875,4,23,10,13,14,0
313126,2,7,10,-3,3,1
319401,1,0,0,0,6,0
175332,4,22,19,3,10,1
233076,1,0,0,0,2,1
99774,2,0,7,-7,12,1
270983,2,0,14,-14,1,1
289443,2,3,0,3,10,0
280165,3,28,0,28,5,1
308342,1,0,3,-3,1,1
79049,3,10,14,-4,2,0
70808,4,30,27,3,15,0
231720,1,0,7,-7,1,1
344649,2,3,10,-7,17,1
257277,4,26,26,0,12,0
390601,4,20,27,-7,3,1
366795,1,0,0,0,10,1
142850,1,0,0,0,13,1
136290,3,18,7,11,11,1
266659,3,19,3,16,16,1
142807,4,12,10,2,13,1
384367,4,16,17,-1,1,1
89143,4,23,6,17,6,1
232376,4,13,15,-2,1,0
292778,3,26,17,9,11,1
346090,4,10,6,4,1,0
143285,1,0,0,0,14,0
87307,4,24,17,7,6,0
286024,1,0,0,0,8,1
48765,4,10,25,-15,5,1
194421,2,6,0,6,2,1
165331,1,0,0,0,6,1
154430,2,14,0,14,1,0
109729,3,10,0,10,16,1
333197,2,0,7,-7,12,0
355041,4,18,33,-15,4,1
378239,1,0,0,0,15,1
289494,3,13,7,6,10,0
390194,1,0,3,-3,3,0
120978,1,5,7,-2,3,0
31630,3,24,6,18,15,0
34765,4,20,3,17,16,1
13320,3,7,26,-19,7,0
292346,3,12,13,-1,11,0
304724,4,21,14,7,16,0
157912,3,6,15,-9,3,1
174267,4,10,33,-23,10,1
42178,1,7,0,7,2,1
24853,3,13,3,10,12,0
377688,2,19,7,12,15,0
103330,2,7,10,-3,13,0
207994,2,14,0,14,8,1
172116,4,13,12,1,9,0
298865,4,21,9,12,14,0
204158,3,10,17,-7,6,1
21179,4,0,16,-16,10,1
29340,4,21,10,11,14,0
175022,4,13,28,-15,10,1
208575,1,3,0,3,8,0
300975,1,0,0,0,15,0
7035,4,19,7,12,3,1
221349,1,0,0,0,14,0
112707,2,3,0,3,17,0
151896,2,13,0,13,17,0
300123,1,7,3,4,14,0
334691,2,15,3,12,13,0
356807,2,0,7,-7,5,1
275369,4,10,22,-12,3,1
152803,3,14,7,7,17,0
397006,2,14,3,11,6,1
239533,2,3,0,3,4,0
202593,3,21,13,8,5,1
77177,1,0,0,0,1,0
397810,1,0,0,0,7,0
296100,4,9,17,-8,13,1
13145,2,10,16,-6,6,1
225960,3,27,13,14,16,0
366054,4,51,14,37,10,0
98350,4,49,35,14,11,0
98135,3,21,10,11,11,1
238713,4,19,17,2,4,0
100061,2,6,3,3,12,0
378079,4,0,17,-17,15,1
96197,3,3,16,-13,10,0
313828,1,7,3,4,3,1
127499,3,3,23,-20,6,1
355380,1,3,3,0,4,1
96714,2,0,7,-7,10,0
197090,2,7,14,-7,3,0
162833,3,3,3,0,5,1
417004,1,0,0,0,15,1
303019,4,23,19,4,16,1
47835,3,10,6,4,5,0
135855,4,7,17,-10,10,1
240590,2,3,7,-4,5,1
33050,1,3,0,3,16,0
99944,3,10,9,1,12,0
203492,3,21,3,18,6,1
150438,2,20,3,17,16,1
29028,4,14,10,4,14,1
403540,1,7,0,7,9,0
98611,3,7,7,0,11,0
162587,1,0,7,-7,5,1
229267,3,17,14,3,17,0
25616,4,36,10,26,12,0
212121,2,3,7,-4,10,0
56097,2,14,7,7,9,1
147704,3,10,10,0,15,0
368531,2,6,0,6,11,1
68986,2,21,14,7,15,1
155002,1,6,3,3,1,1
53382,2,3,14,-11,8,0
31269,1,0,0,0,15,0
150420,1,14,0,14,16,0
122095,2,10,7,3,4,0
391154,3,7,24,-17,4,1
176794,2,3,7,-4,11,1
247843,2,7,3,4,8,1
114829,3,13,27,-14,1,0
150779,4,13,9,4,17,1
104978,4,17,22,-5,14,1
334057,1,0,0,0,13,1
188093,2,0,3,-3,16,0
16442,1,0,0,0,8,1
208543,4,47,23,24,8,1
179405,2,6,13,-7,12,1
374285,2,14,13,1,13,1
13038,3,14,7,7,6,0
95268,3,3,17,-14,10,1
316874,1,3,2,1,4,1
219106,1,0,0,0,13,0
227963,4,30,27,3,16,1
315687,3,10,13,-3,4,0
111375,2,0,7,-7,16,0
183714,4,28,20,8,14,0
338520,3,20,14,6,14,0
40026,2,20,7,13,1,1
125104,1,0,0,0,5,1
85981,3,14,16,-2,5,0
218572,2,7,17,-10,13,0
154732,2,3,10,-7,1,0
233277,2,7,3,4,2,0
225192,2,3,7,-4,15,1
271365,1,0,0,0,1,0
263665,4,27,10,17,15,0
81920,4,7,30,-23,3,1
307043,3,17,0,17,17,0
103979,3,6,10,-4,13,0
351729,4,28,17,11,3,0
109621,4,25,14,11,16,1
320112,2,17,0,17,6,0
101555,2,13,24,-11,12,1
78336,4,24,28,-4,2,1
250121,1,7,0,7,9,0
177655,1,7,0,7,12,0
394959,4,10,17,-7,5,0
379262,1,0,3,-3,16,0
417228,3,17,20,-3,16,1
123920,2,0,0,0,5,1
191856,3,20,10,10,1,0
123860,4,17,3,14,5,0
67676,4,7,35,-28,14,0
141247,4,10,24,-14,13,1
329669,3,23,14,9,11,0
290952,2,17,7,10,10,0
238312,1,3,9,-6,4,0
406048,2,0,10,-10,11,1
343262,4,22,0,22,16,0
64540,1,0,0,0,13,1
351,2,14,10,4,1,1
305592,4,20,10,10,17,1
320934,4,13,21,-8,6,1
380727,4,7,16,-9,16,0
403947,4,20,17,3,10,0
58154,4,23,17,6,10,0
282354,2,7,13,-6,6,0
367222,1,0,0,0,10,1
124218,1,0,14,-14,5,1
210820,4,24,10,14,9,0
173339,3,21,27,-6,10,0
376865,4,21,14,7,15,1
415538,1,0,0,0,15,0
180673,4,24,6,18,13,1
20448,1,0,0,0,10,0
5636,2,0,14,-14,3,1
81247,2,10,7,3,3,0
211228,4,14,20,-6,9,1
193407,3,10,20,-10,1,1
134430,1,0,7,-7,10,0
387377,2,21,7,14,2,0
37896,2,3,7,-4,1,1
162043,2,21,13,8,4,0
282860,4,9,23,-14,6,0
183612,1,0,0,0,14,0
6381,2,0,13,-13,3,0
6917,1,0,0,0,3,1
138953,2,7,3,4,12,0
359392,4,13,23,-10,6,1
76123,1,0,0,0,1,0
418118,2,14,0,14,16,0
19766,4,9,12,-3,10,1
274446,4,10,17,-7,3,0
391932,4,23,27,-4,4,1
334365,2,0,3,-3,13,0
226430,2,0,7,-7,16,0
406713,4,27,0,27,11,1
11783,1,13,0,13,6,1
123737,1,7,3,4,5,0
112413,3,13,13,0,17,1
101814,1,0,0,0,12,1
382610,1,0,0,0,17,1
42613,1,0,7,-7,3,1
160329,3,3,14,-11,4,0
145876,1,0,0,0,15,1
38867,4,9,13,-4,1,1
133220,4,20,20,0,9,1
145290,2,14,9,5,14,1
384558,2,3,35,-32,1,1
66114,4,10,6,4,13,1
142450,2,7,10,-3,13,1
282414,4,10,23,-13,6,0
75866,2,14,7,7,1,1
356771,1,0,0,0,5,1
400382,3,23,10,13,8,1
264631,4,20,17,3,16,0
280367,1,0,0,0,5,1
173479,3,3,10,-7,10,1
292126,2,14,0,14,11,1
17630,1,0,3,-3,9,1
151069,3,17,10,7,17,0
180004,2,7,13,-6,13,0
85719,4,24,28,-4,5,1
62514,5,16,16,0,12,1
130634,2,7,21,-14,8,1
207187,3,14,13,1,7,0
226079,2,0,13,-13,16,0
136472,4,17,13,4,11,0
148626,3,7,9,-2,16,1
301653,4,10,6,4,15,0
74137,4,29,6,23,17,1
349030,4,14,10,4,2,0
230730,3,9,27,-18,1,1
420318,3,17,3,14,17,0
340278,1,3,0,3,15,1
289414,1,0,0,0,10,1
127992,4,23,27,-4,6,1
3295,2,3,3,0,2,1
151936,3,20,17,3,17,1
347893,2,0,7,-7,1,1
241358,1,7,0,7,5,0
50348,4,19,23,-4,6,0
403268,1,3,0,3,9,1
397124,1,3,0,3,6,1
234984,3,13,10,3,2,1
100654,3,14,14,0,12,0
366174,4,7,45,-38,10,0
271258,2,6,0,6,1,0
79709,2,7,7,0,2,1
393343,1,7,7,0,5,0
389858,4,31,6,25,3,0
211009,2,14,0,14,9,0
120682,1,3,0,3,3,1
393404,3,21,17,4,5,0
320529,1,13,0,13,6,1
66515,3,28,24,4,14,1
145601,2,21,0,21,14,1
89782,1,3,0,3,7,0
297712,3,17,13,4,13,0
403109,1,0,0,0,9,0
118004,4,20,6,14,2,0
220375,2,13,7,6,13,1
266775,2,0,14,-14,16,1
389070,2,20,0,20,3,0
323041,2,14,7,7,7,0
83404,3,10,17,-7,4,0
127321,3,10,17,-7,6,1
402703,2,3,0,3,9,0
239682,2,7,10,-3,4,1
103180,2,0,0,0,13,1
143054,2,3,7,-4,13,1
281267,1,7,3,4,6,0
128702,4,13,20,-7,7,0
136908,2,0,13,-13,11,1
400664,2,6,0,6,8,0
245221,1,0,0,0,7,1
86974,2,14,3,11,5,0
353323,4,38,31,7,4,1
375407,4,21,24,-3,14,0
228360,2,7,17,-10,17,1
102374,4,16,13,3,13,0
68056,3,3,10,-7,14,0
242534,4,25,13,12,6,0
398246,4,35,17,18,7,0
135784,2,0,14,-14,10,1
126722,3,10,13,-3,6,1
210460,3,9,14,-5,9,1
166933,4,13,6,7,6,1
374947,1,0,6,-6,14,1
279462,1,0,0,0,5,1
260156,1,0,0,0,14,1
232829,4,16,17,-1,2,0
164255,4,48,41,7,5,0
120270,3,17,6,11,3,0
225080,3,10,14,-4,15,1
68445,1,0,0,0,14,0
24590,4,10,26,-16,12,0
134403,1,0,0,0,10,1
217758,3,10,7,3,12,0
365059,4,23,6,17,9,0
117873,4,12,20,-8,2,0
27797,3,14,14,0,13,1
389509,3,20,9,11,3,0
193400,2,10,17,-7,1,0
240297,2,7,7,0,5,1
410861,2,14,6,8,13,1
348132,4,17,19,-2,1,0
345038,1,0,0,0,17,1
326777,2,3,14,-11,9,1
368544,2,9,0,9,11,1
274777,4,24,23,1,3,0
277691,2,7,0,7,4,1
241356,1,0,0,0,5,1
229260,2,10,14,-4,17,1
306685,1,3,0,3,17,1
205978,3,13,10,3,7,0
223209,2,3,6,-3,15,0
5411,4,20,16,4,3,1
30832,1,0,14,-14,15,0
183294,4,22,20,2,14,0
87052,4,14,25,-11,5,1
60345,2,3,0,3,11,0
53708,3,7,0,7,8,0
401848,3,7,21,-14,9,0
73478,2,3,14,-11,17,0
98171,4,21,19,2,11,1
114696,3,6,10,-4,1,1
301104,4,33,13,20,15,0
32827,2,6,7,-1,15,1
248876,1,14,0,14,9,0
179293,4,33,3,30,12,0
285958,3,29,7,22,8,0
350617,3,13,0,13,2,0
49763,1,0,7,-7,6,1
228878,4,9,17,-8,17,0
286522,2,3,14,-11,8,0
49074,4,10,13,-3,6,1
216381,3,14,23,-9,12,1
87704,2,3,20,-17,6,0
186902,2,7,3,4,15,1
399543,4,0,33,-33,7,0
186748,1,20,0,20,15,0
80745,1,3,0,3,3,1
133890,2,3,6,-3,9,1
53857,2,0,0,0,8,0
45190,3,7,10,-3,4,1
277065,2,3,7,-4,4,1
32341,1,14,0,14,15,0
156352,3,24,0,24,2,0
369210,1,0,0,0,11,1
103914,1,3,0,3,13,0
22801,4,6,21,-15,11,1
48747,3,10,19,-9,5,0
392915,1,0,3,-3,4,1
136556,2,0,13,-13,11,1
408078,4,20,17,3,12,0
337236,4,16,23,-7,14,0
396,3,28,17,11,1,1
366591,4,20,14,6,10,0
309304,3,0,23,-23,1,1
216599,4,43,18,25,12,1
106757,3,17,15,2,14,0
308417,3,6,18,-12,1,1
50981,1,0,7,-7,6,1
196917,1,0,0,0,3,1
220547,3,7,20,-13,13,1
275880,2,10,6,4,3,1
377917,4,23,16,7,15,0
302464,2,3,3,0,15,0
30243,1,3,0,3,14,1
286078,2,10,3,7,8,0
148926,2,3,9,-6,16,1
59975,3,3,24,-21,11,1
342828,1,7,0,7,16,1
96871,2,10,0,10,10,0
167894,3,21,16,5,7,0
403214,4,24,17,7,9,0
354600,2,0,7,-7,4,1
118696,3,17,6,11,2,1
225535,4,8,24,-16,15,0
416081,4,21,6,15,15,0
232244,4,15,12,3,1,1
96139,2,0,16,-16,10,1
303351,4,41,0,41,16,0
201719,4,30,20,10,5,0
245917,3,6,37,-31,7,1
414930,1,0,0,0,15,0
410902,3,14,15,-1,13,0
254308,3,6,19,-13,11,1
46973,1,0,0,0,5,1
320161,4,17,14,3,6,0
138298,2,17,0,17,11,1
279293,4,19,16,3,5,0
73008,1,0,0,0,16,1
38583,4,38,13,25,1,0
83626,4,10,17,-7,4,1
408421,1,0,0,0,12,0
90513,4,0,26,-26,7,1
296998,4,32,14,18,13,0
83297,4,22,17,5,4,0
257458,1,0,0,0,13,0
12932,5,13,13,0,6,0
63467,3,27,13,14,12,1
285787,3,7,17,-10,8,1
132959,1,0,7,-7,9,0
24499,1,0,7,-7,12,1
1509,2,3,6,-3,1,1
192581,1,3,0,3,1,0
3993,4,32,20,12,2,0
206883,3,10,17,-7,7,0
88318,2,14,7,7,6,0
173034,3,21,6,15,9,0
378054,4,0,14,-14,15,1
202958,1,0,0,0,5,1
370793,4,19,17,2,12,1
69802,1,7,0,7,15,0
298537,3,13,0,13,14,1
197240,1,0,0,0,3,1
214470,3,7,17,-10,11,1
25128,2,10,0,10,12,1
292585,2,6,16,-10,11,1
137088,3,17,3,14,11,1
81235,2,7,7,0,3,0
158246,4,38,0,38,3,1
118681,2,14,6,8,2,1
108095,3,13,28,-15,15,1
271556,2,7,6,1,2,0
243376,1,0,7,-7,6,1
282520,3,17,3,14,6,0
387858,2,10,28,-18,2,1
154158,3,7,6,1,1,0
343228,3,16,0,16,16,0
324648,1,0,0,0,8,0
304099,4,13,23,-10,16,0
397476,3,13,19,-6,6,1
321055,4,16,14,2,6,0
229354,1,0,0,0,17,1
312620,1,0,0,0,3,1
354584,1,0,6,-6,4,0
385084,1,0,0,0,1,0
43270,4,24,10,14,3,0
254028,3,7,13,-6,11,0
302599,1,0,3,-3,15,1
247159,4,20,6,14,8,1
192111,2,0,6,-6,1,1
53530,2,7,6,1,8,0
368638,1,0,0,0,11,0
182368,4,24,17,7,14,0
79956,4,13,23,-10,2,0
138676,3,6,28,-22,12,1
183186,1,0,0,0,14,0
92882,3,24,0,24,8,1
204337,4,0,17,-17,6,1
61070,1,0,0,0,11,1
273733,1,0,0,0,2,0
82683,4,12,13,-1,3,0
362741,1,0,0,0,8,0
141811,2,10,14,-4,13,1
109255,2,6,0,6,15,1
185479,4,24,20,4,15,0
253285,4,3,13,-10,11,1
278262,1,0,0,0,4,0
94477,2,0,0,0,9,0
219097,4,45,13,32,13,1
285629,4,20,24,-4,8,1
276799,2,17,17,0,4,0
368694,2,7,10,-3,11,1
27460,2,10,0,10,13,0
98465,3,17,14,3,11,1
284068,4,13,10,3,7,1
248149,2,3,3,0,8,0
414825,2,13,0,13,15,0
300960,4,24,27,-3,15,1
362924,2,14,0,14,8,0
89597,4,7,40,-33,7,0
279626,1,7,0,7,5,0
135036,1,14,3,11,10,1
238042,4,10,13,-3,4,1
359040,3,10,3,7,6,0
88660,3,20,13,7,6,1
132958,1,0,7,-7,9,0
16427,4,24,16,8,8,0
145346,4,41,26,15,14,1
402915,4,17,9,8,9,1
202872,2,14,0,14,5,1
277789,1,0,6,-6,4,0
419459,2,10,6,4,16,1
116184,4,14,19,-5,1,0
155806,1,7,3,4,2,0
285583,3,7,10,-3,8,1
15803,3,0,12,-12,8,0
92752,3,3,17,-14,8,1
201041,3,34,0,34,5,0
291714,2,0,6,-6,11,0
293159,1,6,0,6,11,1
5291,4,24,31,-7,3,0
170865,2,7,0,7,8,0
57094,4,21,27,-6,9,1
193332,1,7,0,7,1,0
216613,1,0,3,-3,12,1
61883,4,20,23,-3,12,1
337828,4,30,6,24,14,1
330970,2,16,7,9,11,1
107200,3,6,28,-22,15,0
138397,1,6,0,6,12,1
202760,3,16,17,-1,5,1
322886,1,6,0,6,7,0
200673,4,41,28,13,4,1
236232,4,27,22,5,3,0
382876,4,35,3,32,17,1
369598,4,14,6,8,11,1
37576,4,13,17,-4,17,1
55059,2,13,3,10,8,1
32,1,0,0,0,1,1
346745,4,27,13,14,1,0
417831,2,10,0,10,16,1
82248,1,0,0,0,3,1
242445,2,0,7,-7,6,1
409566,3,35,11,24,12,1
296863,1,3,0,3,13,0
133422,1,7,7,0,9,1
421650,2,3,7,-4,17,1
333695,3,21,0,21,12,0
115793,1,0,0,0,1,0
10041,2,28,0,28,5,0
330106,3,0,13,-13,11,1
352743,4,24,13,11,3,0
55174,1,0,0,0,9,1
85178,2,7,10,-3,4,1
353235,2,14,17,-3,4,1
111674,3,21,10,11,16,0
255187,2,7,0,7,12,0
289747,2,0,10,-10,10,0
260602,1,0,7,-7,14,0
109333,4,20,3,17,15,0
235463,4,28,32,-4,3,0
292138,2,21,0,21,11,0
131206,2,7,10,-3,8,1
341530,3,6,7,-1,16,0
145192,3,49,0,49,14,0
32633,1,0,0,0,15,1
283796,4,21,3,18,7,0
181249,2,0,3,-3,13,1
340601,1,6,0,6,15,0
151290,1,7,7,0,17,0
397001,2,14,3,11,6,0
308820,2,3,3,0,1,0
310310,3,26,0,26,2,1
208912,2,7,6,1,8,1
307311,2,14,13,1,17,1
219717,4,13,14,-1,13,1
180757,2,7,6,1,13,0
122960,1,0,0,0,4,0
328461,3,3,3,0,10,1
199199,2,7,7,0,4,1
192279,2,24,3,21,1,0
158576,1,0,0,0,3,0
371905,3,27,10,17,12,1
61896,4,27,23,4,12,0
118509,2,14,0,14,2,1
257963,2,0,7,-7,13,0
257731,4,3,24,-21,13,0
144450,4,10,26,-16,14,0
46012,2,7,7,0,4,1
85524,3,14,9,5,5,0
188881,2,10,7,3,16,0
219830,3,38,0,38,13,0
353858,2,7,14,-7,4,0
165067,3,10,17,-7,6,0
80767,2,3,0,3,3,0
51622,3,21,13,8,7,0
51150,2,17,3,14,7,0
101053,2,0,3,-3,12,0
76761,2,17,0,17,1,1
169964,2,14,10,4,8,1
332714,2,14,6,8,12,1
360600,2,7,10,-3,7,1
344173,4,35,11,24,17,1
24290,4,13,17,-4,12,0
40854,1,0,3,-3,2,1
182612,2,0,6,-6,14,1
291459,3,14,20,-6,10,1
33931,2,0,24,-24,16,0
418698,1,0,7,-7,16,1
239874,3,13,3,10,4,0
100116,4,16,6,10,12,1
391902,3,23,20,3,4,0
118232,1,9,0,9,2,0
360107,1,0,0,0,7,0
417205,2,10,17,-7,16,1
361174,1,0,7,-7,7,1
108213,2,6,0,6,15,1
37768,2,7,3,4,1,1
120372,1,9,6,3,3,0
351707,4,14,17,-3,3,0
224028,3,14,6,8,15,1
80863,4,6,10,-4,3,0
189247,4,53,11,42,16,0
159643,4,27,20,7,3,0
240909,2,14,3,11,5,0
229501,1,3,0,3,17,0
74277,4,10,17,-7,17,0
139961,2,18,3,15,12,0
129133,4,34,28,6,7,1
79959,4,13,23,-10,2,1
113941,4,17,10,7,17,1
255931,2,6,3,3,12,0
334480,1,0,7,-7,13,1
419791,4,17,20,-3,17,1
218389,1,0,7,-7,13,1
284247,4,16,33,-17,7,1
315905,1,0,0,0,4,0
280959,1,0,0,0,6,1
176224,4,14,24,-10,11,0
209115,4,9,30,-21,8,0
382439,4,0,24,-24,17,0
32846,3,6,7,-1,15,1
190248,3,7,14,-7,17,0
118100,2,3,13,-10,2,1
93660,4,23,13,10,9,0
413042,1,0,0,0,14,1
262761,3,28,10,18,15,1
317342,2,0,0,0,5,1
395573,1,0,0,0,6,1
215849,4,51,20,31,11,1
162488,2,14,3,11,4,0
330113,3,0,13,-13,11,1
341873,3,23,15,8,16,0
169561,4,10,41,-31,8,1
292653,4,22,16,6,11,0
299555,2,3,3,0,14,1
317074,3,14,17,-3,4,1
83286,4,22,10,12,4,0
404506,3,21,27,-6,10,1
81035,5,23,23,0,3,0
72188,2,10,10,0,16,1
158082,3,22,9,13,3,0
4319,1,0,7,-7,2,0
281174,3,21,13,8,6,1
176532,3,12,17,-5,11,1
385760,2,17,0,17,1,0
197314,3,17,0,17,3,0
166003,3,17,21,-4,6,1
64517,4,34,16,18,13,0
314171,2,7,20,-13,3,1
309080,1,9,0,9,1,0
289046,4,32,21,11,9,1
79460,3,9,14,-5,2,1
167231,3,23,17,6,7,1
242664,4,13,10,3,6,1
8336,2,16,3,13,4,1
43171,1,7,7,0,3,0
161481,3,10,6,4,4,1
387136,3,10,31,-21,2,0
14514,4,34,36,-2,7,0
138518,4,31,30,1,12,0
92197,4,10,43,-33,8,1
3753,2,13,9,4,2,0
282692,3,6,20,-14,6,1
336116,2,10,0,10,13,0
397075,4,24,16,8,6,0
260037,2,3,7,-4,14,1
386281,4,14,20,-6,2,1
31372,4,7,3,4,15,0
400109,3,17,23,-6,8,1
6904,1,0,0,0,3,0
401401,2,17,7,10,8,1
130763,2,7,3,4,8,1
43924,2,0,7,-7,3,1
45889,2,7,3,4,4,0
227375,1,0,0,0,16,1
264321,4,17,36,-19,15,1
63306,2,3,3,0,12,1
276777,2,17,10,7,4,1
321751,2,9,6,3,7,0
115035,4,20,19,1,1,0
350810,4,23,10,13,2,0
398744,2,14,17,-3,7,0
134369,4,29,21,8,10,0
124363,1,0,0,0,5,0
363781,1,0,7,-7,8,1
106949,3,12,6,6,14,1
104128,3,17,20,-3,13,0
389214,2,21,7,14,3,1
149241,2,7,6,1,16,0
208617,2,6,3,3,8,0
59574,1,0,3,-3,11,0
188220,1,0,0,0,16,0
417936,1,7,7,0,16,0
213070,3,17,3,14,10,1
382349,1,0,0,0,17,0
137263,3,7,13,-6,11,0
265341,2,7,7,0,16,0
311508,3,17,10,7,2,0
297145,4,38,6,32,13,0
226247,2,6,0,6,16,1
394126,1,7,7,0,5,0
12938,5,13,13,0,6,0
369762,4,38,43,-5,11,1
157331,4,19,9,10,2,0
16216,2,3,0,3,8,1
200577,2,14,7,7,4,0
242766,3,14,24,-10,6,1
245311,4,16,10,6,7,1
175587,3,33,7,26,11,0
365735,2,17,10,7,9,0
136684,1,0,7,-7,11,1
313770,3,31,10,21,3,0
7921,3,3,20,-17,4,0
62206,4,13,17,-4,12,0
99332,3,13,3,10,11,1
219354,3,16,13,3,13,1
246821,4,10,20,-10,8,0
149609,4,17,26,-9,16,1
323878,4,16,30,-14,8,0
323685,3,20,0,20,8,0
139686,2,0,0,0,12,1
384571,2,3,41,-38,1,0
97417,4,16,23,-7,10,0
169355,2,6,14,-8,8,0
37643,2,17,0,17,17,1
200185,4,7,37,-30,4,0
151787,3,14,13,1,17,1
316127,3,24,16,8,4,0
139212,1,3,6,-3,12,0
145108,1,3,0,3,14,1
327739,4,6,13,-7,10,0
142793,3,12,10,2,13,1
199733,4,35,10,25,4,0
361901,2,0,0,0,7,1
36087,3,34,0,34,17,1
322478,2,15,3,12,7,0
381412,3,16,7,9,16,1
4552,4,24,26,-2,2,0
400274,4,24,9,15,8,0
255311,1,7,0,7,12,0
341473,1,0,7,-7,16,1
254688,1,0,0,0,11,1
242647,4,13,0,13,6,0
390486,1,7,0,7,3,0
340279,1,3,0,3,15,0
18088,1,0,14,-14,9,1
293600,1,0,0,0,12,1
172226,3,7,13,-6,9,1
203950,2,3,7,-4,6,0
9807,3,9,17,-8,5,1
235762,4,13,27,-14,3,1
308105,3,13,16,-3,1,0
157256,3,10,3,7,2,1
31513,4,3,17,-14,15,0
37687,4,30,0,30,17,1
89120,4,23,6,17,6,0
139137,3,12,6,6,12,1
28601,4,33,7,26,14,1
204562,2,0,35,-35,6,1
95163,4,23,20,3,9,0
302483,2,3,10,-7,15,1
323352,2,7,0,7,7,1
354330,2,28,3,25,4,1
91725,1,0,0,0,8,0
226437,2,0,7,-7,16,1
88887,1,9,0,9,6,1
199587,4,34,17,17,4,1
346412,4,9,13,-4,1,1
163035,4,19,3,16,5,1
20184,3,17,3,14,10,0
26691,2,0,7,-7,13,1
141798,1,10,7,3,13,0
352526,2,20,6,14,3,0
271738,2,13,10,3,2,0
333971,3,17,10,7,12,0
341688,3,20,13,7,16,1
212651,4,7,31,-24,10,0
231609,2,14,10,4,1,0
378881,3,13,13,0,15,0
69171,4,14,17,-3,15,1
395420,4,31,3,28,5,1
80979,3,20,7,13,3,0
313558,2,3,10,-7,3,0
63345,3,17,3,14,12,1
199869,4,10,24,-14,4,1
193829,2,10,0,10,1,1
55559,3,17,7,10,9,0
403104,1,0,0,0,9,0
236298,2,0,9,-9,3,0
20821,2,14,3,11,10,0
402245,2,3,10,-7,9,1
103833,3,16,0,16,13,1
161894,2,13,9,4,4,0
406700,3,24,0,24,11,1
341010,1,0,0,0,15,0
300371,4,10,7,3,14,0
150458,2,27,6,21,16,0
282830,3,9,13,-4,6,0
383716,4,16,24,-8,17,0
82136,2,3,0,3,3,0
380045,2,21,17,4,16,0
83445,4,10,23,-13,4,1
246797,3,3,13,-10,8,0
222263,4,13,27,-14,14,1
168206,4,29,15,14,7,1
40815,4,23,35,-12,2,1
1894,1,0,0,0,1,0
2196,1,0,0,0,1,1
88379,4,24,10,14,6,1
398964,4,23,20,3,7,0
174055,3,0,26,-26,10,0
236454,1,7,0,7,3,1
259309,2,13,13,0,13,0
83656,1,9,3,6,4,0
66176,2,17,3,14,13,1
317691,4,22,9,13,5,1
414734,3,3,17,-14,14,1
418770,4,14,21,-7,16,0
197250,1,0,0,0,3,0
145975,4,10,21,-11,15,1
188723,2,0,17,-17,16,0
266949,2,16,7,9,17,0
114363,3,24,13,11,1,0
370740,2,12,7,5,12,1
59867,5,15,16,-1,11,0
354393,4,45,10,35,4,1
383798,2,3,7,-4,1,0
276407,4,32,44,-12,3,1
203626,2,7,7,0,6,0
155254,3,28,14,14,1,0
126411,4,33,17,16,6,0
187106,3,10,0,10,16,1
327065,1,0,0,0,9,0
55080,2,13,3,10,8,1
413212,1,7,0,7,14,0
278346,3,17,14,3,4,0
284828,4,29,20,9,7,0
144149,4,23,13,10,14,1
241441,4,7,35,-28,5,1
389480,2,13,0,13,3,0
323993,3,17,16,1,8,1
173524,4,13,27,-14,10,1
362057,2,14,7,7,8,0
319261,1,0,3,-3,6,1
3159,3,13,9,4,2,1
152387,3,28,3,25,17,0
416871,1,0,0,0,15,0
369114,2,6,7,-1,11,0
132102,2,10,0,10,9,1
216209,3,14,3,11,12,1
398354,3,3,13,-10,7,0
305301,4,42,21,21,16,0
229013,4,21,16,5,17,1
339246,2,21,0,21,15,0
399612,2,3,3,0,8,1
304489,2,0,14,-14,16,0
53200,1,0,0,0,8,0
140979,1,7,0,7,13,0
198701,4,15,27,-12,3,1
105719,3,35,3,32,14,0
267717,4,14,33,-19,17,0
220794,1,0,0,0,14,0
355206,1,0,13,-13,4,0
53881,2,7,7,0,8,0
215120,1,0,0,0,11,0
78367,1,0,0,0,2,1
328605,2,17,14,3,10,0
223810,2,6,0,6,15,1
301543,4,20,24,-4,15,0
327899,4,30,24,6,10,1
199635,1,0,0,0,4,1
104952,4,10,9,1,14,0
5703,4,0,24,-24,3,0
124031,1,0,0,0,5,1
20239,4,27,10,17,10,1
408289,2,0,0,0,12,1
119182,4,13,7,6,3,0
139105,2,9,6,3,12,0
202524,1,0,3,-3,5,1
37539,3,10,10,0,17,0
28519,2,24,7,17,14,1
141021,2,7,7,0,13,1
40443,2,7,14,-7,2,1
383407,3,3,9,-6,17,1
200353,4,33,14,19,4,1
394980,1,0,0,0,5,1
78819,1,0,0,0,2,0
365979,1,20,7,13,10,0
353816,1,7,7,0,4,0
131221,2,14,17,-3,8,1
351955,2,21,14,7,3,0
229248,2,10,14,-4,17,0
2734,4,9,7,2,2,1
173466,2,0,10,-10,10,1
86207,1,0,0,0,5,0
418763,3,7,21,-14,16,1
188489,1,0,0,0,16,1
27509,3,20,9,11,13,1
113530,1,0,0,0,17,0
191651,1,0,3,-3,17,0
153314,4,2,10,-8,1,0
186072,4,31,48,-17,15,0
114623,2,3,3,0,1,1
339881,2,23,0,23,15,1
394198,3,26,17,9,5,1
41698,4,31,14,17,2,1
112424,3,13,13,0,17,1
125698,1,0,0,0,5,0
232427,1,3,0,3,1,0
264014,4,30,14,16,15,1
109387,2,3,10,-7,16,1
39326,4,20,27,-7,1,0
406043,2,0,10,-10,11,1
352744,4,24,13,11,3,0
61683,2,14,10,4,12,1
287733,1,7,0,7,9,1
361492,2,7,0,7,7,1
292116,1,13,0,13,11,1
161609,3,30,16,14,4,0
400449,4,24,10,14,8,0
195276,4,23,24,-1,2,0
28612,1,0,0,0,14,0
296219,4,22,26,-4,13,1
7375,1,0,0,0,4,1
240665,4,29,24,5,5,1
129176,1,7,0,7,7,0
215675,4,14,6,8,11,0
170438,3,21,3,18,8,0
297325,1,3,3,0,13,0
144752,3,3,10,-7,14,1
239989,2,0,13,-13,5,1
53644,1,0,0,0,8,0
375275,1,0,0,0,14,1
160597,1,0,0,0,4,1
389684,4,24,16,8,3,1
304272,4,33,25,8,16,1
63490,3,31,13,18,12,0
187226,2,0,6,-6,16,1
226994,2,3,6,-3,16,1
385242,1,0,3,-3,1,1
348514,2,21,7,14,2,1
43898,1,0,0,0,3,1
43398,4,21,24,-3,3,1
137264,3,7,13,-6,11,0
187984,3,13,14,-1,16,0
325166,3,13,14,-1,8,1
351594,4,6,27,-21,3,1
20493,2,0,0,0,10,0
179764,3,6,17,-11,12,0
278135,2,7,7,0,4,0
96385,4,9,37,-28,10,1
120176,4,19,6,13,3,0
316323,4,17,19,-2,4,0
24064,2,7,7,0,12,0
194969,4,14,22,-8,2,0
92619,4,17,3,14,8,0
6433,4,9,20,-11,3,1
240370,4,21,23,-2,5,1
74197,2,3,0,3,17,0
51509,4,34,24,10,7,0
2462,4,28,20,8,2,0
97961,2,0,10,-10,11,1
317175,2,6,3,3,5,1
326758,2,3,7,-4,9,1
355209,1,0,14,-14,4,1
190981,3,12,3,9,17,1
284184,3,9,20,-11,7,1
413058,1,13,7,6,14,1
360142,2,10,6,4,7,1
151677,4,23,41,-18,17,1
359879,2,20,21,-1,6,0
306390,1,0,3,-3,17,1
126406,4,26,17,9,6,1
242483,3,12,10,2,6,1
352273,3,3,6,-3,3,0
140285,2,13,6,7,12,1
415849,2,7,20,-13,15,1
139115,2,9,6,3,12,0
332966,4,31,3,28,12,0
37097,3,13,17,-4,17,0
100680,3,21,21,0,12,1
98066,5,24,27,-3,11,0
318977,2,0,6,-6,5,1
83505,2,0,7,-7,4,0
330430,4,13,20,-7,11,0
181866,2,21,14,7,13,0
373069,2,3,7,-4,13,0
94848,4,6,13,-7,9,0
373364,2,7,7,0,13,1
30255,1,3,7,-4,14,1
363015,4,33,26,7,8,1
97732,4,9,13,-4,11,1
166359,1,0,0,0,6,1
272666,2,9,0,9,2,0
340734,1,0,7,-7,15,1
25123,2,10,0,10,12,1
340483,2,0,20,-20,15,1
188037,4,23,17,6,16,0
371934,4,34,17,17,12,1
186496,3,17,20,-3,15,0
292247,1,0,0,0,11,0
295692,2,3,9,-6,12,1
70720,2,7,10,-3,15,1
247626,4,26,23,3,8,0
370649,4,21,14,7,12,0
126314,2,7,7,0,6,0
222173,2,10,10,0,14,1
389655,3,24,10,14,3,0
95107,2,0,10,-10,9,1
247645,1,0,0,0,8,1
47894,4,21,13,8,5,1
366441,3,26,10,16,10,0
20079,4,22,16,6,10,0
340823,4,24,16,8,15,1
19217,4,21,19,2,10,1
155754,4,26,23,3,2,1
163164,3,22,28,-6,5,1
24851,3,13,3,10,12,1
408811,3,13,25,-12,12,0
278062,4,13,10,3,4,1
83743,4,22,23,-1,4,1
77426,4,27,21,6,1,0
394086,4,16,23,-7,5,0
237746,5,20,20,0,4,1
64107,4,34,24,10,13,1
415056,4,13,34,-21,15,1
5327,1,7,0,7,3,1
123897,1,0,0,0,5,1
83247,3,9,7,2,4,0
231361,4,9,16,-7,1,1
246730,1,3,0,3,8,0
115836,2,0,10,-10,1,1
406771,1,0,10,-10,11,1
20419,4,10,16,-6,10,1
62086,1,7,0,7,12,0
117581,1,0,0,0,2,0
152064,2,3,7,-4,17,0
30073,4,46,7,39,14,0
371542,1,3,0,3,12,0
347541,4,28,37,-9,1,0
237356,2,6,7,-1,3,0
80870,4,6,13,-7,3,0
225972,3,34,20,14,16,0
186916,2,7,3,4,15,0
147127,3,17,37,-20,15,1
251642,1,3,3,0,10,1
23257,4,30,13,17,11,0
352984,3,13,10,3,3,1
304427,1,0,0,0,16,1
75933,4,32,7,25,1,0
247668,1,7,3,4,8,1
369372,1,3,0,3,11,0
257722,4,3,24,-21,13,1
284061,4,13,3,10,7,0
60211,2,3,7,-4,11,1
77245,3,16,7,9,1,1
308780,1,0,0,0,1,0
237201,2,3,0,3,3,1
17473,1,6,0,6,9,1
269386,3,7,17,-10,1,1
218042,3,21,17,4,12,1
236601,1,0,0,0,3,0
349542,1,0,14,-14,2,1
92444,3,20,10,10,8,0
167999,2,3,14,-11,7,0
111430,4,0,20,-20,16,0
371035,3,10,10,0,12,0
89671,2,6,10,-4,7,0
372659,4,14,9,5,13,0
191614,5,24,24,0,17,1
52740,4,19,23,-4,7,1
69936,1,7,0,7,15,0
240062,4,17,27,-10,5,1
384760,4,19,37,-18,1,0
252820,3,9,13,-4,11,1
53401,2,3,14,-11,8,0
312709,3,28,14,14,3,1
136003,3,3,10,-7,10,0
78524,1,0,7,-7,2,1
350259,1,0,0,0,2,1
334243,2,6,7,-1,13,0
340580,1,0,0,0,15,1
397708,2,6,7,-1,7,1
343559,4,10,10,0,16,1
143629,2,10,10,0,14,1
171059,3,17,30,-13,8,0
287042,3,19,24,-5,8,1
151297,2,7,14,-7,17,1
58633,4,13,17,-4,10,1
80280,1,0,3,-3,2,0
174502,2,7,7,0,10,1
244026,2,13,17,-4,6,1
402112,2,12,0,12,9,1
111627,2,7,10,-3,16,1
34435,2,24,3,21,16,1
232424,1,3,0,3,1,1
227363,4,27,37,-10,16,0
408720,1,3,0,3,12,0
4037,2,10,7,3,2,0
176609,1,0,0,0,11,0
260793,2,3,6,-3,14,0
209401,3,14,10,4,8,1
340632,2,13,3,10,15,1
2687,2,6,7,-1,2,0
261228,2,21,0,21,14,1
308484,1,0,0,0,1,0
260832,3,22,15,7,14,1
4384,3,7,7,0,2,0
150445,2,20,3,17,16,1
299338,4,28,16,12,14,1
45417,1,7,0,7,4,0
92222,1,0,0,0,8,1
414953,1,7,7,0,15,1
220631,1,0,0,0,13,0
122268,2,6,13,-7,4,0
174476,1,7,7,0,10,1
347961,3,0,21,-21,1,1
222287,1,0,0,0,14,0
9451,2,10,0,10,5,0
333252,4,6,21,-15,12,1
346397,3,9,13,-4,1,1
173053,3,24,6,18,9,0
138095,4,56,24,32,11,0
329952,3,7,10,-3,11,0
60744,4,28,3,25,11,0
245476,4,23,6,17,7,1
242116,1,13,0,13,6,0
27656,3,7,27,-20,13,0
242200,3,22,7,15,6,1
119917,1,6,14,-8,3,1
379244,4,25,16,9,16,0
283457,3,23,14,9,7,0
146838,2,17,0,17,15,1
308729,3,10,13,-3,1,0
233111,2,16,3,13,2,0
130374,3,7,3,4,8,1
293002,1,0,6,-6,11,1
258743,3,3,33,-30,13,0
248763,3,27,13,14,9,0
294230,3,13,14,-1,12,1
97179,2,3,3,0,10,0
418018,3,21,35,-14,16,0
30063,4,46,7,39,14,0
398678,4,0,6,-6,7,0
90842,1,14,0,14,7,0
181809,1,0,0,0,13,0
278124,1,0,7,-7,4,1
183183,1,0,0,0,14,0
42942,3,24,23,1,3,0
207163,3,14,10,4,7,0
108716,3,37,13,24,15,1
7493,4,29,6,23,4,1
407137,3,10,20,-10,11,0
293340,1,7,0,7,11,0
345994,1,0,3,-3,1,0
97515,2,16,0,16,10,1
278224,4,31,21,10,4,0
348572,3,28,17,11,2,0
189832,4,27,17,10,17,1
367147,3,29,16,13,10,0
340929,3,0,10,-10,15,1
287964,3,14,13,1,9,1
404956,3,6,13,-7,10,0
190686,3,28,14,14,17,0
400422,4,24,10,14,8,0
106305,2,7,9,-2,14,1
317121,1,0,0,0,5,0
361657,3,7,22,-15,7,1
110906,2,7,3,4,16,1
24619,1,0,0,0,12,1
242508,4,15,13,2,6,1
389778,2,10,6,4,3,1
230037,4,6,6,0,17,1
64806,1,0,0,0,13,0
262880,2,7,23,-16,15,1
371823,1,0,10,-10,12,1
217195,4,12,16,-4,12,0
303663,4,38,19,19,16,1
255006,1,0,9,-9,12,1
132944,1,0,0,0,9,0
35194,3,0,14,-14,16,0
398312,2,3,3,0,7,0
270206,1,3,7,-4,1,0
266314,1,0,0,0,16,1
65650,4,6,19,-13,13,1
232099,4,7,33,-26,1,0
79399,1,3,0,3,2,0
45019,3,13,10,3,4,1
32535,2,20,3,17,15,1
61775,1,0,7,-7,12,1
53721,3,7,0,7,8,0
410390,2,0,7,-7,13,1
94158,2,10,7,3,9,1
357643,1,6,0,6,5,0
9729,1,0,7,-7,5,1
36940,2,0,25,-25,17,0
13719,2,0,14,-14,7,0
302282,4,38,13,25,15,1
221161,4,0,23,-23,14,0
348077,3,0,16,-16,1,0
152865,1,0,0,0,1,0
322904,2,6,0,6,7,1
368989,3,10,7,3,11,1
317663,3,9,6,3,5,0
112885,3,10,3,7,17,0
162577,4,38,17,21,4,1
56969,1,0,0,0,9,0
151843,1,0,0,0,17,1
121157,2,0,13,-13,3,1
380873,1,0,0,0,16,0
286911,3,16,13,3,8,1
16695,4,21,30,-9,8,0
103279,4,3,10,-7,13,1
297659,2,7,3,4,13,0
77893,4,17,38,-21,1,1
289411,1,0,0,0,10,1
356991,3,20,3,17,5,0
289790,3,16,10,6,10,1
1507,2,3,6,-3,1,1
331983,2,0,0,0,12,1
155812,2,7,10,-3,2,1
44180,4,13,27,-14,3,1
235946,4,23,28,-5,3,1
225491,2,0,13,-13,15,0
124689,2,0,3,-3,5,0
380987,4,9,14,-5,16,0
386896,1,7,6,1,2,0
68292,1,0,0,0,14,1
209481,1,0,3,-3,8,1
35502,3,24,7,17,17,1
114335,2,14,6,8,1,1
97442,4,16,36,-20,10,1
31441,2,3,7,-4,15,1
229599,4,30,13,17,17,1
319858,4,23,10,13,6,0
246579,1,0,0,0,8,0
18700,1,0,7,-7,9,1
189589,2,0,0,0,17,0
326716,1,0,0,0,9,0
150731,2,13,9,4,17,0
311485,2,10,3,7,2,0
57904,2,10,10,0,10,1
234832,3,0,12,-12,2,1
251923,4,20,19,1,10,0
194874,2,0,10,-10,2,1
123926,2,0,0,0,5,1
176799,2,10,7,3,11,0
79264,1,9,0,9,2,0
375480,2,19,7,12,14,1
102126,1,6,0,6,13,1
343444,2,7,0,7,16,1
7190,1,0,0,0,4,0
3029,4,20,34,-14,2,1
114576,1,0,0,0,1,1
171673,4,19,17,2,9,0
80145,1,7,0,7,2,0
51690,1,0,0,0,7,0
288957,1,9,0,9,9,1
373424,4,10,17,-7,13,1
299786,4,17,17,0,14,0
316344,4,24,26,-2,4,0
61756,4,24,45,-21,12,1
261185,1,14,0,14,14,0
407246,2,0,16,-16,11,1
64464,3,21,13,8,13,0
367729,3,6,13,-7,10,1
42482,2,0,12,-12,3,1
405782,4,18,21,-3,10,0
45743,2,10,7,3,4,1
168921,4,24,6,18,7,0
375137,2,7,10,-3,14,1
206920,4,10,23,-13,7,1
87649,1,0,0,0,6,0
369257,2,14,14,0,11,1
367945,1,0,7,-7,11,1
8812,3,19,0,19,4,0
288660,2,0,7,-7,9,0
99120,4,23,7,16,11,1
357594,4,16,13,3,5,0
97653,2,3,3,0,11,0
170628,4,47,9,38,8,0
366056,4,51,14,37,10,1
315940,2,0,7,-7,4,1
150671,1,0,0,0,17,0
122848,2,10,3,7,4,0
260167,1,7,0,7,14,0
150645,4,10,22,-12,17,1
304061,2,3,20,-17,16,0
32967,2,0,24,-24,15,1
208752,2,3,6,-3,8,1
337713,4,31,24,7,14,0
404759,2,10,6,4,10,0
137653,1,0,0,0,11,0
318112,2,9,7,2,5,0
268951,4,6,36,-30,17,0
122592,3,20,7,13,4,0
77120,3,14,17,-3,1,0
180749,2,7,3,4,13,0
137436,4,6,21,-15,11,0
139246,2,10,6,4,12,1
251199,2,10,10,0,10,0
353201,1,0,0,0,4,0
329224,3,17,13,4,10,1
257252,4,19,23,-4,12,0
68652,2,7,0,7,15,1
333805,2,14,14,0,12,1
103507,2,13,0,13,13,0
94558,4,10,10,0,9,1
410251,2,7,7,0,13,1
390022,4,31,32,-1,3,1
151877,2,13,0,13,17,0
281427,1,0,10,-10,6,1
283648,4,23,20,3,7,0
28291,4,24,14,10,13,1
72365,3,10,20,-10,16,1
26191,4,0,33,-33,13,0
341351,2,0,10,-10,16,1
88684,4,23,20,3,6,1
30467,3,31,34,-3,14,0
104966,4,10,16,-6,14,0
392430,4,40,54,-14,4,1
158166,2,7,0,7,3,0
397589,2,6,20,-14,7,1
119797,3,17,6,11,3,1
285619,4,20,17,3,8,0
4609,2,10,7,3,2,0
75059,1,0,0,0,17,0
160739,4,10,13,-3,4,1
382116,3,21,3,18,17,0
355404,2,10,10,0,4,0
403789,4,15,16,-1,9,0
265074,2,13,3,10,16,1
84315,3,14,27,-13,4,1
239938,1,0,0,0,5,1
10135,1,0,0,0,5,0
172322,1,0,0,0,9,1
262172,4,28,13,15,15,1
109279,3,6,0,6,15,1
204758,3,14,14,0,6,0
369893,3,7,9,-2,12,0
190421,4,7,10,-3,17,1
79537,1,0,0,0,2,0
287609,2,3,3,0,9,1
166521,4,23,27,-4,6,1
101772,4,13,10,3,12,0
207793,4,27,16,11,7,0
385773,2,20,0,20,1,0
303644,4,31,13,18,16,1
133926,3,6,6,0,9,1
54592,1,0,0,0,8,1
156244,4,24,23,1,2,1
385160,3,14,17,-3,1,0
253928,4,44,14,30,11,0
265885,2,0,9,-9,16,1
334155,4,23,7,16,13,0
340504,3,0,34,-34,15,0
23944,3,16,0,16,12,0
145502,4,23,17,6,14,0
338469,1,7,0,7,14,1
101998,2,7,0,7,12,0
165652,2,0,7,-7,6,0
248551,5,26,26,0,8,1
280396,2,3,7,-4,5,1
120000,4,23,30,-7,3,0
284254,1,0,0,0,7,1
15889,1,0,7,-7,8,1
93398,1,3,0,3,9,0
245320,4,16,13,3,7,1
255052,3,3,21,-18,12,0
370510,4,27,9,18,12,1
259049,4,3,16,-13,13,0
215126,1,0,0,0,11,0
250033,3,17,13,4,9,1
366002,2,23,14,9,10,1
132029,4,3,24,-21,8,0
313420,2,7,7,0,3,1
267913,1,0,0,0,17,1
90386,1,0,6,-6,7,1
100129,1,0,0,0,12,1
59527,4,13,20,-7,11,0
243425,2,3,17,-14,6,0
407279,3,16,16,0,11,1
174938,2,3,7,-4,10,1
53060,1,10,7,3,7,1
312472,1,3,0,3,3,1
125349,4,31,3,28,5,0
193365,2,7,10,-3,1,0
50625,4,10,6,4,6,0
37793,3,7,9,-2,1,1
280410,2,6,10,-4,5,1
11666,2,14,0,14,6,1
120084,2,3,0,3,3,0
306837,1,0,3,-3,17,1
358760,4,14,17,-3,6,1
146650,2,7,17,-10,15,1
35931,3,3,0,3,17,1
253062,2,14,0,14,11,0
408503,3,10,10,0,12,0
279784,1,7,3,4,5,0
98281,3,14,27,-13,11,0
220196,1,7,0,7,13,1
341710,3,23,13,10,16,1
77175,1,0,0,0,1,1
197329,3,17,10,7,3,1
295878,2,7,14,-7,12,1
331636,4,23,30,-7,11,0
130001,2,0,13,-13,8,1
25208,1,0,0,0,12,0
138147,2,7,9,-2,11,0
397136,2,3,0,3,6,1
188613,4,20,13,7,16,1
294188,2,0,7,-7,12,1
212601,2,7,17,-10,10,1
356391,4,31,20,11,5,1
80997,4,20,17,3,3,0
365196,4,14,31,-17,9,0
228669,3,16,17,-1,17,0
13930,4,21,14,7,7,1
155758,4,27,23,4,2,0
161940,4,13,16,-3,4,0
62007,3,10,7,3,12,1
95924,5,23,23,0,10,1
56109,2,17,7,10,9,0
278006,2,3,10,-7,4,1
168347,4,24,24,0,7,1
199081,2,7,21,-14,4,0
141824,2,10,14,-4,13,1
5916,2,0,16,-16,3,1
391551,2,10,21,-11,4,0
299847,2,10,0,10,14,1
234429,1,10,3,7,2,0
328011,3,17,3,14,10,0
192635,3,10,7,3,1,0
327072,1,0,0,0,9,0
301586,2,7,3,4,15,0
383361,2,0,6,-6,17,1
8456,2,9,0,9,4,0
341959,2,6,0,6,16,0
326664,3,16,6,10,9,0
257787,1,0,0,0,13,1
388796,3,14,7,7,3,1
233112,2,16,3,13,2,0
110840,5,13,13,0,16,0
369053,4,20,13,7,11,0
52421,4,12,17,-5,7,0
223242,3,3,6,-3,15,0
75622,3,10,6,4,17,0
93914,4,24,6,18,9,0
267636,1,0,7,-7,17,0
94813,3,6,9,-3,9,1
318578,2,10,7,3,5,0
34767,4,20,3,17,16,0
243117,3,7,12,-5,6,1
105169,1,7,0,7,14,0
377203,1,0,0,0,15,0
307738,1,7,0,7,1,0
337066,3,19,0,19,14,1
86945,1,7,0,7,5,1
305664,1,3,7,-4,17,0
225656,3,14,10,4,16,0
394632,3,17,13,4,5,0
270759,4,6,3,3,1,1
344725,4,6,34,-28,17,1
26938,4,13,6,7,13,1
211281,1,3,0,3,9,1
381281,4,24,20,4,16,1
254497,4,29,13,16,11,1
364976,2,7,3,4,9,0
54601,1,7,6,1,8,1
119511,4,14,24,-10,3,0
128467,2,21,7,14,7,0
322372,3,14,13,1,7,0
4767,2,13,0,13,3,1
308633,4,34,16,18,1,0
388183,4,3,13,-10,2,1
65515,4,30,14,16,13,0
396706,2,7,7,0,6,0
77206,2,6,0,6,1,1
259934,3,20,10,10,14,0
331696,1,0,13,-13,12,0
413289,3,17,0,17,14,1
318591,3,10,10,0,5,1
350064,3,20,13,7,2,0
77435,4,27,21,6,1,1
14095,4,3,31,-28,7,0
99280,1,7,0,7,11,1
189124,1,0,0,0,16,1
189624,2,10,6,4,17,0
368095,1,7,0,7,11,1
277109,3,10,14,-4,4,0
197136,3,21,20,1,3,1
215828,4,51,13,38,11,0
252471,2,7,19,-12,10,0
309889,4,24,14,10,1,1
196703,3,33,0,33,3,0
406995,3,3,20,-17,11,1
331939,4,6,28,-22,12,0
126319,2,7,7,0,6,0
161401,2,7,0,7,4,0
99185,2,10,9,1,11,0
382591,4,0,24,-24,17,1
321338,4,22,19,3,6,0
339355,1,0,0,0,15,0
91096,4,12,7,5,7,0
188358,1,0,0,0,16,0
10443,1,0,0,0,5,1
5185,1,0,3,-3,3,0
8051,2,17,7,10,4,0
313134,2,7,10,-3,3,1
118986,3,0,20,-20,3,0
362816,3,7,21,-14,8,1
46465,2,14,6,8,4,1
279663,2,14,0,14,5,1
383048,1,10,7,3,17,0
363904,1,0,0,0,8,1
363883,4,19,29,-10,8,1
173855,1,0,7,-7,10,0
87205,1,0,0,0,6,1
175381,2,14,3,11,11,1
116597,3,13,0,13,2,0
118138,3,23,20,3,2,0
304625,2,14,7,7,16,0
399504,3,0,24,-24,7,0
395711,4,18,37,-19,6,1
189142,1,14,0,14,16,1
354787,3,13,17,-4,4,0
327539,2,7,9,-2,10,0
181150,4,24,14,10,13,0
13318,3,7,20,-13,7,0
384550,2,3,28,-25,1,1
227305,3,13,20,-7,16,0
6284,4,16,17,-1,3,0
30767,4,31,28,3,15,0
221835,1,0,0,0,14,1
220602,4,16,29,-13,13,0
352394,2,28,7,21,3,1
42372,3,14,9,5,2,0
235952,1,0,0,0,3,0
144133,3,23,7,16,14,0
244841,3,7,10,-3,7,1
81591,4,17,24,-7,3,1
125207,4,31,14,17,5,1
233919,3,17,13,4,2,1
47728,4,6,17,-11,5,0
254482,3,23,10,13,11,0
44049,1,0,0,0,3,1
392220,4,10,16,-6,4,1
228462,1,3,0,3,17,1
406155,4,3,29,-26,11,0
61407,3,13,3,10,11,1
296742,1,0,0,0,13,0
351990,3,28,21,7,3,1
392108,1,0,0,0,4,0
387026,4,14,28,-14,2,0
329102,3,17,7,10,10,1
333373,3,17,10,7,12,0
338035,2,0,0,0,14,0
352218,2,0,3,-3,3,1
20470,2,0,0,0,10,1
328090,1,0,0,0,10,1
404662,4,20,22,-2,10,0
143496,2,14,21,-7,14,0
420087,4,31,21,10,17,1
200612,3,27,14,13,4,0
153938,1,0,0,0,1,1
401730,4,17,14,3,8,1
82785,2,9,9,0,3,0
383479,1,0,3,-3,17,0
346197,2,17,0,17,1,0
374291,3,14,13,1,13,1
213425,4,10,41,-31,10,1
340272,1,0,0,0,15,1
115300,4,17,12,5,1,0
280584,3,17,6,11,5,0
412378,4,34,24,10,13,1
39084,2,13,0,13,1,0
43280,4,24,10,14,3,1
164738,2,13,14,-1,6,1
375293,2,7,0,7,14,1
242533,4,25,13,12,6,0
51470,3,27,24,3,7,0
156047,3,20,24,-4,2,1
229318,4,24,27,-3,17,1
135109,3,31,6,25,10,0
140129,2,10,0,10,12,0
263060,3,10,6,4,15,1
387276,3,6,10,-4,2,0
293233,3,16,7,9,11,0
314861,1,0,0,0,4,0
154779,3,13,16,-3,1,0
121809,2,0,7,-7,4,1
286440,3,17,3,14,8,0
290022,2,7,0,7,10,1
206799,1,0,0,0,7,1
111558,4,35,10,25,16,0
401141,3,34,13,21,8,0
369423,2,24,7,17,11,0
289957,4,6,6,0,10,1
75222,1,0,0,0,17,1
176227,4,14,24,-10,11,1
307030,2,17,0,17,17,0
235347,1,7,0,7,3,1
110616,3,17,10,7,16,1
184692,4,10,24,-14,15,1
289061,4,32,28,4,9,1
120782,4,23,6,17,3,1
276066,3,20,3,17,3,0
411391,4,20,13,7,13,0
177134,3,24,13,11,11,1
39726,3,9,0,9,1,1
378677,1,0,0,0,15,1
183758,1,7,14,-7,14,0
242105,1,7,0,7,6,0
141690,3,23,21,2,13,1
137186,1,0,0,0,11,1
17603,4,20,17,3,9,0
320278,3,14,14,0,6,0
330205,2,7,0,7,11,1
211742,4,29,16,13,9,0
314304,2,7,14,-7,3,0
140717,2,6,14,-8,12,0
68582,4,20,28,-8,14,0
198441,2,3,3,0,3,1
102038,2,20,3,17,12,1
93818,1,0,0,0,9,1
403997,1,0,7,-7,10,0
353541,2,17,0,17,4,0
188030,4,23,17,6,16,0
21719,3,17,14,3,11,1
88406,1,0,0,0,6,0
182467,2,7,0,7,14,1
356930,2,3,3,0,5,1
300258,1,0,0,0,14,0
354101,4,19,0,19,4,1
113614,3,6,6,0,17,1
298892,4,21,23,-2,14,1
73757,2,3,0,3,17,0
267869,4,26,17,9,17,1
103627,2,0,7,-7,13,1
294699,3,6,14,-8,12,1
308604,4,15,16,-1,1,1
228030,2,0,0,0,17,1
341857,3,13,15,-2,16,1
177711,3,13,14,-1,12,1
293071,3,10,13,-3,11,1
269119,4,16,16,0,17,1
291293,3,20,19,1,10,1
260884,1,0,0,0,14,1
203561,4,31,10,21,6,0
172748,3,21,10,11,9,1
89596,4,7,40,-33,7,0
341682,2,20,13,7,16,0
181365,2,14,7,7,13,0
309984,2,3,9,-6,2,0
391228,1,0,0,0,4,1
105857,3,16,10,6,14,0
140728,2,12,14,-2,12,1
86383,1,7,0,7,5,0
309374,2,0,0,0,1,1
150806,4,20,9,11,17,1
411614,3,14,21,-7,13,0
210606,3,13,17,-4,9,1
263168,2,3,14,-11,15,0
231080,4,27,14,13,1,1
175092,2,7,10,-3,10,1
51238,4,39,25,14,7,0
365230,1,0,7,-7,9,0
89802,2,3,3,0,7,0
287395,4,20,3,17,8,0
19099,1,0,3,-3,10,1
371268,1,0,7,-7,12,0
12565,3,3,17,-14,6,0
354613,2,3,7,-4,4,0
231240,1,0,0,0,1,1
234955,2,10,3,7,2,1
275758,2,16,3,13,3,1
282396,3,10,23,-13,6,0
68335,2,3,7,-4,14,1
417480,2,10,21,-11,16,1
218205,4,30,3,27,12,0
102688,4,29,28,1,13,1
310494,4,20,9,11,2,1
363370,2,7,10,-3,8,1
14392,1,0,0,0,7,1
60584,4,30,41,-11,11,1
212334,3,10,3,7,10,0
314878,2,0,0,0,4,1
39497,4,13,19,-6,1,1
124648,1,0,0,0,5,0
277050,1,3,0,3,4,1
205030,2,9,17,-8,6,1
374595,3,20,13,7,14,0
317828,3,9,3,6,5,0
353898,3,17,28,-11,4,0
9779,3,2,10,-8,5,0
167574,4,3,17,-14,7,1
39007,4,30,17,13,1,1
73857,4,13,7,6,17,0
175811,2,14,3,11,11,1
407739,3,10,0,10,11,0
97813,2,7,17,-10,11,0
401663,2,0,14,-14,8,1
35116,1,0,0,0,16,0
283833,1,7,0,7,7,1
191243,3,7,17,-10,17,0
407083,2,0,13,-13,11,1
9276,1,7,0,7,5,1
5895,1,0,6,-6,3,0
91639,3,14,14,0,8,1
256696,1,0,3,-3,12,1
116588,2,10,0,10,2,1
9818,4,12,17,-5,5,1
6385,2,0,13,-13,3,0
107066,3,33,0,33,15,0
224448,2,9,10,-1,15,1
54867,4,26,3,23,8,1
137613,5,34,34,0,11,1
284933,2,7,14,-7,7,1
753,1,0,0,0,1,1
110289,2,0,17,-17,16,1
201929,2,0,0,0,5,1
244411,4,3,17,-14,7,0
360827,4,30,37,-7,7,1
72290,1,0,0,0,16,1
94330,2,10,7,3,9,1
345493,1,0,0,0,17,0
406185,1,7,0,7,11,0
91679,4,21,21,0,8,0
247933,4,20,6,14,8,0
237731,4,20,17,3,4,1
121600,4,22,16,6,4,1
265990,4,0,33,-33,16,1
404276,1,0,3,-3,10,0
313443,3,17,7,10,3,0
127260,1,3,0,3,6,1
321037,4,10,7,3,6,1
172579,4,14,24,-10,9,1
292375,4,12,16,-4,11,1
275959,4,20,21,-1,3,1
305825,2,0,7,-7,17,0
52376,3,6,17,-11,7,1
214427,3,7,14,-7,11,1
119983,3,23,24,-1,3,0
51854,1,6,0,6,7,0
188125,2,7,10,-3,16,1
403465,2,17,9,8,9,0
115580,3,27,9,18,1,1
269593,1,0,0,0,1,1
31556,1,0,3,-3,15,1
106076,1,0,0,0,14,1
190063,2,17,3,14,17,1
193486,4,33,20,13,1,0
341297,1,0,0,0,16,1
318390,1,14,0,14,5,1
211308,2,10,3,7,9,0
257673,2,0,7,-7,13,1
77772,2,7,14,-7,1,1
159505,1,7,0,7,3,1
115294,4,17,12,5,1,1
227218,4,16,17,-1,16,0
291108,2,12,13,-1,10,1
302407,4,16,16,0,15,0
216018,1,7,9,-2,11,0
63304,2,3,0,3,12,0
131152,4,27,12,15,8,0
297718,4,17,20,-3,13,1
210242,1,0,0,0,9,0
161150,3,3,33,-30,4,1
128014,1,0,0,0,7,1
389674,3,24,16,8,3,1
420467,2,0,21,-21,17,0
294782,2,7,13,-6,12,0
177663,1,7,0,7,12,0
108670,2,27,3,24,15,0
219351,3,16,13,3,13,1
271098,1,0,7,-7,1,1
20980,2,14,24,-10,10,0
176192,3,14,17,-3,11,0
104336,2,45,21,24,13,0
264829,4,24,37,-13,16,0
413822,2,14,0,14,14,1
231351,3,9,16,-7,1,1
138264,1,0,0,0,11,1
243309,3,7,10,-3,6,1
132028,4,3,24,-21,8,0
90235,1,0,0,0,7,0
259635,3,6,6,0,13,1
317484,2,10,10,0,5,0
378703,2,7,7,0,15,1
96440,2,10,14,-4,10,1
258324,4,35,32,3,13,0
67261,1,0,0,0,14,1
150395,1,0,0,0,16,1
88319,3,14,7,7,6,1
292437,2,3,3,0,11,1
283410,2,20,7,13,7,0
125817,4,17,23,-6,5,1
417969,2,14,21,-7,16,0
173945,3,20,19,1,10,0
46495,3,27,6,21,4,0
78543,2,10,7,3,2,0
116054,4,16,7,9,1,0
50523,1,0,3,-3,6,1
167836,2,7,13,-6,7,0
164591,2,7,3,4,5,0
366971,2,0,17,-17,10,0
291781,4,9,17,-8,11,0
9364,4,31,7,24,5,1
351836,3,20,14,6,3,1
87479,4,26,17,9,6,0
275249,1,3,0,3,3,1
315971,3,0,21,-21,4,0
220564,3,10,23,-13,13,1
370503,4,27,9,18,12,1
39172,4,27,10,17,1,0
261507,2,6,0,6,14,1
421551,3,13,3,10,17,0
200074,1,0,0,0,4,1
186189,3,16,13,3,15,1
121813,2,0,7,-7,4,0
1423,4,16,0,16,1,1
336055,4,16,28,-12,13,0
214901,3,7,12,-5,11,0
261763,4,21,7,14,14,1
142130,2,0,7,-7,13,0
151045,2,9,3,6,17,1
71478,3,33,7,26,16,0
201258,1,0,0,0,5,1
402816,1,0,0,0,9,0
182126,2,16,0,16,13,0
245626,4,40,20,20,7,1
141319,1,0,7,-7,13,1
323166,1,0,0,0,7,0
405398,2,7,10,-3,10,0
282307,4,28,17,11,6,1
15328,2,7,3,4,8,0
261150,4,21,24,-3,14,0
32852,3,6,7,-1,15,0
86123,2,28,3,25,5,1
322917,2,13,0,13,7,1
178375,4,28,24,4,12,0
410907,3,14,15,-1,13,1
169084,4,36,17,19,7,0
89429,3,17,20,-3,7,1
360369,4,7,20,-13,7,0
356419,1,0,0,0,5,0
268292,2,17,3,14,17,0
62929,4,17,10,7,12,0
231429,2,7,6,1,1,1
239587,3,20,10,10,4,1
118336,4,26,7,19,2,0
370182,3,24,3,21,12,0
68181,2,7,7,0,14,1
120578,2,0,13,-13,3,1
143741,1,0,0,0,14,0
106073,1,0,0,0,14,0
207194,4,14,20,-6,7,1
285674,5,27,27,0,8,1
206748,4,7,24,-17,7,0
13473,3,6,21,-15,7,0
131922,1,0,0,0,8,0
254348,4,13,27,-14,11,0
342242,2,3,0,3,16,1
16145,4,40,17,23,8,0
15769,2,0,5,-5,8,0
393212,2,7,6,1,5,1
13321,3,7,27,-20,7,1
303979,4,21,34,-13,16,0
384224,1,0,0,0,1,0
228093,4,3,10,-7,17,1
396240,2,0,3,-3,6,1
80429,1,0,0,0,3,1
115913,4,13,23,-10,1,0
287383,4,20,3,17,8,1
169330,2,3,14,-11,8,1
62211,1,0,0,0,12,0
357410,3,17,17,0,5,1
211472,2,19,7,12,9,0
223740,4,40,13,27,15,0
190617,1,7,7,0,17,1
102822,3,10,10,0,13,1
352928,1,3,0,3,3,1
395597,1,0,3,-3,6,0
217443,2,9,0,9,12,1
324999,2,20,21,-1,8,0
190834,3,16,3,13,17,0
43076,3,3,10,-7,3,0
31266,1,0,0,0,15,0
217080,1,0,0,0,12,1
223773,1,0,0,0,15,1
209846,2,10,13,-3,8,1
101418,3,15,7,8,12,0
26563,2,10,6,4,13,1
264103,3,13,27,-14,15,0
310459,3,14,3,11,2,1
169175,2,10,6,4,7,0
90152,3,3,0,3,7,1
40624,3,31,7,24,2,1
375348,3,7,17,-10,14,1
78362,4,37,35,2,2,1
374809,1,7,0,7,14,1
135070,2,17,3,14,10,0
416766,2,7,10,-3,15,1
383637,2,0,7,-7,17,0
172620,5,24,24,0,9,0
28861,3,23,7,16,14,1
148414,1,0,0,0,16,1
323129,4,29,14,15,7,1
245618,4,40,19,21,7,0
84253,2,0,7,-7,4,1
161708,2,10,3,7,4,0
252815,3,9,13,-4,11,1
360320,3,0,20,-20,7,1
260209,2,10,3,7,14,1
321438,2,14,20,-6,7,1
389952,3,28,18,10,3,1
144740,3,3,7,-4,14,0
129275,4,17,13,4,7,0
347734,1,0,0,0,1,0
189201,3,24,3,21,16,1
325274,1,3,3,0,8,1
68860,3,6,17,-11,15,0
319430,1,0,0,0,6,1
420303,2,14,0,14,17,0
93757,3,3,16,-13,9,0
4610,2,10,7,3,2,0
23394,4,20,17,3,11,0
37645,2,17,0,17,17,1
111938,2,7,21,-14,17,0
405712,2,10,0,10,10,1
390017,4,31,32,-1,3,1
70845,1,7,9,-2,15,0
121869,3,0,16,-16,4,0
318335,4,9,19,-10,5,0
267265,3,17,14,3,17,1
49695,3,14,24,-10,6,1
172104,3,10,12,-2,9,1
22931,4,3,23,-20,11,0
209096,3,3,20,-17,8,0
314741,1,14,0,14,4,1
360977,1,0,0,0,7,0
294524,3,17,13,4,12,1
164766,3,26,14,12,6,0
311953,3,35,10,25,2,0
399298,1,14,0,14,7,0
326700,4,23,13,10,9,0
107838,4,19,30,-11,15,1
145083,4,27,13,14,14,0
232855,4,16,17,-1,2,1
337912,2,10,0,10,14,1
369175,4,19,14,5,11,0
43775,2,14,9,5,3,0
252374,4,0,29,-29,10,1
303095,2,0,14,-14,16,0
30612,3,17,0,17,14,0
187239,2,7,6,1,16,0
25858,2,24,10,14,12,1
157933,3,9,15,-6,3,0
86971,2,14,3,11,5,0
355679,1,7,0,7,5,0
141792,1,7,7,0,13,1
194106,1,0,0,0,1,0
219654,3,10,7,3,13,0
28590,4,33,7,26,14,1
288154,4,19,13,6,9,0
13727,2,0,17,-17,7,0
232585,1,0,0,0,1,1
155206,2,14,7,7,1,0
233656,4,23,47,-24,2,0
62113,2,7,7,0,12,0
2197,1,0,0,0,1,1
166131,2,14,6,8,6,0
226550,1,0,0,0,16,1
316354,1,0,0,0,4,1
240383,5,24,23,1,5,0
270864,3,16,13,3,1,0
189192,3,24,3,21,16,1
310688,4,20,36,-16,2,0
132444,3,0,21,-21,9,1
270393,2,10,0,10,1,0
77325,1,7,7,0,1,1
67816,1,0,3,-3,14,1
123898,1,0,0,0,5,1
41107,4,3,19,-16,2,1
46486,3,27,6,21,4,1
350667,4,20,10,10,2,0
129632,4,23,23,0,7,0
391946,4,30,27,3,4,0
82761,2,6,6,0,3,0
79212,4,23,10,13,2,1
148413,1,0,0,0,16,1
389810,3,17,6,11,3,1
267176,4,17,10,7,17,1
106026,4,24,3,21,14,1
243465,3,3,23,-20,6,1
124635,4,13,17,-4,5,0
46106,4,28,21,7,4,0
21479,4,15,17,-2,11,0
92591,3,17,3,14,8,1
46088,4,21,14,7,4,0
33231,2,10,0,10,16,0
132459,4,0,24,-24,9,1
234924,1,10,0,10,2,0
368279,3,6,3,3,11,0
93322,3,24,3,21,9,1
293990,4,7,28,-21,12,0
351588,4,6,27,-21,3,0
57462,2,14,3,11,10,0
363981,3,3,9,-6,8,1
284451,2,7,12,-5,7,0
274719,3,10,12,-2,3,1
71722,2,10,13,-3,16,1
128533,4,21,28,-7,7,0
290335,2,6,3,3,10,0
111311,1,0,0,0,16,0
251192,1,10,7,3,10,0
144634,4,26,22,4,14,0
411722,1,0,3,-3,13,0
275170,3,14,16,-2,3,1
133735,1,0,0,0,9,0
390126,3,20,27,-7,3,0
4459,1,7,9,-2,2,1
8965,4,35,20,15,4,0
275411,1,6,7,-1,3,0
409782,1,7,0,7,12,1
152306,1,7,0,7,17,0
331525,1,0,7,-7,11,1
260609,1,0,7,-7,14,0
414766,4,10,17,-7,14,1
174519,3,7,7,0,10,0
215455,2,7,3,4,11,0
155078,3,6,33,-27,1,1
187678,2,7,3,4,16,0
170921,4,20,20,0,8,1
165273,3,17,14,3,6,1
130991,4,10,30,-20,8,0
207901,3,28,7,21,8,0
227284,2,10,20,-10,16,0
415954,4,24,30,-6,15,0
157909,3,6,15,-9,3,1
272048,2,7,3,4,2,1
24167,1,0,0,0,12,0
277938,4,7,27,-20,4,1
55319,4,20,10,10,9,0
252090,1,0,0,0,10,0
310913,2,3,3,0,2,0
362483,2,7,6,1,8,1
185879,2,9,10,-1,15,1
420053,4,24,14,10,17,1
79409,2,6,0,6,2,1
151617,2,13,13,0,17,1
255944,2,6,6,0,12,1
337022,2,13,0,13,14,1
271965,4,23,27,-4,2,1
237402,4,12,14,-2,3,0
318218,1,0,0,0,5,1
138800,2,0,33,-33,12,1
388315,2,10,3,7,2,0
16827,4,20,31,-11,8,1
36420,4,34,26,8,17,0
410720,2,17,3,14,13,0
410997,2,7,7,0,13,1
377884,3,20,10,10,15,0
394119,1,0,7,-7,5,1
388045,4,20,6,14,2,0
317538,4,10,27,-17,5,1
62844,1,3,0,3,12,0
117536,4,17,17,0,2,0
8547,4,22,10,12,4,1
347458,2,6,13,-7,1,1
238845,3,34,0,34,4,1
357076,2,6,14,-8,5,0
151465,2,28,7,21,17,0
282495,2,7,3,4,6,1
263166,2,3,14,-11,15,1
369273,2,14,14,0,11,0
143501,3,14,21,-7,14,0
395138,1,0,0,0,5,1
373767,4,19,21,-2,13,1
305723,3,9,7,2,17,1
227054,4,17,6,11,16,0
270416,3,10,7,3,1,0
378042,3,0,13,-13,15,0
213063,3,17,3,14,10,0
389657,3,24,10,14,3,0
363557,3,3,12,-9,8,1
84403,1,3,0,3,4,1
275816,4,16,3,13,3,0
408499,3,10,10,0,12,1
371931,4,34,17,17,12,1
119512,4,14,24,-10,3,0
145492,4,16,17,-1,14,1
262913,3,14,23,-9,15,0
91829,4,24,6,18,8,1
134920,2,7,16,-9,10,1
163537,2,7,3,4,5,1
385473,4,35,10,25,1,0
391260,2,14,0,14,4,0
11389,3,23,0,23,6,1
314264,4,24,23,1,3,0
382959,3,3,13,-10,17,0
200028,4,24,17,7,4,0
38267,4,13,14,-1,1,1
874,1,0,0,0,1,0
300122,1,7,3,4,14,0
334631,1,0,0,0,13,1
256078,1,0,10,-10,12,1
107682,4,13,36,-23,15,1
419554,1,7,7,0,17,1
233877,2,13,6,7,2,1
50352,1,0,0,0,6,0
371507,4,24,24,0,12,0
377932,1,0,0,0,15,0
395742,1,0,0,0,6,1
43520,2,7,3,4,3,1
203393,4,27,33,-6,6,1
94218,3,24,17,7,9,1
411126,1,0,13,-13,13,1
123018,3,0,13,-13,4,1
310656,3,13,33,-20,2,1
104011,4,13,13,0,13,0
186122,1,3,0,3,15,0
41902,2,14,3,11,2,1
134695,4,37,31,6,10,0
224418,1,6,3,3,15,0
266177,2,14,0,14,16,1
410607,3,17,17,0,13,0
310112,2,7,0,7,2,0
320169,4,17,17,0,6,0
155737,4,20,20,0,2,0
193376,2,7,17,-10,1,1
198491,3,17,3,14,3,0
117028,2,0,10,-10,2,0
61077,1,0,0,0,11,1
28635,1,0,0,0,14,0
144915,4,20,7,13,14,1
210777,3,24,10,14,9,0
158597,1,7,7,0,3,1
396376,2,20,9,11,6,0
1710,3,21,0,21,1,0
19002,2,7,0,7,10,0
273992,4,7,29,-22,2,0
183802,2,10,21,-11,14,1
208775,3,3,15,-12,8,1
395708,4,18,37,-19,6,1
57684,4,23,17,6,10,1
279137,4,21,20,1,5,0
277046,1,3,0,3,4,1
199454,4,22,17,5,4,1
298370,2,7,14,-7,14,0
346963,2,7,3,4,1,1
2482,1,0,0,0,2,0
247700,2,7,6,1,8,0
279245,3,16,13,3,5,1
149269,3,10,20,-10,16,1
402194,4,19,14,5,9,1
186681,4,27,9,18,15,1
285134,4,3,0,3,7,1
16792,3,3,24,-21,8,1
406822,3,0,20,-20,11,1
61458,4,16,17,-1,11,1
410595,3,17,7,10,13,0
244315,1,0,0,0,7,0
366670,1,17,3,14,10,0
418388,1,14,0,14,16,1
46077,4,21,14,7,4,0
352607,4,34,23,11,3,1
349790,4,29,21,8,2,0
187263,3,10,6,4,16,1
233696,2,7,20,-13,2,0
203169,2,0,17,-17,5,1
4357,2,7,7,0,2,0
39571,2,14,6,8,1,0
14212,4,0,31,-31,7,0
377944,1,0,0,0,15,1
226847,1,0,0,0,16,0
361776,2,14,6,8,7,0
272520,2,7,3,4,2,1
182577,1,0,3,-3,14,0
194187,3,6,17,-11,1,1
270104,3,17,10,7,1,0
346432,4,15,19,-4,1,0
70975,1,0,0,0,16,1
86445,3,27,14,13,5,0
322313,2,7,7,0,7,1
237623,1,3,0,3,4,0
289343,3,28,17,11,9,1
324973,1,13,14,-1,8,0
225552,4,8,24,-16,15,0
141788,1,7,7,0,13,1
121964,2,3,7,-4,4,1
70017,3,24,10,14,15,1
339531,1,7,0,7,15,0
359478,2,0,14,-14,6,0
355386,2,3,3,0,4,0
48073,1,0,0,0,5,0
404397,4,20,13,7,10,0
140032,4,28,10,18,12,1
302285,4,41,13,28,15,0
211573,4,42,21,21,9,0
183926,2,7,3,4,14,1
91125,1,0,7,-7,8,1
420215,4,3,10,-7,17,0
51358,4,19,20,-1,7,0
227013,2,10,6,4,16,0
129234,3,14,6,8,7,0
42944,3,24,23,1,3,0
409612,1,0,0,0,12,0
216731,3,27,6,21,12,0
108498,2,7,7,0,15,1
157245,2,7,3,4,2,1
46705,1,0,0,0,4,1
19449,3,17,14,3,10,0
47732,4,6,17,-11,5,0
25004,3,16,21,-5,12,0
115920,4,13,30,-17,1,1
10091,3,41,7,34,5,0
127987,4,23,27,-4,6,0
6439,4,15,20,-5,3,0
156964,3,7,10,-3,2,0
162384,3,10,13,-3,4,0
388289,2,3,3,0,2,1
281611,2,21,0,21,6,0
22243,1,0,0,0,11,1
2471,4,28,20,8,2,1
365204,4,14,38,-24,9,1
111899,1,0,0,0,17,0
292089,4,25,19,6,11,0
90246,1,0,7,-7,7,0
369860,2,7,3,4,12,1
12725,3,52,0,52,6,1
416402,4,16,20,-4,15,1
380304,1,0,0,0,16,1
291525,1,3,0,3,11,0
348320,1,7,7,0,1,1
212090,1,0,7,-7,10,1
114527,3,17,34,-17,1,1
112741,3,10,0,10,17,0
81168,4,16,28,-12,3,0
360132,1,10,3,7,7,1
346177,2,17,0,17,1,0
243155,4,20,22,-2,6,1
87645,1,0,0,0,6,0
334380,2,7,10,-3,13,0
201183,3,13,21,-8,5,1
224484,3,12,10,2,15,0
224355,4,16,12,4,15,1
216622,1,0,3,-3,12,1
137764,4,10,37,-27,11,1
90048,4,18,21,-3,7,0
369337,4,21,20,1,11,1
279455,4,16,30,-14,5,0
69257,2,6,0,6,15,0
154552,1,7,6,1,1,0
341803,2,3,9,-6,16,1
399922,3,3,6,-3,8,0
166090,1,14,0,14,6,0
301686,4,17,6,11,15,1
214883,2,0,12,-12,11,0
6692,3,3,20,-17,3,0
80623,2,7,10,-3,3,0
245307,3,16,9,7,7,0
24235,3,10,17,-7,12,1
405569,2,7,14,-7,10,1
126410,4,33,17,16,6,0
334906,4,27,10,17,13,0
283922,4,31,17,14,7,1
391668,1,0,3,-3,4,1
141187,2,3,21,-18,13,1
39081,2,6,0,6,1,1
273843,4,17,14,3,2,1
255826,3,17,0,17,12,1
140301,2,14,6,8,12,0
152873,1,0,7,-7,1,1
32016,1,7,0,7,15,0
107929,3,6,3,3,15,0
190327,1,0,0,0,17,0
387550,2,3,3,0,2,1
79426,2,6,7,-1,2,1
38818,3,3,10,-7,1,0
161370,1,0,0,0,4,1
209623,4,50,34,16,8,1
63536,1,0,0,0,12,1
363584,4,10,15,-5,8,0
242068,4,17,16,1,5,1
371329,3,28,10,18,12,1
23421,1,0,0,0,11,1
307376,4,16,25,-9,17,1
105405,3,23,17,6,14,0
166216,4,35,19,16,6,1
209356,2,7,7,0,8,0
64745,3,28,0,28,13,0
18925,4,9,20,-11,9,0
229592,3,30,13,17,17,0
301914,3,11,13,-2,15,0
284775,3,26,17,9,7,1
159310,4,27,24,3,3,0
214752,3,3,13,-10,11,0
398966,4,23,20,3,7,0
88232,4,24,17,7,6,1
319616,2,16,3,13,6,0
290179,2,3,0,3,10,1
217093,1,0,0,0,12,0
97301,1,0,0,0,10,0
206457,3,17,0,17,7,1
163258,2,6,6,0,5,0
90885,2,31,7,24,7,1
29421,2,0,14,-14,14,1
202280,2,6,0,6,5,0
236197,3,17,16,1,3,1
41717,1,0,0,0,2,0
16961,3,27,20,7,8,1
96827,1,0,0,0,10,0
3598,2,20,21,-1,2,1
162081,3,28,13,15,4,1
331025,3,39,10,29,11,1
224841,4,11,16,-5,15,0
363275,3,24,7,17,8,0
313951,4,28,32,-4,3,1
37391,3,24,0,24,17,1
172891,3,24,24,0,9,1
388429,2,0,6,-6,2,1
153129,3,13,17,-4,1,1
386933,2,7,21,-14,2,1
382299,4,20,3,17,17,1
189053,3,14,17,-3,16,1
138728,4,28,38,-10,12,1
192509,3,14,17,-3,1,1
174282,1,6,0,6,10,1
158574,4,20,17,3,3,0
374056,4,24,10,14,13,0
146024,1,10,0,10,15,0
180015,2,7,20,-13,13,1
357661,1,6,3,3,5,1
315346,2,10,10,0,4,1
367278,3,3,10,-7,10,0
338193,2,7,21,-14,14,1
7048,1,0,7,-7,4,1
23533,4,17,17,0,11,0
40692,1,6,7,-1,2,1
293188,2,6,7,-1,11,1
26990,1,7,0,7,13,1
160081,4,23,39,-16,3,1
105259,3,10,24,-14,14,1
64408,1,0,3,-3,13,0
250153,2,17,0,17,9,0
315996,3,0,31,-31,4,1
157179,1,0,0,0,2,0
82362,4,13,10,3,3,1
369752,4,38,30,8,11,1
330620,1,0,0,0,11,1
102527,4,31,10,21,13,1
133790,3,16,10,6,9,0
65558,1,6,0,6,13,0
136479,4,17,13,4,11,1
71716,2,10,13,-3,16,0
11174,1,0,0,0,6,1
331646,4,23,33,-10,11,1
143672,3,19,10,9,14,0
108300,4,19,7,12,15,0
253853,2,21,14,7,11,1
46472,2,20,6,14,4,1
193504,1,0,0,0,1,1
202074,1,0,0,0,5,1
3877,2,19,7,12,2,0
151445,2,21,0,21,17,0
323499,2,10,10,0,7,0
395979,3,24,17,7,6,1
364151,3,31,3,28,9,0
265039,2,10,3,7,16,0
58878,2,3,15,-12,10,0
65873,2,7,7,0,13,1
52172,2,0,3,-3,7,0
105750,4,35,10,25,14,1
60439,4,23,17,6,11,0
273107,1,0,0,0,2,0
159737,3,7,10,-3,3,1
293110,4,10,27,-17,11,0
186360,4,29,24,5,15,1
241921,4,23,20,3,5,0
119161,3,10,7,3,3,0
395118,4,24,34,-10,5,0
206000,4,13,10,3,7,1
130873,4,20,15,5,8,1
329201,2,10,6,4,10,0
338837,3,10,7,3,15,1
298986,3,9,12,-3,14,0
220588,4,16,26,-10,13,0
273293,2,21,0,21,2,0
169949,2,7,7,0,8,0
329925,2,7,10,-3,11,1
162330,2,3,7,-4,4,1
277191,1,0,7,-7,4,0
179113,3,9,6,3,12,0
261626,1,0,0,0,14,0
281410,1,0,3,-3,6,0
229225,1,3,7,-4,17,0
94242,4,24,30,-6,9,1
291968,1,0,0,0,11,1
317496,2,10,17,-7,5,1
2262,3,10,10,0,1,1
352240,2,3,3,0,3,0
236100,1,0,0,0,3,0
409520,2,7,3,4,12,0
11799,2,20,3,17,6,0
201344,3,28,13,15,5,1
353513,1,3,0,3,4,0
18847,2,3,6,-3,9,1
220581,4,10,26,-16,13,1
55104,3,23,3,20,8,0
70125,2,13,0,13,15,0
26923,3,13,6,7,13,0
44898,3,7,38,-31,4,1
4441,1,0,0,0,2,0
259879,2,14,7,7,14,0
234280,1,0,0,0,2,1
301184,2,13,14,-1,15,1
71905,3,12,13,-1,16,1
286695,2,10,7,3,8,1
369019,3,13,7,6,11,1
280245,2,3,13,-10,5,1
57089,4,21,27,-6,9,0
414847,2,21,7,14,15,0
1239,3,10,6,4,1,1
229087,2,10,7,3,17,0
381776,1,0,0,0,17,1
68788,2,6,0,6,15,1
295213,2,14,0,14,12,0
298401,3,7,14,-7,14,0
44489,4,27,20,7,3,0
347555,4,28,37,-9,1,1
199575,3,34,10,24,4,0
136789,4,13,10,3,11,0
158606,2,7,7,0,3,0
155524,2,20,3,17,2,0
122154,3,24,21,3,4,1
387490,1,0,0,0,2,1
300016,2,0,20,-20,14,0
287082,4,26,32,-6,8,1
361106,4,23,16,7,7,1
364546,2,9,21,-12,9,1
299229,1,3,0,3,14,0
126831,2,7,6,1,6,1
70866,2,7,10,-3,15,0
216184,2,14,3,11,12,0
192113,2,0,6,-6,1,1
364055,1,0,0,0,9,0
61825,2,3,17,-14,12,0
123590,1,0,0,0,4,0
32659,2,0,0,0,15,1
257460,1,0,0,0,13,0
165529,3,3,21,-18,6,1
364779,1,0,0,0,9,1
49175,2,10,0,10,6,0
30288,2,3,10,-7,14,0
177561,2,10,0,10,11,0
342034,4,20,3,17,16,1
269972,3,16,13,3,1,1
20814,2,14,3,11,10,1
195555,3,6,7,-1,2,1
337576,1,7,0,7,14,0
5356,2,10,7,3,3,1
220610,4,16,29,-13,13,1
146633,1,0,7,-7,15,1
350024,2,13,7,6,2,1
406814,2,0,20,-20,11,1
158661,3,14,7,7,3,1
201160,2,6,21,-15,5,0
312988,2,3,0,3,3,1
259088,1,0,0,0,13,0
251603,4,19,20,-1,10,1
68918,1,0,0,0,15,1
138857,4,12,33,-21,12,0
303568,2,14,3,11,16,0
307346,3,14,19,-5,17,0
303170,4,21,28,-7,16,1
342763,3,7,14,-7,16,0
233892,3,14,6,8,2,0
181260,3,0,6,-6,13,0
301402,4,17,16,1,15,0
268996,1,0,3,-3,17,1
253430,3,14,35,-21,11,1
18845,2,3,6,-3,9,1
403093,5,34,34,0,9,1
211142,2,0,3,-3,9,0
279783,1,7,3,4,5,0
268327,3,20,3,17,17,1
16685,4,14,30,-16,8,1
57016,2,7,10,-3,9,1
144654,1,0,0,0,14,1
306034,3,10,10,0,17,1
332174,2,3,10,-7,12,0
385639,4,9,24,-15,1,1
216476,2,17,1,16,12,1
133883,2,3,6,-3,9,0
191910,4,36,16,20,1,0
287442,1,7,10,-3,9,1
75996,1,7,13,-6,1,1
71685,1,0,0,0,16,1
414476,4,16,23,-7,14,1
356241,4,29,14,15,5,0
314738,1,14,0,14,4,1
304101,4,13,29,-16,16,0
327816,1,3,10,-7,10,0
394744,2,14,0,14,5,1
126092,4,20,3,17,6,1
415719,2,14,10,4,15,1
134219,3,3,23,-20,10,1
181813,1,0,0,0,13,1
366981,2,0,24,-24,10,1
280722,3,6,6,0,5,1
43347,2,14,7,7,3,0
114690,3,6,10,-4,1,0
101056,2,0,10,-10,12,1
204042,4,16,7,9,6,0
17750,4,24,13,11,9,0
296621,2,3,7,-4,13,1
92002,4,27,23,4,8,0
221422,2,3,24,-21,14,0
377196,1,0,0,0,15,1
171886,1,0,7,-7,9,1
382850,3,28,3,25,17,1
233793,4,13,37,-24,2,1
342664,1,0,0,0,16,0
280752,4,14,14,0,5,0
150447,2,20,3,17,16,1
390197,1,0,3,-3,3,0
209011,1,3,0,3,8,1
134842,4,55,20,35,10,0
17342,2,14,0,14,9,1
92849,2,21,0,21,8,1
128580,4,28,35,-7,7,1
168132,2,9,5,4,7,0
266671,3,29,3,26,16,0
271031,3,18,21,-3,1,0
33676,2,28,0,28,16,0
16609,2,7,14,-7,8,1
182575,1,0,3,-3,14,0
333929,2,0,7,-7,12,1
119244,2,7,3,4,3,1
373817,2,13,0,13,13,1
177808,1,0,3,-3,12,1
326931,2,2,0,2,9,1
80332,2,13,6,7,2,0
379094,4,7,12,-5,15,0
406276,4,21,27,-6,11,0
279619,1,0,0,0,5,1
177019,4,26,13,13,11,0
142184,4,8,10,-2,13,0
44050,1,0,0,0,3,0
36248,4,10,27,-17,17,1
171520,3,17,10,7,9,1
231200,4,10,7,3,1,0
171505,3,17,10,7,9,1
87357,1,7,0,7,6,0
189915,2,3,7,-4,17,0
198001,2,0,20,-20,3,0
178696,4,3,20,-17,12,0
172848,2,14,3,11,9,1
200454,3,13,18,-5,4,1
360562,2,7,7,0,7,0
3916,3,19,14,5,2,1
134296,1,7,7,0,10,0
59303,2,0,3,-3,11,0
170567,2,21,3,18,8,0
95962,1,0,0,0,10,0
397343,4,3,24,-21,6,0
19219,4,21,19,2,10,1
109731,3,10,0,10,16,1
397946,4,10,17,-7,7,1
9464,2,10,3,7,5,1
323884,4,16,30,-14,8,1
39528,1,0,3,-3,1,0
26410,2,10,3,7,13,0
204959,4,13,27,-14,6,1
146041,2,10,0,10,15,0
365847,2,7,0,7,9,0
289057,4,32,28,4,9,1
262075,1,7,0,7,15,0
327231,2,0,3,-3,9,1
409929,1,0,7,-7,12,0
99913,2,3,3,0,12,0
319480,3,3,10,-7,6,0
164601,2,7,10,-3,5,1
402986,2,7,14,-7,9,0
13143,2,10,16,-6,6,1
135149,4,31,12,19,10,0
169766,2,0,7,-7,8,1
202803,4,22,17,5,5,1
395523,3,21,14,7,6,1
43607,1,0,0,0,3,0
297883,4,21,27,-6,13,0
259817,4,23,20,3,14,0
357069,2,6,7,-1,5,0
349336,4,28,42,-14,2,1
64351,4,19,26,-7,13,0
231740,2,3,19,-16,1,0
40345,4,9,7,2,2,0
381976,3,0,23,-23,17,1
239923,4,13,9,4,4,0
100791,2,6,3,3,12,1
269894,1,0,0,0,1,1
45300,2,7,7,0,4,0
403706,1,3,3,0,9,0
318943,1,0,0,0,5,0
175436,4,17,23,-6,11,1
192640,3,10,7,3,1,1
367957,1,3,14,-11,11,0
103006,1,0,0,0,13,0
206301,4,10,6,4,7,1
301448,2,10,3,7,15,1
45244,1,0,0,0,4,1
217905,3,17,28,-11,12,1
51377,4,22,23,-1,7,1
75007,4,27,17,10,17,0
384846,2,6,12,-6,1,0
21478,4,15,14,1,11,0
230222,1,0,0,0,17,0
233470,3,23,10,13,2,1
190462,1,0,0,0,17,1
342736,3,0,7,-7,16,1
90650,4,20,33,-13,7,1
178472,2,10,3,7,12,1
367694,2,0,6,-6,10,1
415525,1,0,0,0,15,1
257172,1,0,9,-9,12,1
54471,2,0,7,-7,8,1
406046,2,0,10,-10,11,1
184019,4,22,10,12,14,1
146970,2,17,0,17,15,0
81586,4,17,24,-7,3,0
136088,1,0,7,-7,10,0
32868,3,6,7,-1,15,1
20426,1,0,0,0,10,1
668,3,0,10,-10,1,0
89147,4,23,6,17,6,0
324526,2,7,7,0,8,1
80738,1,0,0,0,3,1
316837,4,16,10,6,4,0
38763,1,0,3,-3,1,1
53425,3,3,28,-25,8,0
180829,4,17,20,-3,13,1
399238,3,13,20,-7,7,1
364872,3,6,20,-14,9,1
109530,1,0,7,-7,16,1
203356,3,14,27,-13,6,1
368301,3,9,6,3,11,0
368212,1,0,0,0,11,1
3833,1,0,0,0,2,0
331233,1,0,0,0,11,1
317989,3,10,10,0,5,1
419212,4,17,6,11,16,0
303063,1,0,0,0,16,0
410834,1,14,3,11,13,1
272536,2,10,3,7,2,0
184133,3,16,14,2,14,1
42188,2,7,0,7,2,0
171292,2,0,3,-3,9,1
361250,4,14,26,-12,7,1
361129,4,23,23,0,7,1
293683,3,10,10,0,12,0
305900,4,14,14,0,17,0
119048,4,7,36,-29,3,1
216755,4,27,9,18,12,1
144665,1,0,0,0,14,0
59279,1,0,0,0,11,0
238018,3,10,13,-3,4,1
406200,2,7,10,-3,11,1
369862,2,7,3,4,12,0
84905,3,40,17,23,4,1
241037,1,0,0,0,5,0
47866,3,13,13,0,5,1
301259,4,27,20,7,15,0
289032,3,26,21,5,9,0
105157,1,0,0,0,14,0
382,2,28,10,18,1,0
141980,2,10,14,-4,13,1
197630,4,26,0,26,3,1
313344,4,13,27,-14,3,1
284895,1,0,7,-7,7,0
206332,4,24,6,18,7,1
330210,2,7,7,0,11,1
207976,1,7,0,7,8,1
200088,1,7,3,4,4,1
247541,2,6,10,-4,8,1
100749,1,6,0,6,12,1
46448,2,7,0,7,4,1
257138,5,24,24,0,12,0
344572,4,0,6,-6,17,1
256775,3,10,13,-3,12,1
106565,2,14,0,14,14,1
318178,4,22,17,5,5,1
199006,4,19,26,-7,3,1
228317,1,0,7,-7,17,0
362643,2,0,7,-7,8,1
216583,4,40,17,23,12,0
322048,2,13,0,13,7,1
255316,1,7,0,7,12,1
139748,4,14,21,-7,12,1
14163,2,0,21,-21,7,0
124229,1,7,14,-7,5,0
147442,4,23,10,13,15,1
41217,4,7,13,-6,2,1
15085,3,10,26,-16,7,1
403462,2,17,9,8,9,0
201057,3,41,0,41,5,0
187251,3,7,6,1,16,1
372210,4,9,19,-10,13,0
376045,1,0,0,0,14,0
25112,2,10,0,10,12,1
416416,1,7,0,7,15,0
136941,3,3,13,-10,11,1
398499,3,21,15,6,7,0
282881,4,23,23,0,6,0
382376,2,0,14,-14,17,1
61032,4,34,16,18,11,0
212762,2,10,21,-11,10,1
115140,3,10,20,-10,1,1
79636,4,21,14,7,2,1
315702,4,10,16,-6,4,1
25568,3,24,10,14,12,0
210723,2,14,0,14,9,1
36511,3,10,19,-9,17,0
87198,4,24,13,11,5,0
48351,1,0,7,-7,5,1
346858,3,16,6,10,1,1
379647,4,26,13,13,16,1
92163,3,3,37,-34,8,1
166100,2,14,3,11,6,0
180531,4,21,20,1,13,0
152540,4,24,7,17,17,0
398559,4,30,23,7,7,0
207698,2,0,7,-7,7,0
242209,4,23,7,16,6,0
252661,3,6,3,3,10,0
290879,4,24,21,3,10,0
120089,2,3,0,3,3,1
413333,4,20,7,13,14,1
41901,2,14,3,11,2,1
375902,2,14,3,11,14,0
149995,2,14,3,11,16,1
246897,1,6,7,-1,8,1
167407,4,37,40,-3,7,1
166572,2,8,7,1,6,0
403393,1,0,0,0,9,1
162897,4,13,6,7,5,0
331895,3,0,9,-9,12,1
67424,1,7,0,7,14,0
360117,1,6,3,3,7,1
350195,3,19,0,19,2,0
344831,3,20,10,10,17,1
285178,5,6,3,3,7,0
385919,2,3,14,-11,1,1
364988,2,14,6,8,9,0
269504,2,10,10,0,1,1
188307,4,20,13,7,16,0
367858,3,20,10,10,10,0
367423,3,17,14,3,10,1
2685,2,6,7,-1,2,1
186012,2,10,34,-24,15,1
95904,4,20,23,-3,10,1
285623,4,20,23,-3,8,0
283801,4,21,3,18,7,0
154986,1,0,0,0,1,0
156162,2,7,10,-3,2,0
420477,2,0,28,-28,17,0
236578,4,16,9,7,3,1
138509,4,31,30,1,12,0
239746,3,13,13,0,4,0
302770,2,3,13,-10,15,1
7780,3,30,3,27,4,0
177572,3,10,3,7,11,0
245298,3,9,3,6,7,1
335882,3,28,14,14,13,0
222386,4,24,10,14,14,1
66141,1,3,0,3,13,0
391849,2,10,3,7,4,0
403331,3,9,0,9,9,1
332858,2,7,0,7,12,1
57154,2,7,0,7,10,0
12870,3,13,6,7,6,1
411785,3,0,26,-26,13,0
314618,2,7,0,7,3,0
285570,2,7,10,-3,8,0
304466,2,0,7,-7,16,0
292259,1,0,7,-7,11,1
30247,1,3,0,3,14,0
212447,2,10,0,10,10,0
391110,2,7,14,-7,4,1
26802,4,13,43,-30,13,1
377848,2,20,7,13,15,0
290017,1,7,0,7,10,1
138387,1,0,0,0,12,1
349244,1,0,14,-14,2,1
72126,5,17,17,0,16,1
134290,1,6,7,-1,10,1
332916,3,24,3,21,12,1
80499,2,5,3,2,3,0
36805,3,10,10,0,17,0
48350,1,0,7,-7,5,1
221448,3,3,31,-28,14,0
288026,1,0,0,0,9,1
327095,2,7,0,7,9,0
242685,4,16,10,6,6,1
203863,4,34,31,3,6,0
411634,3,20,28,-8,13,1
287629,2,3,3,0,9,0
226637,4,10,6,4,16,1
153133,3,19,17,2,1,1
273265,1,7,0,7,2,1
260562,4,27,8,19,14,1
110342,4,17,17,0,16,0
204142,3,10,10,0,6,0
405421,2,14,10,4,10,1
293,4,12,34,-22,1,1
304299,1,0,0,0,16,1
362078,2,14,10,4,8,1
367594,3,28,12,16,10,0
28744,4,10,16,-6,14,1
101194,1,0,7,-7,12,0
7093,2,21,14,7,4,1
359500,3,0,21,-21,6,0
119095,2,7,7,0,3,1
91275,1,7,0,7,8,1
103447,1,0,0,0,13,1
364432,3,35,14,21,9,0
337509,3,7,12,-5,14,0
269455,1,0,3,-3,1,1
164790,4,26,21,5,6,1
207088,4,38,10,28,7,0
290180,2,3,0,3,10,1
15130,4,17,26,-9,7,0
296160,2,13,13,0,13,1
66161,1,10,0,10,13,0
32531,2,17,3,14,15,0
364651,1,0,0,0,9,0
301262,4,27,20,7,15,0
364571,3,15,27,-12,9,0
297421,4,30,24,6,13,1
399218,3,13,13,0,7,1
420110,1,0,0,0,17,1
5995,4,17,29,-12,3,1
336802,4,10,23,-13,14,1
53527,2,7,6,1,8,0
346175,2,17,0,17,1,1
44921,4,14,38,-24,4,0
98745,3,28,6,22,11,0
71999,1,0,10,-10,16,1
4448,1,0,3,-3,2,1
299800,5,17,23,-6,14,0
13963,4,24,21,3,7,1
192389,1,0,0,0,1,1
4303,1,0,0,0,2,0
131326,1,0,0,0,8,0
149103,3,17,17,0,16,0
139203,1,0,6,-6,12,1
21842,2,7,0,7,11,0
45320,3,17,13,4,4,0
141222,3,3,21,-18,13,0
77447,4,27,21,6,1,0
371720,2,14,14,0,12,1
108342,1,0,7,-7,15,0
129968,1,0,0,0,8,0
356380,4,30,14,16,5,1
125735,2,7,7,0,5,0
26282,3,10,21,-11,13,1
248595,2,7,3,4,9,1
283512,1,0,0,0,7,1
406977,3,3,20,-17,11,1
214878,2,0,12,-12,11,1
319768,2,7,0,7,6,0
200464,3,20,18,2,4,1
283679,1,0,0,0,7,1
263818,4,7,24,-17,15,1
153690,2,2,14,-12,1,0
267446,4,20,24,-4,17,1
181994,2,14,7,7,13,1
175772,4,40,28,12,11,0
246536,4,22,7,15,8,1
193210,2,3,0,3,1,0
126984,2,10,10,0,6,1
420722,1,0,0,0,17,0
78668,1,0,0,0,2,1
165171,1,0,0,0,6,1
148312,2,7,3,4,16,1
204981,1,9,0,9,6,0
236187,3,17,16,1,3,0
113826,1,0,0,0,17,0
287626,2,3,3,0,9,0
57141,1,0,0,0,10,1
388044,4,20,6,14,2,0
401584,3,17,14,3,8,0
204134,3,3,10,-7,6,1
129333,1,7,7,0,7,1
416655,3,31,7,24,15,1
273140,2,10,0,10,2,0
44067,1,0,3,-3,3,0
267367,2,0,7,-7,17,0
21586,3,7,24,-17,11,1
21883,3,21,0,21,11,1
391235,1,7,0,7,4,0
122731,3,7,17,-10,4,1
408808,3,10,25,-15,12,1
366311,4,28,10,18,10,1
129879,3,13,0,13,7,1
199921,1,0,7,-7,4,0
197802,4,21,20,1,3,0
132757,4,20,24,-4,9,1
102021,2,13,3,10,12,1
166823,4,30,16,14,6,0
321198,4,3,19,-16,6,1
228694,3,16,23,-7,17,1
400689,3,16,7,9,8,0
35489,2,24,7,17,17,0
172054,2,7,3,4,9,1
225329,2,7,21,-14,15,1
30595,3,17,0,17,14,0
306000,2,3,10,-7,17,1
92143,3,3,30,-27,8,1
83867,3,23,9,14,4,0
35641,3,17,3,14,17,0
242388,4,34,19,15,6,1
289896,2,6,3,3,10,1
421423,4,24,20,4,17,1
376253,3,10,14,-4,14,0
220973,2,14,7,7,14,0
31358,3,7,3,4,15,0
292066,4,21,19,2,11,1
132279,3,24,7,17,9,0
79393,1,3,0,3,2,0
88729,1,3,0,3,6,0
244893,1,0,0,0,7,0
19224,4,27,19,8,10,1
267743,4,16,34,-18,17,1
296037,3,3,7,-4,13,1
69751,4,16,10,6,15,1
239306,3,3,14,-11,4,0
129876,3,10,0,10,7,1
390552,3,17,7,10,3,0
225064,2,7,14,-7,15,1
414384,2,7,17,-10,14,1
267912,1,0,0,0,17,1
368487,1,0,0,0,11,0
206746,4,7,24,-17,7,0
283798,4,21,3,18,7,0
409155,4,3,17,-14,12,1
327314,4,16,20,-4,9,0
115230,2,0,3,-3,1,0
189935,2,3,7,-4,17,1
405240,2,7,7,0,10,0
338616,1,3,0,3,14,0
156675,3,6,14,-8,2,1
15651,3,21,10,11,8,1
104545,4,14,38,-24,13,1
412853,4,31,35,-4,14,0
40580,2,17,7,10,2,0
133802,3,19,10,9,9,1
73982,3,37,0,37,17,1
131577,4,9,23,-14,8,0
87970,1,0,0,0,6,1
390265,3,10,6,4,3,0
88322,3,14,7,7,6,1
416931,3,10,7,3,15,1
290245,3,17,3,14,10,1
72829,4,31,17,14,16,1
12837,2,13,3,10,6,1
400483,1,0,3,-3,8,1
391201,4,10,24,-14,4,1
408688,4,34,17,17,12,1
194564,1,7,0,7,2,1
61603,4,35,14,21,11,1
117485,2,7,14,-7,2,1
168717,2,10,3,7,7,0
2320,4,20,17,3,1,0
97469,1,12,0,12,10,1
87225,1,7,7,0,6,1
143862,4,12,7,5,14,0
17578,4,13,17,-4,9,0
93712,2,0,3,-3,9,0
246276,1,0,0,0,7,1
313797,4,34,17,17,3,0
202417,2,3,3,0,5,1
77652,2,0,10,-10,1,1
367472,4,36,24,12,10,0
145952,3,7,21,-14,15,1
373649,2,0,9,-9,13,0
264659,5,20,20,0,16,1
207507,4,28,21,7,7,1
365,2,21,10,11,1,0
106723,2,7,12,-5,14,1
29330,4,21,7,14,14,0
117688,3,27,13,14,2,0
222745,1,3,0,3,14,0
152358,2,14,3,11,17,1
224062,4,14,9,5,15,0
244492,2,19,3,16,7,1
301145,1,10,3,7,15,0
3438,2,3,16,-13,2,0
10574,1,0,0,0,5,0
408300,2,0,6,-6,12,0
193556,2,0,7,-7,1,0
20430,1,0,0,0,10,0
319844,4,20,10,10,6,1
210299,2,6,10,-4,9,1
83238,3,9,7,2,4,1
185350,1,0,0,0,15,0
385704,1,0,0,0,1,1
299427,2,0,20,-20,14,0
23104,4,10,17,-7,11,1
139779,1,0,0,0,12,0
13008,2,7,7,0,6,1
86648,1,0,0,0,5,1
171567,1,0,0,0,9,1
310202,4,24,10,14,2,1
161103,2,3,16,-13,4,1
62791,4,17,0,17,12,0
258382,2,14,6,8,13,0
110582,2,17,7,10,16,1
280731,3,7,6,1,5,1
240330,3,7,23,-16,5,0
1717,3,28,0,28,1,0
176102,4,24,16,8,11,1
138847,3,12,33,-21,12,0
23931,2,16,0,16,12,1
74011,4,37,0,37,17,1
47558,3,37,6,31,5,0
52129,4,23,19,4,7,0
72546,4,19,24,-5,16,1
33154,4,10,42,-32,16,0
156307,2,10,0,10,2,1
414519,2,13,3,10,14,1
397991,1,0,0,0,7,0
181079,2,10,7,3,13,0
310427,2,14,3,11,2,1
285481,4,36,8,28,8,1
116614,3,13,3,10,2,0
373899,4,37,16,21,13,0
19718,2,6,6,0,10,0
414787,5,17,17,0,14,1
336697,2,3,3,0,14,0
380142,1,0,0,0,16,0
214066,1,0,0,0,11,1
26217,1,0,7,-7,13,1
287025,2,13,21,-8,8,1
140257,1,0,0,0,12,1
83452,4,10,23,-13,4,1
147239,2,0,21,-21,15,0
84835,1,0,3,-3,4,1
317198,2,7,13,-6,5,1
274188,1,3,0,3,3,1
383092,2,20,7,13,17,1
339745,3,21,6,15,15,0
295573,3,23,19,4,12,0
71273,1,7,0,7,16,0
58085,2,10,10,0,10,0
87215,1,0,0,0,6,1
370800,4,26,17,9,12,0
177454,4,24,10,14,11,0
14355,4,2,17,-15,7,0
187026,1,0,0,0,16,0
118750,4,27,18,9,2,0
325641,3,17,7,10,9,1
26038,4,10,19,-9,13,1
218009,2,21,10,11,12,0
398981,1,0,2,-2,7,0
91918,2,0,3,-3,8,1
235343,1,7,0,7,3,0
410584,3,10,7,3,13,1
88332,3,14,7,7,6,0
369534,2,3,0,3,11,1
100381,4,9,20,-11,12,0
409728,4,10,6,4,12,1
304692,4,14,7,7,16,0
307658,3,14,17,-3,17,0
170465,4,21,3,18,8,0
239934,1,0,0,0,5,1
186268,2,13,3,10,15,0
139764,4,21,21,0,12,1
77352,2,7,7,0,1,1
352216,2,0,3,-3,3,0
119960,3,9,24,-15,3,1
356915,1,3,0,3,5,1
375079,1,0,0,0,14,1
69474,4,24,10,14,15,1
219506,3,3,21,-18,13,1
362402,4,30,20,10,8,1
338764,1,0,0,0,15,0
44565,2,7,14,-7,3,1
140707,1,3,14,-11,12,1
292088,4,25,19,6,11,0
340360,3,17,10,7,15,0
289950,4,6,6,0,10,0
135661,2,7,10,-3,10,0
226391,1,0,0,0,16,0
46712,1,7,0,7,4,0
37523,3,10,7,3,17,0
88577,1,3,7,-4,6,1
293029,2,3,13,-10,11,1
167418,1,0,0,0,7,0
319631,2,16,3,13,6,1
313819,1,6,0,6,3,1
386828,3,13,14,-1,2,0
234129,1,0,0,0,2,1
78025,3,12,16,-4,1,0
326343,2,7,10,-3,9,0
151588,2,0,3,-3,17,0
46930,4,20,27,-7,5,0
49738,1,0,0,0,6,1
39904,3,6,10,-4,1,0
270860,3,16,13,3,1,0
56187,4,27,21,6,9,1
334390,2,7,10,-3,13,1
112481,4,13,16,-3,17,1
4205,2,10,6,4,2,0
84074,4,30,25,5,4,0
221245,2,0,16,-16,14,0
23149,2,13,0,13,11,0
26826,1,0,0,0,13,1
414655,1,0,0,0,14,1
414594,4,21,9,12,14,1
179676,5,34,30,4,12,1
273633,2,13,6,7,2,0
109151,3,31,7,24,15,0
65372,4,13,28,-15,13,0
184851,4,24,20,4,15,0
40799,4,17,28,-11,2,1
344773,1,0,0,0,17,0
111523,2,14,3,11,16,0
3493,4,10,30,-20,2,1
8541,4,22,10,12,4,0
51971,4,13,16,-3,7,0
326213,2,10,27,-17,9,1
333973,3,17,10,7,12,0
199744,4,35,10,25,4,1
121774,1,0,0,0,4,1
236337,3,7,23,-16,3,0
246020,2,7,6,1,7,1
123247,4,19,21,-2,4,1
95410,2,28,7,21,10,0
401051,1,7,0,7,8,0
22419,2,10,24,-14,11,1
3463,3,3,23,-20,2,1
320099,2,10,0,10,6,1
102991,4,19,38,-19,13,1
397368,4,16,24,-8,6,1
183117,3,7,6,1,14,1
256612,3,21,0,21,12,1
27967,4,21,17,4,13,0
274406,3,3,17,-14,3,1
389415,4,30,22,8,3,1
83098,3,6,21,-15,4,0
22381,1,0,0,0,11,0
383701,3,9,24,-15,17,0
223092,3,31,7,24,14,0
11140,4,24,20,4,5,0
260952,3,10,0,10,14,1
231563,1,7,0,7,1,0
241913,4,20,20,0,5,1
133362,4,20,9,11,9,1
194221,4,12,17,-5,1,1
325725,1,0,7,-7,9,0
120274,3,17,6,11,3,0
323026,1,7,0,7,7,0
376707,3,3,0,3,14,0
57906,2,10,10,0,10,1
31815,4,16,23,-7,15,0
248676,4,31,10,21,9,0
19447,3,17,14,3,10,0
172744,3,21,10,11,9,0
327589,3,10,15,-5,10,0
335922,4,31,21,10,13,1
342825,1,7,0,7,16,1
106938,3,12,3,9,14,0
91955,2,3,23,-20,8,1
304139,1,0,0,0,16,0
228168,2,7,17,-10,17,0
65610,3,6,9,-3,13,0
352598,4,34,23,11,3,0
328396,1,0,0,0,10,0
132099,2,7,0,7,9,1
357351,1,0,0,0,5,1
394885,2,0,17,-17,5,1
136994,5,20,20,0,11,1
372503,4,23,17,6,13,1
94824,3,6,11,-5,9,0
156212,4,16,10,6,2,0
331064,4,52,17,35,11,0
192648,3,10,7,3,1,1
184035,1,0,0,0,14,1
410355,1,0,0,0,13,1
247657,1,7,0,7,8,0
288224,2,3,14,-11,9,0
48848,2,3,0,3,5,1
123456,1,0,0,0,4,0
199147,4,14,38,-24,4,0
182834,4,29,17,12,14,0
15940,2,6,14,-8,8,1
242244,4,30,21,9,6,1
140446,2,14,7,7,12,0
245136,3,17,15,2,7,0
81116,3,13,14,-1,3,1
389110,3,30,7,23,3,1
351790,2,17,14,3,3,0
345837,1,0,7,-7,17,1
412089,3,31,0,31,13,0
363369,2,7,10,-3,8,1
122389,1,0,17,-17,4,1
400828,3,24,13,11,8,0
162243,4,23,20,3,4,0
350532,4,17,19,-2,2,1
391863,2,13,10,3,4,0
301179,2,13,14,-1,15,1
139268,3,13,13,0,12,0
344176,4,35,11,24,17,0
114817,3,13,20,-7,1,0
118125,3,16,20,-4,2,0
206969,1,14,0,14,7,0
292354,4,12,13,-1,11,0
238944,2,14,6,8,4,0
225698,4,21,13,8,16,1
403123,1,7,0,7,9,0
313981,1,0,0,0,3,0
8117,4,27,20,7,4,1
404109,1,6,0,6,10,1
149280,3,13,20,-7,16,0
275126,2,7,9,-2,3,0
206630,4,10,16,-6,7,0
105214,2,7,23,-16,14,0
87787,1,0,0,0,6,1
388275,2,3,0,3,2,0
161972,4,13,23,-10,4,0
307708,4,17,31,-14,17,0
378504,4,23,0,23,15,1
55404,2,13,7,6,9,0
343068,3,12,13,-1,16,0
282685,3,6,17,-11,6,0
76379,3,29,6,23,1,0
196930,1,0,0,0,3,1
156425,1,0,3,-3,2,1
228555,4,20,14,6,17,1
9342,3,28,7,21,5,0
184291,4,34,14,20,14,0
330289,4,31,21,10,11,0
355457,4,20,13,7,4,1
109740,3,13,0,13,16,1
318999,2,0,16,-16,5,1
278554,1,0,0,0,4,0
357436,4,31,24,7,5,0
417306,1,0,3,-3,16,1
10208,3,6,3,3,5,0
21056,4,34,34,0,10,1
101326,1,0,0,0,12,1
141004,2,7,0,7,13,1
345889,3,10,17,-7,17,1
263272,1,7,0,7,15,0
235143,3,0,10,-10,2,0
285141,4,3,0,3,7,1
64294,2,6,10,-4,13,1
28728,4,10,13,-3,14,0
69882,3,24,16,8,15,1
421108,2,20,10,10,17,1
22307,3,0,3,-3,11,0
419558,1,7,7,0,17,0
173549,1,0,7,-7,10,1
232136,1,0,0,0,1,1
279763,4,30,12,18,5,0
325074,4,33,31,2,8,0
51829,1,0,0,0,7,0
400592,4,13,31,-18,8,0
278277,1,7,0,7,4,0
235229,2,12,3,9,3,1
237850,3,7,20,-13,4,0
3225,1,0,0,0,2,1
59262,4,28,58,-30,10,1
294791,2,13,14,-1,12,1
391931,4,23,27,-4,4,1
2024,4,13,15,-2,1,1
59015,2,0,10,-10,10,0
17466,1,0,0,0,9,1
12262,3,3,3,0,6,0
267406,3,3,10,-7,17,1
5775,2,14,0,14,3,0
228927,2,7,9,-2,17,0
214555,2,3,0,3,11,0
16567,4,30,13,17,8,1
299634,4,20,16,4,14,0
254135,2,3,9,-6,11,1
191145,4,28,27,1,17,1
318517,1,0,0,0,5,1
227544,1,0,0,0,16,1
386334,2,10,3,7,2,0
50130,3,0,17,-17,6,0
110312,3,0,17,-17,16,1
248544,5,23,26,-3,8,1
344005,4,23,6,17,17,0
139657,1,0,0,0,12,0
245565,2,40,0,40,7,0
6541,3,3,3,0,3,0
274401,3,3,17,-14,3,0
307743,1,7,0,7,1,0
72645,2,13,3,10,16,1
246865,5,20,20,0,8,0
261375,2,7,17,-10,14,1
388812,4,14,13,1,3,0
306873,2,0,6,-6,17,0
272672,2,9,3,6,2,1
113239,1,7,0,7,17,0
350415,1,0,3,-3,2,1
29390,1,0,0,0,14,0
293455,1,0,0,0,11,0
201109,1,6,0,6,5,0
287853,4,28,20,8,9,0
60498,2,27,7,20,11,0
126656,1,0,0,0,6,0
68942,1,7,7,0,15,1
279982,2,3,10,-7,5,0
400767,1,7,0,7,8,1
155723,3,13,20,-7,2,1
184084,2,9,7,2,14,1
406557,4,20,30,-10,11,1
320973,2,7,0,7,6,0
357401,2,17,17,0,5,0
182619,2,0,6,-6,14,0
17264,4,14,34,-20,9,0
112293,3,38,17,21,17,0
354321,2,21,3,18,4,1
335615,4,19,7,12,13,0
279487,1,7,6,1,5,1
377726,3,32,7,25,15,0
236972,4,38,7,31,3,0
223882,3,30,6,24,15,0
4415,4,14,14,0,2,0
402958,1,7,7,0,9,1
131855,3,24,7,17,8,0
266169,1,7,0,7,16,1
416953,4,10,10,0,15,1
361720,1,0,0,0,7,0
46063,3,14,14,0,4,1
46124,1,0,0,0,4,0
152565,4,24,14,10,17,0
322302,1,7,0,7,7,1
336488,4,20,17,3,14,0
264610,4,12,17,-5,16,0
306485,3,10,17,-7,17,1
227520,4,25,17,8,16,1
13921,3,21,7,14,7,0
47483,2,10,3,7,5,1
349200,4,27,14,13,2,0
411524,4,13,31,-18,13,0
152903,2,7,7,0,1,0
375598,2,7,14,-7,14,1
400318,1,3,0,3,8,1
409745,4,13,9,4,12,0
150762,3,13,9,4,17,1
127028,4,24,20,4,6,1
79977,1,0,0,0,2,1
164538,4,23,17,6,5,1
291129,2,15,13,2,10,1
195797,2,13,7,6,2,1
243979,1,0,0,0,6,1
53923,3,14,13,1,8,0
349664,1,6,0,6,2,0
187341,1,7,7,0,16,1
326158,1,7,7,0,9,0
82106,1,0,0,0,3,1
335034,4,16,13,3,13,1
289962,4,6,6,0,10,0
109922,4,23,13,10,16,1
209603,4,43,34,9,8,1
178080,5,23,23,0,12,1
418519,1,0,0,0,16,1
97624,1,3,0,3,11,0
94043,3,6,21,-15,9,0
211431,1,3,0,3,9,0
155278,4,28,27,1,1,1
137803,1,0,0,0,11,0
148632,3,7,9,-2,16,1
158496,2,9,10,-1,3,1
244219,2,13,7,6,6,1
226587,2,10,3,7,16,0
123099,5,21,21,0,4,1
386144,1,0,0,0,2,0
418232,1,0,0,0,16,0
135785,2,0,14,-14,10,1
233904,3,14,13,1,2,1
404858,4,23,27,-4,10,1
269178,1,0,3,-3,17,1
132968,2,0,14,-14,9,1
368193,4,24,21,3,11,0
208163,2,0,0,0,8,1
401978,2,3,9,-6,9,0
266322,2,7,0,7,16,0
65226,4,10,10,0,13,0
320881,3,3,14,-11,6,0
68777,2,6,0,6,15,1
110981,4,7,20,-13,16,1
370674,4,24,14,10,12,0
283113,2,3,0,3,7,0
165401,3,6,30,-24,6,1
414064,1,0,0,0,14,1
60909,1,0,0,0,11,1
412124,1,0,0,0,13,0
241013,4,27,30,-3,5,1
400474,1,0,0,0,8,0
289378,4,31,25,6,9,0
48711,2,10,19,-9,5,0
351892,4,27,14,13,3,1
114675,3,3,10,-7,1,1
81793,1,0,0,0,3,0
292045,3,15,12,3,11,0
291987,2,0,3,-3,11,1
69840,2,14,9,5,15,1
302048,2,13,16,-3,15,0
117501,3,14,17,-3,2,0
250619,2,3,0,3,10,1
393128,4,24,3,21,4,0
230582,3,13,17,-4,1,1
226860,2,0,7,-7,16,0
180155,2,10,0,10,13,0
157865,2,6,12,-6,3,1
360964,4,37,5,32,7,0
71898,3,12,13,-1,16,0
63519,4,31,19,12,12,0
42552,4,10,24,-14,3,1
237069,2,0,23,-23,3,1
126065,3,14,3,11,6,0
304166,1,0,0,0,16,1
288339,2,7,0,7,9,1
247532,2,6,3,3,8,0
339870,2,23,0,23,15,1
119094,2,7,7,0,3,1
171047,3,17,23,-6,8,0
323844,3,16,15,1,8,0
124912,4,9,16,-7,5,1
141648,2,17,14,3,13,0
141249,4,10,24,-14,13,1
231661,4,17,13,4,1,0
67907,3,19,3,16,14,0
181098,3,17,7,10,13,1
202571,2,14,6,8,5,1
134814,3,48,17,31,10,1
269693,3,10,12,-2,1,1
165590,4,3,35,-32,6,1
185011,4,14,29,-15,15,0
225990,4,34,20,14,16,1
263514,4,20,23,-3,15,0
33320,1,0,0,0,16,1
53837,1,0,0,0,8,0
295475,1,0,0,0,12,0
9902,2,0,3,-3,5,1
378800,4,17,10,7,15,0
131582,4,9,23,-14,8,0
192186,4,3,20,-17,1,1
417328,2,7,3,4,16,1
44655,4,23,30,-7,3,0
153701,2,2,14,-12,1,0
350216,3,27,0,27,2,1
50904,3,17,24,-7,6,0
299709,2,17,3,14,14,1
239683,2,7,10,-3,4,1
391552,2,10,21,-11,4,1
150176,3,6,26,-20,16,1
21211,1,0,0,0,11,1
359192,4,13,21,-8,6,0
183372,2,14,3,11,14,0
146046,2,10,0,10,15,1
19753,3,9,12,-3,10,1
85594,1,0,0,0,5,1
418052,4,28,35,-7,16,1
178298,1,7,3,4,12,0
33013,4,12,44,-32,15,1
266521,3,10,15,-5,16,1
21983,2,7,3,4,11,0
379130,1,6,3,3,16,1
299411,2,0,19,-19,14,0
298202,2,0,3,-3,14,1
142833,4,12,17,-5,13,0
316049,1,0,0,0,4,1
230506,1,0,0,0,1,1
363113,3,7,3,4,8,1
160892,1,0,0,0,4,1
7997,1,3,0,3,4,0
72524,3,16,17,-1,16,1
358012,3,24,13,11,6,0
265199,2,6,3,3,16,0
114742,1,0,0,0,1,1
320052,4,49,36,13,6,0
229882,3,20,14,6,17,0
16046,1,13,0,13,8,1
25160,3,20,3,17,12,0
198100,1,0,0,0,3,1
376662,2,3,0,3,14,0
85104,1,0,0,0,4,0
160236,4,37,14,23,3,0
37500,2,7,7,0,17,0
302286,4,41,13,28,15,0
366337,4,28,16,12,10,0
193688,2,3,20,-17,1,0
3179,4,13,9,4,2,1
105807,2,6,3,3,14,0
350486,3,7,19,-12,2,1
102385,4,16,27,-11,13,1
250319,2,7,7,0,9,0
310713,1,3,0,3,2,0
4077,3,16,21,-5,2,0
419303,2,0,10,-10,16,0
8570,1,0,0,0,4,0
105551,3,29,14,15,14,1
211924,1,0,0,0,9,0
102371,4,16,13,3,13,1
183874,4,44,28,16,14,1
407900,3,9,17,-8,11,1
399905,2,0,6,-6,8,1
115843,2,0,10,-10,1,1
89113,4,16,6,10,6,0
263701,1,0,0,0,15,1
2745,4,9,7,2,2,1
334758,4,32,11,21,13,1
305440,3,20,3,17,17,1
10607,2,0,10,-10,5,0
73072,3,7,10,-3,16,0
10724,1,0,0,0,5,1
136578,2,9,13,-4,11,1
180638,3,17,6,11,13,0
142054,4,23,14,9,13,1
89257,3,6,0,6,7,1
192431,2,0,17,-17,1,1
185502,1,0,3,-3,15,0
362490,2,7,6,1,8,1
123201,3,6,21,-15,4,0
148031,3,7,3,4,15,1
320466,4,17,17,0,6,1
273689,4,22,13,9,2,0
171883,1,0,7,-7,9,1
345614,4,24,23,1,17,0
253182,1,0,0,0,11,0
56209,1,3,0,3,9,0
139760,4,21,21,0,12,0
134538,1,0,0,0,10,0
395998,3,31,20,11,6,0
209345,2,7,7,0,8,0
264996,1,0,0,0,16,0
169501,2,0,28,-28,8,0
175679,2,16,3,13,11,1
330697,3,6,3,3,11,1
124235,2,7,14,-7,5,0
352356,1,14,0,14,3,0
78502,1,0,0,0,2,0
367917,4,23,27,-4,10,1
313390,1,7,0,7,3,0
153971,2,7,7,0,1,1
197276,2,0,0,0,3,1
83027,1,0,0,0,4,1
44940,4,14,38,-24,4,1
198023,3,0,30,-30,3,1
219337,2,16,7,9,13,0
56286,3,3,20,-17,9,0
53505,1,7,3,4,8,1
119290,3,14,10,4,3,0
230322,3,19,10,9,17,0
57673,4,17,17,0,10,0
176021,3,17,0,17,11,1
132194,1,0,0,0,9,1
215412,1,7,0,7,11,1
259362,4,28,34,-6,13,1
75562,2,7,0,7,17,0
291583,3,20,3,17,11,1
380903,2,0,0,0,16,1
123304,2,14,7,7,4,0
99319,2,13,0,13,11,0
135257,3,16,10,6,10,1
198125,1,0,3,-3,3,0
128665,3,6,17,-11,7,1
415696,2,7,3,4,15,0
164907,2,0,3,-3,6,1
51070,4,3,23,-20,6,1
66121,4,10,13,-3,13,1
257314,1,3,0,3,13,1
354859,4,33,42,-9,4,1
419747,3,10,10,0,17,0
56381,1,0,7,-7,9,1
44030,4,3,28,-25,3,1
401479,4,27,10,17,8,0
162713,4,26,24,2,5,1
129404,3,16,13,3,7,1
53625,4,14,22,-8,8,1
336615,4,7,0,7,14,0
119553,2,7,0,7,3,0
413222,1,7,0,7,14,1
328039,4,17,9,8,10,1
285575,2,7,10,-3,8,0
20605,1,0,0,0,10,1
14294,2,2,7,-5,7,0
287775,2,21,10,11,9,0
89798,2,3,0,3,7,0
246062,3,16,13,3,7,1
255019,2,3,9,-6,12,0
332297,2,3,6,-3,12,1
181310,4,3,23,-20,13,1
370261,2,0,14,-14,12,0
352060,1,3,7,-4,3,1
109160,4,31,7,24,15,0
387289,3,6,10,-4,2,0
255525,3,30,7,23,12,0
230289,3,19,10,9,17,0
35377,4,23,16,7,16,0
294381,3,16,3,13,12,0
71423,2,17,0,17,16,1
42458,1,0,5,-5,3,1
135901,5,24,24,0,10,0
117645,2,13,13,0,2,1
86682,2,10,0,10,5,0
332177,3,3,13,-10,12,1
112206,1,7,0,7,17,0
259294,2,13,7,6,13,0
417008,1,3,0,3,15,1
35643,3,17,3,14,17,0
49737,1,0,0,0,6,1
66218,3,24,3,21,13,1
400667,2,6,7,-1,8,1
268555,1,7,3,4,17,0
341252,4,16,13,3,16,1
73734,1,3,0,3,17,1
208547,4,47,23,24,8,1
313100,1,0,0,0,3,0
388470,2,3,13,-10,2,0
67436,2,10,7,3,14,0
414486,1,0,0,0,14,0
52173,2,0,3,-3,7,1
27307,2,14,3,11,13,0
146402,3,10,3,7,15,1
7247,2,6,13,-7,4,1
18603,3,17,10,7,9,0
414978,2,10,7,3,15,1
50017,4,28,10,18,6,1
236632,2,3,0,3,3,0
158292,1,6,0,6,3,0
114353,2,23,13,10,1,1
64787,4,31,7,24,13,1
55656,2,10,14,-4,9,1
327417,3,3,17,-14,9,1
224129,2,0,16,-16,15,0
292603,2,9,16,-7,11,0
320651,4,38,31,7,6,1
175661,2,3,3,0,11,1
55961,2,10,7,3,9,1
410327,4,7,26,-19,13,1
224780,3,5,3,2,15,1
292340,3,12,13,-1,11,1
240682,4,36,24,12,5,1
38517,2,17,3,14,1,0
263249,4,17,23,-6,15,1
228928,2,7,9,-2,17,1
49600,1,0,0,0,6,0
321101,1,0,3,-3,6,1
327057,1,0,0,0,9,1
246364,3,17,10,7,7,1
279492,2,10,6,4,5,0
177456,4,24,10,14,11,0
164101,4,12,6,6,5,0
172227,3,7,13,-6,9,1
391255,2,7,0,7,4,1
394660,4,17,21,-4,5,1
332493,4,23,9,14,12,1
373256,4,13,16,-3,13,1
294867,4,49,21,28,12,0
318645,4,10,13,-3,5,0
17191,2,7,21,-14,9,1
80306,1,7,6,1,2,0
272990,2,3,3,0,2,0
301736,2,0,10,-10,15,0
32287,4,27,28,-1,15,1
124445,3,9,7,2,5,0
174631,1,3,0,3,10,1
249009,1,0,0,0,9,1
305225,2,14,14,0,16,1
396788,1,0,0,0,6,0
225427,1,0,0,0,15,1
329326,2,6,17,-11,10,1
228991,3,14,9,5,17,1
377477,1,0,0,0,15,0
363114,3,7,3,4,8,1
392280,1,0,7,-7,4,0
211672,2,23,3,20,9,0
139191,1,0,0,0,12,1
192135,2,0,6,-6,1,0
79995,1,7,0,7,2,0
168824,1,14,0,14,7,0
244955,2,0,20,-20,7,0
118818,2,19,0,19,2,1
147371,2,0,7,-7,15,1
110573,2,17,7,10,16,0
10718,5,20,17,3,5,1
376632,1,0,0,0,14,0
208823,4,6,22,-16,8,0
131966,2,0,7,-7,8,0
372207,4,9,16,-7,13,0
116333,4,33,13,20,1,1
63019,2,9,21,-12,12,1
223319,4,6,12,-6,15,1
189852,4,33,17,16,17,0
284944,3,10,14,-4,7,0
300570,1,0,0,0,15,0
324600,4,16,9,7,8,1
1286,4,24,16,8,1,0
26667,1,0,0,0,13,0
198335,3,13,14,-1,3,1
51589,2,7,9,-2,7,0
358344,1,6,0,6,6,0
169542,3,3,28,-25,8,0
82163,2,13,3,10,3,0
269205,2,3,3,0,17,0
80906,1,6,0,6,3,1
305846,2,0,14,-14,17,1
251187,1,10,7,3,10,0
381271,4,24,17,7,16,0
306223,4,20,3,17,17,0
20354,3,10,13,-3,10,0
164600,2,7,10,-3,5,1
418350,4,15,24,-9,16,0
112611,4,31,34,-3,17,0
151864,1,10,0,10,17,0
203507,3,21,3,18,6,1
94433,1,0,0,0,9,0
355273,3,14,14,0,4,0
421089,2,13,3,10,17,0
284486,3,14,15,-1,7,1
64439,2,7,6,1,13,1
420458,2,0,21,-21,17,1
404930,2,3,10,-7,10,0
400782,2,14,6,8,8,0
168965,1,0,0,0,7,0
15864,1,0,0,0,8,0
46774,3,14,20,-6,4,0
401727,3,17,14,3,8,0
125501,4,23,7,16,5,1
162714,4,26,24,2,5,1
66640,3,7,17,-10,14,0
94599,1,0,0,0,9,1
210213,4,10,21,-11,9,0
122165,4,24,21,3,4,1
73096,3,7,10,-3,16,0
90051,4,18,21,-3,7,0
211169,2,0,10,-10,9,1
361047,2,16,2,14,7,1
379694,1,3,0,3,16,1
211403,4,10,13,-3,9,1
219973,3,6,21,-15,13,1
263710,1,0,0,0,15,1
20283,1,7,0,7,10,0
78630,4,30,13,17,2,1
416036,3,14,3,11,15,0
52928,1,7,7,0,7,1
154958,4,29,24,5,1,1
357165,4,12,14,-2,5,0
390231,2,3,6,-3,3,0
32070,2,14,10,4,15,0
32914,1,0,0,0,15,0
361787,2,20,7,13,7,1
69438,3,24,3,21,15,0
230999,2,10,0,10,1,1
337018,2,13,0,13,14,0
285743,2,0,10,-10,8,1
5723,4,0,24,-24,3,0
18167,4,20,20,0,9,0
137051,2,7,3,4,11,1
414532,2,14,3,11,14,0
394524,4,10,25,-15,5,0
288646,1,0,0,0,9,0
183014,1,0,0,0,14,1
293527,3,10,10,0,11,0
371613,3,10,17,-7,12,0
128703,4,13,20,-7,7,0
183947,2,7,3,4,14,1
357634,1,0,0,0,5,0
419581,2,13,7,6,17,1
220456,4,26,21,5,13,1
229938,1,0,0,0,17,1
94123,1,3,0,3,9,1
298262,3,20,13,7,14,0
12371,2,7,3,4,6,1
244548,3,25,13,12,7,0
74413,3,10,13,-3,17,1
181918,4,27,35,-8,13,1
47900,4,21,19,2,5,0
16922,2,20,13,7,8,1
206200,1,0,3,-3,7,0
56335,4,3,33,-30,9,1
55910,1,0,0,0,9,1
382110,3,21,3,18,17,0
24551,3,10,13,-3,12,0
380056,3,21,17,4,16,0
324038,4,20,25,-5,8,1
243764,3,17,17,0,6,0
345524,2,7,17,-10,17,1
289582,2,7,13,-6,10,0
320972,2,7,0,7,6,0
253670,2,3,0,3,11,0
398391,4,3,27,-24,7,0
351399,3,13,13,0,3,0
173348,3,28,27,1,10,0
132478,4,8,31,-23,9,1
69853,3,14,9,5,15,0
144974,1,0,0,0,14,0
404833,4,20,20,0,10,1
401566,3,17,14,3,8,1
81977,1,0,0,0,3,1
23913,2,6,0,6,12,1
343318,2,0,10,-10,16,1
154179,3,10,13,-3,1,0
382953,3,3,13,-10,17,0
69426,3,24,3,21,15,0
70679,1,0,0,0,15,0
73074,3,7,10,-3,16,0
99704,1,0,0,0,12,1
108523,2,14,14,0,15,1
188461,4,3,9,-6,16,0
415476,3,23,3,20,15,1
107088,3,40,6,34,15,1
241672,2,0,3,-3,5,1
254961,4,45,7,38,12,0
262762,3,28,10,18,15,1
396787,1,0,0,0,6,0
216754,4,27,9,18,12,1
356259,4,29,14,15,5,0
234241,4,20,17,3,2,0
376068,2,0,3,-3,14,0
305177,4,33,10,23,16,1
382806,2,21,0,21,17,1
33145,4,10,42,-32,16,1
11230,2,14,14,0,6,0
31408,1,0,0,0,15,1
172084,3,10,9,1,9,1
184832,3,24,20,4,15,1
413224,2,7,0,7,14,1
138963,3,7,6,1,12,0
283411,2,20,7,13,7,0
207318,3,10,14,-4,7,1
380744,1,0,0,0,16,1
220030,4,22,35,-13,13,1
77699,4,16,24,-8,1,1
203733,1,0,0,0,6,0
38889,4,10,15,-5,1,1
25054,4,24,24,0,12,1
178594,1,3,3,0,12,1
121738,4,21,35,-14,4,1
301791,3,0,27,-27,15,1
369228,1,7,7,0,11,0
319553,4,22,23,-1,6,1
253568,3,6,10,-4,11,1
271903,2,10,13,-3,2,1
94162,2,10,7,3,9,0
350819,4,23,10,13,2,0
166643,4,22,20,2,6,1
150991,1,0,0,0,17,1
2220,2,7,0,7,1,0
357027,4,26,10,16,5,1
185086,2,0,10,-10,15,0
326639,2,16,6,10,9,0
21728,3,24,14,10,11,0
302639,2,17,3,14,15,0
284442,2,7,9,-2,7,0
391028,4,27,34,-7,4,1
279655,1,14,0,14,5,1
83492,1,0,0,0,4,0
117391,4,34,3,31,2,0
288300,1,0,0,0,9,0
130804,2,13,12,1,8,1
134182,2,0,17,-17,10,1
81410,3,10,10,0,3,0
359923,4,23,30,-7,6,1
340050,3,17,12,5,15,0
45409,1,7,0,7,4,1
248169,3,6,10,-4,8,1
414404,2,7,17,-10,14,0
117563,4,17,23,-6,2,1
340715,4,22,23,-1,15,1
261412,3,10,24,-14,14,1
250,3,12,24,-12,1,1
310446,2,14,3,11,2,1
393053,1,0,3,-3,4,1
401,3,31,17,14,1,1
141741,4,33,21,12,13,1
405057,1,0,3,-3,10,0
50582,2,0,6,-6,6,1
331495,4,9,35,-26,11,1
249911,4,12,20,-8,9,0
364805,1,3,0,3,9,0
87404,2,10,7,3,6,1
269673,3,10,3,7,1,0
16279,4,19,29,-10,8,0
238888,4,41,14,27,4,0
91116,1,0,0,0,8,0
59675,4,21,6,15,11,1
146859,3,31,0,31,15,0
88011,2,17,0,17,6,1
307490,3,35,13,22,17,1
149596,4,17,26,-9,16,0
18090,2,0,14,-14,9,1
118786,1,10,0,10,2,0
338449,1,0,0,0,14,1
95682,2,10,3,7,10,0
235954,1,0,0,0,3,0
21373,1,0,7,-7,11,1
401073,2,20,3,17,8,1
257931,1,0,0,0,13,0
212781,3,10,21,-11,10,0
147993,2,0,3,-3,15,0
359303,2,3,13,-10,6,0
325651,3,23,7,16,9,1
169022,2,19,14,5,7,0
245501,1,7,0,7,7,0
263748,2,0,0,0,15,0
348051,2,0,10,-10,1,0
84161,3,10,0,10,4,0
408820,4,13,28,-15,12,1
49967,2,21,0,21,6,0
365725,2,10,3,7,9,0
418000,3,14,28,-14,16,1
128039,1,3,3,0,7,0
147225,2,0,21,-21,15,1
144322,4,29,7,22,14,0
9519,4,13,13,0,5,1
184471,1,0,7,-7,14,1
101519,2,10,14,-4,12,1
297597,4,24,7,17,13,0
63316,2,10,3,7,12,1
66971,4,21,7,14,14,1
401318,4,20,24,-4,8,1
176734,4,39,19,20,11,0
134454,2,3,20,-17,10,0
273484,3,7,13,-6,2,1
286295,3,16,16,0,8,1
323177,2,0,0,0,7,0
141327,2,3,7,-4,13,0
12760,4,59,0,59,6,0
68395,3,3,21,-18,14,1
106965,4,19,6,13,14,1
282248,3,10,14,-4,6,1
312562,3,37,0,37,3,1
53512,2,7,3,4,8,0
207266,2,0,7,-7,7,1
273920,2,7,3,4,2,0
269885,1,0,0,0,1,0
257463,1,0,3,-3,13,1
10861,4,27,21,6,5,0
270455,4,10,7,3,1,1
372990,1,0,0,0,13,0
41831,4,21,14,7,2,1
164478,2,17,0,17,5,1
121541,3,16,7,9,4,0
153587,3,12,14,-2,1,1
238329,2,3,9,-6,4,0
98223,1,0,0,0,11,0
396935,4,34,33,1,6,1
337924,2,13,0,13,14,0
284179,3,9,20,-11,7,0
16696,4,21,30,-9,8,0
80176,2,7,10,-3,2,0
392309,2,0,14,-14,4,1
189870,1,0,0,0,17,0
415746,3,14,10,4,15,1
218764,3,0,16,-16,13,1
193148,4,13,6,7,1,1
66535,4,31,24,7,14,1
2382,2,7,10,-3,2,1
90333,3,14,26,-12,7,0
317171,2,0,3,-3,5,1
334668,2,2,3,-1,13,1
314410,4,10,17,-7,3,0
186505,4,17,20,-3,15,1
400603,1,0,0,0,8,0
108080,2,13,21,-8,15,1
742,1,0,0,0,1,1
124885,3,9,6,3,5,0
368934,1,0,7,-7,11,1
303283,2,13,0,13,16,0
337894,2,10,0,10,14,0
362348,2,16,7,9,8,0
22441,2,24,24,0,11,0
100378,3,9,20,-11,12,0
154153,3,7,6,1,1,0
137554,3,17,26,-9,11,0
98827,1,7,0,7,11,1
196553,3,17,6,11,2,1
24501,2,0,7,-7,12,1
93727,2,0,6,-6,9,1
247291,3,35,28,7,8,0
281421,1,0,10,-10,6,0
122156,4,24,21,3,4,0
19626,4,17,28,-11,10,0
48637,4,27,27,0,5,0
188292,3,17,13,4,16,0
114467,2,3,10,-7,1,1
397934,4,10,9,1,7,0
50683,1,0,7,-7,6,0
160899,1,0,0,0,4,1
91156,2,3,14,-11,8,0
184878,1,0,0,0,15,1
251794,1,0,0,0,10,0
389792,2,10,6,4,3,1
301045,3,17,3,14,15,1
118023,4,20,6,14,2,0
204755,3,14,14,0,6,0
327268,3,9,13,-4,9,0
92268,2,10,0,10,8,0
312292,4,10,23,-13,2,0
399774,3,0,24,-24,8,1
309270,2,0,10,-10,1,0
386467,1,0,0,0,2,1
284773,2,26,17,9,7,1
279077,2,14,7,7,5,1
344489,1,0,0,0,17,1
264493,1,0,0,0,16,0
134964,4,7,25,-18,10,0
340186,2,20,21,-1,15,1
251243,3,10,24,-14,10,1
138797,2,0,26,-26,12,0
235928,4,16,21,-5,3,1
230339,4,19,17,2,17,0
136469,3,17,13,4,11,0
396822,2,3,7,-4,6,1
377553,2,10,9,1,15,0
60891,4,17,26,-9,11,1
12636,1,0,0,0,6,0
26614,3,10,6,4,13,1
32938,2,0,14,-14,15,1
260530,3,27,0,27,14,0
18759,3,13,10,3,9,0
379803,4,9,27,-18,16,1
352275,3,3,6,-3,3,0
256235,2,6,7,-1,12,1
266868,5,17,17,0,16,1
412711,4,33,13,20,14,1
282987,3,14,3,11,6,0
322184,2,0,20,-20,7,1
302183,1,21,0,21,15,0
59917,2,3,0,3,11,0
343027,2,3,0,3,16,1
198230,4,16,9,7,3,1
381190,1,7,3,4,16,0
319444,2,0,3,-3,6,1
390179,1,0,3,-3,3,1
350779,4,10,3,7,2,1
149894,4,6,16,-10,16,0
383664,2,6,14,-8,17,0
139864,4,20,17,3,12,0
380606,1,0,0,0,16,1
413126,3,33,35,-2,14,0
259390,1,0,0,0,13,0
81365,2,0,7,-7,3,1
238146,1,3,3,0,4,0
92031,4,27,26,1,8,1
325888,1,3,0,3,9,0
99374,4,23,10,13,11,1
125966,4,16,23,-7,6,1
301106,4,33,13,20,15,0
89602,4,7,40,-33,7,0
155574,3,23,3,20,2,0
237286,4,26,0,26,3,1
14753,2,31,0,31,7,0
159778,4,7,13,-6,3,0
275967,4,20,21,-1,3,0
39053,1,3,0,3,1,0
400613,1,0,0,0,8,0
23307,2,6,10,-4,11,0
335985,2,13,15,-2,13,1
8638,3,7,10,-3,4,1
339746,3,21,6,15,15,0
179568,3,0,23,-23,12,1
421868,4,7,19,-12,17,1
272027,2,7,3,4,2,0
345224,2,7,14,-7,17,1
219389,4,23,20,3,13,1
240074,4,20,27,-7,5,1
216422,4,24,23,1,12,0
193997,2,14,7,7,1,0
152952,3,28,17,11,1,0
347585,1,7,7,0,1,0
359389,4,13,23,-10,6,0
339335,4,45,7,38,15,1
308740,3,10,20,-10,1,1
240524,4,12,13,-1,5,0
195796,2,13,7,6,2,1
220486,1,0,0,0,13,0
251332,1,14,7,7,10,0
238162,2,3,9,-6,4,0
42797,2,6,21,-15,3,0
363267,3,24,7,17,8,0
219677,3,10,14,-4,13,1
113470,3,3,7,-4,17,1
205524,3,14,17,-3,6,0
282917,1,7,0,7,6,0
77422,4,21,21,0,1,0
150897,2,7,7,0,17,0
281454,2,0,10,-10,6,1
8040,2,10,7,3,4,0
250964,3,3,6,-3,10,1
202790,4,19,17,2,5,1
353429,3,24,3,21,4,1
386501,2,7,7,0,2,0
295409,3,10,10,0,12,0
53361,2,3,7,-4,8,1
94428,1,0,0,0,9,1
221193,4,0,23,-23,14,0
156607,2,0,0,0,2,1
387545,2,3,3,0,2,1
183307,4,22,20,2,14,0
171221,4,9,14,-5,8,1
388356,4,17,12,5,2,1
283671,1,0,0,0,7,0
47188,3,6,3,3,5,1
153381,2,0,10,-10,1,1
37796,3,7,9,-2,1,1
297022,1,7,0,7,13,0
251984,2,0,13,-13,10,1
244152,1,0,7,-7,6,0
402324,4,23,24,-1,9,0
360044,3,3,33,-30,7,0
416196,3,10,22,-12,15,1
203891,5,37,37,0,6,0
233375,1,7,0,7,2,0
233975,1,7,0,7,2,0
35977,4,6,14,-8,17,1
231894,2,7,34,-27,1,1
288162,4,19,14,5,9,0
11034,1,7,0,7,5,0
352010,4,28,21,7,3,0
394768,3,21,0,21,5,1
311877,1,7,0,7,2,0
127234,5,16,16,0,6,0
263383,4,38,17,21,15,0
352765,1,0,0,0,3,1
186396,1,0,0,0,15,0
4518,3,17,19,-2,2,0
88800,3,13,13,0,6,1
380928,2,6,0,6,16,0
196211,2,7,3,4,2,0
320338,4,17,24,-7,6,1
304047,2,3,20,-17,16,1
157738,3,10,10,0,2,0
178917,2,3,3,0,12,1
171250,1,0,0,0,9,0
45578,2,7,13,-6,4,1
187050,1,3,0,3,16,1
148450,2,7,3,4,16,1
159630,4,27,20,7,3,1
334373,2,0,10,-10,13,1
416198,3,10,22,-12,15,1
415990,2,7,0,7,15,1
330454,4,20,20,0,11,0
178923,2,3,3,0,12,1
190546,3,17,13,4,17,0
316847,1,0,0,0,4,0
9959,4,3,3,0,5,0
124073,2,0,14,-14,5,1
291981,1,0,3,-3,11,1
259696,1,3,0,3,14,0
276376,3,25,35,-10,3,0
355354,1,3,0,3,4,1
6981,3,3,7,-4,3,1
224590,2,6,7,-1,15,0
207196,4,14,20,-6,7,1
138613,2,3,0,3,12,0
65382,1,0,0,0,13,0
153807,1,0,0,0,1,1
26046,4,13,19,-6,13,0
22680,1,0,0,0,11,1
247782,4,10,6,4,8,0
357915,4,13,34,-21,6,1
146900,4,34,0,34,15,0
353063,1,7,6,1,3,0
377049,1,0,6,-6,15,0
268455,3,14,9,5,17,0
135016,1,7,0,7,10,0
384773,4,26,40,-14,1,0
288533,2,13,28,-15,9,0
411809,3,0,34,-34,13,0
301279,1,7,0,7,15,0
208270,1,0,7,-7,8,0
270198,1,3,7,-4,1,1
407565,2,10,9,1,11,1
6583,4,16,6,10,3,0
41084,4,3,16,-13,2,1
175832,2,20,10,10,11,0
95110,2,3,10,-7,9,0
150049,4,31,6,25,16,0
296697,4,10,16,-6,13,1
228616,2,10,14,-4,17,1
190093,3,20,3,17,17,1
226766,3,7,20,-13,16,1
276336,2,14,21,-7,3,1
268138,2,6,7,-1,17,0
355488,4,23,20,3,4,0
417225,3,17,20,-3,16,1
203082,4,36,17,19,5,1
421064,2,6,0,6,17,0
71106,1,6,0,6,16,0
39516,1,0,0,0,1,0
17355,2,17,0,17,9,1
4562,4,31,29,2,2,0
403357,4,19,3,16,9,1
212950,3,7,7,0,10,1
73474,2,3,14,-11,17,1
281738,1,0,0,0,6,1
408854,4,16,35,-19,12,1
209095,3,3,20,-17,8,0
216178,2,14,3,11,12,1
322825,4,3,39,-36,7,0
395915,1,7,0,7,6,1
365661,1,0,0,0,9,1
341455,1,0,0,0,16,0
5430,4,20,23,-3,3,0
192858,4,10,15,-5,1,1
244701,3,21,23,-2,7,0
38908,1,7,0,7,1,1
79867,2,3,13,-10,2,1
263007,2,10,0,10,15,1
101382,2,6,7,-1,12,1
172643,1,0,0,0,9,1
73924,2,14,0,14,17,1
385398,2,14,7,7,1,0
303316,3,27,0,27,16,1
122772,4,10,27,-17,4,0
39500,4,13,19,-6,1,1
226853,2,0,7,-7,16,1
129306,4,17,13,4,7,1
220445,4,23,20,3,13,0
177165,4,40,13,27,11,0
206713,3,0,14,-14,7,1
330935,1,6,0,6,11,0
122155,3,24,21,3,4,0
127746,2,0,14,-14,6,1
405424,2,14,10,4,10,1
248356,4,29,10,19,8,0
400490,2,0,3,-3,8,1
358114,2,17,0,17,6,0
333697,3,21,0,21,12,1
272703,2,9,3,6,2,1
44553,2,0,14,-14,3,1
305535,2,6,0,6,17,0
292241,1,0,0,0,11,1
200965,1,7,0,7,5,0
7112,2,21,21,0,4,1
175577,3,27,7,20,11,1
155376,2,13,3,10,2,0
50754,4,21,14,7,6,0
328494,3,6,3,3,10,1
400545,3,13,17,-4,8,0
393036,1,0,0,0,4,0
366721,3,24,10,14,10,0
234963,2,10,3,7,2,1
79581,2,14,0,14,2,0
134965,4,7,25,-18,10,1
125360,4,37,3,34,5,1
122665,1,0,0,0,4,0
301446,2,10,3,7,15,1
150258,1,0,0,0,16,1
418538,1,7,0,7,16,1
79062,4,13,21,-8,2,1
166553,1,6,0,6,6,1
273927,2,7,6,1,2,0
264287,3,10,23,-13,15,1
139428,3,24,3,21,12,1
273821,3,17,7,10,2,0
81363,2,0,7,-7,3,0
92623,4,17,10,7,8,1
294836,3,35,21,14,12,1
259030,4,3,16,-13,13,0
341985,3,6,3,3,16,1
169441,4,13,31,-18,8,1
263358,4,24,10,14,15,1
133455,2,14,17,-3,9,1
53381,2,3,14,-11,8,1
159236,2,17,24,-7,3,0
112085,2,7,14,-7,17,1
393663,1,0,0,0,5,0
195159,1,0,0,0,2,1
95251,2,3,10,-7,10,0
242335,3,20,13,7,6,0
173709,1,0,0,0,10,0
346220,3,26,0,26,1,0
9531,4,13,13,0,5,1
308513,1,0,9,-9,1,1
44506,4,27,20,7,3,0
405304,3,14,7,7,10,0
212070,4,24,40,-16,9,1
213897,1,0,0,0,10,0
354928,1,7,0,7,4,0
184030,1,0,0,0,14,0
181089,2,16,7,9,13,1
91313,2,7,7,0,8,0
5053,2,7,0,7,3,1
280726,3,7,6,1,5,0
49696,3,14,24,-10,6,1
208667,4,6,6,0,8,0
198547,5,20,20,0,3,1
137485,1,7,0,7,11,0
358936,4,14,38,-24,6,1
148075,4,14,10,4,15,1
72497,2,13,17,-4,16,1
188639,5,20,19,1,16,1
156732,4,24,23,1,2,0
152193,2,14,0,14,17,0
174101,4,8,36,-28,10,1
325618,2,10,7,3,9,0
353126,3,10,29,-19,3,1
38806,3,3,10,-7,1,0
371296,2,13,10,3,12,1
208455,2,10,0,10,8,1
270085,2,17,10,7,1,0
209336,2,7,7,0,8,1
126258,4,28,9,19,6,0
280977,1,0,3,-3,6,1
258885,4,20,20,0,13,1
240593,2,3,7,-4,5,1
355908,4,27,10,17,5,0
138081,4,49,24,25,11,0
395239,3,10,13,-3,5,0
220323,4,29,9,20,13,1
82323,3,6,10,-4,3,0
240483,3,3,7,-4,5,1
343767,2,7,3,4,17,0
150838,1,0,0,0,17,1
417333,2,10,3,7,16,0
297391,3,9,24,-15,13,1
262739,2,21,0,21,15,1
293637,2,7,7,0,12,1
92198,4,10,43,-33,8,1
325210,4,13,23,-10,8,0
230969,1,0,0,0,1,1
23282,1,0,3,-3,11,0
297033,1,14,0,14,13,0
74544,3,0,3,-3,17,0
176544,4,12,17,-5,11,1
316617,3,9,12,-3,4,1
279268,3,19,13,6,5,0
327565,3,10,15,-5,10,1
301867,1,0,0,0,15,0
221312,4,6,32,-26,14,0
193809,1,3,0,3,1,0
141146,1,3,7,-4,13,0
275753,2,16,3,13,3,1
324745,3,19,7,12,8,1
95516,2,3,7,-4,10,1
294079,3,7,21,-14,12,0
146423,4,16,3,13,15,0
304025,2,0,13,-13,16,1
224956,4,3,16,-13,15,1
39066,1,6,0,6,1,0
68186,2,7,7,0,14,1
2047,1,0,0,0,1,1
4152,1,0,3,-3,2,0
227429,2,7,7,0,16,1
395594,1,0,3,-3,6,0
112530,2,10,9,1,17,1
393757,4,7,7,0,5,0
200893,3,17,0,17,4,1
174727,4,9,10,-1,10,0
177915,4,21,23,-2,12,1
300455,2,16,0,16,14,0
114330,2,14,6,8,1,0
97438,4,16,36,-20,10,1
284704,4,17,34,-17,7,1
151197,3,10,20,-10,17,0
112630,4,38,34,4,17,1
207882,3,14,7,7,8,0
356903,1,3,0,3,5,0
331668,1,0,0,0,12,1
123357,3,21,17,4,4,1
158103,4,22,9,13,3,1
81434,4,10,13,-3,3,0
371810,1,0,0,0,12,0
161800,4,30,6,24,4,0
115583,3,27,9,18,1,0
15267,4,23,7,16,8,1
220203,1,10,0,10,13,0
230203,4,3,32,-29,17,0
344966,3,10,14,-4,17,0
338777,1,7,0,7,15,0
46611,2,3,0,3,4,1
57118,1,0,0,0,10,1
41814,4,21,14,7,2,1
399269,4,16,30,-14,7,1
364085,2,7,3,4,9,1
237303,1,0,0,0,3,1
138817,3,3,33,-30,12,1
42259,4,30,7,23,2,0
177684,2,10,14,-4,12,1
46209,3,14,21,-7,4,0
184811,3,17,20,-3,15,1
193628,4,14,17,-3,1,0
197127,2,14,20,-6,3,1
141850,3,17,14,3,13,1
27195,3,16,7,9,13,1
418798,4,14,24,-10,16,1
172355,2,3,14,-11,9,1
225485,2,0,7,-7,15,0
299443,3,0,20,-20,14,1
109822,2,10,0,10,16,1
256042,4,25,12,13,12,0
257034,2,0,14,-14,12,1
356068,4,27,10,17,5,0
77496,2,6,7,-1,1,1
170449,3,21,3,18,8,1
23068,4,10,17,-7,11,0
214522,1,0,0,0,11,0
156563,1,0,0,0,2,0
74738,4,14,17,-3,17,0
380522,2,7,17,-10,16,1
93101,5,20,20,0,8,1
236618,1,0,0,0,3,1
8702,4,17,10,7,4,0
23171,2,23,0,23,11,0
331567,2,10,20,-10,11,1
134233,3,3,23,-20,10,0
342205,1,0,0,0,16,1
257778,1,0,0,0,13,0
67398,4,30,13,17,14,0
305944,5,21,24,-3,17,1
302871,4,12,23,-11,15,1
334537,2,14,17,-3,13,1
6330,1,0,0,0,3,0
313445,3,17,7,10,3,0
218783,4,3,16,-13,13,0
264509,1,6,7,-1,16,1
299095,2,3,3,0,14,1
235915,4,10,14,-4,3,0
204422,2,7,10,-3,6,1
284910,2,0,14,-14,7,1
266007,1,0,0,0,16,1
215679,4,14,6,8,11,1
416975,4,10,17,-7,15,1
370455,2,13,6,7,12,0
182156,2,19,7,12,13,1
138999,4,14,9,5,12,1
409078,2,3,10,-7,12,0
212948,3,7,7,0,10,1
250158,2,17,0,17,9,1
235839,2,0,14,-14,3,1
60547,3,30,27,3,11,1
110081,1,0,0,0,16,0
328629,3,20,35,-15,10,0
137828,2,0,6,-6,11,1
56360,1,0,0,0,9,1
37894,2,3,7,-4,1,1
10219,3,6,3,3,5,0
148989,4,13,12,1,16,1
95147,3,23,17,6,9,0
145169,3,36,0,36,14,1
190166,1,0,0,0,17,1
28303,4,27,14,13,13,0
8419,1,0,0,0,4,1
249071,2,21,17,4,9,0
206266,3,10,6,4,7,0
315873,4,9,19,-10,4,1
198036,3,0,30,-30,3,1
348715,3,24,10,14,2,0
177102,2,23,13,10,11,1
33985,3,10,27,-17,16,0
230701,2,6,27,-21,1,1
240067,4,20,27,-7,5,0
152746,1,0,0,0,17,0
69895,4,27,16,11,15,0
40574,2,10,7,3,2,1
231831,4,33,27,6,1,1
252431,1,0,0,0,10,1
106172,3,0,7,-7,14,0
91742,1,0,0,0,8,1
328781,3,17,13,4,10,1
185302,4,34,22,12,15,0
389908,2,12,3,9,3,0
133329,3,7,6,1,9,1
84056,4,30,22,8,4,1
61206,1,7,0,7,11,0
133929,3,6,6,0,9,0
37877,1,0,7,-7,1,1
359768,3,27,16,11,6,0
151857,1,3,0,3,17,1
347695,4,27,24,3,1,0
344428,4,28,24,4,17,1
317518,3,10,27,-17,5,0
405504,4,24,16,8,10,0
313336,4,13,27,-14,3,1
27582,1,7,0,7,13,0
49061,3,10,13,-3,6,0
216717,3,27,6,21,12,0
141029,2,7,7,0,13,0
79928,3,10,16,-6,2,0
120942,4,34,31,3,3,1
65896,2,7,14,-7,13,1
218352,4,17,26,-9,12,1
21782,4,31,24,7,11,0
95173,4,23,27,-4,9,0
180409,1,7,0,7,13,0
176527,3,12,17,-5,11,1
337905,2,10,0,10,14,1
374523,1,7,3,4,14,1
292391,4,12,16,-4,11,1
102206,3,24,7,17,13,0
133162,2,10,17,-7,9,1
209922,4,37,16,21,8,0
27173,2,13,7,6,13,1
363593,4,10,15,-5,8,0
96930,3,22,7,15,10,0
259601,2,0,3,-3,13,1
76383,3,29,6,23,1,1
254381,1,0,0,0,11,1
409237,2,13,3,10,12,0
201232,4,23,24,-1,5,1
331764,3,13,27,-14,12,1
307226,4,3,10,-7,17,1
275844,1,0,0,0,3,1
303911,2,13,24,-11,16,1
412444,2,0,7,-7,14,1
121874,3,0,17,-17,4,1
401708,3,10,14,-4,8,0
143242,3,10,16,-6,13,1
89983,2,2,14,-12,7,1
117333,2,21,0,21,2,0
37225,3,10,14,-4,17,1
399911,2,0,6,-6,8,0
339884,3,23,0,23,15,0
110671,4,23,10,13,16,1
139455,4,24,10,14,12,1
62814,4,20,0,20,12,0
139573,3,9,7,2,12,0
241442,4,7,35,-28,5,1
314697,4,17,28,-11,3,1
392353,3,17,28,-11,4,1
285479,4,36,8,28,8,1
381351,2,6,0,6,16,1
243879,2,16,3,13,6,0
349281,2,13,21,-8,2,0
263992,4,23,7,16,15,1
420277,2,7,0,7,17,0
344196,1,0,3,-3,17,1
79701,1,7,7,0,2,1
313953,4,28,32,-4,3,1
68008,1,0,3,-3,14,0
116794,4,27,26,1,2,1
39285,3,3,20,-17,1,1
377259,2,14,3,11,15,0
117738,1,0,0,0,2,0
322455,2,12,0,12,7,0
330576,4,20,7,13,11,1
343146,1,0,0,0,16,1
255420,4,24,6,18,12,0
43614,1,0,0,0,3,0
412924,2,9,3,6,14,0
79371,4,32,3,29,2,1
358641,4,27,16,11,6,1
349884,2,3,6,-3,2,1
81508,2,0,14,-14,3,1
210904,3,19,3,16,9,0
224570,1,3,7,-4,15,1
246457,2,9,0,9,8,1
388381,4,24,20,4,2,0
66991,1,0,0,0,14,0
323349,2,7,0,7,7,1
44222,1,7,10,-3,3,1
302002,1,6,0,6,15,1
288979,2,16,7,9,9,0
278790,2,7,7,0,5,1
248929,3,17,3,14,9,1
134211,3,3,17,-14,10,0
388284,2,3,3,0,2,1
20566,4,17,0,17,10,1
239187,4,20,19,1,4,1
229364,1,3,0,3,17,1
373621,1,0,0,0,13,0
329200,2,10,6,4,10,0
129839,2,10,0,10,7,1
62452,3,6,13,-7,12,1
227503,4,19,17,2,16,0
283737,2,8,3,5,7,0
413049,1,7,0,7,14,0
104226,1,3,0,3,13,0
346502,2,17,17,0,1,0
334778,4,32,11,21,13,0
395464,1,7,0,7,6,0
353027,4,23,10,13,3,1
99683,4,26,3,23,11,1
249372,2,10,12,-2,9,0
288901,4,13,31,-18,9,1
378835,1,7,3,4,15,0
35040,3,9,10,-1,16,1
357765,1,0,0,0,6,0
385407,2,14,7,7,1,1
74012,4,37,0,37,17,1
329383,3,16,34,-18,10,0
100685,4,21,21,0,12,0
419393,1,0,0,0,16,1
276674,3,23,6,17,4,0
133875,1,0,6,-6,9,1
50995,2,0,7,-7,6,0
392087,4,18,33,-15,4,0
261601,4,12,15,-3,14,1
93141,2,0,0,0,9,0
12815,2,3,3,0,6,1
351747,1,7,7,0,3,0
206349,1,0,0,0,7,1
110364,4,20,17,3,16,1
45366,4,20,16,4,4,0
82439,1,0,7,-7,3,1
226241,2,6,0,6,16,0
90200,4,6,3,3,7,0
270830,2,6,7,-1,1,1
163142,3,16,22,-6,5,0
245544,2,34,0,34,7,1
215170,2,7,9,-2,11,1
349933,4,10,12,-2,2,0
241369,2,7,7,0,5,1
110824,4,6,10,-4,16,0
355408,2,10,10,0,4,1
103551,3,33,0,33,13,1
147248,2,0,21,-21,15,0
400847,3,24,19,5,8,0
49243,4,17,10,7,6,0
93217,4,3,20,-17,9,0
409787,1,7,0,7,12,1
153775,4,2,27,-25,1,0
69182,4,17,17,0,15,0
207890,3,21,7,14,8,0
256030,4,25,12,13,12,1
35891,2,0,0,0,17,0
153415,3,13,10,3,1,1
239148,3,13,13,0,4,1
294949,2,14,7,7,12,0
275685,4,37,10,27,3,0
108828,3,7,10,-3,15,1
16039,1,13,0,13,8,1
304931,2,7,3,4,16,0
134746,2,10,3,7,10,1
235537,2,3,13,-10,3,1
403044,3,21,24,-3,9,1
154231,4,10,23,-13,1,1
355762,3,10,6,4,5,0
226599,3,10,3,7,16,0
412699,4,33,10,23,14,0
138693,4,13,28,-15,12,0
18965,1,0,0,0,10,0
136490,4,17,13,4,11,1
194374,4,26,6,20,2,0
307391,4,23,25,-2,17,0
69129,2,14,10,4,15,1
374046,4,24,10,14,13,0
168350,4,24,24,0,7,1
308728,3,10,13,-3,1,0
354518,3,27,28,-1,4,1
275299,2,10,8,2,3,1
52476,1,3,0,3,7,0
342240,2,3,0,3,16,1
25638,1,0,0,0,12,1
233828,1,0,0,0,2,1
52020,2,3,10,-7,7,0
324833,2,3,0,3,8,0
335273,2,0,3,-3,13,0
86060,1,0,0,0,5,1
115575,3,24,9,15,1,1
74539,3,0,3,-3,17,0
376840,3,21,13,8,15,0
159771,4,7,13,-6,3,1
322896,2,6,0,6,7,1
87100,2,7,0,7,5,0
254215,4,3,32,-29,11,1
190338,1,0,0,0,17,0
257278,4,26,26,0,12,0
248653,4,24,10,14,9,0
363753,4,26,27,-1,8,1
298943,2,3,9,-6,14,1
373718,3,13,18,-5,13,0
209002,1,3,0,3,8,0
158471,2,3,7,-4,3,0
244426,4,3,20,-17,7,0
225890,1,7,0,7,16,0
10613,2,0,10,-10,5,1
138993,3,14,9,5,12,0
332165,2,0,10,-10,12,1
318021,4,17,13,4,5,0
16813,3,13,24,-11,8,1
60840,3,17,16,1,11,0
227742,2,3,14,-11,16,1
54521,3,14,10,4,8,1
278698,4,24,10,14,4,1
243687,1,7,0,7,6,0
219276,1,7,0,7,13,1
340850,4,24,27,-3,15,1
252919,2,6,0,6,11,0
363838,3,13,17,-4,8,0
372032,3,13,3,10,13,0
134957,3,7,22,-15,10,0
311975,4,35,17,18,2,0
280379,1,3,0,3,5,1
46225,3,14,24,-10,4,0
369617,4,20,14,6,11,1
282785,2,0,10,-10,6,0
317766,1,0,0,0,5,1
233479,4,23,10,13,2,0
17117,3,23,10,13,9,0
404983,3,9,13,-4,10,0
73009,1,0,0,0,16,1
200533,1,6,0,6,4,1
86284,3,13,20,-7,5,0
277833,2,7,14,-7,4,1
193093,2,13,6,7,1,0
193445,4,23,20,3,1,0
225987,4,34,20,14,16,1
136420,2,10,7,3,11,0
243663,1,0,0,0,6,0
2281,3,10,10,0,1,1
207260,1,0,6,-6,7,0
151714,1,7,0,7,17,0
289978,4,6,9,-3,10,0
329793,3,17,20,-3,11,1
220270,3,20,9,11,13,0
282948,2,7,3,4,6,1
79951,4,13,23,-10,2,0
53758,4,10,3,7,8,0
64690,2,14,0,14,13,0
235651,1,0,3,-3,3,0
122530,1,7,0,7,4,1
250271,1,7,0,7,9,0
379393,1,0,0,0,16,1
114435,1,0,0,0,1,0
217935,4,39,28,11,12,0
256059,1,0,3,-3,12,0
408623,2,28,0,28,12,0
289653,4,13,20,-7,10,0
323015,1,7,0,7,7,0
289149,2,13,7,6,9,1
19260,1,7,14,-7,10,1
313875,2,21,19,2,3,0
31254,1,0,0,0,15,0
13260,1,0,12,-12,7,0
136153,3,10,10,0,10,1
160972,3,10,7,3,4,1
212476,3,10,3,7,10,0
268627,3,7,13,-6,17,1
34671,1,0,3,-3,16,1
347406,5,21,21,0,1,1
339129,3,10,6,4,15,1
295144,4,10,14,-4,12,0
66756,2,7,3,4,14,0
272239,3,6,3,3,2,1
247737,3,7,6,1,8,1
46254,4,24,31,-7,4,0
324674,1,0,7,-7,8,0
220577,4,10,23,-13,13,0
395533,3,21,14,7,6,0
405278,3,14,7,7,10,0
2937,1,7,7,0,2,0
166204,4,35,19,16,6,1
93349,4,27,6,21,9,1
414092,2,0,10,-10,14,1
350864,2,0,7,-7,3,1
364059,1,0,0,0,9,0
176250,4,14,27,-13,11,1
355587,3,24,3,21,5,0
359394,4,13,23,-10,6,1
199061,2,0,14,-14,4,1
305462,4,20,10,10,17,1
134522,4,3,36,-33,10,0
45517,4,27,26,1,4,0
273056,4,9,3,6,2,1
303627,3,28,13,15,16,1
196677,2,33,0,33,3,0
180646,3,24,6,18,13,0
93985,1,0,14,-14,9,1
132148,3,10,3,7,9,0
221990,1,0,0,0,14,1
375463,2,16,7,9,14,0
254838,1,0,0,0,12,0
153849,2,0,0,0,1,0
313680,1,7,0,7,3,0
60034,1,7,0,7,11,0
66820,4,13,6,7,14,1
362516,3,14,6,8,8,1
106930,3,12,3,9,14,1
245833,1,3,10,-7,7,1
360635,4,10,20,-10,7,1
210710,1,14,0,14,9,0
46638,3,3,0,3,4,1
373305,1,0,0,0,13,1
34632,4,24,10,14,16,1
393210,2,7,6,1,5,1
286928,4,23,13,10,8,0
153364,1,0,7,-7,1,1
260727,1,0,0,0,14,1
354250,4,20,17,3,4,1
125555,1,0,7,-7,5,1
126567,4,13,6,7,6,1
100452,1,0,7,-7,12,0
108968,2,16,14,2,15,0
307100,4,24,6,18,17,1
209399,3,14,10,4,8,0
262502,4,21,35,-14,15,0
365045,4,23,6,17,9,0
38582,4,38,13,25,1,0
257476,2,6,3,3,13,0
258808,2,7,7,0,13,1
195155,1,0,0,0,2,1
154620,3,21,14,7,1,0
320719,2,14,17,-3,6,1
333831,3,14,21,-7,12,0
67895,3,16,3,13,14,1
32364,2,14,6,8,15,1
165327,1,0,0,0,6,1
33197,1,7,0,7,16,1
376092,3,0,3,-3,14,0
400275,4,24,9,15,8,0
33669,2,21,0,21,16,1
301798,3,3,27,-24,15,0
252137,2,10,10,0,10,0
64711,2,21,0,21,13,0
12789,1,0,3,-3,6,1
357102,2,6,14,-8,5,1
371425,2,7,7,0,12,0
118136,3,23,20,3,2,0
229554,2,17,6,11,17,1
310143,2,14,7,7,2,1
414029,4,10,38,-28,14,0
49638,2,0,7,-7,6,1
201874,4,31,30,1,5,1
149893,4,6,16,-10,16,1
151593,2,0,3,-3,17,1
103183,2,0,0,0,13,1
300288,2,0,7,-7,14,1
47687,3,3,17,-14,5,1
169128,4,39,33,6,7,1
381206,2,7,10,-3,16,0
325129,2,10,7,3,8,0
27262,1,0,0,0,13,1
68124,4,6,10,-4,14,0
387543,2,3,3,0,2,0
215382,4,24,20,4,11,1
46524,4,40,6,34,4,0
391242,1,7,0,7,4,0
65799,4,27,33,-6,13,1
31018,2,3,6,-3,15,1
408497,3,10,10,0,12,0
364908,4,13,23,-10,9,1
413717,3,14,13,1,14,1
257743,4,3,24,-21,13,0
302122,4,34,34,0,15,0
15125,4,10,26,-16,7,1
79064,4,13,21,-8,2,1
390419,4,7,27,-20,3,1
150505,4,40,6,34,16,1
192506,3,14,17,-3,1,0
324593,3,16,9,7,8,1
274784,5,24,23,1,3,1
110829,4,6,13,-7,16,1
128859,4,20,16,4,7,0
380424,4,10,24,-14,16,1
406789,2,0,17,-17,11,1
372627,3,14,6,8,13,0
269544,3,13,31,-18,1,1
116446,3,6,10,-4,1,1
408107,1,0,0,0,12,0
70448,2,14,17,-3,15,1
63211,4,17,23,-6,12,1
378332,4,9,6,3,15,1
331310,3,0,24,-24,11,1
293881,1,0,7,-7,12,1
224097,1,0,0,0,15,0
137319,1,0,0,0,11,0
403636,3,24,20,4,9,1
344573,4,0,6,-6,17,1
112373,2,10,13,-3,17,1
128491,2,21,21,0,7,0
103170,1,0,0,0,13,1
163307,3,13,16,-3,5,1
17037,1,7,0,7,9,1
409858,3,23,0,23,12,0
301959,4,17,20,-3,15,1
61215,1,7,0,7,11,1
310230,4,24,10,14,2,1
108303,4,19,7,12,15,0
153840,1,0,0,0,1,0
182333,3,17,10,7,14,1
255296,1,0,0,0,12,1
83851,2,20,3,17,4,0
188783,4,0,20,-20,16,1
405586,3,14,17,-3,10,0
190561,4,17,20,-3,17,1
318907,4,24,22,2,5,0
362999,4,33,19,14,8,1
201027,3,27,0,27,5,0
31968,4,16,13,3,15,0
293325,1,0,0,0,11,0
287537,4,14,40,-26,9,1
410024,4,6,42,-36,12,0
362597,1,0,0,0,8,0
182030,3,14,14,0,13,1
421884,4,14,26,-12,17,1
218638,4,10,30,-20,13,0
334831,2,10,3,7,13,1
352683,2,14,3,11,3,1
115543,2,3,3,0,1,0
382180,1,0,0,0,17,1
420876,4,17,34,-17,17,1
64743,3,27,0,27,13,1
362017,1,0,0,0,8,1
25537,2,17,7,10,12,0
186451,2,10,10,0,15,0
51409,1,3,7,-4,7,0
310687,4,20,36,-16,2,0
64194,3,31,6,25,13,1
83352,2,0,14,-14,4,1
259947,3,20,13,7,14,0
115892,3,7,23,-16,1,0
418150,3,21,3,18,16,1
312055,2,14,7,7,2,0
306826,1,0,3,-3,17,0
302317,2,7,3,4,15,1
357421,3,24,17,7,5,0
178723,4,11,26,-15,12,0
47429,5,13,13,0,5,0
3681,1,0,0,0,2,0
354009,1,6,0,6,4,1
73877,1,0,0,0,17,0
396457,4,20,25,-5,6,0
104092,2,10,13,-3,13,1
59724,1,6,7,-1,11,1
43584,4,30,3,27,3,1
115732,3,13,13,0,1,0
172503,1,0,0,0,9,0
155233,3,21,7,14,1,1
15304,1,0,0,0,8,1
33294,4,23,3,20,16,0
391181,3,10,24,-14,4,0
41326,2,14,9,5,2,0
183464,4,27,6,21,14,1
82031,3,10,7,3,3,1
414717,3,3,17,-14,14,0
420162,3,0,3,-3,17,1
381045,2,7,6,1,16,1
331672,1,0,0,0,12,0
347820,4,10,0,10,1,1
237607,1,0,0,0,4,0
310183,3,21,10,11,2,1
222374,4,24,3,21,14,0
386649,2,7,13,-6,2,0
256402,2,9,7,2,12,0
342307,4,20,3,17,16,0
339997,2,14,6,8,15,0
306740,2,10,17,-7,17,0
160741,4,10,13,-3,4,0
211632,2,16,3,13,9,1
184242,3,24,0,24,14,0
190657,2,21,13,8,17,0
387721,3,0,16,-16,2,0
177930,1,0,0,0,12,0
63508,4,31,16,15,12,0
56044,4,24,23,1,9,0
23641,3,7,13,-6,12,0
154083,1,0,0,0,1,1
213279,4,17,27,-10,10,1
97402,3,9,23,-14,10,1
168075,4,6,24,-18,7,1
182478,2,14,0,14,14,0
320365,1,7,0,7,6,0
338187,2,7,14,-7,14,0
218548,1,0,7,-7,13,0
263725,1,0,0,0,15,0
110552,1,3,0,3,16,0
67880,2,13,3,10,14,0
229217,1,3,6,-3,17,0
269889,1,0,0,0,1,1
156971,3,7,13,-6,2,0
153454,4,20,17,3,1,0
80964,3,20,0,20,3,0
406954,2,3,13,-10,11,0
72961,4,31,7,24,16,0
179319,4,36,11,25,12,1
376300,1,0,0,0,14,1
143523,3,17,21,-4,14,1
335905,4,28,14,14,13,1
412048,2,21,0,21,13,0
236919,2,26,0,26,3,1
151203,3,10,20,-10,17,0
124299,3,34,20,14,5,1
386615,2,7,7,0,2,0
331010,3,36,7,29,11,1
297384,3,9,17,-8,13,0
183972,3,22,3,19,14,1
16678,4,14,27,-13,8,0
281444,2,0,10,-10,6,1
349126,2,7,0,7,2,0
136160,3,10,10,0,10,1
412569,4,31,24,7,14,0
419698,1,0,3,-3,17,1
196736,4,54,0,54,3,0
390943,1,7,0,7,4,1
76527,3,7,20,-13,1,0
253774,4,24,10,14,11,0
376959,2,3,16,-13,15,1
234881,4,3,19,-16,2,1
91167,2,3,14,-11,8,1
186354,4,29,23,6,15,0
166844,1,0,3,-3,6,1
257268,4,19,26,-7,12,0
238403,4,17,33,-16,4,0
105416,3,23,17,6,14,0
142579,2,0,3,-3,13,1
114674,3,3,10,-7,1,0
306811,4,26,36,-10,17,0
73467,1,0,14,-14,17,1
383473,1,0,0,0,17,0
264502,1,0,7,-7,16,1
410366,1,0,7,-7,13,1
319559,5,22,23,-1,6,0
234986,3,13,10,3,2,0
45193,4,7,10,-3,4,0
353129,3,10,29,-19,3,1
51158,2,17,3,14,7,1
93758,3,3,16,-13,9,1
116562,2,3,0,3,2,0
387892,3,10,28,-18,2,0
182024,3,14,14,0,13,1
231092,4,27,14,13,1,1
37312,1,7,0,7,17,1
302347,2,7,3,4,15,1
421756,4,31,17,14,17,0
255546,4,30,7,23,12,0
237689,3,20,14,6,4,0
418124,2,14,3,11,16,1
356054,3,24,10,14,5,0
394626,3,17,7,10,5,0
371876,2,21,10,11,12,1
393737,3,7,7,0,5,0
297775,1,7,0,7,13,0
101623,4,13,38,-25,12,1
42389,4,14,16,-2,2,0
65374,4,13,28,-15,13,0
252519,3,17,25,-8,10,0
392815,3,17,6,11,4,0
3374,4,10,13,-3,2,0
403200,3,17,17,0,9,1
105598,4,32,28,4,14,0
311201,2,3,0,3,2,1
340699,4,19,20,-1,15,1
263910,2,9,0,9,15,1
416799,3,13,10,3,15,0
175555,3,20,0,20,11,1
186052,3,31,40,-9,15,0
182077,4,17,24,-7,13,0
145874,1,0,0,0,15,1
2595,4,10,27,-17,2,1
123895,1,0,0,0,5,1
33574,4,17,10,7,16,1
141938,1,10,0,10,13,0
206871,3,3,17,-14,7,1
240300,2,7,7,0,5,0
225335,2,7,21,-14,15,1
61671,2,13,3,10,12,1
407945,4,17,24,-7,11,1
384704,2,13,23,-10,1,0
160882,4,34,27,7,4,0
90178,3,3,0,3,7,0
135263,4,16,10,6,10,1
123195,3,6,21,-15,4,1
299695,2,17,3,14,14,1
56226,2,3,7,-4,9,1
56370,1,0,0,0,9,1
355869,2,13,10,3,5,1
129020,4,42,13,29,7,1
99256,1,0,0,0,11,0
331641,4,23,30,-7,11,0
403404,1,0,0,0,9,1
361497,2,7,0,7,7,0
82001,2,7,0,7,3,0
392229,4,10,16,-6,4,1
24808,2,6,3,3,12,1
382125,3,27,3,24,17,0
239030,4,29,18,11,4,1
196289,4,21,10,11,2,0
268107,2,3,7,-4,17,0
263510,4,20,23,-3,15,0
50371,1,0,0,0,6,1
176512,3,12,17,-5,11,0
332257,1,0,0,0,12,0
86884,4,9,26,-17,5,1
307375,4,16,25,-9,17,1
190275,3,7,14,-7,17,0
353516,2,3,0,3,4,0
341409,4,0,13,-13,16,1
385707,1,0,0,0,1,0
5693,4,0,17,-17,3,0
311166,1,3,0,3,2,1
208289,1,0,14,-14,8,1
259091,1,0,0,0,13,0
304970,3,10,14,-4,16,0
67427,1,7,7,0,14,1
407405,2,7,7,0,11,1
144042,1,0,0,0,14,1
302315,1,7,3,4,15,1
21738,3,24,14,10,11,0
176481,2,0,10,-10,11,1
410851,2,14,6,8,13,1
354179,2,3,7,-4,4,1
206308,4,10,6,4,7,0
71693,1,3,0,3,16,0
141333,2,3,7,-4,13,0
417230,3,17,20,-3,16,1
41802,3,13,14,-1,2,0
362443,1,0,3,-3,8,1
166263,2,0,3,-3,6,1
383947,2,0,3,-3,1,0
387351,1,13,0,13,2,1
380185,2,7,9,-2,16,1
101437,4,18,7,11,12,0
133761,2,13,7,6,9,0
406678,3,21,0,21,11,0
137214,2,7,3,4,11,0
66164,1,10,0,10,13,1
4591,1,7,7,0,2,1
371,2,28,10,18,1,0
203981,3,10,7,3,6,1
352944,2,10,0,10,3,1
238426,4,17,36,-19,4,1
84923,4,41,17,24,4,1
50784,4,24,21,3,6,1
237529,3,24,7,17,3,0
364535,2,3,14,-11,9,1
150910,3,7,7,0,17,0
62674,4,24,20,4,12,1
405577,2,14,14,0,10,0
246900,1,7,7,0,8,0
6261,3,13,14,-1,3,0
229956,1,0,3,-3,17,1
314662,4,14,14,0,3,1
173860,1,6,7,-1,10,0
53017,4,27,24,3,7,0
234561,4,23,20,3,2,0
290557,4,20,20,0,10,1
344283,4,14,13,1,17,1
84633,4,23,13,10,4,0
17839,3,16,10,6,9,0
140547,1,7,0,7,12,0
385996,1,0,0,0,1,1
272632,1,0,0,0,2,0
280376,1,3,0,3,5,1
406257,3,21,27,-6,11,1
46335,3,6,17,-11,4,0
233061,1,0,0,0,2,1
193730,3,3,27,-24,1,1
132147,3,10,3,7,9,0
281331,3,14,13,1,6,1
61011,3,34,16,18,11,0
150931,3,13,7,6,17,0
76563,4,7,41,-34,1,0
138419,1,7,0,7,12,1
83912,4,23,23,0,4,0
354820,3,20,28,-8,4,1
24908,1,0,0,0,12,0
17527,2,13,0,13,9,1
417780,1,0,0,0,16,1
116202,4,22,19,3,1,1
398639,3,0,0,0,7,1
131897,4,31,7,24,8,1
84087,4,30,32,-2,4,0
325919,2,10,7,3,9,1
269513,2,13,10,3,1,0
209661,1,6,0,6,8,0
210718,2,14,0,14,9,1
48659,1,7,0,7,5,0
369044,4,20,13,7,11,0
298617,1,0,0,0,14,1
5960,3,17,23,-6,3,1
268201,4,12,25,-13,17,0
276833,3,20,20,0,4,0
409344,1,0,3,-3,12,1
177719,3,13,14,-1,12,0
295747,4,10,16,-6,12,1
223918,4,30,6,24,15,0
30166,3,10,17,-7,14,1
363336,1,0,0,0,8,0
134387,4,29,24,5,10,1
139049,1,0,0,0,12,0
209453,4,17,20,-3,8,0
355490,4,23,27,-4,4,1
116812,1,0,0,0,2,1
255590,1,0,0,0,12,1
87966,1,0,0,0,6,1
344864,4,30,10,20,17,0
48172,4,10,13,-3,5,0
182717,4,14,26,-12,14,1
117189,2,16,10,6,2,1
407217,1,0,3,-3,11,0
407064,1,0,3,-3,11,0
199381,3,7,10,-3,4,0
219623,2,10,0,10,13,0
249780,4,35,28,7,9,0
395029,2,0,14,-14,5,0
278461,2,22,0,22,4,0
228613,1,10,14,-4,17,0
122882,3,24,6,18,4,1
367711,3,3,13,-10,10,1
182104,1,3,0,3,13,0
295240,2,14,5,9,12,1
3851,1,13,0,13,2,0
43733,4,24,17,7,3,1
38674,3,7,7,0,1,1
48223,1,0,3,-3,5,0
29717,2,17,3,14,14,0
175579,3,27,7,20,11,1
133573,1,3,0,3,9,0
237271,4,23,0,23,3,1
90998,2,3,0,3,7,1
300988,1,3,0,3,15,0
317987,3,10,10,0,5,1
359675,4,40,7,33,6,1
116740,3,13,26,-13,2,0
174982,3,6,21,-15,10,0
351740,1,0,7,-7,3,1
31908,2,6,10,-4,15,0
339597,3,17,14,3,15,1
21268,2,3,7,-4,11,1
206612,4,10,13,-3,7,0
140272,2,7,6,1,12,1
379273,1,0,3,-3,16,0
334038,4,23,16,7,12,1
334612,4,38,31,7,13,0
16569,1,0,0,0,8,0
344698,3,6,20,-14,17,1
413374,1,0,14,-14,14,1
97587,4,44,7,37,10,0
25044,4,24,24,0,12,0
86916,4,23,29,-6,5,1
228166,2,7,17,-10,17,0
101666,1,3,0,3,12,0
29289,3,21,7,14,14,0
230420,2,14,0,14,1,0
388160,3,3,6,-3,2,1
349328,3,28,35,-7,2,0
314975,4,0,20,-20,4,1
140459,2,14,7,7,12,0
164564,1,0,0,0,5,1
106098,1,0,0,0,14,0
180979,4,24,28,-4,13,1
409529,2,7,3,4,12,0
133815,4,19,17,2,9,0
408029,2,9,7,2,12,1
397868,2,0,3,-3,7,1
23479,2,14,7,7,11,0
274787,5,24,23,1,3,1
210588,2,6,14,-8,9,1
17941,2,7,14,-7,9,1
61631,1,0,0,0,12,1
178999,4,19,3,16,12,0
396627,4,23,10,13,6,0
391127,2,7,17,-10,4,0
184089,2,9,7,2,14,0
85520,3,14,9,5,5,0
147718,3,17,10,7,15,0
328138,2,6,6,0,10,0
35560,1,7,0,7,17,1
338703,3,27,10,17,14,1
228563,4,20,20,0,17,0
227944,4,27,27,0,16,1
382238,2,10,3,7,17,1
297669,2,7,6,1,13,0
74060,2,3,0,3,17,0
140232,5,13,13,0,12,0
11558,4,6,10,-4,6,1
108246,3,6,0,6,15,1
253297,4,10,13,-3,11,1
226368,4,25,13,12,16,1
65113,1,0,0,0,13,1
117665,3,20,13,7,2,1
381363,2,13,0,13,16,0
19279,2,7,14,-7,10,0
172820,1,7,0,7,9,0
327440,4,3,20,-17,9,1
278339,3,14,14,0,4,1
337328,2,14,7,7,14,0
331461,3,9,7,2,11,0
58843,1,0,0,0,10,1
109684,1,3,0,3,16,0
276454,1,10,7,3,4,0
242326,3,10,13,-3,6,1
86159,3,31,10,21,5,0
368712,3,7,16,-9,11,0
50729,3,14,14,0,6,1
170205,1,0,0,0,8,0
306169,2,7,3,4,17,1
65510,4,23,14,9,13,1
274686,2,7,9,-2,3,1
14010,2,3,14,-11,7,1
23046,3,10,14,-4,11,0
293100,4,10,20,-10,11,0
371364,4,42,10,32,12,1
263670,4,27,10,17,15,0
257154,1,0,0,0,12,1
294158,1,0,7,-7,12,1
98912,3,7,17,-10,11,1
372828,4,6,0,6,13,0
48899,3,12,0,12,5,0
284036,3,9,3,6,7,1
85327,2,21,3,18,5,1
336054,4,16,28,-12,13,0
368976,2,7,7,0,11,1
96193,3,0,16,-16,10,1
359878,2,20,21,-1,6,0
105103,3,26,14,12,14,0
245146,3,17,22,-5,7,1
372458,3,9,14,-5,13,1
1262,3,17,13,4,1,0
349527,1,0,7,-7,2,1
69536,1,0,0,0,15,1
318829,2,7,6,1,5,1
399091,4,10,26,-16,7,0
6787,2,3,0,3,3,0
206957,1,7,0,7,7,1
326596,1,3,3,0,9,0
410504,4,18,26,-8,13,1
78894,3,17,7,10,2,1
348508,2,21,7,14,2,1
390063,2,7,7,0,3,1
277599,4,12,14,-2,4,0
320570,2,24,0,24,6,0
65856,1,6,7,-1,13,1
22027,3,14,17,-3,11,0
321450,3,14,20,-6,7,1
53274,3,3,7,-4,8,0
365983,2,20,7,13,10,0
114665,3,3,10,-7,1,0
48053,4,10,34,-24,5,0
83354,2,0,14,-14,4,1
203747,1,0,7,-7,6,1
213880,4,54,14,40,10,0
89739,4,16,23,-7,7,0
234683,3,30,20,10,2,0
213677,3,14,17,-3,10,1
63282,2,3,0,3,12,0
363177,4,24,10,14,8,0
4685,4,20,20,0,2,1
245159,3,17,25,-8,7,0
73923,2,14,0,14,17,1
413472,4,17,38,-21,14,0
218799,4,3,19,-16,13,0
379645,4,26,13,13,16,1
332608,3,20,6,14,12,1
386481,2,7,0,7,2,1
296007,2,3,0,3,13,0
36783,2,7,7,0,17,0
337952,3,20,0,20,14,0
89458,4,24,20,4,7,1
26908,3,10,6,4,13,1
388253,1,3,0,3,2,0
277723,2,7,3,4,4,1
117764,1,3,6,-3,2,0
327713,3,6,10,-4,10,0
263394,1,0,0,0,15,1
221791,4,13,21,-8,14,0
282195,1,3,0,3,6,0
21138,3,0,13,-13,10,1
34561,2,14,0,14,16,0
360483,4,17,0,17,7,0
390914,4,15,31,-16,3,1
238058,4,13,13,0,4,1
179081,2,3,6,-3,12,1
41906,2,14,3,11,2,0
244604,1,0,0,0,7,1
122353,4,13,19,-6,4,1
389185,2,14,0,14,3,1
218170,3,14,3,11,12,1
33897,1,0,3,-3,16,0
328237,5,17,17,0,10,1
71681,1,0,0,0,16,1
27898,2,0,0,0,13,0
84040,3,30,15,15,4,0
159865,2,17,0,17,3,1
412090,3,31,0,31,13,0
367065,4,10,41,-31,10,1
307906,1,0,0,0,1,0
313078,1,0,0,0,3,0
265863,1,0,6,-6,16,0
132219,1,7,0,7,9,0
253903,3,38,14,24,11,1
421589,4,16,9,7,17,1
413660,1,7,3,4,14,0
231518,4,23,29,-6,1,1
355349,1,0,0,0,4,1
148745,2,13,3,10,16,0
15238,3,16,7,9,8,1
231355,4,9,16,-7,1,0
278573,1,0,0,0,4,1
216557,4,37,11,26,12,0
368178,4,21,21,0,11,1
108258,3,6,7,-1,15,1
147934,4,31,38,-7,15,1
393914,4,20,20,0,5,1
7569,2,13,0,13,4,1
49224,3,17,3,14,6,0
61174,4,0,21,-21,11,1
1028,1,7,0,7,1,0
14422,2,14,3,11,7,1
116566,2,3,0,3,2,0
305847,2,0,14,-14,17,1
321348,4,29,22,7,6,0
402181,4,19,14,5,9,1
247031,4,20,34,-14,8,0
150366,4,30,7,23,16,0
78415,2,14,0,14,2,1
267840,3,26,14,12,17,0
348704,3,17,10,7,2,1
194011,2,14,7,7,1,1
25190,4,20,3,17,12,0
84116,1,7,0,7,4,0
348096,3,0,19,-19,1,1
299416,2,0,20,-20,14,1
137185,1,0,0,0,11,1
53680,2,0,0,0,8,0
120330,4,24,13,11,3,1
321372,1,0,0,0,7,0
71691,1,3,0,3,16,0
227537,1,0,0,0,16,1
80539,4,8,10,-2,3,0
130798,2,13,6,7,8,1
224892,2,0,6,-6,15,1
393668,1,0,0,0,5,1
421508,2,3,3,0,17,0
100361,3,9,20,-11,12,1
317761,1,0,0,0,5,1
85183,2,7,10,-3,4,1
376256,3,10,14,-4,14,1
169656,3,20,10,10,8,0
365775,3,17,17,0,9,0
126479,2,0,6,-6,6,1
280032,4,3,20,-17,5,1
90023,3,5,21,-16,7,0
128514,3,21,28,-7,7,0
218454,3,24,14,10,13,0
91391,4,21,14,7,8,1
355952,1,0,0,0,5,1
64301,2,6,10,-4,13,1
421231,2,6,7,-1,17,1
386930,2,7,21,-14,2,1
34101,2,0,0,0,16,0
162500,2,14,10,4,4,0
287197,3,10,20,-10,8,1
346638,2,14,3,11,1,0
54689,4,34,29,5,8,0
61416,3,13,3,10,11,1
116704,2,6,10,-4,2,1
239805,1,0,0,0,4,1
139045,1,0,0,0,12,1
236442,1,0,0,0,3,1
78590,3,16,13,3,2,1
287993,4,20,16,4,9,0
206886,3,10,17,-7,7,1
153422,3,13,16,-3,1,0
74734,4,14,17,-3,17,0
151748,2,7,6,1,17,1
159282,3,24,24,0,3,0
90511,4,0,26,-26,7,0
157353,1,3,0,3,2,0
311997,4,35,17,18,2,1
79422,2,6,7,-1,2,1
373894,4,37,16,21,13,0
262408,2,7,7,0,15,1
120014,4,23,38,-15,3,1
96018,3,13,7,6,10,0
355044,4,18,33,-15,4,1
362523,3,16,6,10,8,0
160952,2,10,7,3,4,1
31720,1,0,0,0,15,0
56169,4,27,21,6,9,1
272495,1,7,0,7,2,1
40819,4,24,35,-11,2,0
10905,1,6,7,-1,5,1
145086,4,27,13,14,14,1
243581,2,10,7,3,6,1
104624,3,7,3,4,14,1
166066,1,0,0,0,6,1
407114,2,7,20,-13,11,1
152992,4,35,17,18,1,1
339515,1,0,0,0,15,1
109757,4,13,0,13,16,1
200922,4,27,7,20,4,1
386747,1,0,0,0,2,0
332156,2,0,10,-10,12,0
383028,1,0,0,0,17,1
371178,2,11,19,-8,12,0
376171,1,7,0,7,14,1
341561,4,16,10,6,16,0
151411,1,0,0,0,17,0
134986,4,7,27,-20,10,1
189860,4,33,17,16,17,0
8818,4,26,0,26,4,0
276305,1,7,7,0,3,0
169705,4,20,17,3,8,1
150589,2,3,13,-10,17,0
29471,3,10,14,-4,14,0
421461,1,0,0,0,17,0
230620,4,16,24,-8,1,1
416342,3,16,3,13,15,1
76508,3,7,20,-13,1,0
76052,3,10,16,-6,1,1
37519,3,10,7,3,17,0
173155,2,10,14,-4,9,1
106262,1,0,3,-3,14,1
277089,2,10,14,-4,4,0
201298,2,14,3,11,5,1
396371,2,20,9,11,6,1
114748,1,0,0,0,1,0
13949,4,24,21,3,7,1
174651,2,6,0,6,10,0
387140,3,10,34,-24,2,0
165169,1,0,0,0,6,0
63437,2,14,10,4,12,0
274723,3,16,12,4,3,1
165920,1,0,7,-7,6,1
349205,4,27,14,13,2,0
303010,4,23,16,7,16,0
45392,1,0,0,0,4,1
152859,1,0,0,0,1,0
257606,5,19,23,-4,13,1
96576,2,3,3,0,10,1
395969,3,24,10,14,6,0
372751,2,0,0,0,13,1
115258,2,0,9,-9,1,1
142203,5,11,13,-2,13,1
97893,4,21,27,-6,11,1
29912,4,23,23,0,14,0
41732,1,0,0,0,2,0
204859,2,3,3,0,6,1
179234,2,23,3,20,12,0
7831,1,0,6,-6,4,0
337886,1,10,0,10,14,1
176374,3,16,28,-12,11,0
258000,3,0,28,-28,13,1
87494,1,0,0,0,6,1
394557,1,0,0,0,5,0
32043,2,7,10,-3,15,1
360710,1,3,7,-4,7,1
84429,2,6,7,-1,4,1
378164,3,21,16,5,15,0
83462,4,10,23,-13,4,1
379229,4,12,16,-4,16,1
69538,1,0,0,0,15,0
285095,3,3,0,3,7,0
140729,2,12,14,-2,12,1
67803,4,31,0,31,14,0
97159,1,0,0,0,10,0
262273,2,3,9,-6,15,0
381924,1,0,7,-7,17,0
5903,2,0,9,-9,3,1
290115,4,13,15,-2,10,1
150865,2,0,7,-7,17,0
221253,2,0,16,-16,14,0
159814,1,0,0,0,3,1
294003,1,0,0,0,12,0
65867,2,7,7,0,13,0
295143,4,10,14,-4,12,0
85699,4,24,21,3,5,0
258270,2,14,6,8,13,0
391368,1,0,3,-3,4,0
98723,2,21,3,18,11,0
338375,3,10,0,10,14,0
320887,3,3,14,-11,6,0
298699,3,13,14,-1,14,0
195373,2,10,3,7,2,1
147421,3,23,7,16,15,0
9259,1,6,0,6,5,1
61678,2,14,3,11,12,0
150267,1,7,0,7,16,1
192115,2,0,6,-6,1,1
263346,3,24,10,14,15,1
277148,4,10,24,-14,4,0
409140,4,3,17,-14,12,0
381199,2,7,3,4,16,0
162374,3,10,13,-3,4,0
290078,3,10,6,4,10,0
27575,1,7,0,7,13,0
66003,1,0,0,0,13,1
329588,1,10,0,10,11,0
351527,3,0,27,-27,3,1
384780,1,0,0,0,1,1
250663,3,3,22,-19,10,1
93854,2,14,0,14,9,0
93011,2,13,3,10,8,1
376919,1,0,3,-3,15,1
150674,1,0,0,0,17,0
140166,4,10,3,7,12,1
359852,1,17,14,3,6,1
327773,4,16,23,-7,10,0
319872,4,23,10,13,6,0
16512,3,20,13,7,8,0
1230,2,10,6,4,1,0
155576,3,23,9,14,2,0
329508,3,17,7,10,10,1
396328,1,0,0,0,6,1
136233,1,6,0,6,11,1
337331,2,14,7,7,14,0
150814,4,27,9,18,17,0
405765,3,10,14,-4,10,0
297509,2,11,0,11,13,0
266075,3,17,3,14,16,0
277159,4,17,27,-10,4,0
311432,1,0,3,-3,2,1
231269,1,0,3,-3,1,1
83697,3,22,20,2,4,1
268591,2,7,6,1,17,1
49993,3,28,10,18,6,0
144532,2,7,10,-3,14,0
209208,2,10,7,3,8,1
280969,1,0,3,-3,6,1
198827,4,6,23,-17,3,1
270234,2,3,21,-18,1,1
6097,3,7,10,-3,3,1
217270,2,0,7,-7,12,1
249371,2,10,12,-2,9,0
100734,1,0,0,0,12,0
94600,1,6,0,6,9,1
300022,2,0,20,-20,14,1
92264,2,10,0,10,8,1
138529,4,31,30,1,12,0
367685,2,0,3,-3,10,0
257290,4,26,32,-6,12,1
69900,4,27,16,11,15,0
417372,3,13,10,3,16,0
143083,3,10,17,-7,13,1
251444,1,0,0,0,10,0
371286,2,7,10,-3,12,1
47198,3,9,3,6,5,0
368514,2,3,0,3,11,1
186793,3,26,7,19,15,0
195500,2,0,0,0,2,1
298383,2,7,14,-7,14,0
179903,3,24,9,15,13,1
207,2,6,10,-4,1,1
250867,4,10,12,-2,10,0
218643,4,10,30,-20,13,0
149155,4,17,31,-14,16,0
119731,1,7,3,4,3,1
209918,4,37,16,21,8,0
76096,4,13,23,-10,1,0
391565,2,10,21,-11,4,0
54456,1,0,0,0,8,0
363600,4,10,15,-5,8,1
21522,1,7,0,7,11,0
175538,2,17,0,17,11,1
63783,3,14,24,-10,12,1
73560,4,9,41,-32,17,0
94116,1,3,0,3,9,1
33944,2,0,27,-27,16,1
239584,3,20,10,10,4,0
154066,4,24,21,3,1,1
167099,4,16,34,-18,7,1
381377,2,13,0,13,16,1
315871,4,9,19,-10,4,1
236628,1,3,0,3,3,1
199790,2,3,3,0,4,0
61194,1,0,0,0,11,0
125135,2,14,7,7,5,0
87668,2,0,14,-14,6,1
302253,3,37,13,24,15,1
7433,2,20,3,17,4,0
157902,3,6,15,-9,3,0
57098,4,21,27,-6,9,1
167608,1,7,0,7,7,0
124173,4,22,21,1,5,1
372092,1,0,0,0,13,1
166112,2,14,3,11,6,1
108958,2,16,7,9,15,0
419735,2,10,10,0,17,0
364985,2,14,6,8,9,0
6467,1,0,0,0,3,1
394799,4,24,6,18,5,1
44237,1,10,13,-3,3,1
6607,1,0,0,0,3,1
138426,2,7,0,7,12,1
33707,4,34,0,34,16,1
282953,2,7,3,4,6,1
167093,4,16,34,-18,7,0
361099,4,23,16,7,7,1
306373,4,37,10,27,17,1
148907,2,3,9,-6,16,1
188336,1,0,0,0,16,0
264386,2,3,14,-11,15,1
247567,3,13,16,-3,8,1
280600,3,17,9,8,5,1
229460,4,13,9,4,17,0
65243,1,0,0,0,13,0
21567,2,7,10,-3,11,0
227030,3,10,6,4,16,0
69162,4,14,17,-3,15,1
128157,1,7,0,7,7,0
161443,3,7,3,4,4,0
54255,4,0,3,-3,8,0
211480,2,19,7,12,9,1
173991,1,0,6,-6,10,1
369045,4,20,13,7,11,0
118592,4,31,10,21,2,0
102640,3,15,13,2,13,1
227507,4,19,17,2,16,0
339901,3,26,0,26,15,1
313033,3,20,0,20,3,0
118976,2,0,20,-20,3,1
353094,2,7,16,-9,3,0
285116,3,3,0,3,7,0
92894,3,27,0,27,8,1
18045,4,30,28,2,9,0
314566,1,0,0,0,3,1
60907,1,0,0,0,11,0
136757,3,13,10,3,11,1
241186,4,23,10,13,5,0
75344,4,21,33,-12,17,1
263645,3,20,10,10,15,0
68300,1,0,0,0,14,1
364444,3,35,21,14,9,1
84526,4,27,31,-4,4,1
379574,2,13,6,7,16,1
49508,2,7,3,4,6,0
380856,4,9,31,-22,16,1
157911,3,6,15,-9,3,1
411628,3,20,28,-8,13,0
330516,2,7,7,0,11,0
270794,1,0,0,0,1,1
325207,4,13,23,-10,8,0
124350,1,0,0,0,5,0
148597,2,0,6,-6,16,0
295684,2,0,9,-9,12,1
409146,4,3,17,-14,12,0
48930,4,15,13,2,5,0
416200,3,10,22,-12,15,0
167279,1,3,0,3,7,0
204662,4,17,48,-31,6,0
363313,4,33,14,19,8,1
312678,2,28,7,21,3,0
115946,1,0,0,0,1,0
412413,1,0,0,0,14,0
177924,1,0,0,0,12,1
320670,1,14,10,4,6,0
220033,4,24,35,-11,13,0
37843,4,14,9,5,1,1
146331,1,3,3,0,15,0
352627,1,0,0,0,3,1
100349,3,9,20,-11,12,1
410278,2,7,13,-6,13,1
88225,4,24,17,7,6,0
144512,1,0,7,-7,14,0
403142,2,7,7,0,9,1
375018,3,21,27,-6,14,0
139562,3,6,7,-1,12,1
187731,4,16,20,-4,16,1
23800,3,17,0,17,12,0
210278,2,6,0,6,9,0
215008,2,10,0,10,11,1
297180,1,0,0,0,13,0
215962,4,20,28,-8,11,0
305747,3,9,10,-1,17,0
295633,1,0,0,0,12,1
127650,3,24,12,12,6,1
154657,4,24,28,-4,1,1
159368,2,0,10,-10,3,1
155183,1,7,7,0,1,1
212982,4,21,7,14,10,1
168864,2,14,3,11,7,1
174168,2,0,6,-6,10,1
299732,3,17,6,11,14,1
319489,3,3,10,-7,6,1
200455,3,13,18,-5,4,1
225402,4,27,35,-8,15,0
130679,3,7,38,-31,8,0
294549,3,24,13,11,12,0
53847,1,0,0,0,8,0
322512,4,15,3,12,7,1
305580,3,19,7,12,17,1
85242,4,17,17,0,4,0
300530,4,23,17,6,14,0
225391,4,24,35,-11,15,1
61165,4,0,14,-14,11,0
302946,2,20,6,14,16,0
114278,1,0,0,0,1,1
416472,3,21,10,11,15,0
152819,4,21,10,11,17,0
165927,1,3,7,-4,6,0
167606,1,0,0,0,7,1
250433,1,6,0,6,9,1
146154,1,0,0,0,15,0
141195,2,3,21,-18,13,0
250769,2,3,0,3,10,1
126128,4,37,9,28,6,1
79958,4,13,23,-10,2,0
157379,2,3,7,-4,2,1
130964,3,10,24,-14,8,1
292595,2,6,16,-10,11,1
354841,4,30,28,2,4,1
169913,1,0,0,0,8,1
379435,2,13,0,13,16,0
317241,4,7,16,-9,5,0
240153,2,13,3,10,5,1
347244,1,0,0,0,1,1
222067,3,20,10,10,14,1
356322,2,17,0,17,5,0
354029,2,13,0,13,4,0
419704,2,0,3,-3,17,0
220670,2,10,0,10,13,1
192502,3,14,17,-3,1,1
52182,2,0,3,-3,7,1
136743,2,13,10,3,11,1
265292,1,0,0,0,16,0
388635,3,17,0,17,3,1
305818,2,0,7,-7,17,0
194696,1,0,0,0,2,1
28338,1,3,0,3,14,0
263696,4,30,13,17,15,1
244058,3,20,27,-7,6,1
350148,1,0,0,0,2,0
84374,1,0,0,0,4,0
61353,1,0,0,0,11,1
38671,3,7,7,0,1,1
350266,1,7,0,7,2,0
6489,2,0,0,0,3,1
380842,4,9,24,-15,16,0
146096,3,22,10,12,15,0
253584,3,6,10,-4,11,1
307885,1,0,0,0,1,1
387260,2,6,7,-1,2,0
343643,2,15,7,8,17,1
168201,4,29,15,14,7,0
100323,2,9,14,-5,12,1
318726,2,10,23,-13,5,0
279616,4,10,16,-6,5,0
381594,1,0,0,0,17,1
248048,4,31,13,18,8,1
200996,2,14,0,14,5,1
282715,4,9,27,-18,6,1
303611,3,28,13,15,16,0
270970,2,0,7,-7,1,0
388854,1,0,0,0,3,1
179284,3,33,3,30,12,1
360619,3,7,17,-10,7,0
201768,2,6,0,6,5,0
243418,2,3,17,-14,6,1
222486,2,6,14,-8,14,1
141674,2,23,14,9,13,0
371515,4,24,24,0,12,1
136982,4,17,19,-2,11,0
333463,1,3,0,3,12,0
125246,4,31,21,10,5,1
180807,4,10,20,-10,13,1
267105,3,10,9,1,17,0
315550,3,7,14,-7,4,0
181006,4,31,34,-3,13,1
362324,2,3,7,-4,8,0
398644,3,0,0,0,7,0
70832,1,7,0,7,15,1
219980,3,12,21,-9,13,1
200496,4,26,18,8,4,1
223649,2,6,3,3,15,0
256240,2,6,7,-1,12,1
228090,4,3,10,-7,17,0
213620,1,7,0,7,10,0
215878,1,3,7,-4,11,0
15240,3,16,7,9,8,1
308468,4,7,25,-18,1,1
120998,2,5,21,-16,3,1
289190,3,20,10,10,9,1
6246,3,13,7,6,3,1
186348,3,29,17,12,15,1
123395,4,21,27,-6,4,0
241309,4,13,7,6,5,0
354817,3,20,28,-8,4,1
98768,3,34,6,28,11,0
115168,4,13,27,-14,1,1
33732,4,35,7,28,16,1
408092,4,20,17,3,12,0
228605,1,10,14,-4,17,1
417031,2,10,0,10,15,0
231046,3,24,0,24,1,0
14995,1,0,7,-7,7,0
222519,3,17,14,3,14,0
360580,2,7,10,-3,7,0
244419,4,3,20,-17,7,0
156349,3,24,0,24,2,0
142885,2,0,0,0,13,0
234125,1,0,0,0,2,1
229902,4,20,14,6,17,1
241596,4,6,26,-20,5,0
142095,2,0,7,-7,13,1
112863,2,7,3,4,17,1
352144,4,9,20,-11,3,0
82796,3,9,9,0,3,0
195745,1,0,0,0,2,0
248767,3,27,14,13,9,1
41907,2,14,3,11,2,0
201633,2,10,10,0,5,0
276356,3,17,28,-11,3,0
194809,4,10,23,-13,2,0
131975,2,0,10,-10,8,0
281859,4,13,7,6,6,1
211666,2,23,3,20,9,0
206294,3,10,6,4,7,0
167046,3,13,17,-4,7,1
155954,1,0,7,-7,2,1
36521,3,10,20,-10,17,1
52048,3,10,10,0,7,1
157833,1,6,9,-3,3,1
391474,4,10,30,-20,4,1
160064,4,20,26,-6,3,1
249368,2,10,12,-2,9,0
286616,4,17,38,-21,8,0
176396,4,19,28,-9,11,1
63667,4,26,36,-10,12,1
124447,3,9,7,2,5,0
231376,4,9,16,-7,1,0
301941,3,14,20,-6,15,1
79584,2,14,0,14,2,0
289736,2,0,10,-10,10,1
317988,3,10,10,0,5,1
139345,1,0,0,0,12,0
412775,2,14,10,4,14,0
357032,1,0,0,0,5,1
305150,4,21,10,11,16,1
345435,3,0,19,-19,17,1
148611,3,7,9,-2,16,1
419463,2,10,6,4,16,0
90054,4,18,21,-3,7,0
63322,3,17,3,14,12,1
237315,1,0,0,0,3,1
360405,1,0,0,0,7,1
232199,3,9,9,0,1,0
327718,3,6,13,-7,10,0
248552,5,26,26,0,8,1
229703,2,13,7,6,17,0
59771,2,9,10,-1,11,0
184537,3,27,14,13,14,1
324734,3,16,7,9,8,1
421157,4,44,16,28,17,0
218376,1,0,0,0,13,1
86584,3,30,3,27,5,1
98779,4,34,8,26,11,0
141334,2,3,7,-4,13,0
254186,4,3,18,-15,11,0
281432,1,0,10,-10,6,0
365331,4,17,19,-2,9,0
107549,4,10,23,-13,15,0
931,2,0,0,0,1,1
385246,2,0,3,-3,1,1
268089,1,0,7,-7,17,1
19585,3,14,21,-7,10,0
201522,3,32,7,25,5,0
334007,3,17,13,4,12,1
239600,3,20,10,10,4,1
375373,4,14,24,-10,14,1
7331,5,20,19,1,4,1
331012,3,39,7,32,11,1
299055,1,0,0,0,14,0
131724,4,24,22,2,8,0
274959,1,0,0,0,3,1
42889,1,7,3,4,3,1
317476,2,10,10,0,5,0
184622,2,10,3,7,15,0
248844,4,37,29,8,9,0
128595,1,0,0,0,7,1
288678,2,0,7,-7,9,1
202313,3,13,3,10,5,0
103733,4,3,23,-20,13,1
288046,1,0,0,0,9,1
236744,1,0,0,0,3,0
63422,1,14,3,11,12,0
37409,4,24,0,24,17,0
223746,4,40,13,27,15,0
308500,1,0,6,-6,1,1
314268,5,24,23,1,3,0
278814,3,7,21,-14,5,1
111699,3,31,13,18,16,0
141793,1,7,7,0,13,1
94886,4,13,13,0,9,0
162394,4,10,20,-10,4,1
166139,2,14,12,2,6,1
171923,2,7,7,0,9,1
118939,1,0,10,-10,3,1
412186,2,14,3,11,13,0
162348,2,9,10,-1,4,1
253099,3,21,7,14,11,1
360616,3,7,16,-9,7,0
14495,3,27,16,11,7,0
28714,4,10,13,-3,14,1
63099,1,7,0,7,12,0
38306,1,0,0,0,1,1
32383,3,14,6,8,15,1
52021,2,3,10,-7,7,1
347656,3,17,17,0,1,1
224863,1,0,0,0,15,0
210785,4,24,10,14,9,1
118942,1,0,10,-10,3,1
150874,2,0,7,-7,17,0
249813,1,6,3,3,9,0
134262,4,10,23,-13,10,0
204610,3,0,38,-38,6,1
393133,4,24,3,21,4,0
16371,3,21,10,11,8,1
23198,3,23,12,11,11,0
392770,2,14,3,11,4,1
220719,3,13,6,7,13,1
337898,2,10,0,10,14,0
173558,1,0,7,-7,10,1
137906,3,24,8,16,11,0
166687,1,0,0,0,6,1
196843,3,3,13,-10,3,0
37568,4,13,17,-4,17,1
242677,4,16,10,6,6,1
32853,3,6,7,-1,15,0
176047,3,24,0,24,11,0
93766,3,3,16,-13,9,1
415036,4,10,27,-17,15,0
384693,2,10,20,-10,1,1
198987,4,19,23,-4,3,0
314608,2,7,0,7,3,0
410895,3,14,12,2,13,0
399890,2,0,3,-3,8,0
285017,1,0,0,0,7,1
46786,3,14,27,-13,4,1
186796,3,26,7,19,15,1
333055,3,10,12,-2,12,1
71211,4,19,20,-1,16,0
71303,2,7,13,-6,16,1
404119,1,6,0,6,10,1
52482,2,3,0,3,7,1
2872,4,31,31,0,2,0
56486,4,7,41,-34,9,0
299481,4,10,23,-13,14,1
150520,4,41,13,28,16,1
53792,5,10,10,0,8,1
220109,2,19,6,13,13,1
278175,3,24,14,10,4,1
45103,1,0,0,0,4,0
340364,3,17,13,4,15,0
125507,4,30,7,23,5,0
21573,2,7,17,-10,11,1
267284,3,17,17,0,17,1
44557,2,0,14,-14,3,1
116773,4,16,26,-10,2,1
273808,3,10,7,3,2,0
267286,3,17,17,0,17,1
176722,4,36,19,17,11,0
246796,3,3,13,-10,8,0
298942,2,3,9,-6,14,1
232487,2,10,3,7,1,1
417447,1,3,7,-4,16,0
170420,2,21,3,18,8,0
229946,1,0,0,0,17,0
398329,2,3,10,-7,7,0
323462,1,0,3,-3,7,0
17863,3,24,17,7,9,0
177531,1,7,0,7,11,0
199114,3,14,24,-10,4,0
157378,2,3,7,-4,2,1
143110,4,24,24,0,13,0
419625,3,23,16,7,17,0
189004,2,7,7,0,16,0
169782,2,0,14,-14,8,1
235659,1,0,3,-3,3,1
380593,4,21,27,-6,16,1
135754,1,0,0,0,10,1
354295,1,7,0,7,4,0
112915,4,16,6,10,17,0
66282,1,0,0,0,14,0
416894,2,3,7,-4,15,0
339857,2,16,0,16,15,1
46437,1,6,0,6,4,1
379177,3,9,10,-1,16,1
171455,2,7,3,4,9,1
235000,3,16,17,-1,2,0
46804,4,14,33,-19,4,1
115098,2,3,13,-10,1,0
325149,2,13,7,6,8,1
269915,1,7,0,7,1,0
62387,1,0,7,-7,12,0
213592,4,29,14,15,10,0
334856,3,16,3,13,13,1
71176,3,19,10,9,16,1
354438,1,7,7,0,4,0
379343,3,10,16,-6,16,1
18525,1,0,0,0,9,1
372194,3,9,16,-7,13,1
109538,2,0,7,-7,16,0
24583,4,10,23,-13,12,1
232760,2,0,0,0,2,1
98351,4,49,35,14,11,0
76774,2,24,0,24,1,0
399742,2,0,10,-10,8,0
21920,4,35,9,26,11,0
209807,1,6,7,-1,8,1
76213,3,12,20,-8,1,0
416058,3,21,3,18,15,0
306484,3,10,17,-7,17,1
3083,1,0,0,0,2,0
96599,2,3,3,0,10,0
246264,4,24,16,8,7,0
325043,3,23,24,-1,8,1
160808,2,17,10,7,4,1
132376,1,0,0,0,9,0
331469,3,9,15,-6,11,1
163648,4,21,29,-8,5,0
375858,4,20,14,6,14,1
63800,4,14,31,-17,12,0
223098,3,31,14,17,14,1
350791,4,17,9,8,2,0
61257,2,21,14,7,11,1
140727,2,12,14,-2,12,1
344012,4,23,6,17,17,1
245880,2,3,30,-27,7,1
366816,2,0,3,-3,10,1
276956,3,17,20,-3,4,0
125828,4,17,23,-6,5,1
169954,2,7,7,0,8,0
86441,3,27,14,13,5,1
355665,1,0,0,0,5,0
238007,3,10,13,-3,4,0
256413,2,9,14,-5,12,1
391755,4,10,10,0,4,0
168358,4,24,24,0,7,0
352096,2,3,13,-10,3,0
5919,2,0,16,-16,3,1
192662,3,13,7,6,1,0
367787,1,3,0,3,10,0
179632,4,31,30,1,12,1
149623,1,0,0,0,16,1
324980,2,13,14,-1,8,0
1957,2,10,2,8,1,1
379641,4,26,13,13,16,0
189476,3,14,0,14,17,0
134747,2,10,3,7,10,1
97913,1,0,0,0,11,0
367442,3,20,21,-1,10,1
332786,4,28,9,19,12,1
285482,4,36,8,28,8,0
345444,3,3,19,-16,17,0
3664,4,20,28,-8,2,0
338622,1,3,0,3,14,1
222952,3,13,13,0,14,0
97406,3,9,23,-14,10,1
135185,1,10,0,10,10,0
94416,4,17,24,-7,9,1
89397,3,10,20,-10,7,0
310182,3,21,10,11,2,1
379301,2,0,6,-6,16,1
322803,3,3,27,-24,7,0
277992,2,3,7,-4,4,0
315259,4,20,16,4,4,1
280937,4,21,10,11,6,0
397230,4,16,0,16,6,0
221520,1,6,2,4,14,0
299223,1,3,0,3,14,1
324311,4,25,7,18,8,0
325814,3,6,10,-4,9,0
406725,4,34,7,27,11,1
320067,1,3,0,3,6,0
20025,3,19,6,13,10,1
197987,2,0,17,-17,3,0
261205,2,21,0,21,14,0
343784,2,7,3,4,17,1
209504,2,20,3,17,8,0
103626,2,0,7,-7,13,1
122407,2,0,17,-17,4,0
72139,1,0,3,-3,16,0
61443,4,16,17,-1,11,1
106906,2,9,3,6,14,1
67070,4,10,9,1,14,0
191350,1,0,14,-14,17,0
412693,4,30,10,20,14,1
124922,4,11,16,-5,5,0
17835,2,13,10,3,9,1
158080,3,22,9,13,3,1
231503,4,23,20,3,1,1
315705,4,10,16,-6,4,1
256403,2,9,7,2,12,0
144427,3,3,13,-10,14,0
317421,4,7,17,-10,5,1
249019,1,7,3,4,9,0
258515,1,0,0,0,13,1
66353,3,14,21,-7,14,0
95921,5,23,23,0,10,0
333008,2,3,3,0,12,0
236071,4,44,10,34,3,0
316339,4,24,26,-2,4,0
266058,2,10,3,7,16,1
382077,2,7,3,4,17,1
103136,4,34,7,27,13,1
333586,4,24,23,1,12,1
379623,3,25,13,12,16,1
416102,4,21,13,8,15,0
167287,1,3,0,3,7,0
363909,1,0,0,0,8,1
134344,3,16,21,-5,10,1
280422,3,9,16,-7,5,0
82110,1,0,0,0,3,0
249083,3,21,17,4,9,0
11961,2,7,0,7,6,1
84628,3,20,13,7,4,1
192387,1,0,0,0,1,1
173306,2,14,17,-3,10,0
223809,2,6,0,6,15,1
355051,1,0,6,-6,4,1
316099,2,17,13,4,4,1
163162,3,22,25,-3,5,0
92047,4,30,26,4,8,1
165431,4,6,36,-30,6,1
119038,4,7,33,-26,3,0
209506,2,20,3,17,8,0
313324,3,6,24,-18,3,1
31415,1,0,0,0,15,1
22519,4,31,37,-6,11,0
382239,2,16,3,13,17,1
204836,1,3,0,3,6,0
319570,5,22,23,-1,6,0
343572,1,12,0,12,17,0
404811,3,20,20,0,10,0
360780,3,24,24,0,7,1
411016,2,14,14,0,13,1
368848,2,24,0,24,11,0
370217,4,31,10,21,12,0
25900,4,31,17,14,12,1
289026,3,19,21,-2,9,1
112772,4,19,10,9,17,1
48400,2,3,17,-14,5,1
176460,1,0,10,-10,11,0
345662,1,7,0,7,17,0
291744,3,3,14,-11,11,0
395953,2,24,10,14,6,1
20694,3,17,17,0,10,0
369819,1,0,0,0,12,0
48467,4,20,27,-7,5,1
411658,4,34,28,6,13,0
240799,3,23,10,13,5,1
141724,4,30,21,9,13,0
229753,4,20,17,3,17,0
275862,1,10,0,10,3,0
282419,4,10,26,-16,6,1
15319,2,7,3,4,8,1
104443,2,0,10,-10,13,1
132055,4,3,24,-21,8,1
84383,1,3,0,3,4,1
77608,1,0,7,-7,1,0
122968,2,0,0,0,4,0
412430,1,0,7,-7,14,1
357809,2,3,14,-11,6,0
256944,4,26,21,5,12,0
130483,2,3,3,0,8,1
362538,3,23,12,11,8,1
21333,4,6,17,-11,11,1
138286,1,10,0,10,11,1
87220,1,6,0,6,6,1
40342,3,6,7,-1,2,1
89449,4,24,20,4,7,0
310481,3,20,9,11,2,0
148936,2,3,9,-6,16,0
94705,4,30,43,-13,9,1
419345,3,3,17,-14,16,1
113414,2,0,7,-7,17,0
376604,4,15,6,9,14,1
398632,3,0,0,0,7,0
63411,1,6,3,3,12,1
139374,1,14,0,14,12,1
293900,2,6,14,-8,12,1
254358,4,13,27,-14,11,0
319464,2,0,10,-10,6,0
163815,4,17,19,-2,5,0
342165,4,15,19,-4,16,1
169196,2,10,6,4,7,0
275883,2,10,6,4,3,1
157627,4,22,3,19,2,0
193449,4,23,20,3,1,1
263849,4,14,24,-10,15,0
304089,3,6,23,-17,16,1
344455,4,28,24,4,17,1
39765,4,9,7,2,1,0
258751,4,3,34,-31,13,1
269744,1,7,0,7,1,0
26060,1,0,0,0,13,1
407678,1,0,0,0,11,1
419595,2,20,10,10,17,1
45683,1,0,0,0,4,0
23989,4,26,6,20,12,1
409723,3,10,6,4,12,0
37337,2,14,0,14,17,0
281273,1,7,3,4,6,0
200304,3,24,14,10,4,1
265545,4,17,13,4,16,0
100449,1,0,7,-7,12,0
130275,4,9,29,-20,8,0
236723,4,30,7,23,3,0
209765,4,16,6,10,8,0
317456,1,3,3,0,5,1
389804,3,17,6,11,3,0
62697,1,0,0,0,12,1
275210,4,17,22,-5,3,1
361880,1,0,0,0,7,1
217242,1,0,0,0,12,0
361398,4,17,14,3,7,1
19083,4,10,6,4,10,0
167802,1,0,6,-6,7,1
253764,4,24,10,14,11,0
416941,3,10,7,3,15,1
49316,2,7,3,4,6,0
241789,1,0,0,0,5,0
24403,3,13,7,6,12,1
311694,4,6,9,-3,2,1
68560,4,13,28,-15,14,0
22820,4,13,21,-8,11,0
930,2,0,0,0,1,1
232368,3,13,15,-2,1,1
164463,2,14,0,14,5,1
342336,4,23,13,10,16,1
81271,3,10,7,3,3,0
118482,1,0,0,0,2,1
40323,3,6,7,-1,2,1
97746,1,0,0,0,11,1
210901,3,12,3,9,9,1
212554,1,0,3,-3,10,1
12353,1,0,0,0,6,0
61464,4,24,17,7,11,0
291020,4,20,13,7,10,0
256497,4,19,31,-12,12,0
56196,1,0,0,0,9,1
116909,3,13,10,3,2,1
357842,2,6,24,-18,6,1
350449,2,0,6,-6,2,0
6170,4,7,27,-20,3,0
307912,1,0,0,0,1,1
189000,2,7,7,0,16,1
180437,2,7,7,0,13,1
83491,1,0,0,0,4,0
148237,4,18,31,-13,16,0
232439,1,3,0,3,1,0
2657,2,3,0,3,2,1
171195,3,3,7,-4,8,1
130171,2,0,16,-16,8,0
382848,3,28,3,25,17,0
112801,4,34,10,24,17,0
250564,4,19,22,-3,9,1
3812,4,23,10,13,2,0
109059,4,23,41,-18,15,0
371118,1,0,6,-6,12,0
403523,4,24,19,5,9,1
332967,4,31,3,28,12,0
192903,1,7,7,0,1,0
324695,2,7,7,0,8,0
140115,2,7,0,7,12,1
5373,2,13,7,6,3,1
273629,2,10,6,4,2,1
242265,1,0,7,-7,6,1
252689,4,6,10,-4,10,1
256613,3,21,0,21,12,0
135170,1,7,0,7,10,0
290634,2,21,6,15,10,0
362561,4,26,12,14,8,1
177190,1,0,0,0,11,1
21173,4,0,16,-16,10,0
354772,2,13,17,-4,4,0
233468,3,23,10,13,2,0
181960,1,6,0,6,13,1
310941,3,3,16,-13,2,0
42527,3,10,21,-11,3,0
180650,3,24,6,18,13,0
140735,2,15,14,1,12,1
345740,3,13,7,6,17,1
28904,4,30,10,20,14,1
360647,4,10,27,-17,7,1
162553,4,35,17,18,4,1
5837,4,27,7,20,3,1
396893,3,27,19,8,6,0
294815,2,28,14,14,12,0
351633,2,0,7,-7,3,0
323954,2,10,10,0,8,1
270744,4,6,3,3,1,0
285131,4,3,0,3,7,0
272268,3,9,3,6,2,0
399841,4,17,27,-10,8,1
141641,2,17,7,10,13,0
44840,2,0,7,-7,4,0
294071,3,7,21,-14,12,1
211076,3,30,0,30,9,0
258363,1,7,0,7,13,0
313333,4,13,27,-14,3,0
184767,2,17,7,10,15,0
181913,4,21,35,-14,13,1
116381,1,0,0,0,1,0
331650,4,31,33,-2,11,0
162399,4,13,20,-7,4,0
169108,4,39,30,9,7,0
194527,4,29,10,19,2,0
289930,3,6,3,3,10,0
69857,3,21,9,12,15,0
46644,3,10,0,10,4,0
25612,4,30,10,20,12,1
132655,1,0,3,-3,9,0
1863,4,19,10,9,1,1
71062,3,27,0,27,16,1
370647,4,21,14,7,12,0
329047,2,3,7,-4,10,1
202786,4,19,17,2,5,1
318670,1,0,6,-6,5,0
377473,4,14,13,1,15,1
38662,2,0,0,0,1,1
393907,4,20,20,0,5,0
204996,2,9,7,2,6,0
260688,4,10,25,-15,14,1
369651,1,6,0,6,11,1
204554,1,0,21,-21,6,0
337566,1,0,0,0,14,0
159205,2,7,14,-7,3,1
231167,3,10,7,3,1,0
259632,3,6,6,0,13,1
255151,1,0,0,0,12,0
418309,3,6,20,-14,16,0
49288,1,0,0,0,6,0
13280,2,0,20,-20,7,1
199562,3,26,10,16,4,1
117547,4,17,20,-3,2,1
135611,1,7,0,7,10,0
320514,1,0,0,0,6,1
39680,2,3,0,3,1,1
221940,4,19,19,0,14,1
158365,3,16,17,-1,3,0
380926,2,6,0,6,16,0
266597,1,0,0,0,16,0
36485,2,3,6,-3,17,1
16307,1,0,0,0,8,0
324637,4,19,15,4,8,0
194050,3,27,7,20,1,0
36053,2,17,0,17,17,0
34762,4,20,3,17,16,1
395037,2,0,17,-17,5,1
104607,2,7,3,4,14,0
201701,4,24,20,4,5,1
95881,4,13,23,-10,10,0
136787,4,13,10,3,11,0
107707,1,0,0,0,15,1
207733,2,17,13,4,7,1
21800,1,0,0,0,11,0
23402,4,20,24,-4,11,1
122853,2,10,3,7,4,0
31809,3,16,17,-1,15,0
67923,3,19,3,16,14,1
250815,3,3,9,-6,10,1
31203,3,23,27,-4,15,0
113115,1,14,0,14,17,0
408167,2,6,0,6,12,1
315378,3,16,17,-1,4,1
191392,3,0,31,-31,17,0
225368,3,17,21,-4,15,0
135683,3,14,10,4,10,0
401427,3,17,10,7,8,1
89252,3,6,0,6,7,1
134723,1,9,0,9,10,1
243920,3,19,6,13,6,0
146517,2,7,7,0,15,0
119656,4,17,12,5,3,1
68233,3,20,14,6,14,0
150490,3,34,6,28,16,0
158901,1,14,0,14,3,1
317706,4,23,16,7,5,0
42894,2,7,3,4,3,0
139117,2,9,6,3,12,0
335669,1,7,0,7,13,1
491,2,7,6,1,1,1
246261,4,24,16,8,7,0
340908,2,0,10,-10,15,0
147089,2,7,24,-17,15,1
182856,4,36,20,16,14,0
230095,1,0,3,-3,17,0
393278,4,24,26,-2,5,0
264842,4,24,37,-13,16,0
218928,4,41,24,17,13,1
36270,4,24,27,-3,17,0
362368,3,23,14,9,8,0
163898,2,16,10,6,5,1
159452,4,20,23,-3,3,0
396553,2,17,7,10,6,0
287723,1,0,0,0,9,1
72118,4,17,17,0,16,0
158918,2,14,9,5,3,1
103807,2,9,0,9,13,1
287265,5,23,23,0,8,1
254502,4,29,13,16,11,1
331424,2,6,7,-1,11,1
410641,4,17,31,-14,13,1
8990,1,0,0,0,4,0
152766,2,7,7,0,17,0
374640,1,0,0,0,14,1
324807,1,0,0,0,8,1
47,2,0,0,0,1,1
362928,2,14,0,14,8,0
119092,2,7,7,0,3,1
374361,1,0,0,0,14,1
252576,1,0,0,0,10,0
275464,3,20,17,3,3,1
377546,2,7,9,-2,15,1
314123,4,33,27,6,3,1
135414,4,28,23,5,10,0
275858,1,3,0,3,3,1
137767,4,10,37,-27,11,1
390300,4,17,20,-3,3,0
136203,4,13,10,3,10,0
358326,4,0,27,-27,6,1
239891,3,13,3,10,4,0
168302,3,10,14,-4,7,0
195762,1,3,0,3,2,0
63962,4,6,27,-21,12,0
273356,3,35,0,35,2,0
419331,3,0,17,-17,16,1
218381,1,0,0,0,13,0
184910,2,0,7,-7,15,0
112816,1,0,0,0,17,1
79330,3,15,3,12,2,1
201915,1,0,0,0,5,1
318016,4,17,13,4,5,0
178337,2,14,10,4,12,1
74530,3,0,3,-3,17,0
406781,2,0,10,-10,11,0
215630,3,14,6,8,11,0
258173,4,13,13,0,13,1
298973,3,9,9,0,14,1
371222,4,14,19,-5,12,1
327299,4,16,20,-4,9,1
80229,3,21,31,-10,2,1
275182,3,14,16,-2,3,1
378072,4,0,17,-17,15,1
248357,4,29,10,19,8,0
86138,3,28,3,25,5,0
190826,3,16,3,13,17,1
100940,2,10,3,7,12,1
394318,3,17,10,7,5,1
183454,4,27,6,21,14,1
290382,3,23,10,13,10,0
66191,2,24,3,21,13,0
62831,1,3,0,3,12,0
175975,1,7,0,7,11,0
288605,4,23,41,-18,9,1
2605,4,10,27,-17,2,1
244884,4,7,10,-3,7,1
174106,4,8,36,-28,10,1
152026,2,0,0,0,17,0
66168,2,17,0,17,13,0
200961,1,7,0,7,5,0
123593,1,0,0,0,4,0
12920,5,13,13,0,6,1
246856,5,20,20,0,8,0
204487,4,10,24,-14,6,1
177688,2,10,14,-4,12,1
323096,3,26,14,12,7,1
42867,1,0,0,0,3,0
289798,4,17,10,7,10,0
61337,1,0,0,0,11,1
345258,3,13,14,-1,17,0
132897,4,6,21,-15,9,0
407089,2,0,13,-13,11,0
330414,3,13,20,-7,11,1
76874,1,0,0,0,1,0
153524,2,2,7,-5,1,1
417276,4,20,23,-3,16,1
21213,1,0,0,0,11,1
81887,3,0,27,-27,3,0
48684,2,7,10,-3,5,1
208761,2,3,6,-3,8,0
227904,3,20,6,14,16,0
93619,3,13,6,7,9,0
111054,2,10,0,10,16,0
244161,1,0,7,-7,6,1
391833,2,10,3,7,4,1
370017,3,10,7,3,12,0
5783,2,21,7,14,3,0
176510,2,9,17,-8,11,1
41888,2,13,3,10,2,1
200637,3,27,28,-1,4,1
43192,2,7,7,0,3,1
212402,1,0,0,0,10,1
370958,1,0,0,0,12,1
189146,1,14,0,14,16,1
105933,1,7,0,7,14,0
213763,1,0,0,0,10,1
378660,5,23,23,0,15,1
21245,2,3,0,3,11,0
328124,2,6,0,6,10,0
288777,4,9,13,-4,9,1
253255,3,3,7,-4,11,0
86810,2,6,6,0,5,1
400489,1,0,3,-3,8,1
45225,4,14,10,4,4,1
392910,1,0,3,-3,4,1
416914,2,3,7,-4,15,0
278570,1,0,0,0,4,1
224404,1,0,0,0,15,0
138541,4,31,37,-6,12,0
84845,1,13,3,10,4,1
120313,4,24,13,11,3,0
100464,2,7,7,0,12,0
55020,1,0,0,0,8,1
101323,1,0,0,0,12,1
405272,2,14,7,7,10,0
186856,4,29,20,9,15,0
365917,4,14,21,-7,9,0
24731,4,20,14,6,12,0
33580,4,17,10,7,16,0
123506,2,7,0,7,4,0
357168,4,12,14,-2,5,1
389199,2,21,7,14,3,1
352496,1,6,0,6,3,1
3165,3,13,9,4,2,0
303864,1,0,7,-7,16,1
142182,4,2,10,-8,13,0
251683,2,6,3,3,10,1
88120,1,0,0,0,6,0
203662,3,13,20,-7,6,1
210050,4,16,17,-1,8,1
18778,4,13,13,0,9,1
358511,1,0,0,0,6,0
194460,3,9,0,9,2,0
381984,3,0,23,-23,17,0
114293,1,0,6,-6,1,1
284110,1,0,3,-3,7,1
3573,2,14,7,7,2,0
381168,1,0,0,0,16,1
8825,4,32,0,32,4,0
78680,1,10,0,10,2,0
371272,1,0,10,-10,12,1
205672,3,17,12,5,7,0
154076,1,0,0,0,1,0
108951,2,16,7,9,15,0
392691,4,16,0,16,4,1
134794,3,41,17,24,10,0
396269,3,3,3,0,6,0
256900,2,14,18,-4,12,1
28715,4,10,13,-3,14,1
158905,1,14,0,14,3,0
296826,4,14,7,7,13,0
238240,4,3,16,-13,4,1
323192,2,7,0,7,7,0
74337,1,0,3,-3,17,1
257700,3,3,10,-7,13,0
35885,2,0,0,0,17,1
101660,1,3,0,3,12,0
123996,4,13,7,6,5,0
68651,2,7,0,7,15,1
63597,2,13,20,-7,12,1
159238,2,17,24,-7,3,1
57958,4,13,17,-4,10,1
377635,1,0,7,-7,15,1
187618,4,13,37,-24,16,1
204535,1,0,14,-14,6,1
212786,3,10,21,-11,10,1
131322,1,0,0,0,8,1
129305,4,17,13,4,7,1
290217,2,17,0,17,10,0
178119,5,26,26,0,12,1
351233,3,28,17,11,3,1
8673,4,7,10,-3,4,0
52832,2,7,37,-30,7,0
181504,1,0,0,0,13,0
6141,4,7,16,-9,3,0
250195,3,17,13,4,9,0
251316,1,0,0,0,10,1
229230,2,3,7,-4,17,1
187503,2,3,10,-7,16,0
110493,3,20,6,14,16,1
344463,1,0,0,0,17,1
362477,2,7,6,1,8,0
358091,1,14,0,14,6,0
173469,2,0,10,-10,10,1
320156,4,17,14,3,6,1
247608,4,19,23,-4,8,1
306850,1,0,3,-3,17,1
265978,4,0,33,-33,16,0
21313,4,6,14,-8,11,1
166442,3,17,7,10,6,0
101253,3,7,7,0,12,0
192967,3,17,17,0,1,0
251465,1,9,3,6,10,1
128118,4,10,6,4,7,1
350621,3,13,0,13,2,0
398705,1,0,7,-7,7,1
142012,3,19,14,5,13,1
255792,2,10,0,10,12,1
324778,4,26,14,12,8,0
5218,2,14,17,-3,3,1
225374,3,24,21,3,15,0
104992,4,17,22,-5,14,1
129725,3,14,14,0,7,1
46321,2,3,17,-14,4,1
163559,2,7,13,-6,5,0
351363,3,10,7,3,3,1
249072,2,21,17,4,9,1
205636,2,7,9,-2,7,1
171301,2,0,3,-3,9,1
187400,3,27,7,20,16,1
64288,2,6,10,-4,13,0
173051,3,24,6,18,9,0
62146,3,7,14,-7,12,1
300753,2,7,13,-6,15,1
262705,2,7,0,7,15,1
392387,4,20,38,-18,4,1
42664,3,0,10,-10,3,0
115104,2,3,13,-10,1,0
43318,1,14,7,7,3,0
358020,3,24,16,8,6,0
227711,2,0,0,0,16,0
29022,4,14,10,4,14,0
157855,2,6,9,-3,3,1
192715,1,0,0,0,1,0
110273,2,0,10,-10,16,0
282128,4,23,8,15,6,1
242907,3,21,13,8,6,1
220132,3,26,13,13,13,0
181039,1,7,0,7,13,1
214128,3,3,6,-3,11,0
356346,3,24,0,24,5,0
268505,4,23,9,14,17,1
183251,3,10,20,-10,14,1
293228,3,16,7,9,11,1
152893,2,0,7,-7,1,1
25067,1,0,0,0,12,1
177132,3,24,13,11,11,1
285492,4,36,15,21,8,1
65131,2,0,0,0,13,1
284865,5,29,33,-4,7,0
255016,2,3,9,-6,12,0
196164,4,31,24,7,2,0
230630,4,16,24,-8,1,0
49957,2,21,0,21,6,0
43968,3,3,14,-11,3,1
183996,4,22,10,12,14,1
113832,1,0,0,0,17,1
124706,2,3,3,0,5,1
403375,4,26,11,15,9,1
218040,3,21,17,4,12,1
340189,2,20,21,-1,15,1
10876,1,0,0,0,5,1
2491,1,0,0,0,2,1
376403,4,9,6,3,14,0
159509,1,7,0,7,3,1
312713,3,28,14,14,3,0
405307,3,14,7,7,10,0
413393,2,3,21,-18,14,0
2770,1,6,0,6,2,1
235386,2,21,7,14,3,0
31268,1,0,0,0,15,0
128864,4,26,23,3,7,1
198733,1,3,0,3,3,0
250928,2,3,6,-3,10,1
203615,2,0,7,-7,6,1
333186,2,0,7,-7,12,0
271699,2,6,3,3,2,1
149325,4,20,27,-7,16,1
403647,4,30,20,10,9,0
83475,1,0,0,0,4,0
301826,4,6,34,-28,15,0
374537,2,14,6,8,14,1
363347,1,0,7,-7,8,0
277844,2,7,14,-7,4,0
326030,1,9,0,9,9,0
220654,1,7,0,7,13,1
388512,4,3,23,-20,2,1
153857,2,0,3,-3,1,1
393435,4,28,24,4,5,1
349111,2,7,0,7,2,1
168682,1,7,0,7,7,0
288337,2,7,0,7,9,1
43453,1,0,0,0,3,1
319937,2,23,7,16,6,0
32369,2,14,6,8,15,1
246552,4,36,7,29,8,0
317734,5,23,23,0,5,0
48737,3,10,19,-9,5,1
234505,3,20,20,0,2,1
2887,4,31,31,0,2,1
76077,3,10,23,-13,1,1
86536,2,19,3,16,5,1
232650,2,0,0,0,1,1
129011,4,42,13,29,7,0
350728,2,7,0,7,2,1
192033,4,24,26,-2,1,0
140413,1,0,7,-7,12,1
80775,2,3,0,3,3,0
159683,1,0,7,-7,3,1
224809,4,11,10,1,15,0
91029,3,6,0,6,7,1
154963,4,29,24,5,1,0
324738,3,19,7,12,8,0
83813,2,7,3,4,4,1
51972,1,0,0,0,7,1
187132,4,13,0,13,16,1
334100,2,7,0,7,13,1
376933,2,3,3,0,15,0
333319,1,10,6,4,12,0
17445,4,17,7,10,9,0
366185,4,7,48,-41,10,1
331570,2,10,20,-10,11,1
51317,2,16,17,-1,7,0
266479,2,0,15,-15,16,1
36653,3,13,3,10,17,0
305951,5,27,24,3,17,1
40399,1,0,0,0,2,0
120369,1,3,6,-3,3,0
127665,4,30,12,18,6,0
290141,4,24,15,9,10,1
297941,2,17,7,10,13,1
8975,4,35,27,8,4,1
100838,4,12,19,-7,12,1
415992,2,7,0,7,15,1
19178,3,21,13,8,10,1
377263,3,14,3,11,15,0
386786,2,7,7,0,2,1
401139,3,34,13,21,8,0
262903,3,14,23,-9,15,0
171278,2,0,0,0,9,0
241598,4,6,27,-21,5,1
58508,1,0,3,-3,10,0
406902,1,0,6,-6,11,0
210691,1,0,0,0,9,1
345771,4,19,10,9,17,0
222480,2,6,14,-8,14,1
404877,1,0,0,0,10,0
107819,4,7,23,-16,15,1
262293,3,10,9,1,15,0
305399,2,17,3,14,17,1
210360,4,22,17,5,9,0
389721,1,0,0,0,3,1
337895,2,10,0,10,14,0
93639,4,23,6,17,9,0
213189,2,3,7,-4,10,0
75784,4,35,26,9,1,1
30753,3,31,28,3,15,0
52564,4,19,10,9,7,1
1645,1,0,0,0,1,0
105058,2,6,14,-8,14,1
51603,2,7,10,-3,7,1
96934,3,22,7,15,10,0
391478,4,10,30,-20,4,1
236481,2,7,3,4,3,0
55001,4,13,10,3,8,1
388456,2,3,13,-10,2,0
158492,2,3,10,-7,3,1
32961,2,0,24,-24,15,1
287162,2,10,10,0,8,1
280938,4,21,10,11,6,0
266600,1,0,0,0,16,0
400514,2,7,3,4,8,0
24033,1,0,0,0,12,1
51174,2,24,3,21,7,0
307882,1,0,0,0,1,1
218617,3,10,23,-13,13,0
137082,2,14,3,11,11,1
10160,2,0,0,0,5,0
319840,4,20,10,10,6,0
235998,2,10,0,10,3,0
375911,2,14,3,11,14,0
146991,3,17,0,17,15,1
388618,2,14,0,14,3,1
181494,5,31,31,0,13,1
246479,2,9,0,9,8,1
217280,2,0,7,-7,12,1
223323,1,0,0,0,15,0
51104,1,0,0,0,7,1
303654,4,38,13,25,16,0
175501,1,0,0,0,11,0
152296,1,0,0,0,17,0
40830,4,32,35,-3,2,1
181640,4,23,6,17,13,0
57873,1,3,0,3,10,0
331245,1,0,0,0,11,0
382761,1,7,0,7,17,0
305072,2,21,7,14,16,1
19354,4,17,17,0,10,1
119178,4,13,7,6,3,1
289463,2,3,7,-4,10,1
359435,1,0,7,-7,6,1
362799,2,7,21,-14,8,1
263752,2,0,0,0,15,1
24755,4,20,34,-14,12,1
381052,2,14,6,8,16,1
133665,4,17,35,-18,9,1
268540,1,7,3,4,17,1
402136,2,12,0,12,9,0
414924,4,42,21,21,15,1
392738,1,7,0,7,4,0
10926,2,6,7,-1,5,0
142697,1,0,0,0,13,0
310872,2,3,3,0,2,0
359104,1,7,0,7,6,0
326660,3,16,6,10,9,0
126764,4,19,13,6,6,0
154434,2,14,0,14,1,0
97075,3,19,6,13,10,1
177368,2,10,0,10,11,0
7979,4,16,27,-11,4,1
256183,4,30,22,8,12,0
280635,4,23,16,7,5,1
221008,3,14,17,-3,14,0
14964,4,17,24,-7,7,0
314868,1,0,0,0,4,0
193177,1,0,0,0,1,0
358261,2,0,14,-14,6,0
16459,1,3,0,3,8,1
106974,4,22,6,16,14,0
228188,2,7,27,-20,17,1
186585,1,7,0,7,15,1
369900,3,13,9,4,12,0
162158,1,7,0,7,4,1
268584,2,7,3,4,17,0
37810,3,14,9,5,1,0
258961,2,0,13,-13,13,0
104518,4,14,31,-17,13,1
37676,3,30,0,30,17,1
279951,1,0,10,-10,5,0
321902,3,14,21,-7,7,1
203741,1,0,7,-7,6,1
263508,4,20,23,-3,15,0
207222,4,20,20,0,7,0
245128,2,17,12,5,7,0
343898,1,0,0,0,17,1
16849,4,26,38,-12,8,1
282395,3,10,23,-13,6,0
49414,4,17,20,-3,6,1
329785,2,17,13,4,11,0
169122,4,39,30,9,7,0
17255,3,7,34,-27,9,1
211481,2,19,7,12,9,0
268787,3,31,9,22,17,0
304765,1,0,0,0,16,1
356078,4,34,10,24,5,0
325640,3,17,7,10,9,1
96895,2,16,7,9,10,1
141080,4,14,10,4,13,1
248802,3,30,14,16,9,0
286183,5,24,24,0,8,0
415463,3,23,3,20,15,1
254897,2,14,7,7,12,1
1342,1,0,0,0,1,0
215897,2,3,7,-4,11,1
399772,3,0,24,-24,8,1
392377,3,20,31,-11,4,1
270139,3,24,13,11,1,1
253688,2,3,3,0,11,1
108428,4,13,21,-8,15,0
334260,3,6,7,-1,13,1
105274,4,10,24,-14,14,1
255658,2,3,7,-4,12,0
241832,2,10,3,7,5,1
127555,1,0,0,0,6,0
15516,3,16,6,10,8,1
6686,3,3,20,-17,3,0
220424,3,23,14,9,13,0
410458,3,9,20,-11,13,0
349672,1,7,6,1,2,0
109308,4,13,3,10,15,1
373353,2,7,6,1,13,0
255171,2,7,0,7,12,0
112385,2,10,13,-3,17,1
83093,3,6,21,-15,4,0
363741,4,26,26,0,8,0
74331,1,0,3,-3,17,1
241796,1,0,3,-3,5,1
305552,2,6,0,6,17,1
359889,2,20,24,-4,6,0
327401,2,0,14,-14,9,1
393175,1,0,3,-3,5,1
89069,2,6,6,0,6,1
244908,1,0,0,0,7,1
381147,4,31,28,3,16,0
320750,3,14,23,-9,6,1
378511,1,0,0,0,15,1
263095,4,10,13,-3,15,0
271139,2,7,10,-3,1,0
291271,2,13,12,1,10,1
196657,1,20,0,20,3,1
168971,1,0,7,-7,7,1
282044,1,3,0,3,6,0
256493,4,19,31,-12,12,0
105151,1,0,0,0,14,0
286731,3,20,7,13,8,0
308123,3,13,19,-6,1,1
15027,2,6,16,-10,7,1
84155,3,10,0,10,4,0
37740,1,7,0,7,1,1
335574,3,9,7,2,13,1
56123,2,17,14,3,9,0
47186,3,6,3,3,5,1
64803,1,0,0,0,13,0
226565,2,3,3,0,16,1
277497,1,0,0,0,4,0
396917,4,27,27,0,6,1
62376,1,0,7,-7,12,0
309077,1,9,0,9,1,0
69362,1,0,0,0,15,1
102808,3,10,3,7,13,1
18732,2,6,7,-1,9,0
346711,3,24,12,12,1,0
243182,5,23,22,1,6,1
419240,4,17,9,8,16,1
57956,3,13,17,-4,10,1
146445,4,24,3,21,15,0
387335,1,7,0,7,2,0
267653,2,0,21,-21,17,1
398333,2,3,10,-7,7,0
98788,4,34,8,26,11,0
338,2,14,3,11,1,0
11303,4,17,28,-11,6,0
323908,1,7,0,7,8,1
235100,2,0,7,-7,2,0
221975,1,0,0,0,14,1
358110,2,14,0,14,6,1
187709,3,16,6,10,16,0
412401,4,34,30,4,13,0
79858,1,3,6,-3,2,1
409938,2,0,14,-14,12,1
406384,3,10,7,3,11,1
406399,3,17,7,10,11,0
399482,2,0,24,-24,7,1
411975,4,20,17,3,13,0
383140,4,23,17,6,17,1
152533,3,24,7,17,17,1
108373,2,0,14,-14,15,0
318357,4,9,28,-19,5,0
242837,1,0,0,0,6,1
85285,1,0,3,-3,5,1
142122,2,0,7,-7,13,1
385912,2,3,7,-4,1,0
355302,3,14,17,-3,4,0
18718,2,3,7,-4,9,1
56405,2,0,21,-21,9,0
339707,2,7,6,1,15,1
415309,3,0,14,-14,15,1
102611,2,5,6,-1,13,1
177395,2,17,10,7,11,0
305362,2,14,3,11,17,0
62160,3,7,14,-7,12,1
303544,1,6,0,6,16,1
380506,2,0,14,-14,16,1
288209,2,3,7,-4,9,0
8999,1,0,0,0,4,1
402533,1,7,0,7,9,0
184445,4,31,13,18,14,1
103241,3,3,10,-7,13,1
94383,4,17,14,3,9,0
250985,3,3,6,-3,10,0
159292,4,24,24,0,3,1
344791,2,7,7,0,17,1
212488,3,10,6,4,10,1
381537,3,14,13,1,17,1
173014,2,14,0,14,9,0
239968,2,0,10,-10,5,1
317516,3,10,27,-17,5,0
33170,1,0,0,0,16,0
279579,4,10,16,-6,5,0
61193,1,0,0,0,11,0
184598,1,7,0,7,15,0
360478,4,17,0,17,7,0
291149,3,18,13,5,10,0
374448,3,32,0,32,14,0
181268,3,0,12,-12,13,0
259793,4,20,13,7,14,0
150580,2,3,13,-10,17,0
394052,3,9,13,-4,5,0
89424,3,17,20,-3,7,0
402024,4,3,19,-16,9,1
374740,3,0,39,-39,14,1
133982,1,0,0,0,9,0
311995,4,35,17,18,2,1
318113,2,9,7,2,5,0
24836,3,13,3,10,12,1
97045,2,19,3,16,10,1
74041,1,3,0,3,17,1
148313,2,7,3,4,16,1
3035,4,20,40,-20,2,0
288485,1,3,0,3,9,0
362091,3,21,10,11,8,0
87286,3,24,17,7,6,0
243306,3,7,10,-3,6,0
336591,3,7,0,7,14,0
142752,2,9,10,-1,13,0
231178,3,10,7,3,1,0
113169,3,41,7,34,17,0
343431,1,0,0,0,16,1
202909,3,28,0,28,5,0
76915,2,7,13,-6,1,1
389850,4,24,6,18,3,0
332211,4,10,16,-6,12,0
9544,4,13,20,-7,5,1
29188,4,3,26,-23,14,1
238394,3,17,30,-13,4,0
308703,2,7,6,1,1,1
318104,2,9,7,2,5,0
231243,1,0,0,0,1,1
420481,2,0,35,-35,17,1
196013,4,7,30,-23,2,1
160498,3,20,7,13,4,1
370884,2,10,10,0,12,1
91074,4,9,0,9,7,1
281647,2,21,10,11,6,1
336601,4,7,0,7,14,1
300450,2,9,0,9,14,1
403787,4,15,16,-1,9,0
134629,3,24,17,7,10,1
141981,2,10,14,-4,13,1
153990,2,7,7,0,1,0
282547,3,17,17,0,6,0
95567,3,9,10,-1,10,1
407428,3,14,7,7,11,1
388312,2,10,3,7,2,0
364941,1,7,0,7,9,0
92887,3,27,0,27,8,0
408734,1,3,7,-4,12,1
29076,1,0,3,-3,14,0
247002,4,20,24,-4,8,0
342233,2,3,0,3,16,0
396440,3,20,25,-5,6,0
48579,3,14,17,-3,5,0
324706,2,7,7,0,8,1
140227,5,13,13,0,12,0
35527,4,30,7,23,17,1
44398,2,3,0,3,3,0
190818,3,16,3,13,17,0
155324,1,10,0,10,2,0
63878,2,3,21,-18,12,1
302044,2,7,10,-3,15,0
411666,4,34,28,6,13,1
359562,1,3,0,3,6,1
355825,1,6,0,6,5,1
403985,1,0,7,-7,10,1
355280,3,14,14,0,4,1
185939,4,22,30,-8,15,1
331156,2,7,13,-6,11,1
394421,1,0,3,-3,5,0
79609,3,14,7,7,2,1
321876,2,7,14,-7,7,1
195775,2,9,7,2,2,1
59030,2,0,10,-10,10,1
97614,1,3,0,3,11,0
108225,2,6,0,6,15,1
293162,1,6,0,6,11,1
154412,1,7,0,7,1,0
117757,1,0,6,-6,2,1
56676,1,0,0,0,9,1
241820,2,3,3,0,5,1
104674,4,7,3,4,14,0
253115,3,21,7,14,11,0
78143,2,17,3,14,2,1
344550,3,0,0,0,17,1
161519,4,17,6,11,4,1
415599,3,14,10,4,15,0
124674,1,0,3,-3,5,0
192576,1,0,0,0,1,1
158799,3,17,3,14,3,0
299137,3,3,16,-13,14,1
20485,2,0,0,0,10,0
148209,4,16,21,-5,16,0
111578,4,35,18,17,16,0
336605,4,7,0,7,14,1
405235,2,7,7,0,10,0
329412,4,16,41,-25,10,1
295689,2,0,9,-9,12,1
243751,3,17,10,7,6,0
81906,3,7,30,-23,3,0
375901,2,14,3,11,14,0
200997,2,14,0,14,5,1
110939,3,7,10,-3,16,0
217598,2,6,9,-3,12,1
127014,3,24,19,5,6,0
389619,2,10,7,3,3,0
339791,4,24,13,11,15,1
126660,2,0,3,-3,6,1
390311,4,24,20,4,3,0
407986,1,0,0,0,12,0
225127,4,16,14,2,15,0
129040,1,0,7,-7,7,1
194235,1,0,0,0,2,0
172890,3,24,24,0,9,1
360414,2,0,0,0,7,1
118984,2,0,20,-20,3,1
170642,4,47,9,38,8,1
370256,1,0,14,-14,12,0
102159,2,14,7,7,13,1
361736,1,7,0,7,7,0
48112,2,7,3,4,5,0
357355,1,7,0,7,5,0
318055,1,0,0,0,5,1
66517,3,28,24,4,14,1
36021,1,7,0,7,17,0
32207,2,14,7,7,15,0
165906,1,0,0,0,6,0
223528,3,7,10,-3,15,1
212697,1,0,7,-7,10,1
353498,1,0,0,0,4,1
338385,3,10,9,1,14,0
166383,1,3,0,3,6,0
154241,1,0,0,0,1,1
312268,4,10,23,-13,2,0
131604,4,16,26,-10,8,0
231952,4,14,41,-27,1,1
201969,3,3,0,3,5,1
345019,4,23,23,0,17,0
369419,2,17,7,10,11,1
398063,3,21,21,0,7,0
160393,4,11,35,-24,4,1
351116,4,37,30,7,3,0
231843,1,0,13,-13,1,1
28213,2,10,0,10,13,0
381185,1,7,3,4,16,1
41711,1,0,0,0,2,0
259152,3,14,13,1,13,1
200291,3,17,14,3,4,1
102020,2,7,3,4,12,1
345694,2,7,0,7,17,0
102552,1,0,0,0,13,1
158587,1,0,6,-6,3,0
106653,4,46,9,37,14,0
15946,3,9,14,-5,8,1
352650,2,0,0,0,3,0
16379,3,21,10,11,8,0
362434,1,0,0,0,8,0
64993,2,0,7,-7,13,0
189534,4,20,7,13,17,1
20464,2,0,0,0,10,0
141312,1,0,7,-7,13,1
111004,4,14,20,-6,16,0
203751,2,7,7,0,6,0
184008,4,22,10,12,14,1
191094,2,7,10,-3,17,0
116675,1,3,3,0,2,1
53308,4,17,10,7,8,1
22902,3,3,13,-10,11,0
421682,2,17,7,10,17,1
117469,2,7,14,-7,2,0
129700,2,14,3,11,7,0
72726,1,0,0,0,16,0
312158,4,33,23,10,2,0
330689,3,6,3,3,11,1
5592,4,26,10,16,3,1
153871,2,7,3,4,1,1
356653,2,13,3,10,5,1
352563,3,27,20,7,3,1
195486,1,0,0,0,2,1
343975,3,16,6,10,17,0
299051,1,0,0,0,14,0
184031,1,0,0,0,14,0
278226,4,31,21,10,4,1
217495,4,19,3,16,12,0
361066,3,16,9,7,7,1
34432,2,21,3,18,16,1
181452,4,31,24,7,13,0
151928,3,20,17,3,17,0
133690,4,32,35,-3,9,0
381864,4,25,21,4,17,0
188851,2,3,0,3,16,0
299059,1,0,0,0,14,1
235199,1,2,0,2,3,1
235374,2,14,7,7,3,0
133918,3,6,6,0,9,0
163369,1,0,0,0,5,0
304113,4,16,30,-14,16,0
316082,2,10,6,4,4,1
229257,2,10,14,-4,17,1
312496,2,13,0,13,3,1
341664,2,17,13,4,16,1
146575,4,14,24,-10,15,0
403798,4,18,23,-5,9,0
374484,4,32,7,25,14,0
318064,1,2,0,2,5,1
235010,4,16,17,-1,2,1
53422,3,3,28,-25,8,0
14018,2,3,14,-11,7,0
406693,3,24,0,24,11,0
286397,2,14,0,14,8,1
221606,3,20,18,2,14,0
403374,4,26,11,15,9,1
406815,3,0,20,-20,11,1
257710,3,3,17,-14,13,1
57235,4,20,14,6,10,1
345566,3,7,20,-13,17,1
84387,1,3,0,3,4,1
319826,3,17,10,7,6,0
284419,1,0,6,-6,7,1
155378,2,13,3,10,2,0
152090,3,6,10,-4,17,1
267417,3,10,17,-7,17,1
304767,1,0,0,0,16,0
87292,3,24,17,7,6,1
325289,2,6,3,3,8,0
397004,2,14,3,11,6,1
141437,4,13,23,-10,13,0
83624,4,10,17,-7,4,1
415851,2,7,20,-13,15,1
301003,1,3,3,0,15,1
88154,2,7,10,-3,6,1
67190,3,0,0,0,14,0
313898,3,28,19,9,3,0
87318,4,24,24,0,6,0
167481,2,0,0,0,7,0
26831,1,7,0,7,13,0
261582,4,12,15,-3,14,1
89324,1,0,6,-6,7,1
12561,3,3,17,-14,6,1
317937,2,7,3,4,5,1
31941,3,9,13,-4,15,0
102671,4,22,20,2,13,1
145676,4,42,7,35,14,0
314003,1,0,0,0,3,1
215389,4,24,20,4,11,1
325377,4,15,20,-5,8,1
392381,3,20,31,-11,4,0
35946,3,3,7,-4,17,1
100063,2,6,3,3,12,1
337959,3,20,0,20,14,0
106383,4,21,19,2,14,1
219330,2,16,7,9,13,0
102061,3,28,10,18,12,0
108820,2,0,10,-10,15,1
257545,3,19,10,9,13,1
212361,4,13,10,3,10,1
36268,4,24,27,-3,17,0
375235,5,24,24,0,14,1
190505,2,10,6,4,17,1
183151,4,7,12,-5,14,1
319047,4,13,26,-13,5,0
131523,2,6,6,0,8,0
197005,3,20,17,3,3,0
276804,2,17,17,0,4,1
319008,2,7,16,-9,5,0
303990,1,0,0,0,16,0
55215,2,7,0,7,9,1
26313,4,19,21,-2,13,1
34732,3,6,3,3,16,1
64761,4,28,7,21,13,1
60880,4,17,26,-9,11,1
239887,3,13,3,10,4,1
101280,4,16,7,9,12,1
93900,3,17,6,11,9,1
344689,3,6,20,-14,17,0
374585,3,20,13,7,14,1
414201,1,0,0,0,14,0
77779,2,7,14,-7,1,0
349228,1,0,7,-7,2,1
227665,4,42,7,35,16,0
340805,3,17,16,1,15,1
416771,2,7,10,-3,15,1
103109,4,34,7,27,13,1
62505,4,16,16,0,12,1
287409,4,20,10,10,8,0
264569,3,10,17,-7,16,1
225365,3,17,21,-4,15,0
77863,4,17,28,-11,1,0
219172,2,0,3,-3,13,0
74579,4,10,3,7,17,0
163174,4,22,28,-6,5,1
296740,1,0,0,0,13,0
231386,4,9,19,-10,1,1
204941,4,13,27,-14,6,0
4896,2,14,7,7,3,0
234188,2,10,10,0,2,1
158828,3,20,3,17,3,0
418203,4,31,6,25,16,0
120759,3,23,6,17,3,0
373165,1,0,3,-3,13,0
39004,4,30,17,13,1,1
312069,2,17,7,10,2,0
229241,2,10,14,-4,17,1
364174,4,34,3,31,9,0
104172,4,27,27,0,13,1
30622,3,17,3,14,14,1
232811,3,16,14,2,2,1
23882,1,0,0,0,12,1
215892,2,3,7,-4,11,0
383983,3,3,13,-10,1,0
148974,3,13,12,1,16,1
338589,4,36,38,-2,14,1
221224,1,0,10,-10,14,0
218875,2,21,3,18,13,0
156977,3,7,13,-6,2,0
235385,2,20,7,13,3,1
307838,3,27,21,6,1,0
240618,2,20,7,13,5,0
234237,4,20,17,3,2,0
198171,3,10,3,7,3,0
296862,1,3,0,3,13,0
380683,3,7,7,0,16,0
213005,1,0,0,0,10,1
133679,4,24,35,-11,9,1
272055,2,10,3,7,2,0
150087,1,0,0,0,16,1
324445,4,14,6,8,8,1
202518,1,0,0,0,5,0
292779,3,26,17,9,11,0
192336,3,27,17,10,1,0
264934,3,20,17,3,16,1
134963,4,7,22,-15,10,0
222477,2,6,14,-8,14,1
286763,4,20,21,-1,8,0
391850,2,10,3,7,4,0
240168,3,16,3,13,5,1
69019,3,24,17,7,15,0
210969,4,33,23,10,9,0
397419,2,0,13,-13,6,1
210255,1,3,0,3,9,0
209858,2,13,13,0,8,0
321802,4,21,9,12,7,1
218801,4,3,19,-16,13,0
379104,4,7,12,-5,15,1
26122,2,0,13,-13,13,1
393019,4,12,10,2,4,0
371567,2,3,0,3,12,0
233391,1,7,0,7,2,0
210043,4,10,17,-7,8,1
79057,4,10,14,-4,2,1
267697,3,14,24,-10,17,0
17721,4,17,6,11,9,1
98905,3,7,10,-3,11,1
189483,3,14,0,14,17,1
217931,4,32,28,4,12,1
95028,4,20,16,4,9,1
84843,1,13,3,10,4,0
22617,3,23,3,20,11,1
375071,4,28,30,-2,14,0
267439,4,20,24,-4,17,0
15723,1,0,0,0,8,0
184888,1,0,0,0,15,0
224782,3,5,3,2,15,1
56446,3,0,35,-35,9,0
309139,3,26,3,23,1,0
133682,4,24,35,-11,9,1
151462,2,28,7,21,17,0
70630,4,17,17,0,15,0
66503,3,14,24,-10,14,1
414741,3,10,17,-7,14,0
24372,2,3,0,3,12,1
132707,2,3,10,-7,9,1
194876,2,0,10,-10,2,1
104494,3,14,31,-17,13,1
107229,4,14,31,-17,15,0
317619,2,3,3,0,5,1
220163,4,29,13,16,13,0
316641,4,12,12,0,4,0
378244,1,0,0,0,15,0
183467,4,27,6,21,14,1
302937,2,13,3,10,16,0
231937,4,7,41,-34,1,1
114764,1,6,3,3,1,1
323229,3,7,9,-2,7,0
298789,2,14,6,8,14,0
10239,4,6,10,-4,5,1
347822,4,16,0,16,1,0
184981,3,7,20,-13,15,1
14019,2,3,14,-11,7,0
340932,3,0,10,-10,15,1
358393,2,9,13,-4,6,0
99729,1,0,0,0,12,0
204751,3,14,14,0,6,0
323271,4,7,17,-10,7,0
285202,1,0,0,0,7,0
263788,3,0,24,-24,15,1
405862,1,7,0,7,11,0
41641,3,17,0,17,2,1
59476,3,3,17,-14,11,0
169663,3,20,16,4,8,0
306620,3,7,20,-13,17,1
3288,2,3,3,0,2,1
418196,4,24,6,18,16,1
71131,1,12,0,12,16,0
230470,4,28,14,14,1,0
45635,3,13,13,0,4,0
264316,4,17,36,-19,15,0
154557,2,7,7,0,1,1
331300,2,0,14,-14,11,0
39,2,0,0,0,1,0
407071,1,0,3,-3,11,0
399671,4,16,9,7,8,1
220907,1,0,0,0,14,0
229824,2,6,0,6,17,1
262266,2,3,9,-6,15,1
370967,1,0,0,0,12,0
281415,1,0,10,-10,6,1
60501,2,27,7,20,11,0
256918,3,14,18,-4,12,0
134559,1,3,0,3,10,0
123753,2,7,3,4,5,0
12464,4,13,9,4,6,1
144844,2,14,0,14,14,0
54353,2,14,19,-5,8,1
84410,2,3,0,3,4,1
99088,4,23,0,23,11,1
360685,1,0,0,0,7,0
23635,2,7,13,-6,12,1
638,2,0,3,-3,1,1
132874,3,6,14,-8,9,0
223331,1,0,3,-3,15,1
167707,3,23,20,3,7,0
19670,1,0,0,0,10,0
274748,4,24,20,4,3,1
125683,4,31,24,7,5,0
219199,3,0,3,-3,13,1
303967,4,14,34,-20,16,1
14098,1,0,0,0,7,0
239229,1,0,7,-7,4,0
202888,3,21,0,21,5,1
128612,1,3,10,-7,7,1
152863,1,0,0,0,1,0
357816,2,3,14,-11,6,1
300711,1,7,0,7,15,1
101779,4,13,13,0,12,1
369440,3,31,7,24,11,1
107755,2,7,13,-6,15,1
7645,4,31,3,28,4,0
293487,2,10,3,7,11,0
28656,2,3,7,-4,14,0
371196,3,11,19,-8,12,1
170994,1,7,7,0,8,0
38482,1,7,3,4,1,0
91025,2,6,0,6,7,0
414167,4,10,20,-10,14,0
263325,3,17,7,10,15,1
26629,4,10,6,4,13,0
106754,2,17,15,2,14,0
295455,4,17,16,1,12,1
110108,1,0,3,-3,16,0
183416,3,24,3,21,14,0
76594,1,7,0,7,1,0
31439,2,3,7,-4,15,1
134654,4,34,24,10,10,0
135678,3,7,10,-3,10,1
108073,2,13,14,-1,15,0
245539,2,34,0,34,7,1
230988,2,7,0,7,1,0
47839,3,10,6,4,5,0
306299,2,17,0,17,17,0
160256,1,0,0,0,4,0
346156,1,7,0,7,1,1
909,2,0,0,0,1,1
360308,3,0,13,-13,7,0
131160,4,27,12,15,8,1
212675,4,9,31,-22,10,0
106875,2,9,0,9,14,0
6425,4,9,20,-11,3,0
137030,1,7,0,7,11,0
330716,4,6,6,0,11,1
51970,4,13,16,-3,7,0
194213,4,12,17,-5,1,0
101734,3,13,7,6,12,1
158583,1,0,0,0,3,0
218341,4,17,23,-6,12,0
403327,3,9,0,9,9,1
215629,3,14,6,8,11,0
188278,3,14,10,4,16,0
200832,1,0,0,0,4,0
273683,4,22,13,9,2,0
33003,4,12,37,-25,15,0
138894,1,0,3,-3,12,1
132429,3,0,21,-21,9,0
264657,5,20,20,0,16,1
56811,4,17,20,-3,9,0
221010,3,14,17,-3,14,1
73532,3,3,38,-35,17,0
109274,3,6,0,6,15,0
180060,4,28,20,8,13,1
359649,4,37,7,30,6,0
324150,3,3,10,-7,8,1
275653,3,30,3,27,3,0
213756,1,0,0,0,10,1
228424,4,10,27,-17,17,0
22667,4,30,24,6,11,1
365594,3,35,17,18,9,0
282555,4,17,24,-7,6,1
23529,4,17,17,0,11,1
247214,1,7,7,0,8,0
342924,4,23,17,6,16,1
400339,2,9,3,6,8,1
182302,2,14,7,7,14,1
36711,4,23,10,13,17,0
299354,4,28,16,12,14,1
116997,1,0,3,-3,2,1
292798,4,29,17,12,11,1
368288,3,6,6,0,11,1
234714,4,30,30,0,2,0
304698,4,21,7,14,16,0
279656,2,14,0,14,5,1
196662,2,27,0,27,3,0
55926,1,0,0,0,9,1
34285,3,20,9,11,16,0
127694,4,37,26,11,6,0
164662,4,14,27,-13,5,1
9028,2,7,7,0,4,1
66881,2,0,7,-7,14,1
189548,1,0,0,0,17,1
104293,2,24,14,10,13,1
100473,2,7,10,-3,12,1
57049,3,7,20,-13,9,0
384955,2,7,0,7,1,0
272512,2,7,3,4,2,0
83068,2,6,14,-8,4,0
60011,1,0,0,0,11,0
253393,2,14,21,-7,11,0
118544,2,17,3,14,2,1
154916,3,19,10,9,1,0
166202,4,35,19,16,6,0
309219,1,0,0,0,1,1
294666,2,3,14,-11,12,1
352080,2,3,10,-7,3,0
83501,1,0,7,-7,4,1
326900,1,0,0,0,9,0
366302,4,28,10,18,10,0
243834,1,0,0,0,6,0
216193,3,14,3,11,12,1
287405,4,20,10,10,8,1
221113,2,0,6,-6,14,0
90742,2,14,7,7,7,1
94758,1,3,3,0,9,0
224073,4,14,9,5,15,1
175192,4,49,17,32,10,1
227727,2,3,0,3,16,0
137473,1,7,0,7,11,0
273127,2,6,0,6,2,1
294236,3,13,14,-1,12,0
234802,2,0,3,-3,2,0
403341,3,12,0,12,9,1
33142,4,10,42,-32,16,1
397491,4,13,19,-6,6,0
20825,2,14,3,11,10,0
166649,4,22,20,2,6,1
134217,3,3,23,-20,10,1
404296,2,0,3,-3,10,0
69724,3,13,7,6,15,0
240994,4,27,22,5,5,1
235783,4,20,27,-7,3,1
104837,4,27,33,-6,14,1
305959,1,0,0,0,17,1
399724,1,0,3,-3,8,1
64539,1,0,0,0,13,1
50542,2,0,3,-3,6,0
134390,4,29,24,5,10,1
365590,2,35,17,18,9,0
22802,4,6,21,-15,11,1
3738,2,10,3,7,2,1
262734,2,21,0,21,15,0
110411,1,7,0,7,16,1
172051,2,7,0,7,9,0
284942,3,10,14,-4,7,0
382566,4,0,17,-17,17,1
263978,4,23,7,16,15,1
101197,2,0,7,-7,12,1
282978,2,14,3,11,6,0
95582,3,9,10,-1,10,1
290935,2,14,7,7,10,1
242919,3,21,13,8,6,0
378105,1,14,0,14,15,0
309286,3,0,20,-20,1,1
274578,3,24,23,1,3,0
394154,2,13,10,3,5,1
83667,2,16,10,6,4,0
313509,5,17,17,0,3,1
18062,1,0,0,0,9,0
65061,4,6,17,-11,13,0
403916,3,20,14,6,10,1
198172,3,10,3,7,3,0
104270,2,17,0,17,13,0
174758,1,6,0,6,10,0
48150,3,10,13,-3,5,1
354953,2,7,6,1,4,1
156683,3,14,14,0,2,0
257389,3,20,7,13,13,0
60156,4,34,19,15,11,0
76389,3,29,6,23,1,0
6270,3,13,17,-4,3,1
126867,3,17,6,11,6,0
228714,4,19,23,-4,17,0
1982,3,10,9,1,1,0
183631,2,0,0,0,14,0
102948,3,12,24,-12,13,0
401308,4,20,21,-1,8,0
318851,2,21,6,15,5,0
338265,4,34,31,3,14,0
182941,3,10,37,-27,14,1
189050,3,14,17,-3,16,1
223613,1,6,0,6,15,0
53516,2,7,3,4,8,0
407696,1,0,0,0,11,1
40311,3,6,0,6,2,0
51989,1,0,7,-7,7,1
142190,4,8,13,-5,13,0
141706,3,23,21,2,13,0
97479,1,13,0,13,10,0
320704,2,14,17,-3,6,0
378857,2,7,6,1,15,1
53095,2,19,14,5,7,0
184970,3,7,20,-13,15,1
169624,2,12,0,12,8,1
349277,2,7,21,-14,2,1
344751,1,0,0,0,17,0
280022,3,3,20,-17,5,0
240780,3,10,7,3,5,0
11175,1,0,0,0,6,1
144659,1,0,0,0,14,1
398898,2,9,10,-1,7,1
223178,1,3,0,3,15,0
266672,3,29,3,26,16,0
289496,3,13,7,6,10,0
49480,1,0,0,0,6,0
264420,3,3,28,-25,15,1
198902,2,3,16,-13,3,0
26130,2,0,13,-13,13,1
217749,3,10,7,3,12,0
276746,1,7,0,7,4,1
238541,3,16,13,3,4,1
158581,1,0,0,0,3,0
7450,3,20,6,14,4,0
402436,3,21,12,9,9,1
314289,1,0,7,-7,3,0
237840,2,7,20,-13,4,1
203548,4,31,3,28,6,1
290351,2,6,3,3,10,0
268290,2,17,3,14,17,0
139714,3,7,7,0,12,0
71673,4,3,34,-31,16,0
375793,3,20,0,20,14,0
279585,4,10,16,-6,5,1
401186,1,0,0,0,8,0
334588,4,27,24,3,13,1
339127,3,10,6,4,15,1
140570,1,14,7,7,12,0
167752,4,26,23,3,7,1
231122,1,3,0,3,1,0
247820,1,0,3,-3,8,1
92726,3,3,17,-14,8,1
154339,3,27,17,10,1,0
273154,2,10,0,10,2,1
96497,4,17,24,-7,10,1
178391,4,31,34,-3,12,1
310588,2,10,20,-10,2,0
88817,4,13,13,0,6,0
263758,2,0,6,-6,15,0
286795,4,20,31,-11,8,1
342306,4,20,3,17,16,0
406621,1,0,0,0,11,1
202655,4,40,20,20,5,1
130388,3,7,6,1,8,1
114356,2,24,13,11,1,0
305862,3,7,14,-7,17,0
76069,3,10,23,-13,1,1
23736,1,0,0,0,12,1
125892,2,13,10,3,6,0
340990,4,17,20,-3,15,1
350186,2,17,0,17,2,1
264992,4,32,17,15,16,0
311962,3,35,10,25,2,0
157710,2,10,3,7,2,0
351852,3,27,14,13,3,1
120690,2,10,0,10,3,0
252345,3,0,22,-22,10,1
192190,4,3,20,-17,1,1
402369,1,0,7,-7,9,0
272469,4,31,24,7,2,0
310450,2,14,3,11,2,1
20296,1,10,3,7,10,0
175680,2,22,3,19,11,1
120458,4,19,19,0,3,0
380026,2,21,7,14,16,0
274809,1,0,0,0,3,0
118676,2,14,6,8,2,1
224444,2,9,10,-1,15,0
364612,4,21,37,-16,9,1
311165,1,3,0,3,2,1
110002,2,20,10,10,16,1
339975,1,7,3,4,15,0
116850,2,7,7,0,2,1
138769,1,0,0,0,12,0
224232,1,6,0,6,15,0
9253,1,0,0,0,5,0
243874,2,13,3,10,6,1
406040,2,0,10,-10,11,1
16893,2,7,13,-6,8,1
91769,2,3,0,3,8,0
74124,3,23,6,17,17,0
156050,3,20,24,-4,2,0
223600,1,0,0,0,15,0
276450,1,3,7,-4,4,1
20829,2,14,6,8,10,0
314301,1,6,14,-8,3,1
412627,2,3,3,0,14,1
261807,2,3,7,-4,14,0
187707,3,16,6,10,16,0
316401,2,13,0,13,4,0
267776,1,3,0,3,17,0
32293,4,30,28,2,15,0
139719,3,7,7,0,12,0
36242,4,10,24,-14,17,0
196583,3,20,13,7,2,0
314703,4,17,28,-11,3,1
10280,1,0,0,0,5,0
336326,4,20,10,10,13,0
396743,4,7,17,-10,6,0
41873,1,7,3,4,2,1
201452,2,12,0,12,5,0
30565,2,10,0,10,14,0
19280,2,7,14,-7,10,0
76852,4,33,7,26,1,1
176429,1,0,0,0,11,1
353021,4,23,10,13,3,1
325152,2,13,14,-1,8,1
139793,1,6,3,3,12,1
32499,2,7,3,4,15,1
347467,2,12,13,-1,1,0
271651,4,23,37,-14,2,1
255404,4,24,6,18,12,0
256149,3,24,16,8,12,0
240724,1,0,7,-7,5,1
261702,3,14,0,14,14,1
395536,3,21,14,7,6,0
407017,4,9,34,-25,11,1
371650,4,24,17,7,12,1
132891,4,6,21,-15,9,1
353106,2,10,22,-12,3,0
46733,2,7,0,7,4,0
334116,2,16,7,9,13,1
122212,1,3,7,-4,4,0
218044,3,21,17,4,12,1
68442,1,0,0,0,14,1
409408,3,20,3,17,12,0
171876,1,0,7,-7,9,1
72788,2,21,14,7,16,0
314014,2,3,0,3,3,1
158885,1,14,0,14,3,0
170155,3,7,13,-6,8,1
381573,4,35,16,19,17,0
36380,3,13,19,-6,17,0
48697,2,7,10,-3,5,0
409937,2,0,14,-14,12,1
310102,1,7,0,7,2,0
377715,3,25,7,18,15,0
181572,3,13,3,10,13,1
101448,4,18,10,8,12,0
106673,4,46,16,30,14,0
371282,2,7,10,-3,12,0
200654,4,35,28,7,4,0
137091,3,17,3,14,11,0
114270,4,16,24,-8,1,1
296858,1,0,0,0,13,1
127604,2,3,9,-6,6,1
401521,1,0,14,-14,8,1
415951,4,24,30,-6,15,0
105268,4,10,24,-14,14,0
50123,3,0,17,-17,6,0
365457,3,10,19,-9,9,1
142274,2,0,0,0,13,0
15090,4,10,26,-16,7,1
134780,3,27,10,17,10,1
348577,3,28,17,11,2,1
197992,2,0,20,-20,3,1
206364,1,0,0,0,7,0
253014,1,0,0,0,11,0
215074,3,16,7,9,11,0
53647,1,0,0,0,8,0
116089,1,0,0,0,1,0
196702,3,33,0,33,3,0
334697,2,15,3,12,13,0
25291,3,34,14,20,12,1
251177,1,7,7,0,10,1
301310,2,14,7,7,15,1
267736,4,16,34,-18,17,0
164011,1,0,3,-3,5,0
269432,4,21,20,1,1,0
302512,3,3,10,-7,15,0
286537,2,3,14,-11,8,0
120929,4,31,31,0,3,0
291377,1,7,7,0,10,1
328428,2,3,0,3,10,1
16131,4,40,17,23,8,1
37008,1,0,0,0,17,1
187200,2,0,0,0,16,0
236256,1,0,0,0,3,0
177203,1,0,0,0,11,1
382880,4,35,3,32,17,0
169046,3,26,14,12,7,0
134577,2,10,3,7,10,0
141036,3,7,10,-3,13,1
207342,3,13,21,-8,7,1
14942,4,14,24,-10,7,0
408024,2,3,7,-4,12,1
370604,3,14,14,0,12,1
250671,3,10,22,-12,10,1
183352,1,7,3,4,14,1
239635,4,20,20,0,4,1
111774,1,3,7,-4,17,0
243710,2,14,3,11,6,0
400859,4,31,19,12,8,0
17122,4,23,16,7,9,0
329727,1,0,0,0,11,1
226176,4,28,35,-7,16,1
75056,1,0,0,0,17,1
181416,3,17,17,0,13,0
179684,1,0,0,0,12,0
280205,4,28,14,14,5,1
86246,2,6,10,-4,5,0
124169,4,22,21,1,5,0
75559,2,7,0,7,17,0
376175,1,7,0,7,14,1
119855,4,24,21,3,3,0
106884,2,9,3,6,14,1
134548,1,0,0,0,10,1
101106,3,10,16,-6,12,0
373841,2,20,0,20,13,0
308416,3,0,18,-18,1,1
177398,2,17,10,7,11,1
55930,1,0,0,0,9,0
25673,2,7,7,0,12,0
325630,3,10,7,3,9,1
38142,5,9,9,0,1,0
93827,1,0,0,0,9,0
34961,4,30,27,3,16,1
235243,2,15,3,12,3,0
12893,4,13,13,0,6,0
10342,2,10,28,-18,5,0
152722,1,0,0,0,17,1
229078,2,10,0,10,17,0
282558,4,17,24,-7,6,1
397607,3,6,20,-14,7,0
240473,2,3,7,-4,5,1
115718,3,13,3,10,1,0
205983,3,13,10,3,7,0
173918,3,13,16,-3,10,0
333522,2,13,3,10,12,0
122730,3,7,17,-10,4,1
25122,2,10,0,10,12,1
350102,4,30,26,4,2,0
321699,1,0,3,-3,7,1
372912,2,19,0,19,13,1
324,1,14,3,11,1,1
364948,1,7,0,7,9,1
36975,4,0,32,-32,17,1
117752,1,0,6,-6,2,1
238188,2,3,16,-13,4,1
185119,3,0,16,-16,15,0
206030,4,16,17,-1,7,1
33771,2,0,3,-3,16,0
298340,1,0,7,-7,14,1
275722,1,7,0,7,3,0
22465,3,24,27,-3,11,0
158141,1,0,0,0,3,0
254437,2,20,0,20,11,1
269307,1,0,0,0,1,1
404724,1,0,3,-3,10,1
346657,2,14,6,8,1,1
8841,4,32,0,32,4,0
218857,2,14,3,11,13,0
22251,1,0,0,0,11,0
298503,2,10,0,10,14,0
106007,3,23,3,20,14,1
159069,2,17,0,17,3,1
402590,3,10,16,-6,9,1
65841,1,0,0,0,13,0
22529,4,31,37,-6,11,1
233183,4,36,18,18,2,1
208401,4,23,43,-20,8,0
119460,3,7,17,-10,3,0
405803,4,21,24,-3,10,1
183879,4,44,28,16,14,1
206009,4,16,10,6,7,0
327692,2,3,10,-7,10,1
238863,4,41,7,34,4,1
246331,2,7,10,-3,7,1
249403,3,18,15,3,9,0
128040,2,3,3,0,7,0
57380,4,14,3,11,10,0
377347,1,0,0,0,15,1
111647,2,14,10,4,16,0
273224,4,40,7,33,2,0
1299,4,24,23,1,1,1
300919,3,10,20,-10,15,1
97076,3,19,6,13,10,1
103417,4,10,23,-13,13,1
7245,2,0,13,-13,4,1
402312,4,23,18,5,9,0
104604,2,7,3,4,14,1
83106,3,6,24,-18,4,1
35639,3,17,3,14,17,1
113991,5,20,20,0,17,1
220245,2,17,6,11,13,0
421026,4,14,35,-21,17,0
69351,4,19,12,7,15,0
325609,2,10,7,3,9,0
406085,3,0,20,-20,11,1
93208,3,3,20,-17,9,1
13960,4,24,21,3,7,0
60164,1,0,0,0,11,0
37040,1,10,0,10,17,1
305480,4,27,10,17,17,1
14315,3,2,7,-5,7,1
149967,2,14,3,11,16,1
391034,4,27,34,-7,4,1
11043,1,7,7,0,5,1
183898,1,0,0,0,14,1
13655,4,19,17,2,7,1
244160,1,0,7,-7,6,1
373935,1,6,0,6,13,1
29908,4,23,23,0,14,0
160937,2,7,7,0,4,0
314776,2,21,0,21,4,0
312675,2,28,7,21,3,0
236893,1,12,0,12,3,1
47782,1,0,0,0,5,0
86726,3,17,14,3,5,0
347533,4,20,37,-17,1,1
19092,1,0,0,0,10,1
80695,4,24,26,-2,3,1
338753,4,27,17,10,14,0
407100,2,0,20,-20,11,1
176361,3,16,21,-5,11,1
317708,4,23,16,7,5,0
269515,2,13,16,-3,1,0
68166,1,7,7,0,14,0
55344,1,0,0,0,9,1
296935,3,26,0,26,13,0
156312,2,17,0,17,2,0
55013,1,0,0,0,8,0
200559,2,14,7,7,4,0
49712,4,21,31,-10,6,1
229111,2,16,7,9,17,1
382676,2,0,6,-6,17,1
200479,4,23,18,5,4,1
58998,1,0,7,-7,10,0
77067,2,7,17,-10,1,1
174907,1,0,0,0,10,1
198895,1,3,13,-10,3,0
26331,4,19,21,-2,13,0
274235,2,17,7,10,3,1
223714,3,36,13,23,15,1
292394,4,12,16,-4,11,1
288266,3,10,35,-25,9,1
133780,3,13,10,3,9,0
21533,2,7,7,0,11,1
152453,1,7,0,7,17,1
321142,2,3,10,-7,6,1
138002,2,19,14,5,11,0
305418,3,20,3,17,17,1
86746,4,24,14,10,5,1
193603,4,0,17,-17,1,0
246868,5,20,23,-3,8,1
204051,4,16,14,2,6,1
334834,2,10,3,7,13,1
113504,4,3,7,-4,17,0
46660,4,10,0,10,4,0
345443,3,3,19,-16,17,0
100770,2,6,3,3,12,0
266456,1,0,9,-9,16,0
306305,2,17,7,10,17,1
160336,3,3,21,-18,4,1
196466,1,0,0,0,2,1
173187,3,20,17,3,9,0
348368,2,10,10,0,1,1
302358,3,10,10,0,15,0
405022,4,9,26,-17,10,1
12694,2,38,0,38,6,0
350515,4,17,19,-2,2,0
214619,3,3,16,-13,11,0
363783,1,0,7,-7,8,1
151784,3,14,12,2,17,0
234943,2,10,3,7,2,1
299142,3,3,16,-13,14,1
69859,3,21,9,12,15,0
180484,2,14,20,-6,13,0
175152,3,28,10,18,10,1
228137,1,0,0,0,17,0
96145,2,0,16,-16,10,1
351695,3,14,17,-3,3,0
110027,3,27,10,17,16,1
282507,2,14,3,11,6,1
21676,2,3,7,-4,11,1
260617,2,0,10,-10,14,1
53571,3,14,12,2,8,0
257451,1,0,0,0,13,1
101837,1,3,0,3,12,1
165553,4,3,28,-25,6,0
348695,3,17,10,7,2,1
99848,1,0,0,0,12,1
92052,1,0,0,0,8,1
151483,2,28,7,21,17,1
263950,3,23,0,23,15,0
80185,2,14,10,4,2,0
248965,4,26,3,23,9,1
376922,1,0,3,-3,15,1
219073,4,31,13,18,13,1
114934,1,0,3,-3,1,1
142335,3,0,3,-3,13,0
332203,3,10,16,-6,12,0
282817,3,3,13,-10,6,0
204630,3,10,38,-28,6,0
259458,2,14,10,4,13,1
139020,4,21,12,9,12,0
315167,2,7,7,0,4,0
222234,4,13,24,-11,14,1
34291,3,20,9,11,16,1
229073,2,3,0,3,17,1
125219,4,31,14,17,5,1
260483,2,10,0,10,14,1
207338,3,13,21,-8,7,1
18508,4,20,14,6,9,0
90116,2,0,0,0,7,0
219884,1,0,0,0,13,1
146023,1,10,0,10,15,0
349441,2,0,20,-20,2,1
295777,4,24,16,8,12,0
22530,4,31,37,-6,11,1
242712,1,7,0,7,6,0
237844,2,7,20,-13,4,0
70247,1,6,0,6,15,1
227847,1,7,6,1,16,0
420998,4,14,28,-14,17,1
185495,1,0,3,-3,15,1
52038,2,10,10,0,7,0
194160,2,3,3,0,1,0
137022,1,7,0,7,11,0
56030,4,10,23,-13,9,1
112626,4,38,34,4,17,0
244732,4,24,29,-5,7,1
101684,2,10,0,10,12,0
250680,4,10,22,-12,10,1
138339,3,27,0,27,11,0
330115,3,0,13,-13,11,1
101543,2,10,21,-11,12,1
69611,4,7,17,-10,15,0
49375,3,10,17,-7,6,0
44257,2,17,13,4,3,1
345512,1,7,10,-3,17,1
50047,1,0,0,0,6,1
92050,1,0,0,0,8,1
333102,4,20,18,2,12,0
348328,1,7,7,0,1,1
367521,1,7,0,7,10,0
229963,1,0,3,-3,17,0
262291,3,10,9,1,15,0
111300,4,17,19,-2,16,0
385935,3,10,14,-4,1,0
411630,3,20,28,-8,13,0
272588,4,13,6,7,2,1
361496,2,7,0,7,7,0
250967,3,3,6,-3,10,0
131623,1,0,6,-6,8,0
30927,4,10,24,-14,15,0
419175,3,10,6,4,16,0
396014,4,38,20,18,6,0
190320,1,0,0,0,17,1
11029,1,6,0,6,5,1
394095,4,23,23,0,5,0
4790,3,20,0,20,3,1
419497,3,10,17,-7,16,1
29725,2,20,3,17,14,1
54499,3,7,7,0,8,0
246484,2,12,0,12,8,0
64400,1,0,3,-3,13,1
191298,4,17,17,0,17,0
154036,3,17,21,-4,1,0
52191,2,7,3,4,7,0
27187,2,13,7,6,13,1
363270,3,24,7,17,8,1
351199,2,14,3,11,3,1
247427,3,10,9,1,8,1
402204,4,19,14,5,9,1
227808,4,6,28,-22,16,0
142160,4,2,7,-5,13,0
62621,3,9,17,-8,12,1
91556,4,26,10,16,8,1
249426,4,18,15,3,9,1
248278,2,14,0,14,8,0
39662,1,0,0,0,1,1
361551,4,13,10,3,7,1
373934,1,0,0,0,13,1
325254,1,0,3,-3,8,1
112856,2,7,3,4,17,0
336986,1,3,0,3,14,1
324627,4,16,15,1,8,1
221395,2,3,17,-14,14,1
182047,3,17,14,3,13,1
316385,2,13,0,13,4,1
394416,1,0,3,-3,5,0
65159,2,0,3,-3,13,1
388505,3,3,23,-20,2,0
131278,4,14,17,-3,8,1
179791,4,6,27,-21,12,0
369058,4,20,19,1,11,1
9847,1,0,0,0,5,1
389853,4,24,6,18,3,1
127751,2,0,14,-14,6,1
360152,2,10,6,4,7,0
222725,1,0,0,0,14,1
26671,1,0,0,0,13,0
255191,2,7,7,0,12,1
284346,3,6,17,-11,7,1
107576,1,0,7,-7,15,1
335755,3,10,7,3,13,0
406854,4,7,23,-16,11,1
271037,3,18,28,-10,1,1
189383,4,27,17,10,16,0
258004,3,0,28,-28,13,1
291312,4,21,22,-1,10,1
385267,2,7,3,4,1,0
29953,1,0,0,0,14,1
268729,2,7,3,4,17,1
49428,5,20,20,0,6,0
289040,3,32,21,11,9,0
83730,4,22,23,-1,4,1
262345,4,13,16,-3,15,1
240289,2,7,7,0,5,1
219932,2,6,0,6,13,0
405419,2,14,10,4,10,1
329730,1,0,0,0,11,1
364717,3,6,3,3,9,1
138260,1,0,0,0,11,1
218057,4,21,24,-3,12,0
107112,4,40,6,34,15,1
151261,4,24,26,-2,17,0
260272,4,24,3,21,14,0
99780,3,0,7,-7,12,0
101566,3,13,24,-11,12,0
148291,2,7,0,7,16,0
347828,4,16,0,16,1,0
73828,3,13,0,13,17,0
90142,2,3,0,3,7,1
340386,4,17,13,4,15,0
163623,3,21,19,2,5,0
320167,4,17,17,0,6,1
132957,1,0,7,-7,9,0
26564,2,10,6,4,13,1
139336,4,20,13,7,12,1
162491,2,14,3,11,4,0
204994,1,9,7,2,6,1
216072,3,17,12,5,11,1
133012,3,9,14,-5,9,1
145128,2,17,0,17,14,0
347702,4,27,24,3,1,1
111872,4,16,10,6,17,0
121548,3,16,10,6,4,1
206515,1,0,0,0,7,0
332873,2,14,0,14,12,1
221530,1,13,9,4,14,0
247955,1,0,0,0,8,0
328273,1,3,7,-4,10,1
334543,2,14,17,-3,13,1
161313,4,20,6,14,4,0
107335,3,3,6,-3,15,0
353835,2,7,14,-7,4,1
129363,2,16,7,9,7,0
231739,2,3,13,-10,1,0
279021,4,13,33,-20,5,1
330971,2,22,7,15,11,1
272035,2,7,3,4,2,0
205743,4,27,25,2,7,0
90736,2,14,7,7,7,0
293266,4,26,7,19,11,0
286952,4,26,19,7,8,0
355052,1,0,6,-6,4,1
147592,4,12,0,12,15,1
127003,3,24,13,11,6,0
50384,1,0,0,0,6,0
171483,2,14,10,4,9,1
187469,1,0,0,0,16,0
305885,4,7,14,-7,17,1
266366,3,24,0,24,16,0
15184,2,3,0,3,8,1
197024,4,23,20,3,3,0
150400,1,7,0,7,16,0
336542,2,0,0,0,14,0
46523,4,40,6,34,4,0
250165,2,17,0,17,9,1
130434,1,0,0,0,8,1
316405,2,13,0,13,4,0
118455,4,20,10,10,2,1
85983,3,14,16,-2,5,0
215967,4,20,28,-8,11,0
270700,2,3,3,0,1,1
116187,4,14,19,-5,1,1
18570,2,10,10,0,9,1
116197,4,22,19,3,1,0
67778,4,21,0,21,14,1
384438,2,21,0,21,1,0
197720,2,7,10,-3,3,0
13355,4,7,27,-20,7,0
176672,2,26,12,14,11,1
388050,4,20,9,11,2,0
41379,4,14,12,2,2,0
260067,2,3,7,-4,14,1
372263,2,10,7,3,13,0
160344,3,3,21,-18,4,1
8604,2,7,10,-3,4,0
264687,1,7,0,7,16,0
2504,1,3,0,3,2,1
281762,1,0,0,0,6,1
237140,4,14,40,-26,3,1
54057,3,10,3,7,8,0
143770,2,3,0,3,14,0
39148,3,20,10,10,1,1
337489,2,7,12,-5,14,1
388549,1,7,0,7,3,0
395697,4,18,34,-16,6,0
300802,4,10,33,-23,15,1
360218,4,20,13,7,7,0
342019,4,20,3,17,16,0
344923,2,3,7,-4,17,0
323238,3,7,10,-3,7,0
303666,4,38,19,19,16,1
225513,3,0,21,-21,15,0
364096,2,14,3,11,9,0
241516,1,3,3,0,5,1
49819,3,14,10,4,6,0
152131,4,19,13,6,17,1
56072,1,7,0,7,9,0
375576,1,0,7,-7,14,1
69778,1,0,0,0,15,1
315612,1,0,0,0,4,1
343937,2,14,0,14,17,1
173700,1,0,0,0,10,1
327601,4,10,22,-12,10,1
28182,1,3,0,3,13,1
342145,3,15,16,-1,16,1
166987,1,0,7,-7,7,1
141738,4,33,21,12,13,0
129129,4,34,28,6,7,0
55076,2,13,3,10,8,1
62811,4,20,0,20,12,0
358566,2,10,9,1,6,0
187488,1,0,3,-3,16,1
136867,1,0,7,-7,11,1
169398,4,6,28,-22,8,1
79748,3,20,7,13,2,1
178112,5,26,26,0,12,1
99099,4,23,7,16,11,1
220171,4,29,13,16,13,1
163525,1,7,3,4,5,1
222574,1,0,0,0,14,0
284427,1,0,9,-9,7,1
382927,2,0,7,-7,17,0
293099,4,10,20,-10,11,1
13696,1,0,7,-7,7,1
289759,2,0,10,-10,10,0
270365,1,0,0,0,1,0
26812,4,13,43,-30,13,0
28218,2,10,0,10,13,1
387616,4,13,6,7,2,1
389091,3,23,0,23,3,1
60469,1,7,0,7,11,0
75902,3,29,7,22,1,0
268823,4,38,10,28,17,0
165018,1,7,10,-3,6,1
339279,2,30,0,30,15,1
208579,1,3,0,3,8,1
102622,2,12,6,6,13,1
403158,2,10,14,-4,9,0
297906,1,10,0,10,13,0
129366,2,16,7,9,7,0
338675,3,13,10,3,14,0
395826,3,3,14,-11,6,0
154856,1,3,0,3,1,1
400279,4,24,9,15,8,1
81904,3,7,30,-23,3,0
316248,2,6,13,-7,4,1
380757,1,3,7,-4,16,1
334823,2,10,0,10,13,0
294918,1,0,7,-7,12,1
415136,2,3,21,-18,15,1
383200,1,14,0,14,17,1
306561,1,0,14,-14,17,0
173043,3,21,6,15,9,1
368620,4,16,13,3,11,1
125399,1,0,0,0,5,1
348589,4,28,17,11,2,0
308325,1,0,0,0,1,0
117246,4,30,23,7,2,0
151972,4,34,27,7,17,0
209284,4,34,7,27,8,0
257771,1,0,0,0,13,1
184804,3,17,20,-3,15,0
393096,3,10,3,7,4,1
66810,4,10,6,4,14,1
51343,3,16,20,-4,7,1
100894,1,7,3,4,12,0
296364,4,13,25,-12,13,0
353475,4,25,12,13,4,1
361472,2,7,0,7,7,1
366366,1,6,0,6,10,1
108331,1,0,7,-7,15,1
242044,3,7,9,-2,5,1
10971,3,9,28,-19,5,0
264948,3,23,17,6,16,1
420858,4,17,27,-10,17,0
187829,2,7,13,-6,16,1
76751,1,16,0,16,1,1
247792,4,10,16,-6,8,0
176999,4,20,6,14,11,0
295150,4,10,21,-11,12,0
17456,1,0,0,0,9,0
163882,2,9,10,-1,5,0
116692,1,6,3,3,2,0
292808,4,29,17,12,11,0
212365,4,13,10,3,10,1
87288,3,24,17,7,6,0
246232,4,21,16,5,7,0
328762,2,14,13,1,10,1
75048,1,0,0,0,17,0
388813,4,14,14,0,3,1
409130,4,3,10,-7,12,0
80733,1,0,0,0,3,1
143329,2,0,13,-13,14,0
167483,2,0,0,0,7,0
66043,2,7,0,7,13,0
351624,1,0,7,-7,3,1
347751,2,0,0,0,1,1
353291,3,31,28,3,4,1
76701,4,16,7,9,1,0
261787,1,0,0,0,14,0
189713,1,0,3,-3,17,0
160639,2,7,0,7,4,0
348280,4,16,46,-30,1,1
40715,2,7,7,0,2,1
292234,4,24,17,7,11,1
404691,4,27,32,-5,10,0
47490,2,10,3,7,5,1
332096,4,20,9,11,12,1
231879,2,7,20,-13,1,0
411352,3,17,10,7,13,1
418233,1,0,0,0,16,0
334649,1,2,0,2,13,0
256399,2,9,7,2,12,0
108787,1,0,7,-7,15,0
209608,4,49,34,15,8,1
63892,2,6,21,-15,12,1
417243,4,20,20,0,16,0
112046,1,0,0,0,17,0
67623,3,0,35,-35,14,1
238024,3,10,13,-3,4,1
178943,2,6,3,3,12,1
332834,1,0,0,0,12,0
217747,3,10,7,3,12,1
158538,4,10,17,-7,3,1
170047,1,0,0,0,8,1
87041,4,14,22,-8,5,0
150959,4,16,14,2,17,0
100509,3,7,17,-10,12,1
310620,3,13,30,-17,2,1
202768,4,16,17,-1,5,1
163348,4,22,26,-4,5,0
7646,4,31,3,28,4,0
82303,2,3,10,-7,3,1
9757,2,2,7,-5,5,1
340944,3,10,10,0,15,1
354825,3,20,28,-8,4,1
27740,1,7,7,0,13,0
95672,2,10,3,7,10,1
122580,3,14,7,7,4,0
325080,4,33,38,-5,8,1
262241,1,3,0,3,15,1
351641,2,7,7,0,3,0
315507,2,0,3,-3,4,1
383085,2,20,7,13,17,0
419154,2,10,3,7,16,1
187760,4,16,20,-4,16,0
205841,3,20,0,20,7,1
213864,3,48,7,41,10,0
354163,1,3,0,3,4,0
319614,2,10,3,7,6,0
550,3,7,20,-13,1,1
110461,3,17,0,17,16,1
220608,4,16,29,-13,13,1
232729,1,0,0,0,2,1
240830,4,29,10,19,5,0
29279,2,21,7,14,14,0
158703,4,24,7,17,3,1
272723,3,12,3,9,2,0
340423,4,30,19,11,15,1
180761,2,7,6,1,13,1
255381,3,21,6,15,12,1
330954,1,6,7,-1,11,1
82165,2,13,3,10,3,0
11207,2,7,14,-7,6,1
272299,4,12,10,2,2,0
130829,3,13,12,1,8,1
350144,1,0,0,0,2,1
137616,5,34,34,0,11,1
371397,1,7,7,0,12,0
321343,4,22,22,0,6,0
3997,1,0,0,0,2,1
207525,1,0,0,0,7,1
221666,1,0,0,0,14,1
171828,4,26,17,9,9,0
271721,2,13,10,3,2,0
99496,3,3,10,-7,11,1
268218,4,12,28,-16,17,0
61308,4,31,21,10,11,0
204526,1,0,7,-7,6,1
291974,1,0,0,0,11,0
67230,4,0,3,-3,14,1
26093,1,0,10,-10,13,0
250122,1,7,0,7,9,0
307731,1,7,0,7,1,1
387415,3,21,10,11,2,1
234282,1,7,0,7,2,0
205285,1,3,0,3,6,1
219184,2,0,3,-3,13,1
349710,2,14,7,7,2,0
42252,3,30,7,23,2,1
71101,1,0,0,0,16,1
134918,2,7,16,-9,10,1
167853,2,7,13,-6,7,0
115495,1,0,0,0,1,1
256147,3,24,16,8,12,0
77938,1,3,0,3,1,0
101229,2,7,7,0,12,1
174884,4,26,17,9,10,0
110299,2,0,17,-17,16,1
313655,4,25,30,-5,3,1
34055,1,0,0,0,16,1
197842,1,6,7,-1,3,1
123627,2,0,0,0,4,0
130378,3,7,3,4,8,0
3328,3,3,6,-3,2,1
101831,1,3,0,3,12,0
205886,4,22,7,15,7,1
130445,1,3,0,3,8,0
405379,1,0,7,-7,10,1
387706,3,0,13,-13,2,0
192721,1,0,3,-3,1,0
63972,1,0,0,0,13,1
60186,2,3,0,3,11,0
130703,4,7,45,-38,8,1
252995,4,18,13,5,11,1
23567,1,0,0,0,12,1
36286,1,0,0,0,17,1
207242,1,0,0,0,7,0
300009,2,0,20,-20,14,1
215791,3,29,6,23,11,1
346226,3,26,0,26,1,1
58067,1,7,10,-3,10,1
291314,4,21,22,-1,10,1
57044,3,7,20,-13,9,1
323237,3,7,10,-3,7,0
80048,3,17,3,14,2,0
214017,3,36,7,29,10,1
343781,2,7,3,4,17,1
386813,3,10,7,3,2,0
52207,2,7,10,-3,7,0
331150,2,7,13,-6,11,1
56136,3,17,14,3,9,1
1795,2,9,0,9,1,1
31928,3,6,13,-7,15,1
141950,2,10,7,3,13,1
37987,4,17,14,3,1,1
311549,4,17,19,-2,2,1
390113,3,17,21,-4,3,1
319335,3,13,21,-8,6,1
147666,2,3,0,3,15,1
42658,3,0,10,-10,3,1
123719,1,6,0,6,5,1
139295,3,20,13,7,12,0
374553,2,17,13,4,14,0
121986,3,16,7,9,4,1
332194,3,10,16,-6,12,1
326939,2,2,0,2,9,1
205941,2,3,3,0,7,1
181427,3,23,24,-1,13,1
239366,1,0,7,-7,4,1
307896,1,0,0,0,1,0
91704,4,21,24,-3,8,1
45850,1,7,0,7,4,0
147756,4,24,24,0,15,1
243536,1,3,0,3,6,0
387095,2,10,21,-11,2,0
43900,1,0,0,0,3,1
331241,1,0,0,0,11,0
18463,3,7,7,0,9,0
221734,3,10,7,3,14,1
168858,2,14,3,11,7,1
385712,1,0,0,0,1,0
16290,4,25,29,-4,8,1
159317,4,27,24,3,3,0
233564,2,14,14,0,2,0
287459,2,7,13,-6,9,1
413448,4,10,38,-28,14,1
387193,1,0,0,0,2,1
76122,1,0,0,0,1,0
180293,2,9,7,2,13,0
276613,2,7,6,1,4,1
84634,4,23,13,10,4,0
210846,1,0,0,0,9,0
231675,4,24,16,8,1,0
354856,4,33,35,-2,4,0
160780,1,10,7,3,4,1
275719,1,0,0,0,3,1
137726,3,7,27,-20,11,1
288640,1,0,0,0,9,1
229934,1,0,0,0,17,0
11637,2,14,0,14,6,0
84725,2,10,14,-4,4,1
198405,1,3,0,3,3,0
180466,2,14,7,7,13,0
27569,1,0,0,0,13,1
173411,1,0,6,-6,10,0
117818,3,9,6,3,2,0
349592,3,13,28,-15,2,1
196846,3,3,13,-10,3,0
287674,4,9,10,-1,9,0
357665,2,6,3,3,5,1
59323,2,0,6,-6,11,0
38443,4,31,18,13,1,1
309687,2,3,6,-3,1,0
17746,4,24,13,11,9,0
354369,3,45,3,42,4,0
156347,3,24,0,24,2,0
132673,2,3,3,0,9,0
93716,2,0,3,-3,9,1
176097,4,24,16,8,11,0
419883,3,6,11,-5,17,0
153925,4,7,12,-5,1,0
10967,3,9,28,-19,5,1
326204,2,10,24,-14,9,0
384378,1,7,0,7,1,0
123704,4,10,32,-22,4,1
128197,2,14,7,7,7,1
30611,3,17,0,17,14,0
307428,1,14,3,11,17,0
320445,3,17,10,7,6,1
219421,1,0,0,0,13,0
414835,2,13,7,6,15,1
344561,3,0,0,0,17,0
281804,2,10,0,10,6,1
39335,4,20,27,-7,1,1
339653,4,31,24,7,15,0
156704,4,14,20,-6,2,0
231020,3,17,0,17,1,1
40726,2,10,7,3,2,1
383469,1,0,0,0,17,0
73377,3,20,3,17,17,1
23052,3,10,14,-4,11,0
138978,3,14,6,8,12,0
269416,4,21,17,4,1,0
414941,1,0,7,-7,15,1
170551,2,14,0,14,8,0
154715,2,0,7,-7,1,1
112134,3,7,20,-13,17,1
333165,1,0,0,0,12,0
198888,1,3,13,-10,3,0
106395,1,0,0,0,14,1
329191,2,3,6,-3,10,1
396093,2,17,9,8,6,0
2522,2,3,0,3,2,1
213828,3,42,0,42,10,1
194780,3,10,16,-6,2,0
9962,4,3,3,0,5,1
57067,3,7,20,-13,9,0
271952,4,23,20,3,2,0
275754,2,16,3,13,3,1
221338,4,6,35,-29,14,1
188852,2,3,0,3,16,0
215011,2,10,0,10,11,0
121991,3,16,7,9,4,0
211138,1,0,3,-3,9,0
238094,5,13,13,0,4,0
376863,4,21,14,7,15,1
404859,4,23,27,-4,10,1
297334,2,3,9,-6,13,0
380587,4,21,27,-6,16,1
254515,4,29,13,16,11,1
92228,1,7,0,7,8,0
253666,1,0,0,0,11,1
22091,5,27,24,3,11,1
11159,1,0,0,0,6,1
78677,1,10,0,10,2,1
93752,3,3,13,-10,9,0
199363,2,0,10,-10,4,0
63718,1,7,9,-2,12,1
192587,1,3,0,3,1,0
57177,3,10,0,10,10,0
215821,4,45,13,32,11,1
129299,4,17,13,4,7,0
8852,1,7,0,7,4,0
285858,4,14,30,-16,8,0
361839,4,44,10,34,7,0
351271,4,28,17,11,3,0
349544,1,0,14,-14,2,1
102656,3,22,20,2,13,1
150936,3,13,7,6,17,0
241464,4,10,42,-32,5,0
308714,2,7,13,-6,1,1
127770,2,10,21,-11,6,0
244587,4,25,30,-5,7,1
36941,2,0,25,-25,17,0
343988,3,16,6,10,17,0
8650,3,7,10,-3,4,1
296208,3,16,26,-10,13,1
262938,4,14,32,-18,15,1
314891,2,0,0,0,4,1
415385,1,6,0,6,15,1
97535,3,23,0,23,10,0
353987,1,0,0,0,4,0
65418,2,0,7,-7,13,0
205394,4,27,0,27,6,0
35677,4,23,10,13,17,0
23055,3,10,14,-4,11,1
237678,3,20,7,13,4,0
219268,1,0,0,0,13,1
283115,2,3,0,3,7,0
25147,3,17,3,14,12,1
132351,1,0,0,0,9,0
339459,3,10,23,-13,15,1
36788,2,7,10,-3,17,1
177675,2,10,7,3,12,0
47594,4,49,6,43,5,0
361527,3,10,7,3,7,1
60410,3,20,7,13,11,1
244450,1,0,0,0,7,0
132860,3,3,14,-11,9,1
131094,2,20,6,14,8,0
327803,1,0,10,-10,10,1
89492,1,0,0,0,7,0
157716,2,10,3,7,2,1
181902,4,21,35,-14,13,1
120246,2,14,3,11,3,0
272183,1,0,0,0,2,0
404006,2,0,14,-14,10,1
165337,1,0,0,0,6,0
98352,4,49,35,14,11,1
407013,4,3,34,-31,11,1
201296,2,14,3,11,5,1
14221,4,0,38,-38,7,1
83843,2,13,3,10,4,0
202679,1,0,6,-6,5,0
23522,4,17,17,0,11,0
171007,2,7,10,-3,8,0
65194,3,3,10,-7,13,1
165573,4,3,35,-32,6,1
375935,2,14,6,8,14,0
195213,2,16,3,13,2,0
131347,2,7,10,-3,8,1
78728,2,13,7,6,2,1
126706,3,7,13,-6,6,0
226173,4,28,35,-7,16,1
260547,4,27,8,19,14,0
224013,2,14,6,8,15,0
72671,3,13,10,3,16,1
94035,2,6,21,-15,9,0
377719,3,25,7,18,15,1
193390,2,7,17,-10,1,1
435,4,45,26,19,1,0
77014,4,17,27,-10,1,1
322980,4,19,0,19,7,1
55318,4,20,10,10,9,0
241178,4,20,10,10,5,1
316794,3,16,7,9,4,0
324385,2,7,3,4,8,0
218294,2,10,14,-4,12,0
240834,4,29,10,19,5,1
416937,3,10,7,3,15,0
154476,3,14,10,4,1,1
132671,2,3,3,0,9,0
748,1,0,0,0,1,0
270704,2,3,3,0,1,1
55198,1,7,0,7,9,0
403576,2,17,7,10,9,0
382073,1,7,3,4,17,1
128123,4,13,6,7,7,0
396707,2,7,7,0,6,0
82219,4,16,10,6,3,1
359812,4,40,33,7,6,1
229872,3,13,7,6,17,0
291484,4,21,20,1,10,1
22972,1,0,0,0,11,0
402660,1,0,0,0,9,1
212725,2,3,14,-11,10,0
313596,3,12,23,-11,3,1
229742,3,13,17,-4,17,1
81204,1,0,6,-6,3,0
354719,1,0,0,0,4,0
331896,3,0,9,-9,12,0
258736,3,3,27,-24,13,1
58815,4,18,36,-18,10,1
2562,3,10,17,-7,2,1
38104,4,6,6,0,1,0
206399,2,10,0,10,7,0
155134,4,19,33,-14,1,1
278004,2,3,10,-7,4,0
48739,3,10,19,-9,5,0
262668,4,29,16,13,15,0
405965,4,14,7,7,11,1
370806,4,26,17,9,12,1
337314,2,7,7,0,14,1
253752,4,24,10,14,11,0
317196,2,7,13,-6,5,0
369937,4,16,22,-6,12,0
183364,2,14,3,11,14,0
85426,1,0,0,0,5,1
348758,4,31,24,7,2,1
5141,4,19,7,12,3,0
90821,1,0,0,0,7,0
271039,4,18,28,-10,1,1
293232,3,16,7,9,11,1
358865,2,3,21,-18,6,1
243742,2,17,9,8,6,0
98546,1,0,0,0,11,0
62602,3,6,17,-11,12,1
255872,4,20,14,6,12,1
303489,4,25,10,15,16,0
336935,4,14,21,-7,14,1
299603,4,13,10,3,14,0
414642,1,0,0,0,14,1
179486,1,0,0,0,12,1
319520,4,13,17,-4,6,1
377285,3,14,14,0,15,1
387894,3,10,28,-18,2,0
9858,1,0,0,0,5,1
273624,2,10,6,4,2,1
322724,1,0,7,-7,7,0
58646,4,20,17,3,10,0
139794,1,7,3,4,12,0
242046,4,7,9,-2,5,1
208719,1,0,0,0,8,0
218238,1,0,0,0,12,1
263491,3,20,16,4,15,0
339099,2,3,0,3,15,1
33298,4,23,3,20,16,1
338166,1,7,7,0,14,0
85069,4,31,16,15,4,0
210591,2,13,14,-1,9,0
76427,4,29,12,17,1,1
297896,1,3,0,3,13,0
136106,2,0,10,-10,10,1
213687,3,14,17,-3,10,0
68997,3,21,14,7,15,1
322678,4,6,9,-3,7,1
417500,3,24,21,3,16,1
107310,2,3,0,3,15,0
337154,2,3,0,3,14,1
265954,3,0,30,-30,16,0
310496,4,20,9,11,2,1
148009,2,7,3,4,15,1
137323,1,0,0,0,11,0
274045,2,10,0,10,3,1
141432,4,13,20,-7,13,0
329095,3,17,7,10,10,0
279464,1,0,0,0,5,1
42012,1,6,0,6,2,0
341984,3,6,3,3,16,1
250335,3,7,7,0,9,0
361448,1,0,0,0,7,1
242395,4,34,19,15,6,1
211668,2,23,3,20,9,0
180564,4,28,32,-4,13,1
56181,4,27,21,6,9,0
28906,1,0,0,0,14,0
416781,3,10,10,0,15,0
85369,4,28,10,18,5,1
410209,1,7,0,7,13,0
275711,1,0,0,0,3,1
313237,1,0,0,0,3,1
57901,2,10,10,0,10,1
359323,2,3,13,-10,6,1
387303,4,6,10,-4,2,1
103159,1,0,0,0,13,1
404521,4,31,27,4,10,0
144043,1,0,0,0,14,1
194677,4,34,10,24,2,1
335798,1,0,0,0,13,1
211727,4,29,16,13,9,0
25629,1,0,0,0,12,0
27366,3,24,10,14,13,0
328564,1,7,7,0,10,0
197160,3,27,20,7,3,0
255087,4,6,28,-22,12,0
367082,1,7,0,7,10,0
388404,1,0,3,-3,2,1
289184,3,20,10,10,9,0
206989,2,21,0,21,7,0
25594,3,27,10,17,12,1
332954,4,31,3,28,12,1
13210,4,22,26,-4,6,0
148036,3,7,3,4,15,1
274886,3,7,16,-9,3,1
60854,3,17,16,1,11,0
302494,2,3,10,-7,15,0
364925,4,16,23,-7,9,0
288435,4,19,7,12,9,1
188967,1,0,0,0,16,1
360143,2,10,6,4,7,1
32917,1,0,0,0,15,0
135015,1,7,0,7,10,0
339724,2,14,6,8,15,1
69327,4,19,3,16,15,1
299218,1,3,0,3,14,0
328436,2,3,0,3,10,0
16657,3,14,27,-13,8,0
176729,4,39,19,20,11,0
380326,1,7,0,7,16,0
309502,1,0,0,0,1,1
304369,3,28,14,14,16,0
348540,3,28,14,14,2,1
251212,2,10,17,-7,10,1
135922,5,24,24,0,10,0
311612,2,6,0,6,2,0
132249,2,14,7,7,9,0
279513,2,10,6,4,5,1
111120,3,24,10,14,16,1
178698,4,3,20,-17,12,0
215362,3,17,20,-3,11,1
148651,4,10,9,1,16,1
211894,4,36,17,19,9,0
15462,2,6,0,6,8,1
209958,1,0,3,-3,8,1
94154,2,10,7,3,9,0
197698,2,7,3,4,3,0
260862,4,36,15,21,14,1
229206,1,0,0,0,17,1
415772,4,20,17,3,15,1
345418,3,0,10,-10,17,0
170542,2,14,0,14,8,1
208167,2,0,0,0,8,0
236392,4,14,23,-9,3,1
270697,2,3,3,0,1,0
18379,1,0,0,0,9,1
238161,2,3,9,-6,4,0
189194,3,24,3,21,16,1
347220,1,0,0,0,1,1
155838,2,7,10,-3,2,0
405864,1,7,0,7,11,1
334549,2,21,17,4,13,0
242446,2,0,7,-7,6,1
392972,3,9,10,-1,4,1
388722,1,0,0,0,3,1
246869,5,20,23,-3,8,1
412618,2,3,3,0,14,0
148546,1,0,0,0,16,0
276764,2,14,3,11,4,1
214661,4,17,16,1,11,0
323333,2,0,0,0,7,1
170782,4,27,6,21,8,0
373586,4,23,33,-10,13,1
56413,2,0,28,-28,9,1
147465,4,29,10,19,15,0
292051,3,15,12,3,11,0
325955,3,16,7,9,9,1
345346,1,0,7,-7,17,1
411456,2,10,17,-7,13,0
99881,2,0,3,-3,12,1
296457,2,14,0,14,13,1
398568,1,0,0,0,7,1
145119,1,10,0,10,14,0
172919,4,34,24,10,9,1
113380,1,0,0,0,17,0
348259,3,16,39,-23,1,0
336252,2,10,0,10,13,1
375504,3,33,7,26,14,0
262407,2,7,7,0,15,1
407951,4,17,24,-7,11,0
410494,4,15,26,-11,13,1
182482,3,14,0,14,14,1
226310,3,19,7,12,16,0
355172,4,26,26,0,4,1
402900,3,17,9,8,9,1
12971,1,0,0,0,6,0
122196,4,27,28,-1,4,0
366493,1,7,0,7,10,0
127062,4,31,23,8,6,0
119393,1,0,14,-14,3,0
122959,1,0,0,0,4,1
206198,1,0,3,-3,7,0
410580,3,10,7,3,13,1
246831,4,10,20,-10,8,1
157629,4,22,3,19,2,0
34366,1,0,0,0,16,0
199465,1,0,0,0,4,1
96148,2,0,16,-16,10,0
194582,2,14,0,14,2,1
116537,1,0,0,0,2,1
101366,2,6,0,6,12,1
115011,4,13,12,1,1,1
279469,1,7,0,7,5,0
208333,2,14,24,-10,8,1
17239,3,7,34,-27,9,1
278071,4,13,10,3,4,0
245699,2,3,10,-7,7,1
241288,3,10,0,10,5,0
180813,4,10,20,-10,13,1
380220,3,13,16,-3,16,1
302019,1,7,3,4,15,1
40093,4,20,14,6,1,0
242944,4,24,23,1,6,0
261954,2,7,10,-3,14,1
247352,4,49,48,1,8,0
344738,4,13,34,-21,17,0
177542,2,7,0,7,11,1
202528,1,0,3,-3,5,1
388184,4,3,13,-10,2,1
209709,3,9,6,3,8,1
236993,4,45,7,38,3,0
274439,4,10,17,-7,3,1
45200,4,7,10,-3,4,1
218947,4,48,27,21,13,1
100819,3,9,12,-3,12,0
293799,3,17,6,11,12,0
60847,3,17,16,1,11,1
137840,2,10,6,4,11,0
14417,1,14,3,11,7,1
268708,1,0,0,0,17,1
28852,3,22,7,15,14,1
162981,3,6,3,3,5,1
65704,2,0,16,-16,13,1
21318,4,6,14,-8,11,0
230943,4,31,10,21,1,1
250227,4,27,23,4,9,1
414417,3,7,20,-13,14,0
394390,4,31,17,14,5,0
360185,3,17,13,4,7,0
57458,2,7,3,4,10,1
54080,3,10,3,7,8,1
346367,3,6,13,-7,1,1
165980,2,17,14,3,6,0
348048,2,0,10,-10,1,1
155669,2,3,10,-7,2,0
247716,2,7,6,1,8,1
38230,3,13,14,-1,1,1
299287,3,23,7,16,14,1
419213,4,17,6,11,16,0
70450,2,14,17,-3,15,1
210601,2,13,14,-1,9,0
222509,3,9,14,-5,14,0
369348,4,21,20,1,11,0
401337,1,0,0,0,8,1
365756,3,17,17,0,9,1
296682,4,10,16,-6,13,0
177988,2,7,6,1,12,0
350164,2,8,0,8,2,1
398084,3,21,28,-7,7,1
129817,1,7,0,7,7,1
294302,1,7,0,7,12,1
189544,1,0,0,0,17,0
276881,1,0,0,0,4,1
417704,4,35,12,23,16,0
293255,3,23,7,16,11,1
165810,2,3,6,-3,6,1
278673,4,17,9,8,4,0
41363,3,14,12,2,2,0
116834,1,7,0,7,2,1
219567,4,21,24,-3,13,1
321428,2,14,17,-3,7,0
130362,3,7,3,4,8,0
107342,3,9,6,3,15,1
21537,2,7,7,0,11,0
52375,3,6,17,-11,7,1
417475,2,10,14,-4,16,0
177626,4,24,20,4,11,0
11802,2,20,3,17,6,0
271456,3,14,0,14,1,0
368446,4,30,14,16,11,0
101738,3,13,7,6,12,0
194443,2,9,0,9,2,1
318310,3,9,13,-4,5,1
309418,3,0,3,-3,1,1
241502,1,0,0,0,5,0
183822,3,20,21,-1,14,1
186429,2,10,7,3,15,0
111373,2,0,7,-7,16,1
327452,4,10,27,-17,9,1
228269,4,17,30,-13,17,1
312512,2,20,0,20,3,0
248341,3,24,10,14,8,1
78821,1,0,0,0,2,0
116057,4,16,7,9,1,0
270026,4,22,23,-1,1,0
10643,3,7,17,-10,5,1
394841,1,0,7,-7,5,0
4528,3,17,19,-2,2,1
379582,2,13,6,7,16,1
254255,2,6,6,0,11,1
47592,4,49,6,43,5,0
29603,3,14,13,1,14,1
72747,1,7,0,7,16,1
37872,1,0,0,0,1,0
17606,4,20,17,3,9,0
294533,3,17,13,4,12,1
339165,4,23,13,10,15,0
31753,2,0,10,-10,15,0
167555,4,3,10,-7,7,0
72872,1,0,0,0,16,1
198380,4,20,14,6,3,1
3852,1,13,0,13,2,0
394122,1,7,7,0,5,0
176909,1,0,0,0,11,0
199553,3,20,10,10,4,0
18714,2,3,7,-4,9,0
84193,4,17,10,7,4,1
267876,4,26,24,2,17,1
160106,1,0,0,0,3,1
150973,4,22,14,8,17,0
93778,4,3,16,-13,9,0
406663,2,14,0,14,11,0
319892,1,0,0,0,6,0
367892,4,20,20,0,10,1
292012,2,6,3,3,11,0
357909,4,13,34,-21,6,0
5845,4,27,7,20,3,0
241201,1,0,0,0,5,0
51291,2,6,3,3,7,0
332951,4,31,3,28,12,1
59332,2,0,6,-6,11,1
339923,4,33,0,33,15,0
384712,3,13,23,-10,1,1
150639,4,10,22,-12,17,0
408842,4,16,28,-12,12,1
2134,3,10,16,-6,1,1
98380,1,0,7,-7,11,0
56047,5,24,23,1,9,0
327397,2,0,14,-14,9,1
244523,3,25,13,12,7,1
173076,4,24,19,5,9,1
234155,2,3,7,-4,2,1
186851,4,29,20,9,15,1
327721,3,6,13,-7,10,1
31875,1,6,0,6,15,0
357055,1,6,7,-1,5,0
64329,3,6,20,-14,13,1
64275,1,0,3,-3,13,1
205160,2,7,10,-3,6,1
114642,2,3,3,0,1,0
263979,4,23,7,16,15,1
366834,2,0,3,-3,10,1
46675,4,10,3,7,4,1
376474,1,0,3,-3,14,1
28389,3,13,3,10,14,0
413830,2,14,0,14,14,0
56392,1,0,21,-21,9,1
94691,4,24,35,-11,9,0
376808,2,14,7,7,15,0
236730,4,30,7,23,3,0
317111,4,20,20,0,4,0
238266,4,10,24,-14,4,0
180640,3,17,6,11,13,1
391471,4,10,27,-17,4,0
323491,2,3,10,-7,7,1
382517,2,0,3,-3,17,0
225542,4,8,24,-16,15,1
250629,2,3,9,-6,10,1
264177,4,34,27,7,15,0
166575,2,15,7,8,6,0
342867,2,16,7,9,16,1
398941,4,16,10,6,7,0
265921,2,0,16,-16,16,1
41763,2,7,7,0,2,1
101215,2,7,7,0,12,0
299155,3,10,16,-6,14,1
6638,1,0,10,-10,3,0
391846,2,10,3,7,4,1
301148,2,10,3,7,15,1
404772,2,10,6,4,10,0
106459,3,16,0,16,14,0
109948,1,0,0,0,16,1
45188,3,7,10,-3,4,1
198617,2,0,7,-7,3,0
149432,4,13,27,-14,16,0
229684,2,10,7,3,17,0
293087,4,10,19,-9,11,0
71635,3,3,31,-28,16,1
260296,1,0,0,0,14,1
76145,1,9,3,6,1,0
339601,3,24,14,10,15,0
167498,2,0,3,-3,7,0
128036,1,0,3,-3,7,1
38814,3,3,10,-7,1,0
372064,4,13,10,3,13,1
100289,1,6,7,-1,12,1
17218,3,7,31,-24,9,1
59868,5,15,16,-1,11,0
351295,1,0,0,0,3,1
389515,3,20,10,10,3,0
55071,2,13,3,10,8,1
336552,2,0,0,0,14,0
185799,4,25,3,22,15,0
197454,3,13,6,7,3,0
75925,3,32,7,25,1,1
139417,3,24,0,24,12,1
317493,2,10,10,0,5,0
184561,4,42,14,28,14,0
317846,3,9,10,-1,5,1
191253,3,7,17,-10,17,1
69663,1,0,7,-7,15,1
65950,4,24,21,3,13,1
232449,1,3,0,3,1,0
43901,1,0,0,0,3,1
294173,1,0,7,-7,12,0
306495,4,17,17,0,17,0
217753,3,10,7,3,12,1
201315,2,28,3,25,5,0
165226,2,7,7,0,6,1
414974,2,10,7,3,15,1
59714,1,0,0,0,11,0
191787,1,0,0,0,1,1
207153,2,7,10,-3,7,0
136382,1,0,0,0,11,0
292292,2,6,10,-4,11,1
381999,3,0,23,-23,17,0
203576,1,0,0,0,6,1
206589,3,10,13,-3,7,1
197490,4,20,9,11,3,0
381614,1,0,0,0,17,1
401769,4,27,14,13,8,0
380766,2,3,7,-4,16,0
3197,4,16,9,7,2,1
326237,3,10,41,-31,9,1
209808,1,7,7,0,8,0
261591,4,12,15,-3,14,1
282777,2,0,10,-10,6,1
233165,3,29,3,26,2,1
107087,3,40,6,34,15,1
123978,3,10,7,3,5,1
254224,1,0,0,0,11,1
239407,2,6,10,-4,4,0
207489,4,21,14,7,7,1
327097,2,7,0,7,9,0
29121,2,0,9,-9,14,0
168254,1,7,7,0,7,1
357241,2,3,3,0,5,1
55741,4,23,29,-6,9,0
315866,4,9,19,-10,4,1
161038,4,30,7,23,4,0
228761,1,0,7,-7,17,0
371159,2,0,12,-12,12,1
4859,1,13,0,13,3,1
325123,1,10,7,3,8,0
204336,4,0,17,-17,6,1
261025,1,0,0,0,14,0
61084,1,0,0,0,11,0
76836,4,33,0,33,1,0
195727,4,17,16,1,2,0
119364,1,0,0,0,3,1
344156,4,27,9,18,17,0
76585,1,0,0,0,1,1
52522,3,10,0,10,7,0
308205,1,7,7,0,1,0
179864,2,3,9,-6,13,1
181146,4,24,14,10,13,1
390331,1,0,7,-7,3,0
61102,2,0,7,-7,11,0
240482,3,3,7,-4,5,1
66940,4,12,7,5,14,1
243446,3,3,17,-14,6,0
213859,3,48,7,41,10,1
88264,1,7,0,7,6,0
389322,2,7,6,1,3,1
46569,1,0,0,0,4,1
43498,2,7,0,7,3,0
312841,3,7,0,7,3,1
330630,1,0,0,0,11,0
340377,3,17,13,4,15,0
137499,1,7,7,0,11,1
406770,1,0,10,-10,11,1
60146,4,34,19,15,11,0
305339,1,6,0,6,17,1
269552,4,21,31,-10,1,1
95697,3,10,9,1,10,1
333899,1,0,0,0,12,0
207453,3,14,14,0,7,0
310245,1,3,0,3,2,0
207121,1,7,0,7,7,0
78979,2,0,7,-7,2,1
42066,3,20,10,10,2,1
196943,1,7,0,7,3,1
315456,1,0,0,0,4,0
181677,1,0,0,0,13,0
122645,4,36,14,22,4,1
80212,3,21,24,-3,2,0
150332,3,24,7,17,16,1
252537,4,29,25,4,10,0
379567,2,13,6,7,16,0
115214,1,0,0,0,1,0
356656,2,13,3,10,5,1
237701,4,20,14,6,4,0
212421,1,10,0,10,10,0
159380,2,7,10,-3,3,0
369374,1,3,0,3,11,1
210405,1,9,0,9,9,0
82466,2,7,14,-7,3,0
269697,4,10,12,-2,1,0
147222,2,0,21,-21,15,1
369552,2,14,0,14,11,0
2984,2,10,17,-7,2,1
142209,5,11,13,-2,13,0
291832,1,0,7,-7,11,1
386214,3,9,10,-1,2,0
201681,3,17,20,-3,5,0
34554,2,7,0,7,16,1
42993,4,38,30,8,3,1
11292,4,17,28,-11,6,0
120310,4,24,13,11,3,1
388282,2,3,3,0,2,1
149305,4,20,27,-7,16,0
342039,4,20,3,17,16,0
341007,1,0,0,0,15,1
325436,2,13,3,10,8,0
19604,3,17,21,-4,10,1
109200,1,0,0,0,15,1
340848,4,24,25,-1,15,0
395475,2,7,0,7,6,1
382043,1,0,0,0,17,1
229194,1,0,0,0,17,1
149281,3,13,20,-7,16,0
354738,1,6,0,6,4,0
368944,1,6,7,-1,11,1
149296,4,13,27,-14,16,0
280942,4,21,13,8,6,0
140935,4,20,13,7,13,0
17065,2,13,0,13,9,0
316266,2,7,16,-9,4,0
300211,4,28,3,25,14,1
124126,3,10,21,-11,5,1
92651,1,0,0,0,8,0
182700,4,14,19,-5,14,0
391476,4,10,30,-20,4,1
72099,4,10,17,-7,16,0
335665,1,7,0,7,13,1
61164,4,0,14,-14,11,0
115257,2,0,9,-9,1,1
297605,1,0,0,0,13,1
332296,2,3,6,-3,12,1
275007,2,24,3,21,3,0
5685,3,0,17,-17,3,0
183732,4,34,20,14,14,1
346301,1,0,0,0,1,0
2803,2,21,14,7,2,0
3686,1,0,0,0,2,1
245503,1,7,0,7,7,1
244679,3,7,23,-16,7,1
208714,1,0,0,0,8,1
657,2,0,10,-10,1,1
327928,1,0,0,0,10,0
227476,3,16,10,6,16,1
225343,2,10,21,-11,15,0
181980,2,7,0,7,13,1
386909,2,7,7,0,2,0
229454,4,13,6,7,17,0
134478,3,3,23,-20,10,0
201815,3,13,23,-10,5,1
358246,2,0,14,-14,6,1
272932,4,20,23,-3,2,1
315583,4,7,14,-7,4,0
375965,3,20,12,8,14,0
340863,1,0,0,0,15,1
191221,2,0,17,-17,17,1
43143,1,0,0,0,3,0
140776,3,22,21,1,12,0
111911,1,0,7,-7,17,0
2399,2,20,13,7,2,1
209289,1,0,0,0,8,1
297178,1,0,0,0,13,0
10992,4,9,28,-19,5,0
74784,2,3,3,0,17,1
301398,4,17,16,1,15,1
342066,1,3,0,3,16,0
337176,2,3,3,0,14,0
123596,1,0,0,0,4,0
356082,4,34,10,24,5,0
367667,2,0,3,-3,10,1
343308,1,0,10,-10,16,1
90877,2,31,0,31,7,1
394982,1,0,0,0,5,1
64950,4,10,6,4,13,1
20013,2,16,6,10,10,1
177295,4,17,20,-3,11,0
346170,2,14,0,14,1,0
412315,2,7,7,0,13,0
304136,1,0,0,0,16,0
318117,2,9,7,2,5,1
277973,1,0,0,0,4,0
113517,4,3,7,-4,17,1
73087,3,7,10,-3,16,0
334356,2,0,3,-3,13,1
66752,2,7,3,4,14,0
258615,4,13,13,0,13,0
310333,3,26,0,26,2,1
26401,2,10,3,7,13,1
145893,2,0,0,0,15,0
13199,4,22,26,-4,6,0
241727,3,7,9,-2,5,1
65004,2,0,14,-14,13,1
196979,2,20,7,13,3,0
84294,3,7,24,-17,4,0
156184,3,14,10,4,2,1
124432,3,6,7,-1,5,1
82673,4,12,13,-1,3,0
349043,4,17,17,0,2,0
368128,2,10,7,3,11,1
192475,2,0,17,-17,1,1
280572,3,17,6,11,5,0
348705,3,17,10,7,2,1
35482,2,21,7,14,17,1
286609,4,17,38,-21,8,0
361956,3,10,3,7,7,0
404369,4,20,6,14,10,0
97218,3,9,6,3,10,1
271020,3,18,21,-3,1,0
115247,2,0,9,-9,1,1
151602,2,0,10,-10,17,1
100072,3,6,3,3,12,0
402413,2,14,7,7,9,1
45809,4,13,14,-1,4,1
51332,3,16,17,-1,7,0
197553,2,10,0,10,3,0
326638,2,16,6,10,9,0
311949,3,34,10,24,2,1
53697,2,0,0,0,8,1
309120,2,16,3,13,1,1
25942,1,3,0,3,13,0
243437,3,3,17,-14,6,1
71325,3,10,20,-10,16,1
286490,1,0,0,0,8,1
314937,3,0,10,-10,4,1
47167,2,6,0,6,5,0
42509,3,10,12,-2,3,1
32576,4,27,13,14,15,0
392201,3,10,13,-3,4,0
298326,1,0,0,0,14,0
114589,1,3,0,3,1,0
376150,4,3,16,-13,14,0
420236,4,6,13,-7,17,0
275574,1,14,0,14,3,0
401128,3,27,13,14,8,1
312184,1,0,7,-7,2,1
109429,3,6,10,-4,16,0
363569,4,3,12,-9,8,0
244440,4,3,20,-17,7,0
273794,3,10,7,3,2,0
366705,2,24,10,14,10,0
2474,4,28,20,8,2,0
74841,3,20,13,7,17,0
176456,1,0,10,-10,11,1
250296,2,7,0,7,9,0
23132,1,6,0,6,11,0
37150,1,0,0,0,17,1
360091,4,10,40,-30,7,0
227502,4,19,17,2,16,0
139646,1,0,0,0,12,1
122702,2,7,10,-3,4,1
395866,4,10,17,-7,6,0
73304,1,7,0,7,17,0
155621,4,30,24,6,2,1
50208,1,7,7,0,6,1
230577,3,13,10,3,1,0
96082,4,16,21,-5,10,1
210832,1,0,0,0,9,1
89639,1,3,3,0,7,0
126273,4,35,9,26,6,0
319118,1,0,0,0,5,0
93186,3,0,3,-3,9,0
242047,4,7,9,-2,5,1
21880,3,21,0,21,11,1
1584,4,16,20,-4,1,1
317616,2,3,3,0,5,1
265064,2,13,3,10,16,0
258348,4,41,39,2,13,1
160831,3,33,17,16,4,1
350929,3,6,14,-8,3,0
84119,1,7,0,7,4,1
408488,3,7,10,-3,12,1
308224,2,7,10,-3,1,1
342820,1,7,0,7,16,0
26890,2,10,6,4,13,0
327045,4,14,10,4,9,0
304242,4,33,14,19,16,0
222358,3,21,3,18,14,0
257473,1,0,3,-3,13,0
162662,3,16,10,6,5,0
403267,1,0,0,0,9,1
270720,3,6,3,3,1,1
385688,5,27,27,0,1,1
389764,2,10,3,7,3,0
165732,4,14,7,7,6,1
200641,4,27,28,-1,4,0
364640,1,0,0,0,9,1
103277,4,3,10,-7,13,1
81603,4,30,24,6,3,0
172657,1,7,0,7,9,0
847,4,14,12,2,1,1
261545,3,12,7,5,14,0
99161,2,3,3,0,11,0
338353,2,3,0,3,14,1
231210,4,10,16,-6,1,1
372717,1,0,0,0,13,1
345429,3,0,13,-13,17,0
357149,4,6,14,-8,5,1
125301,2,10,3,7,5,1
45789,3,13,14,-1,4,0
177280,4,14,17,-3,11,0
198661,3,15,21,-6,3,0
209389,3,14,7,7,8,0
314814,3,28,7,21,4,1
262489,4,14,35,-21,15,0
205611,1,7,3,4,7,0
254011,2,0,13,-13,11,1
140880,2,17,7,10,13,0
258735,3,3,27,-24,13,1
177071,2,10,3,7,11,0
43823,3,14,16,-2,3,1
311852,1,0,0,0,2,0
20083,4,22,16,6,10,1
113433,2,0,7,-7,17,1
330032,1,0,0,0,11,0
7838,1,0,7,-7,4,0
286086,3,10,3,7,8,0
119476,3,14,17,-3,3,0
186329,3,26,10,16,15,1
67934,4,22,3,19,14,1
260714,4,13,32,-19,14,1
34697,2,3,3,0,16,1
156974,3,7,13,-6,2,1
363085,2,7,3,4,8,1
197475,3,13,9,4,3,1
263433,2,3,13,-10,15,1
344705,3,6,26,-20,17,0
286827,1,3,7,-4,8,1
308773,4,18,20,-2,1,0
104430,1,0,7,-7,13,1
129611,4,13,23,-10,7,1
213602,1,0,0,0,10,0
198872,1,0,6,-6,3,0
416099,4,21,13,8,15,0
65198,4,3,10,-7,13,1
393784,1,0,0,0,5,1
227397,1,0,7,-7,16,1
350775,3,10,3,7,2,1
313971,1,0,0,0,3,1
10032,2,21,0,21,5,0
37674,3,30,0,30,17,0
90633,3,17,30,-13,7,1
346410,4,9,13,-4,1,1
153980,2,7,7,0,1,0
254544,1,0,0,0,11,1
189503,4,17,0,17,17,1
335643,4,19,10,9,13,0
96536,1,0,0,0,10,1
102884,1,0,7,-7,13,0
222421,1,0,0,0,14,1
223144,4,40,30,10,14,1
184162,4,16,17,-1,14,1
142859,1,0,0,0,13,0
97459,1,6,0,6,10,1
74255,3,9,10,-1,17,1
417631,2,14,3,11,16,0
52473,1,3,0,3,7,1
210931,4,19,10,9,9,0
105722,3,35,3,32,14,0
358460,4,32,27,5,6,1
391161,3,10,24,-14,4,0
230308,3,19,10,9,17,0
87806,1,3,0,3,6,0
46943,4,20,33,-13,5,1
297006,4,32,14,18,13,1
78132,2,14,3,11,2,1
386893,1,7,0,7,2,0
268341,3,20,3,17,17,0
75722,2,21,10,11,1,1
214749,2,3,10,-7,11,0
406565,4,20,30,-10,11,0
45118,1,7,0,7,4,0
74611,1,0,0,0,17,0
397238,4,16,0,16,6,0
347912,2,0,14,-14,1,1
414962,2,10,7,3,15,0
140981,1,7,0,7,13,0
264414,3,3,21,-18,15,0
103375,3,10,17,-7,13,0
112697,2,3,0,3,17,0
380421,4,10,24,-14,16,1
145856,1,0,0,0,15,1
72178,2,3,10,-7,16,1
123969,3,10,7,3,5,1
208438,1,7,0,7,8,1
378106,1,14,0,14,15,0
57096,4,21,27,-6,9,1
161997,1,7,0,7,4,0
390739,4,13,17,-4,3,0
301570,1,7,0,7,15,0
373703,3,6,18,-12,13,1
151446,2,21,6,15,17,0
293660,2,10,7,3,12,1
130606,1,7,7,0,8,0
305347,1,7,0,7,17,0
401882,4,14,28,-14,9,1
228344,2,7,14,-7,17,0
94743,1,0,0,0,9,1
304479,2,0,7,-7,16,0
163807,4,17,12,5,5,0
27095,4,17,9,8,13,0
359998,2,3,25,-22,7,0
91476,2,12,0,12,8,1
10356,3,10,35,-25,5,1
390158,4,20,35,-15,3,0
318565,2,10,0,10,5,0
129915,4,13,0,13,7,1
96357,4,3,30,-27,10,1
238773,1,7,0,7,4,1
281379,4,28,13,15,6,0
70221,4,30,30,0,15,0
6492,2,0,0,0,3,1
110192,4,23,30,-7,16,0
413626,4,17,24,-7,14,1
252294,2,0,13,-13,10,1
406396,3,17,7,10,11,0
149324,4,20,27,-7,16,1
33607,5,17,16,1,16,0
397077,4,24,16,8,6,0
255277,4,13,17,-4,12,1
125311,2,10,3,7,5,1
16639,3,7,27,-20,8,1
379897,3,14,0,14,16,0
147800,1,0,7,-7,15,0
178970,3,12,3,9,12,1
247106,2,13,3,10,8,0
310201,4,24,10,14,2,1
91500,3,19,3,16,8,1
279900,4,24,13,11,5,1
68117,4,3,10,-7,14,1
252056,4,14,20,-6,10,0
106231,5,10,10,0,14,1
192562,4,33,17,16,1,0
52977,3,14,17,-3,7,0
220851,3,7,28,-21,14,1
254679,1,0,0,0,11,0
313546,2,0,10,-10,3,1
405229,2,7,7,0,10,1
335248,1,0,0,0,13,0
220981,3,14,10,4,14,1
404795,3,17,13,4,10,1
416162,2,10,9,1,15,0
115309,4,17,15,2,1,1
36614,2,3,3,0,17,0
267782,1,3,0,3,17,0
175541,2,20,0,20,11,1
166054,4,20,31,-11,6,1
65919,3,17,14,3,13,1
301211,3,20,14,6,15,0
119484,4,14,17,-3,3,1
346938,1,0,3,-3,1,0
46501,3,27,6,21,4,1
49724,4,28,31,-3,6,1
353844,2,7,14,-7,4,0
297337,2,3,10,-7,13,1
304390,4,31,21,10,16,0
320184,4,17,20,-3,6,1
58637,4,19,17,2,10,1
398069,3,21,21,0,7,0
4938,3,14,17,-3,3,0
4260,4,13,6,7,2,1
161530,1,0,0,0,4,0
420205,4,3,10,-7,17,1
187913,1,0,0,0,16,0
105514,2,26,13,13,14,0
393772,4,7,14,-7,5,1
123006,3,0,13,-13,4,0
292255,1,0,7,-7,11,1
67751,3,21,0,21,14,1
90755,3,17,7,10,7,1
131802,1,7,0,7,8,1
41211,3,7,13,-6,2,0
338860,3,13,14,-1,15,1
326420,1,0,0,0,9,0
96489,3,17,23,-6,10,0
394915,3,0,17,-17,5,0
262337,4,13,15,-2,15,0
226965,1,3,0,3,16,0
153061,1,0,7,-7,1,0
238458,1,3,0,3,4,1
143928,2,0,3,-3,14,0
117835,3,9,13,-4,2,1
8157,1,0,7,-7,4,0
252034,3,14,20,-6,10,0
74990,3,20,17,3,17,1
92828,1,14,0,14,8,1
263470,3,13,13,0,15,1
198864,1,0,6,-6,3,1
117395,4,34,10,24,2,1
229931,4,29,20,9,17,1
175891,3,20,27,-7,11,1
364764,4,12,6,6,9,0
337666,3,24,13,11,14,0
175167,4,35,17,18,10,1
31869,1,3,0,3,15,1
13405,1,3,13,-10,7,0
235735,3,3,20,-17,3,1
29461,3,10,14,-4,14,0
58436,3,41,10,31,10,1
405341,4,17,12,5,10,0
76611,2,7,0,7,1,0
288831,2,10,17,-7,9,0
345295,4,19,17,2,17,0
275365,4,10,22,-12,3,1
133335,3,14,6,8,9,0
148476,3,14,3,11,16,1
180825,4,17,20,-3,13,0
292910,3,7,0,7,11,1
163539,2,7,3,4,5,0
281407,1,0,3,-3,6,0
388436,2,0,6,-6,2,0
185166,4,0,23,-23,15,1
270840,2,9,7,2,1,0
250929,2,3,6,-3,10,1
387693,2,0,13,-13,2,1
164287,1,6,0,6,5,0
158377,3,16,17,-1,3,1
23692,4,9,27,-18,12,1
103893,1,0,0,0,13,0
317576,1,0,0,0,5,1
30201,4,13,17,-4,14,0
394328,3,24,10,14,5,0
164286,1,6,0,6,5,0
335047,4,16,13,3,13,0
366099,1,0,7,-7,10,1
421904,4,21,26,-5,17,1
207862,2,7,0,7,8,0
154407,1,0,0,0,1,1
33869,4,9,41,-32,16,0
136467,3,17,13,4,11,0
35376,4,23,16,7,16,0
90463,3,0,13,-13,7,0
413944,1,3,7,-4,14,0
240022,3,10,20,-10,5,1
167299,1,3,10,-7,7,1
253692,2,3,3,0,11,0
245750,3,16,10,6,7,0
264743,2,10,16,-6,16,0
67183,2,0,0,0,14,0
91818,3,24,0,24,8,0
81807,1,0,7,-7,3,1
273272,1,7,0,7,2,0
255762,1,0,0,0,12,1
121824,2,0,7,-7,4,0
242735,2,7,14,-7,6,1
272491,1,7,0,7,2,1
4148,1,0,0,0,2,0
387470,4,21,16,5,2,0
319357,4,16,28,-12,6,1
326099,3,30,3,27,9,0
29884,3,16,23,-7,14,0
419860,2,3,6,-3,17,0
296251,1,0,0,0,13,0
81574,3,17,24,-7,3,0
207084,4,38,10,28,7,0
4963,4,21,17,4,3,1
270493,1,0,0,0,1,0
317632,2,3,3,0,5,1
241747,4,7,9,-2,5,0
214521,1,0,0,0,11,0
384144,3,7,20,-13,1,1
30877,2,3,14,-11,15,1
105102,3,26,14,12,14,0
201521,3,32,7,25,5,0
36412,4,27,26,1,17,1
80768,2,3,0,3,3,1
158480,2,3,7,-4,3,1
73998,4,37,0,37,17,1
419450,2,10,6,4,16,1
213716,4,24,17,7,10,0
30320,3,3,10,-7,14,0
69667,1,0,7,-7,15,0
113129,2,28,0,28,17,0
384892,4,13,22,-9,1,0
46024,2,14,7,7,4,0
204150,3,10,10,0,6,0
139006,4,14,9,5,12,0
380082,4,35,20,15,16,0
219761,1,21,0,21,13,0
298527,2,10,0,10,14,1
365486,4,10,19,-9,9,1
377450,4,7,13,-6,15,1
203028,2,17,3,14,5,1
33745,1,0,0,0,16,1
213169,1,3,0,3,10,0
146492,1,7,6,1,15,0
223193,2,3,0,3,15,0
343080,3,12,13,-1,16,0
77004,4,17,20,-3,1,0
289468,2,3,7,-4,10,1
190242,2,7,7,0,17,0
90420,2,0,13,-13,7,1
237687,3,20,14,6,4,1
403637,3,24,20,4,9,1
31972,4,16,13,3,15,1
70644,4,17,20,-3,15,0
46601,2,3,0,3,4,0
6629,1,0,0,0,3,0
267682,2,7,24,-17,17,1
279943,1,0,10,-10,5,1
318015,4,17,13,4,5,0
44889,3,7,30,-23,4,0
227560,1,14,0,14,16,1
331898,3,0,9,-9,12,0
21906,4,34,3,31,11,1
235520,2,0,13,-13,3,1
313604,3,18,23,-5,3,1
51260,1,3,0,3,7,1
201927,2,0,0,0,5,1
234867,4,3,12,-9,2,0
16258,3,6,16,-10,8,1
276261,4,31,17,14,3,1
720,4,6,24,-18,1,1
10317,2,7,14,-7,5,1
248773,3,27,14,13,9,0
17634,1,7,3,4,9,0
60323,1,3,0,3,11,1
75094,2,7,6,1,17,1
371615,3,16,17,-1,12,1
227729,2,3,7,-4,16,1
314484,2,14,0,14,3,1
119501,4,14,24,-10,3,1
182580,1,0,3,-3,14,1
325037,3,20,24,-4,8,1
61333,1,0,0,0,11,0
203398,4,27,33,-6,6,0
238838,3,34,0,34,4,0
129883,3,13,0,13,7,0
391033,4,27,34,-7,4,1
302620,2,10,3,7,15,1
94481,2,0,0,0,9,1
134188,2,0,17,-17,10,0
84195,4,17,10,7,4,1
342224,1,3,0,3,16,1
344970,3,10,14,-4,17,0
107520,4,3,23,-20,15,1
22214,4,10,15,-5,11,1
149927,1,7,0,7,16,0
292002,2,6,3,3,11,1
251494,2,16,3,13,10,0
48169,4,10,13,-3,5,0
345600,4,14,23,-9,17,1
357743,4,43,13,30,5,0
259164,3,14,13,1,13,1
342388,2,0,3,-3,16,0
255733,1,0,0,0,12,0
193368,2,7,10,-3,1,0
219651,3,10,7,3,13,1
363299,4,27,14,13,8,1
303021,4,23,19,4,16,1
213387,3,10,27,-17,10,1
394883,2,0,17,-17,5,1
228127,4,20,10,10,17,1
172073,2,10,3,7,9,0
135213,2,13,3,10,10,0
166909,3,10,6,4,6,1
198427,2,3,3,0,3,1
152663,3,10,6,4,17,1
407595,3,10,17,-7,11,1
242960,4,24,31,-7,6,1
373298,1,0,0,0,13,1
196550,3,17,6,11,2,0
49848,4,21,16,5,6,0
238565,4,16,20,-4,4,1
347241,1,0,0,0,1,1
113195,4,41,16,25,17,0
407913,3,9,24,-15,11,1
191887,4,29,10,19,1,0
134581,2,10,3,7,10,1
203312,2,7,24,-17,6,0
182563,1,0,0,0,14,0
271927,3,17,20,-3,2,1
93513,4,3,31,-28,9,1
104281,2,17,7,10,13,1
235407,2,28,14,14,3,0
17195,2,7,21,-14,9,1
420278,2,7,0,7,17,0
14779,3,31,3,28,7,1
209380,3,14,7,7,8,0
19714,2,3,6,-3,10,1
45953,4,17,3,14,4,1
113074,4,16,23,-7,17,1
22300,2,0,3,-3,11,0
380081,4,35,20,15,16,0
119204,4,16,10,6,3,1
378874,2,10,13,-3,15,1
90044,4,11,21,-10,7,1
51807,4,10,22,-12,7,1
316416,2,13,3,10,4,0
174545,3,10,14,-4,10,1
29586,3,7,13,-6,14,1
89484,1,0,0,0,7,0
129268,4,17,13,4,7,0
16188,1,0,0,0,8,1
386074,3,14,3,11,1,1
393879,3,13,17,-4,5,1
217567,2,3,9,-6,12,1
371297,2,14,10,4,12,0
8090,3,24,13,11,4,0
68217,3,10,14,-4,14,1
100056,2,6,3,3,12,0
400322,1,3,0,3,8,0
370351,4,20,35,-15,12,1
11528,3,6,10,-4,6,1
134435,2,0,14,-14,10,1
246955,3,20,10,10,8,0
260961,3,10,0,10,14,0
173502,3,9,20,-11,10,1
262517,4,28,35,-7,15,1
349658,1,0,0,0,2,1
14517,4,34,36,-2,7,1
102626,2,12,6,6,13,1
2285,3,10,10,0,1,0
52644,2,3,7,-4,7,0
213008,1,0,0,0,10,1
299355,4,28,16,12,14,0
218727,2,0,10,-10,13,1
345581,3,14,20,-6,17,0
70733,2,7,10,-3,15,0
70545,1,0,7,-7,15,1
133337,3,14,6,8,9,0
126147,1,0,0,0,6,0
73449,1,0,7,-7,17,0
391812,1,3,0,3,4,1
266340,2,10,0,10,16,0
316648,4,12,12,0,4,0
49479,1,0,0,0,6,0
113844,1,0,0,0,17,1
12927,5,13,13,0,6,1
407594,3,10,17,-7,11,1
380422,4,10,24,-14,16,1
265024,1,7,0,7,16,0
128078,3,3,6,-3,7,0
182261,1,7,0,7,14,0
397322,3,0,24,-24,6,0
218868,2,14,3,11,13,1
266142,1,0,0,0,16,1
34917,3,27,24,3,16,1
290503,2,14,7,7,10,1
27497,3,20,9,11,13,0
143390,3,7,26,-19,14,1
317740,5,23,23,0,5,1
122739,3,7,17,-10,4,1
66900,2,6,7,-1,14,1
382344,1,0,0,0,17,0
270536,2,3,7,-4,1,1
353907,3,17,28,-11,4,0
358115,2,17,0,17,6,0
232342,3,6,12,-6,1,0
410985,1,6,7,-1,13,1
6279,3,13,17,-4,3,1
358748,3,14,17,-3,6,0
304152,1,0,0,0,16,1
57663,3,17,17,0,10,1
173610,2,0,13,-13,10,1
372724,1,0,0,0,13,0
111640,2,14,10,4,16,1
342846,2,10,0,10,16,1
123137,2,3,7,-4,4,1
194154,2,3,3,0,1,0
16846,4,26,38,-12,8,1
311698,4,12,9,3,2,1
197839,1,6,0,6,3,0
204203,4,24,27,-3,6,1
301275,1,7,0,7,15,0
278391,4,17,24,-7,4,1
220835,3,7,20,-13,14,0
2705,3,6,7,-1,2,1
45021,3,13,10,3,4,1
49988,3,21,7,14,6,0
323262,4,7,17,-10,7,1
271404,2,7,0,7,1,0
306238,4,30,3,27,17,0
3504,4,17,30,-13,2,0
243619,3,20,14,6,6,1
136605,3,15,16,-1,11,0
337969,4,23,0,23,14,0
300210,4,28,3,25,14,1
204638,4,10,45,-35,6,1
51687,1,0,0,0,7,1
78213,4,48,3,45,2,1
89771,1,0,0,0,7,1
89703,3,9,17,-8,7,0
186616,2,17,3,14,15,1
62499,4,13,16,-3,12,0
56394,1,0,21,-21,9,1
62580,2,3,10,-7,12,1
328946,3,9,7,2,10,0
180809,4,10,20,-10,13,1
228718,4,19,30,-11,17,1
131548,3,9,16,-7,8,1
416171,2,10,9,1,15,0
156648,3,3,7,-4,2,1
354311,2,14,3,11,4,1
366254,2,7,10,-3,10,1
50916,4,17,24,-7,6,0
61565,3,28,7,21,11,1
76956,3,17,13,4,1,1
125146,2,14,7,7,5,1
314698,4,17,28,-11,3,1
382583,4,0,24,-24,17,1
328751,2,14,6,8,10,1
136618,3,15,16,-1,11,0
397960,4,10,24,-14,7,0
214351,1,0,0,0,11,0
34482,4,41,3,38,16,1
111206,2,7,3,4,16,1
165886,4,6,19,-13,6,0
308006,4,21,12,9,1,1
54498,2,7,7,0,8,1
44249,2,17,13,4,3,0
114226,3,3,14,-11,1,1
201716,4,30,20,10,5,0
66173,2,17,3,14,13,0
403169,2,10,14,-4,9,1
340749,1,7,7,0,15,1
272612,4,16,9,7,2,1
379653,4,26,13,13,16,0
341896,4,30,15,15,16,1
315693,4,10,13,-3,4,0
132613,4,20,49,-29,9,0
411019,2,14,14,0,13,1
209364,2,7,7,0,8,1
224817,4,11,10,1,15,1
298212,2,7,3,4,14,1
249988,2,7,3,4,9,0
4069,2,13,21,-8,2,1
274032,1,0,0,0,3,1
342508,1,0,0,0,16,0
241600,4,6,27,-21,5,1
306829,1,0,3,-3,17,1
75337,4,21,33,-12,17,0
48566,2,14,14,0,5,0
120017,4,23,38,-15,3,1
326344,2,7,10,-3,9,0
152061,2,3,7,-4,17,0
190644,2,14,7,7,17,1
251039,1,0,0,0,10,0
207690,1,0,7,-7,7,1
306773,3,16,33,-17,17,1
400456,4,24,10,14,8,0
351105,4,29,30,-1,3,1
150625,3,10,22,-12,17,1
82293,2,3,3,0,3,0
288408,3,13,0,13,9,0
105036,2,0,14,-14,14,1
1825,3,16,7,9,1,0
288394,3,10,0,10,9,0
361270,4,21,29,-8,7,0
43294,1,0,0,0,3,0
134210,3,3,17,-14,10,0
417612,2,14,0,14,16,0
38090,3,6,6,0,1,0
408741,2,10,7,3,12,0
106492,4,29,9,20,14,1
233684,1,7,7,0,2,1
265202,2,6,3,3,16,0
239272,2,3,7,-4,4,0
289678,4,13,23,-10,10,1
420885,1,0,0,0,17,1
247511,1,3,0,3,8,0
129623,4,16,23,-7,7,1
362635,2,0,7,-7,8,0
169557,4,10,41,-31,8,1
1172,1,0,0,0,1,1
419512,4,10,17,-7,16,1
72089,4,10,17,-7,16,1
330016,4,7,19,-12,11,1
36119,4,44,7,37,17,1
2847,3,31,24,7,2,0
227207,4,16,17,-1,16,0
254230,1,0,0,0,11,0
143808,3,6,0,6,14,0
211121,1,0,0,0,9,0
76767,2,17,0,17,1,1
37860,1,0,0,0,1,0
48567,2,14,14,0,5,0
389692,4,27,16,11,3,0
374244,1,7,0,7,13,0
387604,4,13,3,10,2,0
35474,2,14,7,7,17,1
236252,1,0,0,0,3,1
307836,3,27,21,6,1,1
378551,2,7,6,1,15,1
132253,2,14,7,7,9,1
199656,2,7,0,7,4,0
31371,4,7,3,4,15,0
61467,4,24,17,7,11,1
229265,3,17,14,3,17,0
9812,4,12,17,-5,5,0
333501,2,6,0,6,12,1
37112,4,13,17,-4,17,1
399515,3,0,26,-26,7,0
262318,3,13,9,4,15,0
320327,4,14,24,-10,6,1
226969,1,3,0,3,16,0
231322,3,9,10,-1,1,0
202453,3,6,10,-4,5,0
132896,4,6,21,-15,9,0
190018,1,6,0,6,17,1
71533,1,0,0,0,16,1
58499,1,0,3,-3,10,0
331022,3,39,10,29,11,1
319298,2,10,3,7,6,0
359787,4,27,26,1,6,1
136595,3,15,16,-1,11,0
43173,1,7,7,0,3,0
35536,4,30,7,23,17,1
289615,2,10,13,-3,10,0
23649,3,7,13,-6,12,0
165871,4,6,19,-13,6,1
237588,4,38,22,16,3,0
344986,3,10,23,-13,17,1
266367,3,24,0,24,16,0
283757,3,11,3,8,7,1
261810,2,3,10,-7,14,0
273785,2,7,7,0,2,1
243616,3,20,14,6,6,0
215005,2,10,0,10,11,1
325704,4,34,21,13,9,1
176175,2,14,14,0,11,0
254522,4,29,13,16,11,1
195016,1,7,7,0,2,0
268278,2,10,3,7,17,1
178857,4,27,14,13,12,0
295460,4,17,16,1,12,0
361165,1,0,0,0,7,0
147708,3,10,10,0,15,1
387339,1,7,0,7,2,0
363176,4,24,10,14,8,1
4888,2,14,0,14,3,0
370034,3,17,13,4,12,0
33356,2,6,3,3,16,1
89683,3,6,17,-11,7,1
285606,3,20,17,3,8,1
190408,3,7,7,0,17,0
376739,4,6,0,6,14,1
24585,4,10,23,-13,12,0
231407,1,0,0,0,1,1
106272,1,0,3,-3,14,1
353587,3,31,0,31,4,1
215624,2,14,6,8,11,1
158061,3,15,9,6,3,1
257051,3,7,14,-7,12,0
238259,4,10,24,-14,4,1
419736,2,10,10,0,17,0
33318,1,0,0,0,16,1
254646,4,28,21,7,11,1
131397,3,7,13,-6,8,0
388298,2,10,3,7,2,0
353935,4,23,28,-5,4,0
256419,2,9,21,-12,12,1
181066,2,7,7,0,13,1
192513,3,14,17,-3,1,0
46554,1,0,0,0,4,1
266523,3,10,15,-5,16,1
195652,2,7,7,0,2,0
409906,1,0,0,0,12,1
35206,3,0,14,-14,16,1
173398,1,0,0,0,10,0
374583,3,20,13,7,14,1
71256,1,0,0,0,16,0
92252,2,10,0,10,8,1
97661,2,3,3,0,11,0
251247,3,10,24,-14,10,0
170861,2,7,0,7,8,0
125456,3,13,0,13,5,1
286665,1,7,0,7,8,1
52057,3,13,10,3,7,1
70340,3,10,33,-23,15,1
338051,2,0,7,-7,14,1
8010,1,3,7,-4,4,1
343548,4,10,10,0,16,0
399860,1,0,0,0,8,1
142614,2,13,3,10,13,0
350386,4,31,20,11,2,1
149003,4,13,12,1,16,0
271798,4,33,20,13,2,1
355093,2,6,13,-7,4,0
135451,4,31,27,4,10,0
60687,3,21,3,18,11,1
54439,1,0,0,0,8,1
398608,2,0,0,0,7,1
351761,1,7,14,-7,3,1
109865,3,20,0,20,16,1
135884,4,24,24,0,10,1
164484,2,17,0,17,5,1
153156,3,20,17,3,1,1
316995,1,0,7,-7,4,0
337654,3,21,13,8,14,1
160347,3,3,21,-18,4,0
233930,4,17,13,4,2,1
340325,2,17,7,10,15,0
50213,1,7,7,0,6,0
72554,4,19,24,-5,16,0
51424,2,3,10,-7,7,0
281811,3,10,0,10,6,0
40404,1,0,7,-7,2,1
137817,1,0,6,-6,11,0
199234,2,17,21,-4,4,1
364326,4,9,39,-30,9,1
218270,2,7,7,0,12,1
252879,1,0,0,0,11,1
254101,1,0,0,0,11,0
383373,2,0,9,-9,17,0
326180,2,7,17,-10,9,1
48015,3,10,24,-14,5,0
262700,1,7,0,7,15,1
166101,2,14,3,11,6,1
269323,1,0,7,-7,1,1
100148,1,7,0,7,12,0
39248,2,3,3,0,1,0
59267,4,28,58,-30,10,0
198939,3,13,16,-3,3,0
201379,4,28,22,6,5,0
332410,1,7,3,4,12,0
411655,4,26,28,-2,13,1
240234,4,16,18,-2,5,1
323339,2,7,0,7,7,0
198865,1,0,6,-6,3,1
190612,1,7,7,0,17,1
39916,4,6,10,-4,1,0
335586,3,16,7,9,13,0
328784,3,17,13,4,10,1
388745,2,11,0,11,3,1
276676,3,23,6,17,4,0
276907,1,14,0,14,4,0
256179,4,27,22,5,12,1
174804,2,13,17,-4,10,1
177238,2,7,10,-3,11,0
66448,1,0,7,-7,14,0
193736,3,3,27,-24,1,1
353366,2,3,0,3,4,1
323757,1,6,3,3,8,1
170247,2,0,6,-6,8,0
237385,3,12,14,-2,3,1
216969,2,3,3,0,12,0
356779,1,0,0,0,5,0
359902,3,23,24,-1,6,0
118868,3,27,7,20,2,0
373955,2,7,0,7,13,0
67319,2,14,3,11,14,0
166957,4,16,9,7,6,1
406767,1,0,10,-10,11,1
374143,2,16,7,9,13,1
151088,4,17,10,7,17,0
44860,2,0,16,-16,4,0
67648,3,7,35,-28,14,0
259185,3,14,25,-11,13,0
153522,1,2,7,-5,1,1
301195,3,20,14,6,15,0
186557,5,34,33,1,15,0
272419,3,31,9,22,2,0
414629,4,28,12,16,14,1
258708,2,0,20,-20,13,1
113588,2,3,0,3,17,1
258206,5,20,20,0,13,1
216569,4,40,11,29,12,0
44266,2,17,13,4,3,1
20534,4,3,0,3,10,1
82052,3,17,7,10,3,0
109292,3,6,3,3,15,1
243890,2,16,6,10,6,1
27536,4,23,12,11,13,0
418023,4,21,35,-14,16,0
199449,4,22,17,5,4,0
253869,2,28,14,14,11,1
150537,1,0,0,0,17,0
4294,4,27,6,21,2,1
86728,3,17,14,3,5,1
272851,2,20,0,20,2,0
89419,3,10,20,-10,7,1
20560,4,17,0,17,10,0
1699,3,14,0,14,1,0
122514,1,0,0,0,4,1
193469,4,23,20,3,1,1
419817,1,0,0,0,17,0
112246,2,14,7,7,17,0
415104,1,0,14,-14,15,1
320835,2,3,11,-8,6,1
391021,3,27,27,0,4,0
23175,2,23,0,23,11,1
17890,4,24,17,7,9,1
59562,1,0,0,0,11,0
54253,4,0,3,-3,8,1
421180,1,0,0,0,17,1
278504,3,36,0,36,4,0
123896,1,0,0,0,5,1
220651,1,7,0,7,13,0
270309,4,17,27,-10,1,1
372357,4,24,17,7,13,1
147688,2,10,3,7,15,1
356372,3,24,14,10,5,1
258242,1,7,0,7,13,0
240282,2,7,7,0,5,0
278974,3,7,30,-23,5,1
11320,1,13,0,13,6,1
302469,2,3,3,0,15,0
264747,2,10,16,-6,16,1
91307,2,7,7,0,8,1
138474,3,21,14,7,12,1
262046,4,24,31,-7,14,1
50287,3,13,16,-3,6,1
375381,4,14,24,-10,14,0
325889,1,3,0,3,9,0
307389,4,23,25,-2,17,0
154761,3,13,10,3,1,0
373059,2,0,7,-7,13,1
408558,1,0,0,0,12,1
350988,1,0,7,-7,3,1
226104,2,7,14,-7,16,1
51065,4,3,23,-20,6,1
70541,1,0,7,-7,15,1
304762,1,0,0,0,16,1
322689,5,9,9,0,7,1
118562,3,17,3,14,2,1
296210,3,16,26,-10,13,1
384277,2,6,0,6,1,0
154516,4,21,17,4,1,0
323110,4,26,14,12,7,0
337056,3,19,0,19,14,1
401539,2,7,14,-7,8,1
107994,4,6,20,-14,15,1
210949,4,32,23,9,9,1
401533,2,7,14,-7,8,0
263313,2,10,7,3,15,1
266048,2,10,3,7,16,1
244889,1,0,0,0,7,0
412797,2,14,24,-10,14,1
207845,2,7,0,7,8,0
158702,4,24,7,17,3,1
100670,3,14,14,0,12,1
61888,4,20,23,-3,12,1
410978,1,0,7,-7,13,1
338779,1,7,0,7,15,0
325878,1,0,0,0,9,1
230103,1,0,3,-3,17,0
238744,1,0,0,0,4,1
209962,1,0,3,-3,8,0
388392,1,0,0,0,2,0
306954,4,6,43,-37,17,1
233359,4,19,26,-7,2,1
43553,3,17,3,14,3,1
51543,5,34,34,0,7,1
257918,1,0,0,0,13,0
346832,2,10,3,7,1,1
50003,3,28,10,18,6,1
212814,4,17,21,-4,10,1
45818,4,16,14,2,4,0
279723,3,23,6,17,5,0
40046,3,20,7,13,1,0
138712,4,28,35,-7,12,0
385692,5,27,27,0,1,0
350465,3,0,12,-12,2,1
47735,4,6,17,-11,5,1
120146,3,10,6,4,3,0
44397,2,3,0,3,3,1
406782,2,0,16,-16,11,0
142254,1,0,0,0,13,1
27719,1,0,0,0,13,0
56505,1,10,0,10,9,0
65160,2,0,3,-3,13,1
156821,3,23,20,3,2,0
317747,1,0,0,0,5,1
285605,3,20,16,4,8,0
81880,3,0,27,-27,3,0
120549,1,0,6,-6,3,1
277018,4,31,20,11,4,0
285032,1,0,0,0,7,0
360553,2,7,7,0,7,0
322154,1,0,14,-14,7,1
294204,2,0,7,-7,12,1
58874,2,3,15,-12,10,1
354126,4,19,0,19,4,1
171788,3,23,14,9,9,1
11114,3,10,13,-3,5,1
341108,4,14,17,-3,15,1
22062,4,24,24,0,11,0
187281,4,10,6,4,16,0
198117,1,0,3,-3,3,1
94426,1,0,0,0,9,0
223229,2,3,6,-3,15,1
12615,4,3,27,-24,6,1
325275,2,3,3,0,8,0
390147,4,20,35,-15,3,1
45258,1,0,0,0,4,1
301014,2,10,3,7,15,1
70829,1,7,0,7,15,0
160628,2,7,0,7,4,0
317059,3,7,10,-3,4,1
8946,4,28,7,21,4,1
103827,3,9,0,9,13,1
111891,4,19,17,2,17,1
201525,3,32,13,19,5,0
353934,4,23,28,-5,4,0
131041,1,0,0,0,8,1
142394,1,0,0,0,13,1
361532,3,10,7,3,7,0
370960,1,0,0,0,12,1
356351,3,24,8,16,5,1
402488,4,26,15,11,9,1
142890,2,0,3,-3,13,1
286898,3,16,7,9,8,0
82438,1,0,7,-7,3,1
115268,3,7,9,-2,1,1
342144,3,12,16,-4,16,1
228142,1,0,3,-3,17,1
25109,2,10,0,10,12,0
405010,4,9,23,-14,10,0
344326,1,7,0,7,17,0
309619,4,16,3,13,1,1
77655,2,0,10,-10,1,1
107782,3,7,20,-13,15,1
205925,1,3,3,0,7,1
275183,3,14,16,-2,3,1
344301,4,19,13,6,17,0
175258,2,15,7,8,10,1
418644,4,21,31,-10,16,1
296565,1,0,0,0,13,1
384230,1,6,0,6,1,0
145637,3,28,0,28,14,0
44490,4,27,20,7,3,0
217321,3,0,10,-10,12,1
85435,1,7,0,7,5,1
3142,3,3,9,-6,2,1
404976,3,9,13,-4,10,0
301641,3,10,6,4,15,1
31478,3,3,14,-11,15,0
247735,3,7,6,1,8,1
181466,4,31,24,7,13,0
270477,4,13,7,6,1,1
311543,4,17,16,1,2,1
45416,1,7,0,7,4,0
312063,2,14,7,7,2,1
258765,4,3,37,-34,13,0
88911,2,16,3,13,6,1
310195,4,24,10,14,2,0
306708,2,10,3,7,17,0
325128,2,10,7,3,8,0
139261,2,13,6,7,12,0
406698,3,24,0,24,11,1
70536,1,0,7,-7,15,1
43099,4,3,17,-14,3,1
388827,4,14,17,-3,3,0
109144,3,24,7,17,15,1
58701,2,7,10,-3,10,0
260878,4,50,15,35,14,0
23376,4,20,17,3,11,0
317136,1,0,0,0,5,1
72816,3,31,17,14,16,0
170757,4,24,6,18,8,0
346054,3,3,6,-3,1,1
94967,2,6,6,0,9,0
323343,2,7,0,7,7,1
197996,2,0,20,-20,3,1
387246,2,6,7,-1,2,1
334261,3,6,7,-1,13,1
168244,1,0,7,-7,7,1
246510,3,19,7,12,8,1
1404,3,10,0,10,1,0
170170,4,10,20,-10,8,1
195603,4,24,7,17,2,0
399697,1,0,0,0,8,0
345900,3,10,23,-13,17,1
277498,1,0,0,0,4,0
186806,3,26,7,19,15,1
285582,3,7,10,-3,8,1
29174,4,3,19,-16,14,0
278494,3,36,0,36,4,1
338509,2,17,14,3,14,1
12109,2,7,7,0,6,0
190854,4,24,10,14,17,0
251467,1,15,3,12,10,1
25508,1,0,0,0,12,1
337604,2,14,7,7,14,1
292019,2,6,9,-3,11,1
36525,3,10,20,-10,17,1
359521,4,0,21,-21,6,0
368447,4,30,14,16,11,0
100559,4,20,20,0,12,0
324755,4,26,7,19,8,0
162156,1,7,0,7,4,0
229115,3,16,7,9,17,1
28112,3,27,10,17,13,0
361838,4,44,10,34,7,0
140829,1,7,0,7,13,0
191891,4,29,16,13,1,0
345567,3,7,20,-13,17,1
393233,2,14,6,8,5,0
51733,2,0,10,-10,7,1
248569,1,0,0,0,9,1
234080,4,20,7,13,2,0
397422,2,0,13,-13,6,1
207166,3,14,10,4,7,0
140103,2,7,0,7,12,0
148453,2,7,3,4,16,0
170592,3,34,6,28,8,0
346253,3,40,3,37,1,0
279499,2,10,6,4,5,0
50402,2,7,7,0,6,0
29756,3,34,3,31,14,1
307087,4,24,6,18,17,1
188378,2,3,0,3,16,1
311391,4,42,13,29,2,0
270112,3,17,10,7,1,1
377330,4,24,14,10,15,0
370651,4,21,14,7,12,0
41455,2,2,7,-5,2,1
260910,1,0,0,0,14,1
391545,2,10,21,-11,4,1
33339,1,3,3,0,16,0
160013,2,10,23,-13,3,0
111114,3,24,10,14,16,1
275632,3,24,3,21,3,0
329751,1,10,0,10,11,0
181958,1,0,0,0,13,1
249357,2,10,9,1,9,0
17519,2,13,0,13,9,0
280718,3,0,6,-6,5,1
29868,3,9,16,-7,14,0
240344,4,7,23,-16,5,0
194985,4,14,25,-11,2,1
32529,2,17,3,14,15,1
142168,4,2,7,-5,13,0
45025,3,13,10,3,4,1
155060,2,6,19,-13,1,0
163223,1,0,3,-3,5,0
26445,3,20,16,4,13,0
276172,2,17,3,14,3,1
248671,4,31,10,21,9,1
141989,3,10,14,-4,13,1
61823,2,3,17,-14,12,0
163938,3,23,10,13,5,0
3537,1,0,0,0,2,0
285004,4,16,27,-11,7,1
392949,2,6,3,3,4,1
388888,2,10,14,-4,3,0
60972,2,21,6,15,11,0
252546,4,29,32,-3,10,0
27222,3,19,7,12,13,1
81656,1,7,7,0,3,1
189639,3,10,6,4,17,1
412836,3,28,35,-7,14,0
169017,2,19,14,5,7,1
397864,2,0,3,-3,7,1
163702,1,0,6,-6,5,0
237106,3,8,26,-18,3,0
143982,3,7,10,-3,14,0
26508,5,30,29,1,13,1
323193,2,7,0,7,7,0
415840,2,6,13,-7,15,1
116253,1,10,0,10,1,0
71245,4,22,26,-4,16,1
214528,1,0,0,0,11,1
108893,4,17,17,0,15,1
2693,3,6,7,-1,2,0
409999,3,6,35,-29,12,0
202822,1,7,0,7,5,0
332886,2,17,0,17,12,1
65701,2,0,16,-16,13,1
259374,4,35,34,1,13,0
68289,1,0,0,0,14,0
317953,2,10,9,1,5,0
278452,2,22,0,22,4,0
192988,4,17,17,0,1,1
29142,3,0,19,-19,14,1
375798,3,20,0,20,14,1
23942,3,16,0,16,12,0
346696,3,21,6,15,1,1
241074,1,7,0,7,5,0
79413,2,6,0,6,2,0
215352,3,17,13,4,11,0
325804,3,6,10,-4,9,1
242430,2,0,7,-7,6,0
298341,1,0,7,-7,14,1
373272,4,13,23,-10,13,1
57710,4,30,24,6,10,1
193699,2,3,20,-17,1,0
112552,2,17,19,-2,17,1
152129,4,13,13,0,17,1
402542,1,7,7,0,9,1
292622,3,16,16,0,11,0
365975,1,20,7,13,10,0
237621,1,3,0,3,4,0
90394,1,0,6,-6,7,0
419133,2,10,3,7,16,1
222794,2,10,7,3,14,0
85318,2,21,3,18,5,0
132386,2,0,0,0,9,0
130841,3,13,12,1,8,0
31391,4,7,3,4,15,0
368015,3,17,21,-4,11,1
150594,3,3,13,-10,17,0
184986,3,7,20,-13,15,1
113387,1,0,0,0,17,0
248954,3,20,3,17,9,1
316883,2,9,2,7,4,0
35675,4,23,10,13,17,1
232861,4,23,17,6,2,0
644,2,0,3,-3,1,0
229089,2,10,7,3,17,0
337242,4,16,23,-7,14,1
412411,4,37,30,7,13,1
177099,2,17,13,4,11,1
268603,2,7,6,1,17,1
160847,4,34,17,17,4,0
87680,2,0,14,-14,6,0
286339,1,0,0,0,8,0
36266,4,24,27,-3,17,0
61232,2,14,0,14,11,0
259155,3,14,13,1,13,1
51930,3,13,16,-3,7,1
189129,1,7,0,7,16,1
155756,4,27,23,4,2,0
218230,4,37,3,34,12,0
187471,1,0,0,0,16,0
39646,4,30,6,24,1,0
80701,4,32,26,6,3,0
266289,1,0,0,0,16,0
255024,2,3,9,-6,12,1
77705,4,17,24,-7,1,0
67152,2,0,0,0,14,1
330155,4,0,22,-22,11,0
71059,3,27,0,27,16,0
113068,4,16,16,0,17,0
313825,1,7,0,7,3,0
371457,3,14,14,0,12,0
111462,1,0,0,0,16,1
293324,1,0,0,0,11,1
381128,4,24,28,-4,16,1
313657,4,25,30,-5,3,1
372904,2,19,0,19,13,0
300433,1,2,0,2,14,1
161566,2,9,10,-1,4,0
362756,1,0,0,0,8,1
198091,1,0,0,0,3,0
205158,2,7,7,0,6,0
118534,2,17,3,14,2,0
405650,4,24,28,-4,10,1
176586,5,19,20,-1,11,1
217987,2,14,10,4,12,1
265419,4,14,23,-9,16,0
140201,4,13,10,3,12,0
328219,4,14,17,-3,10,1
101061,2,7,10,-3,12,0
261181,1,7,0,7,14,1
345033,1,0,0,0,17,0
385836,4,33,3,30,1,0
175154,3,34,10,24,10,1
83615,4,10,17,-7,4,1
292072,4,22,19,3,11,1
389789,2,10,6,4,3,0
315896,4,9,26,-17,4,1
312680,2,28,7,21,3,0
225340,2,10,21,-11,15,0
362250,4,15,17,-2,8,0
391441,3,10,17,-7,4,0
178856,4,27,14,13,12,0
169349,2,6,14,-8,8,0
23185,2,23,6,17,11,1
111251,3,10,10,0,16,0
264402,2,3,21,-18,15,1
398019,2,14,7,7,7,0
273665,3,16,13,3,2,0
325880,1,0,0,0,9,1
248894,2,14,0,14,9,1
216824,2,0,7,-7,12,1
322907,2,13,0,13,7,0
194865,1,0,7,-7,2,0
420784,2,3,3,0,17,0
288055,2,7,0,7,9,0
276827,3,20,20,0,4,1
258959,2,0,13,-13,13,1
260261,4,17,3,14,14,1
366190,4,7,51,-44,10,1
417792,1,7,0,7,16,0
71349,4,10,20,-10,16,0
270323,4,20,27,-7,1,1
258204,5,20,20,0,13,1
32923,1,0,7,-7,15,0
201015,2,27,0,27,5,0
18581,2,10,10,0,9,1
258092,2,13,6,7,13,0
366019,3,30,14,16,10,1
108865,4,7,17,-10,15,1
2591,4,10,20,-10,2,1
156614,2,3,0,3,2,0
188054,1,0,0,0,16,0
212058,4,17,40,-23,9,1
345267,3,13,14,-1,17,1
24806,2,6,3,3,12,0
297652,2,7,3,4,13,1
60942,2,7,6,1,11,1
377840,2,17,7,10,15,1
287130,1,7,3,4,8,1
57267,1,0,0,0,10,1
207597,3,28,10,18,7,0
163682,1,0,0,0,5,0
11314,1,7,0,7,6,0
314031,2,6,0,6,3,1
286822,1,3,7,-4,8,0
66568,1,0,7,-7,14,0
41458,2,2,7,-5,2,0
74116,3,23,6,17,17,0
150754,3,13,9,4,17,0
306348,4,24,10,14,17,1
7205,1,0,0,0,4,0
204141,3,10,10,0,6,0
399120,4,18,36,-18,7,1
117328,2,21,0,21,2,0
3886,2,19,7,12,2,1
187587,4,13,23,-10,16,1
66753,2,7,3,4,14,0
206798,1,0,0,0,7,1
51614,2,14,10,4,7,0
226812,4,14,23,-9,16,1
267350,1,0,7,-7,17,0
153139,3,20,17,3,1,0
133463,2,20,17,3,9,0
133556,1,0,0,0,9,0
72269,4,27,27,0,16,0
152781,3,7,7,0,17,0
175238,2,15,0,15,10,0
55247,2,7,10,-3,9,1
217940,4,39,28,11,12,0
397000,2,14,3,11,6,0
47684,3,3,17,-14,5,0
387281,3,6,10,-4,2,1
121699,3,21,7,14,4,0
365922,4,14,21,-7,9,1
378676,1,0,0,0,15,1
210096,1,0,0,0,9,1
85117,1,0,3,-3,4,1
226439,2,0,7,-7,16,1
296598,2,3,0,3,13,0
192421,1,0,14,-14,1,0
145410,1,0,7,-7,14,0
80316,2,7,6,1,2,0
125184,3,17,7,10,5,1
88764,2,6,3,3,6,1
135046,2,14,3,11,10,0
355984,2,7,7,0,5,1
301359,3,17,7,10,15,1
358813,1,0,7,-7,6,0
371311,2,21,10,11,12,1
350976,4,21,17,4,3,0
119697,5,20,19,1,3,1
325250,1,0,3,-3,8,1
126191,2,14,6,8,6,1
379084,4,7,12,-5,15,1
317917,1,7,0,7,5,0
110136,2,7,10,-3,16,1
318147,3,9,10,-1,5,1
373855,3,27,10,17,13,1
341073,3,7,17,-10,15,1
164056,2,3,3,0,5,0
278059,4,13,10,3,4,0
40325,3,6,7,-1,2,1
164794,4,26,21,5,6,1
333980,3,17,10,7,12,1
413462,4,17,38,-21,14,1
420204,4,3,10,-7,17,1
325396,1,0,0,0,8,1
69321,4,19,3,16,15,1
213723,4,24,17,7,10,1
11343,2,14,0,14,6,1
84183,4,10,10,0,4,1
16714,4,21,33,-12,8,0
321484,4,21,30,-9,7,1
206155,4,27,19,8,7,0
372797,3,3,0,3,13,1
351303,1,0,0,0,3,1
281670,3,24,10,14,6,0
415134,2,0,21,-21,15,1
120291,3,17,13,4,3,1
347550,4,28,37,-9,1,1
85289,1,0,3,-3,5,1
9668,3,12,28,-16,5,0
74231,2,3,7,-4,17,0
197054,1,0,0,0,3,0
91784,2,3,0,3,8,0
166821,4,30,16,14,6,1
220502,1,0,14,-14,13,1
332611,3,20,6,14,12,1
277876,3,7,17,-10,4,0
2848,3,31,24,7,2,0
165710,4,14,7,7,6,1
407021,4,11,34,-23,11,0
303099,2,0,14,-14,16,1
109020,3,16,33,-17,15,0
264242,2,10,10,0,15,0
66896,2,6,7,-1,14,1
132617,4,20,49,-29,9,0
114997,3,13,12,1,1,1
129285,4,17,13,4,7,1
178232,4,6,10,-4,12,0
269308,1,0,0,0,1,0
274182,1,3,0,3,3,0
236121,1,0,3,-3,3,0
204721,2,7,14,-7,6,1
155235,3,21,7,14,1,1
371175,2,11,19,-8,12,0
54970,3,6,3,3,8,0
249057,2,21,17,4,9,0
414318,4,21,42,-21,14,0
316474,4,16,17,-1,4,1
253515,1,0,7,-7,11,0
104810,4,27,33,-6,14,0
209728,3,9,6,3,8,1
34248,2,10,6,4,16,1
139120,2,9,6,3,12,1
80811,3,3,0,3,3,1
352629,1,0,0,0,3,0
223679,2,13,6,7,15,1
294707,3,6,14,-8,12,1
143554,4,20,28,-8,14,1
27457,2,10,0,10,13,0
271316,3,6,24,-18,1,1
217602,3,6,9,-3,12,0
46908,3,13,20,-7,5,1
27036,2,10,3,7,13,1
88724,1,3,0,3,6,0
398132,4,30,42,-12,7,0
264101,3,13,27,-14,15,0
179200,1,7,0,7,12,1
40877,2,6,10,-4,2,1
417897,4,13,10,3,16,0
25797,1,3,0,3,12,0
184809,3,17,20,-3,15,1
407081,2,0,13,-13,11,1
192555,4,24,17,7,1,1
55728,4,23,21,2,9,0
338030,2,0,0,0,14,0
27594,1,7,10,-3,13,1
301517,4,20,18,2,15,0
167549,3,0,10,-10,7,1
93256,1,6,0,6,9,1
202516,1,0,0,0,5,0
188383,2,3,0,3,16,0
213346,2,10,6,4,10,0
307170,2,0,10,-10,17,0
184929,2,0,10,-10,15,0
130000,2,0,13,-13,8,0
52696,3,3,13,-10,7,0
377158,4,13,10,3,15,0
267273,3,17,14,3,17,0
47497,2,16,3,13,5,1
84008,3,20,3,17,4,1
120713,2,17,0,17,3,1
154323,3,20,14,6,1,0
208018,2,21,0,21,8,0
3231,1,0,0,0,2,0
415213,4,17,31,-14,15,1
416900,2,3,7,-4,15,1
300377,4,10,7,3,14,1
381186,1,7,3,4,16,1
343763,2,7,3,4,17,0
375219,4,17,24,-7,14,1
234399,4,24,10,14,2,0
163910,3,23,10,13,5,1
28666,2,3,7,-4,14,0
229018,4,21,16,5,17,1
125506,4,30,7,23,5,0
405614,3,21,20,1,10,0
193181,1,0,0,0,1,1
72744,1,7,0,7,16,1
95990,2,6,0,6,10,0
90887,2,31,7,24,7,1
259802,4,20,20,0,14,1
151435,1,20,0,20,17,1
104568,1,7,3,4,14,0
376285,4,17,14,3,14,0
215882,1,3,7,-4,11,1
171900,2,7,7,0,9,0
281123,1,0,0,0,6,1
311625,2,6,3,3,2,0
361841,4,44,10,34,7,1
140662,4,38,10,28,12,1
271936,3,20,20,0,2,1
272576,3,13,3,10,2,0
111451,4,0,20,-20,16,0
67771,4,21,0,21,14,0
271723,2,13,10,3,2,0
266647,2,16,3,13,16,1
229088,2,10,7,3,17,0
403543,1,7,0,7,9,0
218169,2,14,3,11,12,0
86924,1,0,0,0,5,1
349399,1,0,6,-6,2,0
286087,3,10,3,7,8,0
169448,1,0,0,0,8,0
405200,1,0,7,-7,10,1
411242,4,11,26,-15,13,0
176911,1,0,0,0,11,0
53067,2,10,7,3,7,0
101565,3,13,24,-11,12,0
92263,2,10,0,10,8,1
17727,4,17,6,11,9,1
175640,1,0,0,0,11,1
385780,3,20,0,20,1,0
410198,4,20,24,-4,13,0
67166,2,0,0,0,14,1
79211,4,20,10,10,2,1
132787,1,0,0,0,9,0
139381,2,14,0,14,12,0
329712,4,40,17,23,11,0
412850,4,31,35,-4,14,0
159744,3,7,10,-3,3,0
38603,1,0,0,0,1,0
195004,1,7,0,7,2,1
58661,1,0,0,0,10,1
410169,4,20,17,3,13,1
202614,3,24,13,11,5,1
336313,3,20,10,10,13,0
260122,4,6,28,-22,14,0
31977,4,16,13,3,15,1
130473,2,3,3,0,8,0
194015,2,14,7,7,1,0
194935,3,14,10,4,2,0
152181,1,7,0,7,17,1
143134,4,37,27,10,13,0
85283,1,0,3,-3,5,1
69469,4,24,10,14,15,0
277424,4,34,9,25,4,0
363308,4,33,14,19,8,0
108000,4,6,20,-14,15,0
112333,1,0,0,0,17,1
299946,4,16,11,5,14,0
217763,3,10,7,3,12,0
271742,2,13,10,3,2,1
355401,2,10,10,0,4,0
315260,4,20,16,4,4,0
390983,2,13,21,-8,4,1
257328,2,17,0,17,13,0
118074,1,3,6,-3,2,0
332423,2,7,3,4,12,1
102078,4,35,17,18,12,1
171467,2,7,3,4,9,1
86637,1,0,0,0,5,1
171285,2,0,3,-3,9,1
25520,2,7,0,7,12,0
349716,2,14,7,7,2,1
270275,3,3,24,-21,1,1
107547,4,3,23,-20,15,1
35408,5,30,30,0,16,1
421764,4,31,24,7,17,1
76541,4,7,34,-27,1,1
106377,4,21,19,2,14,0
95077,1,0,7,-7,9,0
211399,4,10,13,-3,9,1
146416,3,16,3,13,15,1
158169,2,7,0,7,3,0
399028,2,10,12,-2,7,0
288153,4,19,7,12,9,0
411131,2,0,13,-13,13,1
228512,3,20,7,13,17,0
142736,2,9,10,-1,13,1
195177,1,7,0,7,2,1
692,3,0,17,-17,1,0
329704,4,37,17,20,11,1
55828,2,6,7,-1,9,1
50325,4,13,23,-10,6,1
398567,1,0,0,0,7,1
112700,2,3,0,3,17,1
379732,2,9,0,9,16,0
329848,4,24,23,1,11,0
299919,4,16,11,5,14,0
221789,4,13,21,-8,14,0
33589,4,17,16,1,16,1
278657,3,17,3,14,4,1
77526,3,20,14,6,1,0
76524,3,7,20,-13,1,0
412619,2,3,3,0,14,0
49430,5,20,20,0,6,1
246587,1,0,3,-3,8,1
240967,3,21,15,6,5,0
183000,4,10,44,-34,14,1
49942,2,14,0,14,6,1
154722,2,3,7,-4,1,0
259959,4,20,20,0,14,1
237046,2,0,17,-17,3,0
275095,1,7,0,7,3,0
111405,3,0,17,-17,16,0
38511,2,10,3,7,1,1
26499,4,30,29,1,13,1
53595,4,14,15,-1,8,1
336801,4,10,23,-13,14,1
416440,2,7,0,7,15,1
136912,3,0,13,-13,11,0
142291,2,0,0,0,13,1
291059,1,0,0,0,10,1
48605,4,21,24,-3,5,0
263201,3,17,17,0,15,0
19776,4,12,12,0,10,0
160652,2,7,0,7,4,1
375430,1,7,7,0,14,0
342609,4,22,20,2,16,0
25867,3,24,16,8,12,0
167833,2,6,13,-7,7,1
156779,2,14,7,7,2,1
414614,4,28,12,16,14,1
146383,2,10,3,7,15,0
200215,4,14,37,-23,4,1
268457,3,14,9,5,17,0
145063,4,20,12,8,14,0
374025,3,10,10,0,13,0
95677,2,10,3,7,10,1
95249,2,3,10,-7,10,0
254211,4,3,25,-22,11,0
263406,1,0,0,0,15,1
400370,2,17,10,7,8,1
27727,1,0,0,0,13,0
82669,4,12,13,-1,3,1
239090,2,7,9,-2,4,0
368228,1,0,0,0,11,0
367072,1,0,0,0,10,1
388821,4,14,14,0,3,0
291588,3,20,3,17,11,1
2843,3,24,24,0,2,1
236686,3,17,7,10,3,1
65671,1,0,0,0,13,0
370637,4,21,14,7,12,0
285938,3,23,7,16,8,1
246894,1,0,7,-7,8,0
46370,4,6,17,-11,4,1
66460,2,7,7,0,14,0
133876,2,0,6,-6,9,1
38862,4,3,13,-10,1,1
386963,3,7,21,-14,2,1
79427,2,6,7,-1,2,1
245597,3,40,6,34,7,0
67842,1,3,3,0,14,1
292738,2,13,10,3,11,0
36584,1,3,0,3,17,0
228294,1,0,0,0,17,0
97162,1,0,0,0,10,0
66334,2,0,21,-21,14,1
176449,1,0,7,-7,11,0
332661,4,27,20,7,12,1
401947,2,0,3,-3,9,0
412331,2,10,14,-4,13,0
402742,3,17,7,10,9,1
141807,2,10,14,-4,13,1
365729,2,10,10,0,9,1
281154,2,14,7,7,6,1
156591,1,0,0,0,2,1
217441,2,9,0,9,12,1
312662,2,21,7,14,3,0
98922,3,7,17,-10,11,0
198165,3,10,3,7,3,1
232357,3,6,15,-9,1,1
119535,1,7,0,7,3,0
171670,4,19,17,2,9,1
205480,2,14,3,11,6,1
388653,4,17,0,17,3,0
227770,3,3,14,-11,16,1
348810,2,0,7,-7,2,1
276769,2,17,3,14,4,0
27363,3,24,10,14,13,0
189361,4,13,10,3,16,1
399720,1,0,3,-3,8,1
228829,3,6,17,-11,17,1
410401,2,6,10,-4,13,1
7539,1,7,0,7,4,0
45645,3,13,13,0,4,1
157007,4,13,13,0,2,0
382759,1,7,0,7,17,0
252798,3,6,6,0,11,1
388614,2,14,0,14,3,0
12206,2,0,0,0,6,1
165879,4,6,19,-13,6,0
150099,1,0,0,0,16,0
379865,2,7,0,7,16,0
368173,3,21,21,0,11,0
114872,4,16,33,-17,1,0
419028,3,7,17,-10,16,0
118150,3,23,27,-4,2,0
272623,4,19,9,10,2,0
308829,2,3,9,-6,1,0
169483,2,0,14,-14,8,0
361661,3,7,22,-15,7,0
252523,4,23,25,-2,10,0
168289,2,10,7,3,7,0
206404,2,10,0,10,7,1
293406,3,16,10,6,11,1
6440,4,15,20,-5,3,0
201722,4,30,20,10,5,0
18698,1,0,7,-7,9,0
176728,4,39,19,20,11,0
245158,3,17,25,-8,7,0
21862,2,21,0,21,11,0
305456,4,20,3,17,17,0
211677,3,23,9,14,9,1
390622,1,0,0,0,3,0
195030,2,7,10,-3,2,0
402142,3,12,0,12,9,1
203975,3,10,7,3,6,1
377129,3,10,10,0,15,0
267590,4,27,34,-7,17,1
421628,1,3,0,3,17,1
385434,3,21,7,14,1,0
403898,2,17,14,3,10,0
234310,2,10,0,10,2,1
86201,4,34,10,24,5,0
317492,2,10,10,0,5,0
57429,1,0,0,0,10,1
1500,2,3,6,-3,1,1
233301,3,7,17,-10,2,0
59102,4,10,23,-13,10,0
345692,2,7,0,7,17,0
362247,4,12,17,-5,8,1
101718,3,10,7,3,12,1
316813,4,16,7,9,4,1
6001,4,17,36,-19,3,1
54853,4,23,0,23,8,0
195877,1,0,0,0,2,0
150522,1,0,0,0,17,1
221759,3,10,14,-4,14,1
69557,2,0,10,-10,15,0
132045,4,3,24,-21,8,0
42063,3,20,7,13,2,0
256655,4,35,14,21,12,1
194855,1,0,7,-7,2,1
223500,2,7,10,-3,15,1
137619,5,34,34,0,11,1
292527,4,10,19,-9,11,1
390222,2,0,6,-6,3,1
57535,4,21,16,5,10,1
191976,2,7,13,-6,1,0
89076,3,13,6,7,6,0
412068,3,24,0,24,13,1
66929,3,12,7,5,14,1
327751,4,13,16,-3,10,0
276562,4,22,7,15,4,1
363933,1,0,3,-3,8,0
317673,3,16,6,10,5,0
225218,3,3,7,-4,15,0
322204,3,0,20,-20,7,0
252400,1,0,0,0,10,0
55686,3,20,14,6,9,1
197162,3,27,20,7,3,1
36572,4,23,37,-14,17,1
395175,2,10,7,3,5,0
96304,2,0,16,-16,10,1
114155,1,0,0,0,1,1
372730,1,0,0,0,13,0
407862,2,3,7,-4,11,1
206935,4,23,23,0,7,1
160000,2,3,17,-14,3,1
144636,4,26,22,4,14,0
265325,2,7,0,7,16,0
392049,3,10,24,-14,4,1
269459,1,3,3,0,1,0
241524,2,3,3,0,5,1
13419,2,3,14,-11,7,1
211600,1,0,0,0,9,0
215044,3,13,7,6,11,0
121531,3,9,7,2,4,1
99106,4,23,7,16,11,0
140830,1,7,0,7,13,0
38785,2,0,10,-10,1,1
177030,4,26,13,13,11,1
31239,4,32,34,-2,15,1
235381,2,14,7,7,3,1
337846,4,30,6,24,14,0
68648,2,7,0,7,15,1
125853,1,3,3,0,6,0
146238,3,3,16,-13,15,0
380234,3,13,16,-3,16,1
138304,2,20,0,20,11,0
325532,4,28,13,15,8,0
418092,1,14,0,14,16,0
171088,4,24,40,-16,8,0
295465,4,17,22,-5,12,1
149774,1,0,0,0,16,1
280689,2,0,3,-3,5,0
299788,5,17,17,0,14,1
235786,4,20,27,-7,3,1
332692,1,7,0,7,12,1
279597,4,10,16,-6,5,0
249056,2,21,17,4,9,0
363188,1,0,0,0,8,0
369242,2,14,7,7,11,0
380795,2,9,21,-12,16,1
77159,4,24,17,7,1,1
275481,3,20,17,3,3,1
37165,1,0,0,0,17,0
61699,3,17,10,7,12,0
294980,3,17,14,3,12,1
299166,4,10,16,-6,14,0
198601,2,0,0,0,3,1
133576,2,3,0,3,9,0
210297,2,6,10,-4,9,0
49004,2,10,7,3,6,1
294997,4,31,14,17,12,0
22615,3,23,3,20,11,1
16014,4,18,14,4,8,1
329967,3,7,10,-3,11,0
154656,4,24,28,-4,1,1
241952,1,7,0,7,5,0
213902,1,3,0,3,10,0
306192,3,10,3,7,17,0
49453,5,20,20,0,6,1
22186,3,10,15,-5,11,0
145803,3,13,10,3,15,0
214043,4,43,14,29,10,0
35296,2,6,0,6,16,1
8794,3,6,0,6,4,1
1300,4,24,23,1,1,1
164712,1,6,0,6,6,0
238015,3,10,13,-3,4,0
158171,2,7,0,7,3,1
58267,3,17,10,7,10,0
235722,3,3,17,-14,3,0
146846,3,24,0,24,15,1
61840,3,12,20,-8,12,1
280006,3,3,13,-10,5,0
133549,1,0,0,0,9,1
14290,2,2,7,-5,7,0
133074,4,15,22,-7,9,1
302616,2,10,3,7,15,0
322744,1,3,14,-11,7,1
10372,3,10,38,-28,5,0
353579,3,31,0,31,4,0
410706,2,10,3,7,13,1
298399,3,7,14,-7,14,1
67012,2,0,0,0,14,1
299935,4,16,11,5,14,1
237307,1,0,0,0,3,0
225981,4,34,20,14,16,0
122579,3,14,7,7,4,0
332860,2,7,0,7,12,1
134773,2,20,10,10,10,1
345289,4,19,17,2,17,0
347395,5,21,21,0,1,0
237237,3,13,0,13,3,0
188993,1,7,0,7,16,0
79402,1,3,0,3,2,1
206410,2,10,0,10,7,1
156033,3,20,17,3,2,1
276650,3,20,6,14,4,1
418186,4,24,6,18,16,0
402753,3,24,7,17,9,0
205352,3,20,0,20,6,1
119739,2,10,3,7,3,0
402628,4,20,23,-3,9,1
232240,4,15,12,3,1,1
126526,3,7,6,1,6,1
211141,1,0,3,-3,9,0
26398,2,10,0,10,13,0
137113,3,24,6,18,11,1
286142,4,24,17,7,8,0
242764,3,14,17,-3,6,0
288058,2,7,0,7,9,1
86462,4,30,21,9,5,0
217907,4,17,28,-11,12,1
233164,3,29,3,26,2,1
198913,2,6,16,-10,3,0
11554,4,6,10,-4,6,1
378422,2,7,0,7,15,0
116009,3,13,0,13,1,1
36543,4,19,20,-1,17,1
227258,2,3,10,-7,16,0
279124,3,21,20,1,5,0
309915,1,0,0,0,2,0
244183,2,13,7,6,6,0
355092,2,6,13,-7,4,0
195206,2,10,3,7,2,1
328471,3,6,3,3,10,0
124778,4,3,9,-6,5,1
256433,3,12,21,-9,12,0
3626,3,20,21,-1,2,0
23201,3,23,13,10,11,1
102666,4,22,20,2,13,0
281242,4,27,19,8,6,0
117854,4,9,20,-11,2,1
119581,2,10,0,10,3,0
262373,1,0,0,0,15,1
356225,4,29,7,22,5,1
171860,1,0,0,0,9,0
124369,1,0,0,0,5,1
389158,1,7,0,7,3,1
254237,1,0,0,0,11,0
98264,2,13,24,-11,11,1
359025,3,10,3,7,6,1
361463,1,7,0,7,7,0
196723,3,47,0,47,3,0
86111,2,28,3,25,5,0
291789,4,9,23,-14,11,1
133921,3,6,6,0,9,1
226412,2,0,7,-7,16,0
98713,2,21,3,18,11,0
341913,1,0,0,0,16,0
40914,3,16,20,-4,2,0
181955,1,0,0,0,13,1
73969,3,30,0,30,17,1
21307,3,3,14,-11,11,1
130265,4,9,29,-20,8,1
193392,2,7,17,-10,1,1
280338,4,19,22,-3,5,0
105064,2,19,14,5,14,0
327658,1,0,3,-3,10,1
153664,1,2,7,-5,1,0
137259,3,7,13,-6,11,0
363423,3,28,21,7,8,0
182890,1,0,10,-10,14,1
283252,2,10,0,10,7,0
191764,4,22,24,-2,17,0
172723,3,14,10,4,9,0
23709,4,12,33,-21,12,0
281613,2,21,0,21,6,0
273168,2,17,0,17,2,1
19697,2,3,6,-3,10,1
203564,1,0,0,0,6,1
408321,2,0,7,-7,12,1
71709,2,10,7,3,16,1
192774,2,0,9,-9,1,0
244544,3,25,13,12,7,0
413159,4,40,42,-2,14,0
120293,4,23,13,10,3,1
290847,4,17,21,-4,10,1
336182,4,17,10,7,13,1
127759,2,7,14,-7,6,0
306342,3,24,10,14,17,0
7179,4,48,24,24,4,0
390452,4,21,33,-12,3,0
178629,2,3,3,0,12,0
31531,4,3,17,-14,15,0
110425,2,10,0,10,16,1
302617,2,10,3,7,15,0
395797,2,0,7,-7,6,1
343993,3,16,6,10,17,1
134904,2,7,16,-9,10,1
155496,1,7,0,7,2,1
315479,2,0,0,0,4,0
193745,4,10,27,-17,1,0
371949,1,0,0,0,13,1
25759,4,17,17,0,12,0
141664,2,23,14,9,13,0
113469,3,3,7,-4,17,1
228033,2,3,0,3,17,1
137034,1,7,0,7,11,1
401107,2,27,3,24,8,0
246753,2,3,3,0,8,1
83988,2,17,0,17,4,0
34996,2,6,0,6,16,1
990,4,0,6,-6,1,0
246672,3,31,3,28,8,0
409857,3,23,0,23,12,0
151089,4,17,10,7,17,0
286098,3,10,10,0,8,0
357975,2,21,6,15,6,1
268777,3,24,3,21,17,1
13477,3,6,21,-15,7,0
408957,3,24,18,6,12,1
92174,4,3,43,-40,8,1
341239,3,16,10,6,16,0
382969,3,3,13,-10,17,1
126735,4,13,13,0,6,1
308876,4,10,13,-3,1,1
223134,4,40,24,16,14,0
362399,4,30,20,10,8,0
230832,1,0,0,0,1,0
84158,3,10,0,10,4,0
328832,4,17,20,-3,10,1
146842,3,24,0,24,15,0
211757,1,0,0,0,9,0
323360,2,10,0,10,7,0
252433,1,0,0,0,10,1
109045,4,23,34,-11,15,0
416492,3,21,17,4,15,0
117548,4,17,20,-3,2,1
265063,2,13,3,10,16,0
301078,4,30,13,17,15,0
215515,3,13,3,10,11,0
226716,2,7,6,1,16,1
237658,2,3,7,-4,4,1
384109,2,0,17,-17,1,0
78356,4,31,35,-4,2,1
382774,1,7,0,7,17,0
326298,1,0,3,-3,9,0
73083,3,7,10,-3,16,1
253729,3,10,10,0,11,1
133331,3,7,6,1,9,1
374454,3,32,0,32,14,0
238279,4,10,24,-14,4,1
411653,4,26,28,-2,13,1
324176,4,3,17,-14,8,0
114514,3,17,20,-3,1,0
402729,2,17,0,17,9,0
90144,2,3,0,3,7,0
381296,4,31,28,3,16,1
205522,3,14,17,-3,6,0
63055,3,16,21,-5,12,0
208506,3,44,7,37,8,1
245351,1,6,0,6,7,0
199578,3,34,10,24,4,0
369596,4,14,6,8,11,1
221227,1,0,16,-16,14,1
259524,4,44,10,34,13,0
400287,4,24,9,15,8,1
230979,1,0,0,0,1,0
349290,2,13,21,-8,2,1
309027,4,0,20,-20,1,0
248624,3,14,10,4,9,1
234148,2,0,7,-7,2,1
352816,2,14,0,14,3,0
330884,4,13,24,-11,11,0
37243,3,10,14,-4,17,1
349974,1,0,0,0,2,1
8971,4,35,27,8,4,1
187886,4,7,23,-16,16,0
86908,4,23,26,-3,5,0
220822,2,7,7,0,14,0
387220,2,6,7,-1,2,1
42339,2,7,9,-2,2,0
195565,3,13,7,6,2,0
226139,3,14,17,-3,16,1
388696,1,0,0,0,3,1
104072,2,10,13,-3,13,1
12798,1,0,3,-3,6,1
142577,1,0,3,-3,13,1
280684,2,0,3,-3,5,0
330400,3,10,20,-10,11,1
420007,2,9,7,2,17,1
365683,1,7,3,4,9,0
59944,2,3,16,-13,11,0
321045,4,10,7,3,6,0
346699,3,21,6,15,1,1
406833,3,7,20,-13,11,0
275269,2,10,2,8,3,0
365329,4,17,19,-2,9,1
6450,4,15,20,-5,3,1
243827,1,0,0,0,6,1
83190,1,3,0,3,4,0
133833,4,19,24,-5,9,1
136780,3,13,10,3,11,0
295482,1,0,0,0,12,1
116490,4,6,19,-13,1,0
29137,2,0,19,-19,14,1
369067,1,0,0,0,11,1
72259,4,27,17,10,16,1
156213,4,16,10,6,2,0
97945,2,0,7,-7,11,0
277430,4,34,17,17,4,1
1718,3,28,0,28,1,0
139490,1,0,0,0,12,1
222680,3,14,24,-10,14,1
15970,3,12,14,-2,8,1
146681,2,7,26,-19,15,0
367816,2,10,7,3,10,1
70731,2,7,10,-3,15,0
145441,2,9,14,-5,14,1
348597,4,28,23,5,2,1
196213,2,7,3,4,2,0
105671,2,14,3,11,14,1
62777,3,17,0,17,12,0
158708,4,24,7,17,3,1
2997,3,13,31,-18,2,1
212252,1,0,0,0,10,1
123059,4,7,13,-6,4,1
366346,1,0,0,0,10,1
268883,2,6,17,-11,17,1
145001,2,3,3,0,14,0
322127,1,0,0,0,7,0
315975,3,0,21,-21,4,0
351723,4,21,17,4,3,0
410272,2,7,13,-6,13,1
339098,2,3,0,3,15,1
201271,1,7,0,7,5,1
405571,2,7,14,-7,10,1
384601,3,10,49,-39,1,1
421319,1,0,0,0,17,0
323945,2,10,10,0,8,0
161674,1,0,0,0,4,0
320870,3,3,14,-11,6,0
39582,3,20,6,14,1,0
25438,4,13,10,3,12,0
37712,4,37,0,37,17,1
281609,2,21,0,21,6,0
953,3,0,3,-3,1,0
75146,3,7,6,1,17,0
243474,4,10,23,-13,6,1
338773,1,7,0,7,15,0
155079,3,6,33,-27,1,1
267304,4,17,17,0,17,0
394972,4,13,20,-7,5,0
281730,4,38,38,0,6,1
507,2,7,6,1,1,1
296368,4,13,28,-15,13,1
380821,3,9,24,-15,16,1
420419,1,0,7,-7,17,0
182610,2,0,6,-6,14,1
305409,3,20,3,17,17,1
142359,4,7,3,4,13,0
274865,2,0,10,-10,3,1
109537,2,0,7,-7,16,0
114894,4,24,40,-16,1,1
79586,2,14,0,14,2,1
93801,4,3,19,-16,9,1
215343,3,14,13,1,11,1
2741,4,9,7,2,2,1
239769,4,20,13,7,4,1
98864,2,7,7,0,11,1
248438,2,10,6,4,8,1
41822,4,21,14,7,2,0
180660,3,24,6,18,13,0
200101,2,7,10,-3,4,1
251861,3,14,13,1,10,1
275430,2,13,10,3,3,1
57562,4,31,16,15,10,0
147282,3,0,31,-31,15,1
252557,4,29,39,-10,10,1
92470,4,23,10,13,8,1
195811,3,20,14,6,2,1
393706,2,0,7,-7,5,1
364787,1,0,0,0,9,0
82998,4,20,19,1,4,0
101914,3,6,13,-7,12,1
29040,4,17,10,7,14,1
208646,3,6,6,0,8,0
69266,2,13,0,13,15,0
218328,3,17,23,-6,12,1
76746,1,3,0,3,1,1
48773,4,17,25,-8,5,0
108926,1,6,0,6,15,0
386204,2,6,10,-4,2,1
66374,4,14,24,-10,14,0
264042,1,7,7,0,15,1
101241,3,7,7,0,12,1
367312,4,6,17,-11,10,0
67675,4,7,35,-28,14,0
184330,1,0,3,-3,14,0
208939,3,17,6,11,8,0
300206,4,28,3,25,14,0
140886,3,17,7,10,13,0
33397,3,20,10,10,16,0
104974,4,17,22,-5,14,0
298253,3,20,13,7,14,1
386168,2,3,3,0,2,1
412259,4,28,15,13,13,1
61710,3,24,17,7,12,0
3010,3,13,31,-18,2,0
349161,3,27,7,20,2,0
377529,2,0,6,-6,15,1
362067,2,14,10,4,8,1
201065,4,41,7,34,5,0
65352,4,13,21,-8,13,0
282232,2,9,7,2,6,1
311237,3,6,0,6,2,0
131359,2,7,10,-3,8,0
155980,2,10,14,-4,2,0
159571,3,17,6,11,3,1
241104,2,13,7,6,5,0
372614,2,7,6,1,13,1
80874,4,6,13,-7,3,0
321481,4,21,30,-9,7,1
300853,1,0,7,-7,15,0
58688,1,7,7,0,10,0
323562,4,34,17,17,7,0
317970,2,10,10,0,5,1
278794,2,7,7,0,5,0
59300,1,0,3,-3,11,0
361825,3,37,10,27,7,1
191051,1,0,0,0,17,1
29546,2,0,10,-10,14,0
132285,3,24,7,17,9,1
220935,1,0,0,0,14,1
394719,1,14,0,14,5,0
155710,3,10,20,-10,2,1
394857,2,0,14,-14,5,0
154661,4,31,28,3,1,0
276219,3,24,10,14,3,0
225515,3,0,21,-21,15,1
200285,2,17,14,3,4,0
282018,4,28,28,0,6,1
101996,2,7,0,7,12,0
277521,2,3,7,-4,4,1
315088,3,37,14,23,4,1
365771,3,17,17,0,9,1
105174,1,7,0,7,14,1
119423,2,6,14,-8,3,1
361369,3,10,7,3,7,0
260619,2,0,10,-10,14,1
136777,3,13,10,3,11,1
301091,4,33,13,20,15,0
337464,2,7,9,-2,14,1
220793,1,0,0,0,14,0
23470,2,7,7,0,11,1
2068,2,0,7,-7,1,0
1551,3,6,13,-7,1,1
45186,3,7,10,-3,4,1
20436,1,0,0,0,10,1
215114,4,22,7,15,11,1
96980,4,22,17,5,10,1
33786,2,0,16,-16,16,0
51044,3,0,20,-20,6,1
364918,4,16,23,-7,9,0
331860,2,0,0,0,12,0
88043,3,24,3,21,6,0
100737,1,6,0,6,12,0
220901,4,28,41,-13,14,1
29199,4,3,26,-23,14,0
20265,1,7,0,7,10,0
246908,2,14,7,7,8,0
250050,3,17,13,4,9,1
143901,1,0,0,0,14,0
333517,2,13,0,13,12,0
366574,3,20,14,6,10,1
152923,2,14,14,0,1,1
76501,2,0,20,-20,1,1
65227,4,10,10,0,13,0
7920,3,3,20,-17,4,0
113675,4,9,13,-4,17,1
179546,2,0,23,-23,12,1
272218,2,0,0,0,2,0
403118,1,0,0,0,9,1
84413,2,3,0,3,4,1
46802,4,14,33,-19,4,1
159463,4,20,23,-3,3,1
307426,1,14,3,11,17,0
49727,4,28,31,-3,6,1
160591,1,0,0,0,4,0
16899,2,14,13,1,8,0
175889,3,20,27,-7,11,1
31035,3,10,6,4,15,1
381506,2,14,0,14,17,1
36443,1,0,3,-3,17,0
29799,1,0,0,0,14,1
180014,2,7,20,-13,13,1
194188,3,6,17,-11,1,0
263539,4,20,29,-9,15,0
211531,3,36,14,22,9,0
104090,2,10,13,-3,13,1
78324,4,24,21,3,2,0
267467,1,0,7,-7,17,1
315867,4,9,19,-10,4,1
246875,1,0,0,0,8,0
300922,3,10,20,-10,15,1
146763,1,0,0,0,15,1
97129,4,34,6,28,10,0
274416,3,10,17,-7,3,1
75757,3,28,16,12,1,0
242986,5,34,34,0,6,1
198058,4,3,30,-27,3,0
390039,1,0,0,0,3,1
229881,3,19,14,5,17,1
230938,4,31,10,21,1,0
411337,3,17,10,7,13,0
310668,4,13,33,-20,2,0
176248,4,14,27,-13,11,1
181953,1,0,0,0,13,1
33510,2,14,0,14,16,1
143803,3,6,0,6,14,0
259349,4,21,27,-6,13,1
332812,4,35,16,19,12,1
357216,1,0,3,-3,5,1
121375,3,7,3,4,3,0
254307,3,6,19,-13,11,1
40586,2,17,7,10,2,1
5499,2,10,10,0,3,1
149097,3,14,17,-3,16,1
352883,4,14,16,-2,3,0
135834,3,7,14,-7,10,0
73728,1,0,0,0,17,1
166300,3,7,9,-2,6,1
263118,1,0,7,-7,15,0
244012,2,7,10,-3,6,0
217414,1,3,0,3,12,1
5932,2,7,23,-16,3,1
220369,1,13,0,13,13,0
203153,2,0,7,-7,5,0
139629,4,9,14,-5,12,0
40094,4,20,14,6,1,0
313055,4,20,0,20,3,1
380755,1,3,7,-4,16,1
146948,1,14,0,14,15,0
147067,1,0,14,-14,15,1
145610,2,21,0,21,14,1
336095,1,3,0,3,13,1
320725,2,14,23,-9,6,1
148897,2,3,6,-3,16,0
386629,2,7,13,-6,2,1
364300,4,3,29,-26,9,0
285957,3,29,7,22,8,0
391716,2,3,10,-7,4,0
396860,3,20,10,10,6,1
150259,1,6,0,6,16,1
265257,4,9,6,3,16,1
379782,4,9,24,-15,16,1
281663,3,24,10,14,6,0
82488,3,10,17,-7,3,0
331326,3,0,27,-27,11,1
313845,1,7,10,-3,3,1
88767,2,12,3,9,6,1
234091,4,20,14,6,2,1
333445,4,26,20,6,12,1
97902,1,0,0,0,11,0
70391,1,7,0,7,15,0
109268,2,6,0,6,15,0
344971,3,10,14,-4,17,0
411747,2,0,10,-10,13,1
106610,3,34,0,34,14,0
323879,4,16,30,-14,8,0
212666,4,9,31,-22,10,1
218814,4,3,19,-16,13,1
121772,1,0,0,0,4,0
262770,3,28,17,11,15,1
299899,3,13,8,5,14,0
378802,4,17,10,7,15,0
151437,1,21,0,21,17,0
364526,2,3,14,-11,9,1
28082,3,21,10,11,13,0
405959,4,14,7,7,11,0
112190,4,27,34,-7,17,1
190136,4,27,3,24,17,1
91436,2,3,0,3,8,0
135476,1,7,0,7,10,1
307182,2,0,10,-10,17,1
137855,2,10,6,4,11,1
261368,2,7,14,-7,14,0
36673,3,20,3,17,17,1
386740,1,0,0,0,2,0
202386,1,3,0,3,5,0
136814,4,20,13,7,11,1
2739,4,9,7,2,2,1
95228,1,3,6,-3,10,0
406427,4,31,7,24,11,1
251745,4,24,9,15,10,1
286177,5,24,24,0,8,0
243006,5,34,34,0,6,1
293349,2,7,0,7,11,0
324349,1,0,0,0,8,1
153413,2,13,10,3,1,1
71973,1,0,0,0,16,0
341713,3,23,13,10,16,1
415300,2,0,14,-14,15,0
279162,4,21,23,-2,5,1
92855,2,21,0,21,8,1
342655,1,0,0,0,16,1
233116,2,22,3,19,2,0
53298,4,10,10,0,8,0
134282,1,0,7,-7,10,1
8269,4,16,13,3,4,1
156260,5,24,23,1,2,1
190000,4,16,10,6,17,1
248018,3,21,6,15,8,1
189846,4,27,17,10,17,1
389103,3,30,0,30,3,0
249191,1,9,0,9,9,1
357151,4,6,14,-8,5,1
24440,4,16,7,9,12,0
282163,4,30,15,15,6,0
19172,3,21,10,11,10,0
269856,4,22,10,12,1,0
146614,1,0,0,0,15,0
363745,4,26,27,-1,8,1
83745,4,22,23,-1,4,1
376764,1,0,0,0,15,1
233782,3,13,34,-21,2,0
40384,4,15,10,5,2,1
5591,4,26,10,16,3,1
413586,3,9,17,-8,14,0
279817,2,7,6,1,5,1
187240,2,7,6,1,16,1
294849,3,42,21,21,12,0
140730,2,12,14,-2,12,1
139847,3,13,17,-4,12,1
166124,2,14,6,8,6,1
144472,4,16,33,-17,14,1
314235,4,17,20,-3,3,1
228583,1,7,7,0,17,1
207582,2,21,3,18,7,0
241707,3,7,3,4,5,1
398380,3,3,27,-24,7,1
245285,3,9,3,6,7,0
164631,3,7,17,-10,5,1
385301,3,14,20,-6,1,0
410244,2,7,0,7,13,0
32896,4,25,7,18,15,1
41805,3,13,14,-1,2,0
190973,3,12,0,12,17,0
1902,1,0,0,0,1,1
56517,1,10,0,10,9,1
105806,2,6,3,3,14,0
207335,3,13,21,-8,7,1
264642,5,20,20,0,16,1
135275,4,24,17,7,10,0
252432,1,0,0,0,10,1
418866,2,7,10,-3,16,1
74049,1,3,0,3,17,1
207586,2,21,3,18,7,0
222227,3,13,17,-4,14,0
54557,4,21,18,3,8,1
380292,4,29,30,-1,16,1
404355,3,20,6,14,10,1
23247,4,30,13,17,11,0
151517,4,35,7,28,17,1
262915,4,14,23,-9,15,0
44789,4,16,19,-3,3,0
235574,3,24,13,11,3,1
227732,2,3,7,-4,16,1
41517,3,15,7,8,2,0
158044,2,3,6,-3,3,0
245712,2,10,10,0,7,0
42735,4,7,20,-13,3,0
407456,4,14,10,4,11,0
182052,4,17,20,-3,13,0
162423,4,20,30,-10,4,1
43630,1,7,3,4,3,0
162793,2,0,0,0,5,0
2454,4,28,20,8,2,1
331770,3,13,27,-14,12,1
334760,4,32,11,21,13,1
217118,2,0,7,-7,12,0
233772,3,13,27,-14,2,0
285374,1,0,0,0,8,1
198991,4,19,23,-4,3,0
139869,4,20,17,3,12,1
352994,3,20,10,10,3,1
339233,2,7,0,7,15,1
257738,4,3,24,-21,13,1
350690,1,0,0,0,2,1
333702,3,21,0,21,12,0
149709,3,27,0,27,16,0
165671,2,7,7,0,6,1
188122,2,7,10,-3,16,0
256335,4,21,24,-3,12,1
352854,3,14,10,4,3,1
199729,4,34,10,24,4,1
85655,2,24,7,17,5,0
58507,1,0,3,-3,10,0
37009,1,3,0,3,17,1
385727,1,7,0,7,1,1
186001,2,10,26,-16,15,0
370045,3,24,13,11,12,0
245845,2,3,17,-14,7,0
51620,3,21,13,8,7,0
96530,4,17,24,-7,10,0
133097,1,0,0,0,9,1
144123,3,23,0,23,14,0
187430,4,41,14,27,16,1
161996,1,7,0,7,4,0
261356,2,7,14,-7,14,0
54928,2,0,3,-3,8,1
318819,1,7,0,7,5,0
372496,4,23,14,9,13,0
23999,4,26,6,20,12,1
378679,1,7,0,7,15,0
297187,1,0,0,0,13,0
45794,4,13,14,-1,4,1
175084,2,7,9,-2,10,0
254440,2,20,0,20,11,0
417396,4,16,17,-1,16,1
349727,3,17,7,10,2,1
8909,2,21,0,21,4,0
37435,1,0,0,0,17,0
253537,2,3,7,-4,11,1
75776,3,35,26,9,1,0
357549,3,10,12,-2,5,0
203647,3,7,13,-6,6,0
270380,2,3,0,3,1,0
177396,2,17,10,7,11,1
272310,4,12,13,-1,2,1
162832,3,3,3,0,5,0
49232,3,17,10,7,6,1
20220,4,24,10,14,10,0
371224,4,14,19,-5,12,1
154592,2,14,7,7,1,0
393369,2,21,7,14,5,0
117877,4,12,20,-8,2,1
227172,3,13,7,6,16,0
33001,3,12,37,-25,15,0
241459,4,10,42,-32,5,1
170909,3,14,20,-6,8,1
262764,3,28,10,18,15,1
7709,2,10,0,10,4,0
177724,3,13,14,-1,12,0
160103,1,0,0,0,3,1
392247,4,10,16,-6,4,0
219906,1,3,0,3,13,0
316522,1,0,0,0,4,1
231049,3,24,8,16,1,1
74487,1,0,0,0,17,0
20793,1,7,0,7,10,1
161011,4,16,7,9,4,1
59157,1,0,21,-21,10,0
229621,4,33,13,20,17,0
220634,1,0,0,0,13,0
291752,3,3,14,-11,11,0
237474,1,14,0,14,3,0
195778,2,10,7,3,2,0
39775,4,9,7,2,1,1
259148,2,14,7,7,13,1
347572,1,0,0,0,1,1
409866,3,23,8,15,12,1
137271,4,7,20,-13,11,1
270376,1,3,0,3,1,0
154849,1,3,0,3,1,0
214556,2,3,0,3,11,0
278002,2,3,10,-7,4,0
404781,2,10,13,-3,10,1
17913,1,0,0,0,9,1
383626,1,0,7,-7,17,0
405171,4,12,16,-4,10,1
4084,3,16,21,-5,2,1
144834,1,14,0,14,14,0
174115,4,8,36,-28,10,1
67661,4,7,35,-28,14,1
15265,4,23,7,16,8,1
161170,4,3,33,-30,4,0
12001,3,24,14,10,6,0
244291,4,26,7,19,6,0
212249,1,0,0,0,10,1
299541,2,0,3,-3,14,1
306471,3,10,17,-7,17,0
280481,4,34,31,3,5,0
165912,1,0,6,-6,6,0
397817,1,0,0,0,7,0
18993,2,0,0,0,10,0
45962,4,17,3,14,4,0
26827,1,0,0,0,13,1
354226,3,13,10,3,4,0
39417,2,3,10,-7,1,1
183413,3,24,3,21,14,0
39879,3,6,7,-1,1,0
234954,2,10,3,7,2,1
379559,2,13,3,10,16,0
267320,4,17,17,0,17,1
301452,2,17,3,14,15,0
224435,2,6,10,-4,15,1
70667,4,17,22,-5,15,1
189366,4,20,10,10,16,0
33475,1,0,0,0,16,1
382283,4,17,3,14,17,0
387070,2,7,14,-7,2,1
141163,2,3,14,-11,13,0
329026,1,0,7,-7,10,1
198806,3,3,16,-13,3,1
296936,3,26,0,26,13,0
338200,2,14,21,-7,14,0
102146,1,7,0,7,13,1
26652,4,24,20,4,13,0
177376,2,10,7,3,11,1
183472,4,27,6,21,14,0
16578,1,0,0,0,8,0
23151,2,13,0,13,11,1
124886,3,9,6,3,5,1
32286,4,27,28,-1,15,1
359299,2,3,13,-10,6,0
297623,1,7,0,7,13,0
260300,1,0,0,0,14,1
140584,2,17,7,10,12,1
417478,2,10,20,-10,16,0
163761,3,7,12,-5,5,0
356498,3,6,3,3,5,1
351962,3,21,14,7,3,0
115841,2,0,10,-10,1,1
250724,1,0,0,0,10,1
267095,2,3,3,0,17,1
135800,2,7,14,-7,10,1
123246,4,19,21,-2,4,1
264168,4,27,27,0,15,0
266269,4,38,19,19,16,0
232660,3,7,0,7,1,0
4658,3,13,13,0,2,0
134552,1,0,0,0,10,1
348740,4,24,17,7,2,1
123284,1,7,0,7,4,0
277630,4,27,28,-1,4,1
134793,3,40,17,23,10,1
306491,4,17,17,0,17,0
236777,2,0,9,-9,3,0
330791,1,3,3,0,11,1
50780,4,24,21,3,6,1
147158,4,17,46,-29,15,0
109283,3,6,0,6,15,1
231021,3,17,0,17,1,1
359587,2,17,0,17,6,1
22696,1,3,0,3,11,1
337472,2,7,9,-2,14,0
161217,1,0,3,-3,4,1
297308,1,0,0,0,13,0
315421,4,23,30,-7,4,0
117815,3,6,6,0,2,1
337498,3,7,12,-5,14,0
113312,3,16,30,-14,17,0
279890,4,24,13,11,5,1
301097,4,33,13,20,15,1
309917,1,0,0,0,2,0
131350,2,7,10,-3,8,0
311276,4,9,3,6,2,0
357298,4,6,19,-13,5,1
238315,1,3,9,-6,4,1
264827,4,24,37,-13,16,0
400757,1,0,0,0,8,1
313054,4,20,0,20,3,0
285809,3,13,24,-11,8,1
329657,3,16,14,2,11,1
89803,2,3,3,0,7,1
180934,2,10,7,3,13,1
365126,2,6,14,-8,9,1
45004,2,10,10,0,4,1
337513,3,7,12,-5,14,0
344926,2,3,7,-4,17,0
409580,4,42,17,25,12,0
92842,2,21,0,21,8,0
356635,1,6,3,3,5,1
387628,4,13,6,7,2,0
42216,2,17,0,17,2,1
141340,2,3,14,-11,13,1
191468,1,0,0,0,17,0
99450,2,0,3,-3,11,1
192122,2,0,6,-6,1,0
174160,2,0,3,-3,10,1
36417,4,34,26,8,17,0
416570,1,0,0,0,15,0
397638,4,6,27,-21,7,1
419757,3,10,17,-7,17,1
362337,2,10,7,3,8,0
128543,4,21,35,-14,7,0
168861,2,14,3,11,7,1
329145,1,0,0,0,10,1
167124,1,0,0,0,7,1
6235,2,13,0,13,3,0
293948,3,7,21,-14,12,1
318640,4,10,13,-3,5,1
310604,2,13,26,-13,2,0
201905,1,0,0,0,5,0
129912,4,13,0,13,7,1
14050,3,3,21,-18,7,0
234102,4,27,14,13,2,0
95121,2,9,10,-1,9,0
246311,2,7,3,4,7,1
138694,4,13,28,-15,12,0
183613,1,0,0,0,14,0
413796,1,7,0,7,14,0
337821,3,30,6,24,14,0
292841,1,0,0,0,11,0
82035,3,10,7,3,3,1
124973,2,3,3,0,5,0
65392,1,0,7,-7,13,0
369508,1,3,0,3,11,0
182427,1,7,0,7,14,1
271097,1,0,7,-7,1,1
225239,4,10,7,3,15,1
278212,3,24,21,3,4,1
261409,3,10,17,-7,14,0
269238,3,3,13,-10,17,1
188576,3,10,13,-3,16,1
193021,5,20,20,0,1,0
274727,3,17,12,5,3,0
331521,1,0,0,0,11,0
154400,1,0,0,0,1,1
46716,1,7,0,7,4,1
382727,4,9,13,-4,17,0
122067,1,0,7,-7,4,1
113562,2,0,0,0,17,0
309456,4,14,6,8,1,1
55825,2,0,7,-7,9,1
34650,4,31,10,21,16,1
112859,2,7,3,4,17,1
53388,2,3,14,-11,8,1
229891,3,20,14,6,17,1
346147,1,7,0,7,1,1
21034,4,21,31,-10,10,1
237643,2,3,7,-4,4,0
228045,2,3,3,0,17,1
172906,4,27,24,3,9,1
268416,2,14,0,14,17,0
323780,2,6,3,3,8,0
190848,3,16,10,6,17,1
231729,2,3,7,-4,1,0
81146,4,16,14,2,3,1
157369,1,3,0,3,2,1
236958,3,36,7,29,3,1
19916,4,16,21,-5,10,1
260241,3,10,3,7,14,0
222135,1,0,0,0,14,0
349577,2,6,28,-22,2,0
340975,4,17,17,0,15,1
31070,4,13,13,0,15,1
408412,1,0,0,0,12,1
114957,2,7,3,4,1,0
97473,1,13,0,13,10,0
223492,2,7,3,4,15,0
299838,2,9,0,9,14,1
404303,2,0,3,-3,10,1
33986,3,10,27,-17,16,1
178577,4,16,20,-4,12,1
32243,3,21,14,7,15,1
181717,2,7,7,0,13,1
159101,3,24,0,24,3,0
205409,4,27,0,27,6,0
294796,2,20,14,6,12,1
98242,2,7,17,-10,11,1
130358,3,7,3,4,8,1
26520,1,0,0,0,13,1
320983,2,7,0,7,6,0
241247,2,3,0,3,5,0
16190,1,0,0,0,8,1
347160,3,23,16,7,1,0
304178,2,7,0,7,16,0
130440,1,0,0,0,8,1
71401,1,14,0,14,16,0
193440,3,23,20,3,1,0
99168,2,3,3,0,11,1
277260,3,0,13,-13,4,0
292183,3,21,7,14,11,0
178395,4,31,34,-3,12,1
181620,4,23,6,17,13,0
257184,2,0,9,-9,12,1
329742,1,3,0,3,11,0
417532,3,24,28,-4,16,0
108964,2,16,14,2,15,0
414538,2,14,3,11,14,1
13193,3,22,23,-1,6,0
119574,2,10,0,10,3,0
296182,3,16,19,-3,13,0
403321,3,9,0,9,9,0
362955,2,27,6,21,8,0
15385,4,10,17,-7,8,1
148896,1,3,6,-3,16,0
257889,4,16,19,-3,13,1
386571,4,14,31,-17,2,1
257287,4,26,26,0,12,1
212091,1,0,7,-7,10,1
331929,4,6,28,-22,12,1
125285,2,3,0,3,5,0
155558,3,23,3,20,2,1
87723,3,6,20,-14,6,1
161785,3,24,6,18,4,1
125120,2,7,7,0,5,1
230120,2,3,10,-7,17,1
13568,2,3,0,3,7,0
9309,2,14,0,14,5,0
96353,4,3,30,-27,10,0
227246,1,3,10,-7,16,0
152298,1,0,0,0,17,1
388035,3,13,6,7,2,1
230408,2,7,0,7,1,1
267902,4,29,24,5,17,0
281183,3,21,13,8,6,1
412431,1,0,7,-7,14,1
345427,3,0,13,-13,17,0
380600,4,28,27,1,16,1
70446,2,14,17,-3,15,0
256791,4,13,13,0,12,1
170521,1,7,0,7,8,0
374405,2,15,0,15,14,1
58061,1,7,10,-3,10,0
242328,3,10,13,-3,6,1
287241,4,16,23,-7,8,1
200329,4,30,14,16,4,0
96982,4,22,17,5,10,1
151422,1,7,0,7,17,1
377903,4,23,13,10,15,1
126227,3,21,6,15,6,1
147219,1,0,21,-21,15,1
164508,3,17,0,17,5,0
414062,1,0,0,0,14,1
174174,2,0,6,-6,10,1
70104,1,3,0,3,15,0
297913,1,10,0,10,13,0
98042,4,17,24,-7,11,1
270542,2,10,7,3,1,0
95570,3,9,10,-1,10,1
261852,3,6,20,-14,14,1
81719,3,17,17,0,3,1
342727,2,0,7,-7,16,0
351760,1,7,14,-7,3,1
79508,4,12,24,-12,2,1
180649,3,24,6,18,13,0
271301,3,6,17,-11,1,1
319364,4,16,28,-12,6,1
108992,3,16,27,-11,15,0
51955,4,13,16,-3,7,0
152711,4,27,13,14,17,1
30778,4,31,28,3,15,0
380005,2,7,0,7,16,0
421435,4,31,20,11,17,0
1203,2,10,0,10,1,1
116120,2,0,3,-3,1,1
197777,4,21,17,4,3,0
96406,1,0,7,-7,10,0
204071,1,3,7,-4,6,0
381542,3,21,13,8,17,1
331511,4,9,35,-26,11,1
217482,3,12,3,9,12,1
121104,4,25,31,-6,3,0
140348,3,17,26,-9,12,1
165216,2,7,7,0,6,0
194674,4,34,10,24,2,1
260945,2,7,0,7,14,1
414890,3,28,7,21,15,1
174650,2,6,0,6,10,0
158999,4,27,29,-2,3,0
405143,3,6,10,-4,10,1
86747,4,24,14,10,5,1
385268,2,7,3,4,1,0
76460,1,0,7,-7,1,1
63205,4,14,23,-9,12,0
6922,1,0,0,0,3,0
201589,1,0,0,0,5,1
72457,2,7,7,0,16,0
278112,1,0,7,-7,4,1
232360,3,6,15,-9,1,1
329619,2,10,7,3,11,1
402534,1,7,0,7,9,0
45828,1,0,0,0,4,1
190256,3,7,14,-7,17,0
395389,3,28,3,25,5,1
156116,1,7,7,0,2,0
421357,2,3,10,-7,17,1
309389,2,0,0,0,1,1
68892,4,6,20,-14,15,1
149817,2,3,10,-7,16,1
159074,2,17,0,17,3,0
287188,3,10,13,-3,8,0
75464,3,31,7,24,17,1
51615,2,14,13,1,7,0
85218,3,10,17,-7,4,1
252481,3,7,22,-15,10,1
348568,3,28,17,11,2,1
404153,2,6,7,-1,10,1
230889,3,14,10,4,1,1
234474,2,17,13,4,2,0
30301,3,3,10,-7,14,0
227081,4,20,12,8,16,1
412050,2,21,0,21,13,0
400837,3,24,13,11,8,0
294789,2,7,14,-7,12,1
373820,2,13,0,13,13,1
137420,3,6,21,-15,11,0
407374,1,0,7,-7,11,1
45994,1,0,6,-6,4,0
385711,1,0,0,0,1,0
284715,1,0,7,-7,7,1
19042,3,7,6,1,10,1
180699,1,0,0,0,13,1
256966,4,32,27,5,12,0
81107,2,10,14,-4,3,1
73713,4,20,9,11,17,0
228144,1,6,3,3,17,1
202746,3,13,17,-4,5,1
398047,2,14,21,-7,7,1
80950,2,13,0,13,3,1
123150,2,3,7,-4,4,0
227467,3,13,10,3,16,1
111106,3,24,7,17,16,0
375039,3,28,27,1,14,0
53413,3,3,21,-18,8,0
9590,1,3,7,-4,5,1
383055,1,10,7,3,17,1
392063,4,18,24,-6,4,0
26669,1,0,0,0,13,0
224079,4,14,9,5,15,1
401768,4,27,14,13,8,0
42938,3,24,23,1,3,0
251538,3,16,13,3,10,0
260295,1,0,0,0,14,1
168580,2,14,10,4,7,0
238602,1,6,0,6,4,0
294538,3,17,13,4,12,1
235362,1,14,0,14,3,0
14068,4,3,24,-21,7,0
138436,2,7,7,0,12,1
65968,4,24,28,-4,13,1
155674,2,3,13,-10,2,1
189725,1,0,3,-3,17,0
25975,2,10,6,4,13,0
218500,4,31,17,14,13,1
121192,2,14,13,1,3,0
401029,4,29,15,14,8,0
52226,3,7,16,-9,7,0
322711,1,0,0,0,7,0
263143,2,3,7,-4,15,0
105732,3,35,3,32,14,0
23388,4,20,17,3,11,0
195158,1,0,0,0,2,1
8536,4,21,10,11,4,1
382716,4,3,13,-10,17,0
234249,4,20,17,3,2,1
45131,2,7,7,0,4,1
41110,4,3,19,-16,2,1
235860,2,0,14,-14,3,0
328845,4,24,20,4,10,0
239178,4,20,16,4,4,0
305740,3,9,10,-1,17,0
320131,3,17,0,17,6,0
314283,1,0,7,-7,3,1
148347,3,14,3,11,16,1
64900,3,10,3,7,13,0
212859,5,24,27,-3,10,0
163911,3,23,10,13,5,1
361536,3,10,7,3,7,1
193327,1,0,0,0,1,0
182967,3,10,37,-27,14,1
221822,1,0,0,0,14,0
49987,3,21,7,14,6,0
420431,1,0,7,-7,17,0
149702,3,20,0,20,16,1
358765,4,14,17,-3,6,0
91762,2,0,0,0,8,1
57848,4,22,17,5,10,0
65627,3,6,16,-10,13,1
275351,4,10,19,-9,3,0
375186,4,17,17,0,14,1
171427,1,0,0,0,9,1
201457,2,12,0,12,5,1
299880,3,13,8,5,14,0
78678,1,10,0,10,2,0
406535,3,14,23,-9,11,0
335817,1,7,7,0,13,1
106013,3,24,3,21,14,1
134822,4,48,17,31,10,0
319592,1,3,0,3,6,1
14271,2,0,7,-7,7,0
255368,3,14,6,8,12,1
189773,2,16,6,10,17,1
181126,3,24,14,10,13,1
53683,2,0,0,0,8,1
27337,2,21,3,18,13,0
333881,4,28,28,0,12,0
214970,1,0,0,0,11,1
208572,1,0,0,0,8,1
398127,4,30,42,-12,7,1
240350,4,14,23,-9,5,0
311500,3,10,10,0,2,1
76726,1,0,0,0,1,0
168574,2,7,10,-3,7,1
122678,1,0,3,-3,4,1
111361,2,0,7,-7,16,0
269647,2,3,0,3,1,1
188431,3,3,3,0,16,1
250094,4,17,16,1,9,1
307976,3,14,6,8,1,0
262074,1,7,0,7,15,0
322254,4,0,27,-27,7,1
143582,1,0,0,0,14,0
266018,1,7,0,7,16,1
236510,3,7,9,-2,3,1
329416,4,16,41,-25,10,0
239520,1,3,0,3,4,0
214,2,12,10,2,1,0
386677,3,17,13,4,2,0
263657,3,20,10,10,15,1
139411,2,21,0,21,12,0
179133,3,9,13,-4,12,1
44383,1,0,0,0,3,0
400746,1,0,0,0,8,0
245788,4,23,20,3,7,1
277733,3,7,3,4,4,0
271959,4,23,26,-3,2,0
353415,3,18,0,18,4,0
96090,4,16,21,-5,10,0
134524,4,3,36,-33,10,0
212125,2,3,14,-11,10,1
53755,4,10,3,7,8,0
167845,2,7,13,-6,7,1
395489,2,14,0,14,6,0
421516,2,3,3,0,17,0
382219,2,10,3,7,17,1
384341,4,16,10,6,1,1
286025,1,0,0,0,8,1
272285,4,12,10,2,2,0
221459,3,3,38,-35,14,0
204762,3,14,14,0,6,1
46883,2,13,6,7,5,0
117900,1,0,0,0,2,0
387972,2,3,0,3,2,0
176508,2,9,17,-8,11,1
399525,3,0,26,-26,7,1
335054,4,16,20,-4,13,1
190252,3,7,14,-7,17,1
234621,2,17,17,0,2,1
134272,4,10,26,-16,10,1
375172,3,17,10,7,14,0
19994,2,9,3,6,10,0
255732,1,0,0,0,12,0
204793,4,28,21,7,6,0
28044,2,7,7,0,13,1
118599,4,31,10,21,2,1
327230,2,0,3,-3,9,1
265109,3,13,10,3,16,1
336037,4,16,25,-9,13,1
240519,4,6,7,-1,5,1
167988,2,0,14,-14,7,1
121363,3,7,0,7,3,0
187221,2,0,6,-6,16,0
92277,2,10,0,10,8,1
231596,2,14,3,11,1,0
217853,2,10,14,-4,12,0
61704,3,17,17,0,12,1
73577,4,9,41,-32,17,1
270191,1,3,0,3,1,0
12145,4,14,21,-7,6,1
251741,4,24,3,21,10,0
303898,2,7,17,-10,16,0
48584,3,14,17,-3,5,1
72702,4,27,13,14,16,1
166424,2,17,7,10,6,0
375384,4,14,24,-10,14,1
279859,3,17,13,4,5,1
155816,2,7,10,-3,2,0
144943,4,20,7,13,14,0
339305,3,38,7,31,15,1
204075,1,3,7,-4,6,1
40739,2,17,14,3,2,1
168837,2,14,0,14,7,1
39606,3,27,6,21,1,1
115481,4,45,28,17,1,1
164755,2,23,14,9,6,1
418602,3,14,17,-3,16,1
52466,1,3,0,3,7,0
43086,3,3,10,-7,3,0
290207,2,10,0,10,10,1
105065,2,19,14,5,14,0
208404,4,23,43,-20,8,0
73487,2,3,21,-18,17,1
380558,3,14,24,-10,16,1
335745,3,10,7,3,13,0
273561,1,0,0,0,2,1
315695,4,10,13,-3,4,0
192566,1,0,0,0,1,1
176997,3,20,6,14,11,0
341041,2,7,14,-7,15,1
349671,1,7,0,7,2,0
93280,2,14,3,11,9,0
268882,2,6,17,-11,17,1
260855,4,36,15,21,14,0
325510,4,22,13,9,8,0
34462,3,38,3,35,16,0
151734,2,7,3,4,17,0
256121,2,14,16,-2,12,1
249653,1,3,7,-4,9,0
53937,4,14,13,1,8,1
178612,2,3,3,0,12,0
133522,4,30,20,10,9,0
43059,2,3,7,-4,3,0
26220,1,0,7,-7,13,1
343104,4,12,20,-8,16,1
247638,4,26,26,0,8,1
331884,3,0,3,-3,12,0
291126,2,15,13,2,10,0
52392,3,9,17,-8,7,1
298012,4,37,7,30,13,1
132065,1,0,0,0,9,1
318573,2,10,7,3,5,1
83224,2,6,7,-1,4,0
397229,4,16,0,16,6,0
154428,2,14,0,14,1,0
42384,3,14,16,-2,2,1
271112,1,0,10,-10,1,1
323732,4,39,0,39,8,1
25007,3,16,21,-5,12,0
356996,3,20,3,17,5,0
394389,4,31,17,14,5,0
185170,1,0,0,0,15,1
243396,2,3,10,-7,6,1
246054,3,10,13,-3,7,0
366797,1,0,0,0,10,1
303264,2,10,0,10,16,1
18462,3,7,7,0,9,0
273440,2,0,0,0,2,0
379814,4,9,27,-18,16,1
41679,4,24,7,17,2,1
38904,1,7,0,7,1,0
191150,4,28,27,1,17,0
387674,2,0,7,-7,2,0
270374,1,0,0,0,1,1
378468,3,20,0,20,15,0
242080,4,20,16,4,5,0
344261,3,7,13,-6,17,1
89747,4,16,23,-7,7,0
414885,3,28,7,21,15,1
401681,2,0,14,-14,8,1
130334,2,7,0,7,8,1
308924,1,0,0,0,1,1
339241,2,14,0,14,15,1
240756,2,7,7,0,5,1
327369,2,0,7,-7,9,0
22929,4,3,23,-20,11,0
81453,4,10,13,-3,3,0
50206,1,7,7,0,6,1
370442,2,10,6,4,12,0
104972,4,17,22,-5,14,0
370270,2,0,21,-21,12,0
2789,1,14,7,7,2,0
27519,3,23,9,14,13,0
333754,1,0,0,0,12,1
398376,3,3,27,-24,7,1
218562,2,7,14,-7,13,0
292306,2,12,10,2,11,0
157138,3,16,20,-4,2,1
144681,2,0,0,0,14,0
122972,2,0,0,0,4,0
99333,3,19,3,16,11,1
365947,4,14,28,-14,9,0
250187,3,17,13,4,9,1
24352,2,3,0,3,12,1
42052,2,20,7,13,2,0
155439,4,13,10,3,2,1
2082,2,0,7,-7,1,1
174356,3,17,0,17,10,0
415410,2,9,0,9,15,0
129143,4,34,28,6,7,0
110032,3,34,10,24,16,0
353520,2,3,0,3,4,1
148527,4,24,10,14,16,0
56991,1,0,10,-10,9,0
232976,3,10,3,7,2,0
193370,2,7,10,-3,1,0
131811,2,7,7,0,8,1
216342,2,7,13,-6,12,1
8460,2,15,0,15,4,0
387458,4,21,16,5,2,0
122272,2,6,13,-7,4,0
93734,2,0,13,-13,9,1
91758,2,0,0,0,8,1
58532,2,7,3,4,10,1
267349,1,0,7,-7,17,1
4687,4,20,20,0,2,1
47648,2,3,17,-14,5,1
181916,4,21,35,-14,13,1
114569,1,0,0,0,1,0
399672,4,16,9,7,8,1
231534,5,30,29,1,1,1
270741,3,6,3,3,1,1
11383,3,23,0,23,6,0
148467,3,14,3,11,16,0
128608,1,3,7,-4,7,0
156358,3,31,0,31,2,0
227373,1,0,0,0,16,1
313789,4,34,17,17,3,1
313858,2,14,10,4,3,0
389498,2,13,3,10,3,1
79963,4,13,23,-10,2,0
179992,2,7,6,1,13,0
388149,2,3,6,-3,2,0
38164,1,3,0,3,1,0
287588,1,0,3,-3,9,1
208161,2,0,0,0,8,0
378357,4,12,13,-1,15,0
165023,2,7,10,-3,6,1
3875,2,16,7,9,2,1
138235,4,10,12,-2,11,1
202572,2,14,6,8,5,1
382104,2,21,3,18,17,1
134400,1,0,0,0,10,1
175440,4,17,23,-6,11,1
197349,4,27,10,17,3,1
295400,3,10,10,0,12,1
255649,2,3,7,-4,12,0
298569,4,13,0,13,14,1
324348,1,0,0,0,8,1
244666,2,7,23,-16,7,1
129672,1,0,3,-3,7,1
155777,4,30,30,0,2,0
142983,4,10,13,-3,13,0
178992,4,19,3,16,12,1
201393,4,28,28,0,5,0
232825,3,16,17,-1,2,0
32246,3,21,14,7,15,1
165655,2,0,7,-7,6,0
334058,1,0,0,0,13,1
35651,3,20,3,17,17,1
56921,3,34,7,27,9,1
177361,1,10,0,10,11,0
358157,3,17,6,11,6,0
268247,1,0,0,0,17,1
383971,2,0,10,-10,1,0
249723,3,21,21,0,9,1
182269,1,7,0,7,14,1
213771,1,14,0,14,10,0
218007,2,21,10,11,12,1
160277,1,3,0,3,4,0
116062,4,16,7,9,1,0
134114,4,27,13,14,9,1
136689,1,0,7,-7,11,0
363875,4,13,29,-16,8,1
298544,3,13,0,13,14,0
123290,1,7,7,0,4,1
293422,4,29,17,12,11,0
156808,3,23,20,3,2,1
172634,1,0,0,0,9,0
73994,4,37,0,37,17,0
320042,4,49,36,13,6,0
56184,4,27,21,6,9,0
221398,2,3,17,-14,14,1
350903,3,3,14,-11,3,0
193733,3,3,27,-24,1,1
347412,1,0,0,0,1,1
98082,1,0,0,0,11,1
36230,3,10,23,-13,17,0
340464,1,0,13,-13,15,0
356058,4,24,10,14,5,1
81269,3,10,7,3,3,0
131217,2,14,17,-3,8,0
192598,2,3,7,-4,1,1
371021,2,7,10,-3,12,1
336140,3,10,3,7,13,0
140305,2,14,13,1,12,1
204947,4,13,27,-14,6,1
229490,1,0,0,0,17,1
5975,3,17,23,-6,3,1
212385,4,13,17,-4,10,1
84012,3,20,3,17,4,1
180076,4,28,20,8,13,1
63426,2,14,3,11,12,0
214148,3,3,9,-6,11,1
136999,5,20,20,0,11,1
55505,1,10,0,10,9,0
357764,1,0,0,0,6,1
162409,4,13,27,-14,4,0
140156,3,10,3,7,12,0
17576,4,13,17,-4,9,0
400930,2,13,7,6,8,1
78986,2,0,7,-7,2,1
373708,3,13,18,-5,13,0
323253,4,7,10,-3,7,0
230955,1,0,0,0,1,0
47178,2,6,3,3,5,0
165002,1,7,3,4,6,0
130807,3,13,12,1,8,1
133949,4,13,6,7,9,1
70697,1,7,3,4,15,1
81883,3,0,27,-27,3,0
12669,2,10,0,10,6,1
300846,1,0,7,-7,15,1
36276,4,24,27,-3,17,0
385332,4,14,20,-6,1,1
237889,4,7,27,-20,4,1
403806,4,18,30,-12,9,1
205120,1,0,0,0,6,1
319649,2,24,3,21,6,0
74097,3,16,6,10,17,1
257956,2,0,7,-7,13,1
352823,2,14,3,11,3,1
31732,2,0,7,-7,15,0
238231,3,3,16,-13,4,1
172722,3,14,10,4,9,0
379340,3,10,16,-6,16,1
3298,3,3,3,0,2,1
390344,1,7,7,0,3,0
164497,3,17,0,17,5,0
212920,2,7,7,0,10,0
18628,4,17,17,0,9,1
206535,2,0,3,-3,7,0
388474,3,3,16,-13,2,1
110373,4,26,17,9,16,1
79319,3,15,3,12,2,1
255820,3,17,0,17,12,0
243387,1,3,7,-4,6,0
245798,4,30,20,10,7,0
48943,4,22,19,3,5,0
141711,3,23,21,2,13,1
126674,2,7,3,4,6,0
418050,4,28,35,-7,16,1
390956,2,10,7,3,4,1
386175,2,3,3,0,2,1
98056,5,24,24,0,11,1
28672,2,3,7,-4,14,0
341955,2,6,0,6,16,1
129534,2,3,14,-11,7,1
279262,3,16,13,3,5,1
199478,1,0,0,0,4,0
34442,3,24,3,21,16,1
411445,2,7,17,-10,13,1
4703,4,23,27,-4,2,1
320150,3,17,14,3,6,1
194951,4,14,19,-5,2,1
247361,1,0,0,0,8,1
203974,3,10,7,3,6,1
300316,3,0,7,-7,14,0
70513,4,32,23,9,15,1
374141,2,16,7,9,13,1
55708,3,23,21,2,9,1
284120,1,0,3,-3,7,0
256510,1,0,0,0,12,0
153450,4,20,17,3,1,1
382075,2,7,3,4,17,1
168059,4,6,24,-18,7,0
192014,3,17,20,-3,1,0
209179,1,0,7,-7,8,1
245150,3,17,22,-5,7,0
145296,2,14,9,5,14,0
105344,2,7,7,0,14,1
195600,4,24,7,17,2,0
328169,3,6,14,-8,10,1
21681,2,3,7,-4,11,1
135640,2,7,7,0,10,0
151625,3,16,13,3,17,1
159445,4,20,23,-3,3,1
74204,2,3,0,3,17,0
286319,4,22,19,3,8,1
115997,2,13,0,13,1,0
77448,4,27,21,6,1,0
42668,3,0,10,-10,3,1
397537,1,6,0,6,7,0
348829,2,3,14,-11,2,1
408569,1,7,0,7,12,1
331626,4,23,30,-7,11,0
377023,4,22,19,3,15,0
39538,2,0,3,-3,1,0
211268,1,0,0,0,9,1
23962,3,16,3,13,12,0
38024,1,3,0,3,1,0
231082,4,27,14,13,1,1
127510,3,3,23,-20,6,1
403222,4,24,17,7,9,0
133898,2,3,6,-3,9,0
421409,3,24,20,4,17,0
96026,3,13,7,6,10,1
362866,4,14,28,-14,8,0
161429,2,7,3,4,4,0
281212,4,24,16,8,6,0
145523,4,26,17,9,14,1
212978,4,21,7,14,10,1
50872,2,7,17,-10,6,0
244122,4,20,34,-14,6,0
348443,4,13,32,-19,1,1
419931,4,16,18,-2,17,1
224094,1,0,0,0,15,0
100277,1,6,0,6,12,1
10014,1,6,0,6,5,1
307318,2,14,19,-5,17,0
17844,3,16,10,6,9,0
392905,1,0,3,-3,4,0
186893,2,7,0,7,15,0
356379,4,24,14,10,5,1
52357,2,3,16,-13,7,0
372491,4,23,14,9,13,1
126057,2,7,3,4,6,1
81150,4,16,14,2,3,0
212475,3,10,3,7,10,1
163719,2,0,9,-9,5,1
333701,3,21,0,21,12,0
137396,2,6,21,-15,11,1
33601,5,17,16,1,16,0
36494,2,10,6,4,17,0
413077,2,20,14,6,14,1
181105,3,24,7,17,13,0
65981,1,0,0,0,13,1
335675,1,7,0,7,13,0
207446,2,14,14,0,7,0
348970,2,14,0,14,2,1
354991,3,7,19,-12,4,1
335886,3,28,14,14,13,1
181546,2,6,0,6,13,1
373302,1,0,0,0,13,1
246697,4,45,10,35,8,0
353926,4,17,28,-11,4,1
321533,1,0,0,0,7,0
320876,3,3,14,-11,6,1
50841,2,7,14,-7,6,0
258227,1,0,0,0,13,1
96707,2,0,7,-7,10,1
323399,3,20,0,20,7,0
360751,2,17,21,-4,7,1
133600,2,3,7,-4,9,0
311334,2,14,7,7,2,1
3974,4,29,14,15,2,0
54890,1,0,0,0,8,0
99840,4,8,27,-19,12,1
356481,2,0,3,-3,5,0
136549,1,0,10,-10,11,0
312634,1,0,0,0,3,1
88333,3,14,7,7,6,0
218208,4,30,3,27,12,0
97906,1,0,0,0,11,0
72870,1,0,0,0,16,0
227554,1,7,0,7,16,0
194569,2,7,0,7,2,1
89451,4,24,20,4,7,0
92173,4,3,43,-40,8,1
154951,4,29,17,12,1,0
216079,3,24,12,12,11,0
4816,4,27,3,24,3,0
118830,2,20,0,20,2,0
81205,1,0,7,-7,3,1
309554,2,13,0,13,1,0
277907,4,7,20,-13,4,1
103260,4,3,10,-7,13,1
78654,4,30,13,17,2,0
95669,2,10,3,7,10,0
224044,3,14,6,8,15,1
252283,2,0,13,-13,10,1
241671,2,0,3,-3,5,1
145660,4,35,7,28,14,0
267687,3,14,24,-10,17,0
265767,3,10,3,7,16,0
26473,4,30,19,11,13,0
152384,3,28,3,25,17,0
221939,4,19,19,0,14,0
186206,4,22,13,9,15,1
165137,4,24,24,0,6,0
152127,4,13,13,0,17,1
276986,4,24,20,4,4,0
366150,3,7,35,-28,10,0
421522,2,3,3,0,17,1
11375,2,20,0,20,6,0
288706,3,0,7,-7,9,0
44804,1,0,0,0,4,0
332062,4,10,9,1,12,0
26840,1,7,0,7,13,1
15155,1,0,0,0,8,1
253801,1,0,0,0,11,1
183538,2,7,10,-3,14,0
273909,2,7,3,4,2,1
885,1,0,0,0,1,1
34866,2,17,7,10,16,1
37508,3,7,7,0,17,1
9690,4,12,28,-16,5,1
295109,3,7,14,-7,12,1
272627,4,19,12,7,2,0
210948,4,26,22,4,9,0
133446,2,14,14,0,9,0
2682,2,6,7,-1,2,1
270714,3,6,3,3,1,1
391735,3,10,10,0,4,0
270516,2,0,7,-7,1,1
122442,3,6,26,-20,4,1
39196,1,0,0,0,1,1
398523,4,28,16,12,7,0
184286,4,34,14,20,14,0
86722,3,17,14,3,5,1
407297,3,17,16,1,11,0
331413,1,6,7,-1,11,0
184220,2,10,0,10,14,1
201417,1,6,0,6,5,1
168979,1,3,7,-4,7,0
417067,3,20,0,20,15,1
285114,3,3,0,3,7,0
324932,4,23,23,0,8,0
239120,2,10,10,0,4,1
232396,4,20,22,-2,1,0
330931,1,0,0,0,11,0
411500,4,13,23,-10,13,0
348696,3,17,10,7,2,1
42094,4,27,20,7,2,1
388525,4,3,23,-20,2,0
14308,2,2,7,-5,7,1
240489,3,3,7,-4,5,0
224077,4,14,9,5,15,1
75883,2,14,7,7,1,1
146921,1,0,0,0,15,0
82153,2,10,3,7,3,0
398509,3,21,16,5,7,1
122323,4,6,19,-13,4,1
383379,2,0,9,-9,17,1
240172,3,16,3,13,5,0
329919,2,7,10,-3,11,0
158066,3,22,9,13,3,0
336059,4,16,28,-12,13,0
326311,1,0,10,-10,9,1
413408,2,3,24,-21,14,0
408474,3,7,3,4,12,0
243601,3,20,7,13,6,0
163320,4,13,22,-9,5,0
362413,4,30,20,10,8,1
310891,2,3,3,0,2,1
275177,3,14,16,-2,3,1
358908,3,6,35,-29,6,0
126180,2,14,3,11,6,0
114315,1,7,6,1,1,0
273237,4,40,7,33,2,0
207790,4,24,16,8,7,1
278469,2,22,0,22,4,1
31745,2,0,10,-10,15,1
270161,4,27,27,0,1,1
134314,2,10,14,-4,10,0
64452,2,14,13,1,13,1
380298,4,29,30,-1,16,1
320021,4,43,30,13,6,0
310144,2,14,7,7,2,0
19060,4,10,6,4,10,1
208307,2,7,21,-14,8,1
111721,4,37,16,21,16,0
288689,2,0,7,-7,9,0
203184,2,7,17,-10,5,0
270786,1,0,0,0,1,1
122512,1,0,0,0,4,1
415448,3,15,3,12,15,1
337825,3,30,6,24,14,1
164344,3,20,0,20,5,1
183133,3,7,6,1,14,0
343632,2,15,7,8,17,1
203135,1,0,7,-7,5,1
300548,4,30,23,7,14,1
347692,4,27,24,3,1,1
238206,3,3,16,-13,4,0
151698,1,0,0,0,17,1
271611,3,23,20,3,2,0
264573,3,10,17,-7,16,0
12211,2,0,0,0,6,0
131639,1,0,13,-13,8,0
173287,2,14,10,4,10,0
174789,2,13,7,6,10,0
262409,2,7,7,0,15,1
274143,4,27,0,27,3,0
175094,2,7,10,-3,10,1
141418,4,10,20,-10,13,1
376563,3,15,6,9,14,1
17582,4,13,17,-4,9,1
56881,2,14,0,14,9,1
295282,3,14,5,9,12,1
95081,1,0,7,-7,9,1
125795,3,14,20,-6,5,0
314677,4,14,21,-7,3,1
110915,2,7,10,-3,16,1
15247,4,23,7,16,8,0
175411,3,17,6,11,11,0
387924,4,10,28,-18,2,0
410111,2,14,7,7,13,1
359612,3,24,0,24,6,0
361870,1,0,0,0,7,0
337561,4,7,33,-26,14,0
226618,3,10,3,7,16,0
182273,2,7,0,7,14,1
356715,3,19,16,3,5,1
343113,4,12,20,-8,16,0
140906,3,17,10,7,13,1
166375,1,3,0,3,6,1
20685,3,17,17,0,10,0
203457,2,14,3,11,6,0
181989,2,14,0,14,13,0
388622,3,14,0,14,3,0
144789,4,10,17,-7,14,1
289329,3,28,17,11,9,0
247988,2,13,3,10,8,1
254017,3,7,13,-6,11,0
193404,2,10,20,-10,1,0
295999,2,3,0,3,13,1
163713,1,0,6,-6,5,1
394271,1,0,0,0,5,1
110063,4,48,16,32,16,0
314256,4,17,23,-6,3,1
405100,2,0,10,-10,10,1
292188,3,21,14,7,11,1
34580,3,17,0,17,16,1
178958,3,9,3,6,12,0
319361,4,16,28,-12,6,1
383847,3,3,7,-4,1,1
142346,3,0,3,-3,13,1
314535,4,24,10,14,3,1
217471,3,9,3,6,12,0
194880,2,0,10,-10,2,0
400428,4,24,10,14,8,0
337091,4,26,6,20,14,0
310329,3,26,0,26,2,1
308976,2,0,3,-3,1,0
228243,4,10,27,-17,17,1
136911,2,0,13,-13,11,0
295548,3,23,7,16,12,0
329650,2,13,7,6,11,1
410831,1,14,0,14,13,0
318391,1,14,0,14,5,1
305321,4,42,21,21,16,1
151894,2,13,0,13,17,0
141263,4,10,24,-14,13,1
72158,1,0,3,-3,16,1
186456,2,10,10,0,15,0
85187,3,7,10,-3,4,1
129666,1,0,3,-3,7,1
206882,3,10,17,-7,7,0
64980,1,0,7,-7,13,0
374368,1,7,0,7,14,0
66371,3,14,24,-10,14,0
375272,1,0,0,0,14,1
381371,2,13,0,13,16,1
398441,1,7,0,7,7,0
209730,3,9,6,3,8,1
284814,4,29,20,9,7,0
329678,3,23,17,6,11,1
268506,4,23,9,14,17,1
266930,2,13,0,13,17,0
378589,3,17,13,4,15,0
273373,4,35,7,28,2,1
369559,3,14,0,14,11,1
381129,4,24,28,-4,16,0
415166,3,3,24,-21,15,1
114543,4,17,40,-23,1,1
36566,4,23,34,-11,17,0
269629,2,3,0,3,1,1
60660,2,7,3,4,11,1
338387,3,17,10,7,14,0
209112,3,9,27,-18,8,0
270784,1,0,0,0,1,1
247415,2,3,9,-6,8,0
73833,4,13,0,13,17,0
362510,3,14,6,8,8,1
15984,4,18,14,4,8,0
70022,3,24,10,14,15,0
367738,4,13,13,0,10,0
288263,3,10,28,-18,9,0
10691,4,17,17,0,5,0
405418,2,14,10,4,10,1
169968,2,14,10,4,8,1
20515,3,3,0,3,10,0
216495,2,20,8,12,12,1
392185,3,3,13,-10,4,1
249365,2,10,12,-2,9,1
71029,2,17,0,17,16,1
175816,2,14,3,11,11,1
253473,4,17,38,-21,11,0
59631,3,14,3,11,11,1
392693,4,16,0,16,4,1
357417,3,24,17,7,5,0
133632,3,10,14,-4,9,0
321916,3,14,21,-7,7,1
112998,2,7,3,4,17,0
31508,4,3,17,-14,15,1
238049,4,13,13,0,4,0
240988,4,21,22,-1,5,1
254824,4,20,13,7,11,1
257883,4,16,12,4,13,0
332107,1,0,0,0,12,1
208093,4,21,19,2,8,0
380156,1,0,0,0,16,1
254733,2,3,3,0,11,1
240946,3,14,9,5,5,1
44405,2,3,0,3,3,0
278159,2,17,14,3,4,0
201606,1,7,7,0,5,0
318217,1,0,0,0,5,1
15148,1,0,0,0,8,0
190331,1,0,0,0,17,1
177772,4,13,17,-4,12,0
187795,1,7,0,7,16,1
392306,2,0,7,-7,4,0
354500,3,27,28,-1,4,0
229947,1,0,0,0,17,0
17155,1,0,0,0,9,0
380287,4,29,23,6,16,0
47347,3,3,10,-7,5,1
112746,3,10,7,3,17,1
299535,2,0,3,-3,14,0
417594,1,13,0,13,16,1
177446,3,17,10,7,11,1
394906,3,0,17,-17,5,1
252959,3,9,7,2,11,0
250988,3,3,6,-3,10,1
163141,3,16,22,-6,5,0
356323,2,17,0,17,5,0
49596,1,0,0,0,6,0
351777,2,10,14,-4,3,0
205663,2,14,12,2,7,1
193610,4,0,17,-17,1,1
219355,3,16,13,3,13,1
229915,4,27,14,13,17,1
415350,4,14,21,-7,15,0
181392,2,17,14,3,13,1
332232,4,10,16,-6,12,1
32018,1,7,0,7,15,0
387200,1,0,0,0,2,0
228151,1,7,10,-3,17,1
172833,2,7,0,7,9,1
271150,2,7,10,-3,1,0
96612,3,3,3,0,10,1
363056,1,0,0,0,8,0
88422,1,0,0,0,6,1
60535,3,30,14,16,11,0
252569,1,0,0,0,10,1
415560,2,6,7,-1,15,1
260419,4,20,7,13,14,0
252033,3,14,20,-6,10,1
265986,4,0,33,-33,16,0
33930,2,0,24,-24,16,0
295611,4,31,32,-1,12,1
2433,3,21,13,8,2,1
67475,3,36,7,29,14,0
219827,3,38,0,38,13,1
54384,3,23,19,4,8,1
64093,4,34,24,10,13,0
249126,4,28,28,0,9,1
247656,1,6,0,6,8,1
361238,3,14,20,-6,7,0
209305,1,0,0,0,8,0
20599,1,0,0,0,10,0
165609,1,0,0,0,6,0
399131,4,25,36,-11,7,0
380665,3,7,7,0,16,0
127958,3,23,13,10,6,0
9192,3,3,16,-13,5,0
273595,2,3,3,0,2,1
277634,4,27,28,-1,4,1
311457,2,3,3,0,2,0
113736,2,3,10,-7,17,0
121417,4,7,12,-5,3,1
208099,1,0,0,0,8,1
166656,4,29,20,9,6,1
238436,4,23,36,-13,4,0
208737,2,0,6,-6,8,1
103999,4,13,13,0,13,1
270100,2,17,10,7,1,0
139464,4,27,10,17,12,0
152585,1,0,0,0,17,0
340175,2,20,14,6,15,1
361204,2,7,10,-3,7,0
321157,3,3,16,-13,6,0
104955,4,10,9,1,14,0
106472,3,16,9,7,14,1
363681,2,0,10,-10,8,1
54204,2,0,3,-3,8,1
243882,2,16,3,13,6,0
53709,3,7,0,7,8,0
290174,1,3,0,3,10,0
346342,2,3,6,-3,1,0
227918,3,27,19,8,16,0
331585,2,17,23,-6,11,1
304298,1,0,0,0,16,1
224163,3,0,20,-20,15,1
329778,2,17,13,4,11,1
229657,1,7,7,0,17,0
274980,1,13,3,10,3,1
104578,1,7,3,4,14,1
221585,3,20,18,2,14,1
84580,2,10,7,3,4,1
241034,5,30,33,-3,5,0
337040,3,16,0,16,14,1
19293,2,14,14,0,10,0
348956,1,14,0,14,2,0
161333,4,20,19,1,4,1
264784,3,17,23,-6,16,0
199401,3,16,10,6,4,1
178492,2,16,3,13,12,0
334494,1,7,14,-7,13,0
234423,1,7,3,4,2,1
341672,2,17,13,4,16,0
400320,1,3,0,3,8,0
310217,4,24,10,14,2,0
114719,4,15,10,5,1,1
111709,4,31,16,15,16,1
198737,1,3,0,3,3,0
416060,3,21,3,18,15,0
392388,4,20,38,-18,4,1
336117,2,10,0,10,13,0
417622,2,14,3,11,16,0
205784,2,7,0,7,7,0
48291,3,13,13,0,5,0
138915,1,0,3,-3,12,1
240965,3,21,9,12,5,0
6945,2,0,0,0,3,1
329692,4,30,17,13,11,1
337144,1,3,0,3,14,0
171590,1,3,3,0,9,0
7197,1,0,0,0,4,1
400626,1,0,0,0,8,1
34336,4,23,9,14,16,1
347745,2,0,0,0,1,1
128523,3,21,28,-7,7,0
237094,3,0,26,-26,3,1
350341,3,24,3,21,2,1
311087,3,10,3,7,2,0
123045,3,7,13,-6,4,1
158199,2,10,0,10,3,1
245686,2,3,3,0,7,0
387146,3,10,34,-24,2,0
405413,2,14,10,4,10,1
259319,3,13,13,0,13,0
249528,2,14,3,11,9,0
385197,4,21,20,1,1,1
23916,2,13,0,13,12,0
204318,4,0,10,-10,6,0
25912,4,38,17,21,12,1
320997,2,7,6,1,6,0
388645,3,17,0,17,3,0
376870,4,28,14,14,15,0
374718,3,0,33,-33,14,0
72873,1,0,0,0,16,1
5548,3,16,10,6,3,1
259280,2,13,7,6,13,1
298343,1,0,7,-7,14,1
10260,4,13,10,3,5,0
357571,3,13,13,0,5,0
236462,2,7,0,7,3,0
26517,5,30,29,1,13,0
182061,4,17,21,-4,13,0
217244,1,0,0,0,12,0
101196,1,0,7,-7,12,1
261398,3,10,17,-7,14,1
205852,3,20,0,20,7,0
238119,1,0,0,0,4,1
263341,3,24,7,17,15,0
323372,3,17,0,17,7,0
107160,2,0,14,-14,15,1
71038,3,20,0,20,16,1
361509,2,7,7,0,7,1
238158,2,3,9,-6,4,1
207035,3,35,3,32,7,0
419313,3,0,17,-17,16,0
249262,3,26,14,12,9,0
266346,2,10,0,10,16,0
41128,1,0,0,0,2,1
407284,3,17,16,1,11,1
227208,4,16,17,-1,16,0
317845,3,9,10,-1,5,1
355056,1,0,6,-6,4,0
165584,4,3,35,-32,6,1
262589,2,20,3,17,15,1
374687,2,0,9,-9,14,1
412913,2,0,3,-3,14,1
150548,1,3,3,0,17,0
280777,4,14,14,0,5,0
326962,2,2,7,-5,9,0
306895,2,6,13,-7,17,0
325256,1,3,3,0,8,1
345706,2,7,0,7,17,0
415174,3,3,24,-21,15,1
340061,4,17,12,5,15,0
363533,2,3,5,-2,8,0
378631,4,23,23,0,15,1
275643,3,27,3,24,3,0
311891,2,7,7,0,2,1
268145,2,6,14,-8,17,1
7007,4,13,7,6,3,0
395451,1,0,0,0,6,0
225021,1,0,0,0,15,0
90421,2,0,13,-13,7,1
49094,4,13,20,-7,6,1
130451,1,3,0,3,8,0
26230,1,0,7,-7,13,0
109386,2,3,10,-7,16,0
8402,4,37,10,27,4,0
256633,4,28,7,21,12,0
87465,4,20,17,3,6,0
66053,3,7,0,7,13,0
230416,2,14,0,14,1,0
157126,3,13,20,-7,2,1
321724,2,6,6,0,7,1
98629,4,14,7,7,11,0
47881,4,21,13,8,5,1
195548,3,6,7,-1,2,1
383038,1,3,6,-3,17,0
338845,3,13,7,6,15,1
285220,1,0,0,0,7,0
398760,2,14,17,-3,7,1
137765,4,10,37,-27,11,1
370999,2,7,7,0,12,0
54721,1,0,0,0,8,0
17044,1,13,0,13,9,0
399957,3,12,13,-1,8,0
89295,4,15,7,8,7,0
90010,3,5,21,-16,7,1
282902,1,0,0,0,6,1
49188,2,10,0,10,6,1
91521,4,19,9,10,8,0
11987,3,23,14,9,6,1
101785,5,13,13,0,12,0
392318,2,0,21,-21,4,1
179316,4,36,11,25,12,1
156891,1,0,3,-3,2,1
199210,2,10,7,3,4,0
213873,4,54,7,47,10,0
376873,4,28,14,14,15,0
221108,2,0,6,-6,14,1
65448,2,0,14,-14,13,1
2215,2,7,0,7,1,1
421807,2,0,10,-10,17,1
300393,1,0,0,0,14,1
174568,4,10,14,-4,10,1
110742,2,3,3,0,16,0
412599,1,3,0,3,14,0
314920,3,0,3,-3,4,0
180028,3,14,20,-6,13,0
48932,4,15,13,2,5,1
55270,3,13,10,3,9,0
63740,2,7,12,-5,12,0
319225,4,17,17,0,5,0
310032,4,9,10,-1,2,1
21735,3,24,14,10,11,0
338542,3,20,24,-4,14,0
290675,3,35,16,19,10,0
49661,2,7,7,0,6,0
181622,4,23,6,17,13,0
401399,2,17,7,10,8,1
396773,4,7,20,-13,6,0
7239,2,0,13,-13,4,1
191898,4,29,16,13,1,1
218575,2,7,17,-10,13,0
39499,4,13,19,-6,1,0
238818,2,27,0,27,4,0
274503,1,14,3,11,3,0
329151,1,3,0,3,10,0
107933,3,6,3,3,15,0
257576,4,19,13,6,13,1
24652,2,14,0,14,12,1
114861,4,16,30,-14,1,0
317030,2,0,10,-10,4,0
108343,1,0,7,-7,15,0
179562,2,0,23,-23,12,1
250781,2,3,0,3,10,0
353331,1,0,0,0,4,0
98282,3,14,27,-13,11,0
344757,1,0,0,0,17,1
37864,1,0,0,0,1,0
139963,2,25,3,22,12,0
314395,4,10,17,-7,3,0
136831,5,20,21,-1,11,0
127894,1,10,0,10,6,1
155267,4,28,21,7,1,1
24778,1,6,0,6,12,0
272898,3,20,17,3,2,1
410691,2,7,3,4,13,1
161097,2,3,9,-6,4,0
405023,4,9,26,-17,10,1
419697,1,0,3,-3,17,1
285949,3,26,7,19,8,1
307189,3,0,10,-10,17,0
184338,1,0,6,-6,14,1
88743,2,3,3,0,6,1
179286,3,33,3,30,12,1
390514,2,10,7,3,3,1
110563,1,10,6,4,16,0
212688,4,17,31,-14,10,0
174739,4,9,10,-1,10,0
411505,4,13,24,-11,13,1
77879,4,17,31,-14,1,1
296945,3,26,0,26,13,1
250526,3,16,7,9,9,0
217339,3,7,10,-3,12,0
342349,1,0,0,0,16,1
348610,4,31,23,8,2,1
229509,1,10,0,10,17,0
197014,4,20,20,0,3,1
67213,3,0,3,-3,14,1
47816,2,7,6,1,5,0
65279,2,3,14,-11,13,0
287925,2,14,10,4,9,0
376608,4,15,6,9,14,0
421907,4,21,26,-5,17,1
164736,2,13,14,-1,6,1
291830,1,0,7,-7,11,1
270419,3,10,7,3,1,0
221760,3,10,14,-4,14,0
27042,3,10,3,7,13,1
313281,2,6,7,-1,3,0
769,2,0,0,0,1,0
174566,4,10,14,-4,10,1
137293,4,13,27,-14,11,1
112024,4,35,21,14,17,1
350037,3,13,10,3,2,1
52680,2,3,13,-10,7,0
41444,2,2,0,2,2,0
270658,1,3,0,3,1,0
358761,4,14,17,-3,6,0
21631,4,7,38,-31,11,1
204936,4,13,27,-14,6,1
388279,2,3,0,3,2,0
391518,1,7,14,-7,4,0
175305,4,21,19,2,10,1
187692,2,13,6,7,16,0
289755,2,0,10,-10,10,0
406167,1,7,0,7,11,1
212975,4,21,7,14,10,0
206059,1,7,3,4,7,1
359714,1,10,6,4,6,1
210635,3,13,17,-4,9,0
2991,3,13,24,-11,2,1
397482,3,13,19,-6,6,0
324260,2,15,0,15,8,0
268634,3,14,13,1,17,0
135698,3,17,10,7,10,0
388858,1,3,7,-4,3,1
268396,1,7,0,7,17,0
105045,2,0,14,-14,14,1
35813,4,3,10,-7,17,1
2709,3,9,7,2,2,0
304884,1,0,0,0,16,0
210766,3,21,10,11,9,1
418367,1,0,0,0,16,1
46312,2,3,14,-11,4,0
343848,4,24,3,21,17,1
61054,1,0,0,0,11,0
214105,2,3,3,0,11,0
173688,4,20,28,-8,10,1
287367,3,20,3,17,8,1
12769,1,0,0,0,6,1
22867,2,0,10,-10,11,0
6163,4,7,26,-19,3,0
180539,4,21,20,1,13,0
272885,3,20,17,3,2,1
400117,3,17,23,-6,8,1
105875,3,19,10,9,14,0
301082,4,30,13,17,15,1
25180,4,20,3,17,12,0
140355,4,17,26,-9,12,1
31024,2,9,6,3,15,1
227634,3,35,0,35,16,1
336401,2,3,3,0,14,0
138855,4,12,33,-21,12,0
166975,1,0,0,0,7,1
416220,4,10,25,-15,15,0
156912,1,7,10,-3,2,1
125997,1,0,0,0,6,1
58619,4,13,17,-4,10,0
267306,4,17,17,0,17,0
188369,2,0,0,0,16,1
99067,3,23,0,23,11,0
210416,2,9,0,9,9,0
249017,1,7,0,7,9,0
61934,1,0,0,0,12,1
72707,4,34,13,21,16,0
273917,2,7,3,4,2,0
278380,4,17,21,-4,4,0
407956,4,17,24,-7,11,1
192299,2,24,3,21,1,1
254082,1,0,0,0,11,0
20788,1,7,0,7,10,0
323586,1,0,0,0,8,0
116879,2,7,7,0,2,1
149378,2,6,6,0,16,0
330158,4,0,23,-23,11,1
76583,1,0,0,0,1,1
192158,3,0,13,-13,1,1
379234,4,19,16,3,16,0
96464,3,10,17,-7,10,0
358818,1,0,7,-7,6,1
87525,2,17,0,17,6,1
104705,1,0,0,0,14,1
240576,1,3,0,3,5,0
54033,2,3,0,3,8,1
104008,4,13,13,0,13,0
229760,4,20,17,3,17,1
174738,4,9,10,-1,10,0
313375,1,0,0,0,3,1
154959,4,29,24,5,1,1
219659,3,10,7,3,13,0
362734,4,6,20,-14,8,1
252079,1,0,0,0,10,0
209104,3,3,27,-24,8,1
129097,3,20,21,-1,7,0
385510,1,0,0,0,1,1
99010,1,6,0,6,11,0
249746,4,21,21,0,9,1
123521,3,10,3,7,4,0
270451,4,10,7,3,1,0
256178,4,27,22,5,12,1
17035,1,7,0,7,9,1
113287,2,13,21,-8,17,0
380943,3,9,7,2,16,1
9229,4,3,23,-20,5,0
59971,3,3,24,-21,11,1
325638,3,17,7,10,9,0
380617,1,7,0,7,16,0
45229,4,14,16,-2,4,0
276631,2,14,6,8,4,1
202791,4,19,17,2,5,1
111837,3,6,10,-4,17,1
6831,3,10,21,-11,3,0
336390,1,3,3,0,14,0
107834,4,13,30,-17,15,1
405494,4,24,16,8,10,0
266249,4,38,19,19,16,0
197955,1,0,3,-3,3,1
363617,1,0,0,0,8,0
288261,3,10,28,-18,9,0
272279,4,9,10,-1,2,1
273010,2,6,3,3,2,0
294087,3,7,24,-17,12,1
55294,4,13,10,3,9,1
53126,3,19,31,-12,7,0
219863,4,45,0,45,13,1
128783,2,10,10,0,7,0
231842,1,0,13,-13,1,1
409337,1,0,3,-3,12,1
208599,2,6,3,3,8,1
138334,3,27,0,27,11,0
172447,4,13,49,-36,9,0
173218,4,20,24,-4,9,1
89230,3,6,0,6,7,1
23811,3,17,7,10,12,1
182925,2,0,30,-30,14,1
257680,2,0,7,-7,13,0
387111,2,10,21,-11,2,0
296708,4,10,16,-6,13,0
304473,2,0,7,-7,16,1
246123,1,7,0,7,7,0
225198,2,3,7,-4,15,1
307061,3,24,0,24,17,1
50339,4,13,23,-10,6,1
308629,4,34,16,18,1,0
360415,2,0,0,0,7,1
128695,4,13,20,-7,7,0
165087,3,10,24,-14,6,0
61576,3,28,7,21,11,1
393119,3,24,3,21,4,1
287205,3,13,20,-7,8,0
202104,2,13,3,10,5,1
78537,2,3,7,-4,2,0
276276,1,0,0,0,3,1
37025,1,10,0,10,17,0
145659,4,34,7,27,14,1
172121,4,13,18,-5,9,1
40479,3,7,17,-10,2,0
259393,1,0,0,0,13,1
363810,2,13,10,3,8,1
212142,2,3,14,-11,10,0
373534,3,7,19,-12,13,1
391072,1,0,0,0,4,1
133107,1,0,0,0,9,0
219683,4,13,14,-1,13,0
307045,3,17,0,17,17,1
398924,3,10,10,0,7,1
68164,1,7,7,0,14,0
154509,4,21,17,4,1,0
334306,4,9,14,-5,13,1
405026,4,9,26,-17,10,1
87412,3,10,7,3,6,1
24264,4,13,17,-4,12,1
406610,1,0,0,0,11,1
64833,2,7,0,7,13,0
144944,4,20,7,13,14,0
255208,2,10,14,-4,12,1
242490,3,12,10,2,6,0
185899,3,16,16,0,15,0
272769,4,15,10,5,2,0
393507,1,7,6,1,5,1
338866,3,13,22,-9,15,1
195694,3,14,10,4,2,0
129563,3,6,17,-11,7,1
268674,4,27,20,7,17,0
97489,2,13,0,13,10,1
406429,4,31,7,24,11,1
387766,4,0,37,-37,2,0
414327,1,0,0,0,14,1
28354,2,3,0,3,14,0
376412,4,9,9,0,14,1
261229,2,21,0,21,14,1
75645,4,13,6,7,17,0
77984,2,3,13,-10,1,0
89898,4,30,20,10,7,0
9726,1,0,7,-7,5,1
128676,3,6,17,-11,7,1
68071,3,3,10,-7,14,0
138837,3,5,33,-28,12,1
97303,1,0,0,0,10,0
261559,3,12,7,5,14,0
198742,1,3,0,3,3,0
34179,4,10,10,0,16,1
265503,3,7,7,0,16,0
199084,2,7,21,-14,4,0
795,2,7,6,1,1,1
169708,4,20,17,3,8,1
386662,3,14,13,1,2,0
316389,2,13,0,13,4,0
210643,3,13,24,-11,9,0
181225,2,0,0,0,13,1
171803,3,23,14,9,9,0
333270,4,6,21,-15,12,1
291625,4,23,13,10,11,1
399033,2,10,12,-2,7,0
20412,4,10,16,-6,10,0
192694,4,19,7,12,1,0
25393,2,6,0,6,12,0
99180,2,10,3,7,11,0
120348,1,0,3,-3,3,1
237971,2,3,3,0,4,0
345629,4,24,26,-2,17,0
249309,1,3,0,3,9,0
120393,2,16,9,7,3,1
215334,2,14,10,4,11,0
40453,3,7,14,-7,2,1
130908,1,0,7,-7,8,0
380548,3,14,17,-3,16,0
77802,2,7,14,-7,1,1
139645,1,0,0,0,12,1
227221,4,16,17,-1,16,0
230898,3,21,10,11,1,0
327945,1,0,0,0,10,0
313632,4,25,30,-5,3,0
362822,3,7,21,-14,8,1
106587,2,31,0,31,14,0
41572,1,0,0,0,2,0
174957,2,6,14,-8,10,1
312887,4,14,14,0,3,1
195981,4,0,27,-27,2,1
314033,2,6,0,6,3,1
343600,1,15,7,8,17,0
6793,2,3,7,-4,3,1
185306,4,40,22,18,15,1
70548,1,0,7,-7,15,0
201248,1,0,0,0,5,1
36605,1,3,3,0,17,1
86692,2,10,7,3,5,1
307613,2,0,7,-7,17,1
279056,1,7,0,7,5,1
175912,4,23,27,-4,11,1
169228,3,17,6,11,7,0
166559,1,6,7,-1,6,1
291297,3,21,19,2,10,0
198632,3,3,14,-11,3,0
293879,1,0,7,-7,12,1
221966,4,22,25,-3,14,0
412786,2,14,17,-3,14,1
367140,2,29,16,13,10,0
224411,1,0,3,-3,15,1
306301,2,17,0,17,17,0
299021,4,16,18,-2,14,0
58320,4,27,13,14,10,0
413409,2,3,24,-21,14,0
52956,2,14,17,-3,7,0
412191,2,14,3,11,13,0
16616,2,7,27,-20,8,1
174389,3,17,3,14,10,1
11621,1,7,0,7,6,1
266045,2,10,3,7,16,1
317993,3,10,10,0,5,0
23592,1,7,0,7,12,1
93515,4,3,31,-28,9,0
114832,3,13,30,-17,1,0
27608,2,7,10,-3,13,1
136380,1,0,0,0,11,0
295440,4,10,13,-3,12,1
319633,2,16,3,13,6,1
111703,4,31,13,18,16,0
249781,4,35,28,7,9,0
213839,3,45,0,45,10,1
269420,4,21,17,4,1,0
276851,4,26,20,6,4,0
364714,3,6,3,3,9,1
683,3,0,17,-17,1,0
195530,2,6,0,6,2,0
217742,3,10,7,3,12,0
343793,2,14,3,11,17,0
391409,2,10,10,0,4,1
226569,2,3,3,0,16,0
167065,3,13,31,-18,7,1
354322,2,21,3,18,4,1
232399,4,20,22,-2,1,0
140099,2,0,0,0,12,1
222879,1,0,0,0,14,0
252264,1,0,10,-10,10,0
80278,1,0,0,0,2,0
382817,2,21,0,21,17,0
158457,1,0,7,-7,3,1
212223,4,3,24,-21,10,1
269511,2,13,10,3,1,0
223693,3,20,13,7,15,0
389774,2,10,6,4,3,1
418048,4,28,35,-7,16,1
34710,2,3,3,0,16,1
150839,1,0,0,0,17,0
121397,4,7,6,1,3,0
281885,4,16,17,-1,6,1
81832,1,0,21,-21,3,0
23899,2,3,0,3,12,1
119886,1,0,7,-7,3,1
155003,1,6,9,-3,1,0
4463,1,7,9,-2,2,0
79118,1,0,0,0,2,1
370665,4,21,14,7,12,1
190634,2,14,7,7,17,1
373922,4,43,16,27,13,1
27528,4,23,12,11,13,1
58190,1,0,0,0,10,1
3063,4,22,47,-25,2,1
18056,4,36,28,8,9,0
18002,3,16,21,-5,9,1
401815,2,7,7,0,9,0
99641,3,23,3,20,11,0
126514,2,7,6,1,6,0
99288,2,10,0,10,11,0
294165,1,0,7,-7,12,0
330733,4,6,6,0,11,1
287613,2,3,3,0,9,1
75478,4,31,7,24,17,1
565,4,14,27,-13,1,1
279993,2,3,13,-10,5,1
199308,1,0,0,0,4,1
86484,4,30,24,6,5,0
177846,2,14,16,-2,12,0
347682,4,20,24,-4,1,1
404197,3,9,9,0,10,1
192256,2,10,3,7,1,0
44831,1,0,7,-7,4,1
7829,1,0,0,0,4,0
215738,2,16,3,13,11,1
366523,2,10,7,3,10,1
113038,3,13,16,-3,17,1
406112,3,0,26,-26,11,0
150518,4,41,12,29,16,0
96365,4,9,30,-21,10,0
329862,4,24,26,-2,11,0
281311,2,14,6,8,6,0
329001,4,33,7,26,10,1
324643,4,19,15,4,8,0
277978,1,0,7,-7,4,1
243183,5,23,22,1,6,1
55814,2,0,7,-7,9,0
275457,2,20,10,10,3,0
149504,1,14,6,8,16,0
356570,4,9,6,3,5,0
35092,4,15,27,-12,16,1
251545,3,16,13,3,10,1
197309,3,17,0,17,3,1
210284,2,6,7,-1,9,1
169127,4,39,33,6,7,0
404462,2,14,13,1,10,1
41514,3,15,7,8,2,1
150663,4,17,22,-5,17,1
374690,2,0,15,-15,14,0
390870,3,9,28,-19,3,1
228222,3,10,27,-17,17,1
155284,4,28,27,1,1,0
308272,3,10,16,-6,1,1
172876,3,24,16,8,9,0
291483,4,21,20,1,10,1
293583,4,27,20,7,11,0
10702,4,17,17,0,5,1
25509,1,0,0,0,12,1
316595,3,6,6,0,4,0
161404,2,7,0,7,4,0
68747,1,0,0,0,15,1
165776,1,0,0,0,6,1
358380,2,9,10,-1,6,1
218952,4,48,27,21,13,1
103041,2,7,0,7,13,0
211190,3,7,10,-3,9,0
353973,5,34,31,3,4,0
132653,1,0,3,-3,9,1
105468,1,6,0,6,14,0
255891,1,0,0,0,12,1
401824,2,7,14,-7,9,1
315158,2,7,7,0,4,1
195034,2,7,10,-3,2,0
304781,2,0,0,0,16,1
381644,2,10,0,10,17,0
362598,1,0,0,0,8,0
141728,4,30,21,9,13,1
234319,2,10,0,10,2,1
280202,4,28,14,14,5,1
327085,1,7,0,7,9,0
10803,3,21,0,21,5,1
260607,1,0,7,-7,14,0
399009,1,7,9,-2,7,1
293452,1,0,0,0,11,0
39505,4,13,19,-6,1,1
93110,1,0,0,0,9,0
197082,1,7,14,-7,3,1
354548,4,36,31,5,4,0
404453,2,14,7,7,10,1
193299,4,10,23,-13,1,0
38083,3,3,6,-3,1,1
372201,4,9,16,-7,13,0
26094,1,0,10,-10,13,0
361063,3,16,9,7,7,1
289725,2,0,7,-7,10,0
55644,1,10,7,3,9,0
65777,4,27,25,2,13,0
256761,3,3,13,-10,12,1
107544,4,3,23,-20,15,1
275048,3,34,17,17,3,0
370727,2,9,7,2,12,1
148813,3,13,16,-3,16,0
155207,2,14,7,7,1,0
380684,3,7,7,0,16,1
316235,2,0,10,-10,4,1
237986,2,3,10,-7,4,1
19563,2,7,14,-7,10,1
51046,3,0,20,-20,6,1
180095,1,0,0,0,13,0
257312,1,3,0,3,13,1
421418,3,24,20,4,17,0
70025,3,24,10,14,15,0
373060,2,0,7,-7,13,1
123087,4,20,21,-1,4,1
20835,3,14,6,8,10,0
21546,2,7,7,0,11,1
99305,2,13,0,13,11,0
176007,2,17,0,17,11,0
371200,3,11,19,-8,12,1
396796,1,0,0,0,6,0
295115,3,7,14,-7,12,1
395980,3,24,17,7,6,1
109024,4,16,34,-18,15,1
200519,4,26,18,8,4,0
51503,4,34,24,10,7,1
104252,2,3,0,3,13,1
113123,2,21,0,21,17,1
288284,4,10,35,-25,9,1
176863,4,17,16,1,11,0
128799,3,13,13,0,7,0
275682,4,37,10,27,3,0
103693,3,3,10,-7,13,0
221401,2,3,17,-14,14,1
324547,2,10,9,1,8,0
142740,2,9,10,-1,13,1
389725,1,3,0,3,3,0
300345,3,3,7,-4,14,1
169336,2,3,14,-11,8,0
21783,4,31,24,7,11,0
325324,3,12,10,2,8,0
270961,1,0,7,-7,1,1
17047,1,13,0,13,9,0
111956,2,14,21,-7,17,1
94969,3,6,9,-3,9,1
320741,3,14,23,-9,6,1
6726,4,3,23,-20,3,0
405415,2,14,10,4,10,1
384251,1,6,0,6,1,0
207861,2,7,0,7,8,0
141977,2,10,14,-4,13,1
418181,3,24,6,18,16,0
411259,1,0,0,0,13,0
296351,4,13,19,-6,13,0
268349,4,20,6,14,17,1
260464,1,7,0,7,14,1
372645,3,14,9,5,13,0
164293,1,6,0,6,5,1
383249,2,28,10,18,17,1
25106,2,3,0,3,12,1
260213,2,10,3,7,14,1
21740,3,24,14,10,11,0
248189,3,9,10,-1,8,1
81748,4,31,17,14,3,0
211551,4,42,21,21,9,0
32236,3,21,14,7,15,1
416236,4,10,39,-29,15,0
245310,3,16,10,6,7,1
117667,3,20,13,7,2,1
203069,3,33,17,16,5,1
293187,2,6,7,-1,11,1
245971,1,0,0,0,7,1
170950,4,38,20,18,8,0
86687,2,10,0,10,5,0
271086,1,0,0,0,1,0
49016,2,10,7,3,6,1
154411,1,7,0,7,1,0
122211,1,3,7,-4,4,0
173606,2,0,13,-13,10,1
364958,1,7,0,7,9,0
55265,3,13,10,3,9,1
25788,5,20,17,3,12,1
329493,2,10,7,3,10,1
331582,2,17,23,-6,11,0
203718,4,22,37,-15,6,0
170260,2,0,9,-9,8,0
33128,3,10,28,-18,16,0
282434,4,10,26,-16,6,1
402226,1,0,3,-3,9,1
10734,1,7,0,7,5,0
36293,1,7,0,7,17,0
229049,1,0,0,0,17,1
125404,1,7,0,7,5,0
41796,3,10,14,-4,2,1
295790,5,24,24,0,12,1
357960,2,14,6,8,6,1
162837,3,3,3,0,5,1
392632,2,7,0,7,4,1
415451,3,15,3,12,15,1
215917,2,3,14,-11,11,0
413682,2,7,13,-6,14,1
386072,3,14,3,11,1,1
31088,4,13,16,-3,15,1
273773,2,7,7,0,2,0
26633,4,17,13,4,13,0
119427,2,7,14,-7,3,0
358452,3,32,20,12,6,0
51474,3,27,24,3,7,0
58759,3,10,23,-13,10,1
62359,1,0,0,0,12,0
420335,3,17,3,14,17,0
9502,3,13,10,3,5,1
104256,2,10,0,10,13,0
397513,4,20,22,-2,6,1
205284,1,3,0,3,6,1
48725,3,10,19,-9,5,1
302587,1,0,0,0,15,0
27402,4,24,10,14,13,1
289696,1,0,0,0,10,1
179230,2,17,3,14,12,1
417778,1,0,0,0,16,1
126591,4,16,13,3,6,1
73254,4,7,16,-9,16,1
343086,4,12,13,-1,16,0
300724,2,7,0,7,15,0
202456,3,6,10,-4,5,0
274592,4,24,26,-2,3,0
123198,3,6,21,-15,4,1
338812,2,10,0,10,15,0
130294,1,0,0,0,8,1
353241,2,14,17,-3,4,0
318124,2,9,7,2,5,0
7295,4,17,13,4,4,0
115460,4,39,14,25,1,0
181859,2,21,14,7,13,0
227557,1,14,0,14,16,0
339516,1,0,0,0,15,1
417162,1,0,10,-10,16,1
321092,1,0,3,-3,6,1
405918,2,14,0,14,11,0
146685,3,7,29,-22,15,0
90812,4,34,7,27,7,0
59671,4,21,6,15,11,1
344973,3,10,14,-4,17,0
245799,4,30,23,7,7,0
346743,4,27,13,14,1,0
335708,2,10,7,3,13,0
412066,3,21,0,21,13,1
71364,4,10,20,-10,16,0
235790,1,0,0,0,3,1
213661,2,7,14,-7,10,1
13150,2,13,16,-3,6,0
144884,3,14,7,7,14,1
96317,2,0,16,-16,10,0
242286,2,7,7,0,6,1
412001,1,0,0,0,13,1
196932,1,6,0,6,3,1
374723,3,0,33,-33,14,1
53952,4,20,25,-5,8,1
210788,4,24,10,14,9,1
52073,3,13,10,3,7,0
157336,1,0,0,0,2,0
117546,4,17,20,-3,2,1
50136,3,0,17,-17,6,1
138385,1,0,0,0,12,1
390323,1,0,7,-7,3,1
89437,4,17,20,-3,7,0
130828,3,13,12,1,8,1
123864,4,17,3,14,5,1
124718,2,3,3,0,5,1
112224,1,14,7,7,17,0
372233,1,0,0,0,13,1
126226,3,21,6,15,6,1
318338,4,9,22,-13,5,1
229466,4,13,9,4,17,1
15363,3,10,6,4,8,0
122734,3,7,17,-10,4,1
171481,2,14,10,4,9,1
122351,4,13,19,-6,4,1
392365,3,20,28,-8,4,0
11749,4,33,31,2,6,0
277251,3,0,13,-13,4,1
36907,1,0,14,-14,17,1
341123,4,14,24,-10,15,1
23124,1,0,0,0,11,1
209439,4,17,17,0,8,1
2146,4,13,16,-3,1,0
418358,4,15,31,-16,16,0
143695,4,19,10,9,14,1
296780,2,7,0,7,13,0
92110,2,3,16,-13,8,0
198022,3,0,30,-30,3,1
240816,4,26,10,16,5,0
71014,2,10,0,10,16,1
33997,4,10,27,-17,16,0
327958,1,0,0,0,10,1
283498,4,23,21,2,7,1
309513,1,3,0,3,1,1
142057,4,23,14,9,13,0
362496,2,7,6,1,8,1
274387,2,3,10,-7,3,0
93517,4,3,31,-28,9,0
250594,1,0,0,0,10,1
342024,4,20,3,17,16,0
63262,1,0,0,0,12,0
385229,1,0,3,-3,1,1
401446,4,24,10,14,8,0
168280,2,10,7,3,7,1
365599,3,35,17,18,9,0
229083,2,10,7,3,17,1
180106,1,7,0,7,13,0
17290,4,21,41,-20,9,1
338320,1,3,0,3,14,0
302023,1,7,3,4,15,0
187508,2,3,10,-7,16,1
350612,3,10,0,10,2,1
385702,1,0,0,0,1,1
8561,1,0,0,0,4,1
208571,1,0,0,0,8,1
66449,1,0,7,-7,14,0
284979,4,16,26,-10,7,0
86496,1,0,0,0,5,0
291047,4,20,20,0,10,1
251513,2,16,13,3,10,0
55872,4,19,14,5,9,0
306931,3,6,30,-24,17,0
388480,3,3,16,-13,2,1
68711,4,30,0,30,15,1
22719,2,3,13,-10,11,0
347303,3,7,14,-7,1,1
157519,1,0,0,0,2,1
17660,2,7,3,4,9,1
145081,4,26,13,13,14,1
189414,1,7,0,7,17,0
221188,4,0,23,-23,14,1
376331,2,3,0,3,14,1
186534,4,24,33,-9,15,0
105578,4,32,21,11,14,1
312995,2,9,0,9,3,1
403656,4,30,20,10,9,1
283197,4,26,9,17,7,1
210358,4,22,17,5,9,0
102079,4,35,17,18,12,1
344593,4,0,6,-6,17,0
332833,1,0,0,0,12,0
146715,3,7,32,-25,15,1
323587,1,0,0,0,8,0
251685,2,6,3,3,10,1
340740,1,7,7,0,15,0
254537,1,0,0,0,11,0
52231,3,7,16,-9,7,0
256686,1,0,0,0,12,0
334879,3,24,10,14,13,1
383410,3,10,9,1,17,0
21949,1,7,0,7,11,0
266691,4,39,10,29,16,0
259819,4,23,20,3,14,0
291432,3,14,17,-3,10,0
384827,2,6,10,-4,1,1
107706,1,0,0,0,15,1
130177,2,0,19,-19,8,1
248980,4,27,3,24,9,1
89881,4,30,13,17,7,0
49228,3,17,9,8,6,0
368306,4,9,12,-3,11,1
278763,2,0,0,0,5,0
326553,4,51,22,29,9,0
45389,4,20,26,-6,4,1
217757,3,10,7,3,12,1
143236,3,10,13,-3,13,0
100211,3,17,0,17,12,0
364147,3,31,3,28,9,0
367845,2,13,10,3,10,1
263934,2,23,0,23,15,0
241170,4,20,10,10,5,0
383477,1,0,3,-3,17,1
69245,1,6,0,6,15,1
130184,2,0,19,-19,8,1
382776,1,14,0,14,17,0
270450,4,10,7,3,1,0
17766,1,0,0,0,9,0
27652,3,7,27,-20,13,1
210803,4,24,10,14,9,1
27477,2,17,0,17,13,0
315919,1,0,0,0,4,1
250772,2,3,0,3,10,0
112694,2,3,0,3,17,1
208669,4,6,6,0,8,1
19793,4,12,15,-3,10,0
256578,2,7,0,7,12,1
4613,2,10,10,0,2,0
396716,3,7,14,-7,6,1
279954,1,0,10,-10,5,1
333562,4,16,10,6,12,1
250686,4,10,22,-12,10,0
284121,1,0,3,-3,7,0
275055,4,34,20,14,3,0
78985,2,0,7,-7,2,1
60361,2,10,7,3,11,0
156328,2,24,0,24,2,0
214297,3,14,10,4,11,0
163374,1,0,3,-3,5,0
246323,2,7,9,-2,7,0
143829,4,12,7,5,14,1
317646,2,6,6,0,5,1
310408,1,7,0,7,2,1
11099,3,10,13,-3,5,0
410031,4,6,45,-39,12,1
306797,4,19,33,-14,17,0
72634,2,13,0,13,16,0
24971,2,10,14,-4,12,1
173063,4,24,12,12,9,1
398265,4,42,24,18,7,1
363093,2,7,3,4,8,1
328247,5,17,17,0,10,1
168797,1,0,0,0,7,1
255800,2,17,0,17,12,0
403193,3,17,14,3,9,0
389747,1,10,0,10,3,0
342223,1,3,0,3,16,1
316397,2,13,0,13,4,0
150590,2,3,13,-10,17,1
72939,3,17,7,10,16,1
87786,1,0,0,0,6,1
419184,3,10,6,4,16,0
163062,1,0,3,-3,5,1
198948,3,13,23,-10,3,1
304509,3,10,14,-4,16,0
319621,2,16,3,13,6,1
343901,1,7,0,7,17,0
214346,1,0,0,0,11,1
16608,2,7,14,-7,8,1
86069,1,14,0,14,5,1
236493,2,7,9,-2,3,1
261337,2,0,7,-7,14,0
414771,4,10,17,-7,14,1
231694,4,31,19,12,1,0
361447,1,0,0,0,7,1
213599,4,29,14,15,10,0
270322,4,20,27,-7,1,0
43755,1,14,0,14,3,0
371022,2,7,10,-3,12,1
402573,2,10,7,3,9,0
128293,1,0,0,0,7,1
418661,4,28,38,-10,16,1
102905,2,6,14,-8,13,0
379131,1,6,3,3,16,0
416173,2,10,12,-2,15,1
86109,2,28,3,25,5,0
58891,2,6,18,-12,10,0
64702,2,14,0,14,13,0
309928,1,0,0,0,2,0
298400,3,7,14,-7,14,0
73543,4,3,38,-35,17,0
177933,1,0,0,0,12,1
12884,3,13,13,0,6,1
93387,1,3,0,3,9,1
130102,4,17,36,-19,8,0
23559,4,17,20,-3,11,1
75835,1,7,0,7,1,1
299439,3,0,20,-20,14,1
293048,2,10,13,-3,11,0
127427,1,0,0,0,6,1
254044,3,14,13,1,11,0
249217,2,12,7,5,9,1
118593,4,31,10,21,2,0
211062,3,27,0,27,9,1
109970,1,10,0,10,16,0
32185,1,14,7,7,15,0
83849,2,20,3,17,4,0
284392,4,28,17,11,7,0
151825,4,28,16,12,17,1
2533,2,10,0,10,2,0
96754,3,0,10,-10,10,1
302301,1,7,0,7,15,0
333431,4,23,13,10,12,1
19759,3,9,12,-3,10,0
86472,4,30,24,6,5,1
319070,4,20,38,-18,5,0
15302,1,0,0,0,8,0
161070,1,3,0,3,4,1
264068,2,7,20,-13,15,1
227146,2,7,7,0,16,1
335312,3,3,16,-13,13,1
340426,4,31,19,12,15,0
153913,4,7,12,-5,1,0
318998,2,0,16,-16,5,1
304269,4,33,22,11,16,0
107497,3,3,20,-17,15,0
47040,3,17,7,10,5,0
126053,2,7,3,4,6,0
55355,1,7,0,7,9,0
275680,4,37,10,27,3,1
89921,1,0,0,0,7,1
383711,3,16,24,-8,17,0
317931,2,7,3,4,5,1
164494,3,17,0,17,5,0
162670,3,16,17,-1,5,0
27467,2,10,0,10,13,1
177151,4,40,13,27,11,1
163871,1,6,7,-1,5,0
70647,4,17,20,-3,15,0
255379,3,21,6,15,12,0
178111,5,26,26,0,12,1
178716,4,3,26,-23,12,1
373545,3,10,19,-9,13,0
159982,1,0,10,-10,3,0
143726,1,0,0,0,14,1
331394,1,3,7,-4,11,1
251337,2,14,7,7,10,1
40633,3,34,7,27,2,0
390695,3,6,3,3,3,0
108834,3,7,10,-3,15,1
406193,1,7,3,4,11,0
135260,3,16,10,6,10,1
32292,4,30,28,2,15,0
419707,2,0,3,-3,17,0
235767,4,19,27,-8,3,1
359854,2,17,14,3,6,1
114449,1,0,7,-7,1,1
315786,2,0,3,-3,4,0
184123,3,16,14,2,14,1
112993,2,7,3,4,17,1
169935,2,7,0,7,8,0
390702,3,6,10,-4,3,1
159148,4,31,7,24,3,0
308309,4,16,23,-7,1,0
254147,2,3,12,-9,11,1
209594,4,41,34,7,8,0
235136,3,0,10,-10,2,0
10250,4,13,10,3,5,1
298081,2,3,17,-14,13,1
407409,2,13,7,6,11,1
114091,3,21,7,14,17,1
304115,4,16,30,-14,16,0
349693,2,14,7,7,2,1
249492,1,7,3,4,9,1
40425,2,0,7,-7,2,1
80893,1,3,0,3,3,1
280463,4,34,24,10,5,0
229751,4,20,17,3,17,0
363175,4,24,10,14,8,1
53609,4,14,22,-8,8,0
29949,1,0,0,0,14,0
415670,1,0,0,0,15,1
386191,2,6,3,3,2,1
339243,2,14,0,14,15,1
184611,1,7,3,4,15,1
115557,2,10,3,7,1,0
184083,2,6,7,-1,14,1
127341,3,10,20,-10,6,0
70362,4,18,33,-15,15,0
113862,2,7,0,7,17,0
221535,1,13,12,1,14,1
236393,4,14,23,-9,3,0
419236,4,17,9,8,16,0
323678,3,20,0,20,8,1
190026,1,7,0,7,17,1
220525,2,0,17,-17,13,1
345945,4,27,23,4,17,1
216232,4,17,16,1,12,0
138903,1,0,3,-3,12,0
417679,3,28,6,22,16,0
147832,2,3,7,-4,15,0
287773,2,21,10,11,9,0
48982,1,3,7,-4,6,1
162808,2,3,0,3,5,0
93094,5,20,20,0,8,1
212397,4,13,17,-4,10,1
39514,1,0,0,0,1,0
286414,2,14,0,14,8,0
314269,5,24,23,1,3,1
254426,2,20,0,20,11,0
225089,3,13,14,-1,15,0
306840,1,0,3,-3,17,1
404171,2,9,7,2,10,0
135262,4,16,10,6,10,1
262667,4,29,16,13,15,0
170120,2,7,10,-3,8,1
178700,4,3,20,-17,12,0
35964,4,3,7,-4,17,1
185132,4,0,16,-16,15,1
305232,2,14,14,0,16,0
40954,4,16,20,-4,2,0
169589,1,0,0,0,8,1
394043,3,9,13,-4,5,1
162747,1,0,0,0,5,0
48382,2,3,17,-14,5,1
273222,4,40,7,33,2,1
16035,1,13,0,13,8,0
121552,3,16,10,6,4,1
163453,3,10,23,-13,5,0
67708,2,7,0,7,14,0
95957,1,0,0,0,10,0
4773,2,19,0,19,3,1
397188,3,6,0,6,6,1
322326,2,14,7,7,7,1
255571,4,30,7,23,12,0
31337,3,7,3,4,15,1
21329,4,6,17,-11,11,1
341854,3,13,15,-2,16,1
406047,2,0,10,-10,11,1
351513,2,0,27,-27,3,0
89412,3,10,20,-10,7,0
306382,1,0,0,0,17,0
209860,2,13,13,0,8,0
397669,4,6,30,-24,7,1
9258,1,0,0,0,5,1
338937,1,3,0,3,15,1
139867,4,20,17,3,12,0
417045,2,16,0,16,15,1
188342,1,0,0,0,16,1
344808,2,14,10,4,17,0
232274,1,0,0,0,1,1
387910,4,10,28,-18,2,1
316688,5,12,15,-3,4,0
127077,4,31,29,2,6,1
56899,3,27,7,20,9,1
227920,3,27,20,7,16,1
363864,4,13,26,-13,8,0
295205,1,7,0,7,12,1
174814,2,13,17,-4,10,0
181983,2,7,0,7,13,1
45170,3,7,10,-3,4,0
411679,4,37,28,9,13,0
290797,2,10,0,10,10,0
179623,4,31,23,8,12,0
117291,1,0,0,0,2,1
378600,3,17,13,4,15,1
223769,1,0,0,0,15,0
172825,2,7,0,7,9,0
290252,3,17,3,14,10,1
6697,3,3,20,-17,3,0
140741,2,15,14,1,12,0
151696,4,37,44,-7,17,0
94239,4,24,30,-6,9,1
311108,4,13,3,10,2,0
4076,3,16,21,-5,2,0
100024,1,3,3,0,12,1
392608,2,7,0,7,4,1
179362,1,0,6,-6,12,1
283009,3,21,3,18,6,0
8686,4,10,10,0,4,0
313878,2,21,19,2,3,0
103786,2,3,0,3,13,0
46141,1,7,7,0,4,0
221417,2,3,24,-21,14,1
412212,3,14,3,11,13,1
381338,1,6,0,6,16,1
327206,1,0,0,0,9,0
66749,2,7,3,4,14,0
262650,4,26,10,16,15,1
275806,4,16,3,13,3,0
171320,2,7,3,4,9,1
313872,2,20,19,1,3,1
307657,3,14,17,-3,17,0
232622,2,0,0,0,1,0
169372,3,6,14,-8,8,0
194614,3,21,7,14,2,0
311605,2,6,0,6,2,1
348302,1,0,0,0,1,1
283927,4,31,17,14,7,1
167678,2,10,20,-10,7,0
162660,2,16,10,6,5,0
11018,1,0,0,0,5,1
89390,2,10,20,-10,7,1
172720,3,14,10,4,9,0
218403,1,3,14,-11,13,1
231520,4,23,29,-6,1,1
376745,4,20,0,20,14,0
369532,2,3,0,3,11,1
289121,1,6,0,6,9,1
335811,1,7,0,7,13,0
151270,1,0,0,0,17,1
137491,1,7,0,7,11,0
83732,4,22,23,-1,4,0
390950,2,10,0,10,4,0
21544,2,7,7,0,11,1
25755,4,17,17,0,12,1
156915,2,7,10,-3,2,0
292534,4,17,19,-2,11,0
352105,2,3,20,-17,3,1
332612,3,20,6,14,12,1
129328,1,7,7,0,7,0
104734,1,10,13,-3,14,0
9504,3,13,10,3,5,1
72968,4,31,15,16,16,1
334338,1,0,3,-3,13,1
57259,1,0,0,0,10,0
129893,3,13,0,13,7,1
167613,1,7,0,7,7,0
412310,2,7,7,0,13,0
407541,2,10,0,10,11,0
369401,2,17,0,17,11,0
34078,2,0,0,0,16,1
259654,4,9,6,3,13,0
397315,3,0,24,-24,6,1
64165,2,28,6,22,13,0
123764,2,10,3,7,5,0
362371,3,23,14,9,8,1
296600,2,3,0,3,13,0
383721,4,16,24,-8,17,1
147078,2,7,17,-10,15,0
52840,3,14,37,-23,7,0
304926,2,7,3,4,16,0
388187,4,3,13,-10,2,1
155395,3,13,3,10,2,0
382607,1,0,0,0,17,1
272757,4,15,10,5,2,0
415870,2,7,20,-13,15,0
168610,3,17,16,1,7,1
416708,1,0,0,0,15,1
390261,3,10,6,4,3,1
6791,2,3,7,-4,3,1
244169,1,7,7,0,6,0
181300,4,3,20,-17,13,0
180655,3,24,6,18,13,1
131258,3,14,17,-3,8,1
283658,4,23,33,-10,7,1
332484,3,23,9,14,12,1
59238,3,21,58,-37,10,0
384469,3,28,0,28,1,0
67336,3,20,6,14,14,1
48373,1,3,10,-7,5,1
325621,2,10,7,3,9,1
286039,1,3,0,3,8,0
240111,1,6,0,6,5,0
86743,3,24,14,10,5,0
158424,4,19,27,-8,3,0
262146,3,21,6,15,15,0
377700,3,25,7,18,15,0
154498,4,14,17,-3,1,1
333059,3,10,12,-2,12,0
101730,3,13,7,6,12,0
236292,2,0,3,-3,3,1
52745,4,20,23,-3,7,1
206325,4,24,6,18,7,0
103281,4,3,10,-7,13,0
374151,3,23,7,16,13,1
79792,4,20,14,6,2,0
355518,1,7,0,7,5,1
175996,2,14,0,14,11,1
381734,4,32,31,1,17,0
232790,2,13,14,-1,2,1
159196,1,7,7,0,3,0
306929,3,6,30,-24,17,0
342374,1,0,3,-3,16,1
333603,4,24,23,1,12,1
303875,1,0,13,-13,16,0
223433,4,20,26,-6,15,0
88376,4,24,10,14,6,1
387754,4,0,37,-37,2,1
81825,1,0,20,-20,3,0
246675,4,31,3,28,8,0
191635,1,0,0,0,17,0
78179,3,27,3,24,2,1
357263,3,3,16,-13,5,1
186099,1,0,0,0,15,1
385521,1,0,0,0,1,1
143556,4,20,28,-8,14,1
103000,4,19,38,-19,13,0
58315,4,27,13,14,10,1
237219,2,3,0,3,3,1
9299,2,7,0,7,5,0
281600,1,14,0,14,6,0
406709,4,27,0,27,11,0
237969,2,3,3,0,4,1
249497,1,7,3,4,9,1
199970,2,17,10,7,4,0
122031,4,19,13,6,4,1
220595,4,16,26,-10,13,0
277579,3,6,14,-8,4,1
404964,3,6,13,-7,10,1
302187,2,21,0,21,15,0
320114,2,17,0,17,6,1
239691,2,7,10,-3,4,0
142529,4,30,13,17,13,0
421283,4,16,10,6,17,1
234522,4,20,20,0,2,1
351284,4,31,17,14,3,0
355283,3,14,14,0,4,1
30249,1,3,0,3,14,0
236116,1,0,3,-3,3,1
385079,1,0,0,0,1,0
61384,2,10,3,7,11,0
88306,2,14,7,7,6,1
374596,4,20,13,7,14,0
5334,2,7,0,7,3,1
360457,3,10,0,10,7,1
108298,4,19,7,12,15,0
178631,2,3,3,0,12,0
216838,2,7,7,0,12,1
150150,2,3,13,-10,16,1
87902,3,13,15,-2,6,1
420593,1,0,10,-10,17,0
217861,2,10,20,-10,12,0
355418,2,10,10,0,4,1
312445,4,39,41,-2,3,1
304971,3,10,14,-4,16,0
90346,4,14,29,-15,7,0
332473,3,23,6,17,12,0
41806,3,13,14,-1,2,1
50002,3,28,10,18,6,1
314614,2,7,0,7,3,1
375337,2,7,17,-10,14,0
4210,2,10,6,4,2,1
375818,3,20,7,13,14,1
393479,4,34,27,7,5,0
240984,4,21,22,-1,5,0
329771,2,17,6,11,11,0
248680,4,31,10,21,9,0
91974,3,13,23,-10,8,0
193056,1,0,0,0,1,1
346132,1,0,0,0,1,1
104346,3,45,31,14,13,0
347718,1,0,0,0,1,1
359868,2,17,14,3,6,1
302823,3,9,20,-11,15,0
31433,2,3,0,3,15,0
370438,2,10,6,4,12,0
359831,1,6,7,-1,6,1
99660,4,26,3,23,11,0
279517,2,10,6,4,5,0
140174,4,10,3,7,12,1
83965,2,7,0,7,4,1
2225,2,7,7,0,1,1
55877,4,19,14,5,9,0
153050,1,0,7,-7,1,1
345624,4,24,23,1,17,0
181806,1,0,0,0,13,0
108970,2,16,17,-1,15,1
277698,2,7,0,7,4,0
241549,2,3,10,-7,5,1
309815,2,7,7,0,1,1
99203,3,17,17,0,11,1
182530,4,35,20,15,14,0
320561,2,24,0,24,6,0
268711,1,0,0,0,17,0
67151,2,0,0,0,14,0
199659,2,7,0,7,4,0
36468,2,3,6,-3,17,1
280252,2,3,13,-10,5,1
218850,2,7,3,4,13,0
166912,3,13,6,7,6,0
87082,1,0,0,0,5,0
180093,4,31,23,8,13,1
332220,4,10,16,-6,12,0
341260,4,16,13,3,16,1
247971,1,0,3,-3,8,1
250869,4,10,12,-2,10,0
36828,3,17,26,-9,17,0
16970,4,27,20,7,8,0
174131,1,0,0,0,10,1
168822,1,14,0,14,7,0
88957,3,33,10,23,6,1
72114,4,17,17,0,16,0
338115,4,6,7,-1,14,1
48316,4,22,13,9,5,1
310541,1,0,0,0,2,0
329723,4,40,17,23,11,0
41875,1,7,3,4,2,1
149412,3,13,27,-14,16,1
267091,2,3,3,0,17,0
392543,4,3,20,-17,4,1
29804,1,3,0,3,14,0
105851,3,16,10,6,14,1
91218,4,13,17,-4,8,0
328335,3,3,24,-21,10,1
112355,1,3,0,3,17,1
11638,2,14,0,14,6,1
173519,4,13,27,-14,10,1
128873,1,0,0,0,7,0
414031,4,10,45,-35,14,1
112400,2,10,13,-3,17,1
115782,4,20,16,4,1,0
205327,2,20,0,20,6,1
99548,4,10,17,-7,11,0
353793,1,0,0,0,4,1
19880,3,13,21,-8,10,0
238298,1,0,9,-9,4,1
97744,4,16,13,3,11,0
39894,3,6,7,-1,1,0
1691,3,14,0,14,1,1
391122,2,7,17,-10,4,1
407271,2,10,16,-6,11,1
74961,2,17,10,7,17,0
153794,4,2,27,-25,1,1
67493,3,36,7,29,14,1
321518,4,24,30,-6,7,1
22842,1,0,0,0,11,0
413284,3,17,0,17,14,0
54318,1,7,2,5,8,0
294904,1,0,7,-7,12,1
403833,1,0,0,0,10,0
355569,2,14,3,11,5,1
173552,1,0,7,-7,10,0
23366,3,12,17,-5,11,1
399539,4,0,33,-33,7,1
260993,4,10,3,7,14,1
369775,4,45,43,2,11,0
88079,4,24,3,21,6,1
126196,2,14,6,8,6,1
263484,3,13,16,-3,15,1
295731,3,10,15,-5,12,0
24662,2,17,0,17,12,0
317653,3,6,6,0,5,1
392598,1,7,0,7,4,0
271183,4,14,17,-3,1,0
393223,2,14,6,8,5,1
282606,1,0,7,-7,6,1
96343,3,3,23,-20,10,0
339669,1,6,0,6,15,1
369779,4,45,43,2,11,0
311554,4,17,19,-2,2,1
52572,4,19,10,9,7,1
245670,1,3,3,0,7,1
249790,4,35,35,0,9,1
143561,4,20,28,-8,14,1
129408,3,16,13,3,7,1
98855,2,7,0,7,11,0
17749,4,24,13,11,9,0
385753,2,10,0,10,1,1
403236,4,24,24,0,9,1
414312,4,21,42,-21,14,1
313761,3,28,10,18,3,1
157306,4,19,3,16,2,0
413328,4,20,0,20,14,0
394956,4,10,17,-7,5,1
154508,4,21,17,4,1,0
229436,3,10,6,4,17,1
154043,4,17,21,-4,1,0
191849,3,17,10,7,1,1
323627,2,10,0,10,8,1
204125,2,3,10,-7,6,1
212834,4,24,24,0,10,1
217839,2,3,13,-10,12,0
152818,4,21,10,11,17,0
105565,3,29,21,8,14,1
326694,4,16,13,3,9,1
163692,1,0,6,-6,5,0
146716,4,7,32,-25,15,1
312219,2,7,14,-7,2,0
251710,3,21,3,18,10,0
334101,2,10,0,10,13,1
211851,3,22,10,12,9,0
234396,4,24,10,14,2,0
374257,2,7,9,-2,13,0
97778,1,7,3,4,11,0
26437,3,17,16,1,13,1
371627,3,17,17,0,12,0
150123,2,3,6,-3,16,0
22658,4,30,17,13,11,1
105760,4,37,10,27,14,1
376011,1,0,0,0,14,0
200651,4,33,28,5,4,1
251335,2,14,7,7,10,0
406065,2,0,13,-13,11,1
127682,4,30,26,4,6,1
218862,2,14,3,11,13,1
167559,4,3,10,-7,7,0
316479,4,16,17,-1,4,0
71510,4,33,14,19,16,0
51637,3,27,20,7,7,0
197509,4,20,9,11,3,1
24764,4,27,34,-7,12,0
284217,4,9,26,-17,7,1
385061,1,0,0,0,1,0
241650,1,0,0,0,5,1
359873,2,20,21,-1,6,1
120070,1,3,0,3,3,1
87111,2,7,3,4,5,0
263062,3,10,6,4,15,1
119130,3,10,7,3,3,0
329870,1,0,0,0,11,0
146535,2,14,10,4,15,0
269443,1,0,0,0,1,1
7575,2,14,0,14,4,0
275386,1,0,0,0,3,0
320632,4,38,18,20,6,0
277074,2,3,7,-4,4,0
150533,1,0,0,0,17,0
147122,3,17,37,-20,15,1
194063,4,27,13,14,1,0
227268,2,3,13,-10,16,0
163716,1,0,6,-6,5,0
257604,5,19,23,-4,13,1
89756,4,16,23,-7,7,1
399530,3,0,26,-26,7,0
198438,2,3,3,0,3,1
118953,2,0,17,-17,3,1
345990,1,0,0,0,1,0
280614,4,20,9,11,5,1
116646,4,23,10,13,2,1
220988,3,14,10,4,14,1
40442,2,7,14,-7,2,1
273634,3,13,6,7,2,0
338869,3,13,22,-9,15,1
279373,2,6,7,-1,5,0
321623,3,17,13,4,7,1
395695,4,18,34,-16,6,1
162140,1,0,0,0,4,1
415513,1,0,0,0,15,0
360276,2,0,6,-6,7,0
263730,1,0,0,0,15,1
291622,4,23,13,10,11,0
302185,2,21,0,21,15,0
15348,2,7,6,1,8,1
334066,1,0,0,0,13,1
240298,2,7,7,0,5,0
134361,3,23,21,2,10,0
2838,3,24,24,0,2,0
311573,1,3,0,3,2,1
359678,1,0,0,0,6,1
233155,3,29,3,26,2,0
70355,4,10,33,-23,15,1
396337,1,7,0,7,6,0
336305,3,17,10,7,13,1
48944,4,22,20,2,5,1
285640,4,27,24,3,8,1
179347,1,0,0,0,12,0
82536,4,17,27,-10,3,1
396237,2,0,3,-3,6,0
119552,1,7,0,7,3,0
173338,3,21,27,-6,10,0
223339,1,0,3,-3,15,1
317938,2,10,3,7,5,1
299757,4,17,6,11,14,0
194480,3,16,9,7,2,0
197258,2,0,0,0,3,1
390395,3,7,27,-20,3,1
320006,4,43,24,19,6,0
158676,3,14,7,7,3,1
280356,1,0,0,0,5,1
91803,3,17,0,17,8,0
284300,2,3,10,-7,7,1
418949,1,0,0,0,16,1
403722,2,9,3,6,9,0
67157,2,0,0,0,14,1
202271,2,3,0,3,5,1
390621,1,0,0,0,3,0
177455,4,24,10,14,11,0
294550,4,24,13,11,12,0
186300,2,19,3,16,15,0
234932,1,10,3,7,2,0
311192,2,3,0,3,2,1
84683,1,3,0,3,4,0
4339,2,0,7,-7,2,0
118588,4,24,10,14,2,1
101920,4,6,13,-7,12,0
7303,4,20,13,7,4,0
61455,4,16,17,-1,11,1
103135,4,34,7,27,13,1
168306,3,10,21,-11,7,1
102500,3,31,3,28,13,0
195496,2,0,0,0,2,1
277608,4,12,21,-9,4,1
44098,2,0,13,-13,3,1
415046,4,10,27,-17,15,1
414820,1,13,0,13,15,0
335667,1,7,0,7,13,1
140378,4,17,29,-12,12,1
82433,1,0,7,-7,3,0
277798,1,0,7,-7,4,1
22513,4,31,37,-6,11,1
30582,2,10,0,10,14,1
229849,2,13,0,13,17,0
45338,3,20,16,4,4,0
204178,4,24,17,7,6,0
83927,1,0,0,0,4,0
334750,4,25,9,16,13,0
331055,4,51,17,34,11,1
250739,1,3,0,3,10,1
16549,4,30,13,17,8,1
399393,4,30,10,20,7,0
268820,4,38,10,28,17,0
203910,1,0,7,-7,6,1
374272,2,7,10,-3,13,0
228680,3,16,23,-7,17,1
352205,1,0,3,-3,3,1
243755,3,17,16,1,6,0
159371,2,7,10,-3,3,0
232943,2,7,3,4,2,1
188907,3,10,10,0,16,1
317428,1,0,0,0,5,1
80530,3,5,10,-5,3,1
127623,3,17,9,8,6,1
285406,2,24,0,24,8,0
394941,4,7,17,-10,5,0
359208,4,21,21,0,6,0
166763,3,20,9,11,6,0
411644,3,26,28,-2,13,0
214170,4,18,9,9,11,1
223170,1,0,0,0,15,1
162317,2,3,0,3,4,0
220409,3,23,14,9,13,0
50456,3,10,10,0,6,0
270768,4,6,10,-4,1,1
325418,1,13,0,13,8,1
77495,2,0,7,-7,1,1
29452,3,7,14,-7,14,1
57424,1,0,0,0,10,0
390223,2,0,6,-6,3,1
385133,2,14,16,-2,1,0
410660,1,0,0,0,13,0
161129,3,3,19,-16,4,0
352850,3,14,10,4,3,1
33274,3,23,0,23,16,0
311298,1,0,0,0,2,1
374226,1,0,0,0,13,1
328063,4,17,17,0,10,0
53477,1,0,0,0,8,1
371199,3,11,19,-8,12,1
34059,1,0,0,0,16,0
78004,3,9,16,-7,1,0
162222,3,20,20,0,4,0
43256,4,24,10,14,3,1
110481,3,17,0,17,16,1
48790,4,24,28,-4,5,1
148132,1,0,7,-7,16,1
418822,1,0,3,-3,16,1
324007,4,17,22,-5,8,1
219995,4,16,28,-12,13,0
393080,2,7,3,4,4,1
177251,3,14,10,4,11,1
276588,1,7,0,7,4,0
239950,1,0,3,-3,5,1
43915,1,0,7,-7,3,0
209876,3,16,16,0,8,1
410140,3,17,10,7,13,0
7185,1,0,0,0,4,0
269268,4,10,19,-9,17,0
75992,1,7,13,-6,1,1
229202,1,0,0,0,17,1
117066,3,7,17,-10,2,0
139856,3,13,17,-4,12,1
290792,2,3,0,3,10,1
175662,2,9,3,6,11,1
186306,2,19,3,16,15,1
394003,2,6,10,-4,5,0
400764,1,7,0,7,8,0
71639,3,3,31,-28,16,0
183637,2,0,8,-8,14,1
49817,3,14,10,4,6,0
274275,4,29,13,16,3,0
313001,2,10,0,10,3,0
302742,1,0,3,-3,15,0
153816,1,0,0,0,1,1
170098,2,7,0,7,8,0
407720,2,3,0,3,11,1
379673,1,0,0,0,16,0
5778,2,21,7,14,3,0
37663,3,30,0,30,17,1
69106,2,7,7,0,15,1
376676,2,3,0,3,14,1
54137,1,0,0,0,8,0
330504,2,7,7,0,11,1
257688,3,0,10,-10,13,1
72868,1,0,0,0,16,0
43784,2,14,10,4,3,0
337751,2,13,0,13,14,0
204892,3,3,13,-10,6,1
248087,4,34,20,14,8,1
32431,4,31,6,25,15,1
174440,5,17,17,0,10,0
384475,4,28,0,28,1,0
126151,1,0,3,-3,6,1
207832,1,0,0,0,8,1
159449,4,20,23,-3,3,0
405119,3,0,10,-10,10,1
241410,3,7,28,-21,5,1
194664,4,34,7,27,2,0
11139,4,24,20,4,5,0
334945,1,0,7,-7,13,1
4779,3,20,0,20,3,1
380401,3,10,17,-7,16,0
174084,3,0,36,-36,10,1
301640,3,10,6,4,15,1
337794,3,23,6,17,14,0
13231,4,22,33,-11,6,1
222729,1,0,0,0,14,1
47132,1,3,0,3,5,0
174189,2,3,16,-13,10,1
279777,1,0,0,0,5,0
183137,4,7,12,-5,14,1
266937,2,13,7,6,17,1
117982,3,17,6,11,2,1
114328,2,13,6,7,1,1
348648,1,3,3,0,2,0
417383,3,13,17,-4,16,0
138799,2,0,32,-32,12,0
407902,3,9,17,-8,11,0
147900,4,17,31,-14,15,0
266665,3,19,3,16,16,1
291808,1,0,0,0,11,1
321057,4,16,14,2,6,1
181887,3,21,28,-7,13,1
114615,2,3,3,0,1,1
185158,4,0,23,-23,15,1
275916,3,13,12,1,3,0
257206,2,10,16,-6,12,1
118406,3,13,10,3,2,0
104616,2,7,3,4,14,0
375101,1,0,0,0,14,1
138357,4,27,7,20,11,1
411564,1,0,10,-10,13,1
316738,2,10,0,10,4,1
117467,2,7,14,-7,2,1
114203,2,3,0,3,1,0
219808,3,38,0,38,13,1
237261,4,23,0,23,3,0
231769,3,10,20,-10,1,1
337453,1,7,6,1,14,0
372189,3,9,13,-4,13,0
17324,1,7,0,7,9,1
158754,2,0,3,-3,3,0
59762,2,9,10,-1,11,0
392413,4,40,45,-5,4,0
119696,5,20,19,1,3,1
32989,3,6,24,-18,15,0
29956,1,7,0,7,14,0
51896,2,6,10,-4,7,1
42416,4,14,19,-5,2,0
395076,3,3,24,-21,5,0
399628,2,6,6,0,8,1
351228,3,28,10,18,3,0
253600,4,9,10,-1,11,0
230214,1,0,0,0,17,1
206692,2,0,7,-7,7,0
9511,4,13,10,3,5,0
410408,2,6,10,-4,13,1
300426,1,2,0,2,14,1
134203,2,0,17,-17,10,1
128526,3,21,28,-7,7,0
322112,4,26,0,26,7,1
11000,4,9,31,-22,5,1
83336,1,0,7,-7,4,0
90121,2,0,0,0,7,1
94,3,7,7,0,1,1
121846,3,0,10,-10,4,0
108492,2,7,7,0,15,0
89091,3,13,6,7,6,1
146178,1,0,3,-3,15,0
275900,2,13,6,7,3,1
251075,2,10,14,-4,10,1
14919,3,14,17,-3,7,0
41751,2,0,7,-7,2,1
367389,2,10,14,-4,10,1
283894,3,28,17,11,7,0
26732,2,3,14,-11,13,1
394471,3,7,18,-11,5,1
3957,4,22,14,8,2,0
34951,4,27,27,0,16,0
285727,1,0,3,-3,8,0
144645,4,26,22,4,14,1
180634,2,16,6,10,13,1
54650,3,14,22,-8,8,0
51586,2,7,3,4,7,0
415948,4,17,30,-13,15,1
203906,1,0,0,0,6,0
167591,4,3,17,-14,7,1
283852,2,7,3,4,7,1
226624,3,10,6,4,16,0
20198,3,17,10,7,10,0
107267,1,0,0,0,15,1
250603,1,3,0,3,10,0
18273,2,7,17,-10,9,1
32344,2,14,0,14,15,0
241371,2,7,13,-6,5,0
56972,1,0,7,-7,9,1
339023,4,20,3,17,15,0
68085,3,3,10,-7,14,0
407440,3,14,10,4,11,1
183913,1,7,3,4,14,1
45759,3,10,7,3,4,0
12974,1,0,0,0,6,1
134429,1,0,7,-7,10,0
85942,2,7,14,-7,5,0
48612,4,21,27,-6,5,1
24165,1,0,0,0,12,0
216856,3,10,14,-4,12,1
104629,3,7,3,4,14,1
13136,2,10,7,3,6,0
191777,1,0,0,0,1,0
392123,1,0,13,-13,4,1
366844,2,3,3,0,10,0
360881,2,6,0,6,7,0
237815,2,0,13,-13,4,1
23750,1,3,0,3,12,0
151238,4,17,23,-6,17,0
154505,4,20,17,3,1,1
418015,3,21,35,-14,16,1
64546,1,7,0,7,13,0
101408,3,15,7,8,12,0
354990,3,7,18,-11,4,0
99993,4,17,19,-2,12,1
333471,1,3,0,3,12,1
53166,4,19,38,-19,7,1
29879,3,15,23,-8,14,1
62049,4,24,10,14,12,0
312694,3,28,14,14,3,0
306250,1,7,0,7,17,0
355435,3,13,13,0,4,0
369231,1,7,7,0,11,1
349072,1,7,0,7,2,0
128305,1,0,0,0,7,0
186757,2,20,0,20,15,1
346993,3,7,3,4,1,1
331352,4,8,30,-22,11,0
55546,2,17,7,10,9,0
289055,4,32,21,11,9,0
246540,4,29,7,22,8,0
122934,4,37,6,31,4,0
113073,4,16,22,-6,17,0
170404,2,14,3,11,8,0
264902,2,17,14,3,16,0
408028,2,3,7,-4,12,1
178557,4,16,13,3,12,1
74294,4,10,30,-20,17,1
68414,4,3,21,-18,14,1
253487,4,17,44,-27,11,0
420840,4,17,20,-3,17,0
304802,2,0,0,0,16,0
10418,4,10,45,-35,5,0
234196,3,13,10,3,2,1
206408,2,10,0,10,7,0
63920,3,6,21,-15,12,0
191737,3,16,17,-1,17,0
348895,4,9,20,-11,2,0
149271,3,13,20,-7,16,1
4989,4,24,17,7,3,1
149788,1,3,7,-4,16,1
19341,4,14,17,-3,10,1
367645,1,0,0,0,10,0
393586,3,7,19,-12,5,0
171036,2,10,23,-13,8,1
69734,3,13,7,6,15,1
269058,3,10,16,-6,17,1
187802,2,7,0,7,16,0
278653,3,17,3,14,4,0
410940,4,14,22,-8,13,0
265462,2,7,7,0,16,0
322143,1,0,7,-7,7,0
45814,4,16,14,2,4,0
162817,2,3,0,3,5,0
89503,1,0,3,-3,7,0
248109,1,0,0,0,8,0
55428,3,20,10,10,9,0
269121,4,16,16,0,17,1
189809,3,17,15,2,17,0
20193,3,17,10,7,10,1
68310,1,3,0,3,14,1
266119,4,17,13,4,16,0
163105,2,13,12,1,5,0
365338,4,17,19,-2,9,1
188740,3,0,17,-17,16,0
67331,2,20,6,14,14,1
107581,1,6,7,-1,15,0
403538,1,0,0,0,9,1
420761,2,0,3,-3,17,0
266732,1,0,0,0,16,0
267934,1,0,0,0,17,0
108996,3,16,27,-11,15,0
275832,4,22,3,19,3,1
323355,2,10,0,10,7,0
29684,1,0,0,0,14,1
267603,4,30,34,-4,17,0
409707,3,10,6,4,12,0
268960,4,6,36,-30,17,1
233506,4,26,10,16,2,0
221221,1,0,10,-10,14,0
134753,2,17,3,14,10,0
88170,2,14,10,4,6,0
159166,1,0,0,0,3,1
231591,2,14,3,11,1,0
251508,2,16,13,3,10,1
117262,4,33,24,9,2,0
364770,4,12,6,6,9,0
182366,4,24,17,7,14,0
372396,1,6,0,6,13,1
228244,4,10,27,-17,17,1
250747,1,3,0,3,10,0
390832,2,0,21,-21,3,0
61552,3,21,7,14,11,1
297190,2,0,0,0,13,0
365768,3,17,17,0,9,1
39245,2,3,3,0,1,0
185137,4,0,16,-16,15,0
224980,4,10,19,-9,15,0
403422,1,7,0,7,9,1
229270,3,24,14,10,17,0
40463,3,7,14,-7,2,0
84568,2,7,7,0,4,1
368699,2,7,16,-9,11,1
80576,4,16,10,6,3,0
197193,4,27,27,0,3,1
243278,2,7,10,-3,6,0
260488,2,13,0,13,14,0
310504,4,20,9,11,2,0
217770,4,10,10,0,12,0
43521,2,7,3,4,3,1
350038,3,13,10,3,2,1
194192,3,6,17,-11,1,1
363839,3,13,17,-4,8,0
9394,1,0,0,0,5,0
164813,4,26,21,5,6,0
416059,3,21,3,18,15,0
330296,4,31,21,10,11,0
238250,4,3,16,-13,4,1
52325,1,3,0,3,7,0
138502,4,31,30,1,12,0
17494,2,10,0,10,9,1
84250,2,0,7,-7,4,0
109302,3,13,3,10,15,0
190958,2,9,0,9,17,1
55214,2,7,0,7,9,1
160794,2,17,7,10,4,0
312934,1,0,0,0,3,0
359139,2,7,0,7,6,0
261200,2,21,0,21,14,0
389569,1,0,0,0,3,1
288530,2,10,28,-18,9,1
283422,2,20,7,13,7,1
173992,1,0,6,-6,10,1
246088,4,19,13,6,7,0
172062,2,7,3,4,9,1
178116,5,26,26,0,12,1
31631,3,24,6,18,15,0
231989,1,0,7,-7,1,1
95016,4,13,16,-3,9,1
310460,3,14,3,11,2,1
297307,1,0,0,0,13,0
342833,1,10,0,10,16,0
13310,3,7,20,-13,7,0
313616,3,22,23,-1,3,0
68634,1,7,0,7,15,1
268319,3,20,3,17,17,1
261450,4,17,24,-7,14,0
157167,4,19,20,-1,2,1
271534,1,0,0,0,2,0
236341,3,7,23,-16,3,1
204960,4,13,27,-14,6,1
344585,4,0,6,-6,17,1
360658,4,17,27,-10,7,0
405861,1,7,0,7,11,0
421852,3,0,13,-13,17,1
335852,2,21,7,14,13,0
392880,4,24,23,1,4,0
171273,1,0,0,0,9,0
191147,4,28,27,1,17,0
399051,2,10,12,-2,7,1
83311,1,0,0,0,4,1
373021,1,0,0,0,13,1
232341,3,6,12,-6,1,0
58330,4,27,13,14,10,1
2198,1,6,0,6,1,1
348806,2,0,7,-7,2,1
32687,3,7,3,4,15,0
96852,1,10,0,10,10,1
15364,3,10,6,4,8,0
304803,2,0,0,0,16,0
99739,2,0,0,0,12,1
226460,3,7,10,-3,16,0
95518,2,3,7,-4,10,0
202219,1,0,0,0,5,1
339304,3,38,7,31,15,0
369504,1,3,0,3,11,1
278529,4,36,7,29,4,1
370966,1,0,0,0,12,0
338611,1,0,0,0,14,1
307837,3,27,21,6,1,0
251626,1,0,0,0,10,1
213811,2,35,0,35,10,0
214171,4,19,9,10,11,0
89546,3,0,20,-20,7,1
243906,3,16,6,10,6,0
221696,2,10,0,10,14,1
252037,4,14,20,-6,10,0
406503,2,0,16,-16,11,0
11216,2,7,14,-7,6,1
322368,3,14,13,1,7,0
108294,4,19,7,12,15,0
399419,1,0,0,0,7,0
29891,3,16,23,-7,14,1
155337,1,10,3,7,2,1
131819,2,7,7,0,8,0
207674,1,0,0,0,7,0
114725,4,15,10,5,1,0
121513,2,9,7,2,4,1
262641,4,26,10,16,15,1
159382,2,7,10,-3,3,0
231777,3,13,20,-7,1,1
164536,4,23,17,6,5,1
378458,3,17,0,17,15,1
153911,4,7,6,1,1,0
364511,1,0,7,-7,9,1
174878,4,26,17,9,10,0
174397,4,17,3,14,10,1
20209,3,17,10,7,10,0
363456,4,28,42,-14,8,1
175721,3,30,6,24,11,0
285180,5,6,6,0,7,0
384300,3,6,0,6,1,1
392755,1,7,3,4,4,0
215053,3,13,7,6,11,1
229428,3,10,6,4,17,0
39780,4,9,7,2,1,1
280116,2,14,0,14,5,1
24275,4,13,17,-4,12,1
367695,2,3,6,-3,10,1
256157,3,24,22,2,12,1
219852,4,44,0,44,13,1
254906,2,17,7,10,12,1
403241,4,30,24,6,9,1
258981,2,0,16,-16,13,1
182624,2,0,6,-6,14,1
326982,3,2,7,-5,9,0
219145,1,0,3,-3,13,1
400515,2,7,3,4,8,0
6250,3,13,7,6,3,0
280953,1,0,0,0,6,1
388871,1,10,7,3,3,0
83387,3,10,14,-4,4,0
251863,3,14,13,1,10,1
132552,2,2,29,-27,9,0
7724,2,17,3,14,4,1
357690,2,20,6,14,5,0
216781,1,0,0,0,12,0
304090,3,6,23,-17,16,1
392002,2,0,7,-7,4,0
168808,1,7,0,7,7,0
44247,2,17,13,4,3,0
218380,1,0,0,0,13,0
415084,1,0,0,0,15,0
391258,2,14,0,14,4,0
253368,2,7,14,-7,11,0
172300,4,24,23,1,9,0
28873,4,23,7,16,14,0
101135,4,13,24,-11,12,1
159570,3,17,6,11,3,1
314547,4,27,10,17,3,0
89190,2,0,0,0,7,1
252722,1,0,0,0,11,0
290366,2,13,3,10,10,1
82360,3,13,10,3,3,1
9714,1,0,7,-7,5,1
8176,2,0,7,-7,4,1
89491,1,0,0,0,7,0
213570,4,10,14,-4,10,1
98802,4,34,8,26,11,1
300965,4,24,27,-3,15,1
299400,2,0,13,-13,14,0
326886,4,10,20,-10,9,0
44817,1,0,7,-7,4,1
407587,3,10,17,-7,11,0
130264,4,9,29,-20,8,1
93583,2,6,3,3,9,0
378006,2,0,7,-7,15,1
277501,1,0,0,0,4,1
370369,4,20,35,-15,12,1
76285,1,0,0,0,1,1
52127,4,23,19,4,7,0
290467,1,7,0,7,10,0
28258,3,17,7,10,13,0
146943,1,7,0,7,15,1
319372,4,23,28,-5,6,0
202844,1,7,0,7,5,1
221033,4,21,35,-14,14,1
258820,2,7,7,0,13,0
33276,3,23,0,23,16,0
404199,3,9,9,0,10,1
115109,2,3,19,-16,1,0
132712,3,3,17,-14,9,1
46724,2,7,0,7,4,0
162676,3,16,17,-1,5,0
265143,4,20,17,3,16,0
32986,3,6,24,-18,15,0
108423,4,13,21,-8,15,0
412481,2,10,7,3,14,1
170930,4,28,20,8,8,1
378187,3,24,16,8,15,1
243019,1,0,0,0,6,1
76485,2,0,14,-14,1,0
213807,2,35,0,35,10,0
332047,3,10,3,7,12,1
281709,4,31,30,1,6,0
356027,3,21,10,11,5,0
292438,2,3,3,0,11,1
12037,4,27,14,13,6,1
368361,1,7,0,7,11,0
187590,4,13,23,-10,16,1
181005,4,31,34,-3,13,1
158835,4,20,3,17,3,0
333852,4,21,21,0,12,0
244519,2,25,13,12,7,1
179238,2,23,3,20,12,1
172017,1,0,0,0,9,0
169718,4,20,17,3,8,0
174674,3,9,7,2,10,0
248193,3,9,10,-1,8,0
12482,1,0,0,0,6,0
74831,3,13,13,0,17,1
125623,3,14,24,-10,5,1
370963,1,0,0,0,12,1
124965,2,3,3,0,5,0
188332,4,23,13,10,16,0
219834,3,38,0,38,13,1
243427,2,3,17,-14,6,0
380841,4,9,24,-15,16,1
137952,4,30,22,8,11,1
396101,2,17,9,8,6,0
216362,3,14,13,1,12,0
132994,2,3,14,-11,9,1
312549,3,30,0,30,3,0
267694,3,14,24,-10,17,1
297210,2,0,3,-3,13,0
323049,2,14,14,0,7,1
250556,4,19,14,5,9,0
362748,1,0,0,0,8,0
168745,3,10,6,4,7,1
224934,3,3,9,-6,15,1
25931,1,3,0,3,13,0
26529,1,3,0,3,13,0
405217,1,0,7,-7,10,1
181678,1,0,0,0,13,0
101680,2,3,0,3,12,1
148426,2,7,0,7,16,0
252939,3,9,0,9,11,0
81910,3,7,30,-23,3,1
205566,4,14,24,-10,6,1
274402,3,3,17,-14,3,0
120623,4,3,20,-17,3,0
32044,2,7,10,-3,15,1
230485,4,28,14,14,1,1
82487,3,10,17,-7,3,0
151985,4,34,34,0,17,1
271010,3,10,21,-11,1,1
70006,3,24,3,21,15,0
236303,2,0,9,-9,3,1
326384,4,20,10,10,9,1
47826,2,7,6,1,5,1
147451,4,23,10,13,15,1
186990,4,10,15,-5,15,1
410971,1,0,7,-7,13,1
121047,3,11,24,-13,3,1
289232,4,30,20,10,9,1
348877,3,6,14,-8,2,1
337133,1,3,0,3,14,0
196659,2,26,0,26,3,1
362952,2,27,6,21,8,0
235348,1,7,0,7,3,1
102505,3,31,3,28,13,0
368017,3,17,21,-4,11,0
392354,3,17,28,-11,4,1
312008,4,35,17,18,2,0
204635,3,10,44,-34,6,0
113339,4,19,31,-12,17,1
414253,2,14,21,-7,14,1
18659,4,26,33,-7,9,1
400327,1,3,0,3,8,0
63111,1,7,3,4,12,0
223034,1,7,6,1,14,0
373608,4,30,40,-10,13,1
236004,2,10,3,7,3,1
263381,4,31,17,14,15,1
391390,2,7,10,-3,4,1
339395,2,0,3,-3,15,0
302399,4,16,16,0,15,0
385286,3,7,6,1,1,0
136792,4,13,10,3,11,0
366285,3,28,10,18,10,0
353688,2,3,7,-4,4,0
152399,3,28,3,25,17,1
111417,4,0,17,-17,16,0
272634,1,0,0,0,2,0
299033,4,16,18,-2,14,0
169734,1,0,0,0,8,1
216665,2,14,6,8,12,1
283594,3,13,17,-4,7,1
220630,1,0,0,0,13,1
256296,3,14,17,-3,12,1
29592,3,14,13,1,14,0
313471,4,17,14,3,3,0
14069,4,3,24,-21,7,0
383948,2,0,9,-9,1,0
356327,2,17,0,17,5,1
92664,1,0,10,-10,8,1
57282,1,0,0,0,10,1
287809,3,21,10,11,9,0
411227,4,11,23,-12,13,0
40676,1,0,0,0,2,1
94374,3,17,14,3,9,0
326479,2,24,6,18,9,0
185780,4,25,3,22,15,0
375135,2,7,10,-3,14,1
312363,2,13,17,-4,3,0
144031,4,21,16,5,14,0
249393,3,18,15,3,9,1
130340,2,7,0,7,8,1
368743,3,14,19,-5,11,1
359777,3,27,19,8,6,1
317110,4,20,17,3,4,0
364390,2,27,7,20,9,1
114327,2,7,6,1,1,1
350167,2,11,0,11,2,1
125390,1,0,0,0,5,0
317445,1,3,0,3,5,1
49083,4,13,13,0,6,1
374322,4,22,13,9,13,1
93528,1,0,0,0,9,0
57640,3,17,3,14,10,0
176571,4,19,17,2,11,0
18664,1,0,0,0,9,0
208224,4,3,10,-7,8,1
97706,4,9,10,-1,11,0
260903,1,0,0,0,14,0
221068,1,0,0,0,14,0
42050,2,20,7,13,2,0
329039,2,3,7,-4,10,0
358815,1,0,7,-7,6,1
296288,2,0,10,-10,13,1
234560,4,23,20,3,2,1
348966,2,14,0,14,2,1
168753,3,13,6,7,7,0
71861,2,9,0,9,16,1
209374,2,7,7,0,8,0
46849,1,10,3,7,5,0
342358,1,0,0,0,16,0
385748,2,10,0,10,1,0
103337,2,7,17,-10,13,1
182626,2,0,6,-6,14,1
404404,4,20,13,7,10,0
56889,2,20,0,20,9,1
307507,3,38,13,25,17,1
419457,2,10,6,4,16,0
80249,4,28,31,-3,2,1
325332,3,12,10,2,8,0
360455,3,10,0,10,7,0
67530,4,39,14,25,14,0
300051,3,0,40,-40,14,1
347424,1,3,6,-3,1,0
388326,3,17,6,11,2,0
421152,4,37,16,21,17,1
298712,4,19,21,-2,14,0
22715,2,3,7,-4,11,0
25256,2,14,7,7,12,0
220431,3,23,14,9,13,1
257755,4,3,27,-24,13,0
169213,3,10,6,4,7,0
416881,1,0,0,0,15,0
149548,3,14,9,5,16,0
196715,3,33,0,33,3,1
174385,3,17,3,14,10,1
197978,2,0,10,-10,3,0
155712,3,10,20,-10,2,1
70249,1,7,0,7,15,0
8300,1,0,0,0,4,0
90564,1,7,7,0,7,1
330062,2,0,3,-3,11,0
407601,3,10,17,-7,11,0
302463,2,3,3,0,15,0
410321,4,7,23,-16,13,0
101283,4,17,7,10,12,0
152736,1,0,0,0,17,1
189344,3,10,10,0,16,1
234392,4,17,10,7,2,1
248816,4,36,14,22,9,1
280680,2,0,3,-3,5,0
209146,4,15,30,-15,8,1
140449,2,14,7,7,12,0
85120,1,0,3,-3,4,0
297697,3,10,13,-3,13,1
415909,3,10,20,-10,15,0
22482,3,31,27,4,11,1
309921,1,0,0,0,2,1
421087,2,13,3,10,17,0
400337,2,3,3,0,8,1
53613,4,14,22,-8,8,1
252616,2,3,3,0,10,1
357426,3,24,24,0,5,1
90038,4,11,21,-10,7,0
284943,3,10,14,-4,7,0
207353,4,13,21,-8,7,0
110694,1,0,3,-3,16,0
52333,2,3,3,0,7,0
388337,3,17,6,11,2,0
45272,2,0,0,0,4,0
188877,2,10,7,3,16,0
58778,4,10,29,-19,10,0
206125,3,20,13,7,7,1
280662,1,0,3,-3,5,0
319091,1,0,0,0,5,1
204559,2,0,28,-28,6,1
182875,1,0,0,0,14,0
384299,3,6,0,6,1,1
287256,4,23,23,0,8,0
3100,1,0,3,-3,2,1
417346,2,10,3,7,16,0
399177,2,7,6,1,7,1
376816,2,14,7,7,15,1
108341,1,0,7,-7,15,0
294772,1,0,7,-7,12,1
308095,2,13,13,0,1,0
250854,4,3,12,-9,10,1
222555,4,17,14,3,14,1
303337,4,34,0,34,16,1
88254,1,0,0,0,6,1
380929,2,6,0,6,16,0
289009,3,19,14,5,9,0
316828,4,16,10,6,4,1
135371,2,14,17,-3,10,1
270047,1,3,3,0,1,1
199393,3,13,10,3,4,1
237902,4,14,27,-13,4,1
343794,2,14,3,11,17,0
279414,3,13,24,-11,5,1
363914,1,0,0,0,8,0
316221,1,0,7,-7,4,0
344131,3,20,3,17,17,1
287976,3,20,13,7,9,0
57544,4,24,16,8,10,0
24574,3,10,16,-6,12,0
276737,1,6,0,6,4,1
158740,1,0,0,0,3,0
175764,4,40,21,19,11,0
392040,3,10,17,-7,4,0
16402,4,21,13,8,8,0
181912,4,21,35,-14,13,1
196048,1,3,14,-11,2,0
166589,2,15,14,1,6,1
384139,3,7,20,-13,1,1
160827,3,27,17,10,4,0
36094,3,41,0,41,17,0
307628,2,7,7,0,17,1
28801,2,3,0,3,14,0
310049,4,9,10,-1,2,0
313840,1,7,9,-2,3,0
174806,2,13,17,-4,10,1
47827,2,7,6,1,5,1
148809,3,13,16,-3,16,0
92358,1,7,0,7,8,0
274560,3,21,16,5,3,0
380378,3,10,17,-7,16,1
275316,3,10,8,2,3,0
269981,3,16,13,3,1,0
227173,3,13,7,6,16,0
65358,4,13,21,-8,13,0
363380,2,14,10,4,8,0
144379,2,0,3,-3,14,0
67090,4,10,9,1,14,0
158750,1,0,3,-3,3,1
189434,2,7,0,7,17,1
295555,3,23,13,10,12,0
30294,2,3,10,-7,14,0
411870,1,6,0,6,13,1
420861,4,17,34,-17,17,1
276932,2,14,14,0,4,1
303173,4,24,28,-4,16,0
178553,4,16,13,3,12,1
103433,4,17,23,-6,13,1
378130,2,21,0,21,15,1
271505,4,21,0,21,1,1
407624,4,10,17,-7,11,0
247300,3,35,28,7,8,1
136725,2,13,10,3,11,1
51899,2,6,10,-4,7,1
35726,1,3,0,3,17,1
386560,4,14,24,-10,2,0
312733,4,31,14,17,3,1
243235,2,0,7,-7,6,1
213485,1,0,7,-7,10,1
109208,1,0,0,0,15,1
301272,1,6,0,6,15,1
140612,2,31,10,21,12,0
242267,1,0,7,-7,6,1
28062,2,14,7,7,13,0
43252,4,24,10,14,3,0
234263,4,20,24,-4,2,0
124463,4,16,14,2,5,0
306428,2,0,10,-10,17,0
207257,1,0,0,0,7,0
69200,4,20,17,3,15,0
382259,3,17,3,14,17,1
187327,1,7,0,7,16,0
107920,2,3,3,0,15,0
11737,4,30,24,6,6,1
354468,2,20,21,-1,4,1
193962,1,7,0,7,1,1
404061,3,10,35,-25,10,0
167477,2,0,0,0,7,1
46277,1,0,6,-6,4,0
131765,4,24,28,-4,8,1
10865,4,27,21,6,5,0
74263,3,10,10,0,17,0
56898,3,27,7,20,9,1
281515,3,17,13,4,6,0
190472,1,7,0,7,17,1
145794,3,13,10,3,15,1
282020,4,28,28,0,6,1
412289,1,0,7,-7,13,1
30010,3,23,0,23,14,1
72599,1,7,0,7,16,1
135049,2,14,3,11,10,1
94109,1,0,0,0,9,1
86789,1,0,0,0,5,0
353179,4,27,29,-2,3,0
291851,2,0,7,-7,11,0
75496,4,31,7,24,17,0
27270,1,7,0,7,13,0
110120,2,7,10,-3,16,0
260169,1,7,0,7,14,0
154797,4,21,23,-2,1,0
361619,1,0,3,-3,7,0
141410,4,10,20,-10,13,1
371491,4,14,24,-10,12,1
168264,2,7,7,0,7,1
210987,1,0,0,0,9,1
316517,1,0,0,0,4,1
333773,1,6,7,-1,12,1
83833,2,10,3,7,4,1
134451,2,3,20,-17,10,0
388799,3,14,7,7,3,1
265323,2,7,0,7,16,0
330023,1,0,0,0,11,1
62740,2,14,0,14,12,1
337041,3,16,0,16,14,1
95278,3,10,17,-7,10,0
190778,2,6,3,3,17,1
202894,3,21,0,21,5,1
14897,2,14,7,7,7,0
352472,4,38,27,11,3,1
214585,2,3,3,0,11,0
388080,1,0,0,0,2,1
47811,2,7,6,1,5,1
399153,1,0,3,-3,7,1
130390,3,7,6,1,8,1
68101,4,3,10,-7,14,1
268323,3,20,3,17,17,0
315700,4,10,16,-6,4,1
53706,2,7,0,7,8,0
79344,4,29,3,26,2,1
171566,1,0,0,0,9,1
169868,4,27,17,10,8,0
199001,4,19,26,-7,3,1
403890,2,10,14,-4,10,1
393972,1,3,7,-4,5,0
40759,3,17,21,-4,2,0
58332,1,0,0,0,10,1
386735,1,0,0,0,2,1
242112,1,7,0,7,6,1
261314,1,0,0,0,14,0
291735,3,0,14,-14,11,1
77562,4,20,14,6,1,1
311024,2,10,0,10,2,1
288436,4,19,7,12,9,1
129732,3,17,14,3,7,0
214696,1,3,0,3,11,1
37602,1,7,0,7,17,1
392597,1,7,0,7,4,0
369447,3,38,7,31,11,0
338613,1,0,0,0,14,1
150235,4,12,26,-14,16,0
261266,3,38,0,38,14,0
244439,4,3,20,-17,7,0
82607,2,0,10,-10,3,1
94849,4,6,13,-7,9,0
230775,4,9,27,-18,1,1
393853,2,10,17,-7,5,0
228265,4,17,27,-10,17,0
347265,2,0,7,-7,1,1
231439,2,10,6,4,1,0
69998,2,21,3,18,15,1
38605,1,0,0,0,1,0
128430,1,0,0,0,7,0
301744,2,0,17,-17,15,1
88613,2,20,7,13,6,0
58541,2,10,9,1,10,0
78326,4,24,21,3,2,0
165988,3,17,14,3,6,1
368656,1,0,3,-3,11,0
301258,4,27,20,7,15,0
301629,3,10,3,7,15,0
92161,3,3,37,-34,8,1
274895,3,7,16,-9,3,1
256339,1,0,0,0,12,1
394583,2,13,0,13,5,1
339302,3,38,7,31,15,0
321091,1,0,3,-3,6,1
109833,2,10,0,10,16,1
33214,2,10,0,10,16,1
114075,3,21,0,21,17,1
99918,2,10,3,7,12,0
265690,4,12,18,-6,16,1
237097,3,6,26,-20,3,1
419323,3,0,17,-17,16,1
24246,3,13,17,-4,12,1
219105,4,45,20,25,13,1
365376,1,0,0,0,9,1
66359,3,14,24,-10,14,1
175584,3,27,7,20,11,0
265238,3,9,6,3,16,0
91630,2,14,7,7,8,1
240738,2,0,7,-7,5,0
147029,4,27,0,27,15,1
103960,3,3,10,-7,13,1
286805,1,0,0,0,8,1
373903,4,43,16,27,13,0
44893,3,7,31,-24,4,1
202876,2,21,0,21,5,0
146342,1,3,3,0,15,0
367908,4,23,20,3,10,0
102440,2,3,3,0,13,1
125256,1,0,0,0,5,0
394628,3,17,7,10,5,0
13985,1,0,0,0,7,1
178118,5,26,26,0,12,1
254058,4,14,23,-9,11,1
342070,1,3,0,3,16,0
245241,2,3,3,0,7,1
192487,3,7,17,-10,1,0
356431,1,0,0,0,5,1
152530,3,24,7,17,17,0
390659,2,3,3,0,3,0
342029,4,20,3,17,16,0
406589,4,20,37,-17,11,0
353043,1,0,0,0,3,0
305536,2,6,0,6,17,0
347700,4,27,24,3,1,1
2170,4,25,23,2,1,1
171624,2,6,10,-4,9,1
127983,4,23,27,-4,6,1
8358,3,23,3,20,4,0
159309,4,27,24,3,3,0
112189,4,27,34,-7,17,1
241330,1,0,0,0,5,1
15915,2,6,7,-1,8,1
237597,4,38,28,10,3,1
39725,3,9,0,9,1,1
206469,4,24,0,24,7,0
119051,1,0,0,0,3,1
393439,4,28,24,4,5,1
193631,4,14,17,-3,1,0
299132,3,3,13,-10,14,0
192209,4,3,27,-24,1,1
252194,4,23,17,6,10,1
118170,4,31,27,4,2,0
2990,3,13,23,-10,2,0
5374,2,13,7,6,3,1
371697,1,7,7,0,12,0
220704,3,10,6,4,13,1
139422,3,24,0,24,12,0
371647,4,24,17,7,12,0
98016,4,17,17,0,11,1
54381,3,17,19,-2,8,1
388733,2,8,0,8,3,1
273330,3,28,0,28,2,0
124263,2,17,17,0,5,1
126718,3,10,13,-3,6,0
142973,4,10,13,-3,13,1
98687,1,7,3,4,11,0
48819,1,3,0,3,5,0
398040,2,14,14,0,7,0
74131,4,23,6,17,17,1
196085,2,6,21,-15,2,1
165409,3,6,30,-24,6,1
271319,3,9,24,-15,1,0
129487,5,29,26,3,7,0
80341,2,13,6,7,2,0
409720,3,10,6,4,12,0
279134,4,21,20,1,5,1
335648,1,0,0,0,13,0
130642,2,7,21,-14,8,0
379422,2,0,0,0,16,1
339095,2,3,0,3,15,0
259975,4,20,20,0,14,0
182525,4,35,14,21,14,0
259076,1,0,0,0,13,0
96254,1,0,6,-6,10,1
19149,2,14,10,4,10,1
25043,4,24,24,0,12,0
186061,4,31,48,-17,15,0
188148,3,10,10,0,16,0
384928,1,0,0,0,1,0
419648,4,30,16,14,17,0
410133,3,17,10,7,13,0
262702,1,7,0,7,15,1
47257,4,19,9,10,5,0
373447,4,17,20,-3,13,1
335147,2,17,0,17,13,0
171367,4,16,17,-1,9,0
353979,5,34,34,0,4,1
387822,2,10,7,3,2,1
356056,3,24,10,14,5,0
252459,2,0,12,-12,10,1
268038,4,21,9,12,17,1
316896,2,9,8,1,4,1
334469,4,23,13,10,13,1
374970,2,14,13,1,14,0
127419,1,0,0,0,6,1
141285,1,0,0,0,13,1
68819,2,6,14,-8,15,0
347889,1,0,0,0,1,0
171093,4,24,43,-19,8,0
369513,1,3,0,3,11,0
142070,1,0,0,0,13,1
290657,2,35,10,25,10,0
1585,4,16,20,-4,1,1
327158,3,21,17,4,9,1
86216,1,0,7,-7,5,0
375498,3,26,7,19,14,1
68062,3,3,10,-7,14,1
18537,1,3,0,3,9,0
124857,2,0,6,-6,5,1
277182,1,0,0,0,4,0
58379,2,28,0,28,10,0
132485,4,8,31,-23,9,1
231539,5,33,29,4,1,1
193144,4,13,6,7,1,1
296888,2,10,0,10,13,0
388639,3,17,0,17,3,0
314760,2,14,0,14,4,1
315711,4,17,16,1,4,0
415998,2,7,0,7,15,0
44056,1,0,0,0,3,0
245940,4,13,37,-24,7,1
311946,3,28,10,18,2,0
398791,3,14,24,-10,7,1
421766,4,31,24,7,17,1
278798,3,7,7,0,5,0
385041,4,24,16,8,1,0
15477,2,9,0,9,8,1
214429,3,7,14,-7,11,1
66636,3,7,17,-10,14,0
90143,2,3,0,3,7,0
87209,1,0,0,0,6,0
106625,3,34,7,27,14,1
149366,2,3,6,-3,16,1
176580,5,19,20,-1,11,0
386643,2,7,13,-6,2,0
102026,2,14,3,11,12,0
393270,3,21,26,-5,5,1
370831,1,0,0,0,12,1
109633,4,37,14,23,16,0
202492,4,9,16,-7,5,0
337664,3,24,13,11,14,0
10686,4,10,17,-7,5,1
402193,4,19,14,5,9,1
231088,4,27,14,13,1,0
367797,1,3,0,3,10,0
12223,2,0,0,0,6,0
69092,2,0,7,-7,15,1
53369,2,3,7,-4,8,0
265867,1,0,6,-6,16,0
101433,3,18,7,11,12,0
78308,3,10,21,-11,2,1
184976,3,7,20,-13,15,0
392279,1,0,7,-7,4,0
279994,2,3,13,-10,5,1
287952,3,14,13,1,9,1
212229,4,3,24,-21,10,0
23773,2,10,0,10,12,1
196548,3,17,6,11,2,0
418882,3,10,10,0,16,1
25262,2,14,7,7,12,1
360362,4,7,20,-13,7,1
267937,1,0,0,0,17,0
343050,2,9,7,2,16,1
41397,4,14,15,-1,2,0
320043,4,49,36,13,6,0
58293,3,20,13,7,10,1
135994,3,3,10,-7,10,1
309035,4,0,20,-20,1,1
415809,1,0,0,0,15,0
5925,2,7,22,-15,3,0
346292,4,47,3,44,1,0
226325,4,19,7,12,16,1
25831,2,17,7,10,12,0
156043,3,20,24,-4,2,1
397501,4,13,22,-9,6,1
295636,1,0,0,0,12,0
309067,1,0,0,0,1,1
276930,2,14,14,0,4,1
344663,2,3,13,-10,17,1
380215,2,13,16,-3,16,1
5687,3,0,17,-17,3,0
16240,3,3,3,0,8,1
100741,1,6,0,6,12,1
22857,2,0,7,-7,11,0
155410,3,13,3,10,2,0
182854,4,36,20,16,14,0
31918,2,6,10,-4,15,0
366470,4,34,22,12,10,0
323381,3,17,0,17,7,0
251040,1,0,0,0,10,0
265865,1,0,6,-6,16,0
296467,3,17,0,17,13,0
296966,4,29,7,22,13,0
418024,4,21,35,-14,16,1
221605,3,20,18,2,14,0
90212,4,6,3,3,7,1
387243,2,6,7,-1,2,0
260339,2,0,0,0,14,1
358177,4,20,9,11,6,0
62948,1,0,0,0,12,0
135733,4,17,29,-12,10,1
309107,2,9,3,6,1,0
82206,4,16,3,13,3,0
335492,4,13,12,1,13,0
61915,4,27,30,-3,12,1
137219,2,7,3,4,11,0
419868,2,3,8,-5,17,0
55152,4,29,17,12,8,1
377152,3,13,10,3,15,0
397883,2,0,3,-3,7,1
420311,2,14,0,14,17,0
224958,4,3,16,-13,15,1
162073,3,28,13,15,4,0
188170,4,17,10,7,16,0
174661,2,9,0,9,10,0
264860,1,0,7,-7,16,1
378270,2,0,3,-3,15,0
118037,4,20,13,7,2,0
230439,3,21,9,12,1,0
316234,2,0,10,-10,4,1
131535,3,6,13,-7,8,0
192803,3,0,15,-15,1,1
2321,4,20,17,3,1,0
278500,3,36,0,36,4,0
33078,2,3,7,-4,16,0
317794,2,9,3,6,5,1
225931,2,20,7,13,16,1
348398,3,13,13,0,1,0
313479,4,17,14,3,3,1
248755,2,27,7,20,9,0
135219,2,13,3,10,10,1
240376,4,21,23,-2,5,1
117373,3,34,3,31,2,0
2909,1,0,0,0,2,0
22397,1,3,10,-7,11,0
157964,4,16,25,-9,3,1
171525,4,17,10,7,9,0
279873,3,17,13,4,5,1
265376,3,14,13,1,16,1
64177,2,31,6,25,13,1
193952,1,7,0,7,1,0
300368,4,10,7,3,14,1
113421,2,0,7,-7,17,1
225123,4,16,14,2,15,1
387132,3,10,31,-21,2,0
285066,2,0,0,0,7,1
179154,4,12,13,-1,12,0
226635,4,10,6,4,16,1
366707,2,24,10,14,10,0
87401,2,7,7,0,6,1
106168,3,0,7,-7,14,1
300805,4,10,33,-23,15,1
321638,3,17,13,4,7,1
409711,3,10,6,4,12,1
215806,3,38,6,32,11,0
42103,4,27,20,7,2,0
358195,4,23,17,6,6,0
78309,3,10,21,-11,2,1
312982,2,3,0,3,3,0
189364,4,19,10,9,16,1
351583,4,0,27,-27,3,1
301209,3,20,14,6,15,0
396562,2,17,10,7,6,1
185761,3,23,3,20,15,1
241536,2,3,3,0,5,1
392961,3,9,3,6,4,0
296093,4,9,17,-8,13,1
364089,2,13,3,10,9,1
45642,3,13,13,0,4,1
207008,2,28,0,28,7,0
365609,3,35,24,11,9,0
319683,3,33,3,30,6,0
198789,3,3,9,-6,3,1
215281,1,0,0,0,11,1
409055,1,3,7,-4,12,1
276672,3,23,6,17,4,0
51345,3,19,20,-1,7,1
86352,4,27,30,-3,5,1
134394,4,32,24,8,10,0
145103,1,3,0,3,14,0
106454,2,16,0,16,14,1
325410,1,6,0,6,8,1
268488,3,23,9,14,17,1
24225,3,10,10,0,12,1
308180,1,0,7,-7,1,1
416315,2,10,3,7,15,1
330343,2,7,6,1,11,1
366630,4,26,14,12,10,0
153084,2,0,10,-10,1,0
29005,3,7,7,0,14,1
371370,4,45,10,35,12,1
377669,2,16,7,9,15,1
100247,4,17,14,3,12,1
383700,3,9,24,-15,17,0
206650,1,0,0,0,7,0
174036,2,0,19,-19,10,1
359900,3,23,24,-1,6,0
16313,1,7,0,7,8,0
68477,1,0,7,-7,14,1
96880,2,13,7,6,10,1
38899,1,0,0,0,1,1
307963,3,7,6,1,1,1
368362,1,7,0,7,11,1
154329,3,20,14,6,1,0
248765,3,27,14,13,9,1
283738,2,8,3,5,7,1
173408,1,0,0,0,10,1
35260,1,0,0,0,16,0
263297,2,10,0,10,15,1
310346,4,29,0,29,2,0
4795,3,27,0,27,3,0
162789,2,0,0,0,5,1
172451,4,13,49,-36,9,1
357462,4,31,33,-2,5,1
116734,2,13,23,-10,2,1
185089,2,0,10,-10,15,0
243737,2,17,3,14,6,0
106794,4,20,22,-2,14,1
134510,4,3,33,-30,10,1
177307,4,17,20,-3,11,1
187343,1,7,7,0,16,1
341921,1,0,0,0,16,1
45485,3,27,17,10,4,0
43695,3,14,10,4,3,0
164331,2,20,0,20,5,0
392758,1,7,3,4,4,1
55609,4,27,14,13,9,1
194138,2,3,0,3,1,0
234313,2,10,0,10,2,1
164686,4,27,27,0,5,1
107014,1,7,0,7,15,1
218474,3,24,17,7,13,1
408251,1,0,0,0,12,0
19695,2,3,6,-3,10,0
399528,3,0,26,-26,7,0
288140,4,19,7,12,9,0
124898,4,9,13,-4,5,0
196423,3,20,7,13,2,0
86946,1,7,0,7,5,1
159837,1,7,0,7,3,1
421270,3,16,10,6,17,1
76349,2,16,3,13,1,0
138879,4,12,47,-35,12,1
187873,4,7,23,-16,16,0
395889,4,16,17,-1,6,0
57053,3,7,20,-13,9,1
291796,4,9,23,-14,11,1
102701,4,32,31,1,13,0
376944,2,3,6,-3,15,0
81787,4,34,24,10,3,1
396363,2,20,6,14,6,0
216845,2,7,14,-7,12,1
213988,3,29,7,22,10,1
312324,1,7,14,-7,3,1
61398,2,13,3,10,11,1
164330,2,20,0,20,5,0
320395,2,14,0,14,6,0
99864,1,0,0,0,12,0
165942,1,3,7,-4,6,1
363684,2,2,10,-8,8,1
337528,4,7,26,-19,14,1
358782,4,21,20,1,6,0
84891,3,33,17,16,4,1
186210,4,23,13,10,15,0
272774,4,15,10,5,2,0
347414,1,0,6,-6,1,1
109768,4,20,0,20,16,0
36923,2,0,16,-16,17,0
319210,4,17,17,0,5,0
231313,2,3,10,-7,1,1
342513,1,0,0,0,16,0
262941,4,14,32,-18,15,1
219170,2,0,3,-3,13,1
139572,3,9,7,2,12,0
2464,4,28,20,8,2,0
191118,3,21,20,1,17,0
245828,1,0,10,-10,7,1
388709,1,0,0,0,3,1
231724,1,0,7,-7,1,1
171137,2,3,0,3,8,0
119757,2,10,3,7,3,1
88133,1,0,3,-3,6,1
183193,1,0,0,0,14,1
318381,1,7,0,7,5,0
102776,2,10,3,7,13,0
376850,3,21,14,7,15,0
90357,4,14,32,-18,7,1
121834,2,0,7,-7,4,0
174220,3,3,26,-23,10,1
330761,5,9,9,0,11,1
195571,4,13,7,6,2,1
103922,2,3,0,3,13,0
385699,1,0,0,0,1,1
344417,3,28,24,4,17,1
204218,1,0,7,-7,6,0
124331,4,41,20,21,5,0
225286,1,0,7,-7,15,0
421618,1,0,0,0,17,1
95685,2,10,6,4,10,1
388380,4,24,20,4,2,0
41006,2,3,10,-7,2,0
394474,3,7,18,-11,5,1
207631,4,42,10,32,7,1
267352,1,0,7,-7,17,0
333844,3,21,21,0,12,0
317686,4,16,9,7,5,1
184318,1,0,0,0,14,0
327905,4,30,24,6,10,0
128006,4,23,33,-10,6,0
402431,3,21,12,9,9,1
401841,2,7,14,-7,9,0
21209,1,0,0,0,11,1
359597,2,17,0,17,6,1
348626,4,34,23,11,2,0
552,3,7,20,-13,1,1
3721,2,10,0,10,2,0
100621,2,7,7,0,12,0
297290,4,24,6,18,13,1
22778,3,3,21,-18,11,1
308183,1,0,7,-7,1,1
44039,1,0,0,0,3,0
73538,3,3,38,-35,17,0
11883,4,41,20,21,6,1
94331,2,10,7,3,9,1
51307,2,9,17,-8,7,1
331474,3,9,15,-6,11,0
388865,1,9,7,2,3,1
420759,2,0,3,-3,17,0
302273,4,38,13,25,15,0
225687,4,21,10,11,16,0
386027,2,7,0,7,1,0
142976,4,10,13,-3,13,0
366439,3,26,10,16,10,0
8218,3,3,10,-7,4,0
391354,4,24,3,21,4,1
351643,2,7,7,0,3,0
344141,3,20,3,17,17,1
338529,3,20,17,3,14,0
111072,2,17,0,17,16,1
384107,2,0,17,-17,1,1
135441,4,31,27,4,10,0
129774,4,17,24,-7,7,0
257188,2,3,15,-12,12,0
282904,1,0,0,0,6,1
402616,3,20,16,4,9,0
111735,4,37,16,21,16,1
384930,1,0,0,0,1,0
328305,2,3,14,-11,10,1
15532,4,23,6,17,8,1
72221,3,17,10,7,16,0
126695,3,7,13,-6,6,0
114585,1,3,0,3,1,0
177553,2,7,0,7,11,1
354463,2,14,21,-7,4,1
355322,4,14,20,-6,4,0
416622,2,27,7,20,15,1
6476,1,0,0,0,3,0
125020,3,3,3,0,5,0
330966,2,15,7,8,11,1
58861,2,3,9,-6,10,1
129937,4,13,0,13,7,0
62373,1,0,7,-7,12,1
88142,2,7,3,4,6,0
124746,3,3,6,-3,5,0
170232,1,0,6,-6,8,1
215704,1,3,0,3,11,0
327847,2,16,10,6,10,0
315065,3,30,14,16,4,1
64483,3,28,16,12,13,1
223328,1,0,0,0,15,0
312328,1,7,14,-7,3,0
337323,2,13,7,6,14,1
291042,4,20,20,0,10,1
236220,4,27,16,11,3,0
233464,3,23,10,13,2,0
47585,4,49,6,43,5,0
269590,1,0,0,0,1,1
399715,1,0,3,-3,8,0
78730,2,13,7,6,2,1
81011,4,20,20,0,3,1
198229,4,16,9,7,3,1
324672,1,0,7,-7,8,0
299502,1,0,0,0,14,1
23359,3,12,10,2,11,1
82779,2,9,6,3,3,0
167219,3,23,17,6,7,0
222512,3,9,14,-5,14,0
157826,1,0,9,-9,3,0
391737,3,10,10,0,4,0
140911,3,17,10,7,13,0
421323,1,0,0,0,17,0
159023,1,0,0,0,3,0
225606,2,0,7,-7,16,0
71748,2,17,23,-6,16,0
91807,3,17,0,17,8,1
80475,2,5,0,5,3,0
254525,4,29,13,16,11,1
104558,1,0,0,0,14,0
393366,2,21,7,14,5,0
190011,1,0,0,0,17,1
28742,4,10,16,-6,14,1
180067,4,28,20,8,13,1
214120,2,3,6,-3,11,1
233292,3,7,17,-10,2,1
408007,2,3,0,3,12,0
60341,2,3,0,3,11,0
63060,4,16,28,-12,12,1
412735,1,0,7,-7,14,1
112241,2,14,7,7,17,1
202164,4,13,6,7,5,0
303632,3,28,13,15,16,1
103744,4,10,23,-13,13,0
43477,1,0,0,0,3,1
226776,4,7,20,-13,16,0
217563,2,3,3,0,12,1
126248,4,28,9,19,6,1
321546,1,3,3,0,7,1
149797,1,3,7,-4,16,0
212135,2,3,14,-11,10,0
110841,5,13,13,0,16,0
181137,4,24,14,10,13,1
162639,2,3,10,-7,5,1
25648,1,7,0,7,12,1
160310,2,3,13,-10,4,0
172393,2,10,28,-18,9,1
262169,4,28,6,22,15,0
109576,3,16,7,9,16,0
300698,1,0,0,0,15,1
38119,4,9,6,3,1,0
239369,1,0,7,-7,4,1
195649,2,7,7,0,2,0
212141,2,3,14,-11,10,0
23137,1,6,0,6,11,1
170744,3,24,6,18,8,0
350919,3,3,14,-11,3,0
332711,2,14,0,14,12,1
414767,4,10,17,-7,14,1
125134,2,13,7,6,5,1
361444,1,0,0,0,7,1
160878,4,34,27,7,4,0
284228,4,9,26,-17,7,1
133486,3,20,17,3,9,1
224375,4,19,12,7,15,0
334569,3,24,23,1,13,0
27106,4,17,9,8,13,0
187810,2,7,3,4,16,1
301268,1,0,0,0,15,0
191646,1,0,3,-3,17,1
178305,2,7,3,4,12,0
310745,2,3,3,0,2,1
235420,3,28,17,11,3,1
121281,4,31,30,1,3,1
232459,2,3,0,3,1,1
4053,2,10,14,-4,2,1
289249,1,0,0,0,9,1
48844,2,3,0,3,5,0
7737,2,20,3,17,4,1
50521,1,0,0,0,6,0
175040,4,20,28,-8,10,1
171107,1,0,0,0,8,1
383000,4,10,21,-11,17,0
24727,4,20,14,6,12,1
63665,4,20,36,-16,12,1
2706,3,6,7,-1,2,1
349116,2,7,0,7,2,0
165804,2,3,3,0,6,0
31036,3,10,6,4,15,1
265693,4,12,18,-6,16,1
252483,3,7,22,-15,10,1
275919,3,13,18,-5,3,0
248383,1,3,0,3,8,1
262488,4,14,35,-21,15,0
149849,3,3,13,-10,16,0
235866,2,0,14,-14,3,1
156289,1,3,0,3,2,0
181048,2,7,0,7,13,0
276668,3,23,6,17,4,1
117130,1,6,0,6,2,0
126961,2,3,10,-7,6,1
51817,4,10,28,-18,7,1
230143,2,3,23,-20,17,0
314675,4,14,21,-7,3,1
206950,1,0,0,0,7,1
138166,2,7,9,-2,11,1
238050,4,13,13,0,4,0
238980,3,14,12,2,4,1
93774,4,3,16,-13,9,0
108308,4,19,14,5,15,1
110738,2,3,3,0,16,0
173818,4,17,3,14,10,0
342952,4,37,17,20,16,0
136364,1,0,0,0,11,1
68787,2,6,0,6,15,1
223201,2,3,3,0,15,1
314743,1,14,0,14,4,0
218280,2,7,7,0,12,0
375747,2,6,0,6,14,0
152823,4,21,10,11,17,1
403272,1,3,0,3,9,0
218064,4,21,24,-3,12,1
151662,4,23,27,-4,17,0
178575,4,16,20,-4,12,1
306636,3,14,27,-13,17,1
343814,3,21,3,18,17,1
271772,3,30,10,20,2,0
344851,3,30,10,20,17,0
370381,1,0,0,0,12,0
372321,3,24,10,14,13,0
35087,4,15,19,-4,16,0
151292,1,7,7,0,17,0
7457,3,20,6,14,4,0
325302,2,9,10,-1,8,1
209646,1,3,0,3,8,0
178002,3,7,13,-6,12,1
340350,3,17,10,7,15,0
378539,1,7,6,1,15,0
95979,2,0,0,0,10,0
316506,1,0,0,0,4,1
31710,1,0,0,0,15,1
270415,3,10,7,3,1,0
354428,1,7,7,0,4,1
399185,2,10,6,4,7,1
277729,3,7,3,4,4,0
37748,2,7,0,7,1,0
237536,3,24,7,17,3,1
7485,4,29,6,23,4,0
139949,2,10,3,7,12,1
86404,2,20,7,13,5,1
305775,4,16,10,6,17,0
395818,3,3,7,-4,6,0
80294,1,7,3,4,2,0
168013,3,3,14,-11,7,0
392956,3,9,3,6,4,1
388902,2,10,14,-4,3,0
140098,2,0,0,0,12,1
353333,1,0,0,0,4,0
44813,1,0,7,-7,4,0
42058,3,20,7,13,2,0
413844,2,14,6,8,14,1
100421,4,12,20,-8,12,1
96049,4,13,7,6,10,1
239959,1,0,3,-3,5,0
188114,2,0,10,-10,16,1
302544,4,3,13,-10,15,1
365108,2,0,7,-7,9,0
2629,1,0,0,0,2,1
392601,1,7,0,7,4,0
412661,3,13,10,3,14,1
149582,4,14,26,-12,16,0
12963,1,0,0,0,6,0
32051,2,7,10,-3,15,1
31163,2,23,20,3,15,1
416437,1,7,0,7,15,1
16417,4,21,16,5,8,1
263006,2,7,0,7,15,1
352219,2,0,3,-3,3,1
411507,4,13,24,-11,13,0
133607,2,9,7,2,9,1
256522,1,0,0,0,12,1
417257,4,20,20,0,16,0
159331,4,27,31,-4,3,1
404865,4,30,27,3,10,0
11401,3,26,0,26,6,1
404505,3,21,27,-6,10,1
421747,4,24,17,7,17,1
129975,1,0,3,-3,8,1
168871,3,17,3,14,7,1
169388,3,6,21,-15,8,0
231319,2,3,10,-7,1,1
418814,1,0,0,0,16,0
229651,1,6,7,-1,17,1
356278,1,7,0,7,5,0
123281,1,7,0,7,4,0
127379,4,17,23,-6,6,0
206258,3,7,6,1,7,1
108235,2,6,0,6,15,0
89196,2,3,0,3,7,0
138315,2,20,0,20,11,0
63592,2,13,14,-1,12,0
334863,3,24,3,21,13,0
381283,4,24,20,4,16,1
89082,3,13,6,7,6,0
188739,3,0,17,-17,16,0
33477,1,0,0,0,16,1
419268,1,0,0,0,16,0
114768,1,7,10,-3,1,1
31108,1,0,0,0,15,0
392145,2,0,13,-13,4,0
339471,4,10,26,-16,15,1
343330,2,0,10,-10,16,0
50911,4,17,24,-7,6,1
200511,4,26,18,8,4,0
386230,3,12,17,-5,2,1
200669,4,38,28,10,4,1
128315,2,0,3,-3,7,1
360801,4,24,30,-6,7,1
313900,3,28,19,9,3,0
410435,3,9,17,-8,13,1
118174,4,31,27,4,2,0
78266,2,0,14,-14,2,1
186980,4,10,12,-2,15,0
328348,3,3,30,-27,10,0
340870,1,0,0,0,15,0
49231,3,17,10,7,6,1
349481,4,6,20,-14,2,1
191107,3,14,13,1,17,0
308401,3,0,18,-18,1,1
96853,1,10,0,10,10,1
393029,1,0,0,0,4,0
259200,4,14,32,-18,13,0
349602,3,13,28,-15,2,0
219336,2,16,7,9,13,0
122243,2,3,10,-7,4,0
178115,5,26,26,0,12,1
392450,1,0,0,0,4,0
260631,2,6,13,-7,14,1
143507,3,14,21,-7,14,1
240384,5,24,23,1,5,0
365583,2,28,14,14,9,1
332044,3,10,3,7,12,0
374165,3,23,7,16,13,0
45174,3,7,10,-3,4,1
62849,2,3,3,0,12,1
252352,3,0,22,-22,10,0
362086,3,20,10,10,8,1
390100,3,10,14,-4,3,1
260509,2,27,0,27,14,0
108424,4,13,21,-8,15,0
29840,2,6,10,-4,14,0
66898,2,6,7,-1,14,1
178379,4,28,24,4,12,0
354085,3,19,0,19,4,1
53402,3,3,14,-11,8,0
202969,1,7,0,7,5,0
43822,3,14,16,-2,3,1
30382,1,0,7,-7,14,1
371636,4,17,17,0,12,1
203331,2,14,27,-13,6,0
68833,3,6,14,-8,15,0
173599,2,0,13,-13,10,1
116266,2,17,3,14,1,0
197122,2,14,20,-6,3,1
249281,4,33,14,19,9,0
385991,4,27,28,-1,1,1
15563,1,0,0,0,8,0
177407,2,17,10,7,11,0
187794,1,7,0,7,16,1
278284,1,7,0,7,4,1
23083,4,10,17,-7,11,0
209466,4,24,20,4,8,0
251069,2,7,14,-7,10,1
375931,2,14,6,8,14,1
212008,3,3,22,-19,9,0
195814,3,20,14,6,2,0
61675,2,14,3,11,12,0
113144,2,41,0,41,17,0
166660,4,32,20,12,6,0
210031,3,7,10,-3,8,1
74884,4,20,20,0,17,1
112078,2,7,7,0,17,1
338248,3,27,24,3,14,0
288070,2,10,0,10,9,0
397234,4,16,0,16,6,0
191062,2,7,0,7,17,1
287760,2,14,3,11,9,1
75010,4,27,17,10,17,0
110918,2,7,10,-3,16,1
72709,4,34,13,21,16,0
62397,2,0,10,-10,12,0
275657,3,30,3,27,3,1
328075,1,0,0,0,10,0
223541,3,10,10,0,15,1
181178,1,0,0,0,13,0
225632,2,6,10,-4,16,1
221075,1,0,0,0,14,0
116930,3,21,10,11,2,0
332307,2,6,6,0,12,1
363160,4,17,10,7,8,1
419866,2,3,8,-5,17,0
231703,1,0,0,0,1,0
196146,4,31,24,7,2,1
182561,1,0,0,0,14,0
258529,1,0,0,0,13,0
348756,4,31,23,8,2,0
17091,3,23,3,20,9,0
328959,3,16,7,9,10,1
102515,4,31,9,22,13,0
221968,4,22,25,-3,14,1
342251,2,3,0,3,16,1
420173,3,0,3,-3,17,0
98655,4,14,10,4,11,0
140152,3,10,3,7,12,0
300933,4,10,27,-17,15,1
30239,1,0,0,0,14,1
339008,3,20,3,17,15,0
343174,2,3,0,3,16,0
353756,4,20,17,3,4,0
177700,2,13,14,-1,12,1
92607,4,17,3,14,8,0
366849,2,3,3,0,10,0
168506,4,10,30,-20,7,1
186182,3,16,6,10,15,0
188748,3,0,17,-17,16,0
209732,3,9,6,3,8,0
383187,1,14,0,14,17,0
374436,3,18,0,18,14,1
22444,2,24,24,0,11,0
319042,3,13,23,-10,5,0
126069,3,14,3,11,6,0
7212,1,0,6,-6,4,0
18156,3,13,17,-4,9,0
346509,2,17,30,-13,1,1
4945,3,14,17,-3,3,1
266032,2,10,0,10,16,1
390925,1,6,0,6,4,1
205517,3,14,17,-3,6,1
77280,4,16,10,6,1,1
306239,4,30,3,27,17,0
317081,3,17,17,0,4,0
330642,2,6,0,6,11,0
296616,2,3,7,-4,13,1
88967,3,36,10,26,6,0
329120,4,27,7,20,10,0
380774,2,3,14,-11,16,1
286707,2,10,7,3,8,1
242180,3,13,7,6,6,1
196442,4,20,21,-1,2,1
41314,2,13,9,4,2,1
233330,4,13,23,-10,2,1
303524,4,37,17,20,16,0
174737,4,9,10,-1,10,0
191165,1,0,0,0,17,1
287533,4,14,33,-19,9,0
260604,1,0,7,-7,14,0
224588,2,6,7,-1,15,0
59661,4,21,6,15,11,1
189890,1,0,7,-7,17,0
182220,4,33,7,26,13,1
288766,4,3,13,-10,9,1
138750,1,0,0,0,12,0
367580,3,14,12,2,10,1
303495,4,25,10,15,16,0
12961,1,0,0,0,6,0
284052,4,10,3,7,7,1
102258,1,7,0,7,13,0
389983,4,28,25,3,3,0
311193,2,3,0,3,2,1
24445,4,16,7,9,12,0
163501,1,0,0,0,5,1
256473,4,19,24,-5,12,0
347421,1,0,6,-6,1,1
294676,3,6,14,-8,12,1
323838,3,16,15,1,8,1
355961,1,0,7,-7,5,1
189131,1,7,0,7,16,1
161334,4,20,19,1,4,1
416892,2,3,7,-4,15,0
77492,2,0,7,-7,1,1
65474,3,23,14,9,13,0
229912,4,27,14,13,17,0
237566,4,38,14,24,3,0
294682,3,6,14,-8,12,1
342441,3,10,3,7,16,1
341920,1,0,0,0,16,1
411477,3,10,17,-7,13,1
200798,4,31,17,14,4,0
35718,1,3,0,3,17,0
195926,2,0,17,-17,2,0
130371,3,7,3,4,8,1
335921,4,31,21,10,13,1
420831,3,16,17,-1,17,1
256750,3,3,6,-3,12,0
303647,4,31,13,18,16,1
171907,2,7,7,0,9,0
405054,1,0,3,-3,10,1
195823,3,20,14,6,2,1
382728,4,9,13,-4,17,0
370397,1,7,0,7,12,1
414896,4,35,7,28,15,0
371809,1,0,0,0,12,0
118770,1,10,0,10,2,1
384587,3,10,42,-32,1,0
139275,3,13,13,0,12,1
51496,4,34,24,10,7,0
260737,1,3,0,3,14,0
118405,3,13,10,3,2,0
213364,2,10,6,4,10,1
55572,3,23,7,16,9,1
162079,3,28,13,15,4,1
274928,4,17,16,1,3,0
23936,3,16,0,16,12,1
176683,3,29,12,17,11,0
13643,4,13,10,3,7,0
309029,4,0,20,-20,1,0
107713,1,0,0,0,15,0
48360,1,0,7,-7,5,0
190787,2,13,3,10,17,0
123584,1,0,0,0,4,1
58142,3,20,17,3,10,1
290672,3,35,16,19,10,1
17870,4,24,17,7,9,1
155240,3,28,7,21,1,0
63806,4,14,34,-20,12,1
399383,4,27,10,17,7,1
143535,4,20,21,-1,14,0
385049,4,24,24,0,1,1
65656,4,6,19,-13,13,1
213871,4,48,7,41,10,0
67231,4,0,3,-3,14,1
359736,2,17,9,8,6,1
266992,4,19,17,2,17,0
328288,2,3,7,-4,10,1
27359,3,24,10,14,13,1
224357,4,16,12,4,15,1
191162,4,28,33,-5,17,1
180682,4,27,6,21,13,1
136797,4,13,10,3,11,1
37584,1,0,0,0,17,1
159021,1,0,0,0,3,0
107260,1,0,0,0,15,1
36236,3,10,24,-14,17,0
326891,1,0,0,0,9,0
55335,4,20,20,0,9,0
373811,2,13,0,13,13,0
261635,1,0,0,0,14,1
144248,2,9,7,2,14,0
213987,3,29,7,22,10,1
205981,3,13,10,3,7,0
419966,1,0,0,0,17,1
217269,2,0,7,-7,12,1
2436,4,21,13,8,2,1
19221,4,21,19,2,10,0
31303,2,7,3,4,15,1
312853,3,7,0,7,3,1
236062,3,37,10,27,3,0
28530,3,24,7,17,14,0
419787,4,17,20,-3,17,1
327948,1,0,0,0,10,0
382496,1,0,0,0,17,0
260742,1,3,3,0,14,1
392034,3,10,17,-7,4,1
73211,2,7,6,1,16,1
104305,2,31,14,17,13,0
362335,2,10,7,3,8,0
241209,1,0,0,0,5,1
208028,3,21,0,21,8,0
26513,5,30,29,1,13,0
18176,4,20,20,0,9,1
155856,2,7,10,-3,2,0
371845,2,14,10,4,12,0
278903,1,7,7,0,5,0
134614,3,24,17,7,10,1
122763,4,10,27,-17,4,0
222760,2,3,7,-4,14,1
23634,2,7,13,-6,12,1
354201,2,6,10,-4,4,1
122675,1,0,3,-3,4,1
75171,4,13,6,7,17,1
136841,1,0,0,0,11,0
125793,3,14,20,-6,5,0
78562,2,13,7,6,2,1
372757,2,0,0,0,13,1
27412,4,27,17,10,13,0
243373,1,0,7,-7,6,1
305593,4,20,10,10,17,1
363295,3,27,14,13,8,1
126693,3,7,13,-6,6,0
197580,2,19,0,19,3,0
388734,2,8,0,8,3,1
214586,2,3,3,0,11,0
378636,4,23,23,0,15,0
2506,2,3,0,3,2,1
191049,1,0,0,0,17,1
88436,2,7,0,7,6,0
226221,1,3,0,3,16,1
292465,2,10,6,4,11,0
90009,3,5,21,-16,7,1
365217,1,0,0,0,9,0
212316,2,10,3,7,10,1
186746,1,14,0,14,15,0
23318,2,6,10,-4,11,1
283415,2,20,7,13,7,0
72617,2,13,0,13,16,1
37249,3,13,14,-1,17,1
266811,3,10,14,-4,16,1
242453,2,3,7,-4,6,0
419956,1,0,0,0,17,0
92274,2,10,0,10,8,1
392088,4,18,39,-21,4,0
12257,3,3,3,0,6,0
384397,1,14,0,14,1,1
18276,2,10,17,-7,9,0
384278,2,6,0,6,1,1
122607,3,27,7,20,4,0
360154,2,10,6,4,7,0
339135,3,10,12,-2,15,0
227196,4,13,17,-4,16,1
137000,5,20,20,0,11,1
86601,4,40,3,37,5,0
44810,1,0,7,-7,4,0
359057,4,10,13,-3,6,0
230513,1,3,0,3,1,0
404727,1,7,3,4,10,0
393738,3,7,7,0,5,0
175,1,3,0,3,1,0
96881,2,13,7,6,10,0
286930,4,23,13,10,8,1
168028,3,3,17,-14,7,1
267592,4,27,34,-7,17,1
390304,4,17,20,-3,3,1
96149,2,0,16,-16,10,0
37430,4,24,0,24,17,1
16894,2,7,13,-6,8,1
54661,3,14,22,-8,8,0
319756,1,0,0,0,6,1
185913,4,22,16,6,15,1
268135,2,3,7,-4,17,1
369397,2,17,0,17,11,0
165511,2,0,14,-14,6,1
381401,3,16,0,16,16,0
247324,4,42,35,7,8,1
276329,2,14,14,0,3,0
208456,2,10,0,10,8,1
20830,2,14,6,8,10,1
225158,1,0,0,0,15,1
3808,4,23,10,13,2,1
273558,1,0,0,0,2,1
131527,2,6,13,-7,8,1
370741,2,12,7,5,12,0
409232,2,13,3,10,12,1
403247,4,31,24,7,9,0
308482,1,0,0,0,1,0
363427,3,28,21,7,8,0
247760,4,10,6,4,8,1
392127,1,0,13,-13,4,0
118891,4,27,14,13,2,0
265191,2,6,3,3,16,0
331006,3,36,7,29,11,1
367627,4,31,12,19,10,1
299396,2,0,13,-13,14,1
156093,1,6,0,6,2,1
105942,1,7,0,7,14,1
121264,4,28,30,-2,3,0
336419,2,9,3,6,14,1
195834,3,27,14,13,2,0
114790,2,7,17,-10,1,0
129460,4,23,23,0,7,0
164566,1,0,0,0,5,1
281520,4,17,13,4,6,1
174531,3,7,14,-7,10,1
85476,2,14,3,11,5,1
341947,2,6,0,6,16,1
240550,5,19,19,0,5,0
97160,1,0,0,0,10,0
408548,4,10,16,-6,12,0
383120,3,23,14,9,17,0
301779,3,0,27,-27,15,0
383508,2,14,3,11,17,1
219964,3,6,14,-8,13,1
268840,1,0,0,0,17,0
208265,1,0,7,-7,8,1
258914,4,20,32,-12,13,1
292804,4,29,17,12,11,1
282222,2,3,0,3,6,0
203200,3,10,17,-7,5,1
115463,4,39,21,18,1,1
98094,1,7,0,7,11,0
79479,3,12,14,-2,2,1
379367,4,10,16,-6,16,1
48920,4,15,13,2,5,1
143071,2,3,14,-11,13,1
272098,3,17,6,11,2,0
328154,3,6,14,-8,10,1
273104,1,0,0,0,2,1
122122,2,17,14,3,4,0
375438,1,7,7,0,14,0
392275,1,0,7,-7,4,1
174682,3,9,7,2,10,1
213566,4,10,14,-4,10,0
1775,1,3,0,3,1,0
119774,2,10,6,4,3,0
188927,4,23,10,13,16,0
158696,4,24,7,17,3,0
27585,1,7,3,4,13,0
172170,1,0,0,0,9,1
113495,4,3,7,-4,17,1
254097,1,0,0,0,11,0
334456,4,17,13,4,13,1
5485,2,3,3,0,3,1
124215,1,0,14,-14,5,1
312258,4,10,17,-7,2,1
51041,3,0,20,-20,6,1
31287,2,7,3,4,15,1
168082,4,6,24,-18,7,0
207826,1,0,0,0,8,1
98747,3,28,6,22,11,0
120365,1,0,6,-6,3,1
289485,3,6,7,-1,10,1
316758,2,10,6,4,4,0
18160,3,13,20,-7,9,1
249626,1,0,0,0,9,1
26043,4,10,19,-9,13,1
135383,3,21,17,4,10,0
248704,1,3,0,3,9,0
131609,1,0,0,0,8,0
231309,2,3,3,0,1,0
353763,5,20,20,0,4,0
369811,1,0,0,0,12,1
103035,2,0,0,0,13,1
331856,2,0,0,0,12,0
147015,3,24,0,24,15,1
274664,2,7,3,4,3,1
153562,3,12,14,-2,1,1
229245,2,10,14,-4,17,1
338568,4,29,31,-2,14,1
264664,5,23,20,3,16,0
258477,4,21,21,0,13,1
232544,4,20,17,3,1,1
240952,3,20,9,11,5,1
391012,3,20,27,-7,4,1
157637,4,22,3,19,2,1
356775,1,0,0,0,5,0
158625,2,7,7,0,3,1
212901,2,0,7,-7,10,0
220819,2,7,7,0,14,0
279770,4,30,13,17,5,1
121982,3,16,7,9,4,1
344457,1,0,0,0,17,1
102317,3,13,10,3,13,1
399134,1,0,0,0,7,0
129760,4,17,24,-7,7,1
117382,4,34,3,31,2,1
221441,3,3,31,-28,14,0
249040,2,14,10,4,9,1
340049,3,17,12,5,15,0
150473,3,27,6,21,16,1
20318,2,10,10,0,10,0
219324,2,13,7,6,13,1
155346,2,10,3,7,2,1
180562,4,28,32,-4,13,1
187163,4,19,0,19,16,0
280647,1,0,0,0,5,0
108781,1,0,7,-7,15,1
24793,1,6,0,6,12,0
357637,1,0,0,0,5,1
230867,2,7,7,0,1,0
294442,4,19,12,7,12,1
347346,4,7,21,-14,1,1
127948,3,23,7,16,6,1
168188,4,29,12,17,7,0
116956,4,35,13,22,2,0
353865,2,7,21,-14,4,1
162861,4,6,3,3,5,1
75461,3,31,7,24,17,1
65357,4,13,21,-8,13,0
163310,3,13,16,-3,5,0
79717,2,10,7,3,2,0
206552,2,7,3,4,7,0
92703,2,3,10,-7,8,0
316465,3,16,17,-1,4,0
400455,4,24,10,14,8,0
399564,4,0,33,-33,7,0
191176,1,0,3,-3,17,0
289872,2,0,3,-3,10,1
74939,2,16,7,9,17,1
256136,3,21,16,5,12,0
225464,2,0,7,-7,15,1
25271,2,27,7,20,12,0
185264,3,24,9,15,15,0
75316,4,14,26,-12,17,1
181512,1,0,0,0,13,1
153241,2,2,0,2,1,0
211433,1,3,0,3,9,0
63820,4,14,34,-20,12,1
29519,1,0,7,-7,14,1
275765,3,16,3,13,3,1
186363,4,29,24,5,15,1
95730,4,13,9,4,10,1
368202,4,24,21,3,11,1
22098,1,0,0,0,11,1
293898,2,0,14,-14,12,1
416359,3,16,6,10,15,1
311224,3,6,0,6,2,1
42616,1,0,7,-7,3,0
232127,1,0,0,0,1,1
229431,3,10,6,4,17,1
218566,2,7,14,-7,13,0
385249,2,0,3,-3,1,1
420736,1,0,0,0,17,0
256328,4,21,17,4,12,0
240001,2,3,13,-10,5,0
80226,3,21,30,-9,2,0
43157,1,0,0,0,3,0
204922,3,13,19,-6,6,0
192333,3,27,17,10,1,0
385768,2,17,0,17,1,1
162643,2,3,10,-7,5,1
294047,2,7,14,-7,12,0
347954,3,0,21,-21,1,0
370059,4,31,20,11,12,1
113652,4,9,13,-4,17,0
115797,1,0,0,0,1,1
348222,2,6,17,-11,1,1
59282,1,0,0,0,11,1
42539,4,10,21,-11,3,0
279738,4,30,6,24,5,0
369344,4,21,20,1,11,1
267300,4,17,17,0,17,0
104813,4,27,33,-6,14,0
121696,3,14,7,7,4,1
101064,2,7,10,-3,12,0
29766,4,41,3,38,14,0
313809,1,0,0,0,3,0
368824,2,7,0,7,11,1
285289,3,14,9,5,7,1
272737,3,12,3,9,2,1
148351,4,14,3,11,16,0
20225,4,24,10,14,10,1
184575,4,45,21,24,14,0
48044,4,10,27,-17,5,0
178761,1,14,7,7,12,1
381031,1,7,3,4,16,0
65500,4,23,14,9,13,0
195051,2,7,17,-10,2,1
206986,2,21,0,21,7,0
86883,4,9,26,-17,5,0
389954,3,28,18,10,3,0
391107,2,7,14,-7,4,1
43510,2,7,3,4,3,1
185635,4,20,27,-7,15,1
309617,4,16,3,13,1,1
147472,4,36,10,26,15,0
404542,4,34,27,7,10,1
103923,2,3,0,3,13,0
346829,2,10,3,7,1,1
10544,4,40,0,40,5,0
390974,2,13,14,-1,4,1
8864,1,7,0,7,4,1
148228,4,16,31,-15,16,1
286400,2,14,0,14,8,1
154055,4,24,21,3,1,0
209229,3,20,7,13,8,0
111612,1,7,3,4,16,0
81938,4,7,30,-23,3,1
309179,4,35,9,26,1,1
363857,3,13,26,-13,8,0
270614,4,23,14,9,1,1
40751,2,17,14,3,2,0
233437,3,17,10,7,2,0
133405,1,0,7,-7,9,0
12125,3,7,14,-7,6,1
31438,2,3,6,-3,15,0
333054,3,10,12,-2,12,1
281552,4,20,23,-3,6,1
400000,4,15,13,2,8,1
417541,4,24,28,-4,16,1
101969,1,0,0,0,12,1
47713,3,6,17,-11,5,0
349056,4,17,17,0,2,1
260902,1,0,0,0,14,0
302443,1,0,3,-3,15,1
327501,1,0,7,-7,10,1
357063,1,6,7,-1,5,1
148859,4,16,23,-7,16,1
359264,1,0,3,-3,6,0
403412,1,7,0,7,9,0
278490,3,36,0,36,4,0
389066,2,20,0,20,3,1
286750,3,20,20,0,8,0
119706,5,20,22,-2,3,0
366790,1,0,0,0,10,0
68405,4,3,21,-18,14,1
181895,3,21,28,-7,13,0
140946,4,20,13,7,13,1
4435,1,0,0,0,2,0
375601,2,7,14,-7,14,1
395740,1,0,0,0,6,0
353842,2,7,14,-7,4,0
393335,1,7,7,0,5,1
189354,3,13,10,3,16,0
241849,2,13,3,10,5,0
194807,4,10,23,-13,2,0
417105,4,34,0,34,15,0
61830,2,3,17,-14,12,0
49446,5,20,20,0,6,0
289667,4,13,23,-10,10,1
298602,4,13,10,3,14,0
104244,2,3,0,3,13,1
347801,3,10,0,10,1,0
180297,2,9,7,2,13,0
122701,2,7,10,-3,4,1
404484,3,21,13,8,10,0
323663,3,20,0,20,8,1
275971,4,20,21,-1,3,1
128863,4,20,23,-3,7,1
200603,3,24,14,10,4,1
123185,3,6,21,-15,4,0
371414,2,7,7,0,12,0
43921,1,0,7,-7,3,0
341502,2,3,7,-4,16,0
229939,1,0,0,0,17,1
40216,4,34,7,27,2,0
357390,2,14,17,-3,5,1
420778,2,3,3,0,17,1
72207,3,17,10,7,16,1
312775,1,0,0,0,3,0
100576,4,23,20,3,12,1
23031,2,7,14,-7,11,1
406641,2,0,0,0,11,1
117380,4,34,3,31,2,1
116958,4,35,13,22,2,0
414789,5,17,17,0,14,1
542,3,7,20,-13,1,0
289487,3,13,7,6,10,0
357058,1,6,7,-1,5,1
46060,3,14,14,0,4,0
124390,2,6,0,6,5,0
230509,1,0,0,0,1,1
285135,4,3,0,3,7,1
157803,4,20,10,10,2,0
181353,1,14,0,14,13,0
346542,3,24,33,-9,1,1
373992,3,10,7,3,13,1
400333,2,3,3,0,8,1
398566,1,0,0,0,7,1
118229,1,9,0,9,2,0
216049,2,10,12,-2,11,0
238712,4,19,17,2,4,0
123572,4,19,17,2,4,0
127357,4,10,20,-10,6,0
83192,1,3,7,-4,4,1
334773,4,32,11,21,13,0
96847,1,10,0,10,10,0
46109,4,28,21,7,4,0
334627,1,0,0,0,13,1
50820,1,7,7,0,6,0
46968,1,0,0,0,5,1
232188,2,6,3,3,1,1
143230,3,10,13,-3,13,1
37504,2,7,7,0,17,0
168485,4,3,24,-21,7,1
103155,1,0,0,0,13,0
372596,2,7,6,1,13,1
125715,1,0,7,-7,5,0
351226,3,28,10,18,3,0
119925,2,6,14,-8,3,0
420208,4,3,10,-7,17,0
409300,4,13,16,-3,12,0
352064,1,3,7,-4,3,0
381610,1,0,0,0,17,1
395064,3,0,24,-24,5,1
227816,4,6,35,-29,16,1
140600,2,24,10,14,12,1
180100,1,0,0,0,13,1
73864,4,13,7,6,17,1
302860,4,12,23,-11,15,0
390135,4,20,34,-14,3,0
237478,1,14,0,14,3,1
212777,3,10,21,-11,10,1
202860,2,14,0,14,5,0
192958,3,10,17,-7,1,0
287062,4,26,24,2,8,0
41275,1,0,3,-3,2,0
124730,3,3,3,0,5,1
105753,4,35,10,25,14,1
203053,3,20,10,10,5,1
160296,2,3,0,3,4,0
176557,4,19,17,2,11,1
64251,1,0,0,0,13,0
13617,3,13,7,6,7,0
374956,1,7,6,1,14,1
309691,2,10,6,4,1,0
185039,1,0,3,-3,15,1
400213,2,10,6,4,8,1
285480,4,36,8,28,8,1
146133,4,25,17,8,15,1
348488,1,14,0,14,2,1
121925,1,0,7,-7,4,1
187823,2,7,10,-3,16,0
310041,4,9,10,-1,2,1
30925,4,9,24,-15,15,1
222940,2,13,13,0,14,0
251572,4,16,20,-4,10,1
262306,3,10,9,1,15,1
51062,4,3,20,-17,6,0
118621,1,7,0,7,2,0
228482,2,10,7,3,17,1
119747,2,10,3,7,3,0
365056,4,23,6,17,9,0
61807,2,0,17,-17,12,1
314292,1,0,13,-13,3,0
195425,4,24,3,21,2,0
71031,2,20,0,20,16,1
230695,2,6,17,-11,1,0
186727,1,6,0,6,15,1
119141,3,10,7,3,3,0
25764,4,17,17,0,12,1
78203,4,47,3,44,2,1
16233,2,3,3,0,8,0
363265,3,24,7,17,8,0
131715,3,24,22,2,8,0
5911,2,0,16,-16,3,1
250003,2,7,6,1,9,1
268390,1,0,0,0,17,1
121773,1,0,0,0,4,0
257035,2,0,14,-14,12,1
418792,4,14,24,-10,16,1
171626,2,6,10,-4,9,1
15522,4,23,6,17,8,0
276327,2,14,14,0,3,0
400692,3,16,7,9,8,0
154727,2,3,7,-4,1,0
394754,2,14,0,14,5,1
370517,4,27,9,18,12,1
2313,4,13,17,-4,1,1
267416,3,10,16,-6,17,0
60732,4,28,3,25,11,0
184154,4,16,14,2,14,0
325461,2,16,3,13,8,1
383002,4,10,24,-14,17,1
357725,3,40,13,27,5,0
159939,4,38,17,21,3,1
179348,1,0,0,0,12,1
5653,2,0,14,-14,3,0
188132,3,10,10,0,16,1
89669,2,6,10,-4,7,1
269330,2,0,7,-7,1,0
310948,3,3,23,-20,2,1
128052,2,3,6,-3,7,0
137193,1,7,0,7,11,0
403975,4,26,24,2,10,0
22037,4,17,17,0,11,0
106065,4,24,3,21,14,0
106205,4,0,10,-10,14,1
135702,3,17,10,7,10,0
350828,1,0,0,0,3,0
13860,2,7,0,7,7,1
169568,4,10,41,-31,8,1
264789,3,17,23,-6,16,1
170833,1,7,0,7,8,0
191476,1,7,7,0,17,0
7546,1,7,0,7,4,0
262805,4,35,17,18,15,0
25915,4,38,17,21,12,1
358357,1,6,7,-1,6,1
259584,2,0,0,0,13,0
46589,2,3,0,3,4,0
273725,1,0,0,0,2,0
8250,4,16,10,6,4,0
334501,1,7,14,-7,13,1
250429,1,0,0,0,9,1
78030,4,12,16,-4,1,1
270936,1,0,0,0,1,1
111743,4,44,16,28,16,0
215566,1,6,0,6,11,1
392603,1,7,0,7,4,1
184221,2,10,0,10,14,1
68029,2,0,10,-10,14,1
226026,5,34,34,0,16,1
243811,4,27,20,7,6,0
323359,2,10,0,10,7,0
327029,4,8,10,-2,9,0
346472,1,7,7,0,1,1
9643,3,12,21,-9,5,1
14857,1,0,0,0,7,1
262851,2,7,20,-13,15,1
252008,3,14,20,-6,10,1
59294,1,0,3,-3,11,1
231849,1,0,13,-13,1,0
347930,3,0,21,-21,1,1
133717,1,0,0,0,9,1
9725,1,0,7,-7,5,1
354403,4,48,10,38,4,0
400002,4,15,13,2,8,0
69127,2,14,10,4,15,1
393281,4,24,26,-2,5,0
337725,1,0,0,0,14,1
149068,2,7,7,0,16,1
136707,2,6,10,-4,11,0
110295,2,0,17,-17,16,0
91927,2,3,3,0,8,0
120010,4,23,37,-14,3,0
344453,4,28,24,4,17,1
287689,4,9,13,-4,9,0
357174,4,12,20,-8,5,1
132183,4,29,13,16,9,1
45511,4,27,26,1,4,0
114500,3,17,20,-3,1,1
52891,4,14,58,-44,7,1
145705,1,0,7,-7,15,1
317010,2,0,10,-10,4,1
119179,4,13,7,6,3,1
330786,1,0,3,-3,11,1
83424,4,10,23,-13,4,0
190182,1,0,0,0,17,1
174361,3,17,0,17,10,0
61029,4,34,16,18,11,0
238149,1,3,3,0,4,0
323039,2,14,7,7,7,0
169863,4,20,17,3,8,1
402424,2,21,7,14,9,0
249256,3,19,14,5,9,1
300806,4,10,33,-23,15,0
53140,3,19,38,-19,7,1
290280,4,17,12,5,10,0
61039,4,34,19,15,11,0
320353,1,7,0,7,6,0
97845,3,7,24,-17,11,0
39733,3,9,0,9,1,1
362757,1,0,0,0,8,1
380341,2,7,7,0,16,1
167363,3,23,23,0,7,1
6699,3,3,20,-17,3,0
326495,2,31,9,22,9,0
401613,4,24,31,-7,8,1
115106,2,3,13,-10,1,0
413217,1,7,0,7,14,0
15334,2,7,3,4,8,0
404340,3,20,6,14,10,0
130408,4,7,6,1,8,1
330737,4,6,6,0,11,0
270676,2,3,3,0,1,1
138530,4,31,30,1,12,0
131023,4,17,30,-13,8,1
15988,4,18,14,4,8,0
373343,2,7,0,7,13,0
88934,2,23,3,20,6,1
179629,4,31,23,8,12,0
86948,2,7,0,7,5,1
284354,4,14,17,-3,7,0
115260,2,7,9,-2,1,0
175298,4,15,19,-4,10,1
77777,2,7,14,-7,1,1
106293,2,6,6,0,14,1
236675,3,17,7,10,3,0
42966,4,31,23,8,3,1
144758,4,3,10,-7,14,0
101833,1,3,0,3,12,0
416307,2,10,3,7,15,0
172167,1,0,0,0,9,1
356661,2,16,3,13,5,0
27310,2,14,3,11,13,1
202963,1,6,0,6,5,1
343373,3,0,20,-20,16,0
414138,3,10,13,-3,14,1
146630,1,0,7,-7,15,0
25493,1,0,0,0,12,0
70183,3,30,14,16,15,0
338679,3,13,10,3,14,1
223724,4,37,13,24,15,0
98530,1,0,0,0,11,1
77339,2,7,7,0,1,0
186920,2,7,3,4,15,0
394779,3,21,0,21,5,1
421787,1,0,0,0,17,0
133570,1,3,0,3,9,1
18934,4,9,27,-18,9,1
409994,3,6,35,-29,12,0
161993,1,7,0,7,4,0
54736,1,0,0,0,8,1
275429,2,13,10,3,3,1
410913,3,14,15,-1,13,1
62396,2,0,10,-10,12,0
325216,4,13,26,-13,8,1
14250,1,0,0,0,7,0
344281,3,14,13,1,17,0
233615,3,23,41,-18,2,0
18226,1,0,0,0,9,0
19240,1,0,7,-7,10,1
291370,1,7,7,0,10,0
243068,2,0,9,-9,6,1
260834,3,28,15,13,14,1
156849,4,23,23,0,2,0
36980,4,0,32,-32,17,0
400672,2,6,7,-1,8,1
303650,4,38,13,25,16,0
342933,4,30,17,13,16,1
70143,2,20,7,13,15,0
383741,4,16,27,-11,17,1
307033,2,17,0,17,17,0
48872,2,9,0,9,5,1
25127,2,10,0,10,12,1
184425,4,24,6,18,14,1
311034,2,10,0,10,2,0
204752,3,14,14,0,6,0
227755,3,3,14,-11,16,1
328221,4,14,17,-3,10,1
194871,2,0,10,-10,2,1
384927,1,0,0,0,1,1
75180,4,13,6,7,17,1
209726,3,9,6,3,8,1
339913,3,26,0,26,15,1
78879,3,17,0,17,2,1
68469,1,0,6,-6,14,0
154136,2,0,6,-6,1,1
388647,3,17,0,17,3,0
210015,3,7,3,4,8,0
193104,3,13,6,7,1,0
36320,2,7,7,0,17,0
362695,4,3,10,-7,8,0
161541,1,0,3,-3,4,1
301807,4,3,34,-31,15,1
420642,3,21,16,5,17,1
386480,2,7,0,7,2,1
80284,1,0,3,-3,2,1
281065,4,24,16,8,6,1
211995,2,3,16,-13,9,1
353729,4,10,17,-7,4,1
3282,2,3,3,0,2,0
147155,4,17,46,-29,15,0
110677,4,23,10,13,16,0
234046,3,20,0,20,2,1
17022,1,0,0,0,9,1
219061,3,31,13,18,13,0
24201,2,3,0,3,12,1
80685,4,17,26,-9,3,0
373794,1,0,0,0,13,1
243127,4,7,12,-5,6,0
96293,2,0,9,-9,10,0
198964,3,13,23,-10,3,0
47981,2,3,24,-21,5,1
338576,4,29,38,-9,14,1
179751,3,6,10,-4,12,1
256465,4,12,24,-12,12,1
262746,3,21,0,21,15,0
198679,4,15,21,-6,3,1
243964,4,25,20,5,6,1
70098,1,3,0,3,15,1
270065,2,9,10,-1,1,1
246225,3,21,16,5,7,0
34094,2,0,0,0,16,0
163883,2,15,10,5,5,1
17189,2,7,21,-14,9,1
45655,4,13,13,0,4,0
358004,3,24,13,11,6,1
166797,4,23,16,7,6,0
368998,3,10,7,3,11,0
141773,1,0,0,0,13,1
383485,1,0,3,-3,17,1
116619,3,13,3,10,2,1
365691,1,7,3,4,9,0
261007,4,10,3,7,14,0
83562,3,0,17,-17,4,0
172604,4,17,24,-7,9,1
132581,3,12,29,-17,9,0
141739,4,33,21,12,13,0
257001,1,0,7,-7,12,1
52469,1,3,0,3,7,0
248868,1,7,0,7,9,1
136204,4,13,10,3,10,0
82522,4,10,20,-10,3,0
280907,4,21,3,18,6,0
392478,2,3,10,-7,4,0
49705,4,21,24,-3,6,0
235936,4,23,21,2,3,0
162604,1,0,7,-7,5,0
340427,4,31,19,12,15,0
33252,2,10,0,10,16,1
182323,3,17,7,10,14,1
91127,1,0,7,-7,8,1
311805,3,17,20,-3,2,0
394345,3,24,17,7,5,0
249195,2,9,0,9,9,0
303422,2,10,7,3,16,1
45524,4,27,26,1,4,1
259572,2,0,0,0,13,1
380954,3,9,7,2,16,0
220648,1,7,0,7,13,0
71212,4,19,20,-1,16,0
292300,2,6,10,-4,11,1
87258,2,10,14,-4,6,1
157323,4,19,9,10,2,0
81664,2,7,7,0,3,0
252406,1,0,0,0,10,1
45265,2,0,0,0,4,0
143341,2,0,13,-13,14,1
277600,4,12,20,-8,4,0
213069,3,17,3,14,10,1
193275,3,3,20,-17,1,0
409307,4,13,16,-3,12,1
74821,3,13,6,7,17,1
409144,4,3,17,-14,12,1
134255,4,3,23,-20,10,1
351160,1,7,0,7,3,1
52196,2,7,3,4,7,0
230006,3,0,6,-6,17,1
416234,4,10,39,-29,15,1
371083,4,13,26,-13,12,0
68922,1,0,0,0,15,0
326068,3,16,3,13,9,0
246291,1,0,3,-3,7,0
105525,2,26,14,12,14,1
283866,2,7,10,-3,7,1
140740,2,15,14,1,12,0
70231,4,33,30,3,15,0
410391,2,6,7,-1,13,1
188321,4,23,13,10,16,0
192749,2,0,6,-6,1,0
324615,4,16,15,1,8,1
289713,1,0,7,-7,10,1
77109,3,14,17,-3,1,1
136795,4,13,10,3,11,1
18474,4,7,14,-7,9,1
412957,3,16,9,7,14,0
249373,2,10,15,-5,9,0
242720,1,7,7,0,6,0
237749,5,20,20,0,4,0
206224,2,0,3,-3,7,0
2234,2,7,7,0,1,1
340925,2,0,10,-10,15,1
352208,1,0,3,-3,3,1
223304,4,6,12,-6,15,1
282673,3,6,17,-11,6,1
25516,1,0,0,0,12,1
122129,3,17,14,3,4,0
248198,4,9,10,-1,8,1
91528,4,19,10,9,8,1
404915,2,3,10,-7,10,1
199074,2,7,14,-7,4,0
381141,4,24,28,-4,16,1
172933,4,41,31,10,9,1
212101,1,0,7,-7,10,1
342104,2,6,3,3,16,1
251092,2,10,14,-4,10,0
180094,1,0,0,0,13,0
330043,1,0,0,0,11,0
393078,2,7,3,4,4,0
362527,3,16,6,10,8,0
26603,3,10,6,4,13,1
257747,4,3,24,-21,13,0
230330,4,19,17,2,17,1
337949,3,20,0,20,14,1
278775,2,0,0,0,5,1
201003,2,14,0,14,5,0
223427,4,13,26,-13,15,1
22063,4,24,24,0,11,0
396063,1,10,3,7,6,1
67637,3,7,35,-28,14,0
241291,3,10,7,3,5,1
263575,1,0,7,-7,15,1
37724,1,7,0,7,1,1
50212,1,7,7,0,6,0
202202,4,13,14,-1,5,1
405748,3,10,7,3,10,0
317280,4,14,19,-5,5,1
280844,2,10,3,7,6,0
354196,2,6,7,-1,4,0
260837,3,29,15,14,14,0
367677,2,0,3,-3,10,0
59785,3,12,10,2,11,0
340488,2,0,20,-20,15,0
345192,1,0,0,0,17,1
347514,4,12,30,-18,1,1
193709,3,3,27,-24,1,0
75246,2,7,10,-3,17,1
8227,3,3,10,-7,4,1
236599,1,0,0,0,3,0
74304,4,10,30,-20,17,0
232060,3,0,24,-24,1,1
396605,4,20,10,10,6,1
197333,4,17,10,7,3,1
323396,3,20,0,20,7,0
352631,1,0,0,0,3,0
77797,2,7,14,-7,1,0
392082,4,18,33,-15,4,1
418174,3,24,6,18,16,0
77440,4,27,21,6,1,0
284164,2,6,13,-7,7,0
176924,1,7,0,7,11,1
145551,1,7,0,7,14,0
164723,2,6,7,-1,6,1
161220,1,0,3,-3,4,1
32735,4,7,24,-17,15,1
142844,4,12,20,-8,13,1
20713,4,24,20,4,10,0
60158,4,34,19,15,11,0
14432,2,17,3,14,7,1
384030,4,20,23,-3,1,0
139431,3,24,3,21,12,1
407080,2,0,13,-13,11,1
94707,4,31,43,-12,9,1
225576,1,0,0,0,16,0
234477,2,17,13,4,2,1
156629,2,3,0,3,2,1
238461,1,3,0,3,4,1
385011,3,24,16,8,1,0
176187,3,14,17,-3,11,1
68959,2,20,7,13,15,1
55829,2,7,7,0,9,0
336296,3,17,3,14,13,0
249046,2,21,10,11,9,0
86168,4,31,10,21,5,0
348250,3,16,39,-23,1,0
265188,2,6,3,3,16,0
360692,1,0,7,-7,7,1
385149,3,14,17,-3,1,0
147096,2,7,31,-24,15,1
335513,1,0,0,0,13,1
15995,4,18,14,4,8,1
294088,3,7,24,-17,12,1
27914,2,0,3,-3,13,0
208645,3,6,6,0,8,1
212232,4,3,24,-21,10,1
246112,1,0,0,0,7,0
242601,2,10,0,10,6,1
261520,2,9,0,9,14,1
209150,1,0,0,0,8,0
300900,3,10,10,0,15,0
377316,4,24,14,10,15,0
68360,3,3,14,-11,14,0
397228,4,16,0,16,6,0
311265,4,6,3,3,2,1
411396,4,20,13,7,13,1
290006,1,0,0,0,10,1
399567,4,0,33,-33,7,1
343747,1,7,0,7,17,1
103686,3,0,10,-10,13,1
68690,3,17,0,17,15,1
372716,1,0,0,0,13,1
363890,4,20,29,-9,8,0
147493,1,0,0,0,15,1
175780,1,0,0,0,11,0
42659,3,0,10,-10,3,1
67472,2,30,7,23,14,1
231635,3,14,13,1,1,0
19567,2,7,14,-7,10,1
110488,3,20,0,20,16,1
370450,2,10,6,4,12,1
189796,3,17,6,11,17,0
98031,4,17,24,-7,11,0
101613,4,13,38,-25,12,1
31272,1,0,3,-3,15,1
245728,3,13,10,3,7,1
59360,3,0,9,-9,11,0
407000,3,3,20,-17,11,0
408516,4,10,10,0,12,0
137275,4,7,20,-13,11,0
321850,1,7,7,0,7,0
362827,3,7,21,-14,8,0
236521,3,10,9,1,3,1
294059,2,7,20,-13,12,0
33754,1,0,0,0,16,0
271220,4,21,23,-2,1,1
297014,1,6,0,6,13,1
315490,2,0,3,-3,4,0
253202,2,0,7,-7,11,0
247592,3,16,23,-7,8,1
283673,1,0,0,0,7,0
3711,1,10,0,10,2,1
131842,2,14,7,7,8,1
208590,2,3,0,3,8,1
209669,2,6,0,6,8,0
380345,2,7,7,0,16,1
137552,3,17,20,-3,11,0
77187,1,0,0,0,1,0
10592,1,0,10,-10,5,0
83872,3,23,10,13,4,0
306227,4,20,3,17,17,1
394782,3,21,0,21,5,1
109139,3,24,7,17,15,0
170325,4,0,15,-15,8,1
364911,4,13,23,-10,9,1
256693,1,0,0,0,12,0
172364,2,3,21,-18,9,1
10276,1,0,0,0,5,1
236753,1,0,3,-3,3,1
327725,3,6,13,-7,10,0
317667,3,9,6,3,5,0
173263,1,0,3,-3,10,1
239927,4,13,9,4,4,1
142310,2,0,3,-3,13,0
265077,3,13,3,10,16,1
204894,3,3,13,-10,6,1
161761,3,24,6,18,4,1
135433,4,31,27,4,10,1
343941,2,14,6,8,17,1
418188,4,24,6,18,16,1
35073,4,15,16,-1,16,0
335095,1,0,0,0,13,1
67460,2,20,7,13,14,0
239946,1,0,0,0,5,0
397119,1,3,0,3,6,0
313177,3,13,16,-3,3,1
311378,3,28,13,15,2,0
60913,1,0,0,0,11,0
256299,4,14,17,-3,12,1
206641,4,10,16,-6,7,1
208071,4,21,13,8,8,0
379744,2,9,7,2,16,0
207560,2,14,0,14,7,0
246867,5,20,23,-3,8,0
341771,1,0,0,0,16,0
222560,4,17,14,3,14,1
85022,2,25,13,12,4,0
288773,4,3,13,-10,9,1
171174,3,3,7,-4,8,0
377919,4,29,16,13,15,1
314073,3,23,14,9,3,0
338740,4,27,17,10,14,0
156386,4,38,14,24,2,1
205932,2,3,3,0,7,0
250285,2,7,0,7,9,1
187405,3,34,7,27,16,0
48496,1,2,0,2,5,1
28940,1,0,7,-7,14,1
317669,3,9,6,3,5,1
14577,1,0,7,-7,7,1
342241,2,3,0,3,16,1
257851,3,7,9,-2,13,0
182038,3,14,14,0,13,1
401666,2,0,14,-14,8,1
23091,4,10,17,-7,11,0
300261,1,0,0,0,14,0
375904,2,14,3,11,14,0
163574,2,7,16,-9,5,0
410286,3,7,16,-9,13,0
80158,2,7,7,0,2,1
150902,3,7,7,0,17,1
129349,2,14,7,7,7,1
57589,1,3,3,0,10,1
303649,4,37,13,24,16,1
215982,4,20,42,-22,11,1
12189,1,0,0,0,6,1
82107,1,0,0,0,3,1
114461,1,3,10,-7,1,0
126939,1,3,0,3,6,0
141395,3,10,17,-7,13,1
410455,3,9,20,-11,13,0
409784,1,7,0,7,12,0
320662,1,7,7,0,6,0
326369,3,17,10,7,9,1
393731,3,6,7,-1,5,1
372197,4,9,16,-7,13,1
294483,2,7,10,-3,12,1
310795,4,13,10,3,2,0
255696,4,3,10,-7,12,0
29215,1,0,0,0,14,1
13671,4,25,17,8,7,0
277929,4,7,27,-20,4,0
338084,3,3,7,-4,14,0
71432,2,24,0,24,16,1
243108,3,7,9,-2,6,1
414867,3,21,7,14,15,0
294858,4,42,21,21,12,1
197169,3,27,27,0,3,1
386422,4,23,17,6,2,1
308474,4,7,28,-21,1,0
393573,3,7,12,-5,5,0
366651,1,7,3,4,10,1
324025,4,20,25,-5,8,1
354904,5,44,42,2,4,1
302718,4,26,20,6,15,1
375881,1,7,0,7,14,0
42731,4,7,20,-13,3,1
237039,1,0,14,-14,3,0
250314,2,7,7,0,9,1
371010,2,7,7,0,12,0
267379,2,0,7,-7,17,0
189733,1,0,3,-3,17,0
315818,3,0,19,-19,4,0
84381,1,3,0,3,4,0
63670,4,26,36,-10,12,0
292824,4,29,24,5,11,1
305547,2,6,0,6,17,1
378212,4,41,16,25,15,0
172875,3,24,10,14,9,0
70460,3,17,17,0,15,1
37690,4,30,0,30,17,1
78141,2,17,3,14,2,1
269933,2,13,10,3,1,1
382138,3,27,3,24,17,0
202993,2,14,0,14,5,1
123231,4,19,21,-2,4,0
196137,3,31,24,7,2,0
395170,2,10,7,3,5,0
7023,4,19,7,12,3,0
334581,3,27,24,3,13,1
151947,3,27,17,10,17,0
343357,3,0,20,-20,16,1
297664,2,7,3,4,13,0
329065,2,3,7,-4,10,1
87419,3,17,7,10,6,0
100251,4,17,14,3,12,1
383309,4,48,24,24,17,1
47949,2,0,21,-21,5,1
293930,2,7,21,-14,12,0
146076,2,19,10,9,15,1
311422,1,0,0,0,2,0
412595,1,0,0,0,14,1
326519,3,38,9,29,9,0
227759,3,3,14,-11,16,0
368965,2,7,7,0,11,0
407370,1,0,0,0,11,0
72636,2,13,0,13,16,0
384850,2,6,12,-6,1,0
254317,3,6,19,-13,11,0
56112,2,17,7,10,9,0
173183,3,17,17,0,9,1
8563,1,0,0,0,4,1
84303,3,7,27,-20,4,1
35017,2,9,0,9,16,0
246411,4,26,18,8,7,0
315607,1,0,0,0,4,0
278816,3,7,21,-14,5,1
186087,4,31,55,-24,15,1
291937,4,24,17,7,11,1
149151,4,17,31,-14,16,0
318987,2,0,6,-6,5,0
189540,4,20,7,13,17,1
23901,2,3,0,3,12,1
283095,2,3,0,3,7,0
109463,4,9,13,-4,16,1
237774,1,0,6,-6,4,0
393517,1,7,6,1,5,0
81929,4,7,30,-23,3,1
395231,3,10,13,-3,5,1
41047,3,3,13,-10,2,1
293290,4,26,15,11,11,1
157762,3,17,10,7,2,0
202853,2,7,0,7,5,1
225776,2,10,14,-4,16,1
137059,2,14,3,11,11,0
16159,1,0,0,0,8,0
235586,4,27,13,14,3,1
42385,3,14,16,-2,2,1
219156,2,0,3,-3,13,0
60878,4,17,26,-9,11,1
334847,2,16,3,13,13,0
391143,2,7,24,-17,4,0
251804,1,0,7,-7,10,1
251922,4,20,19,1,10,1
332456,2,16,3,13,12,0
350573,2,10,0,10,2,1
297799,2,14,7,7,13,1
123142,2,3,7,-4,4,0
241248,2,3,0,3,5,1
273852,4,17,14,3,2,0
175885,3,20,27,-7,11,1
235749,4,10,27,-17,3,1
13389,1,0,0,0,7,0
126817,2,0,6,-6,6,0
164450,2,14,0,14,5,0
56576,3,16,17,-1,9,0
217966,1,7,0,7,12,0
193807,1,3,0,3,1,0
325844,4,13,20,-7,9,0
336340,4,20,13,7,13,1
264693,1,7,6,1,16,1
323453,1,0,3,-3,7,0
273475,2,7,13,-6,2,1
404201,3,9,9,0,10,1
30956,4,17,24,-7,15,1
219401,4,30,27,3,13,1
26356,4,22,21,1,13,0
299933,4,16,11,5,14,0
26112,2,0,10,-10,13,1
269057,3,10,16,-6,17,1
287254,4,23,23,0,8,0
364746,4,12,3,9,9,0
222110,4,34,17,17,14,0
308395,2,0,12,-12,1,1
25302,3,37,14,23,12,0
133575,2,3,0,3,9,0
247161,4,20,6,14,8,1
201479,2,12,7,5,5,1
116163,3,7,10,-3,1,0
95168,4,23,27,-4,9,1
341625,1,3,0,3,16,0
156242,4,24,23,1,2,0
18655,4,20,33,-13,9,1
279530,2,10,6,4,5,0
233034,4,24,17,7,2,1
374773,4,16,39,-23,14,1
406744,1,0,0,0,11,0
210975,1,0,0,0,9,0
296329,3,6,16,-10,13,1
354107,4,19,0,19,4,0
9397,1,0,0,0,5,0
41670,4,24,7,17,2,1
185936,4,22,30,-8,15,1
8944,4,28,7,21,4,1
117927,1,7,3,4,2,0
326355,3,14,10,4,9,1
185958,1,0,7,-7,15,1
208521,4,44,15,29,8,1
38205,2,3,7,-4,1,0
100851,4,12,19,-7,12,1
176033,3,24,0,24,11,0
171390,4,16,20,-4,9,1
267509,2,13,14,-1,17,0
188348,1,0,0,0,16,0
206126,3,20,13,7,7,1
407305,4,17,19,-2,11,1
251484,2,16,3,13,10,1
373167,1,0,3,-3,13,1
400464,1,0,0,0,8,0
116142,2,7,3,4,1,0
206562,2,10,10,0,7,0
381310,4,38,31,7,16,1
346059,3,3,6,-3,1,0
385394,2,7,7,0,1,1
403870,2,10,0,10,10,0
314683,4,17,21,-4,3,1
159459,4,20,23,-3,3,1
415938,4,16,30,-14,15,1
38636,1,0,0,0,1,0
176359,3,16,21,-5,11,0
178196,3,3,10,-7,12,1
414783,4,17,17,0,14,1
231459,3,10,9,1,1,1
221429,3,3,24,-21,14,1
316675,5,12,12,0,4,0
268872,2,6,10,-4,17,0
297044,2,14,0,14,13,0
368194,4,24,21,3,11,0
391064,4,27,34,-7,4,0
370136,2,10,3,7,12,1
400212,2,10,6,4,8,0
326734,1,0,7,-7,9,0
12641,1,0,0,0,6,0
283889,3,21,10,11,7,0
216315,2,7,10,-3,12,1
326252,4,10,48,-38,9,0
128844,4,20,13,7,7,1
192287,2,24,3,21,1,0
320094,2,10,0,10,6,0
60956,2,14,6,8,11,1
261598,4,12,15,-3,14,0
378111,1,14,0,14,15,1
140167,4,10,3,7,12,1
299103,2,3,3,0,14,0
334598,4,30,31,-1,13,1
120872,3,14,17,-3,3,0
379271,1,0,3,-3,16,0
244039,2,20,17,3,6,0
366265,2,14,10,4,10,0
289073,4,41,28,13,9,0
201767,2,6,0,6,5,0
260368,3,6,0,6,14,0
234221,4,20,10,10,2,0
353081,2,7,16,-9,3,1
341038,2,7,14,-7,15,1
48065,1,0,0,0,5,1
93916,4,24,6,18,9,0
354828,3,20,28,-8,4,1
29648,4,14,21,-7,14,0
248976,4,27,3,24,9,1
83260,3,12,10,2,4,0
132749,4,20,17,3,9,0
55146,4,29,17,12,8,0
33826,3,0,31,-31,16,1
380968,4,9,14,-5,16,0
369004,3,10,7,3,11,1
322130,1,0,0,0,7,0
377398,2,7,13,-6,15,0
366680,2,17,10,7,10,0
109594,3,19,14,5,16,1
187068,2,10,0,10,16,1
29739,3,26,3,23,14,1
109044,4,23,34,-11,15,0
418732,2,7,7,0,16,0
94755,1,3,0,3,9,0
6977,3,3,7,-4,3,0
260677,3,10,22,-12,14,0
393763,4,7,14,-7,5,1
198458,3,17,3,14,3,0
405296,3,14,7,7,10,1
219390,4,23,20,3,13,1
239817,1,0,0,0,4,1
414578,3,21,9,12,14,0
278848,4,14,24,-10,5,0
32274,4,24,21,3,15,1
364802,1,3,0,3,9,1
236040,3,23,3,20,3,0
325237,4,19,26,-7,8,1
157943,4,9,22,-13,3,1
56384,1,0,7,-7,9,1
90378,1,0,0,0,7,0
217918,4,25,28,-3,12,1
155964,1,3,7,-4,2,0
127514,4,3,23,-20,6,0
285563,2,7,10,-3,8,1
298707,4,13,21,-8,14,1
284896,1,0,7,-7,7,0
319962,3,30,10,20,6,0
122144,3,24,14,10,4,0
8680,4,7,10,-3,4,1
6964,3,0,7,-7,3,0
251704,2,21,3,18,10,0
301725,1,0,10,-10,15,0
313365,1,0,0,0,3,0
350090,4,30,20,10,2,0
172756,4,21,18,3,9,1
293317,1,0,0,0,11,1
264605,4,12,17,-5,16,0
26144,3,0,13,-13,13,0
360632,3,10,20,-10,7,0
302289,1,0,0,0,15,1
102449,2,3,3,0,13,1
414502,1,7,3,4,14,0
275514,4,26,30,-4,3,1
107854,1,0,0,0,15,1
227533,4,26,24,2,16,1
188179,4,17,13,4,16,1
203979,3,10,7,3,6,1
340366,3,17,13,4,15,1
29385,1,0,0,0,14,0
76574,4,7,41,-34,1,0
129952,4,13,6,7,7,0
385497,4,35,17,18,1,0
139174,4,19,13,6,12,0
304138,1,0,0,0,16,0
30213,4,13,31,-18,14,1
37110,4,13,17,-4,17,1
331861,2,0,0,0,12,0
45356,4,20,16,4,4,1
347239,1,0,0,0,1,0
295962,1,0,0,0,13,0
314572,1,7,0,7,3,0
389837,4,24,6,18,3,1
412571,1,0,0,0,14,1
130387,3,7,6,1,8,1
391963,1,0,0,0,4,0
375247,5,27,24,3,14,0
350300,2,14,0,14,2,0
111438,4,0,20,-20,16,1
323691,3,20,0,20,8,1
201405,1,6,0,6,5,0
401498,1,0,0,0,8,0
368467,4,37,28,9,11,0
251159,4,10,27,-17,10,0
279523,2,10,6,4,5,0
283813,1,0,0,0,7,1
248082,4,34,20,14,8,0
373968,2,7,0,7,13,1
407496,1,0,0,0,11,1
417442,1,3,7,-4,16,0
56677,1,0,0,0,9,0
62192,4,13,17,-4,12,1
231628,3,14,13,1,1,1
135481,1,7,0,7,10,0
198416,1,3,3,0,3,0
77312,1,0,0,0,1,1
243904,3,16,6,10,6,0
128996,4,35,10,25,7,0
415420,2,9,0,9,15,1
145785,3,13,10,3,15,1
73217,3,7,6,1,16,0
157442,3,9,17,-8,2,1
329316,2,6,14,-8,10,0
276884,1,0,0,0,4,1
362386,4,30,20,10,8,1
229661,1,7,7,0,17,0
126790,1,0,3,-3,6,0
40573,2,10,7,3,2,1
317424,4,13,17,-4,5,1
395460,1,0,0,0,6,0
167910,4,21,19,2,7,0
3177,3,13,9,4,2,1
258350,1,0,0,0,13,0
205596,1,7,0,7,7,0
297937,2,17,7,10,13,0
419516,4,10,23,-13,16,1
294015,1,0,0,0,12,1
119933,2,6,14,-8,3,0
307576,1,0,0,0,17,0
388100,1,3,0,3,2,0
31683,4,24,16,8,15,0
126649,1,0,0,0,6,1
382981,4,10,13,-3,17,0
129019,4,42,13,29,7,1
272827,2,20,0,20,2,1
211067,3,30,0,30,9,0
50678,1,0,7,-7,6,1
303771,3,20,10,10,16,0
286242,2,3,13,-10,8,1
403180,3,17,14,3,9,1
299174,4,10,19,-9,14,1
36476,2,3,6,-3,17,0
102784,2,10,3,7,13,1
55891,4,19,22,-3,9,1
392147,2,0,13,-13,4,0
222860,4,24,13,11,14,1
300958,4,24,27,-3,15,1
43465,1,0,0,0,3,1
349395,1,0,0,0,2,1
410934,4,14,22,-8,13,1
48885,3,9,0,9,5,1
14478,3,24,16,8,7,1
181286,3,3,20,-17,13,1
306105,1,0,0,0,17,0
334233,2,3,7,-4,13,1
235814,1,0,7,-7,3,1
384104,2,0,17,-17,1,1
279690,2,23,3,20,5,0
176041,3,24,0,24,11,1
174430,4,17,10,7,10,0
185143,4,0,23,-23,15,1
97196,2,3,6,-3,10,1
125722,1,7,7,0,5,0
324744,3,19,7,12,8,1
149692,2,20,0,20,16,1
366784,1,0,0,0,10,1
87440,3,20,7,13,6,0
54561,4,21,18,3,8,1
122584,3,14,7,7,4,1
400401,3,24,10,14,8,1
46003,1,6,7,-1,4,1
105154,1,0,0,0,14,0
399032,2,10,12,-2,7,1
26438,3,17,16,1,13,1
206850,2,3,7,-4,7,1
233014,4,17,10,7,2,1
32702,3,7,13,-6,15,1
313248,1,3,0,3,3,1
216071,3,17,12,5,11,1
107451,2,0,10,-10,15,0
197592,3,19,0,19,3,0
265023,1,7,0,7,16,0
51027,2,0,17,-17,6,1
80333,2,13,6,7,2,0
378741,3,14,7,7,15,1
207219,4,17,20,-3,7,1
340046,3,17,12,5,15,1
179478,4,21,20,1,12,0
27880,1,0,0,0,13,0
151170,2,3,10,-7,17,0
292440,2,3,3,0,11,0
70433,2,14,17,-3,15,0
94002,2,0,21,-21,9,1
252775,2,3,6,-3,11,1
244287,4,26,7,19,6,0
147144,3,17,46,-29,15,1
68549,3,10,28,-18,14,1
415675,1,0,0,0,15,0
64337,3,6,20,-14,13,1
111568,4,35,16,19,16,0
285819,4,14,24,-10,8,1
123469,2,0,0,0,4,0
334429,4,17,10,7,13,0
46919,3,20,20,0,5,0
218483,4,31,17,14,13,0
235186,1,0,0,0,3,0
101851,2,3,0,3,12,0
119823,4,24,16,8,3,1
92273,2,10,0,10,8,1
336553,2,0,0,0,14,0
345645,1,0,0,0,17,1
226879,2,0,10,-10,16,1
237542,3,31,7,24,3,0
245363,1,9,0,9,7,0
341175,2,3,0,3,16,1
77149,4,24,17,7,1,1
180777,3,7,13,-6,13,1
77191,2,0,0,0,1,1
357215,1,0,3,-3,5,1
71305,2,7,13,-6,16,1
187305,4,10,13,-3,16,0
357566,3,13,13,0,5,0
296471,3,17,0,17,13,1
41964,4,31,6,25,2,1
386718,4,17,19,-2,2,0
24575,3,10,16,-6,12,0
97142,4,34,6,28,10,0
284508,4,24,15,9,7,0
29945,1,0,0,0,14,0
80473,2,5,0,5,3,0
11317,1,7,0,7,6,1
413824,2,14,0,14,14,1
197730,3,7,10,-3,3,1
28582,4,33,7,26,14,0
164854,1,0,3,-3,6,0
40430,2,7,7,0,2,0
156073,4,20,24,-4,2,0
65395,1,0,7,-7,13,0
202789,4,19,17,2,5,1
407750,3,10,7,3,11,1
79749,3,20,7,13,2,1
138925,2,7,3,4,12,0
49642,2,0,7,-7,6,1
253545,2,6,7,-1,11,1
393781,4,7,14,-7,5,0
378797,4,17,10,7,15,0
350805,4,23,10,13,2,0
378772,4,14,10,4,15,0
57295,2,0,0,0,10,1
196847,3,3,13,-10,3,0
147131,3,17,37,-20,15,0
308413,3,0,18,-18,1,1
85802,3,13,13,0,5,0
159137,4,31,7,24,3,0
17930,1,7,7,0,9,0
361027,2,9,2,7,7,1
288555,3,20,31,-11,9,1
171457,2,7,3,4,9,1
122938,1,0,0,0,4,1
373737,4,13,21,-8,13,1
81889,3,0,27,-27,3,0
115838,2,0,10,-10,1,1
51351,4,19,20,-1,7,1
251176,1,7,7,0,10,1
153714,2,2,21,-19,1,0
236318,2,0,16,-16,3,0
257723,4,3,24,-21,13,1
21201,4,0,16,-16,10,0
111185,1,7,0,7,16,1
385865,1,0,0,0,1,0
382956,3,3,13,-10,17,0
222472,2,6,7,-1,14,0
33646,2,14,0,14,16,0
151145,1,3,10,-7,17,1
296068,4,9,7,2,13,0
185489,1,0,0,0,15,0
88931,2,23,3,20,6,0
375563,4,33,20,13,14,0
148977,3,13,12,1,16,1
157934,3,9,15,-6,3,0
409527,2,7,3,4,12,0
89882,4,30,13,17,7,0
9619,2,12,14,-2,5,0
135609,1,7,0,7,10,0
133085,4,15,25,-10,9,1
44876,3,7,17,-10,4,0
308906,4,17,23,-6,1,1
94472,2,0,0,0,9,0
273885,1,0,3,-3,2,1
250018,2,10,6,4,9,1
103397,3,10,20,-10,13,1
347434,1,3,13,-10,1,0
22220,4,10,15,-5,11,1
314954,4,0,13,-13,4,1
346312,1,0,3,-3,1,1
38358,2,7,6,1,1,1
241001,4,27,22,5,5,0
174577,4,13,14,-1,10,0
166801,4,30,16,14,6,0
148159,2,3,14,-11,16,0
161544,1,0,3,-3,4,1
13425,2,3,14,-11,7,0
266654,3,19,3,16,16,0
96823,1,0,0,0,10,1
134721,1,3,0,3,10,1
14771,3,31,3,28,7,0
402023,4,3,19,-16,9,1
249774,4,35,28,7,9,1
369875,3,7,9,-2,12,0
135142,4,31,6,25,10,0
56664,1,0,0,0,9,1
119583,2,10,0,10,3,0
205557,4,14,24,-10,6,1
118057,1,0,6,-6,2,1
413305,4,20,0,20,14,0
239449,3,9,17,-8,4,1
200134,2,7,24,-17,4,1
85995,3,14,16,-2,5,0
190832,3,16,3,13,17,0
289908,2,6,3,3,10,1
211662,2,16,3,13,9,1
288914,4,19,31,-12,9,1
184890,1,0,0,0,15,0
51676,4,40,20,20,7,1
153202,4,20,20,0,1,0
406012,1,0,3,-3,11,0
218145,2,7,3,4,12,0
77124,4,14,17,-3,1,0
122053,1,0,0,0,4,1
91643,3,14,14,0,8,1
421488,2,0,3,-3,17,1
173768,3,10,3,7,10,0
352642,1,0,0,0,3,0
5368,2,13,7,6,3,1
343438,1,7,0,7,16,0
191509,2,14,14,0,17,1
229190,4,19,7,12,17,0
187231,2,0,6,-6,16,0
310451,2,14,3,11,2,1
162681,3,16,24,-8,5,1
125857,1,3,3,0,6,1
182264,1,7,0,7,14,0
408116,1,0,0,0,12,1
295253,2,14,5,9,12,1
87638,1,0,0,0,6,1
416985,4,10,17,-7,15,1
183787,2,10,14,-4,14,0
358388,2,9,13,-4,6,1
89956,2,2,7,-5,7,1
226109,2,7,14,-7,16,0
349172,3,27,7,20,2,0
230925,4,31,10,21,1,0
151155,2,3,10,-7,17,0
272657,1,9,0,9,2,0
110811,4,6,10,-4,16,1
231914,3,7,41,-34,1,1
313201,4,23,16,7,3,0
194079,4,35,14,21,1,0
290345,2,6,3,3,10,1
106934,3,12,3,9,14,1
3770,3,20,10,10,2,0
32678,2,7,0,7,15,0
394165,2,16,10,6,5,0
1727,4,28,0,28,1,1
230982,1,0,0,0,1,1
375075,4,28,30,-2,14,0
211080,3,37,0,37,9,0
208881,2,7,0,7,8,0
386597,1,0,7,-7,2,0
256421,3,9,21,-12,12,0
214605,3,3,9,-6,11,0
384978,2,14,6,8,1,1
242690,1,0,0,0,6,1
93908,3,24,6,18,9,0
261552,3,12,7,5,14,0
231101,1,0,0,0,1,1
105651,2,7,3,4,14,0
354255,4,20,17,3,4,1
371323,3,28,10,18,12,1
399066,3,10,19,-9,7,1
18670,1,0,0,0,9,1
81328,1,0,0,0,3,1
39926,4,9,10,-1,1,0
198875,1,0,12,-12,3,0
250008,2,10,6,4,9,1
419654,4,30,22,8,17,0
36991,4,0,32,-32,17,0
351403,3,13,13,0,3,1
119784,3,10,6,4,3,1
333875,4,28,28,0,12,1
349773,4,23,21,2,2,1
165201,2,6,7,-1,6,1
250641,2,3,9,-6,10,0
211749,4,29,22,7,9,0
297167,1,0,0,0,13,1
416244,4,10,39,-29,15,0
200596,2,21,14,7,4,1
222925,2,13,6,7,14,0
156605,2,0,0,0,2,1
87345,1,0,0,0,6,0
82269,1,0,0,0,3,1
360398,1,0,0,0,7,1
347966,4,0,21,-21,1,0
236153,2,7,10,-3,3,0
76979,4,17,13,4,1,0
28764,1,0,0,0,14,0
146810,2,10,0,10,15,1
288415,3,13,0,13,9,1
92074,1,3,7,-4,8,1
351057,2,14,16,-2,3,1
174027,2,0,13,-13,10,1
236340,3,7,23,-16,3,1
9053,3,21,13,8,4,1
121914,1,0,0,0,4,0
110389,1,0,0,0,16,0
36396,4,13,26,-13,17,1
139343,1,0,0,0,12,0
281456,2,0,10,-10,6,1
407153,4,17,27,-10,11,0
130503,3,10,3,7,8,0
409594,4,42,20,22,12,1
119462,3,7,17,-10,3,1
369055,4,20,13,7,11,0
339502,4,10,26,-16,15,0
186450,2,10,10,0,15,0
31771,2,0,17,-17,15,1
226923,4,3,10,-7,16,0
398459,2,7,3,4,7,0
410287,3,7,16,-9,13,1
305983,2,3,3,0,17,0
301410,1,0,0,0,15,1
162840,3,3,3,0,5,1
31102,1,0,0,0,15,0
321151,2,3,16,-13,6,1
62371,1,0,7,-7,12,1
243622,4,20,14,6,6,1
350637,4,13,3,10,2,0
229402,2,3,0,3,17,0
160707,4,10,3,7,4,0
39696,2,3,0,3,1,1
330526,2,7,7,0,11,0
382307,4,20,3,17,17,0
160919,1,0,0,0,4,1
377620,1,0,0,0,15,1
135828,3,7,14,-7,10,1
15473,2,9,0,9,8,1
282173,1,3,0,3,6,1
124282,3,27,17,10,5,0
174772,1,6,7,-1,10,1
160109,1,0,0,0,3,1
185402,3,7,10,-3,15,0
279495,2,10,6,4,5,0
203183,2,7,17,-10,5,0
95632,1,0,0,0,10,1
106093,1,0,0,0,14,1
245803,1,0,0,0,7,1
181794,1,0,0,0,13,1
186671,4,27,3,24,15,0
49809,2,14,7,7,6,0
26291,3,13,21,-8,13,0
411040,3,17,14,3,13,0
344425,4,28,24,4,17,1
26281,3,10,20,-10,13,0
275744,2,16,0,16,3,0
309405,2,0,0,0,1,1
348561,3,28,17,11,2,0
143021,1,0,0,0,13,1
315308,1,3,0,3,4,1
287043,3,19,24,-5,8,1
212318,2,10,3,7,10,1
26553,2,10,3,7,13,0
175697,3,23,6,17,11,0
386832,3,13,21,-8,2,1
42986,4,38,30,8,3,1
412499,3,24,7,17,14,0
157367,1,3,0,3,2,0
49685,3,14,21,-7,6,0
418924,4,27,17,10,16,0
343390,4,6,33,-27,16,0
368645,1,0,3,-3,11,0
4742,2,10,0,10,3,0
346434,4,15,19,-4,1,0
344024,4,23,9,14,17,0
413973,2,3,14,-11,14,1
214652,4,10,16,-6,11,0
339566,2,10,7,3,15,1
357755,4,43,19,24,5,1
364166,4,31,3,28,9,1
103924,2,3,0,3,13,0
119864,5,24,24,0,3,0
417619,2,14,3,11,16,1
352952,2,13,0,13,3,0
73884,1,7,0,7,17,0
322424,1,0,0,0,7,0
378465,3,20,0,20,15,0
72721,1,0,0,0,16,1
16447,1,3,0,3,8,1
353960,5,31,31,0,4,1
393762,4,7,14,-7,5,1
413025,4,19,18,1,14,0
221870,2,6,6,0,14,0
7451,3,20,6,14,4,0
294756,1,0,7,-7,12,1
183957,2,14,3,11,14,0
102486,3,24,3,21,13,0
30340,4,10,10,0,14,0
283484,4,23,14,9,7,0
13805,4,7,30,-23,7,1
81953,1,0,0,0,3,0
186114,1,0,0,0,15,1
342854,2,16,0,16,16,0
317443,1,3,0,3,5,0
129547,2,3,17,-14,7,0
13995,2,3,0,3,7,0
416686,4,37,13,24,15,0
30899,3,3,23,-20,15,0
39264,2,3,10,-7,1,0
275731,2,7,0,7,3,1
142999,4,10,20,-10,13,1
19057,4,10,6,4,10,0
209810,1,7,7,0,8,0
377988,2,0,7,-7,15,0
67992,1,0,0,0,14,1
133037,3,9,14,-5,9,1
310826,4,27,13,14,2,0
295798,5,27,24,3,12,0
359977,1,0,12,-12,7,0
363507,2,3,2,1,8,1
155820,2,7,10,-3,2,1
35766,2,3,3,0,17,1
22502,4,31,29,2,11,0
220172,4,29,13,16,13,0
227756,3,3,14,-11,16,1
298264,3,20,13,7,14,0
105709,3,28,3,25,14,1
279828,2,7,13,-6,5,1
336719,2,9,3,6,14,1
240469,2,3,7,-4,5,1
20457,1,0,0,0,10,1
54717,1,0,0,0,8,1
81102,2,9,14,-5,3,1
39876,3,6,7,-1,1,0
312778,1,0,0,0,3,0
78196,4,41,3,38,2,1
142332,3,0,3,-3,13,1
389250,4,31,7,24,3,0
218487,4,31,17,14,13,0
108477,1,7,0,7,15,0
398788,3,14,24,-10,7,1
128027,1,0,3,-3,7,0
231682,4,24,19,5,1,1
60028,1,0,0,0,11,1
112428,3,13,13,0,17,0
33812,2,0,24,-24,16,1
55597,4,27,7,20,9,0
274090,3,13,0,13,3,1
308877,4,10,13,-3,1,1
113812,4,16,24,-8,17,0
116939,4,21,13,8,2,1
308032,1,0,0,0,1,1
189617,2,10,3,7,17,0
9018,2,7,7,0,4,0
325598,2,10,7,3,9,0
141480,1,7,0,7,13,0
367976,2,9,14,-5,11,1
374119,2,13,7,6,13,0
51594,2,7,10,-3,7,1
119448,3,7,17,-10,3,0
193911,4,31,10,21,1,0
319486,3,3,10,-7,6,1
235865,2,0,14,-14,3,1
282415,4,10,23,-13,6,0
159602,3,20,12,8,3,0
253875,2,31,14,17,11,1
335419,2,7,6,1,13,0
6152,4,7,17,-10,3,0
218078,4,28,24,4,12,0
256723,2,0,6,-6,12,1
128144,1,0,0,0,7,1
320984,2,7,0,7,6,0
54280,4,0,6,-6,8,0
79154,2,3,0,3,2,0
174535,3,7,14,-7,10,1
326606,2,10,3,7,9,0
144687,2,0,0,0,14,0
158714,4,31,7,24,3,1
22672,4,30,24,6,11,1
248727,2,10,7,3,9,0
40894,2,13,17,-4,2,0
303856,1,0,0,0,16,0
174787,2,13,7,6,10,0
131336,1,7,0,7,8,0
19631,4,17,28,-11,10,1
46541,4,40,9,31,4,1
355213,1,0,14,-14,4,0
351065,3,21,16,5,3,0
317202,3,7,13,-6,5,1
309498,1,0,0,0,1,0
320854,2,3,11,-8,6,0
132021,4,3,24,-21,8,0
68090,3,3,10,-7,14,1
38888,4,10,15,-5,1,1
191553,3,14,24,-10,17,1
98216,1,0,0,0,11,1
176377,4,16,28,-12,11,1
66737,2,0,3,-3,14,1
16042,1,13,0,13,8,1
205820,2,14,0,14,7,1
384084,1,0,7,-7,1,0
138777,2,0,7,-7,12,1
318344,4,9,22,-13,5,0
46939,4,20,30,-10,5,0
244506,2,25,9,16,7,0
237764,5,20,23,-3,4,0
95051,1,0,0,0,9,0
105047,2,0,14,-14,14,1
72741,1,7,0,7,16,1
166210,4,35,19,16,6,1
40988,1,3,7,-4,2,0
317123,1,0,0,0,5,0
205647,2,14,9,5,7,0
333407,4,23,10,13,12,0
283995,2,3,0,3,7,0
190186,1,0,0,0,17,0
235710,3,3,17,-14,3,1
363495,1,0,2,-2,8,1
225046,2,0,14,-14,15,1
205311,2,10,0,10,6,1
333348,2,17,7,10,12,0
45807,4,13,14,-1,4,1
410338,4,7,26,-19,13,0
414387,2,7,17,-10,14,0
282494,2,7,3,4,6,1
135162,1,0,0,0,10,1
291599,3,23,3,20,11,0
289587,2,7,13,-6,10,1
138020,2,19,17,2,11,1
252544,4,29,32,-3,10,1
104063,1,7,7,0,13,1
332234,4,10,16,-6,12,1
244048,2,20,17,3,6,0
404115,1,6,0,6,10,1
172764,4,21,18,3,9,0
119111,2,7,7,0,3,1
333622,1,0,0,0,12,0
182749,1,3,0,3,14,0
331046,4,45,16,29,11,0
172165,1,0,0,0,9,1
224023,3,14,6,8,15,1
331053,4,45,17,28,11,1
239396,2,6,7,-1,4,0
234499,3,20,20,0,2,0
280427,3,15,17,-2,5,1
270038,1,0,3,-3,1,1
348814,2,3,7,-4,2,0
310938,3,3,16,-13,2,1
395895,1,0,0,0,6,1
85982,3,14,16,-2,5,0
252730,1,0,3,-3,11,1
144762,4,3,17,-14,14,1
195904,1,0,13,-13,2,0
234056,3,20,0,20,2,1
62367,1,0,0,0,12,0
109644,4,37,14,23,16,0
329368,3,15,27,-12,10,1
87754,4,6,20,-14,6,0
342516,1,0,6,-6,16,1
397938,4,10,17,-7,7,1
107936,3,6,3,3,15,0
66520,4,28,24,4,14,1
366420,3,26,10,16,10,1
70882,2,7,17,-10,15,1
92866,3,24,0,24,8,0
3960,4,22,14,8,2,1
50530,1,0,3,-3,6,1
195456,4,24,10,14,2,0
90644,4,20,33,-13,7,0
148963,3,13,12,1,16,1
266437,1,0,0,0,16,0
388513,4,3,23,-20,2,0
99175,2,3,3,0,11,1
103854,4,19,0,19,13,0
131716,3,24,22,2,8,0
254272,2,6,9,-3,11,0
162947,2,6,0,6,5,0
127556,1,0,0,0,6,0
98744,3,28,6,22,11,0
342532,1,3,6,-3,16,0
63107,1,7,3,4,12,0
414909,4,42,13,29,15,0
310025,3,9,10,-1,2,0
145386,4,52,26,26,14,1
342804,4,7,14,-7,16,0
57992,4,20,20,0,10,0
298987,3,9,12,-3,14,1
6670,3,3,13,-10,3,0
22229,4,18,15,3,11,0
39166,4,27,10,17,1,0
256689,1,0,0,0,12,0
119147,3,10,7,3,3,0
416106,4,21,13,8,15,1
52955,2,14,14,0,7,0
386212,3,9,10,-1,2,0
77322,1,7,7,0,1,1
304928,2,7,3,4,16,0
271079,1,0,0,0,1,1
252630,2,6,3,3,10,1
37691,4,30,0,30,17,1
258495,4,30,21,9,13,0
42934,3,24,23,1,3,1
391601,4,10,24,-14,4,0
80347,2,13,6,7,2,1
415816,1,0,6,-6,15,1
357499,2,0,6,-6,5,1
413936,1,3,0,3,14,0
190141,4,30,3,27,17,0
196489,1,6,3,3,2,1
363661,2,0,10,-10,8,1
142618,2,13,3,10,13,0
224139,2,0,20,-20,15,1
74166,1,3,0,3,17,1
19427,2,17,14,3,10,1
57763,2,16,3,13,10,0
339749,3,21,6,15,15,1
118183,4,31,27,4,2,0
118597,4,31,10,21,2,1
39479,4,13,12,1,1,0
44410,2,3,0,3,3,1
115025,4,20,19,1,1,0
217297,2,0,7,-7,12,0
46407,4,12,17,-5,4,0
398953,4,23,13,10,7,0
104215,1,0,0,0,13,1
362719,4,6,13,-7,8,0
20400,4,10,13,-3,10,0
325025,3,20,21,-1,8,0
571,4,14,27,-13,1,0
161167,4,3,33,-30,4,0
39837,2,3,0,3,1,1
257959,2,0,7,-7,13,1
229113,3,16,7,9,17,1
253929,4,44,14,30,11,1
146183,1,0,3,-3,15,1
24817,2,6,3,3,12,0
311266,4,6,3,3,2,1
88995,4,39,10,29,6,0
14905,3,14,10,4,7,1
174869,4,19,17,2,10,1
50118,2,0,17,-17,6,0
145969,4,10,21,-11,15,0
87000,3,14,6,8,5,0
358034,4,24,22,2,6,1
41018,2,3,10,-7,2,1
245104,2,14,6,8,7,1
101074,2,7,10,-3,12,0
413368,1,0,13,-13,14,1
263265,1,0,0,0,15,1
416091,4,21,13,8,15,0
78518,1,0,0,0,2,0
75917,3,29,7,22,1,1
164289,1,6,0,6,5,1
60470,1,7,0,7,11,0
245291,3,9,3,6,7,0
125888,2,13,10,3,6,0
29260,2,21,0,21,14,0
207537,1,7,0,7,7,0
337163,2,3,0,3,14,1
404352,3,20,6,14,10,0
311857,1,0,0,0,2,1
53158,4,19,38,-19,7,1
265195,2,6,3,3,16,1
304820,3,0,3,-3,16,1
132410,2,0,14,-14,9,0
313129,2,7,10,-3,3,1
61821,2,3,17,-14,12,0
295525,2,17,7,10,12,0
158204,2,17,0,17,3,0
239352,1,0,0,0,4,0
321679,1,0,0,0,7,0
368368,1,7,0,7,11,1
127437,2,3,0,3,6,1
369615,4,20,14,6,11,1
110701,1,0,3,-3,16,0
243555,2,3,7,-4,6,1
175433,3,17,23,-6,11,1
155803,1,7,3,4,2,1
100300,1,6,7,-1,12,0
6609,1,0,0,0,3,1
403280,1,6,0,6,9,1
51394,1,0,0,0,7,1
372494,4,23,14,9,13,0
145925,2,7,14,-7,15,1
100501,3,7,17,-10,12,1
82850,4,15,16,-1,3,1
291242,2,7,6,1,10,0
218076,4,27,24,3,12,1
372979,4,28,13,15,13,1
106124,2,0,0,0,14,1
389276,4,34,14,20,3,1
272396,2,24,0,24,2,0
300342,3,3,7,-4,14,0
81340,1,0,7,-7,3,1
389187,2,14,0,14,3,1
239097,2,7,10,-3,4,1
116717,2,6,17,-11,2,1
113253,2,7,7,0,17,1
331761,3,13,27,-14,12,0
414957,1,7,7,0,15,1
338723,4,27,17,10,14,1
151574,1,0,3,-3,17,1
176327,2,13,14,-1,11,1
363413,3,21,21,0,8,1
245656,1,3,0,3,7,0
163708,1,0,6,-6,5,0
85015,2,25,13,12,4,1
75339,4,21,33,-12,17,0
100876,1,0,0,0,12,1
158138,1,0,0,0,3,1
375132,2,7,10,-3,14,1
95322,4,17,24,-7,10,1
246751,2,3,3,0,8,1
94327,2,10,7,3,9,1
272839,2,20,0,20,2,0
237620,1,3,0,3,4,0
238975,3,14,12,2,4,0
414254,2,20,21,-1,14,1
335146,2,17,0,17,13,0
210661,4,20,24,-4,9,0
257269,4,19,26,-7,12,0
124835,2,0,6,-6,5,1
411068,4,17,17,0,13,0
400089,3,17,15,2,8,1
8534,4,15,10,5,4,1
140214,5,13,13,0,12,0
103203,2,3,0,3,13,0
301320,2,14,7,7,15,1
306424,2,0,10,-10,17,1
176581,5,19,20,-1,11,0
396633,4,23,10,13,6,0
94839,4,6,13,-7,9,1
63808,4,14,34,-20,12,1
196681,2,33,0,33,3,1
50720,2,7,14,-7,6,1
206084,2,20,3,17,7,1
108592,4,26,20,6,15,0
70393,1,7,0,7,15,1
213608,1,0,0,0,10,1
402475,4,24,15,9,9,0
384489,4,28,6,22,1,1
397367,4,10,24,-14,6,1
160041,3,10,26,-16,3,1
86721,3,17,14,3,5,1
5113,4,13,7,6,3,0
29108,2,0,6,-6,14,0
296233,4,22,26,-4,13,1
92494,4,25,17,8,8,1
20214,4,17,10,7,10,1
307106,4,24,6,18,17,0
10568,1,0,0,0,5,1
171597,2,3,3,0,9,1
178393,4,31,34,-3,12,1
316150,4,24,26,-2,4,0
6202,1,7,0,7,3,1
159872,2,17,0,17,3,0
123184,3,6,21,-15,4,0
255565,4,30,7,23,12,0
62524,5,16,16,0,12,0
217096,1,0,0,0,12,0
85454,2,7,3,4,5,1
280249,2,3,13,-10,5,0
22882,2,0,13,-13,11,0
162946,2,6,0,6,5,0
251042,1,0,0,0,10,0
98579,2,7,7,0,11,0
300032,3,0,26,-26,14,0
381875,4,25,28,-3,17,1
115236,2,0,3,-3,1,0
342118,2,12,6,6,16,0
279079,2,14,7,7,5,1
100003,1,0,0,0,12,1
33724,4,35,7,28,16,1
316975,4,44,18,26,4,0
295612,4,31,32,-1,12,1
335683,2,7,7,0,13,1
266674,3,29,3,26,16,1
420102,1,0,0,0,17,1
10820,3,21,7,14,5,1
186888,1,7,0,7,15,0
89867,3,23,13,10,7,1
393003,4,12,10,2,4,0
7904,3,3,17,-14,4,0
84436,2,6,7,-1,4,0
158163,2,7,0,7,3,0
232197,3,9,9,0,1,1
129788,4,17,24,-7,7,0
62557,1,3,7,-4,12,1
158022,2,0,6,-6,3,1
338640,2,6,0,6,14,0
350640,4,13,3,10,2,1
287718,5,16,16,0,9,0
1901,1,0,0,0,1,1
379504,4,26,10,16,16,1
407041,4,11,34,-23,11,1
27932,3,14,10,4,13,1
264478,4,26,35,-9,15,1
117876,4,12,20,-8,2,1
366067,4,51,21,30,10,1
177498,4,27,17,10,11,1
306611,3,7,20,-13,17,1
159635,4,27,20,7,3,0
261858,3,6,20,-14,14,1
137495,1,7,7,0,11,1
227524,4,26,17,9,16,1
212895,2,0,7,-7,10,1
229271,3,24,20,4,17,0
220359,1,3,0,3,13,1
324647,1,0,0,0,8,0
63216,4,17,23,-6,12,0
325260,1,3,3,0,8,0
277056,2,3,0,3,4,0
254479,3,23,10,13,11,0
97147,4,34,13,21,10,1
172777,4,21,18,3,9,1
363277,3,24,7,17,8,0
41759,2,7,7,0,2,0
331147,2,7,13,-6,11,0
139263,2,13,6,7,12,0
32843,3,6,7,-1,15,0
308196,1,7,7,0,1,0
112308,4,45,17,28,17,0
307554,4,38,31,7,17,0
108097,3,13,28,-15,15,0
244609,1,0,6,-6,7,0
220340,1,0,0,0,13,1
81967,1,0,0,0,3,0
143676,3,19,10,9,14,0
184339,1,0,6,-6,14,1
119929,2,6,14,-8,3,0
101513,2,10,7,3,12,1
85530,3,14,12,2,5,1
82273,1,3,0,3,3,0
273310,2,21,0,21,2,0
43357,3,14,14,0,3,1
11606,1,0,0,0,6,1
380577,4,21,27,-6,16,1
376765,1,6,0,6,15,1
144204,1,0,7,-7,14,1
60683,3,21,3,18,11,1
282848,4,9,20,-11,6,1
99563,1,0,0,0,11,0
202976,1,7,0,7,5,1
374752,4,6,39,-33,14,1
193166,1,0,0,0,1,1
45242,1,0,0,0,4,1
371979,1,3,0,3,13,1
184664,3,10,24,-14,15,1
184429,4,24,6,18,14,1
20812,2,14,3,11,10,1
75137,3,7,6,1,17,1
85759,2,7,7,0,5,0
363454,4,28,41,-13,8,0
163485,4,10,26,-16,5,1
174205,3,3,23,-20,10,0
276643,3,17,6,11,4,1
86158,3,31,10,21,5,0
338927,1,3,0,3,15,0
191209,2,0,17,-17,17,1
42607,1,0,6,-6,3,0
66166,1,17,0,17,13,0
210523,4,16,28,-12,9,0
329465,2,3,0,3,10,0
72995,1,0,0,0,16,0
247400,2,3,9,-6,8,1
117979,3,17,6,11,2,1
8483,3,15,3,12,4,0
46382,4,6,17,-11,4,0
332091,4,17,9,8,12,1
152223,3,21,0,21,17,0
28173,1,3,0,3,13,0
90028,4,5,21,-16,7,1
55388,2,10,7,3,9,1
29698,2,10,0,10,14,0
266510,3,10,15,-5,16,0
6011,4,17,36,-19,3,0
89859,3,16,13,3,7,1
54820,3,13,0,13,8,1
420397,4,20,20,0,17,1
304172,1,0,0,0,16,1
70303,2,10,10,0,15,0
354723,1,0,0,0,4,1
25422,3,6,3,3,12,0
158001,1,0,3,-3,3,0
160152,2,16,0,16,3,1
303125,3,7,14,-7,16,0
265946,3,0,30,-30,16,1
401977,2,3,9,-6,9,0
401315,4,20,24,-4,8,1
365591,3,35,17,18,9,0
308944,1,0,3,-3,1,1
259763,3,17,10,7,14,1
85040,3,25,16,9,4,0
263000,2,7,0,7,15,0
209896,3,23,16,7,8,1
216181,2,14,3,11,12,0
372468,3,16,14,2,13,1
329423,4,16,41,-25,10,0
344704,3,6,20,-14,17,0
5681,3,0,17,-17,3,1
139778,1,0,0,0,12,0
164378,3,23,3,20,5,0
199269,3,17,31,-14,4,0
157563,2,2,0,2,2,1
84136,2,7,0,7,4,1
246199,3,14,6,8,7,1
317714,4,23,16,7,5,0
420669,3,21,16,5,17,0
124796,1,0,0,0,5,0
189958,3,13,7,6,17,0
374590,3,20,13,7,14,0
360721,2,10,7,3,7,1
34002,4,10,27,-17,16,0
173981,4,23,19,4,10,1
1949,2,9,2,7,1,1
309334,4,3,23,-20,1,0
168492,4,10,24,-14,7,0
336762,3,10,10,0,14,0
409273,3,13,13,0,12,0
53228,2,3,0,3,8,0
77956,2,3,10,-7,1,1
291679,1,0,3,-3,11,1
116300,3,17,10,7,1,0
409242,3,13,6,7,12,0
18402,1,0,0,0,9,0
189635,3,10,6,4,17,0
2033,1,0,0,0,1,1
175747,4,40,13,27,11,0
211507,3,26,7,19,9,0
148768,2,13,6,7,16,0
338354,2,3,0,3,14,1
86642,1,0,0,0,5,0
395658,3,7,17,-10,6,0
127756,2,7,14,-7,6,0
371221,4,14,19,-5,12,1
225831,4,24,14,10,16,0
55715,4,23,21,2,9,0
236523,3,10,9,1,3,1
103530,3,20,0,20,13,1
311932,3,21,10,11,2,1
285626,4,20,24,-4,8,1
20656,2,7,14,-7,10,0
376674,2,3,0,3,14,1
260747,1,3,3,0,14,0
268141,2,6,7,-1,17,0
215093,4,19,7,12,11,1
335049,4,16,13,3,13,0
189295,2,3,0,3,16,0
145817,4,13,26,-13,15,0
271483,4,14,0,14,1,1
269810,3,13,7,6,1,0
328430,2,3,0,3,10,1
241432,3,7,35,-28,5,1
333381,3,17,10,7,12,1
84185,4,10,10,0,4,1
239654,1,0,0,0,4,0
232868,4,23,30,-7,2,1
393426,3,28,24,4,5,0
273837,4,17,14,3,2,0
420284,2,7,0,7,17,1
8513,3,15,10,5,4,0
173210,4,20,24,-4,9,1
275315,3,10,8,2,3,0
104369,4,45,38,7,13,0
273129,2,7,0,7,2,0
238088,4,13,13,0,4,0
232011,2,0,7,-7,1,0
225381,3,24,28,-4,15,1
43659,2,14,9,5,3,0
384155,3,14,20,-6,1,1
156816,3,23,20,3,2,0
333969,2,17,10,7,12,1
243193,5,23,22,1,6,0
213385,3,10,20,-10,10,0
10809,3,21,0,21,5,0
369027,4,13,7,6,11,0
283036,4,28,3,25,6,0
217683,1,7,0,7,12,0
72527,3,16,17,-1,16,0
103398,3,10,20,-10,13,0
85149,2,0,3,-3,4,1
330511,2,7,7,0,11,0
267210,1,3,0,3,17,0
13589,2,3,7,-4,7,0
368220,1,0,0,0,11,0
259616,3,6,3,3,13,1
75004,4,27,17,10,17,1
35322,2,13,0,13,16,1
128378,3,7,13,-6,7,0
196312,4,24,17,7,2,0
103132,4,34,7,27,13,0
198293,2,6,7,-1,3,0
281524,4,17,13,4,6,1
31759,2,0,17,-17,15,1
250440,1,7,0,7,9,0
158206,3,17,0,17,3,1
110889,2,7,3,4,16,0
260957,3,10,0,10,14,0
408500,3,10,10,0,12,1
188016,4,23,14,9,16,0
175442,4,17,23,-6,11,1
114551,4,17,40,-23,1,0
328385,4,10,47,-37,10,0
350832,1,0,0,0,3,1
187370,2,20,7,13,16,1
228726,4,26,30,-4,17,0
315964,2,0,21,-21,4,1
410679,1,0,3,-3,13,1
270604,4,20,14,6,1,1
154026,3,10,21,-11,1,1
9377,4,31,14,17,5,0
149084,2,14,13,1,16,0
413545,2,3,10,-7,14,0
331344,4,0,30,-30,11,1
296443,2,14,0,14,13,1
60774,1,7,0,7,11,0
309237,2,0,7,-7,1,1
140097,2,0,0,0,12,1
203738,1,0,7,-7,6,1
369628,4,23,14,9,11,0
306095,4,20,13,7,17,1
108627,1,6,0,6,15,0
181493,4,31,31,0,13,0
95188,4,23,30,-7,9,1
94369,3,17,14,3,9,1
373160,1,0,0,0,13,0
128397,4,14,13,1,7,0
298065,2,0,14,-14,13,1
330096,3,0,13,-13,11,1
352193,1,0,0,0,3,1
116343,4,40,13,27,1,0
315621,1,0,0,0,4,0
266438,1,0,0,0,16,0
326113,4,30,3,27,9,0
164673,4,21,27,-6,5,0
210397,1,6,0,6,9,1
89556,3,0,20,-20,7,0
46100,4,21,21,0,4,1
224254,1,6,3,3,15,0
413062,1,13,7,6,14,0
383518,2,14,10,4,17,0
207462,3,14,14,0,7,1
226663,4,17,13,4,16,1
292790,3,29,17,12,11,1
87606,4,17,10,7,6,0
385866,1,0,0,0,1,0
54285,1,0,0,0,8,1
100856,4,19,19,0,12,0
187528,2,6,10,-4,16,0
288558,3,20,31,-11,9,0
248701,1,3,0,3,9,1
176712,3,29,19,10,11,1
307695,4,17,23,-6,17,0
105662,2,7,3,4,14,1
329797,3,17,20,-3,11,0
392140,2,0,13,-13,4,1
159308,4,27,24,3,3,0
340530,3,0,40,-40,15,1
142519,4,30,13,17,13,0
345127,3,15,3,12,17,0
61564,3,28,7,21,11,1
30334,4,10,10,0,14,0
409597,4,42,20,22,12,1
329859,4,24,26,-2,11,1
53941,4,14,19,-5,8,0
86151,3,31,10,21,5,1
49008,2,10,7,3,6,0
174236,4,10,26,-16,10,0
385757,2,16,0,16,1,1
87020,4,14,22,-8,5,1
260990,4,10,3,7,14,0
135309,1,0,0,0,10,0
160966,3,10,7,3,4,0
108355,2,0,14,-14,15,0
33846,4,3,34,-31,16,1
350761,3,10,3,7,2,1
199819,2,3,10,-7,4,1
199168,1,0,0,0,4,1
279741,4,30,6,24,5,0
154152,3,7,6,1,1,1
200442,2,13,18,-5,4,1
242718,1,7,7,0,6,0
356893,4,25,16,9,5,0
117265,4,33,24,9,2,0
349758,4,20,14,6,2,1
103010,1,0,0,0,13,0
158116,4,25,9,16,3,1
240810,3,23,10,13,5,1
93788,4,3,19,-16,9,1
330082,2,0,3,-3,11,0
26403,2,10,3,7,13,1
210748,2,21,10,11,9,0
164644,3,14,17,-3,5,1
197269,2,0,0,0,3,1
153014,4,42,24,18,1,0
337063,3,19,0,19,14,0
264417,3,3,21,-18,15,0
298182,1,0,3,-3,14,0
235183,4,7,20,-13,2,1
149670,2,17,0,17,16,1
129668,1,0,3,-3,7,1
375787,2,13,0,13,14,1
29599,3,14,13,1,14,1
52552,3,16,7,9,7,1
224131,2,0,17,-17,15,1
93598,3,6,6,0,9,0
390887,4,15,28,-13,3,1
247477,4,20,12,8,8,0
2095,2,7,13,-6,1,1
153374,1,0,10,-10,1,1
259454,2,14,10,4,13,1
103017,1,0,0,0,13,1
136283,2,15,7,8,11,1
305231,2,14,14,0,16,0
62415,2,0,10,-10,12,1
26630,4,10,12,-2,13,0
415359,4,14,24,-10,15,0
77121,3,14,17,-3,1,0
76114,4,13,30,-17,1,1
311392,4,42,13,29,2,0
91067,4,9,0,9,7,0
39171,4,27,10,17,1,0
201755,1,3,0,3,5,1
386774,2,7,0,7,2,0
318661,4,10,16,-6,5,1
104799,3,27,33,-6,14,1
171342,3,16,3,13,9,0
178357,3,21,17,4,12,0
158170,2,7,0,7,3,0
283353,4,10,16,-6,7,1
240882,1,7,0,7,5,0
66257,4,45,3,42,13,1
188914,3,17,10,7,16,0
305708,2,3,7,-4,17,0
391315,3,17,3,14,4,1
178826,3,24,14,10,12,1
401819,2,7,14,-7,9,1
270966,2,0,7,-7,1,0
40282,2,6,0,6,2,1
247590,3,16,16,0,8,0
37210,2,3,14,-11,17,1
214479,4,7,17,-10,11,0
225074,3,10,14,-4,15,1
264525,2,7,7,0,16,0
241771,4,7,15,-8,5,1
197195,4,27,27,0,3,1
283433,3,20,7,13,7,0
174803,2,13,17,-4,10,1
323206,2,7,0,7,7,0
230211,4,3,32,-29,17,1
74606,1,0,0,0,17,1
318399,2,21,0,21,5,0
64628,4,20,17,3,13,1
257054,3,7,14,-7,12,1
281240,4,27,19,8,6,0
329387,4,16,34,-18,10,0
42904,2,7,6,1,3,0
40944,4,16,20,-4,2,0
345053,1,0,0,0,17,0
381673,3,17,7,10,17,0
370327,4,14,35,-21,12,1
392826,3,17,13,4,4,1
3637,4,20,28,-8,2,1
85710,4,24,21,3,5,0
199358,2,0,3,-3,4,0
413855,3,14,6,8,14,1
45916,3,16,3,13,4,1
87188,4,21,13,8,5,1
271642,4,23,30,-7,2,0
123312,2,14,7,7,4,1
362880,1,0,0,0,8,0
27073,4,17,6,11,13,0
344891,1,0,7,-7,17,1
352139,3,9,20,-11,3,1
12713,3,45,0,45,6,1
168129,2,9,2,7,7,0
188130,3,10,10,0,16,1
317364,2,0,0,0,5,0
387821,2,10,7,3,2,1
281583,1,7,0,7,6,0
419343,3,0,17,-17,16,1
188820,1,0,0,0,16,0
300441,2,9,0,9,14,0
46358,3,6,17,-11,4,1
131469,1,0,0,0,8,0
195187,2,10,0,10,2,0
70234,4,33,30,3,15,0
195699,3,14,10,4,2,0
27530,4,23,12,11,13,1
311370,3,21,13,8,2,1
286987,1,10,7,3,8,0
111118,3,24,10,14,16,1
125654,4,21,24,-3,5,1
363131,3,7,3,4,8,1
386913,2,7,14,-7,2,1
199746,4,38,10,28,4,1
151301,2,7,14,-7,17,0
148713,1,10,0,10,16,0
24392,3,13,0,13,12,0
317702,4,23,16,7,5,1
265932,3,0,16,-16,16,0
404787,3,17,13,4,10,0
338706,3,27,10,17,14,1
363096,2,7,3,4,8,1
385374,1,0,7,-7,1,1
82774,2,6,6,0,3,1
10751,2,7,0,7,5,0
129044,1,0,7,-7,7,1
394361,4,30,17,13,5,1
318254,2,3,7,-4,5,1
393937,5,23,26,-3,5,0
399052,2,10,12,-2,7,0
284363,4,14,17,-3,7,1
184423,4,24,6,18,14,1
20374,3,10,13,-3,10,0
421269,3,16,10,6,17,1
107419,1,0,0,0,15,0
376328,1,3,0,3,14,1
186813,3,29,7,22,15,1
11490,2,6,7,-1,6,1
351240,3,28,17,11,3,1
330637,2,0,0,0,11,1
289703,1,0,0,0,10,0
381791,2,0,0,0,17,0
264151,4,27,27,0,15,1
161786,3,24,6,18,4,1
336893,3,7,14,-7,14,1
325117,1,10,7,3,8,0
41021,2,3,10,-7,2,0
399408,4,37,10,27,7,1
268582,2,7,3,4,17,0
308955,2,0,3,-3,1,1
196849,3,3,13,-10,3,0
401299,3,13,21,-8,8,1
43217,3,14,10,4,3,1
145310,2,14,12,2,14,1
109075,1,0,0,0,15,1
246723,1,0,0,0,8,1
382679,2,0,6,-6,17,1
142446,2,7,10,-3,13,1
6987,3,10,7,3,3,0
381188,1,7,3,4,16,1
231305,2,3,3,0,1,0
163329,4,16,23,-7,5,0
38864,4,3,13,-10,1,1
235322,4,25,12,13,3,0
145518,4,26,17,9,14,0
111928,2,0,21,-21,17,1
206810,1,0,0,0,7,0
391101,1,7,14,-7,4,1
157985,1,0,0,0,3,0
332186,3,3,13,-10,12,1
204325,4,0,17,-17,6,0
121026,3,11,21,-10,3,0
98161,3,21,13,8,11,0
260847,4,29,15,14,14,1
24599,4,10,26,-16,12,1
301267,1,0,0,0,15,0
166121,2,14,3,11,6,0
384261,2,6,0,6,1,1
118140,3,23,20,3,2,0
284867,1,0,0,0,7,1
304847,4,6,3,3,16,1
262756,3,28,3,25,15,0
358053,4,31,29,2,6,1
299834,1,3,0,3,14,1
353624,1,0,0,0,4,1
340126,1,6,0,6,15,0
159257,3,17,24,-7,3,0
209757,4,16,6,10,8,1
214158,3,12,9,3,11,0
147911,4,24,31,-7,15,0
266843,4,17,17,0,16,1
322703,5,9,9,0,7,0
363920,1,0,0,0,8,0
257954,2,0,7,-7,13,1
379473,3,23,0,23,16,0
136293,3,18,7,11,11,1
314423,1,0,0,0,3,1
12033,4,27,14,13,6,0
288218,2,3,14,-11,9,1
52923,1,7,0,7,7,0
313207,4,23,16,7,3,0
247745,3,10,6,4,8,0
125293,2,10,3,7,5,0
13594,2,3,7,-4,7,1
197034,4,23,33,-10,3,1
378114,1,14,0,14,15,1
316964,4,37,18,19,4,1
130444,1,3,0,3,8,0
414110,2,3,10,-7,14,1
331938,4,6,28,-22,12,0
8039,2,10,7,3,4,0
307653,3,14,17,-3,17,1
20456,1,0,0,0,10,1
373664,2,0,12,-12,13,0
39743,3,9,0,9,1,0
401169,4,44,13,31,8,0
53569,3,14,12,2,8,0
126154,1,0,3,-3,6,1
359718,2,16,6,10,6,1
15680,4,37,10,27,8,0
88780,3,13,10,3,6,1
358430,3,29,13,16,6,0
329085,3,10,7,3,10,1
76931,2,14,13,1,1,0
384849,2,6,12,-6,1,0
241665,1,0,0,0,5,0
334150,3,16,7,9,13,1
23815,3,17,7,10,12,0
152852,1,0,0,0,1,1
18699,1,0,7,-7,9,0
417390,4,13,17,-4,16,1
194686,4,41,10,31,2,0
319211,4,17,17,0,5,0
404476,2,14,13,1,10,0
7567,2,7,0,7,4,1
122517,1,7,0,7,4,0
89368,2,3,13,-10,7,1
333816,3,14,14,0,12,0
69076,1,0,0,0,15,1
198350,4,20,14,6,3,0
237389,3,12,14,-2,3,0
45628,3,13,13,0,4,1
247436,3,13,9,4,8,0
275017,2,30,3,27,3,1
113935,3,17,10,7,17,0
391042,4,27,34,-7,4,0
185477,4,24,20,4,15,0
282577,4,23,24,-1,6,0
83659,1,9,3,6,4,0
183821,3,20,21,-1,14,1
111998,3,20,21,-1,17,1
36760,2,6,7,-1,17,1
82916,2,3,3,0,4,1
370165,3,17,3,14,12,0
36851,4,24,35,-11,17,1
122124,2,17,14,3,4,0
151820,4,28,16,12,17,0
214089,1,3,3,0,11,0
114368,3,30,13,17,1,1
194335,3,17,6,11,2,1
261697,2,14,0,14,14,0
159573,3,17,6,11,3,1
118198,4,31,27,4,2,1
189088,4,24,30,-6,16,1
328850,1,0,0,0,10,0
227631,3,35,0,35,16,0
112292,3,37,17,20,17,1
245085,1,7,3,4,7,0
136438,2,10,7,3,11,0
287394,4,20,3,17,8,0
217673,1,0,0,0,12,0
209744,3,9,6,3,8,1
303852,1,0,0,0,16,0
108586,4,26,14,12,15,0
366060,4,51,14,37,10,0
256279,3,6,17,-11,12,1
128166,1,7,0,7,7,0
356864,4,16,16,0,5,0
273953,3,7,9,-2,2,1
84530,1,0,0,0,4,1
380909,2,0,0,0,16,1
221847,2,6,0,6,14,1
204822,1,0,0,0,6,0
368932,1,0,6,-6,11,0
48354,1,0,7,-7,5,1
11185,1,0,0,0,6,0
205597,1,7,0,7,7,0
170273,2,0,12,-12,8,1
169203,2,10,6,4,7,1
266607,1,0,0,0,16,1
125366,4,38,3,35,5,1
150896,2,7,7,0,17,0
231551,1,0,0,0,1,1
365382,1,7,0,7,9,0
69626,4,14,17,-3,15,0
3854,1,13,0,13,2,0
395280,4,10,19,-9,5,1
208587,2,3,0,3,8,1
42811,3,6,28,-22,3,1
266752,2,0,7,-7,16,0
7591,2,14,3,11,4,1
322135,1,0,0,0,7,0
301984,4,27,20,7,15,0
32458,1,0,0,0,15,1
180860,5,20,20,0,13,1
411649,4,26,28,-2,13,1
58576,3,10,10,0,10,0
154953,4,29,24,5,1,1
70085,1,0,0,0,15,1
114726,4,15,10,5,1,0
81730,3,17,17,0,3,1
353529,2,10,0,10,4,1
417489,2,17,21,-4,16,0
178429,1,0,0,0,12,1
26794,4,13,40,-27,13,0
277372,2,17,9,8,4,0
160889,1,0,0,0,4,1
61163,4,0,14,-14,11,0
110902,2,7,3,4,16,0
19593,3,14,21,-7,10,1
173437,2,0,7,-7,10,1
382600,4,0,24,-24,17,0
91410,1,0,0,0,8,1
127029,4,24,20,4,6,1
21833,2,0,0,0,11,1
39263,2,3,10,-7,1,0
29332,4,21,10,11,14,1
336377,1,0,3,-3,14,1
374907,4,14,18,-4,14,0
346315,1,0,3,-3,1,0
167442,1,0,0,0,7,1
117102,4,7,24,-17,2,0
174533,3,7,14,-7,10,1
280990,2,13,10,3,6,1
295829,1,0,7,-7,12,1
214259,2,14,10,4,11,0
393960,1,3,0,3,5,0
50306,3,13,16,-3,6,0
164999,1,7,3,4,6,0
178125,1,0,0,0,12,0
55757,1,0,0,0,9,0
240171,3,16,3,13,5,1
67483,3,36,7,29,14,0
330605,4,24,7,17,11,0
145240,1,0,0,0,14,0
380944,3,9,7,2,16,1
187622,1,0,0,0,16,1
20425,1,0,0,0,10,1
268561,1,7,3,4,17,1
296436,2,14,0,14,13,1
63358,4,17,3,14,12,1
251585,4,16,20,-4,10,1
397586,2,6,20,-14,7,1
15866,1,0,0,0,8,1
65931,3,17,14,3,13,0
17608,4,20,17,3,9,0
307494,3,35,13,22,17,1
140402,1,0,0,0,12,0
78528,1,0,7,-7,2,1
210998,1,7,0,7,9,0
23702,4,12,27,-15,12,0
181148,4,24,14,10,13,1
152077,3,6,7,-1,17,0
154709,2,0,0,0,1,0
404100,4,13,49,-36,10,0
335454,3,13,9,4,13,0
216206,3,14,3,11,12,1
128935,2,22,3,19,7,1
168365,4,24,24,0,7,1
319185,3,2,10,-8,5,1
38058,2,3,0,3,1,1
15353,3,10,6,4,8,1
101104,3,10,10,0,12,0
247392,2,3,6,-3,8,0
372254,1,10,7,3,13,1
98717,2,21,3,18,11,1
112055,1,0,0,0,17,1
139726,3,7,14,-7,12,1
8542,4,22,10,12,4,1
152124,4,13,13,0,17,1
128566,4,28,35,-7,7,0
217315,3,0,10,-10,12,0
37053,2,13,0,13,17,0
89416,3,10,20,-10,7,1
208103,1,0,0,0,8,1
258573,2,13,0,13,13,0
128710,4,13,27,-14,7,0
355170,4,26,26,0,4,1
138864,4,12,47,-35,12,1
379200,3,9,10,-1,16,0
230164,3,3,26,-23,17,0
256228,2,6,7,-1,12,0
262113,2,14,3,11,15,0
386854,4,19,28,-9,2,1
147559,3,9,0,9,15,0
77299,4,32,17,15,1,0
191664,2,0,10,-10,17,0
14441,2,24,3,21,7,0
354095,3,19,0,19,4,1
14658,4,24,14,10,7,1
332300,2,3,6,-3,12,1
134995,4,14,27,-13,10,0
350908,3,3,14,-11,3,0
166554,1,6,0,6,6,0
156127,2,7,7,0,2,0
331963,1,0,0,0,12,1
93950,4,27,16,11,9,0
227548,1,0,0,0,16,1
40647,4,34,7,27,2,1
22911,3,3,20,-17,11,1
221102,2,0,6,-6,14,0
258322,4,28,32,-4,13,1
192164,3,3,13,-10,1,0
148742,2,13,3,10,16,1
97757,1,0,0,0,11,0
357685,2,13,6,7,5,1
412209,3,14,3,11,13,0
279332,1,0,0,0,5,1
390382,3,7,20,-13,3,0
32635,1,0,0,0,15,1
49736,4,35,31,4,6,0
160932,2,7,7,0,4,1
393971,1,3,7,-4,5,0
405541,1,0,7,-7,10,0
116261,2,10,3,7,1,1
132257,2,14,7,7,9,1
44420,2,3,0,3,3,0
87592,4,17,10,7,6,1
359070,4,10,13,-3,6,1
194212,4,12,17,-5,1,0
183284,4,16,20,-4,14,0
81843,2,0,21,-21,3,1
270778,4,6,10,-4,1,1
228289,1,0,0,0,17,0
392174,2,3,13,-10,4,1
96400,1,0,0,0,10,0
285826,4,14,24,-10,8,0
35500,3,24,7,17,17,1
364550,2,9,21,-12,9,1
420393,4,20,20,0,17,0
272494,1,7,0,7,2,1
84458,3,13,10,3,4,0
395246,3,10,13,-3,5,0
47079,4,24,7,17,5,0
234507,3,20,20,0,2,1
197641,4,33,6,27,3,0
258117,2,13,13,0,13,1
385349,4,17,31,-14,1,1
370544,1,0,0,0,12,0
351384,3,10,13,-3,3,1
303865,1,0,7,-7,16,1
209224,3,17,7,10,8,1
241917,4,20,20,0,5,1
290148,1,0,0,0,10,1
134934,3,7,16,-9,10,1
121188,2,14,13,1,3,0
148456,2,7,3,4,16,1
113655,4,9,13,-4,17,0
95487,1,0,0,0,10,0
293291,4,26,15,11,11,1
226875,2,0,10,-10,16,0
41192,3,0,7,-7,2,0
218908,3,34,17,17,13,0
231032,3,24,0,24,1,0
274022,1,0,0,0,3,0
78905,3,17,10,7,2,1
284652,3,14,27,-13,7,1
15325,2,7,3,4,8,1
220217,1,17,0,17,13,1
42002,1,3,0,3,2,0
409164,4,3,17,-14,12,1
411354,4,17,10,7,13,1
70250,1,7,0,7,15,0
41830,4,21,14,7,2,1
231660,4,17,13,4,1,0
180118,1,7,0,7,13,0
208967,4,20,20,0,8,0
215426,1,7,3,4,11,1
378591,3,17,13,4,15,0
285005,4,16,27,-11,7,1
290474,1,7,0,7,10,1
247947,4,20,6,14,8,0
205956,2,6,3,3,7,1
42695,4,7,13,-6,3,1
192861,4,16,15,1,1,1
89358,2,3,6,-3,7,0
309690,2,9,6,3,1,1
262685,1,0,0,0,15,1
224277,2,6,9,-3,15,1
226822,1,0,0,0,16,0
185564,2,10,17,-7,15,1
239202,4,27,27,0,4,1
194886,2,0,10,-10,2,1
292695,1,0,0,0,11,1
350736,2,7,0,7,2,1
307922,2,6,0,6,1,1
407914,3,9,24,-15,11,1
293112,4,10,27,-17,11,0
90238,1,0,6,-6,7,0
148324,3,14,3,11,16,0
104391,4,52,38,14,13,1
95751,4,20,9,11,10,1
127124,2,3,9,-6,6,1
371079,4,13,20,-7,12,0
97044,2,19,3,16,10,1
229038,4,23,16,7,17,0
102329,3,13,10,3,13,0
293819,3,17,6,11,12,0
82018,2,10,0,10,3,0
131374,2,7,13,-6,8,1
99491,3,3,10,-7,11,0
217522,4,19,3,16,12,1
68418,4,3,21,-18,14,0
243640,4,23,14,9,6,0
24737,4,20,20,0,12,0
283261,2,10,9,1,7,1
89543,2,0,20,-20,7,0
106310,2,7,9,-2,14,0
398066,3,21,21,0,7,0
381355,2,6,0,6,16,1
52629,1,3,0,3,7,1
293382,3,13,10,3,11,1
135426,4,28,27,1,10,1
251461,1,9,3,6,10,1
360828,4,31,37,-6,7,0
79940,4,13,16,-3,2,1
287017,2,13,14,-1,8,0
202774,4,16,17,-1,5,1
183576,3,20,24,-4,14,1
40241,1,0,0,0,2,1
38226,3,13,14,-1,1,1
159197,1,7,7,0,3,0
364455,4,35,28,7,9,1
299563,2,3,3,0,14,1
167228,3,23,17,6,7,1
173616,3,7,13,-6,10,0
127769,2,10,21,-11,6,1
104248,2,3,0,3,13,1
87063,1,0,0,0,5,0
166396,2,9,7,2,6,1
51060,3,3,20,-17,6,0
357553,3,10,13,-3,5,1
327750,4,13,16,-3,10,0
350703,1,7,0,7,2,1
326404,4,20,10,10,9,0
122559,2,14,7,7,4,1
209509,2,20,3,17,8,0
279204,2,3,3,0,5,1
306293,2,17,0,17,17,0
300621,2,10,3,7,15,0
269717,4,10,21,-11,1,0
267269,3,17,14,3,17,0
313031,3,20,0,20,3,1
110227,1,0,3,-3,16,1
124775,4,3,9,-6,5,1
44709,2,0,9,-9,3,0
283749,3,11,3,8,7,0
86239,1,6,10,-4,5,0
321935,4,14,28,-14,7,0
120079,2,3,0,3,3,1
19876,3,13,21,-8,10,1
91771,2,3,0,3,8,0
190503,2,10,0,10,17,1
313862,2,14,10,4,3,0
30278,2,3,10,-7,14,1
78246,1,0,0,0,2,0
145704,1,0,7,-7,15,1
25313,4,37,14,23,12,1
96514,4,17,24,-7,10,1
224562,1,3,0,3,15,0
49158,1,3,0,3,6,1
151520,4,35,7,28,17,1
44335,4,24,23,1,3,0
410193,4,20,24,-4,13,1
296570,1,0,0,0,13,0
15874,1,0,7,-7,8,1
286984,1,3,7,-4,8,1
89193,2,3,0,3,7,0
391499,1,0,7,-7,4,1
381324,1,6,0,6,16,0
169138,1,0,0,0,7,1
28497,2,24,0,24,14,0
318115,2,9,7,2,5,1
278744,1,0,0,0,5,1
316215,1,0,7,-7,4,1
415822,1,0,6,-6,15,0
45261,1,0,0,0,4,1
368902,4,38,3,35,11,1
389226,3,21,7,14,3,1
404163,2,9,7,2,10,0
254231,1,0,0,0,11,0
164831,1,0,3,-3,6,0
152692,4,27,6,21,17,0
271908,3,10,13,-3,2,1
14364,4,8,17,-9,7,1
112605,3,31,34,-3,17,1
50460,3,10,10,0,6,1
412306,2,7,7,0,13,1
368271,2,3,3,0,11,1
386096,4,14,6,8,1,0
332885,2,17,0,17,12,1
399938,3,3,13,-10,8,1
181221,2,0,0,0,13,0
197577,2,19,0,19,3,0
133100,1,0,0,0,9,0
286431,3,14,3,11,8,1
262796,4,35,17,18,15,0
8714,1,0,0,0,4,1
393841,2,10,17,-7,5,0
21939,1,7,0,7,11,0
380012,2,7,0,7,16,1
77914,1,0,0,0,1,1
395240,3,10,13,-3,5,0
403669,4,37,20,17,9,0
248249,1,0,0,0,8,0
376527,2,6,6,0,14,1
157723,2,10,10,0,2,1
398778,3,14,17,-3,7,1
57252,4,26,21,5,10,0
298692,3,13,14,-1,14,1
421148,3,37,16,21,17,0
271875,2,7,10,-3,2,0
300778,3,10,19,-9,15,0
211338,3,10,10,0,9,0
134336,3,16,21,-5,10,1
237342,2,0,0,0,3,0
40598,2,24,7,17,2,0
5085,3,13,7,6,3,1
321413,2,14,17,-3,7,1
316709,1,0,0,0,4,1
368388,2,14,0,14,11,0
247624,4,26,23,3,8,0
235816,1,0,7,-7,3,1
375238,5,24,24,0,14,1
61505,1,7,7,0,11,0
158140,1,0,0,0,3,0
338407,4,24,10,14,14,1
366681,2,17,10,7,10,0
95187,4,23,30,-7,9,1
103483,2,6,0,6,13,0
156253,5,24,23,1,2,1
287167,2,10,10,0,8,0
326839,4,10,14,-4,9,0
274823,1,0,0,0,3,1
19439,2,17,14,3,10,1
299119,2,3,10,-7,14,1
359727,2,17,6,11,6,0
229445,4,10,6,4,17,0
195261,4,23,17,6,2,0
26373,1,6,0,6,13,1
335682,2,7,7,0,13,1
319086,4,26,41,-15,5,1
112555,2,17,19,-2,17,1
376838,3,21,7,14,15,0
286624,4,17,41,-24,8,1
103394,3,10,20,-10,13,1
84548,1,0,0,0,4,0
169180,2,10,6,4,7,0
251586,4,19,20,-1,10,1
52842,3,14,37,-23,7,0
235969,1,7,0,7,3,0
111337,1,0,7,-7,16,0
150489,3,34,6,28,16,0
27601,2,7,10,-3,13,1
144700,2,3,0,3,14,1
248502,4,23,13,10,8,1
317084,4,17,17,0,4,0
137217,2,7,3,4,11,1
42736,4,7,20,-13,3,0
398291,1,3,0,3,7,1
194468,3,16,3,13,2,0
225582,1,0,7,-7,16,1
313638,4,25,30,-5,3,0
129358,2,16,7,9,7,1
52743,4,20,23,-3,7,0
154787,3,13,23,-10,1,1
109625,4,37,14,23,16,0
157484,4,22,37,-15,2,1
63188,3,14,23,-9,12,0
295607,4,31,32,-1,12,1
356788,2,0,0,0,5,1
144469,4,10,33,-23,14,1
108693,3,27,13,14,15,0
108695,3,27,13,14,15,0
317713,4,23,16,7,5,0
17243,3,7,34,-27,9,0
138268,1,3,0,3,11,0
77210,2,6,0,6,1,1
49115,5,20,20,0,6,1
187307,4,10,13,-3,16,1
50572,2,0,6,-6,6,1
69276,2,13,0,13,15,0
323504,2,10,10,0,7,1
29254,2,14,0,14,14,1
147714,3,10,10,0,15,1
231175,3,10,7,3,1,0
7959,4,9,27,-18,4,1
197738,3,14,10,4,3,0
283680,1,0,0,0,7,0
379834,1,0,0,0,16,0
185962,1,3,7,-4,15,1
302546,4,3,13,-10,15,1
375542,4,33,14,19,14,0
153819,1,0,0,0,1,0
171171,2,3,7,-4,8,0
38145,5,9,9,0,1,0
274432,4,10,17,-7,3,1
377521,2,0,6,-6,15,1
28036,1,7,7,0,13,1
95356,1,7,0,7,10,0
45107,1,0,0,0,4,1
270799,1,3,0,3,1,0
7016,4,13,7,6,3,1
331836,1,0,0,0,12,0
48597,3,14,24,-10,5,1
57900,2,10,10,0,10,1
27802,3,14,14,0,13,0
406578,4,20,37,-17,11,1
224856,1,0,0,0,15,1
328670,4,27,38,-11,10,1
293659,2,10,7,3,12,1
293449,1,0,0,0,11,0
233135,3,29,3,26,2,0
315841,3,9,19,-10,4,0
25783,5,17,17,0,12,1
66925,3,12,7,5,14,1
162985,3,6,3,3,5,0
286003,4,29,20,9,8,1
420843,4,17,20,-3,17,1
22338,3,0,6,-6,11,0
260203,2,10,0,10,14,0
167003,2,0,14,-14,7,1
13911,3,21,7,14,7,0
341202,2,13,7,6,16,1
55232,2,7,0,7,9,0
244318,1,0,0,0,7,0
264198,1,0,6,-6,15,0
332901,3,24,0,24,12,0
7382,1,0,0,0,4,1
108846,3,7,10,-3,15,1
269388,3,7,17,-10,1,0
194710,1,0,0,0,2,0
402866,2,17,3,14,9,0
126962,2,3,10,-7,6,1
84958,1,6,7,-1,4,1
94159,2,10,7,3,9,1
97495,2,16,0,16,10,0
381111,4,24,28,-4,16,1
402028,4,3,19,-16,9,1
363373,2,7,10,-3,8,1
373590,4,29,33,-4,13,1
125860,1,3,10,-7,6,1
86476,4,30,24,6,5,1
228696,3,19,23,-4,17,0
212271,1,7,3,4,10,1
65457,3,3,14,-11,13,1
246130,1,7,0,7,7,0
233802,4,19,37,-18,2,0
391435,3,10,17,-7,4,1
166111,2,14,3,11,6,1
279227,2,13,6,7,5,0
47795,1,7,0,7,5,0
47006,2,14,0,14,5,1
237012,1,0,7,-7,3,1
109116,2,10,7,3,15,0
22769,3,3,21,-18,11,0
10652,3,10,17,-7,5,0
55371,2,10,7,3,9,1
39555,2,0,6,-6,1,0
330933,1,0,0,0,11,0
144697,2,3,0,3,14,0
206892,3,10,17,-7,7,0
261231,2,27,0,27,14,1
287862,4,28,20,8,9,0
307223,4,3,10,-7,17,1
20134,2,3,0,3,10,0
211440,1,3,6,-3,9,0
421479,1,0,0,0,17,0
154549,1,7,0,7,1,0
102045,3,21,3,18,12,0
220881,4,13,38,-25,14,1
366720,3,24,10,14,10,1
61881,4,20,23,-3,12,1
331573,2,17,20,-3,11,0
316179,4,30,32,-2,4,0
274783,4,24,23,1,3,0
413162,4,40,42,-2,14,0
283953,1,0,0,0,7,1
231621,3,14,10,4,1,0
403050,4,24,24,0,9,1
34852,2,10,6,4,16,0
103796,2,6,0,6,13,0
294315,1,10,0,10,12,0
150799,4,20,9,11,17,0
181388,2,17,7,10,13,0
340838,4,24,16,8,15,0
320216,1,7,0,7,6,0
318441,3,21,7,14,5,1
350432,2,0,6,-6,2,0
417801,1,7,0,7,16,0
11319,1,7,0,7,6,1
411428,2,7,14,-7,13,1
404224,4,12,9,3,10,1
156743,1,7,7,0,2,0
126967,2,3,10,-7,6,1
269763,1,7,0,7,1,1
133922,3,6,6,0,9,1
136090,1,0,7,-7,10,0
327200,1,0,0,0,9,0
18735,2,6,7,-1,9,0
99198,3,17,10,7,11,0
68649,2,7,0,7,15,1
368549,2,9,0,9,11,1
65452,2,3,14,-11,13,0
352026,4,28,21,7,3,1
379009,2,7,3,4,15,0
300275,2,0,7,-7,14,1
4128,4,26,28,-2,2,0
56111,2,17,7,10,9,0
59296,1,0,3,-3,11,1
185282,3,27,16,11,15,0
266254,4,38,19,19,16,0
112323,4,45,17,28,17,1
357754,4,43,19,24,5,1
198266,1,3,7,-4,3,1
198075,4,10,37,-27,3,0
337031,2,16,0,16,14,0
194419,2,6,0,6,2,1
121081,4,18,31,-13,3,0
309987,2,3,10,-7,2,1
273192,3,27,7,20,2,0
183253,3,10,20,-10,14,1
402505,4,26,18,8,9,1
65026,3,0,17,-17,13,0
90776,3,20,7,13,7,1
98592,3,7,7,0,11,0
89796,1,3,0,3,7,0
245215,1,0,0,0,7,1
119567,2,7,0,7,3,1
136120,2,3,10,-7,10,1
25946,1,3,3,0,13,1
269913,1,7,0,7,1,0
181040,1,7,0,7,13,1
366555,2,20,7,13,10,0
12061,1,7,0,7,6,0
182445,2,7,0,7,14,0
160701,4,10,0,10,4,1
79814,4,34,21,13,2,1
277730,3,7,3,4,4,0
220108,2,19,6,13,13,1
318743,3,10,23,-13,5,0
21770,4,31,24,7,11,1
340784,3,17,10,7,15,0
143055,2,3,7,-4,13,0
279370,2,6,7,-1,5,0
298188,1,0,3,-3,14,1
146016,1,3,0,3,15,1
369890,3,7,9,-2,12,0
104222,1,3,0,3,13,0
77387,3,14,14,0,1,0
291310,3,21,22,-1,10,1
382136,3,27,3,24,17,1
33903,1,0,3,-3,16,0
352249,2,3,3,0,3,0
132300,3,24,14,10,9,0
209551,3,34,20,14,8,1
194552,1,7,0,7,2,0
281947,2,7,14,-7,6,1
317751,1,0,0,0,5,0
61635,1,0,0,0,12,0
26995,1,10,0,10,13,0
50419,2,7,7,0,6,0
382913,2,0,7,-7,17,1
76108,4,13,30,-17,1,0
360714,1,9,7,2,7,1
230733,3,9,27,-18,1,1
154639,4,24,21,3,1,0
294854,3,42,21,21,12,0
208159,2,0,0,0,8,0
12853,3,13,3,10,6,0
8196,2,0,7,-7,4,0
168751,3,13,6,7,7,0
46179,2,14,14,0,4,0
306453,2,3,17,-14,17,0
157434,3,9,17,-8,2,1
400604,1,0,0,0,8,0
120900,3,21,31,-10,3,1
282440,4,10,26,-16,6,0
369565,3,14,0,14,11,0
235352,1,7,0,7,3,1
78800,4,16,30,-14,2,1
340526,3,0,40,-40,15,1
181963,1,7,0,7,13,0
411605,2,14,13,1,13,0
148143,2,3,13,-10,16,0
368853,2,24,0,24,11,0
92871,3,24,0,24,8,1
317083,4,17,17,0,4,0
236407,4,14,23,-9,3,1
204939,4,13,27,-14,6,1
314473,2,7,0,7,3,1
400023,1,7,3,4,8,0
145638,3,28,0,28,14,0
65285,2,3,14,-11,13,0
322014,2,3,0,3,7,1
373369,2,10,7,3,13,0
78575,2,16,7,9,2,0
278199,3,24,21,3,4,1
292559,1,0,6,-6,11,1
351582,4,0,27,-27,3,1
294847,3,35,21,14,12,1
277845,2,7,14,-7,4,0
192436,2,0,17,-17,1,1
125304,2,10,3,7,5,1
104139,3,24,27,-3,13,0
123124,1,0,0,0,4,1
326319,2,0,10,-10,9,1
24803,2,6,0,6,12,0
373610,4,30,40,-10,13,1
9421,1,0,0,0,5,1
20201,3,17,10,7,10,0
91518,4,19,3,16,8,0
107865,1,0,0,0,15,0
340644,2,16,9,7,15,0
167720,4,26,20,6,7,0
48508,1,11,0,11,5,0
265357,2,7,10,-3,16,0
182247,1,0,0,0,14,1
246726,1,3,0,3,8,1
33346,1,6,3,3,16,1
282757,1,0,0,0,6,0
401105,2,27,3,24,8,0
234579,1,10,0,10,2,0
117016,2,0,10,-10,2,0
394558,1,0,0,0,5,0
302268,4,38,13,25,15,0
22876,2,0,13,-13,11,1
225017,1,0,0,0,15,1
78587,3,16,13,3,2,1
230204,4,3,32,-29,17,0
54999,4,13,10,3,8,1
76334,2,13,3,10,1,1
252242,1,0,0,0,10,1
54525,3,14,10,4,8,1
368799,1,0,0,0,11,1
350040,3,19,10,9,2,1
420106,1,0,0,0,17,0
141326,2,3,7,-4,13,0
119788,3,17,6,11,3,0
308707,2,7,6,1,1,0
318853,2,21,6,15,5,0
72817,3,31,17,14,16,0
115926,4,20,30,-10,1,0
254543,1,0,0,0,11,1
412530,4,31,14,17,14,1
110177,4,23,23,0,16,1
32824,2,6,7,-1,15,1
290288,4,17,15,2,10,0
24936,1,10,7,3,12,0
168295,2,10,14,-4,7,1
194882,2,0,10,-10,2,0
72748,1,13,0,13,16,1
214711,1,3,7,-4,11,1
398711,1,0,14,-14,7,1
154746,2,9,10,-1,1,1
410729,3,17,6,11,13,1
233185,4,36,18,18,2,1
157551,2,0,0,0,2,0
310648,3,13,30,-17,2,0
299792,5,17,17,0,14,1
347660,3,17,17,0,1,1
235116,2,0,10,-10,2,0
23706,4,12,33,-21,12,1
404168,2,9,7,2,10,0
101454,4,18,13,5,12,1
354058,2,13,0,13,4,1
306008,2,3,10,-7,17,1
353515,2,3,0,3,4,0
164595,2,7,3,4,5,0
68702,3,24,0,24,15,1
310151,3,21,7,14,2,1
185978,1,3,20,-17,15,1
23831,4,24,7,17,12,0
159971,1,0,3,-3,3,0
50818,1,6,7,-1,6,1
153540,2,5,7,-2,1,0
210066,4,17,17,0,8,1
74094,3,16,0,16,17,1
261970,2,14,10,4,14,1
300028,2,0,20,-20,14,0
146078,2,19,10,9,15,1
262048,4,24,31,-7,14,0
79806,4,28,21,7,2,1
315377,3,16,17,-1,4,1
147279,3,0,30,-30,15,0
395775,2,0,0,0,6,0
139703,2,7,7,0,12,1
140382,4,17,29,-12,12,0
55853,3,7,14,-7,9,1
48551,2,11,14,-3,5,1
8078,3,17,7,10,4,0
324062,1,0,0,0,8,0
349045,4,17,17,0,2,0
14173,3,0,24,-24,7,1
90661,4,27,33,-6,7,0
261261,3,31,0,31,14,1
118840,3,20,7,13,2,1
273746,1,0,7,-7,2,0
61051,4,34,19,15,11,1
340756,2,10,7,3,15,0
355615,3,24,10,14,5,0
228348,2,7,17,-10,17,1
324582,3,16,9,7,8,0
140704,1,3,14,-11,12,1
365028,3,17,6,11,9,0
73763,2,3,0,3,17,1
90806,4,34,7,27,7,0
374349,4,28,13,15,13,1
34567,2,14,0,14,16,1
362845,4,14,28,-14,8,0
189616,2,10,3,7,17,0
398020,2,14,7,7,7,0
162987,3,6,3,3,5,0
24103,3,7,14,-7,12,1
137582,4,20,34,-14,11,1
36493,2,10,6,4,17,0
357823,2,6,14,-8,6,0
670,3,0,10,-10,1,0
150413,1,14,0,14,16,0
16583,1,0,7,-7,8,1
379091,4,7,12,-5,15,0
365279,2,10,13,-3,9,0
95922,5,23,23,0,10,0
225413,4,27,38,-11,15,0
369137,2,13,7,6,11,1
400317,1,0,0,0,8,1
195749,1,0,0,0,2,1
283650,4,23,20,3,7,0
29772,4,41,3,38,14,1
302716,4,26,20,6,15,0
189043,3,14,17,-3,16,1
218501,4,31,17,14,13,1
43599,4,31,9,22,3,0
88137,1,0,3,-3,6,1
229495,1,0,0,0,17,1
36738,1,0,7,-7,17,0
119826,4,24,16,8,3,0
223485,2,7,3,4,15,0
36800,3,10,10,0,17,0
248744,2,20,7,13,9,1
199320,1,0,0,0,4,1
392257,4,10,16,-6,4,0
371439,2,7,7,0,12,1
258872,3,20,14,6,13,0
342801,4,7,14,-7,16,0
286413,2,14,0,14,8,0
29811,1,3,3,0,14,0
301464,2,17,6,11,15,1
257466,1,0,3,-3,13,1
185440,4,17,10,7,15,0
421862,3,7,19,-12,17,1
194996,1,7,0,7,2,0
27936,3,14,10,4,13,1
377112,2,10,10,0,15,0
35110,1,0,0,0,16,1
265493,3,7,7,0,16,1
401606,4,24,24,0,8,0
305284,3,35,21,14,16,0
345517,1,7,10,-3,17,0
169821,3,10,17,-7,8,1
401755,4,27,14,13,8,0
91000,2,3,0,3,7,0
68275,4,27,30,-3,14,0
134386,4,29,24,5,10,0
199130,3,14,31,-17,4,1
268638,3,14,13,1,17,0
113396,1,0,0,0,17,0
348065,2,0,10,-10,1,0
235708,2,3,17,-14,3,1
220587,4,16,26,-10,13,1
415074,4,13,34,-21,15,0
138736,4,31,38,-7,12,0
382382,2,0,14,-14,17,0
394864,2,0,14,-14,5,1
319140,2,2,0,2,5,1
311639,3,6,6,0,2,0
245295,3,9,3,6,7,1
349343,4,30,42,-12,2,1
163269,2,6,6,0,5,1
302378,3,16,13,3,15,1
313114,2,0,3,-3,3,1
374118,2,13,7,6,13,0
410362,1,0,7,-7,13,1
208398,4,17,43,-26,8,1
101474,4,25,20,5,12,0
299886,3,13,8,5,14,1
136827,5,20,21,-1,11,0
69238,1,3,0,3,15,1
18874,3,9,6,3,9,0
38759,1,0,3,-3,1,0
347778,2,7,0,7,1,1
123690,4,10,25,-15,4,1
375680,4,23,20,3,14,1
92594,3,17,3,14,8,0
332508,4,23,9,14,12,0
139568,3,6,7,-1,12,1
395416,4,28,3,25,5,1
19323,3,14,17,-3,10,1
396225,1,0,3,-3,6,1
165194,1,0,7,-7,6,1
111680,3,27,10,17,16,1
265032,2,7,3,4,16,1
27539,4,23,12,11,13,1
367339,4,6,20,-14,10,0
114656,2,3,10,-7,1,1
90133,2,3,0,3,7,1
161,1,0,0,0,1,1
301439,2,10,3,7,15,0
259645,4,9,6,3,13,1
314872,2,0,0,0,4,0
200125,2,7,17,-10,4,0
267964,2,0,3,-3,17,0
167701,3,16,20,-4,7,1
362200,2,6,3,3,8,0
110608,2,17,10,7,16,0
266489,2,0,15,-15,16,1
78276,2,3,14,-11,2,0
362771,2,7,7,0,8,0
300302,2,0,7,-7,14,0
410702,2,10,3,7,13,0
344155,4,27,3,24,17,0
360286,2,0,13,-13,7,1
399666,3,16,9,7,8,1
358475,4,38,27,11,6,0
189048,3,14,17,-3,16,1
355817,1,6,0,6,5,0
294183,2,0,7,-7,12,1
122664,1,0,0,0,4,0
330840,2,10,17,-7,11,1
28477,1,10,0,10,14,1
251503,2,16,6,10,10,1
19281,2,7,14,-7,10,1
308145,4,16,19,-3,1,1
413693,2,14,13,1,14,1
187532,2,6,13,-7,16,1
323494,2,3,10,-7,7,1
167906,4,21,19,2,7,0
136497,4,20,13,7,11,0
160885,4,34,27,7,4,0
308456,4,7,25,-18,1,0
381327,1,6,0,6,16,1
264761,3,10,16,-6,16,1
352075,2,3,10,-7,3,1
328018,3,17,9,8,10,1
4838,4,34,3,31,3,0
179634,4,31,30,1,12,1
187404,3,34,7,27,16,0
261108,3,7,21,-14,14,1
198191,3,10,6,4,3,0
178814,3,24,14,10,12,0
252214,4,23,24,-1,10,1
273510,3,14,21,-7,2,1
333628,1,0,0,0,12,1
405917,2,14,0,14,11,0
170379,1,14,0,14,8,0
359195,4,13,21,-8,6,0
229705,2,13,10,3,17,0
189577,1,0,0,0,17,1
241133,3,20,10,10,5,0
282111,3,16,8,8,6,0
283812,4,21,10,11,7,1
58026,5,20,20,0,10,0
374759,4,8,39,-31,14,1
243837,1,0,0,0,6,0
127267,1,3,7,-4,6,1
380437,4,10,24,-14,16,1
287820,3,27,17,10,9,1
192422,1,0,14,-14,1,0
206944,4,24,23,1,7,1
94269,1,0,0,0,9,0
278866,4,14,31,-17,5,1
306483,3,10,17,-7,17,1
18008,3,16,21,-5,9,0
372216,4,9,25,-16,13,1
401561,2,17,14,3,8,0
168230,1,0,0,0,7,0
110171,3,20,23,-3,16,1
151286,1,7,7,0,17,1
368630,4,16,19,-3,11,0
104267,2,17,0,17,13,0
81240,2,7,7,0,3,1
393277,4,24,26,-2,5,0
336418,2,3,3,0,14,1
334950,1,0,7,-7,13,1
271125,2,0,10,-10,1,0
342865,2,16,0,16,16,0
292731,2,7,10,-3,11,1
243412,2,3,10,-7,6,0
78182,4,34,3,31,2,0
118813,2,13,0,13,2,1
236807,3,3,9,-6,3,0
32424,4,31,6,25,15,1
288043,1,0,0,0,9,1
46232,4,14,31,-17,4,1
364484,4,42,28,14,9,1
392789,2,17,3,14,4,0
3921,3,19,14,5,2,1
395560,4,28,14,14,6,1
353848,2,7,14,-7,4,1
73002,1,0,0,0,16,1
412860,4,31,35,-4,14,1
17392,3,17,0,17,9,0
329791,3,17,20,-3,11,0
178560,4,16,13,3,12,1
254903,2,17,7,10,12,1
335656,1,7,0,7,13,0
198138,2,0,3,-3,3,1
83214,2,3,7,-4,4,1
20203,3,17,10,7,10,1
2376,2,7,10,-3,2,1
199332,1,0,0,0,4,0
420869,4,17,34,-17,17,0
275273,2,10,2,8,3,1
310279,2,16,0,16,2,1
153036,1,0,0,0,1,0
399751,2,0,17,-17,8,1
95510,1,3,0,3,10,0
276528,3,19,7,12,4,1
129369,2,16,7,9,7,1
164849,1,0,3,-3,6,1
246295,1,7,3,4,7,0
87872,3,10,12,-2,6,1
150036,4,24,6,18,16,0
13852,1,0,0,0,7,1
276856,4,26,20,6,4,1
314027,2,6,0,6,3,0
206940,4,24,23,1,7,0
392780,2,14,3,11,4,1
303215,5,31,31,0,16,1
284127,1,0,3,-3,7,0
185835,1,3,0,3,15,0
205186,2,14,13,1,6,0
171119,1,0,0,0,8,1
145756,2,10,10,0,15,0
286997,2,10,7,3,8,0
28699,3,3,10,-7,14,0
388217,4,6,13,-7,2,1
314663,4,14,14,0,3,0
86812,2,6,6,0,5,1
86594,3,33,3,30,5,0
71378,1,0,0,0,16,1
281720,4,38,30,8,6,0
267413,3,10,10,0,17,0
213647,2,7,14,-7,10,0
47471,1,3,0,3,5,0
376913,1,0,3,-3,15,1
387509,1,0,0,0,2,1
192470,2,0,17,-17,1,0
360345,4,7,20,-13,7,1
34673,1,0,3,-3,16,0
88480,3,10,7,3,6,1
254165,3,3,12,-9,11,0
5285,4,24,31,-7,3,1
143458,2,14,7,7,14,0
326380,4,20,10,10,9,1
53059,1,10,6,4,7,0
412079,3,30,0,30,13,1
216108,4,24,26,-2,11,0
213096,3,20,3,17,10,0
253092,3,14,7,7,11,1
283563,2,6,17,-11,7,0
108014,1,0,0,0,15,1
145996,4,13,21,-8,15,0
304389,4,31,21,10,16,1
267733,4,16,34,-18,17,1
68764,1,3,0,3,15,1
243436,2,3,17,-14,6,1
79521,4,12,27,-15,2,1
177330,1,0,0,0,11,1
271909,3,10,13,-3,2,1
376861,4,21,14,7,15,1
106744,2,14,12,2,14,0
230905,3,21,10,11,1,1
156114,1,7,7,0,2,1
226613,3,10,3,7,16,1
149162,4,23,31,-8,16,1
5034,1,0,0,0,3,1
214731,2,3,7,-4,11,0
334908,4,27,10,17,13,1
40867,2,6,10,-4,2,1
208783,3,6,15,-9,8,1
35587,1,7,0,7,17,1
24151,4,31,14,17,12,0
222953,3,13,13,0,14,0
100327,2,9,17,-8,12,0
184365,2,7,6,1,14,1
292489,3,10,12,-2,11,1
409436,4,34,3,31,12,0
44161,4,13,20,-7,3,1
330187,1,0,0,0,11,1
403394,1,0,0,0,9,1
277832,2,7,14,-7,4,1
132534,2,2,26,-24,9,0
150151,2,3,13,-10,16,1
86443,3,27,14,13,5,1
359346,3,3,19,-16,6,0
295073,2,0,0,0,12,1
202124,2,13,3,10,5,1
356709,3,19,16,3,5,0
398140,1,0,3,-3,7,0
281199,3,24,13,11,6,1
412682,3,30,10,20,14,0
371209,3,14,19,-5,12,0
309646,1,0,0,0,1,0
76849,4,33,7,26,1,0
71326,3,10,20,-10,16,1
390542,3,17,7,10,3,0
406532,3,14,23,-9,11,0
121540,3,16,7,9,4,0
165798,2,3,3,0,6,1
226499,4,14,10,4,16,0
188137,3,10,10,0,16,0
206812,1,0,0,0,7,0
3579,2,14,14,0,2,1
272902,4,20,17,3,2,1
391800,1,0,0,0,4,1
179719,2,0,10,-10,12,1
403399,1,0,0,0,9,0
181939,4,28,35,-7,13,1
75147,3,7,6,1,17,0
304219,3,32,7,25,16,1
353244,2,14,17,-3,4,1
17141,4,30,17,13,9,1
328872,1,3,0,3,10,0
402597,3,10,16,-6,9,0
369770,4,45,43,2,11,1
287987,4,20,16,4,9,1
63141,2,7,10,-3,12,1
167326,2,16,16,0,7,1
400302,1,0,0,0,8,0
299141,3,3,16,-13,14,1
318859,2,21,12,9,5,1
352087,2,3,10,-7,3,0
326656,3,16,6,10,9,1
142620,2,13,6,7,13,0
259078,1,0,0,0,13,1
387440,3,21,16,5,2,1
56073,1,7,0,7,9,0
259149,2,14,13,1,13,1
315777,2,0,3,-3,4,1
252300,2,0,16,-16,10,0
313746,3,21,3,18,3,1
118774,1,10,0,10,2,0
327235,2,6,3,3,9,1
62136,2,7,7,0,12,1
225528,4,0,24,-24,15,1
17415,4,17,7,10,9,1
155479,1,7,0,7,2,0
162856,3,6,3,3,5,1
78536,2,3,7,-4,2,0
284159,2,6,13,-7,7,0
115535,2,0,3,-3,1,0
216428,4,24,26,-2,12,0
356860,4,16,16,0,5,0
377029,4,22,26,-4,15,1
159473,4,27,23,4,3,0
284342,3,6,16,-10,7,0
288772,4,3,13,-10,9,1
29561,2,0,13,-13,14,1
362174,1,3,0,3,8,1
219212,3,13,3,10,13,1
364169,4,31,3,28,9,1
20732,4,31,20,11,10,1
138311,2,20,0,20,11,1
387144,3,10,34,-24,2,1
220508,2,0,14,-14,13,0
183299,4,22,20,2,14,0
401834,2,7,14,-7,9,0
354019,1,6,0,6,4,1
357729,3,40,13,27,5,0
217994,2,14,10,4,12,1
189533,4,20,7,13,17,1
402561,2,7,7,0,9,1
285366,1,0,0,0,8,1
367361,1,0,7,-7,10,1
155971,2,3,14,-11,2,1
259461,2,14,10,4,13,1
283368,1,0,0,0,7,1
266432,1,0,0,0,16,1
144509,1,0,7,-7,14,0
10177,2,6,3,3,5,0
416478,3,21,10,11,15,0
386252,4,14,17,-3,2,1
421637,1,3,7,-4,17,0
250338,3,7,7,0,9,0
177643,1,0,0,0,12,1
411826,4,6,34,-28,13,1
179795,4,6,27,-21,12,1
279967,2,3,10,-7,5,0
35990,4,6,21,-15,17,1
274302,4,32,16,16,3,0
364077,1,7,3,4,9,1
7860,2,3,7,-4,4,0
113847,1,0,0,0,17,1
333180,2,0,7,-7,12,1
204637,4,10,45,-35,6,1
282374,3,10,13,-3,6,0
159525,2,7,6,1,3,0
317272,4,7,16,-9,5,1
328789,3,17,13,4,10,1
72072,3,10,10,0,16,1
238080,4,13,13,0,4,1
94174,2,17,7,10,9,0
97528,3,16,0,16,10,1
12317,4,6,9,-3,6,0
107647,3,13,20,-7,15,1
312272,4,10,23,-13,2,1
276308,2,7,14,-7,3,1
140601,2,24,10,14,12,1
120147,3,10,6,4,3,0
79620,3,14,14,0,2,1
89642,1,3,3,0,7,0
216670,2,14,6,8,12,1
414869,3,21,7,14,15,1
152220,3,21,0,21,17,0
203438,2,0,3,-3,6,0
285260,2,13,6,7,7,1
26596,3,10,6,4,13,0
106634,3,43,7,36,14,0
269711,4,10,21,-11,1,0
178443,1,7,3,4,12,0
137976,1,7,7,0,11,0
295701,2,3,9,-6,12,0
278872,4,21,31,-10,5,0
89981,2,2,14,-12,7,1
325,1,14,3,11,1,1
308483,1,0,0,0,1,0
131132,3,27,9,18,8,0
375192,4,17,17,0,14,1
346983,3,7,3,4,1,1
334183,4,36,14,22,13,1
196810,2,0,10,-10,3,1
194575,2,14,0,14,2,1
87238,2,7,14,-7,6,1
149364,2,3,6,-3,16,1
45270,2,0,0,0,4,0
366396,2,26,0,26,10,0
328584,2,10,7,3,10,0
237025,1,0,7,-7,3,0
253026,1,0,0,0,11,0
185167,4,0,23,-23,15,1
173404,1,0,0,0,10,1
29138,3,0,19,-19,14,0
287762,2,14,3,11,9,0
184372,2,14,6,8,14,1
254806,4,20,10,10,11,0
220796,2,0,0,0,14,0
208234,4,6,10,-4,8,1
30881,2,3,14,-11,15,0
73410,4,30,3,27,17,0
273296,2,21,0,21,2,1
363439,4,28,28,0,8,1
83563,3,0,17,-17,4,0
214917,3,7,18,-11,11,0
162482,2,7,3,4,4,1
109016,3,16,27,-11,15,0
90819,1,0,0,0,7,0
394561,1,0,0,0,5,0
55220,2,7,0,7,9,1
285266,2,14,6,8,7,0
151779,3,14,6,8,17,0
26574,2,10,6,4,13,0
396549,2,17,7,10,6,1
120855,2,7,14,-7,3,1
43625,1,0,3,-3,3,1
413580,3,9,17,-8,14,0
89831,2,6,6,0,7,1
147027,4,27,0,27,15,1
364099,2,14,3,11,9,0
367544,2,14,6,8,10,1
161709,2,10,3,7,4,1
270240,2,3,21,-18,1,0
107731,2,7,7,0,15,1
351505,2,0,27,-27,3,1
38316,1,0,0,0,1,1
403149,2,10,14,-4,9,1
157955,4,16,22,-6,3,0
84599,3,13,10,3,4,0
80122,1,0,0,0,2,0
147021,4,27,0,27,15,1
339078,1,0,0,0,15,1
302416,4,16,19,-3,15,1
106200,4,0,10,-10,14,1
191235,2,7,17,-10,17,0
112822,1,0,0,0,17,1
197811,1,6,0,6,3,0
55450,4,20,10,10,9,1
202221,1,3,0,3,5,0
137045,1,7,0,7,11,0
49149,1,3,0,3,6,0
346571,4,30,47,-17,1,1
202209,1,0,0,0,5,1
243432,2,3,17,-14,6,0
135909,5,24,24,0,10,1
44126,3,10,13,-3,3,0
234661,3,20,20,0,2,1
358071,1,0,0,0,6,1
311571,1,0,0,0,2,1
346931,1,0,3,-3,1,0
237496,2,14,7,7,3,1
219702,4,13,14,-1,13,1
144242,2,9,7,2,14,1
334783,1,0,0,0,13,0
386485,2,7,0,7,2,1
373622,1,0,0,0,13,0
272641,1,0,0,0,2,0
96636,4,3,10,-7,10,1
330122,4,0,13,-13,11,0
75486,4,31,7,24,17,1
267986,2,7,6,1,17,0
154926,3,19,10,9,1,1
340425,4,31,19,12,15,0
411845,4,7,34,-27,13,0
138176,2,7,9,-2,11,0
238089,4,13,13,0,4,0
91963,3,6,23,-17,8,1
105176,1,7,0,7,14,0
408609,2,21,0,21,12,1
200740,2,17,0,17,4,1
265569,1,0,2,-2,16,1
223718,4,37,13,24,15,0
50667,1,0,0,0,6,1
359203,4,19,21,-2,6,1
238509,3,13,0,13,4,0
357347,1,0,0,0,5,1
118878,4,27,7,20,2,0
66373,4,14,24,-10,14,0
266753,2,0,7,-7,16,0
201416,1,6,0,6,5,1
57476,2,14,10,4,10,0
261100,3,7,14,-7,14,0
351123,4,37,37,0,3,1
278020,2,9,10,-1,4,1
96210,4,3,19,-16,10,0
279277,3,19,13,6,5,1
390901,4,15,28,-13,3,0
125049,4,3,19,-16,5,0
241390,2,7,21,-14,5,1
186658,3,24,3,21,15,1
277628,4,27,28,-1,4,1
144470,4,10,33,-23,14,1
272127,4,17,9,8,2,1
103515,2,13,0,13,13,1
11108,3,10,13,-3,5,1
420385,4,20,20,0,17,1
41357,3,14,12,2,2,1
161739,2,17,6,11,4,1
108360,2,0,14,-14,15,1
236543,3,10,9,1,3,1
264278,3,10,17,-7,15,0
179025,1,0,0,0,12,1
196709,3,33,0,33,3,0
22541,1,3,0,3,11,1
348153,1,6,0,6,1,0
153035,1,0,0,0,1,0
97923,1,0,7,-7,11,0
154912,3,19,10,9,1,0
396494,1,7,7,0,6,0
301361,3,17,7,10,15,1
327669,2,3,3,0,10,1
296672,4,10,16,-6,13,0
98377,1,0,7,-7,11,1
82869,1,0,0,0,4,1
63570,2,10,7,3,12,1
173526,4,13,27,-14,10,1
282734,4,16,30,-14,6,0
168630,4,17,16,1,7,1
88750,2,3,3,0,6,1
217201,4,12,19,-7,12,1
325170,3,13,14,-1,8,0
57767,2,16,3,13,10,0
415265,1,0,0,0,15,1
363908,1,0,0,0,8,1
308956,2,0,3,-3,1,1
416576,1,0,0,0,15,1
314522,4,24,7,17,3,0
193463,4,23,20,3,1,1
157094,2,10,14,-4,2,1
298551,3,13,0,13,14,0
306439,2,0,17,-17,17,1
393286,4,24,29,-5,5,1
240943,3,14,9,5,5,1
346630,2,7,3,4,1,1
99829,4,8,24,-16,12,0
82510,3,10,20,-10,3,0
66985,1,0,0,0,14,1
370980,1,6,0,6,12,1
383135,4,23,14,9,17,0
292652,4,22,16,6,11,1
22673,4,30,24,6,11,1
193614,4,7,17,-10,1,0
233299,3,7,17,-10,2,0
203057,3,26,10,16,5,1
362033,1,0,7,-7,8,1
358036,4,30,22,8,6,1
221228,2,0,16,-16,14,1
367875,3,20,20,0,10,1
91891,1,0,0,0,8,1
377689,2,19,7,12,15,0
289507,3,21,7,14,10,0
224824,4,11,10,1,15,0
113077,4,16,23,-7,17,1
145559,1,7,0,7,14,1
258182,4,13,13,0,13,1
170135,3,7,10,-3,8,1
110571,2,16,7,9,16,1
110160,3,13,17,-4,16,1
105133,4,33,14,19,14,0
95912,4,20,23,-3,10,1
118522,2,17,0,17,2,1
283177,4,20,9,11,7,1
222321,2,7,3,4,14,1
167480,2,0,0,0,7,0
337373,3,21,7,14,14,0
400798,2,14,7,7,8,0
12013,4,24,14,10,6,0
139097,2,6,3,3,12,1
29202,4,3,26,-23,14,1
90738,2,14,7,7,7,1
302925,2,13,3,10,16,0
211728,4,29,16,13,9,0
197315,3,17,0,17,3,0
152273,4,21,0,21,17,1
21775,4,31,24,7,11,0
312552,3,36,0,36,3,1
320805,1,0,0,0,6,0
147329,1,0,0,0,15,1
398918,3,10,10,0,7,0
29049,4,20,10,10,14,0
356295,1,14,0,14,5,0
59639,3,21,3,18,11,0
143112,4,24,24,0,13,0
35681,4,23,10,13,17,0
104527,4,14,38,-24,13,1
387864,3,10,28,-18,2,0
178292,1,0,3,-3,12,1
377012,4,15,19,-4,15,1
190910,1,6,0,6,17,1
296537,4,26,3,23,13,0
355334,4,14,23,-9,4,1
227494,3,19,10,9,16,0
151223,3,17,20,-3,17,0
71800,4,38,33,5,16,0
405487,4,24,16,8,10,1
301630,3,10,3,7,15,0
71585,2,3,14,-11,16,0
399887,2,0,3,-3,8,1
390698,3,6,3,3,3,0
414219,1,7,7,0,14,1
6357,2,0,10,-10,3,0
206460,3,17,0,17,7,1
156232,4,16,23,-7,2,1
416333,3,16,3,13,15,0
261940,1,7,3,4,14,1
337507,3,7,12,-5,14,1
294823,2,28,21,7,12,1
88166,2,14,10,4,6,0
287286,1,3,0,3,8,1
303028,4,23,19,4,16,0
170192,4,24,27,-3,8,0
106935,3,12,3,9,14,1
244894,1,0,0,0,7,1
346281,4,40,3,37,1,1
255822,3,17,0,17,12,0
27123,1,0,0,0,13,0
14574,1,0,7,-7,7,1
398636,3,0,0,0,7,0
142826,4,12,10,2,13,0
340800,3,17,16,1,15,0
334322,4,9,14,-5,13,0
160381,4,3,28,-25,4,0
197626,4,26,0,26,3,0
25328,4,39,14,25,12,1
207434,2,7,14,-7,7,1
389598,1,7,0,7,3,0
316809,4,16,7,9,4,1
137303,4,13,27,-14,11,0
201691,4,17,20,-3,5,1
339546,2,7,7,0,15,1
194497,4,23,10,13,2,1
15542,4,23,6,17,8,0
355426,3,13,10,3,4,0
266890,1,0,0,0,17,0
393006,4,12,10,2,4,1
375174,3,17,10,7,14,0
108038,1,3,7,-4,15,1
309340,1,0,0,0,1,0
327006,3,2,10,-8,9,1
146031,1,10,0,10,15,0
79054,4,10,14,-4,2,1
106137,2,0,0,0,14,1
313411,2,7,0,7,3,0
249824,1,6,3,3,9,0
206843,2,3,7,-4,7,0
373616,1,0,0,0,13,1
188768,3,0,20,-20,16,1
313265,2,3,7,-4,3,1
109986,2,17,7,10,16,0
368283,3,6,3,3,11,0
116140,2,7,3,4,1,0
195619,1,0,0,0,2,1
39768,4,9,7,2,1,0
203286,1,0,17,-17,6,1
205808,2,7,0,7,7,1
127825,4,17,41,-24,6,0
377273,3,14,6,8,15,1
263648,3,20,10,10,15,0
140038,4,28,10,18,12,0
386296,1,0,0,0,2,1
185833,1,3,0,3,15,0
62965,1,0,7,-7,12,0
163145,3,16,25,-9,5,1
312303,1,0,7,-7,3,1
143378,3,7,23,-16,14,1
1667,2,0,0,0,1,1
133483,3,20,17,3,9,1
608,1,0,0,0,1,0
379201,3,9,13,-4,16,0
410517,1,7,0,7,13,0
270606,4,20,14,6,1,1
2515,2,3,0,3,2,0
197140,3,24,20,4,3,0
236840,4,3,9,-6,3,1
84229,1,0,0,0,4,0
235423,3,28,17,11,3,1
331078,4,52,24,28,11,1
364126,3,23,3,20,9,1
268728,2,7,3,4,17,1
394603,2,17,0,17,5,0
387967,2,3,0,3,2,1
153751,3,2,21,-19,1,1
62157,3,7,14,-7,12,1
250712,4,17,22,-5,10,0
180973,3,24,21,3,13,0
344452,4,28,24,4,17,1
421393,3,16,20,-4,17,1
57287,1,0,0,0,10,0
352806,2,14,0,14,3,0
207725,2,3,13,-10,7,0
115759,4,13,16,-3,1,1
346201,2,17,0,17,1,1
376106,3,0,9,-9,14,1
39891,3,6,7,-1,1,0
241933,4,23,27,-4,5,1
161890,2,13,9,4,4,1
354773,2,13,17,-4,4,0
300736,2,7,6,1,15,1
26382,1,7,0,7,13,1
406182,1,7,0,7,11,0
83149,4,13,30,-17,4,1
3538,1,0,0,0,2,0
373729,4,13,21,-8,13,0
341732,4,26,13,13,16,1
197132,3,21,20,1,3,1
262792,4,35,17,18,15,1
150992,1,0,0,0,17,0
151584,2,0,3,-3,17,0
108570,4,17,14,3,15,1
258281,2,21,12,9,13,0
81985,2,7,0,7,3,0
344964,3,10,14,-4,17,0
397955,4,10,17,-7,7,1
378519,1,0,0,0,15,0
410901,3,14,15,-1,13,1
374584,3,20,13,7,14,1
316892,2,9,2,7,4,0
292130,2,14,0,14,11,1
10635,3,7,17,-10,5,0
183292,4,22,20,2,14,0
159689,1,7,7,0,3,0
279318,4,29,23,6,5,0
369181,4,19,20,-1,11,1
4572,4,31,32,-1,2,0
275985,1,0,0,0,3,0
173311,2,14,17,-3,10,0
193781,1,0,0,0,1,0
101075,2,7,10,-3,12,0
377331,4,24,14,10,15,0
60031,1,6,0,6,11,1
80641,2,7,16,-9,3,1
14188,3,0,31,-31,7,1
123946,2,7,0,7,5,1
123667,3,7,22,-15,4,1
151382,4,34,14,20,17,0
75749,3,28,16,12,1,0
207272,2,0,7,-7,7,0
12685,2,31,0,31,6,0
371317,2,21,10,11,12,1
100365,3,9,20,-11,12,1
340173,2,20,13,7,15,0
5445,4,20,23,-3,3,1
225272,1,0,0,0,15,0
27425,1,3,0,3,13,0
143402,4,7,26,-19,14,0
236519,3,10,9,1,3,0
11302,4,17,28,-11,6,0
279413,3,13,24,-11,5,1
98945,4,7,17,-10,11,0
361062,3,16,9,7,7,1
38528,2,24,3,21,1,0
112726,2,10,0,10,17,0
2853,3,31,24,7,2,1
227704,1,0,0,0,16,1
171386,4,16,20,-4,9,1
279238,2,13,13,0,5,1
8797,3,13,0,13,4,0
357578,4,13,13,0,5,0
29116,2,0,9,-9,14,1
306279,2,17,0,17,17,0
410569,2,10,7,3,13,0
177085,2,16,10,6,11,1
341687,3,20,13,7,16,1
207645,4,42,10,32,7,0
386609,1,0,7,-7,2,1
166523,1,0,0,0,6,0
198355,4,20,14,6,3,1
185426,3,10,10,0,15,1
411474,3,10,17,-7,13,1
220015,4,16,35,-19,13,0
249314,1,3,0,3,9,1
421138,3,30,16,14,17,0
147209,1,0,14,-14,15,1
184352,2,7,6,1,14,0
171853,4,26,20,6,9,0
336104,2,10,0,10,13,0
254698,1,3,0,3,11,0
227381,1,0,0,0,16,0
308947,1,0,3,-3,1,0
413479,4,17,38,-21,14,1
171819,4,23,17,6,9,1
218747,2,0,13,-13,13,1
10489,2,6,0,6,5,0
89028,1,0,3,-3,6,0
8136,1,0,0,0,4,1
340479,2,0,13,-13,15,0
333332,2,10,7,3,12,1
211475,2,19,7,12,9,0
407363,1,0,0,0,11,0
176493,2,9,10,-1,11,0
110226,1,0,3,-3,16,1
376811,2,14,7,7,15,0
153936,1,0,0,0,1,1
403790,4,15,16,-1,9,0
13680,1,0,0,0,7,1
408381,4,19,7,12,12,0
379185,3,9,10,-1,16,1
90085,1,0,0,0,7,0
315468,1,0,0,0,4,1
101573,3,13,31,-18,12,1
276448,1,3,7,-4,4,1
285597,3,13,10,3,8,1
54039,2,9,0,9,8,1
16103,3,33,7,26,8,0
165070,3,10,24,-14,6,1
226198,1,0,0,0,16,1
49087,4,13,13,0,6,0
267565,3,27,27,0,17,1
394437,2,7,10,-3,5,0
358316,4,0,26,-26,6,0
326261,4,17,48,-31,9,0
401547,2,14,14,0,8,0
238127,1,0,0,0,4,0
375150,2,14,10,4,14,1
102934,2,12,21,-9,13,0
98666,1,0,0,0,11,0
152408,4,35,3,32,17,1
82124,1,0,0,0,3,1
72757,2,14,0,14,16,1
187554,3,13,16,-3,16,0
113394,1,0,0,0,17,0
362362,3,22,14,8,8,1
307826,3,24,21,3,1,0
322985,4,20,0,20,7,0
56859,1,0,0,0,9,1
310463,3,17,3,14,2,0
328814,4,17,13,4,10,1
60035,1,7,0,7,11,0
317805,2,9,3,6,5,0
139574,3,9,7,2,12,0
325411,1,6,0,6,8,1
205382,3,27,0,27,6,1
1696,3,14,0,14,1,0
199495,1,7,0,7,4,1
117228,3,23,10,13,2,0
57008,2,0,10,-10,9,1
297104,3,24,0,24,13,1
296151,2,13,6,7,13,0
198326,3,6,14,-8,3,1
314327,2,7,17,-10,3,1
222249,4,13,27,-14,14,1
555,4,7,20,-13,1,1
197722,2,7,10,-3,3,0
123327,2,21,7,14,4,0
101084,2,7,10,-3,12,1
83840,2,10,3,7,4,1
335539,2,0,0,0,13,1
86871,3,9,23,-14,5,1
338734,4,27,17,10,14,1
177155,4,40,13,27,11,0
276775,2,17,10,7,4,1
246319,2,7,3,4,7,0
6998,4,10,7,3,3,1
250970,3,3,6,-3,10,0
335872,3,21,14,7,13,1
310115,2,7,0,7,2,0
412586,1,0,0,0,14,1
36419,4,34,26,8,17,0
174921,1,0,7,-7,10,1
267360,2,0,7,-7,17,0
349895,3,3,6,-3,2,0
67632,3,7,35,-28,14,0
12833,2,13,3,10,6,0
326374,3,17,10,7,9,1
126137,1,0,0,0,6,1
405495,4,24,16,8,10,0
64395,1,0,3,-3,13,1
80046,3,17,3,14,2,0
358322,4,0,27,-27,6,1
200229,1,0,0,0,4,0
3248,1,0,0,0,2,1
210211,4,10,21,-11,9,0
369799,4,52,50,2,11,0
294844,3,35,21,14,12,1
332371,4,16,20,-4,12,1
124583,3,6,17,-11,5,1
362796,2,7,21,-14,8,1
292645,3,22,16,6,11,0
307345,3,14,19,-5,17,0
280801,1,6,0,6,6,1
311119,4,13,10,3,2,0
73411,4,30,3,27,17,1
100582,1,0,0,0,12,0
198962,3,13,23,-10,3,0
105156,1,0,0,0,14,0
418715,2,0,7,-7,16,1
194338,4,17,6,11,2,1
229559,2,17,6,11,17,1
138390,1,0,0,0,12,1
326693,4,16,13,3,9,1
85111,1,0,0,0,4,0
12060,1,7,0,7,6,0
123852,4,17,3,14,5,0
15576,1,0,3,-3,8,1
240386,5,24,23,1,5,1
22017,3,14,17,-3,11,0
383353,2,0,0,0,17,1
220494,1,0,7,-7,13,0
86515,1,7,3,4,5,1
186497,3,17,20,-3,15,0
324885,3,10,13,-3,8,1
50121,3,0,17,-17,6,0
265388,4,14,19,-5,16,0
23322,2,6,10,-4,11,1
107456,2,0,10,-10,15,0
307966,3,7,6,1,1,0
229945,1,0,0,0,17,0
411497,3,13,17,-4,13,0
354238,3,20,10,10,4,0
317607,2,3,3,0,5,0
116344,4,40,13,27,1,1
18334,4,22,17,5,9,1
328746,2,14,6,8,10,0
134940,3,7,22,-15,10,1
343811,3,21,3,18,17,1
204424,2,7,10,-3,6,1
347554,4,28,37,-9,1,0
270083,2,17,10,7,1,0
216749,4,27,9,18,12,0
294391,3,16,9,7,12,1
186071,4,31,48,-17,15,0
179016,4,19,3,16,12,1
20037,3,19,6,13,10,0
101276,4,10,7,3,12,1
290528,3,14,20,-6,10,1
394256,1,0,0,0,5,0
231344,3,9,16,-7,1,0
234725,4,30,33,-3,2,1
235798,1,0,0,0,3,0
49674,3,7,14,-7,6,0
247342,4,42,48,-6,8,1
72921,2,17,7,10,16,0
179846,2,3,0,3,13,0
194506,4,26,10,16,2,0
111042,1,7,0,7,16,1
281734,4,38,38,0,6,1
236066,3,37,10,27,3,1
177169,4,40,13,27,11,0
225680,4,20,10,10,16,1
8283,1,0,0,0,4,0
301875,2,0,3,-3,15,0
174922,1,0,7,-7,10,1
5568,4,19,10,9,3,1
251163,1,0,0,0,10,1
414371,2,7,10,-3,14,1
170745,3,24,6,18,8,0
117639,2,6,13,-7,2,1
60892,4,17,26,-9,11,1
295893,3,10,14,-4,12,0
341677,2,17,13,4,16,1
136623,3,15,16,-1,11,0
361036,2,16,2,14,7,0
405774,4,10,21,-11,10,1
252010,3,14,20,-6,10,1
138449,2,14,7,7,12,0
267202,1,3,0,3,17,0
414863,3,21,7,14,15,1
267137,3,10,10,0,17,1
188476,4,10,9,1,16,0
321496,4,24,30,-6,7,0
45119,2,7,0,7,4,0
131526,2,6,12,-6,8,0
223241,3,3,6,-3,15,0
347283,2,0,7,-7,1,0
289379,4,31,25,6,9,0
269986,3,16,20,-4,1,1
182908,2,0,24,-24,14,1
348769,4,31,24,7,2,0
285969,3,29,14,15,8,0
199610,4,41,17,24,4,1
372351,4,24,17,7,13,0
81565,3,17,21,-4,3,0
268193,4,12,17,-5,17,1
120480,4,39,27,12,3,0
290576,4,26,20,6,10,1
405604,3,14,20,-6,10,1
393617,4,7,33,-26,5,1
201444,2,12,0,12,5,0
158416,4,16,27,-11,3,1
163790,4,17,12,5,5,0
395778,2,0,0,0,6,0
123429,1,0,0,0,4,0
117072,3,7,17,-10,2,0
323981,3,17,13,4,8,0
232588,1,0,0,0,1,1
196856,3,3,20,-17,3,1
201744,1,3,0,3,5,0
166537,1,3,0,3,6,1
175499,1,0,0,0,11,0
62182,4,10,17,-7,12,1
241161,4,20,10,10,5,0
180474,2,14,14,0,13,1
281262,1,7,3,4,6,0
228900,1,7,0,7,17,0
224241,1,6,3,3,15,1
245269,2,9,3,6,7,0
266681,3,32,9,23,16,0
6690,3,3,20,-17,3,0
91622,2,14,7,7,8,0
67194,3,0,3,-3,14,0
222681,3,14,24,-10,14,0
277173,1,0,0,0,4,1
297469,1,0,0,0,13,0
330654,2,6,0,6,11,0
250252,1,0,0,0,9,0
160249,1,0,0,0,4,1
268890,2,6,24,-18,17,1
29580,3,7,13,-6,14,0
81057,1,0,0,0,3,0
329090,3,17,7,10,10,0
60806,2,10,10,0,11,0
269625,2,3,0,3,1,0
294470,1,7,7,0,12,0
17825,2,13,10,3,9,0
43290,4,24,10,14,3,1
5656,2,0,14,-14,3,0
75660,4,13,6,7,17,1
165285,4,17,21,-4,6,1
22578,2,6,3,3,11,1
307434,1,14,10,4,17,1
273819,3,17,7,10,2,0
159153,4,31,7,24,3,0
213501,2,7,7,0,10,0
353603,4,38,0,38,4,1
172797,1,0,0,0,9,1
46582,2,3,0,3,4,0
156968,3,7,10,-3,2,0
170546,2,14,0,14,8,0
377503,1,0,0,0,15,0
205272,1,0,0,0,6,1
121720,3,21,21,0,4,1
399446,1,0,10,-10,7,0
109999,2,17,10,7,16,1
416912,2,3,7,-4,15,1
104294,2,24,14,10,13,1
192892,1,7,0,7,1,0
364333,4,9,39,-30,9,1
276484,2,13,7,6,4,0
88785,3,13,10,3,6,1
64765,4,28,7,21,13,1
104830,4,27,33,-6,14,1
140206,5,13,13,0,12,1
42079,3,27,10,17,2,0
42908,2,7,6,1,3,0
125318,3,17,3,14,5,0
33178,1,7,0,7,16,1
281215,4,24,16,8,6,1
2445,4,28,13,15,2,0
127818,4,17,28,-11,6,0
93258,1,7,0,7,9,1
110773,3,3,3,0,16,1
45689,1,0,0,0,4,1
145863,1,0,0,0,15,0
324810,1,3,0,3,8,1
174548,3,10,14,-4,10,1
353090,2,7,16,-9,3,0
256606,3,21,0,21,12,0
299,4,12,34,-22,1,1
267263,3,17,14,3,17,1
192685,4,13,7,6,1,0
361531,3,10,7,3,7,0
47980,2,3,24,-21,5,0
410914,3,14,15,-1,13,1
47161,2,6,0,6,5,1
180277,1,6,0,6,13,0
361245,3,14,26,-12,7,1
217901,3,17,28,-11,12,1
240907,2,14,3,11,5,0
50214,1,7,7,0,6,0
397116,1,3,0,3,6,0
169188,2,10,6,4,7,0
211414,1,0,0,0,9,0
242021,3,7,3,4,5,0
278740,1,0,0,0,5,0
147264,2,0,21,-21,15,0
327460,4,10,27,-17,9,0
96632,3,3,10,-7,10,1
79935,4,10,16,-6,2,1
381090,3,24,14,10,16,0
390,3,28,16,12,1,0
286492,1,3,0,3,8,0
99742,2,0,0,0,12,0
153366,1,0,7,-7,1,0
140481,3,21,26,-5,12,0
49481,1,0,3,-3,6,0
337219,3,16,16,0,14,1
92302,3,20,0,20,8,1
9477,3,10,3,7,5,0
307165,2,0,10,-10,17,0
371093,4,13,27,-14,12,1
323542,4,24,17,7,7,1
27081,4,17,9,8,13,1
149519,2,14,6,8,16,0
121766,4,28,52,-24,4,1
199124,3,14,31,-17,4,0
232902,1,0,3,-3,2,1
326927,2,2,0,2,9,0
238503,2,13,0,13,4,0
364332,4,9,39,-30,9,1
307041,3,17,0,17,17,0
332336,3,16,6,10,12,0
417885,4,13,10,3,16,1
361524,3,10,7,3,7,1
66187,2,24,3,21,13,1
233941,4,23,13,10,2,1
110642,3,20,10,10,16,1
206788,1,0,0,0,7,0
99679,4,26,3,23,11,0
146448,4,24,3,21,15,0
15566,1,0,0,0,8,0
12007,3,24,14,10,6,0
272798,1,7,0,7,2,0
210353,4,16,17,-1,9,0
215861,1,0,0,0,11,0
268958,4,6,36,-30,17,1
63603,2,13,20,-7,12,0
259481,3,28,10,18,13,1
70959,1,0,0,0,16,0
376329,2,3,0,3,14,1
244997,3,0,27,-27,7,1
94602,1,7,0,7,9,0
365025,3,17,6,11,9,0
5080,3,13,0,13,3,0
296354,4,13,25,-12,13,0
233101,2,8,0,8,2,0
12849,2,13,3,10,6,1
352500,1,7,6,1,3,1
25884,3,31,17,14,12,1
212558,1,6,3,3,10,1
397792,4,24,14,10,7,0
279483,1,7,6,1,5,1
168499,4,10,30,-20,7,1
124848,2,0,6,-6,5,1
288618,4,23,41,-18,9,0
142420,1,7,9,-2,13,0
175551,3,20,0,20,11,1
116559,2,3,0,3,2,0
340343,2,17,10,7,15,0
24632,1,7,0,7,12,0
192317,3,27,16,11,1,0
280613,4,20,9,11,5,1
261174,1,7,0,7,14,0
175438,4,17,23,-6,11,1
387107,2,10,21,-11,2,1
331483,3,9,23,-14,11,0
221218,1,0,10,-10,14,1
250226,4,24,23,1,9,1
95764,1,0,0,0,10,1
202835,1,7,0,7,5,1
137040,1,7,0,7,11,0
117623,2,6,10,-4,2,0
313622,4,22,30,-8,3,1
421385,2,13,20,-7,17,1
356980,3,17,3,14,5,1
147976,1,0,3,-3,15,0
293161,1,6,0,6,11,1
82618,2,3,10,-7,3,0
180933,2,10,7,3,13,1
368438,3,23,14,9,11,1
218507,4,34,17,17,13,0
119311,3,14,13,1,3,0
264325,4,17,36,-19,15,1
167076,4,13,31,-18,7,1
342068,1,3,0,3,16,0
330643,2,6,0,6,11,0
213981,2,29,7,22,10,0
49615,1,0,7,-7,6,1
322382,3,14,16,-2,7,1
170610,3,41,9,32,8,0
182494,3,21,0,21,14,0
128058,2,3,6,-3,7,0
241926,4,23,20,3,5,0
237139,4,14,40,-26,3,1
223865,3,9,6,3,15,1
376354,2,3,0,3,14,0
253004,4,18,13,5,11,1
209510,2,20,9,11,8,0
299852,2,13,0,13,14,1
254326,3,13,19,-6,11,0
95327,4,17,24,-7,10,1
78941,4,20,23,-3,2,0
80910,1,6,0,6,3,1
151546,1,0,0,0,17,0
134500,4,3,30,-27,10,0
9056,3,28,13,15,4,0
365020,3,17,6,11,9,1
130643,2,7,21,-14,8,0
271968,4,23,27,-4,2,0
229647,1,0,0,0,17,0
355763,3,10,6,4,5,0
137043,1,7,0,7,11,0
21053,4,28,34,-6,10,1
132556,2,2,29,-27,9,0
325612,2,10,7,3,9,0
387216,1,6,7,-1,2,1
331644,4,23,33,-10,11,1
266835,4,17,14,3,16,0
175166,4,35,17,18,10,1
243945,4,25,13,12,6,0
77277,4,16,10,6,1,1
12581,3,3,24,-21,6,1
379419,1,0,0,0,16,1
275786,3,16,3,13,3,0
206943,4,24,23,1,7,0
87840,2,10,7,3,6,0
309692,2,10,6,4,1,0
188980,1,0,0,0,16,1
103726,4,3,17,-14,13,1
20604,1,0,0,0,10,1
90872,2,28,0,28,7,1
373905,4,43,16,27,13,0
368847,2,23,0,23,11,1
228160,1,7,17,-10,17,1
294,4,12,34,-22,1,1
348884,4,9,14,-5,2,0
62027,3,17,7,10,12,1
26235,2,0,13,-13,13,0
96346,3,3,23,-20,10,0
114057,2,14,0,14,17,0
150636,4,10,22,-12,17,0
58903,3,6,25,-19,10,1
3772,3,20,10,10,2,0
248956,3,20,3,17,9,1
141272,4,10,24,-14,13,0
399710,1,0,3,-3,8,1
132849,3,3,14,-11,9,1
4413,4,14,14,0,2,0
190813,2,16,3,13,17,1
124122,3,10,21,-11,5,1
317932,2,7,3,4,5,1
393143,4,24,3,21,4,1
232224,3,9,12,-3,1,0
6305,4,19,17,2,3,0
315348,2,10,10,0,4,1
27614,2,7,10,-3,13,0
238505,2,13,0,13,4,0
365951,4,14,28,-14,9,0
287529,4,14,33,-19,9,0
131356,2,7,10,-3,8,0
245628,4,43,20,23,7,0
232318,2,3,3,0,1,1
248299,2,17,6,11,8,0
358779,4,14,20,-6,6,1
102753,2,3,0,3,13,1
123090,5,21,21,0,4,1
341102,3,14,17,-3,15,1
209057,2,3,10,-7,8,0
234121,1,0,0,0,2,1
46129,1,0,7,-7,4,1
295517,2,14,7,7,12,1
344527,2,0,0,0,17,0
83001,4,20,19,1,4,0
395093,4,10,31,-21,5,1
49312,1,7,3,4,6,0
296630,3,3,10,-7,13,0
141309,1,0,7,-7,13,1
286727,3,20,7,13,8,0
299938,4,16,11,5,14,1
337636,2,14,10,4,14,0
119595,3,10,9,1,3,1
59156,1,0,21,-21,10,0
5268,4,24,31,-7,3,0
383925,1,0,0,0,1,0
345646,1,0,0,0,17,1
230774,4,9,27,-18,1,1
406507,2,0,16,-16,11,1
24954,2,10,14,-4,12,0
377968,2,0,7,-7,15,1
81024,4,20,23,-3,3,1
62639,4,17,17,0,12,0
282974,2,14,3,11,6,1
113162,3,41,7,34,17,1
395054,3,0,17,-17,5,1
384564,2,3,35,-32,1,0
367430,3,20,14,6,10,0
61180,4,0,21,-21,11,0
350498,4,10,19,-9,2,0
223275,3,3,9,-6,15,1
124492,1,0,0,0,5,0
228129,4,20,10,10,17,1
126863,3,17,6,11,6,0
326545,4,44,16,28,9,1
119327,4,14,16,-2,3,1
26688,1,0,7,-7,13,1
325205,4,13,23,-10,8,0
290122,4,21,15,6,10,0
340748,1,7,7,0,15,1
297247,3,21,6,15,13,0
229443,4,10,6,4,17,0
102394,4,19,34,-15,13,1
107191,2,0,28,-28,15,1
158965,3,14,22,-8,3,0
138115,1,7,0,7,11,0
387759,4,0,37,-37,2,1
308641,1,0,0,0,1,1
3354,4,3,6,-3,2,1
60374,2,13,7,6,11,0
145181,3,46,0,46,14,0
393485,1,0,0,0,5,1
285939,3,23,7,16,8,1
367977,2,10,14,-4,11,0
225248,4,17,7,10,15,0
408052,3,10,10,0,12,0
213991,3,29,7,22,10,0
312447,4,39,41,-2,3,0
123181,2,6,21,-15,4,0
419259,1,0,0,0,16,0
102468,2,10,3,7,13,1
310006,3,6,10,-4,2,1
333655,2,7,0,7,12,0
17596,4,20,17,3,9,1
182249,1,7,0,7,14,0
208311,2,7,21,-14,8,0
161105,2,3,16,-13,4,0
24745,4,20,27,-7,12,1
194070,4,27,14,13,1,1
313945,4,28,29,-1,3,0
263085,4,10,13,-3,15,0
49100,4,13,20,-7,6,1
16758,2,3,14,-11,8,1
313345,4,13,27,-14,3,0
325822,4,6,17,-11,9,1
259929,3,20,10,10,14,1
200686,1,0,0,0,4,1
154664,4,31,28,3,1,1
346255,3,40,3,37,1,1
281737,4,41,38,3,6,0
162572,4,38,17,21,4,0
51892,2,6,10,-4,7,0
397672,1,0,0,0,7,1
262051,4,24,31,-7,14,1
47238,4,12,9,3,5,1
239761,4,13,13,0,4,1
231183,3,10,7,3,1,1
331311,3,0,24,-24,11,1
20489,2,0,0,0,10,1
256444,3,12,21,-9,12,0
158642,2,14,7,7,3,1
352393,2,28,7,21,3,1
251708,3,21,3,18,10,0
126731,4,13,13,0,6,0
296676,4,10,16,-6,13,1
19196,4,21,13,8,10,0
310141,2,14,7,7,2,1
386541,3,14,21,-7,2,0
326865,4,10,20,-10,9,1
173417,1,0,7,-7,10,0
323731,4,39,0,39,8,1
217813,1,0,7,-7,12,1
111993,3,17,21,-4,17,1
89083,3,13,6,7,6,0
323389,3,17,0,17,7,1
402523,1,0,0,0,9,1
353824,1,7,14,-7,4,1
233663,1,0,0,0,2,1
51502,4,34,24,10,7,0
261788,1,0,0,0,14,0
388951,3,17,20,-3,3,0
60229,3,10,7,3,11,0
245782,4,23,20,3,7,0
303793,4,20,17,3,16,1
320409,2,14,0,14,6,1
37986,4,17,14,3,1,1
385068,1,0,0,0,1,1
293390,3,16,10,6,11,1
269378,3,7,17,-10,1,1
403334,3,12,0,12,9,0
161267,3,20,3,17,4,0
347473,2,12,16,-4,1,1
131935,1,0,0,0,8,0
133817,4,19,17,2,9,1
58397,2,34,7,27,10,1
53627,4,14,22,-8,8,1
228886,4,9,17,-8,17,1
359720,2,17,6,11,6,0
121420,4,7,12,-5,3,1
370837,1,0,0,0,12,0
300487,3,16,3,13,14,1
201820,3,13,23,-10,5,1
334788,1,0,0,0,13,0
82412,1,0,0,0,3,0
62067,4,26,10,16,12,1
32316,1,0,0,0,15,1
164285,1,6,0,6,5,0
188392,2,3,0,3,16,0
379436,2,13,0,13,16,0
1579,4,16,13,3,1,0
307923,2,7,0,7,1,0
270733,3,6,3,3,1,0
347531,4,20,37,-17,1,1
94804,3,3,9,-6,9,1
212574,1,7,10,-3,10,1
269422,4,21,20,1,1,0
276573,1,0,0,0,4,0
185326,4,48,30,18,15,0
82929,2,3,9,-6,4,1
88407,1,0,0,0,6,0
154518,4,21,17,4,1,1
294725,4,13,20,-7,12,0
172641,1,0,0,0,9,1
43194,2,14,7,7,3,0
408108,1,0,0,0,12,0
279995,3,3,13,-10,5,1
327901,4,30,24,6,10,1
324468,4,17,6,11,8,0
389686,4,24,16,8,3,1
407036,4,11,34,-23,11,1
381130,4,24,28,-4,16,0
167992,2,3,14,-11,7,0
271182,3,14,17,-3,1,0
191073,2,7,0,7,17,0
98036,4,17,24,-7,11,1
5266,4,24,31,-7,3,1
280127,2,21,0,21,5,1
398661,3,0,3,-3,7,0
384796,1,6,3,3,1,1
204340,4,0,17,-17,6,1
176173,2,14,14,0,11,0
179114,3,9,6,3,12,0
258189,4,20,13,7,13,0
153792,4,2,27,-25,1,1
111408,3,0,17,-17,16,1
184068,2,6,0,6,14,0
142569,1,0,3,-3,13,0
157432,3,9,10,-1,2,0
246340,3,14,10,4,7,0
7454,3,20,6,14,4,1
61286,3,28,14,14,11,0
418227,1,0,0,0,16,1
18910,4,9,13,-4,9,0
201283,2,14,0,14,5,0
403299,2,6,0,6,9,0
225271,1,0,0,0,15,0
171349,3,16,9,7,9,0
401752,4,24,14,10,8,1
77604,1,0,7,-7,1,0
178897,1,0,0,0,12,0
239393,2,6,7,-1,4,0
198887,1,3,13,-10,3,0
221792,4,13,27,-14,14,0
106669,4,46,16,30,14,1
349350,4,30,42,-12,2,0
276413,4,32,44,-12,3,1
10903,1,3,7,-4,5,1
260499,2,20,0,20,14,0
77788,2,7,14,-7,1,0
299694,2,17,3,14,14,1
304234,3,33,14,19,16,1
48524,1,11,0,11,5,1
127579,1,0,9,-9,6,0
57734,1,0,0,0,10,1
77389,3,14,14,0,1,0
278216,3,24,21,3,4,1
248205,4,12,10,2,8,0
353054,1,7,6,1,3,0
220573,3,10,23,-13,13,0
372230,4,15,25,-10,13,0
120284,3,17,13,4,3,1
196430,3,20,7,13,2,0
271424,2,14,0,14,1,1
124109,3,3,21,-18,5,0
7090,2,21,14,7,4,1
354459,2,14,21,-7,4,1
382798,2,21,0,21,17,0
217329,3,7,10,-3,12,0
260798,2,3,12,-9,14,1
389936,2,25,10,15,3,0
255004,1,0,9,-9,12,1
229597,4,30,13,17,17,1
36318,2,7,7,0,17,0
56511,1,10,0,10,9,0
237650,2,3,7,-4,4,0
174298,1,7,0,7,10,1
179549,2,0,23,-23,12,0
76641,2,10,0,10,1,1
29917,4,23,26,-3,14,0
25075,1,3,0,3,12,0
78570,2,16,7,9,2,0
272119,4,17,9,8,2,1
36686,4,20,3,17,17,0
216669,2,14,6,8,12,1
44432,3,17,0,17,3,0
408219,4,13,3,10,12,1
46284,1,0,7,-7,4,0
119256,2,7,3,4,3,0
176868,4,17,16,1,11,1
341684,3,20,13,7,16,1
200734,2,17,0,17,4,0
205763,1,7,0,7,7,1
100839,4,12,19,-7,12,1
81105,2,10,14,-4,3,0
361014,2,9,2,7,7,0
264422,3,3,28,-25,15,1
108563,3,17,14,3,15,0
343866,4,24,6,18,17,0
206039,1,0,0,0,7,0
92079,1,3,7,-4,8,0
169525,3,3,28,-25,8,1
111521,2,7,3,4,16,1
73872,4,13,7,6,17,1
327247,2,6,10,-4,9,1
284353,3,14,17,-3,7,0
309001,3,0,17,-17,1,0
97031,2,19,0,19,10,1
18309,3,16,17,-1,9,0
160690,3,10,0,10,4,0
182594,2,0,6,-6,14,0
179861,2,3,9,-6,13,1
136760,3,13,10,3,11,0
301737,2,0,10,-10,15,0
323870,4,16,30,-14,8,0
220129,3,26,13,13,13,1
260707,4,13,25,-12,14,0
285776,2,7,10,-3,8,0
417510,3,24,21,3,16,1
226689,1,7,3,4,16,1
388355,4,17,12,5,2,1
354831,4,23,28,-5,4,1
15628,2,20,10,10,8,1
330706,4,6,6,0,11,0
93688,1,0,0,0,9,1
233723,2,13,21,-8,2,0
263033,3,10,3,7,15,1
175836,2,20,16,4,11,0
107011,1,7,0,7,15,1
42204,2,14,0,14,2,1
190780,2,6,3,3,17,1
363878,4,13,29,-16,8,1
26893,2,10,6,4,13,0
170835,1,7,0,7,8,0
257369,3,17,0,17,13,1
144616,4,20,22,-2,14,1
197975,2,0,10,-10,3,0
372783,3,3,0,3,13,1
337647,3,14,13,1,14,1
420658,3,21,16,5,17,1
174034,2,0,19,-19,10,1
299293,3,26,7,19,14,0
77184,1,0,0,0,1,0
133644,3,10,21,-11,9,1
70776,4,20,24,-4,15,0
252182,3,20,17,3,10,1
80352,2,19,6,13,2,1
49493,2,7,3,4,6,0
348881,4,6,14,-8,2,1
358188,4,20,17,3,6,1
197639,4,33,0,33,3,0
397978,4,17,27,-10,7,0
105292,4,10,26,-16,14,1
124831,2,0,3,-3,5,0
411566,1,0,10,-10,13,1
381936,2,0,13,-13,17,1
236369,3,7,23,-16,3,1
286340,1,0,0,0,8,0
397526,1,0,0,0,7,1
388376,4,17,20,-3,2,1
106749,2,14,15,-1,14,1
155309,1,7,0,7,2,0
120799,1,0,0,0,3,0
161692,1,7,0,7,4,1
318704,2,3,20,-17,5,1
217125,2,0,9,-9,12,1
190435,4,13,13,0,17,1
129858,2,10,0,10,7,0
397223,4,13,0,13,6,1
25562,2,23,7,16,12,1
281549,4,20,16,4,6,0
375093,1,0,0,0,14,1
116169,3,7,13,-6,1,1
357056,1,6,7,-1,5,0
305015,4,24,27,-3,16,1
363223,2,14,7,7,8,0
137700,2,0,13,-13,11,0
192118,2,0,6,-6,1,0
355323,4,14,20,-6,4,0
233714,2,7,21,-14,2,0
31539,4,10,17,-7,15,0
195983,4,7,27,-20,2,0
343775,2,7,3,4,17,0
288128,3,16,7,9,9,1
45601,2,7,13,-6,4,1
401573,3,17,14,3,8,0
355768,4,10,6,4,5,0
131136,4,27,9,18,8,0
284696,4,17,34,-17,7,1
288002,4,20,16,4,9,1
206203,1,0,3,-3,7,1
212017,3,10,23,-13,9,0
221480,4,3,41,-38,14,1
297593,4,21,7,14,13,1
337468,2,7,9,-2,14,1
293033,2,9,13,-4,11,1
112837,2,7,0,7,17,0
407014,4,3,34,-31,11,1
17699,3,14,6,8,9,0
264162,4,27,27,0,15,1
37950,3,10,14,-4,1,0
9647,3,12,21,-9,5,1
367670,2,0,3,-3,10,1
184992,4,14,20,-6,15,0
355543,2,14,0,14,5,0
30720,2,17,21,-4,15,1
89198,2,3,0,3,7,0
186260,1,6,3,3,15,1
301004,1,3,3,0,15,1
387084,2,7,21,-14,2,1
164924,3,0,6,-6,6,0
339856,2,16,0,16,15,0
124714,2,3,3,0,5,0
378549,2,7,6,1,15,1
356676,2,19,10,9,5,0
62268,2,21,7,14,12,0
397283,2,0,14,-14,6,0
114573,1,0,0,0,1,0
287506,3,14,26,-12,9,1
46042,2,14,14,0,4,1
144186,1,0,7,-7,14,1
257595,5,19,20,-1,13,0
246928,2,20,7,13,8,0
130291,1,0,0,0,8,1
403868,2,10,0,10,10,0
110972,4,7,20,-13,16,0
164442,1,13,0,13,5,1
141710,3,23,21,2,13,1
63706,1,7,0,7,12,0
227872,2,10,6,4,16,1
235485,1,0,0,0,3,1
81749,4,31,17,14,3,0
324384,2,7,3,4,8,0
280551,2,14,3,11,5,1
101025,1,0,0,0,12,0
152630,2,7,6,1,17,0
94740,1,0,0,0,9,1
340553,4,7,42,-35,15,0
198056,4,3,30,-27,3,1
276013,1,3,0,3,3,1
362697,4,3,13,-10,8,1
92639,4,20,10,10,8,0
232453,1,3,0,3,1,0
310551,1,0,6,-6,2,1
132796,1,0,0,0,9,1
412774,2,14,10,4,14,0
208129,2,0,0,0,8,0
155770,4,30,30,0,2,1
213673,2,14,14,0,10,0
155727,3,20,20,0,2,0
214958,4,7,26,-19,11,1
399404,4,37,10,27,7,1
383229,2,21,3,18,17,1
373970,2,7,0,7,13,1
252302,2,0,16,-16,10,1
186925,2,7,6,1,15,1
158043,2,3,6,-3,3,0
66954,4,18,7,11,14,1
333654,2,7,0,7,12,0
284410,1,0,0,0,7,1
281932,2,7,7,0,6,0
330128,4,0,13,-13,11,1
54688,4,34,29,5,8,0
11945,2,0,0,0,6,1
298669,2,6,7,-1,14,1
250638,2,3,9,-6,10,0
56598,3,19,17,2,9,1
192411,1,0,14,-14,1,0
225297,1,0,14,-14,15,1
388417,1,0,6,-6,2,1
170850,2,7,0,7,8,0
351389,3,10,13,-3,3,1
79053,4,10,14,-4,2,1
333043,2,3,12,-9,12,1
211407,4,10,13,-3,9,1
354555,4,36,31,5,4,0
83709,3,22,20,2,4,0
349452,3,6,20,-14,2,0
362029,1,0,7,-7,8,1
274483,1,7,0,7,3,0
76214,3,12,26,-14,1,0
321767,3,18,6,12,7,0
206437,3,16,0,16,7,1
137771,4,10,37,-27,11,0
28820,2,10,0,10,14,0
251066,2,7,14,-7,10,1
28995,3,7,7,0,14,0
371488,4,14,24,-10,12,1
165761,1,0,0,0,6,0
275245,1,3,0,3,3,0
204818,1,0,0,0,6,0
184303,4,37,14,23,14,0
280852,2,10,3,7,6,0
115315,4,20,15,5,1,0
34471,4,38,3,35,16,1
175081,1,7,3,4,10,0
200259,2,10,7,3,4,0
198915,2,6,16,-10,3,0
408991,4,31,31,0,12,1
333075,3,10,12,-2,12,1
418193,4,24,6,18,16,1
245706,2,3,10,-7,7,1
395847,4,3,17,-14,6,1
349090,1,7,0,7,2,1
81507,2,0,14,-14,3,0
238913,1,7,0,7,4,0
350634,3,13,3,10,2,0
218576,2,7,17,-10,13,1
97174,1,0,3,-3,10,1
178593,1,0,3,-3,12,1
13939,4,24,14,10,7,1
197152,3,27,20,7,3,0
179427,3,6,20,-14,12,1
360018,2,3,26,-23,7,0
174343,2,17,0,17,10,1
136819,4,20,13,7,11,0
36389,4,13,26,-13,17,1
343034,2,6,0,6,16,0
87826,2,10,7,3,6,1
63293,2,3,0,3,12,1
52702,3,3,20,-17,7,1
14224,4,0,38,-38,7,1
186327,3,26,10,16,15,1
268749,2,17,3,14,17,1
155312,1,7,0,7,2,0
47942,1,0,14,-14,5,0
187222,2,0,6,-6,16,0
309695,2,10,6,4,1,0
359377,4,13,20,-7,6,0
176482,2,0,10,-10,11,1
97248,3,12,13,-1,10,0
136715,2,6,10,-4,11,1
329210,2,17,13,4,10,0
212740,2,10,14,-4,10,0
153808,1,0,0,0,1,1
418565,2,14,3,11,16,0
166959,4,19,9,10,6,1
337368,3,20,7,13,14,1
46622,3,3,0,3,4,0
243166,4,23,22,1,6,1
237557,4,31,14,17,3,1
44016,4,3,28,-25,3,1
7087,2,21,14,7,4,0
337550,4,7,33,-26,14,0
33509,2,14,0,14,16,1
314353,3,10,17,-7,3,1
265992,4,0,33,-33,16,1
129957,1,0,0,0,8,1
361790,2,21,7,14,7,0
64013,2,17,3,14,13,0
93991,2,0,14,-14,9,1
75941,4,32,7,25,1,0
131386,2,7,13,-6,8,1
404190,3,9,9,0,10,0
403685,1,3,0,3,9,0
209624,4,50,34,16,8,1
257901,4,16,19,-3,13,1
410449,3,9,20,-11,13,1
247202,1,0,0,0,8,0
377504,1,0,0,0,15,0
7083,2,14,14,0,4,1
407469,4,17,10,7,11,0
110697,1,0,3,-3,16,1
249250,3,19,14,5,9,0
231924,3,7,41,-34,1,1
382621,1,0,0,0,17,1
314890,2,0,0,0,4,0
235824,1,0,7,-7,3,0
194791,3,10,22,-12,2,0
320243,2,14,0,14,6,0
224203,4,0,23,-23,15,0
100454,1,0,7,-7,12,1
14354,4,2,14,-12,7,0
380950,3,9,7,2,16,0
193490,4,33,20,13,1,0
331024,3,39,10,29,11,1
384206,4,32,20,12,1,0
367194,4,29,23,6,10,0
53207,1,0,0,0,8,1
124765,4,3,9,-6,5,1
144443,3,9,26,-17,14,1
336227,1,3,0,3,13,0
195401,3,24,3,21,2,0
91087,4,9,0,9,7,0
24708,3,20,14,6,12,1
302744,1,0,3,-3,15,1
336366,1,0,0,0,14,0
237925,4,14,27,-13,4,0
112121,3,7,20,-13,17,1
154477,3,14,10,4,1,1
314541,4,27,10,17,3,0
192503,3,14,17,-3,1,1
173074,4,24,19,5,9,1
78232,1,0,0,0,2,1
392238,4,10,16,-6,4,1
49063,3,10,13,-3,6,0
209028,2,3,0,3,8,1
421863,3,7,19,-12,17,1
333222,3,3,7,-4,12,1
93581,2,6,3,3,9,0
114370,3,31,13,18,1,1
350872,2,0,7,-7,3,0
162869,4,13,3,10,5,0
379713,2,6,0,6,16,0
29666,1,0,0,0,14,0
285853,4,14,30,-16,8,1
258086,2,13,6,7,13,0
34920,4,27,24,3,16,0
236558,4,10,9,1,3,0
110533,1,0,0,0,16,1
160105,1,0,0,0,3,1
12810,2,3,3,0,6,0
352298,4,6,6,0,3,0
217575,2,3,9,-6,12,0
46785,3,14,27,-13,4,1
118461,4,26,10,16,2,1
151457,2,21,7,14,17,1
67969,4,36,13,23,14,0
406958,2,3,13,-10,11,0
396242,2,0,3,-3,6,1
246941,2,20,7,13,8,1
70724,2,7,10,-3,15,1
197621,4,26,0,26,3,0
131468,1,0,0,0,8,0
135277,4,24,17,7,10,0
149750,4,48,0,48,16,1
56393,1,0,21,-21,9,1
30663,1,0,0,0,15,1
43557,3,24,3,21,3,0
179656,5,31,30,1,12,1
15158,1,0,0,0,8,1
198240,4,16,9,7,3,1
21442,3,12,14,-2,11,0
382958,3,3,13,-10,17,0
403696,1,3,3,0,9,0
398710,1,0,14,-14,7,1
108636,1,6,0,6,15,1
360537,1,0,7,-7,7,1
136586,2,12,13,-1,11,0
131685,2,10,22,-12,8,0
79079,4,19,21,-2,2,1
210563,1,6,7,-1,9,0
320695,2,14,17,-3,6,0
61777,1,0,7,-7,12,0
334147,3,16,7,9,13,1
56340,4,3,33,-30,9,1
136326,4,18,7,11,11,1
225999,4,34,20,14,16,0
152202,2,14,0,14,17,1
329617,2,10,7,3,11,1
12193,1,0,0,0,6,0
27009,2,10,0,10,13,1
120833,2,7,14,-7,3,1
371667,4,24,17,7,12,1
355785,4,10,9,1,5,0
173010,2,14,0,14,9,1
288052,1,7,0,7,9,0
58331,1,0,0,0,10,1
361133,4,23,23,0,7,1
3121,2,0,6,-6,2,1
132934,4,13,21,-8,9,0
349266,2,7,21,-14,2,0
80209,3,21,24,-3,2,1
136705,2,6,10,-4,11,0
62058,4,26,10,16,12,1
47806,2,7,6,1,5,0
13401,1,3,7,-4,7,1
45080,4,23,20,3,4,1
83184,1,3,0,3,4,0
236511,3,7,9,-2,3,1
121153,2,0,13,-13,3,1
81322,1,0,0,0,3,0
20979,2,14,24,-10,10,0
48991,1,3,7,-4,6,0
380344,2,7,7,0,16,1
415368,4,21,24,-3,15,0
91064,4,9,0,9,7,1
122757,4,10,27,-17,4,1
170576,2,21,6,15,8,1
227116,1,0,0,0,16,1
38346,2,7,6,1,1,0
391513,1,7,14,-7,4,0
299764,4,17,6,11,14,0
192201,4,3,26,-23,1,0
174005,1,0,6,-6,10,0
78221,1,0,0,0,2,1
145198,4,49,0,49,14,1
181435,3,24,24,0,13,0
20331,2,10,13,-3,10,0
220827,2,7,7,0,14,0
88528,4,19,14,5,6,0
304566,4,25,31,-6,16,1
316507,1,0,0,0,4,1
249208,2,9,7,2,9,1
94672,3,17,29,-12,9,1
184786,2,17,14,3,15,0
164655,4,14,20,-6,5,1
178315,2,7,3,4,12,1
288311,1,0,0,0,9,0
122799,1,7,0,7,4,0
358072,1,6,0,6,6,1
236843,4,3,9,-6,3,1
106620,3,34,7,27,14,1
403740,2,12,3,9,9,0
395003,1,0,7,-7,5,0
114354,2,24,13,11,1,0
177413,3,17,10,7,11,1
149182,5,31,31,0,16,0
223551,3,10,13,-3,15,1
405750,3,10,7,3,10,0
119570,2,10,0,10,3,0
29682,1,0,0,0,14,1
281958,2,14,14,0,6,0
323270,4,7,17,-10,7,0
27350,3,24,10,14,13,1
290162,1,3,0,3,10,1
317050,2,7,10,-3,4,1
97422,4,16,29,-13,10,0
355744,3,7,6,1,5,0
27040,3,10,3,7,13,0
347863,1,0,0,0,1,0
277415,3,31,9,22,4,1
244838,3,7,3,4,7,0
361460,1,7,0,7,7,1
338132,4,12,7,5,14,1
404033,2,3,28,-25,10,1
99403,1,0,0,0,11,0
153470,4,23,17,6,1,1
85593,1,0,0,0,5,1
241160,4,20,10,10,5,0
203007,2,14,0,14,5,0
393380,2,21,14,7,5,1
345343,1,0,0,0,17,0
342707,2,0,7,-7,16,1
297662,2,7,3,4,13,0
310492,3,20,9,11,2,1
68325,2,3,0,3,14,0
334665,2,2,3,-1,13,1
351791,2,17,14,3,3,1
229909,4,27,14,13,17,0
202471,3,9,10,-1,5,0
182109,1,9,0,9,13,0
75808,4,42,26,16,1,0
139775,1,0,0,0,12,0
379093,4,7,12,-5,15,0
77429,4,27,21,6,1,0
398388,4,3,27,-24,7,0
77255,3,16,7,9,1,0
253292,4,10,13,-3,11,0
3235,1,0,0,0,2,1
321774,3,18,6,12,7,0
233896,3,14,6,8,2,0
36001,4,6,28,-22,17,0
280123,2,21,0,21,5,0
116971,1,0,0,0,2,0
230710,2,6,27,-21,1,1
330011,4,7,19,-12,11,1
196029,1,0,7,-7,2,1
176743,4,39,19,20,11,0
352033,4,31,21,10,3,0
107463,2,0,17,-17,15,1
314510,3,21,0,21,3,0
46994,2,7,0,7,5,0
62805,4,17,0,17,12,1
399034,2,10,12,-2,7,0
254047,4,14,20,-6,11,1
266640,2,16,3,13,16,0
252752,2,3,3,0,11,0
294505,2,17,10,7,12,0
44797,4,16,19,-3,3,1
366624,4,26,14,12,10,0
387866,3,10,28,-18,2,0
298594,4,13,10,3,14,1
175052,1,0,0,0,10,1
36288,1,0,0,0,17,1
92833,2,14,0,14,8,1
45979,4,20,3,17,4,0
84823,1,0,0,0,4,0
351176,1,14,0,14,3,0
62022,3,16,7,9,12,1
347609,2,14,10,4,1,0
341971,2,6,0,6,16,1
146521,2,7,10,-3,15,0
410531,1,7,7,0,13,1
35278,1,3,0,3,16,0
118433,3,20,10,10,2,0
228858,4,9,17,-8,17,0
64735,3,21,0,21,13,1
239783,4,20,20,0,4,1
304120,4,16,30,-14,16,0
68377,3,3,14,-11,14,0
292425,2,3,0,3,11,1
69279,2,13,0,13,15,0
313157,2,10,13,-3,3,1
107584,1,6,7,-1,15,0
204053,1,0,0,0,6,0
347975,4,0,24,-24,1,1
344779,2,0,0,0,17,1
285460,4,33,8,25,8,1
192549,4,24,17,7,1,0
334211,1,3,0,3,13,0
370632,3,14,14,0,12,1
187193,1,0,0,0,16,0
32671,2,7,0,7,15,0
128631,2,3,10,-7,7,1
322442,1,6,0,6,7,1
272057,2,10,3,7,2,0
380810,3,9,21,-12,16,0
283685,1,0,0,0,7,1
256013,4,19,12,7,12,1
199778,1,3,3,0,4,0
37974,4,17,14,3,1,1
16976,4,27,23,4,8,0
136462,3,10,13,-3,11,1
220930,1,0,0,0,14,0
316663,4,12,12,0,4,1
368127,2,7,7,0,11,1
225741,1,3,7,-4,16,1
293451,1,0,0,0,11,0
315298,5,20,19,1,4,1
185013,4,14,29,-15,15,0
158180,2,7,0,7,3,1
216680,2,21,6,15,12,0
69150,3,14,17,-3,15,0
346219,3,26,0,26,1,0
248925,3,17,3,14,9,0
376655,2,3,0,3,14,1
247579,3,16,16,0,8,0
145939,3,7,14,-7,15,0
352872,4,14,13,1,3,0
305646,1,3,0,3,17,0
262199,4,31,16,15,15,1
57075,4,13,27,-14,9,1
350247,4,34,0,34,2,0
83289,4,22,10,12,4,0
101414,3,15,7,8,12,1
102162,2,14,7,7,13,0
291015,4,20,13,7,10,0
171780,2,19,14,5,9,1
319572,1,0,0,0,6,1
417227,3,17,20,-3,16,1
322729,1,0,14,-14,7,1
105847,3,16,3,13,14,0
3942,3,19,14,5,2,1
79448,3,9,14,-5,2,0
382612,1,0,0,0,17,1
61003,3,34,16,18,11,1
317105,4,20,17,3,4,0
21761,4,31,17,14,11,0
283191,4,26,9,17,7,1
293714,4,10,13,-3,12,1
225554,4,8,24,-16,15,1
213278,4,17,27,-10,10,1
90654,4,20,33,-13,7,1
341332,2,0,10,-10,16,1
362514,3,14,6,8,8,0
350263,1,0,0,0,2,1
28039,1,7,7,0,13,1
196980,2,20,7,13,3,0
131225,2,14,17,-3,8,0
168079,4,6,24,-18,7,1
386119,4,24,9,15,1,0
167744,4,26,23,3,7,1
134664,4,34,24,10,10,1
212551,1,0,3,-3,10,1
107431,1,0,3,-3,15,1
248858,1,0,0,0,9,1
57703,4,24,24,0,10,0
91192,3,10,17,-7,8,0
88579,1,3,7,-4,6,1
28468,1,10,0,10,14,1
55915,1,0,0,0,9,1
380208,2,13,9,4,16,0
40385,4,15,10,5,2,1
76203,3,12,20,-8,1,0
314208,3,14,20,-6,3,1
109897,3,23,0,23,16,0
102695,4,32,28,4,13,0
234880,4,3,18,-15,2,0
294861,4,42,21,21,12,1
112807,1,0,0,0,17,1
143742,1,0,0,0,14,1
10538,3,34,0,34,5,0
240624,3,20,14,6,5,0
14262,1,0,7,-7,7,1
10599,2,0,10,-10,5,1
91792,2,10,0,10,8,1
397794,4,24,14,10,7,0
270002,4,19,20,-1,1,0
363782,1,0,7,-7,8,1
153686,2,2,14,-12,1,0
137663,1,0,7,-7,11,1
402716,2,10,0,10,9,1
328595,2,10,14,-4,10,1
367021,3,10,31,-21,10,0
166515,4,23,27,-4,6,1
193871,3,24,7,17,1,1
356566,4,9,6,3,5,0
4811,4,27,3,24,3,1
179106,2,9,6,3,12,0
144449,4,10,26,-16,14,0
46341,3,6,17,-11,4,0
325156,2,13,14,-1,8,1
311036,2,10,0,10,2,0
210059,4,17,17,0,8,0
329103,3,17,7,10,10,1
88007,2,17,0,17,6,0
262277,2,3,9,-6,15,1
324309,3,25,7,18,8,0
420820,3,10,10,0,17,1
220615,4,16,29,-13,13,0
192919,2,7,7,0,1,0
353795,1,6,0,6,4,1
80680,4,17,26,-9,3,1
141928,1,7,0,7,13,1
281356,4,21,13,8,6,1
89072,2,6,6,0,6,1
310931,3,3,9,-6,2,1
222573,1,0,0,0,14,0
176669,2,26,12,14,11,0
204330,4,0,17,-17,6,1
374126,2,13,7,6,13,0
7508,4,29,6,23,4,1
169222,3,10,6,4,7,1
21013,3,14,24,-10,10,1
109231,2,6,0,6,15,1
31961,4,16,13,3,15,1
160380,4,3,28,-25,4,0
143837,4,12,7,5,14,0
203245,4,10,24,-14,5,1
281745,1,0,0,0,6,0
41010,2,3,10,-7,2,1
82545,4,17,27,-10,3,0
383866,4,3,7,-4,1,1
411062,4,17,17,0,13,0
176784,1,3,6,-3,11,0
8767,2,6,0,6,4,0
187489,1,0,3,-3,16,1
314084,4,30,14,16,3,0
306795,4,19,33,-14,17,0
164475,2,17,0,17,5,0
315290,5,20,19,1,4,1
419705,2,0,3,-3,17,0
40693,1,7,7,0,2,0
48980,1,3,6,-3,6,0
399223,3,13,13,0,7,0
118515,2,17,0,17,2,0
382373,2,0,14,-14,17,1
404445,2,14,0,14,10,0
183202,1,0,0,0,14,1
298477,1,7,0,7,14,1
287971,3,17,13,4,9,1
196993,3,20,17,3,3,1
31860,1,0,0,0,15,1
149937,1,7,0,7,16,0
100601,1,0,0,0,12,0
75810,4,42,26,16,1,0
148428,2,7,0,7,16,1
381029,1,7,3,4,16,0
73229,3,7,9,-2,16,0
86222,1,0,7,-7,5,0
182947,3,10,37,-27,14,1
241073,1,7,0,7,5,0
357176,4,12,20,-8,5,0
167367,3,29,23,6,7,1
201972,3,3,0,3,5,0
365474,4,10,19,-9,9,1
201508,3,25,7,18,5,1
7632,4,28,3,25,4,1
213940,2,16,7,9,10,1
123110,1,0,0,0,4,1
32829,3,6,7,-1,15,0
22490,4,31,29,2,11,1
70721,2,7,10,-3,15,1
303443,3,19,7,12,16,0
417116,4,34,0,34,15,0
257853,3,7,12,-5,13,1
315524,3,7,3,4,4,0
396617,4,20,10,10,6,1
278896,1,0,7,-7,5,1
51455,2,10,24,-14,7,1
221546,2,20,12,8,14,0
182815,3,26,10,16,14,0
283547,2,6,7,-1,7,0
270751,4,6,3,3,1,0
263495,3,20,23,-3,15,1
365277,2,10,13,-3,9,0
89643,1,3,3,0,7,0
392673,3,16,0,16,4,0
267492,1,3,14,-11,17,1
307931,2,7,3,4,1,0
406993,3,3,20,-17,11,1
133994,1,0,0,0,9,0
254901,2,17,7,10,12,0
373460,1,0,0,0,13,1
5612,1,0,7,-7,3,1
99990,4,17,19,-2,12,1
271211,4,21,23,-2,1,1
143469,2,14,14,0,14,1
356269,1,0,0,0,5,1
235541,2,3,13,-10,3,1
117557,4,17,20,-3,2,0
404444,2,14,0,14,10,0
420732,1,0,0,0,17,1
185605,3,13,20,-7,15,0
187102,3,10,0,10,16,0
87249,2,10,14,-4,6,0
421163,4,44,16,28,17,1
161127,3,3,19,-16,4,1
374494,1,0,0,0,14,1
23672,4,7,27,-20,12,1
185309,4,41,22,19,15,0
198686,4,15,21,-6,3,0
271233,1,0,0,0,1,0
384009,3,10,16,-6,1,0
5657,2,0,14,-14,3,0
234906,1,0,0,0,2,1
160365,4,3,21,-18,4,0
49395,4,10,20,-10,6,1
73659,3,10,0,10,17,1
242409,1,0,0,0,6,0
414586,3,21,9,12,14,0
1325,1,0,0,0,1,1
59611,2,14,3,11,11,1
59454,2,3,10,-7,11,0
84106,1,0,0,0,4,1
236784,2,0,9,-9,3,1
154607,3,14,14,0,1,1
339865,2,22,0,22,15,1
205951,2,6,3,3,7,0
353902,3,17,28,-11,4,1
89612,1,0,0,0,7,0
17125,4,29,17,12,9,1
16276,4,19,23,-4,8,0
92643,1,0,0,0,8,0
411338,3,17,10,7,13,0
174532,3,7,14,-7,10,1
18701,1,0,7,-7,9,1
102207,3,24,7,17,13,0
31651,3,24,9,15,15,1
243438,3,3,17,-14,6,1
220891,4,28,38,-10,14,0
388397,1,0,0,0,2,0
3901,2,19,7,12,2,1
74728,4,7,17,-10,17,0
191772,4,22,24,-2,17,0
173368,4,31,27,4,10,1
6430,4,9,20,-11,3,1
13546,1,0,0,0,7,1
365840,1,7,0,7,9,0
169408,4,6,28,-22,8,1
121329,2,0,0,0,3,0
51990,1,0,7,-7,7,1
375667,3,17,20,-3,14,1
38301,4,19,14,5,1,1
372824,4,6,0,6,13,1
166788,4,20,16,4,6,1
62050,4,24,10,14,12,1
59056,3,3,10,-7,10,0
147429,3,23,10,13,15,0
163800,4,17,12,5,5,0
287079,4,26,24,2,8,0
80505,2,5,3,2,3,0
251324,1,7,7,0,10,1
254613,3,20,14,6,11,1
248543,5,23,26,-3,8,1
142500,3,27,10,17,13,0
387361,2,21,6,15,2,0
20868,4,28,9,19,10,0
86416,2,20,7,13,5,1
105686,2,28,3,25,14,0
412737,1,0,7,-7,14,1
397913,3,7,9,-2,7,0
117691,3,27,13,14,2,0
421705,3,17,10,7,17,1
143013,1,0,0,0,13,0
97563,4,30,7,23,10,1
354780,2,13,17,-4,4,1
90914,3,41,7,34,7,1
174512,2,7,7,0,10,1
247877,2,10,3,7,8,1
396518,1,14,7,7,6,1
5169,1,0,0,0,3,0
27093,4,17,9,8,13,1
349033,4,14,16,-2,2,0
248399,1,10,0,10,8,0
173871,1,6,7,-1,10,1
189342,3,10,10,0,16,1
196441,4,20,21,-1,2,1
327552,2,7,15,-8,10,0
123712,4,10,32,-22,4,1
307127,1,0,0,0,17,0
302528,3,3,13,-10,15,0
213549,3,10,14,-4,10,0
152192,2,14,0,14,17,0
265266,4,9,6,3,16,0
314627,3,7,7,0,3,0
234111,1,0,0,0,2,0
341834,2,13,9,4,16,0
40810,4,17,35,-18,2,1
290602,1,7,0,7,10,0
124793,1,0,0,0,5,1
5733,1,0,0,0,3,0
40275,2,6,0,6,2,0
413697,2,14,13,1,14,0
105523,2,26,14,12,14,1
371704,2,7,14,-7,12,1
295977,1,0,0,0,13,1
74285,4,10,24,-14,17,1
301245,4,27,17,10,15,0
236107,1,0,0,0,3,0
270935,1,0,0,0,1,1
419702,2,0,3,-3,17,0
327370,2,0,7,-7,9,0
209142,4,9,30,-21,8,1
31180,3,23,27,-4,15,1
394495,3,10,25,-15,5,1
85269,1,0,0,0,5,0
197316,3,17,0,17,3,0
280349,1,0,0,0,5,1
146852,3,24,0,24,15,1
151143,1,3,10,-7,17,1
318025,4,17,16,1,5,1
266190,2,21,0,21,16,0
33495,2,14,0,14,16,0
363233,2,14,7,7,8,1
316910,2,9,15,-6,4,1
61719,3,24,24,0,12,1
409624,1,0,0,0,12,0
201366,4,28,15,13,5,0
9170,2,3,13,-10,5,0
233311,3,7,23,-16,2,0
27769,2,14,14,0,13,1
28611,1,0,0,0,14,0
235366,1,14,7,7,3,1
145593,2,21,0,21,14,0
283429,2,20,7,13,7,0
395383,3,28,3,25,5,1
337950,3,20,0,20,14,1
406329,1,0,7,-7,11,1
335370,4,3,23,-20,13,1
328504,4,9,3,6,10,1
96928,3,22,7,15,10,1
297744,4,30,23,7,13,1
157530,1,0,0,0,2,0
285621,4,20,17,3,8,0
315229,3,17,10,7,4,1
417055,2,17,0,17,15,1
390541,3,17,7,10,3,0
318800,1,0,0,0,5,1
308177,1,0,0,0,1,0
340454,1,0,12,-12,15,0
85925,2,7,14,-7,5,0
74552,3,0,3,-3,17,1
85612,1,7,0,7,5,1
333395,3,20,10,10,12,1
201208,4,20,24,-4,5,1
147072,1,7,14,-7,15,0
162067,3,21,13,8,4,1
419468,2,10,6,4,16,0
416169,2,10,9,1,15,0
321625,3,17,13,4,7,1
362555,4,26,12,14,8,0
31366,3,7,3,4,15,0
49475,1,0,0,0,6,0
297739,4,24,23,1,13,1
363043,1,0,0,0,8,0
99917,2,10,3,7,12,0
128237,3,20,7,13,7,1
353644,1,3,0,3,4,0
367121,2,21,13,8,10,1
75055,1,0,0,0,17,1
413916,4,20,9,11,14,0
66443,1,0,7,-7,14,1
255465,1,7,0,7,12,0
302069,2,20,24,-4,15,0
317313,1,0,0,0,5,1
229884,3,20,14,6,17,0
395916,1,10,0,10,6,1
344308,4,19,13,6,17,1
260373,3,6,0,6,14,1
387386,2,21,7,14,2,0
383179,1,0,0,0,17,1
109043,4,23,34,-11,15,0
376373,3,6,0,6,14,1
342162,4,15,19,-4,16,1
216981,2,3,3,0,12,1
224105,1,0,0,0,15,0
300569,1,0,0,0,15,0
161480,3,10,6,4,4,1
215297,2,7,0,7,11,0
88253,1,0,0,0,6,1
179703,1,0,0,0,12,0
261884,4,6,20,-14,14,1
299094,2,3,3,0,14,1
179434,3,13,20,-7,12,0
283717,2,0,0,0,7,0
91143,2,3,13,-10,8,0
234120,1,0,0,0,2,1
59670,4,21,6,15,11,1
4321,2,0,7,-7,2,0
143746,1,0,0,0,14,1
220762,4,13,16,-3,13,1
300444,2,9,0,9,14,0
347472,2,12,16,-4,1,1
132603,4,12,35,-23,9,0
139663,1,0,0,0,12,1
353134,3,13,29,-16,3,0
171173,2,3,7,-4,8,0
171046,3,17,23,-6,8,0
118577,3,24,3,21,2,0
111144,4,31,10,21,16,0
237695,3,20,14,6,4,1
384372,1,0,0,0,1,0
7986,1,0,0,0,4,1
303972,4,14,34,-20,16,1
139848,3,13,17,-4,12,0
372243,1,7,0,7,13,0
249954,1,0,0,0,9,0
339407,2,7,3,4,15,0
25601,4,27,10,17,12,1
141085,4,14,10,4,13,1
396910,4,27,27,0,6,1
250161,2,17,0,17,9,1
110324,3,3,17,-14,16,1
228463,2,3,0,3,17,1
290320,1,6,0,6,10,0
262832,1,7,7,0,15,0
88295,2,14,7,7,6,0
35853,1,0,0,0,17,1
310029,4,9,10,-1,2,1
413754,4,24,16,8,14,0
185566,2,10,17,-7,15,1
102487,3,24,3,21,13,0
200305,3,24,14,10,4,1
35372,4,23,16,7,16,1
38368,2,7,9,-2,1,1
400898,1,6,0,6,8,0
50731,3,14,14,0,6,1
338604,1,0,0,0,14,1
252488,3,10,22,-12,10,0
178261,4,6,13,-7,12,1
161057,1,0,0,0,4,1
326429,1,0,3,-3,9,0
27849,4,17,17,0,13,1
164099,4,12,6,6,5,0
17946,2,7,14,-7,9,0
285832,4,14,27,-13,8,1
303353,4,41,0,41,16,0
16952,3,27,20,7,8,0
113259,2,7,7,0,17,0
328263,1,3,0,3,10,0
158428,4,19,27,-8,3,0
264291,3,10,23,-13,15,1
205218,3,17,13,4,6,1
88278,2,7,0,7,6,0
271046,4,21,28,-7,1,0
199775,1,3,0,3,4,0
104372,4,45,38,7,13,0
27951,3,14,10,4,13,0
107467,2,0,17,-17,15,0
330339,2,7,3,4,11,0
14524,4,34,36,-2,7,0
142978,4,10,13,-3,13,0
372221,4,9,25,-16,13,1
320931,4,13,21,-8,6,1
258637,4,13,13,0,13,1
176205,3,14,24,-10,11,1
223959,1,0,0,0,15,1
154391,1,0,0,0,1,0
349709,2,14,7,7,2,0
214684,1,0,0,0,11,1
404254,1,0,0,0,10,0
338649,2,6,0,6,14,1
227277,2,3,20,-17,16,1
274053,2,10,0,10,3,0
190711,4,42,17,25,17,1
221478,4,3,41,-38,14,0
86341,4,27,23,4,5,0
273680,4,22,13,9,2,1
23829,4,24,7,17,12,1
173947,3,20,19,1,10,0
233757,3,13,27,-14,2,1
94262,1,0,0,0,9,1
365192,4,14,28,-14,9,0
161014,4,16,7,9,4,1
377228,2,7,0,7,15,1
270544,2,10,7,3,1,1
354042,2,13,0,13,4,1
144838,2,14,0,14,14,1
125214,4,31,14,17,5,0
382684,3,3,6,-3,17,1
318152,3,16,10,6,5,0
267231,2,10,14,-4,17,1
400087,3,17,15,2,8,1
208580,1,3,0,3,8,1
140926,3,17,13,4,13,1
333493,2,3,0,3,12,1
5136,4,13,7,6,3,1
282301,4,28,17,11,6,1
388314,2,10,3,7,2,0
418566,2,14,3,11,16,0
230283,2,16,10,6,17,1
322872,1,6,0,6,7,0
349409,2,0,7,-7,2,1
141676,2,23,14,9,13,0
34090,2,0,0,0,16,1
90040,4,11,21,-10,7,0
162823,3,3,3,0,5,1
202599,3,21,13,8,5,0
309565,2,16,0,16,1,0
191478,1,7,7,0,17,0
197076,1,7,7,0,3,0
224997,1,0,0,0,15,1
229342,1,0,0,0,17,0
327936,1,0,0,0,10,0
354557,4,36,31,5,4,0
197139,3,24,20,4,3,0
321807,4,21,9,12,7,1
414270,3,21,21,0,14,0
84850,2,19,3,16,4,1
260016,1,0,0,0,14,0
278621,2,14,0,14,4,0
213301,1,0,0,0,10,1
289542,1,0,0,0,10,1
303040,4,23,19,4,16,0
178538,4,16,13,3,12,0
206947,1,0,0,0,7,1
300073,4,7,40,-33,14,0
415194,4,17,24,-7,15,0
305868,3,7,14,-7,17,0
385515,1,0,0,0,1,0
26201,4,0,33,-33,13,1
247688,2,7,6,1,8,0
71296,2,7,10,-3,16,0
9790,3,2,17,-15,5,1
178797,2,21,14,7,12,1
210461,3,9,14,-5,9,1
70350,4,10,33,-23,15,1
388006,3,6,3,3,2,1
77163,1,0,0,0,1,0
398928,3,10,10,0,7,1
350564,1,10,0,10,2,1
236168,3,10,10,0,3,1
68458,1,0,0,0,14,1
79846,1,0,6,-6,2,1
402949,1,0,7,-7,9,1
87450,4,20,10,10,6,0
338544,3,20,31,-11,14,1
78947,1,0,0,0,2,1
165300,4,17,24,-7,6,0
272208,2,0,0,0,2,0
55995,3,10,20,-10,9,0
81643,1,7,0,7,3,0
234325,2,17,0,17,2,0
179733,2,3,10,-7,12,0
323441,1,0,0,0,7,0
355661,4,38,23,15,5,0
266963,3,16,10,6,17,1
352288,4,3,6,-3,3,1
274151,4,27,0,27,3,1
189238,4,40,11,29,16,0
31784,3,0,17,-17,15,1
327800,1,0,10,-10,10,1
231530,4,30,29,1,1,0
275241,1,3,0,3,3,1
169351,2,6,14,-8,8,0
90232,1,0,0,0,7,1
190286,4,7,14,-7,17,1
140239,1,0,0,0,12,0
28030,1,6,7,-1,13,1
275865,1,10,0,10,3,0
104869,1,0,3,-3,14,0
39532,1,0,3,-3,1,0
321569,2,9,6,3,7,1
167385,4,37,30,7,7,0
82233,4,16,10,6,3,0
225830,4,24,14,10,16,0
354702,4,17,17,0,4,1
137269,4,7,19,-12,11,0
196971,2,20,0,20,3,0
7590,2,14,3,11,4,1
246349,3,17,10,7,7,1
90602,2,17,10,7,7,0
147260,2,0,21,-21,15,0
392907,1,0,3,-3,4,1
332447,2,13,3,10,12,1
232612,1,0,0,0,1,0
150876,2,0,7,-7,17,0
240603,2,13,7,6,5,0
135474,1,7,0,7,10,1
239071,1,0,0,0,4,0
118795,2,10,0,10,2,1
323126,4,29,14,15,7,0
326110,4,30,3,27,9,0
147901,4,17,31,-14,15,0
123230,4,19,21,-2,4,1
52423,4,12,17,-5,7,0
355885,3,13,10,3,5,1
107397,4,26,13,13,15,0
139067,1,6,3,3,12,1
229177,4,19,7,12,17,1
415763,3,14,17,-3,15,1
333904,1,0,6,-6,12,0
247830,1,0,3,-3,8,1
278144,2,7,13,-6,4,0
281649,2,21,10,11,6,1
56970,1,0,6,-6,9,0
118572,3,17,3,14,2,1
309762,4,29,12,17,1,1
289234,4,30,20,10,9,1
33187,1,7,0,7,16,0
296939,3,26,0,26,13,1
343321,2,0,10,-10,16,1
328990,4,33,7,26,10,0
364610,4,21,37,-16,9,1
329637,2,10,7,3,11,1
135298,4,34,17,17,10,0
52761,1,0,6,-6,7,0
134425,1,0,7,-7,10,0
101256,3,7,7,0,12,1
392366,3,20,28,-8,4,0
176836,3,10,10,0,11,1
399244,4,13,20,-7,7,1
63559,1,10,0,10,12,0
334473,4,24,13,11,13,0
388659,4,17,7,10,3,1
379110,4,7,12,-5,15,0
244024,2,13,16,-3,6,0
186069,4,31,48,-17,15,0
302319,2,7,3,4,15,0
42514,3,10,14,-4,3,0
5851,4,34,7,27,3,0
173750,2,3,3,0,10,1
336586,3,7,0,7,14,0
54473,2,0,7,-7,8,1
114027,1,7,0,7,17,0
303509,4,37,17,20,16,0
186040,3,24,34,-10,15,1
20536,4,9,0,9,10,1
164620,2,7,17,-10,5,1
44875,3,7,17,-10,4,0
365916,4,14,21,-7,9,0
267801,2,10,7,3,17,0
348369,2,10,10,0,1,1
250327,3,7,7,0,9,1
112138,3,7,20,-13,17,1
139540,2,6,0,6,12,1
357771,1,0,7,-7,6,1
187176,1,0,0,0,16,0
380876,1,0,0,0,16,1
106646,4,46,7,39,14,0
294228,3,13,14,-1,12,1
162668,3,16,17,-1,5,1
151463,2,28,7,21,17,0
92101,2,3,10,-7,8,1
107916,2,3,3,0,15,0
121831,2,0,7,-7,4,1
130422,4,7,6,1,8,0
377878,3,20,10,10,15,1
23496,3,14,14,0,11,1
205969,3,6,10,-4,7,0
227101,1,0,0,0,16,1
254797,3,20,10,10,11,0
302943,2,13,6,7,16,1
331658,4,31,33,-2,11,1
300222,4,31,10,21,14,1
83786,1,0,0,0,4,0
311270,4,6,3,3,2,1
264575,3,10,17,-7,16,1
184698,4,17,24,-7,15,0
407782,4,10,7,3,11,0
375892,1,7,3,4,14,1
64392,1,0,3,-3,13,1
251604,4,19,20,-1,10,1
47120,1,0,0,0,5,1
148852,4,16,23,-7,16,1
176632,2,7,12,-5,11,0
143772,2,3,0,3,14,0
135370,2,14,17,-3,10,1
414695,2,3,10,-7,14,1
287932,2,14,13,1,9,1
371836,1,7,10,-3,12,1
289416,1,0,0,0,10,0
337282,1,0,0,0,14,0
43029,2,0,0,0,3,1
228487,2,10,7,3,17,1
309745,4,26,9,17,1,0
349946,4,18,12,6,2,0
361045,2,16,2,14,7,1
333026,2,3,9,-6,12,1
195402,3,24,3,21,2,0
216692,3,24,6,18,12,1
315301,1,0,0,0,4,1
147109,2,14,31,-17,15,1
420892,1,0,0,0,17,1
158148,1,0,0,0,3,1
327441,4,3,20,-17,9,1
357282,3,3,19,-16,5,1
306168,2,7,3,4,17,1
161432,2,7,3,4,4,1
358469,4,35,27,8,6,0
229892,4,20,14,6,17,1
334143,3,16,7,9,13,1
14736,2,21,0,21,7,1
178323,2,7,3,4,12,1
189868,1,0,0,0,17,0
23597,2,7,7,0,12,1
3562,2,14,7,7,2,0
400313,1,0,0,0,8,1
265259,4,9,6,3,16,1
101456,4,18,13,5,12,1
362159,1,0,0,0,8,1
95456,4,34,7,27,10,1
322191,2,0,20,-20,7,0
154171,3,7,13,-6,1,1
330036,1,0,0,0,11,1
65196,3,3,10,-7,13,1
205957,2,6,3,3,7,0
284059,4,13,3,10,7,0
400555,3,13,24,-11,8,1
418240,1,0,0,0,16,0
294429,4,19,12,7,12,0
108266,3,9,7,2,15,0
250417,1,0,0,0,9,0
91286,2,7,0,7,8,1
264748,2,10,16,-6,16,1
337380,4,21,7,14,14,0
328077,1,0,0,0,10,0
118777,1,10,0,10,2,0
151440,2,21,0,21,17,0
125001,2,3,3,0,5,0
387209,1,0,7,-7,2,1
83953,1,7,0,7,4,1
276939,2,17,14,3,4,0
331281,2,0,7,-7,11,0
91099,4,12,7,5,7,1
80823,3,3,0,3,3,0
127312,2,10,17,-7,6,1
91370,4,21,7,14,8,0
262835,1,7,7,0,15,1
269639,2,3,0,3,1,0
227189,3,13,10,3,16,0
195343,2,3,3,0,2,1
215674,4,14,6,8,11,0
120597,3,0,20,-20,3,1
96786,4,7,10,-3,10,0
94015,2,6,21,-15,9,0
136483,4,17,13,4,11,0
286555,2,10,21,-11,8,1
196779,1,0,7,-7,3,1
181204,1,0,0,0,13,0
254259,2,6,6,0,11,0
165051,2,10,17,-7,6,1
406867,4,20,23,-3,11,0
197761,4,21,17,4,3,1
201673,3,10,20,-10,5,1
11923,1,0,0,0,6,1
272438,4,31,17,14,2,1
16051,2,16,0,16,8,0
387547,2,3,3,0,2,1
298439,4,13,24,-11,14,0
149302,4,13,27,-14,16,1
37107,4,13,17,-4,17,1
170204,1,0,0,0,8,0
181815,1,0,0,0,13,1
78430,3,17,0,17,2,0
170106,2,7,3,4,8,1
389115,4,30,7,23,3,1
233604,3,20,34,-14,2,0
155216,2,14,7,7,1,1
130885,1,0,0,0,8,0
402387,2,7,7,0,9,0
365758,3,17,17,0,9,1
212258,1,7,0,7,10,0
392349,3,17,28,-11,4,1
58675,1,7,0,7,10,0
387865,3,10,28,-18,2,0
219286,1,10,0,10,13,0
26009,3,10,16,-6,13,1
214816,4,10,27,-17,11,1
217637,4,19,16,3,12,1
194243,1,0,0,0,2,0
359558,1,3,0,3,6,1
54250,4,0,3,-3,8,1
335005,3,16,10,6,13,0
309330,4,3,23,-20,1,0
412650,2,10,10,0,14,1
109867,3,20,0,20,16,1
60589,4,30,41,-11,11,0
80105,4,24,22,2,2,1
167336,2,16,16,0,7,1
36007,1,6,0,6,17,1
339022,4,20,3,17,15,0
175212,1,10,0,10,10,1
23606,2,7,7,0,12,0
47823,2,7,6,1,5,1
262395,1,6,7,-1,15,1
335307,3,3,9,-6,13,0
70014,3,24,10,14,15,1
50890,3,14,24,-10,6,1
389822,3,24,6,18,3,1
253471,4,17,38,-21,11,1
299219,1,3,0,3,14,0
193102,3,13,6,7,1,0
42636,2,0,7,-7,3,1
242454,2,3,7,-4,6,0
396942,1,0,0,0,6,0
52938,2,14,7,7,7,0
410348,4,15,26,-11,13,0
34838,1,7,0,7,16,1
307967,3,7,6,1,1,0
238685,3,16,17,-1,4,1
292399,1,0,0,0,11,1
66795,3,10,6,4,14,0
196242,2,14,10,4,2,1
216875,3,10,14,-4,12,1
318733,3,10,23,-13,5,1
282963,2,14,3,11,6,1
412149,1,0,3,-3,13,1
230433,3,21,3,18,1,0
134185,2,0,17,-17,10,0
54737,1,0,0,0,8,1
115914,4,13,23,-10,1,0
238413,4,17,33,-16,4,1
381854,4,18,21,-3,17,0
201198,3,20,24,-4,5,1
80371,3,20,9,11,2,1
233700,2,7,21,-14,2,1
343746,1,7,0,7,17,1
300370,4,10,7,3,14,1
205208,3,14,13,1,6,1
277643,1,0,0,0,4,0
160420,1,0,0,0,4,1
168956,1,0,0,0,7,0
25372,2,6,0,6,12,0
241682,2,7,3,4,5,0
296318,3,6,13,-7,13,0
137677,1,0,13,-13,11,1
281673,3,24,10,14,6,0
214888,2,0,12,-12,11,0
300214,4,31,3,28,14,0
353753,4,20,17,3,4,1
193150,4,13,6,7,1,1
226024,4,34,34,0,16,1
289850,1,0,3,-3,10,0
296115,1,0,0,0,13,1
34555,2,7,0,7,16,1
326800,2,3,14,-11,9,1
325161,2,13,14,-1,8,0
46191,2,14,14,0,4,1
264841,4,24,37,-13,16,0
269469,1,3,3,0,1,0
3421,2,3,16,-13,2,1
226450,2,7,7,0,16,0
272976,2,3,3,0,2,1
21991,2,7,10,-3,11,1
181675,1,0,0,0,13,1
156718,4,17,20,-3,2,0
303083,2,0,7,-7,16,0
105865,3,16,10,6,14,1
181053,2,7,0,7,13,1
268447,2,14,9,5,17,0
376812,2,14,7,7,15,0
80236,4,21,31,-10,2,1
316968,4,37,18,19,4,1
42727,4,7,20,-13,3,1
146245,3,3,23,-20,15,0
328731,2,7,6,1,10,1
3780,3,20,10,10,2,1
342959,4,37,17,20,16,0
172407,3,13,42,-29,9,1
212603,2,7,17,-10,10,1
90902,3,40,7,33,7,1
416134,1,0,6,-6,15,1
106881,2,9,3,6,14,0
15828,4,8,12,-4,8,0
186252,1,3,3,0,15,1
314948,4,0,10,-10,4,0
9109,4,30,19,11,4,0
269112,4,16,16,0,17,0
314879,2,0,0,0,4,1
341919,1,0,0,0,16,1
353592,3,31,0,31,4,1
353427,3,18,3,15,4,1
56957,4,43,7,36,9,0
23023,2,7,14,-7,11,0
182882,1,0,3,-3,14,1
373299,1,0,0,0,13,1
284907,2,0,14,-14,7,1
416256,1,0,0,0,15,1
320545,2,20,0,20,6,1
235140,3,0,10,-10,2,1
148056,3,7,10,-3,15,1
62426,2,0,10,-10,12,0
248758,2,27,7,20,9,0
232220,3,9,12,-3,1,1
89302,4,15,15,0,7,1
366496,1,7,0,7,10,0
75602,3,7,3,4,17,0
264310,4,10,36,-26,15,1
111255,3,10,10,0,16,0
267629,1,0,6,-6,17,0
166567,2,6,7,-1,6,1
127690,4,37,26,11,6,0
364305,4,3,32,-29,9,1
191610,5,24,24,0,17,1
183745,1,0,7,-7,14,1
309752,4,26,9,17,1,0
406242,3,14,24,-10,11,1
267971,2,0,6,-6,17,0
415458,3,23,3,20,15,0
282000,4,21,28,-7,6,1
405081,2,0,3,-3,10,0
216576,4,40,11,29,12,1
188487,1,0,0,0,16,1
143645,3,13,10,3,14,1
103004,1,0,0,0,13,1
58399,2,34,7,27,10,1
61137,3,0,7,-7,11,0
395397,3,28,3,25,5,1
402408,2,14,7,7,9,0
176607,1,0,0,0,11,0
205106,1,0,0,0,6,1
90576,2,14,7,7,7,0
314987,1,0,0,0,4,0
205778,1,7,0,7,7,1
156773,2,14,7,7,2,1
295578,3,23,25,-2,12,1
148030,3,7,3,4,15,0
307424,1,7,3,4,17,0
278402,4,17,24,-7,4,0
152742,1,0,0,0,17,1
397650,4,6,27,-21,7,1
191704,3,10,17,-7,17,1
33143,4,10,42,-32,16,1
225154,1,0,0,0,15,1
342787,4,7,14,-7,16,1
132941,1,0,0,0,9,0
38116,4,9,6,3,1,1
132821,2,3,7,-4,9,1
13437,2,3,14,-11,7,0
152810,4,14,10,4,17,0
308595,3,15,16,-1,1,0
353800,1,7,0,7,4,0
232668,3,7,0,7,1,1
115185,4,13,30,-17,1,0
84083,4,30,32,-2,4,1
166409,2,10,7,3,6,1
65605,3,6,9,-3,13,1
414069,1,0,0,0,14,0
266885,1,0,0,0,17,0
277385,2,17,9,8,4,1
4555,4,24,29,-5,2,1
163828,4,17,25,-8,5,1
292434,2,3,0,3,11,0
849,4,14,12,2,1,1
321879,2,14,14,0,7,0
149347,1,3,0,3,16,0
361635,2,0,15,-15,7,1
216968,2,3,3,0,12,0
270064,2,3,10,-7,1,1
357266,3,3,16,-13,5,1
196866,4,10,20,-10,3,0
360097,4,10,43,-33,7,1
141722,4,30,21,9,13,1
73836,4,13,6,7,17,0
315008,1,14,0,14,4,0
12822,2,6,3,3,6,1
319752,1,0,0,0,6,1
65965,4,24,28,-4,13,1
386601,1,0,7,-7,2,0
409900,4,37,8,29,12,0
352968,3,13,3,10,3,1
241349,1,0,0,0,5,0
373422,4,10,17,-7,13,1
322042,2,13,0,13,7,0
15287,1,0,0,0,8,1
42631,2,0,7,-7,3,0
54896,1,0,0,0,8,1
61913,4,27,30,-3,12,1
56442,3,0,35,-35,9,1
210568,2,6,7,-1,9,1
108521,2,14,14,0,15,1
338524,3,20,17,3,14,0
166150,3,14,12,2,6,1
54817,3,13,0,13,8,0
238523,3,13,6,7,4,0
393061,2,0,3,-3,4,0
141133,1,3,7,-4,13,0
27155,2,6,7,-1,13,0
275419,1,6,10,-4,3,1
144649,1,0,0,0,14,0
130821,3,13,12,1,8,1
412574,1,0,0,0,14,1
192120,2,0,6,-6,1,0
51321,3,16,17,-1,7,1
354666,3,10,10,0,4,0
184581,4,45,21,24,14,0
316532,1,0,0,0,4,0
193423,3,19,20,-1,1,1
178259,4,6,13,-7,12,0
100969,3,10,16,-6,12,0
256716,2,0,6,-6,12,1
213188,2,3,7,-4,10,0
304818,3,0,3,-3,16,1
152456,1,7,0,7,17,1
149473,4,13,27,-14,16,1
382411,3,0,21,-21,17,0
149200,1,7,0,7,16,0
274736,4,24,12,12,3,0
370154,3,17,3,14,12,0
28403,3,13,3,10,14,0
354590,1,0,7,-7,4,1
193723,3,3,27,-24,1,0
261804,2,3,7,-4,14,0
334836,2,10,3,7,13,1
245884,3,6,30,-24,7,0
68691,3,17,0,17,15,1
175656,2,3,0,3,11,0
54175,2,0,3,-3,8,1
294783,2,7,14,-7,12,1
206245,2,0,6,-6,7,1
256568,2,7,0,7,12,0
263404,1,0,0,0,15,0
227170,3,13,7,6,16,1
401652,1,0,7,-7,8,0
316184,4,30,35,-5,4,1
56720,2,0,10,-10,9,0
126990,2,16,10,6,6,1
371895,3,27,10,17,12,0
348611,4,31,23,8,2,1
40297,2,6,0,6,2,0
85494,2,14,9,5,5,1
393600,3,7,26,-19,5,1
320543,2,14,0,14,6,1
66849,1,0,7,-7,14,1
345455,4,3,22,-19,17,1
376571,3,15,6,9,14,1
269694,3,10,12,-2,1,0
127479,3,3,16,-13,6,0
133852,1,0,3,-3,9,1
272618,4,19,9,10,2,0
141650,2,17,14,3,13,1
228754,1,0,0,0,17,0
133557,1,0,0,0,9,0
41870,1,7,3,4,2,0
57072,4,7,27,-20,9,1
267958,2,0,3,-3,17,1
173209,4,20,24,-4,9,1
382112,3,21,3,18,17,1
420146,2,0,3,-3,17,0
61127,3,0,7,-7,11,0
93616,3,13,6,7,9,1
318700,2,3,19,-16,5,0
109996,2,17,10,7,16,1
147647,1,3,0,3,15,0
297774,1,7,0,7,13,0
333991,3,17,10,7,12,0
208155,2,0,0,0,8,0
389529,4,20,10,10,3,0
58503,1,0,3,-3,10,1
53307,4,17,10,7,8,1
325395,1,0,0,0,8,0
368120,2,7,7,0,11,0
415544,1,0,0,0,15,1
224506,4,15,10,5,15,0
96771,3,7,10,-3,10,0
204044,4,16,7,9,6,0
406184,1,7,0,7,11,0
62018,3,10,7,3,12,1
348599,4,28,23,5,2,1
165888,4,6,19,-13,6,0
179229,2,14,3,11,12,1
304736,1,0,0,0,16,0
385162,3,14,17,-3,1,0
410537,1,7,7,0,13,1
36520,3,10,20,-10,17,0
107857,1,0,0,0,15,1
265987,4,0,33,-33,16,0
331825,1,0,0,0,12,1
164002,1,0,3,-3,5,1
105199,2,7,14,-7,14,1
119792,3,17,6,11,3,0
271863,1,0,10,-10,2,1
285542,2,7,7,0,8,0
141342,2,3,14,-11,13,1
203049,3,20,10,10,5,1
365470,3,10,19,-9,9,0
134583,2,10,3,7,10,1
380978,4,9,14,-5,16,1
185035,1,0,0,0,15,0
269963,3,16,13,3,1,1
402447,3,21,15,6,9,0
341966,2,6,0,6,16,0
296922,2,19,0,19,13,1
398450,2,7,0,7,7,1
201420,1,6,0,6,5,1
240560,1,0,0,0,5,1
221982,1,0,0,0,14,0
307664,3,14,17,-3,17,0
182221,4,33,7,26,13,1
381590,4,42,16,26,17,1
303794,4,20,17,3,16,1
129589,3,13,20,-7,7,1
199880,4,10,24,-14,4,1
9970,4,3,3,0,5,0
177980,2,7,6,1,12,1
189693,4,20,6,14,17,1
48251,2,3,10,-7,5,1
321769,3,18,6,12,7,0
290902,1,0,0,0,10,0
394887,2,0,17,-17,5,1
363294,3,27,13,14,8,0
37198,2,3,7,-4,17,1
51525,4,34,31,3,7,0
95250,2,3,10,-7,10,0
300301,2,0,7,-7,14,0
325407,1,6,0,6,8,0
154016,3,10,14,-4,1,0
19944,1,0,0,0,10,0
76689,4,16,7,9,1,1
249323,1,10,0,10,9,0
375472,2,16,7,9,14,1
124044,1,0,0,0,5,0
300536,4,30,20,10,14,0
65893,2,7,14,-7,13,1
105681,2,21,3,18,14,1
131664,2,0,22,-22,8,1
90237,1,0,0,0,7,0
178414,4,38,40,-2,12,0
17778,1,7,3,4,9,0
202884,3,21,0,21,5,0
33347,1,6,3,3,16,0
400229,2,10,6,4,8,1
270992,2,3,14,-11,1,0
30151,2,10,16,-6,14,0
307190,3,0,10,-10,17,0
82559,1,0,0,0,3,0
118844,3,20,7,13,2,0
251262,3,10,24,-14,10,1
200258,2,9,7,2,4,1
54018,2,0,0,0,8,1
101137,4,13,24,-11,12,1
330165,1,0,0,0,11,0
27678,4,14,27,-13,13,0
43958,2,3,7,-4,3,0
328439,2,3,0,3,10,1
212147,2,3,17,-14,10,0
342737,3,0,7,-7,16,1
250001,2,7,6,1,9,1
307446,2,21,10,11,17,1
256177,4,27,22,5,12,1
91083,4,9,0,9,7,0
404707,1,0,0,0,10,0
19905,4,13,21,-8,10,1
310850,1,0,0,0,2,1
39729,3,9,0,9,1,1
98225,1,0,0,0,11,0
124012,4,13,14,-1,5,1
28176,1,3,0,3,13,0
181853,2,21,14,7,13,1
17050,2,13,0,13,9,0
248060,4,34,13,21,8,0
247197,1,0,0,0,8,0
277804,1,7,7,0,4,0
305614,4,23,10,13,17,0
285496,4,36,15,21,8,0
361390,3,17,7,10,7,0
317725,5,23,23,0,5,1
281093,4,45,16,29,6,0
207635,4,42,10,32,7,0
242742,2,7,17,-10,6,1
236384,4,7,23,-16,3,1
183210,2,7,0,7,14,0
128554,4,21,35,-14,7,1
231272,1,0,3,-3,1,1
410486,4,9,26,-17,13,1
222511,3,9,14,-5,14,0
395484,2,7,0,7,6,1
45641,3,13,13,0,4,1
408045,3,10,10,0,12,1
332056,3,10,9,1,12,1
124166,4,22,21,1,5,0
198499,4,17,3,14,3,1
262198,4,31,16,15,15,1
118839,3,20,7,13,2,1
337006,2,10,0,10,14,1
72764,2,14,7,7,16,1
191641,1,0,3,-3,17,0
253982,2,0,6,-6,11,1
125212,4,31,14,17,5,0
186166,3,16,6,10,15,0
43163,1,0,0,0,3,0
316931,3,17,15,2,4,1
161769,3,24,6,18,4,0
74460,1,0,0,0,17,1
143452,1,14,7,7,14,0
157229,2,7,0,7,2,0
79826,1,0,0,0,2,0
97138,4,34,6,28,10,0
362857,4,14,28,-14,8,1
405542,1,0,7,-7,10,0
118963,2,0,17,-17,3,0
319983,3,43,10,33,6,0
309269,2,0,10,-10,1,0
316590,3,6,6,0,4,0
189847,4,27,17,10,17,1
187957,2,6,7,-1,16,0
266,4,12,24,-12,1,1
133638,3,10,21,-11,9,1
379903,3,14,3,11,16,1
25670,2,7,7,0,12,0
206110,3,20,6,14,7,1
72835,4,31,17,14,16,0
273496,3,14,13,1,2,1
72598,1,7,0,7,16,1
331549,1,7,14,-7,11,0
244867,4,7,10,-3,7,0
86290,3,13,23,-10,5,1
134717,1,3,0,3,10,1
87533,2,17,0,17,6,0
266296,1,0,0,0,16,1
305893,4,14,14,0,17,0
218785,4,3,16,-13,13,0
317749,1,0,0,0,5,1
417919,4,16,10,6,16,0
197393,1,7,0,7,3,1
203425,1,0,0,0,6,0
140466,3,14,13,1,12,0
32249,3,21,14,7,15,1
313949,4,28,32,-4,3,1
130803,2,13,12,1,8,0
200632,3,27,21,6,4,0
289657,4,13,20,-7,10,0
369889,3,7,9,-2,12,0
302643,2,17,6,11,15,1
386372,3,17,6,11,2,0
158864,4,23,3,20,3,0
342253,2,6,0,6,16,0
239965,1,0,10,-10,5,1
352798,2,14,0,14,3,1
380586,4,21,27,-6,16,0
406636,2,0,0,0,11,1
316909,2,9,15,-6,4,1
5673,3,0,14,-14,3,0
342480,4,20,3,17,16,1
199171,1,0,0,0,4,1
251412,4,43,14,29,10,0
54312,1,7,2,5,8,0
326823,3,10,14,-4,9,0
16950,3,27,20,7,8,0
221996,1,6,0,6,14,1
419104,1,3,0,3,16,0
274790,5,24,23,1,3,0
322121,4,33,0,33,7,1
243346,4,20,30,-10,6,0
198044,3,3,30,-27,3,0
108547,3,17,14,3,15,1
172636,1,0,0,0,9,0
161264,2,17,3,14,4,1
362550,4,26,12,14,8,1
317583,1,3,0,3,5,0
127546,4,3,26,-23,6,1
353991,1,0,0,0,4,1
285061,2,0,0,0,7,1
105352,2,9,7,2,14,0
393075,2,7,3,4,4,0
176490,2,9,10,-1,11,0
329817,3,17,20,-3,11,1
241947,1,0,0,0,5,1
314174,2,7,20,-13,3,1
89670,2,6,10,-4,7,0
141097,4,14,10,4,13,0
105267,4,10,24,-14,14,0
321710,1,3,3,0,7,1
186719,1,0,0,0,15,1
412662,3,19,10,9,14,1
183302,4,22,20,2,14,1
75601,3,7,3,4,17,0
242094,1,0,0,0,6,1
112453,4,13,16,-3,17,1
16821,4,20,24,-4,8,0
300199,4,28,3,25,14,1
382995,4,10,21,-11,17,1
69655,1,0,6,-6,15,0
292719,1,7,7,0,11,0
282652,2,6,10,-4,6,1
407161,4,17,27,-10,11,1
309568,3,16,0,16,1,0
105720,3,35,3,32,14,0
403187,3,17,14,3,9,0
360037,2,3,26,-23,7,0
179466,4,21,20,1,12,0
19483,4,24,17,7,10,0
15527,4,23,6,17,8,1
107418,1,0,0,0,15,0
258594,3,13,10,3,13,1
253412,3,14,28,-14,11,0
32113,3,24,13,11,15,1
24138,4,23,14,9,12,1
417088,3,27,0,27,15,0
140137,3,10,0,10,12,0
414143,3,10,13,-3,14,0
239357,1,0,7,-7,4,1
296772,2,7,0,7,13,1
210693,1,0,0,0,9,1
352681,2,14,3,11,3,0
21339,4,14,23,-9,11,0
220958,2,7,7,0,14,1
124259,2,16,17,-1,5,1
23147,2,13,0,13,11,0
374662,1,0,0,0,14,1
14456,2,24,3,21,7,0
396647,1,0,0,0,6,1
95422,3,28,7,21,10,0
420575,1,0,7,-7,17,0
258271,2,14,12,2,13,0
154360,4,27,24,3,1,1
269718,4,10,21,-11,1,0
395048,2,0,17,-17,5,1
349154,3,20,7,13,2,1
52403,4,12,17,-5,7,0
326600,1,3,3,0,9,1
102101,4,42,24,18,12,1
248242,1,0,0,0,8,1
1970,3,10,2,8,1,0
51938,4,13,16,-3,7,0
354833,4,23,28,-5,4,0
141201,2,3,21,-18,13,1
68017,2,0,10,-10,14,1
327489,1,0,0,0,10,1
170013,4,28,17,11,8,1
248947,3,20,3,17,9,0
307641,3,14,10,4,17,0
236535,3,10,9,1,3,1
289364,4,28,25,3,9,1
337295,1,7,7,0,14,0
153833,1,0,0,0,1,1
88772,2,13,3,10,6,0
380592,4,21,27,-6,16,1
103800,2,6,0,6,13,1
190244,2,7,14,-7,17,1
34685,2,3,3,0,16,0
22619,3,23,3,20,11,1
614,1,0,0,0,1,0
162890,4,13,6,7,5,0
223794,2,6,0,6,15,1
32920,1,0,7,-7,15,1
149248,2,7,13,-6,16,1
32912,1,0,0,0,15,0
335654,1,7,0,7,13,0
210938,4,26,10,16,9,0
146524,2,7,10,-3,15,1
366785,1,0,0,0,10,1
169485,2,0,20,-20,8,0
206654,1,0,0,0,7,1
193711,3,3,27,-24,1,1
31938,3,9,13,-4,15,0
189060,3,14,17,-3,16,1
14869,2,6,0,6,7,1
115842,2,0,10,-10,1,1
142907,2,0,10,-10,13,1
236746,1,0,0,0,3,0
205527,4,14,24,-10,6,1
386476,2,7,0,7,2,0
263331,3,24,7,17,15,0
125291,2,9,3,6,5,1
318365,1,0,0,0,5,1
128306,1,0,0,0,7,0
296709,4,10,19,-9,13,0
375607,2,14,14,0,14,0
179874,2,10,9,1,13,1
322769,2,3,20,-17,7,0
341189,2,10,0,10,16,0
125037,3,3,12,-9,5,0
271524,1,0,0,0,2,0
205885,4,22,7,15,7,1
333989,3,17,10,7,12,0
165815,2,3,6,-3,6,0
67312,2,14,3,11,14,1
211264,4,29,26,3,9,0
145995,4,13,21,-8,15,0
352514,2,14,6,8,3,1
65734,2,7,16,-9,13,0
315034,2,21,7,14,4,1
47988,3,3,24,-21,5,1
386141,1,0,0,0,2,0
213037,2,17,0,17,10,0
373257,4,13,16,-3,13,1
299597,4,13,10,3,14,1
141174,2,3,14,-11,13,0
58150,4,23,17,6,10,0
61146,3,0,7,-7,11,0
106642,4,46,7,39,14,1
1196,1,10,0,10,1,0
8997,1,0,0,0,4,1
341810,2,3,9,-6,16,1
207214,4,17,20,-3,7,1
168476,4,3,24,-21,7,1
180521,4,21,20,1,13,1
329089,3,16,7,9,10,1
144898,3,14,7,7,14,1
348382,3,13,10,3,1,0
378910,3,13,29,-16,15,0
146223,2,0,10,-10,15,1
301413,1,0,0,0,15,1
17423,4,17,7,10,9,0
675,3,0,16,-16,1,0
175465,4,20,29,-9,11,0
227408,1,0,7,-7,16,1
185063,2,0,3,-3,15,1
51512,4,34,24,10,7,0
180906,1,10,7,3,13,1
360072,3,10,40,-30,7,0
178493,2,16,3,13,12,0
331440,2,6,7,-1,11,1
130866,4,20,15,5,8,0
182822,3,26,17,9,14,1
281073,4,38,16,22,6,0
171374,4,16,17,-1,9,1
330252,3,17,14,3,11,0
121134,1,0,10,-10,3,1
242257,1,0,0,0,6,0
92191,4,10,43,-33,8,0
334835,2,10,3,7,13,1
78352,4,31,35,-4,2,1
163626,3,21,22,-1,5,0
381625,1,7,0,7,17,1
8422,1,0,0,0,4,1
309444,3,7,6,1,1,1
368263,2,3,3,0,11,1
315163,2,7,7,0,4,1
344296,4,16,13,3,17,1
139352,1,0,0,0,12,1
78364,4,38,35,3,2,0
398130,4,30,42,-12,7,0
48732,3,10,19,-9,5,0
250263,1,6,0,6,9,1
226931,4,3,13,-10,16,1
117462,2,7,7,0,2,0
42408,4,14,19,-5,2,0
1566,4,13,13,0,1,1
145283,2,14,6,8,14,0
294838,3,35,21,14,12,0
217107,1,0,7,-7,12,1
56915,3,34,7,27,9,0
390350,2,7,7,0,3,1
175753,4,40,21,19,11,1
52214,3,7,13,-6,7,0
231751,2,10,20,-10,1,0
281069,4,24,16,8,6,1
47016,2,17,0,17,5,1
205608,1,7,3,4,7,0
137450,4,6,28,-22,11,0
362255,4,15,24,-9,8,1
420704,4,21,19,2,17,0
304722,4,21,14,7,16,0
414792,5,17,17,0,14,1
298480,1,10,0,10,14,0
256552,2,7,0,7,12,1
85776,2,13,7,6,5,0
302792,2,9,13,-4,15,0
71358,4,10,20,-10,16,1
76342,2,13,3,10,1,1
144345,1,0,0,0,14,0
76481,2,0,14,-14,1,0
16861,1,0,0,0,8,0
77287,4,19,10,9,1,0
357382,2,14,10,4,5,0
286229,2,0,6,-6,8,1
332214,4,10,16,-6,12,1
411310,2,3,10,-7,13,0
300269,1,0,7,-7,14,1
178439,1,6,3,3,12,1
187498,2,3,10,-7,16,1
313039,4,20,0,20,3,0
112318,4,45,17,28,17,1
381649,2,10,0,10,17,0
94396,4,17,21,-4,9,0
231133,2,3,0,3,1,0
97089,3,31,6,25,10,0
35360,3,23,13,10,16,0
214629,3,3,16,-13,11,0
14557,1,0,0,0,7,0
257186,2,3,9,-6,12,0
306242,1,0,0,0,17,1
246405,4,26,18,8,7,0
33683,3,28,0,28,16,0
362343,2,10,7,3,8,1
310234,1,0,0,0,2,1
248770,3,27,14,13,9,0
102447,2,3,3,0,13,1
73057,2,7,10,-3,16,0
363021,4,33,26,7,8,1
191572,4,14,24,-10,17,1
357,2,14,10,4,1,1
404628,3,13,13,0,10,1
203562,4,31,10,21,6,0
132231,2,7,0,7,9,0
106616,3,34,0,34,14,0
210001,2,7,3,4,8,1
216946,1,3,0,3,12,1
187470,1,0,0,0,16,0
117989,3,20,6,14,2,0
151937,3,20,17,3,17,1
293594,1,0,0,0,12,1
250620,2,3,0,3,10,1
347616,2,14,10,4,1,1
4016,1,7,0,7,2,0
333677,2,14,0,14,12,0
396612,4,20,10,10,6,1
259455,2,14,10,4,13,1
108485,1,7,7,0,15,1
167024,2,10,14,-4,7,0
350299,2,14,0,14,2,0
90449,2,0,13,-13,7,1
205137,1,7,0,7,6,0
178835,3,27,14,13,12,0
72394,4,17,23,-6,16,0
377855,2,20,7,13,15,0
95647,1,7,0,7,10,0
351904,1,0,0,0,3,0
73178,2,7,0,7,16,0
118551,2,17,3,14,2,1
161705,1,10,0,10,4,0
246334,2,13,10,3,7,1
315362,2,13,10,3,4,0
155234,3,21,7,14,1,1
294119,4,14,27,-13,12,1
266709,4,42,10,32,16,1
288338,2,7,0,7,9,1
346056,3,3,6,-3,1,1
8367,3,23,3,20,4,1
233443,3,17,10,7,2,1
208408,1,0,0,0,8,0
60102,3,19,12,7,11,1
34012,4,17,27,-10,16,0
312045,2,7,7,0,2,1
43762,1,14,0,14,3,0
143902,1,0,0,0,14,0
12100,2,7,7,0,6,1
41098,4,3,19,-16,2,1
340732,1,0,7,-7,15,1
115788,4,20,16,4,1,0
211667,2,23,3,20,9,0
100314,2,9,7,2,12,0
40281,2,6,0,6,2,1
343423,1,0,0,0,16,0
330893,4,16,24,-8,11,0
360370,4,7,20,-13,7,0
386128,1,0,0,0,2,0
386834,3,13,21,-8,2,1
321756,3,9,6,3,7,1
118137,3,23,20,3,2,0
255243,4,13,14,-1,12,0
93329,3,24,3,21,9,1
75498,4,31,7,24,17,0
142991,4,10,20,-10,13,1
161771,3,24,6,18,4,1
131242,2,14,17,-3,8,0
42661,3,0,10,-10,3,0
291654,4,23,20,3,11,0
95052,1,0,0,0,9,0
162306,1,3,0,3,4,1
249053,2,21,17,4,9,1
72428,1,7,0,7,16,0
143431,1,0,0,0,14,1
21023,4,14,31,-17,10,1
143015,1,0,0,0,13,0
6755,1,0,0,0,3,1
419066,4,10,20,-10,16,1
152796,3,7,7,0,17,1
358439,3,29,20,9,6,1
236626,1,0,0,0,3,1
261048,2,0,7,-7,14,0
64569,2,10,7,3,13,1
407979,1,0,0,0,12,1
276683,4,23,13,10,4,1
312602,1,0,0,0,3,0
203353,3,14,27,-13,6,0
234602,1,10,3,7,2,0
227555,1,13,0,13,16,1
148821,4,13,23,-10,16,1
141367,3,10,17,-7,13,1
252861,4,19,13,6,11,0
363350,1,0,7,-7,8,0
25285,3,34,7,27,12,0
60792,2,7,3,4,11,1
207409,1,7,0,7,7,0
192770,2,0,9,-9,1,0
137240,3,7,13,-6,11,1
13211,4,22,26,-4,6,0
191609,5,24,24,0,17,1
183222,2,7,14,-7,14,1
231996,1,0,7,-7,1,0
27058,3,10,6,4,13,1
32248,3,21,14,7,15,1
414349,1,7,3,4,14,1
335006,3,16,10,6,13,0
61423,3,16,3,13,11,0
80878,1,0,0,0,3,1
148569,1,0,6,-6,16,1
271227,1,0,0,0,1,1
171211,4,6,14,-8,8,1
224833,4,11,16,-5,15,1
183918,1,7,3,4,14,0
331620,3,23,30,-7,11,0
122338,4,6,19,-13,4,1
266321,2,7,0,7,16,0
247142,3,20,6,14,8,0
370845,1,0,0,0,12,1
65854,1,0,7,-7,13,1
136597,3,15,16,-1,11,0
245869,2,3,23,-20,7,1
73152,1,6,0,6,16,1
336126,2,10,3,7,13,0
274671,2,7,3,4,3,0
386975,3,7,21,-14,2,0
234985,3,13,10,3,2,0
67664,4,7,35,-28,14,1
86694,2,10,7,3,5,1
108840,3,7,10,-3,15,1
284488,3,14,15,-1,7,0
141685,3,23,21,2,13,1
296631,3,3,10,-7,13,0
297237,3,14,6,8,13,0
313048,4,20,0,20,3,1
61168,4,0,21,-21,11,1
294618,1,0,0,0,12,1
41053,3,3,13,-10,2,1
328737,2,7,6,1,10,0
47804,2,7,6,1,5,1
373130,4,10,21,-11,13,0
385233,1,0,3,-3,1,0
222878,1,0,0,0,14,0
26140,2,0,13,-13,13,0
395848,4,3,17,-14,6,1
46906,3,13,20,-7,5,1
264968,4,23,17,6,16,1
155287,4,28,27,1,1,0
269137,5,16,16,0,17,1
13989,1,0,0,0,7,1
20796,2,7,0,7,10,1
203027,2,14,3,11,5,1
235626,4,33,34,-1,3,1
217785,4,10,13,-3,12,1
196153,4,31,24,7,2,1
297382,3,9,17,-8,13,0
231662,4,17,16,1,1,0
397360,4,10,24,-14,6,1
136414,2,3,7,-4,11,1
394894,2,0,17,-17,5,1
325666,4,24,7,17,9,0
303074,1,0,7,-7,16,1
246722,1,0,0,0,8,1
310219,4,24,10,14,2,0
416098,4,21,13,8,15,0
331793,4,23,27,-4,12,0
324418,3,14,3,11,8,1
1430,4,19,0,19,1,1
273395,4,38,7,31,2,0
419320,3,0,17,-17,16,1
225186,2,3,7,-4,15,0
330754,5,9,9,0,11,0
309477,4,17,9,8,1,1
36220,3,10,17,-7,17,1
177715,3,13,14,-1,12,0
151267,1,0,0,0,17,1
272873,3,20,17,3,2,1
235596,4,27,13,14,3,0
199123,3,14,31,-17,4,1
84742,3,10,17,-7,4,0
358403,2,16,13,3,6,0
23098,4,10,17,-7,11,1
171045,3,17,23,-6,8,0
221155,3,0,23,-23,14,1
175490,1,0,0,0,11,0
340117,1,0,0,0,15,1
249735,3,21,21,0,9,0
128963,3,28,3,25,7,0
55973,2,10,14,-4,9,1
241435,4,7,35,-28,5,0
107316,2,3,3,0,15,1
248436,2,10,6,4,8,0
361465,1,7,0,7,7,0
255810,3,17,0,17,12,1
94157,2,10,7,3,9,1
283917,3,31,17,14,7,0
51181,3,24,3,21,7,0
299073,1,3,0,3,14,0
73444,1,0,7,-7,17,1
243359,4,20,30,-10,6,1
231927,4,7,41,-34,1,0
399656,3,16,9,7,8,1
268767,3,24,3,21,17,0
292708,1,7,0,7,11,0
20800,2,7,0,7,10,1
318230,1,3,0,3,5,0
41493,3,8,7,1,2,0
163876,2,6,10,-4,5,1
120483,4,39,27,12,3,0
48136,3,7,6,1,5,1
307013,2,10,0,10,17,1
69249,2,6,0,6,15,0
249524,2,14,3,11,9,1
350458,2,0,12,-12,2,1
364835,2,3,14,-11,9,1
120517,1,0,0,0,3,0
235793,1,0,0,0,3,1
60793,2,7,3,4,11,1
255651,2,3,7,-4,12,0
5366,2,13,7,6,3,0
392493,2,3,17,-14,4,1
300973,4,27,30,-3,15,0
81088,2,3,14,-11,3,1
307702,4,17,31,-14,17,1
237486,2,14,0,14,3,0
376173,1,7,0,7,14,1
378509,1,0,0,0,15,1
344204,1,0,3,-3,17,1
177869,3,21,16,5,12,1
54828,3,13,0,13,8,0
330324,1,0,3,-3,11,1
90881,2,31,0,31,7,0
418611,3,14,17,-3,16,0
242544,1,0,0,0,6,1
61115,2,0,7,-7,11,0
330978,2,23,7,16,11,1
143621,2,10,10,0,14,1
35852,1,0,0,0,17,1
373014,1,0,0,0,13,0
167355,3,23,16,7,7,1
407335,4,23,26,-3,11,1
178381,4,28,27,1,12,0
25578,3,24,10,14,12,1
107103,4,40,6,34,15,0
27176,2,13,7,6,13,1
84506,4,27,17,10,4,0
17011,4,34,26,8,8,0
101849,2,3,0,3,12,0
344174,4,35,11,24,17,0
155701,3,10,13,-3,2,0
254150,3,3,12,-9,11,1
17848,3,16,10,6,9,0
239618,4,20,17,3,4,0
184657,3,10,17,-7,15,0
176466,1,0,10,-10,11,0
30721,2,17,21,-4,15,1
241847,2,13,3,10,5,0
401558,2,17,14,3,8,1
248981,4,27,3,24,9,1
379411,1,0,0,0,16,0
180594,1,7,3,4,13,0
382457,4,0,24,-24,17,0
356707,3,19,16,3,5,1
252963,3,9,10,-1,11,1
128860,4,20,16,4,7,0
29723,2,17,3,14,14,1
401359,1,10,0,10,8,1
164504,3,17,0,17,5,0
166677,1,0,0,0,6,1
172533,2,0,7,-7,9,0
24272,4,13,17,-4,12,0
419499,3,10,17,-7,16,1
369386,1,10,0,10,11,1
86861,3,9,23,-14,5,1
331371,4,8,33,-25,11,1
405325,4,14,12,2,10,0
178555,4,16,13,3,12,1
150409,1,7,0,7,16,1
329268,4,31,13,18,10,0
246495,2,19,0,19,8,0
121760,4,28,49,-21,4,1
254458,3,20,7,13,11,0
214695,1,0,0,0,11,1
148128,1,0,7,-7,16,1
9591,1,3,7,-4,5,1
330149,4,0,16,-16,11,0
25603,4,30,10,20,12,0
195173,1,7,0,7,2,1
148631,3,7,9,-2,16,1
302124,4,34,34,0,15,0
240680,4,36,24,12,5,1
275251,1,3,0,3,3,1
237712,4,20,17,3,4,1
189275,1,3,0,3,16,0
173048,3,24,6,18,9,0
67668,4,7,35,-28,14,0
234481,3,20,13,7,2,0
296442,2,14,0,14,13,1
402402,2,7,7,0,9,1
301239,4,27,17,10,15,0
152961,3,28,17,11,1,1
420078,4,24,21,3,17,1
250812,3,3,9,-6,10,1
262055,4,24,31,-7,14,0
220167,4,29,13,16,13,1
11817,2,27,17,10,6,1
350046,3,20,10,10,2,0
49290,1,0,0,0,6,0
15822,4,8,12,-4,8,0
335796,1,0,0,0,13,1
247304,3,35,28,7,8,1
408514,4,10,10,0,12,0
131186,1,0,0,0,8,0
284560,1,7,0,7,7,0
387338,1,7,0,7,2,0
384599,3,10,49,-39,1,1
359430,1,0,6,-6,6,0
110024,3,27,10,17,16,0
122405,2,0,17,-17,4,0
67910,3,19,3,16,14,1
9932,3,3,3,0,5,0
415470,3,23,3,20,15,0
264170,4,27,27,0,15,1
358082,1,7,0,7,6,1
267621,1,0,0,0,17,0
91317,2,7,7,0,8,0
273584,1,3,3,0,2,1
359710,1,10,6,4,6,1
223952,1,0,0,0,15,0
145788,3,13,10,3,15,1
317208,3,7,13,-6,5,0
294100,4,7,27,-20,12,1
300484,3,16,3,13,14,0
115123,3,3,20,-17,1,0
292788,3,26,17,9,11,1
354373,3,45,3,42,4,0
399761,2,0,17,-17,8,0
168308,3,10,21,-11,7,1
156790,2,14,13,1,2,0
177750,4,13,17,-4,12,0
272426,3,31,10,21,2,1
133316,2,7,3,4,9,1
287908,1,7,9,-2,9,0
74955,2,17,10,7,17,0
244104,4,20,34,-14,6,1
357993,3,24,13,11,6,0
46030,2,14,14,0,4,1
159013,4,33,29,4,3,0
393834,2,7,17,-10,5,0
279216,2,10,3,7,5,0
326132,4,30,10,20,9,1
140702,1,3,7,-4,12,0
115537,2,0,3,-3,1,0
358519,1,0,3,-3,6,1
323933,2,10,7,3,8,1
348352,2,10,7,3,1,0
113686,1,0,7,-7,17,1
80718,4,40,33,7,3,0
209534,2,34,10,24,8,0
314404,4,10,17,-7,3,1
67679,1,0,0,0,14,0
400238,3,10,6,4,8,0
412772,2,14,10,4,14,0
187098,3,10,0,10,16,1
394163,2,16,10,6,5,0
410785,4,22,6,16,13,0
247943,4,20,6,14,8,1
337409,4,21,14,7,14,0
338831,2,10,7,3,15,0
251201,2,10,10,0,10,0
245183,4,17,28,-11,7,0
362204,2,6,3,3,8,0
296372,4,13,28,-15,13,1
113806,4,13,24,-11,17,1
402189,4,19,14,5,9,0
384166,3,21,20,1,1,1
295877,2,7,14,-7,12,1
145674,4,41,7,34,14,1
335803,1,7,0,7,13,0
201139,2,6,14,-8,5,0
285961,3,29,7,22,8,0
75485,4,31,7,24,17,1
210605,3,13,17,-4,9,1
153964,1,7,0,7,1,0
197302,3,14,0,14,3,0
267023,4,22,17,5,17,0
249562,3,14,10,4,9,0
205281,1,3,0,3,6,1
63818,4,14,34,-20,12,1
100270,1,0,0,0,12,0
79010,2,10,7,3,2,1
419895,3,6,18,-12,17,0
107698,1,0,0,0,15,1
307064,3,24,0,24,17,0
85299,2,7,3,4,5,1
25206,1,0,0,0,12,0
360520,1,0,0,0,7,0
347011,3,10,3,7,1,0
267102,3,10,3,7,17,0
115867,2,7,13,-6,1,0
182157,2,19,7,12,13,1
183951,2,14,3,11,14,0
65403,1,0,7,-7,13,0
328608,2,17,21,-4,10,0
45388,4,20,26,-6,4,1
182759,1,10,0,10,14,0
87042,4,14,22,-8,5,0
307627,2,7,7,0,17,1
289700,1,0,0,0,10,0
101048,1,0,3,-3,12,1
329736,1,3,0,3,11,1
183102,3,7,3,4,14,0
293059,3,10,13,-3,11,1
256015,4,19,12,7,12,1
24818,2,6,3,3,12,1
376567,3,15,6,9,14,1
327288,3,16,20,-4,9,0
128516,3,21,28,-7,7,0
345421,3,0,13,-13,17,1
207119,1,0,0,0,7,1
27473,2,17,0,17,13,0
200977,1,14,0,14,5,1
343213,3,10,0,10,16,1
222795,2,10,7,3,14,0
346614,1,7,0,7,1,0
417980,2,14,21,-7,16,0
354091,3,19,0,19,4,0
137640,5,37,37,0,11,1
343475,2,7,7,0,16,1
151456,2,21,7,14,17,1
166998,2,0,7,-7,7,0
419369,4,3,23,-20,16,0
391336,4,24,3,21,4,0
40740,2,17,14,3,2,1
103102,3,34,7,27,13,0
223074,2,24,7,17,14,0
209995,2,7,3,4,8,0
55911,1,0,0,0,9,1
286924,4,23,13,10,8,0
57979,4,13,17,-4,10,0
221400,2,3,17,-14,14,1
321713,2,3,3,0,7,1
114423,4,41,20,21,1,1
400549,3,13,24,-11,8,1
347172,4,23,17,6,1,0
373675,2,0,12,-12,13,0
196265,3,21,10,11,2,0
118087,1,3,6,-3,2,0
225195,2,3,7,-4,15,1
193902,4,24,10,14,1,1
68026,2,0,10,-10,14,1
388599,2,14,0,14,3,0
248154,2,3,10,-7,8,1
77259,3,16,7,9,1,0
68778,2,6,0,6,15,1
260318,1,0,0,0,14,0
349993,1,3,7,-4,2,1
65399,1,0,7,-7,13,1
299762,4,17,6,11,14,0
402035,4,3,19,-16,9,1
312151,4,33,23,10,2,1
175115,2,21,10,11,10,0
318786,4,17,26,-9,5,0
177197,1,0,0,0,11,0
302496,2,3,10,-7,15,1
394044,3,9,13,-4,5,1
228489,2,10,7,3,17,1
273522,4,21,21,0,2,0
178385,4,28,27,1,12,1
92904,4,34,7,27,8,1
98705,2,21,3,18,11,1
377592,4,20,12,8,15,1
96144,2,0,16,-16,10,1
12477,4,13,9,4,6,1
121225,3,21,27,-6,3,0
51746,2,3,10,-7,7,0
44148,3,13,20,-7,3,0
203067,3,33,17,16,5,1
70410,1,7,14,-7,15,1
375679,4,23,20,3,14,1
176080,4,24,16,8,11,1
327043,4,14,10,4,9,0
9649,3,12,21,-9,5,1
20060,4,19,16,3,10,0
71590,2,3,14,-11,16,0
232432,1,3,0,3,1,1
159231,2,14,24,-10,3,1
249764,4,35,28,7,9,0
368913,4,38,3,35,11,0
390639,1,0,3,-3,3,0
291549,2,3,3,0,11,1
345217,2,7,14,-7,17,0
312976,2,0,0,0,3,1
316133,3,24,19,5,4,1
182913,2,0,30,-30,14,1
103236,3,3,7,-4,13,0
132940,1,0,0,0,9,0
189071,3,21,30,-9,16,1
336812,4,10,30,-20,14,1
325054,4,26,24,2,8,1
313064,4,20,0,20,3,1
328875,1,3,0,3,10,1
153718,2,2,21,-19,1,1
90082,1,0,0,0,7,1
199800,2,3,3,0,4,0
302218,2,28,7,21,15,0
29715,2,16,3,13,14,1
193363,2,7,10,-3,1,0
247585,3,16,16,0,8,1
147008,3,24,0,24,15,1
72942,3,17,7,10,16,1
234747,1,0,0,0,2,1
293243,3,23,7,16,11,0
363759,4,29,27,2,8,1
246890,1,0,7,-7,8,0
338974,2,13,0,13,15,1
217965,1,7,0,7,12,0
143441,1,7,7,0,14,1
277564,3,6,14,-8,4,1
395005,1,0,14,-14,5,1
411021,2,14,14,0,13,1
271127,2,0,10,-10,1,1
102321,3,13,10,3,13,0
267611,4,30,34,-4,17,1
257503,2,16,10,6,13,0
382705,3,3,13,-10,17,1
83215,2,3,7,-4,4,1
207846,2,7,0,7,8,0
376288,4,17,21,-4,14,1
394565,1,0,0,0,5,1
274769,4,24,23,1,3,1
412855,4,31,35,-4,14,1
117029,2,0,16,-16,2,0
278182,3,24,14,10,4,0
217143,2,3,9,-6,12,0
352520,2,14,6,8,3,1
345707,2,7,0,7,17,0
109098,2,7,6,1,15,0
216263,4,24,20,4,12,0
104297,2,24,14,10,13,1
115266,3,7,9,-2,1,0
17426,4,17,7,10,9,0
235035,4,27,17,10,2,0
12081,2,7,0,7,6,0
140436,2,7,7,0,12,1
168688,2,7,3,4,7,1
147,5,10,10,0,1,1
322807,3,3,27,-24,7,0
34541,1,0,0,0,16,0
152238,3,21,0,21,17,0
196157,4,31,24,7,2,1
204674,1,7,0,7,6,0
90168,3,3,0,3,7,1
414075,1,0,0,0,14,0
71469,3,30,7,23,16,0
341665,2,17,13,4,16,1
29662,1,0,0,0,14,0
414539,2,14,3,11,14,1
157325,4,19,9,10,2,0
2245,2,10,7,3,1,0
54338,2,7,12,-5,8,1
85216,3,10,17,-7,4,1
43448,5,24,27,-3,3,0
277569,3,6,14,-8,4,0
37242,3,10,14,-4,17,1
63460,2,21,13,8,12,0
231120,1,3,0,3,1,1
112204,1,7,0,7,17,0
81739,3,17,17,0,3,0
221952,4,22,19,3,14,1
36904,1,0,14,-14,17,1
334048,1,0,0,0,13,1
388569,1,14,0,14,3,1
164580,1,0,3,-3,5,1
11194,2,0,7,-7,6,1
369953,1,7,0,7,12,1
330148,4,0,16,-16,11,1
329741,1,3,0,3,11,0
248779,3,27,14,13,9,1
386063,3,14,0,14,1,0
204778,3,21,21,0,6,0
114341,2,17,6,11,1,0
230253,2,6,10,-4,17,0
310711,1,3,0,3,2,0
381876,4,25,28,-3,17,1
19869,2,10,21,-11,10,1
302412,4,16,19,-3,15,0
30596,3,17,0,17,14,0
182204,4,33,7,26,13,1
298794,2,14,6,8,14,1
121837,2,0,7,-7,4,0
107101,4,40,6,34,15,0
86745,4,24,14,10,5,1
404555,4,34,27,7,10,0
174799,2,13,14,-1,10,0
275605,2,21,3,18,3,0
88251,1,0,0,0,6,1
36590,1,3,0,3,17,0
113362,4,26,38,-12,17,1
254889,2,14,7,7,12,0
233432,2,17,3,14,2,0
150917,3,7,7,0,17,1
10523,3,27,0,27,5,1
123300,2,14,7,7,4,0
213514,2,10,7,3,10,0
34716,2,6,3,3,16,0
94060,3,6,27,-21,9,0
170441,3,21,3,18,8,0
172200,2,0,6,-6,9,0
211032,2,20,0,20,9,0
215910,2,3,7,-4,11,0
232736,1,0,0,0,2,1
96249,1,0,6,-6,10,1
214600,3,3,9,-6,11,1
407155,4,17,27,-10,11,1
101521,2,10,14,-4,12,0
361833,4,37,10,27,7,1
331984,2,0,0,0,12,1
139312,4,20,13,7,12,1
165993,3,17,14,3,6,0
158303,1,6,7,-1,3,0
198549,5,20,20,0,3,1
25922,1,0,0,0,13,1
406406,3,23,7,16,11,1
124868,3,9,6,3,5,0
16889,1,7,13,-6,8,1
96,3,7,7,0,1,1
46204,3,14,21,-7,4,1
80611,2,0,10,-10,3,0
412887,1,0,0,0,14,1
204505,4,17,24,-7,6,0
224112,1,0,7,-7,15,0
175967,1,0,0,0,11,0
270336,5,27,27,0,1,1
59353,3,0,9,-9,11,0
229761,4,20,17,3,17,1
386295,1,0,0,0,2,1
330357,2,7,13,-6,11,1
397578,2,6,20,-14,7,1
358981,2,7,0,7,6,1
291455,3,14,20,-6,10,0
54163,1,0,3,-3,8,1
416625,3,28,7,21,15,1
142692,1,0,0,0,13,0
69440,3,24,3,21,15,0
308302,4,13,23,-10,1,1
382142,4,27,3,24,17,0
302427,1,0,3,-3,15,0
410935,4,14,22,-8,13,1
8580,1,0,3,-3,4,0
263881,1,6,0,6,15,0
411417,1,0,7,-7,13,1
237831,2,7,13,-6,4,0
145581,2,21,0,21,14,0
32945,2,0,14,-14,15,0
113593,2,6,0,6,17,0
280474,4,34,31,3,5,1
320619,4,31,18,13,6,1
319499,3,10,17,-7,6,0
248952,3,20,3,17,9,1
101511,1,10,7,3,12,1
85535,3,17,12,5,5,0
319093,1,0,0,0,5,1
256819,4,13,19,-6,12,1
183906,1,7,0,7,14,0
32974,2,0,24,-24,15,1
45092,1,0,0,0,4,1
274931,4,17,16,1,3,0
373770,4,26,21,5,13,0
247163,4,20,6,14,8,0
142558,1,0,0,0,13,0
224968,4,10,16,-6,15,0
189121,1,0,0,0,16,0
72093,4,10,17,-7,16,1
275951,4,20,18,2,3,0
47517,2,17,6,11,5,1
413509,1,0,0,0,14,0
315454,1,0,0,0,4,1
314997,1,7,0,7,4,1
104947,3,9,9,0,14,1
195880,1,0,0,0,2,0
361112,4,23,16,7,7,0
150354,3,27,7,20,16,1
265173,1,0,3,-3,16,0
410154,3,17,17,0,13,1
187636,1,0,3,-3,16,1
208418,1,0,0,0,8,1
353263,2,28,17,11,4,0
296417,1,7,0,7,13,1
177734,3,13,17,-4,12,1
281612,2,21,0,21,6,0
135479,1,7,0,7,10,0
251090,2,10,14,-4,10,0
170497,4,21,10,11,8,0
150939,4,13,7,6,17,0
87332,4,27,24,3,6,1
372421,2,6,7,-1,13,1
93118,1,0,0,0,9,0
102007,2,7,3,4,12,1
118360,1,3,7,-4,2,1
178936,2,6,3,3,12,1
223345,1,0,3,-3,15,0
31204,3,23,27,-4,15,0
305960,1,0,0,0,17,1
269440,4,21,20,1,1,0
3610,3,20,21,-1,2,0
122914,4,34,6,28,4,1
60784,1,7,0,7,11,0
342644,4,22,27,-5,16,1
323424,4,23,0,23,7,0
322667,4,6,9,-3,7,1
225375,3,24,21,3,15,0
85934,2,7,14,-7,5,1
229171,4,19,7,12,17,0
34781,4,20,3,17,16,0
407555,2,10,3,7,11,0
330338,2,7,3,4,11,0
413691,2,14,13,1,14,0
391196,4,10,24,-14,4,1
166013,3,17,21,-4,6,1
68909,4,13,27,-14,15,0
1635,1,0,0,0,1,1
314220,3,14,20,-6,3,1
258584,3,13,10,3,13,1
88126,1,0,0,0,6,0
383380,2,0,9,-9,17,1
391118,2,7,17,-10,4,1
356660,2,16,3,13,5,0
75065,1,0,0,0,17,1
183938,2,7,3,4,14,1
333601,4,24,23,1,12,0
89695,3,6,17,-11,7,1
330762,5,9,9,0,11,1
75576,2,7,3,4,17,0
152761,2,0,7,-7,17,1
100645,2,13,14,-1,12,1
279553,3,10,13,-3,5,1
82692,4,12,19,-7,3,1
48709,2,10,19,-9,5,0
125902,2,13,10,3,6,1
285600,3,19,10,9,8,1
126145,1,0,0,0,6,0
239099,2,10,10,0,4,1
6666,2,3,13,-10,3,1
38876,4,10,13,-3,1,1
96968,4,22,10,12,10,0
181241,2,0,0,0,13,0
185474,4,24,20,4,15,0
101307,4,17,20,-3,12,1
212244,1,0,0,0,10,0
257370,3,17,0,17,13,1
120809,1,7,7,0,3,0
47630,1,3,17,-14,5,0
249128,4,28,28,0,9,1
91498,3,19,0,19,8,0
379383,4,10,22,-12,16,1
219703,4,13,14,-1,13,1
345761,4,16,10,6,17,1
369936,4,16,22,-6,12,0
410634,4,17,23,-6,13,1
56309,3,3,26,-23,9,1
370315,3,7,35,-28,12,1
372289,2,10,7,3,13,0
96955,4,22,10,12,10,1
319071,4,20,38,-18,5,0
197532,1,0,0,0,3,1
382207,1,3,3,0,17,1
339905,3,26,0,26,15,0
179263,3,26,3,23,12,0
133205,3,19,17,2,9,1
58412,3,34,10,24,10,1
281523,4,17,13,4,6,1
171637,3,19,10,9,9,0
124523,1,3,0,3,5,1
418569,2,14,3,11,16,0
254292,2,6,16,-10,11,1
9698,4,19,28,-9,5,1
409966,2,6,21,-15,12,0
330539,3,7,7,0,11,1
313782,4,31,17,14,3,0
419502,4,10,17,-7,16,0
247973,1,6,3,3,8,1
188948,4,26,13,13,16,0
117644,2,13,13,0,2,0
358753,4,14,17,-3,6,1
164843,1,0,3,-3,6,1
350228,4,27,0,27,2,1
137810,1,0,6,-6,11,1
140618,3,31,10,21,12,0
54994,4,13,10,3,8,0
28693,3,3,10,-7,14,1
234352,3,17,3,14,2,0
324611,4,16,15,1,8,1
243107,3,7,9,-2,6,0
360766,3,17,21,-4,7,1
179330,1,0,0,0,12,0
191393,3,0,31,-31,17,0
292341,3,12,13,-1,11,0
45328,3,17,16,1,4,1
161819,4,37,13,24,4,0
227066,4,17,9,8,16,1
243321,4,14,17,-3,6,1
268660,4,20,20,0,17,0
317387,3,7,9,-2,5,0
204687,1,7,7,0,6,1
136205,4,13,10,3,10,0
158217,3,24,0,24,3,1
100431,1,0,0,0,12,0
91922,2,3,3,0,8,0
214090,1,3,3,0,11,1
102397,4,19,34,-15,13,1
300817,4,10,33,-23,15,1
330,1,14,3,11,1,0
414553,3,21,3,18,14,1
23572,1,7,0,7,12,0
77943,2,3,0,3,1,0
91617,2,14,7,7,8,0
271918,3,17,13,4,2,0
393307,4,30,29,1,5,0
346036,2,3,6,-3,1,1
111505,2,7,0,7,16,1
126462,1,0,3,-3,6,0
105661,2,7,3,4,14,1
155110,4,13,33,-20,1,0
167019,2,3,14,-11,7,1
363957,2,0,9,-9,8,1
81923,4,7,30,-23,3,0
29358,4,21,16,5,14,1
72793,3,21,14,7,16,0
252310,2,0,16,-16,10,0
278341,3,17,14,3,4,0
321659,4,20,20,0,7,0
21285,3,3,14,-11,11,1
112533,2,10,9,1,17,0
146487,1,7,0,7,15,0
400439,4,24,10,14,8,1
215163,2,7,6,1,11,1
47094,4,31,10,21,5,0
197983,2,0,17,-17,3,1
297784,2,7,7,0,13,1
96899,2,19,7,12,10,0
396725,3,7,14,-7,6,0
191636,1,0,0,0,17,0
124106,2,3,21,-18,5,0
367576,3,14,9,5,10,0
102609,2,5,6,-1,13,1
84318,3,14,27,-13,4,0
352003,4,28,21,7,3,1
365008,3,17,6,11,9,1
241894,3,20,13,7,5,0
361684,3,10,32,-22,7,0
13300,2,0,20,-20,7,1
40558,1,7,0,7,2,1
2968,2,7,10,-3,2,1
193430,3,20,20,0,1,1
329697,4,37,17,20,11,1
327850,2,16,10,6,10,0
204745,2,14,14,0,6,1
80250,4,34,31,3,2,1
296607,2,3,7,-4,13,1
367152,3,29,16,13,10,0
135787,2,0,14,-14,10,1
240854,4,39,10,29,5,0
371391,1,7,7,0,12,0
8271,1,0,0,0,4,0
232422,1,0,0,0,1,1
148479,3,21,3,18,16,0
394753,2,14,0,14,5,0
16105,3,33,7,26,8,0
354957,2,7,6,1,4,1
43907,1,0,0,0,3,0
16999,4,34,23,11,8,0
47920,1,0,0,0,5,1
353923,4,17,28,-11,4,1
182881,1,0,3,-3,14,1
151276,1,7,0,7,17,0
389293,1,0,0,0,3,0
151202,3,10,20,-10,17,0
255777,2,10,0,10,12,0
1157,4,10,36,-26,1,1
70685,1,0,3,-3,15,0
185945,4,22,30,-8,15,0
43763,1,14,0,14,3,0
158223,3,31,0,31,3,0
90214,4,6,3,3,7,1
316136,3,24,19,5,4,1
238815,2,27,0,27,4,0
220532,2,7,17,-10,13,0
313510,5,23,17,6,3,1
47964,2,3,21,-18,5,1
190354,2,7,0,7,17,1
87764,4,6,20,-14,6,1
56364,1,0,0,0,9,0
164584,1,0,3,-3,5,1
323167,1,0,0,0,7,0
233178,4,29,10,19,2,1
103605,1,0,0,0,13,0
313110,1,0,0,0,3,0
313834,1,7,3,4,3,0
30704,2,10,14,-4,15,1
253005,4,18,13,5,11,1
404181,3,9,7,2,10,0
172217,2,7,12,-5,9,0
62598,2,6,17,-11,12,1
164229,3,33,38,-5,5,1
214211,1,0,3,-3,11,1
254386,1,7,0,7,11,0
274308,4,32,18,14,3,0
219362,3,23,13,10,13,0
314672,4,14,21,-7,3,1
88449,2,7,0,7,6,0
350901,2,3,14,-11,3,1
5938,3,14,23,-9,3,0
337372,3,21,7,14,14,0
10113,4,44,7,37,5,0
168273,2,10,7,3,7,0
195395,3,17,3,14,2,1
170948,4,38,20,18,8,0
183977,3,22,3,19,14,1
370446,2,10,6,4,12,1
175424,3,17,20,-3,11,0
223179,1,3,0,3,15,0
359848,1,17,7,10,6,0
106156,3,0,0,0,14,1
368724,3,7,16,-9,11,1
91912,2,0,3,-3,8,1
151441,2,21,0,21,17,0
375555,4,33,14,19,14,0
392557,4,10,20,-10,4,0
207928,4,35,14,21,8,0
410837,1,14,3,11,13,1
403306,2,6,0,6,9,0
149009,4,13,19,-6,16,1
219586,1,0,0,0,13,1
345262,3,13,14,-1,17,1
165608,1,0,0,0,6,1
373710,3,13,18,-5,13,0
284776,3,26,17,9,7,1
293019,2,3,13,-10,11,0
50775,4,24,21,3,6,0
18547,1,3,3,0,9,0
124212,1,0,13,-13,5,0
295519,2,14,7,7,12,1
364233,2,0,7,-7,9,1
166005,3,17,21,-4,6,0
235424,3,28,17,11,3,1
264285,3,10,23,-13,15,1
117850,4,9,13,-4,2,0
94567,4,13,10,3,9,0
346721,4,24,13,11,1,1
288578,3,23,31,-8,9,0
355421,3,13,10,3,4,0
341509,2,3,7,-4,16,1
125886,2,13,10,3,6,0
323319,1,0,0,0,7,0
19037,3,7,6,1,10,0
375742,2,3,0,3,14,1
127755,2,7,14,-7,6,0
202511,1,0,0,0,5,0
353593,4,31,0,31,4,1
198382,4,23,14,9,3,0
297273,4,24,6,18,13,1
257724,4,3,24,-21,13,1
355909,4,27,10,17,5,0
221581,3,20,15,5,14,0
173385,4,34,27,7,10,0
4961,4,21,17,4,3,0
39061,1,3,0,3,1,1
331981,2,0,0,0,12,0
91007,2,3,0,3,7,1
183108,3,7,6,1,14,1
122802,1,7,0,7,4,0
57675,4,17,17,0,10,1
48254,2,3,10,-7,5,1
173793,3,10,3,7,10,1
108761,1,0,0,0,15,0
281643,2,21,9,12,6,0
200071,1,0,0,0,4,1
228011,1,0,0,0,17,0
142287,2,0,0,0,13,0
405573,2,7,14,-7,10,1
142388,1,0,0,0,13,0
3186,4,16,9,7,2,1
49214,3,17,3,14,6,1
168539,1,0,3,-3,7,1
377770,4,39,14,25,15,0
410470,4,9,20,-11,13,0
276991,4,24,20,4,4,1
170061,1,0,0,0,8,1
213554,3,10,14,-4,10,1
26868,2,10,6,4,13,1
144323,4,29,7,22,14,1
410261,2,7,7,0,13,1
176631,2,7,12,-5,11,0
141294,1,0,7,-7,13,1
79287,2,12,3,9,2,1
77062,2,7,17,-10,1,1
323132,4,29,14,15,7,1
140995,2,7,0,7,13,1
259043,4,3,16,-13,13,1
390400,3,7,27,-20,3,1
121239,4,21,30,-9,3,1
222383,4,24,10,14,14,1
308970,2,0,3,-3,1,1
310985,4,16,37,-21,2,0
268207,4,12,28,-16,17,1
289564,1,7,6,1,10,0
252888,1,3,0,3,11,1
338434,4,30,24,6,14,1
201454,2,12,0,12,5,1
351939,2,14,7,7,3,0
131761,4,24,28,-4,8,1
70076,4,31,17,14,15,0
15437,1,0,0,0,8,1
103204,2,3,0,3,13,0
168317,3,17,21,-4,7,0
125738,2,7,7,0,5,0
325664,4,24,7,17,9,1
40736,2,17,7,10,2,0
372388,1,6,0,6,13,1
366602,4,26,14,12,10,1
70226,4,30,30,0,15,1
393931,5,23,23,0,5,0
208862,1,7,0,7,8,0
197157,3,27,20,7,3,0
180689,4,27,6,21,13,0
109309,4,13,3,10,15,0
206249,2,7,6,1,7,0
186153,2,13,6,7,15,0
413291,3,17,0,17,14,1
325851,4,13,20,-7,9,1
146365,2,3,3,0,15,1
201910,1,0,0,0,5,1
261157,4,21,24,-3,14,1
164510,3,17,3,14,5,0
376209,2,10,7,3,14,1
24666,2,17,0,17,12,0
240485,3,3,7,-4,5,0
370583,2,14,14,0,12,1
343417,1,0,0,0,16,0
302752,1,3,3,0,15,0
289221,4,23,13,10,9,1
396007,4,31,20,11,6,1
366485,4,34,22,12,10,0
235672,2,0,3,-3,3,1
206510,1,0,0,0,7,0
94676,3,17,29,-12,9,1
176213,4,14,24,-10,11,0
252639,2,6,3,3,10,0
368322,4,12,19,-7,11,0
94542,3,3,10,-7,9,1
33248,2,10,0,10,16,1
18342,4,25,17,8,9,0
192177,3,3,20,-17,1,1
259652,4,9,6,3,13,0
32751,4,7,24,-17,15,1
44518,1,0,0,0,3,0
5563,4,19,10,9,3,0
284057,4,13,3,10,7,0
1480,1,0,3,-3,1,0
86838,2,9,13,-4,5,0
327526,2,7,9,-2,10,0
232110,4,7,33,-26,1,1
71765,3,31,29,2,16,0
19770,4,9,12,-3,10,1
286539,2,3,14,-11,8,1
394865,2,0,14,-14,5,1
382186,1,0,0,0,17,0
317867,4,15,10,5,5,0
144318,4,29,7,22,14,1
420672,3,21,16,5,17,0
170078,1,6,0,6,8,1
387283,3,6,10,-4,2,0
243274,2,7,10,-3,6,1
107490,3,3,20,-17,15,1
415064,4,13,34,-21,15,1
236550,3,10,9,1,3,1
380560,3,21,24,-3,16,0
231963,4,14,41,-27,1,1
360122,1,7,3,4,7,0
51190,3,24,6,18,7,1
48903,3,12,0,12,5,0
217487,3,12,3,9,12,1
124023,1,0,0,0,5,1
80183,2,7,10,-3,2,1
79206,4,20,10,10,2,1
410983,1,0,7,-7,13,0
45439,2,14,7,7,4,1
298624,1,3,0,3,14,1
155603,4,30,17,13,2,0
1794,2,3,0,3,1,1
204321,4,0,17,-17,6,1
157926,3,9,15,-6,3,1
276776,2,17,10,7,4,1
191461,4,7,34,-27,17,1
21651,1,0,0,0,11,1
368016,3,17,21,-4,11,1
224055,4,14,6,8,15,0
253987,2,0,6,-6,11,0
258967,2,0,13,-13,13,0
49636,2,0,7,-7,6,1
351879,4,27,14,13,3,0
164663,4,14,27,-13,5,1
365933,4,14,28,-14,9,1
216105,4,24,26,-2,11,0
359788,4,27,26,1,6,1
116998,1,0,3,-3,2,1
316189,4,30,35,-5,4,1
363208,1,0,7,-7,8,0
241886,3,13,13,0,5,1
339699,2,7,3,4,15,0
162474,2,7,3,4,4,0
177262,3,14,17,-3,11,1
369917,4,13,16,-3,12,1
15537,4,23,6,17,8,1
81778,4,34,24,10,3,0
133046,3,12,14,-2,9,1
139176,4,19,13,6,12,0
41106,4,3,19,-16,2,1
419750,3,10,10,0,17,0
152152,1,0,0,0,17,0
197220,4,37,34,3,3,1
49027,2,10,7,3,6,0
96832,1,0,0,0,10,1
385806,3,30,3,27,1,1
15235,3,16,7,9,8,1
324561,3,13,9,4,8,0
55353,1,7,0,7,9,0
37856,1,0,0,0,1,1
48667,1,7,6,1,5,0
148847,4,16,23,-7,16,0
75991,1,7,7,0,1,1
201319,3,28,10,18,5,0
268667,4,20,20,0,17,0
324854,2,9,10,-1,8,1
134718,1,3,0,3,10,1
219649,3,10,7,3,13,1
250979,3,3,6,-3,10,1
28230,3,17,0,17,13,0
67946,4,22,3,19,14,0
389994,4,28,25,3,3,1
203132,1,0,7,-7,5,0
142993,4,10,20,-10,13,1
181816,1,0,0,0,13,1
112038,4,48,21,27,17,0
95457,4,34,7,27,10,1
396526,2,17,7,10,6,0
134374,4,29,21,8,10,0
177740,3,13,17,-4,12,1
347821,4,16,0,16,1,1
38682,3,14,7,7,1,0
252774,2,3,6,-3,11,1
408039,2,10,10,0,12,0
121263,4,27,30,-3,3,1
359884,2,20,21,-1,6,0
7391,1,3,0,3,4,1
70843,1,7,3,4,15,0
344067,1,0,3,-3,17,1
30440,2,17,22,-5,14,0
317378,3,7,3,4,5,0
291865,2,7,7,0,11,0
414548,2,21,3,18,14,0
159772,4,7,13,-6,3,1
243397,2,3,10,-7,6,1
370415,2,7,0,7,12,0
338201,2,14,21,-7,14,1
236995,4,45,7,38,3,0
196299,4,21,17,4,2,1
164453,2,14,0,14,5,0
17206,2,7,28,-21,9,1
266117,4,17,13,4,16,0
154567,2,14,7,7,1,0
398575,1,0,0,0,7,1
122447,3,6,26,-20,4,1
358182,4,20,15,5,6,0
390317,1,0,0,0,3,1
300689,4,24,3,21,15,1
165940,1,3,7,-4,6,0
369873,3,7,9,-2,12,0
337553,4,7,33,-26,14,1
368180,4,21,21,0,11,1
125362,4,38,3,35,5,0
400501,2,7,3,4,8,0
261323,1,0,7,-7,14,0
335761,4,10,7,3,13,1
210827,1,0,0,0,9,0
383535,3,14,13,1,17,0
238476,2,6,0,6,4,0
107461,2,0,17,-17,15,1
94250,4,24,30,-6,9,0
318629,4,10,13,-3,5,0
161758,3,24,6,18,4,0
378163,3,21,16,5,15,0
150043,4,24,6,18,16,1
209746,4,9,6,3,8,1
232975,3,10,3,7,2,0
145708,1,0,7,-7,15,0
189369,4,20,10,10,16,0
81436,4,10,13,-3,3,0
251409,4,43,14,29,10,0
303153,4,21,28,-7,16,0
70834,1,7,0,7,15,0
227706,1,0,0,0,16,1
66326,2,0,14,-14,14,1
122762,4,10,27,-17,4,0
298381,2,7,14,-7,14,1
97433,4,16,36,-20,10,0
355232,2,3,14,-11,4,0
338109,4,6,7,-1,14,0
301846,1,0,0,0,15,1
382816,2,21,0,21,17,0
226489,4,14,10,4,16,0
30718,2,17,21,-4,15,1
350887,2,0,14,-14,3,0
106682,1,0,0,0,14,0
339461,3,10,23,-13,15,1
241321,4,13,14,-1,5,1
408050,3,10,10,0,12,0
203793,3,17,10,7,6,1
211997,2,3,16,-13,9,1
28444,4,13,6,7,14,0
358820,1,0,7,-7,6,1
387839,2,10,13,-3,2,0
241696,2,7,3,4,5,0
2902,4,31,34,-3,2,1
234549,4,20,20,0,2,0
175211,1,7,0,7,10,1
352580,3,34,20,14,3,0
73664,3,13,0,13,17,0
311515,3,17,13,4,2,1
200543,1,7,0,7,4,0
210057,4,17,17,0,8,0
401179,4,51,13,38,8,1
254843,1,0,0,0,12,0
168676,1,7,0,7,7,0
175621,1,0,0,0,11,1
122347,4,13,19,-6,4,0
157597,3,12,0,12,2,0
370454,2,13,6,7,12,1
243370,1,0,7,-7,6,1
208736,2,0,6,-6,8,1
112710,2,3,0,3,17,0
140952,4,23,13,10,13,0
246039,2,7,13,-6,7,1
241172,4,20,10,10,5,0
65304,3,3,21,-18,13,0
145334,3,35,19,16,14,1
257862,3,13,12,1,13,1
370751,2,12,10,2,12,1
130341,2,7,0,7,8,1
129252,3,14,13,1,7,1
164249,4,41,41,0,5,1
260370,3,6,0,6,14,1
160653,2,7,0,7,4,1
273018,3,6,3,3,2,0
261664,2,7,0,7,14,0
201766,2,6,0,6,5,0
387661,1,0,7,-7,2,0
246229,4,21,16,5,7,0
91054,3,9,0,9,7,0
365138,2,7,21,-14,9,1
92831,2,14,0,14,8,1
228002,1,0,0,0,17,1
215986,4,20,42,-22,11,0
180830,4,17,20,-3,13,1
145407,1,0,7,-7,14,1
58493,1,0,0,0,10,0
217102,1,0,0,0,12,0
24593,4,10,26,-16,12,1
32094,3,14,13,1,15,1
219378,4,23,20,3,13,1
232640,2,0,0,0,1,0
17803,2,7,3,4,9,1
180674,4,24,6,18,13,1
240319,3,7,17,-10,5,1
363287,3,27,7,20,8,0
325570,1,7,0,7,9,1
405502,4,24,16,8,10,0
419825,1,0,0,0,17,0
5859,4,34,7,27,3,0
652,2,0,9,-9,1,0
285741,2,0,3,-3,8,0
367810,2,10,7,3,10,0
418178,3,24,6,18,16,0
20553,4,17,0,17,10,0
109360,1,0,7,-7,16,0
322784,3,3,20,-17,7,1
210235,1,0,0,0,9,0
185067,2,0,3,-3,15,0
24912,1,0,7,-7,12,1
274366,2,3,7,-4,3,0
252087,1,0,0,0,10,0
318740,3,10,23,-13,5,1
91939,2,3,16,-13,8,1
24487,1,0,7,-7,12,0
384466,3,27,0,27,1,1
415912,3,10,20,-10,15,0
97290,4,27,20,7,10,1
383615,1,0,0,0,17,0
174181,2,3,13,-10,10,1
80061,3,17,6,11,2,0
385930,3,10,14,-4,1,0
130801,2,13,6,7,8,0
318586,3,10,10,0,5,1
82984,4,13,19,-6,4,0
310050,4,9,10,-1,2,0
279991,2,3,13,-10,5,1
414964,2,10,7,3,15,0
104775,3,20,19,1,14,0
85180,2,7,10,-3,4,1
369594,4,14,6,8,11,1
113711,2,3,10,-7,17,1
360260,1,0,6,-6,7,1
3214,4,16,9,7,2,0
184762,2,14,7,7,15,1
201705,4,27,20,7,5,0
29219,1,0,0,0,14,1
366767,4,33,10,23,10,1
292783,3,26,17,9,11,1
161227,2,7,3,4,4,0
332146,2,0,10,-10,12,1
390886,4,15,28,-13,3,1
342806,4,7,14,-7,16,0
145909,2,7,0,7,15,0
27581,1,7,0,7,13,0
109593,3,19,14,5,16,1
391547,2,10,21,-11,4,1
290151,1,3,0,3,10,0
314172,2,7,20,-13,3,1
395563,4,35,14,21,6,0
170824,1,7,0,7,8,1
147598,4,15,0,15,15,0
389280,1,0,0,0,3,1
188815,4,7,39,-32,16,1
51554,1,0,0,0,7,0
229149,4,19,7,12,17,1
323847,3,16,21,-5,8,0
194035,3,17,7,10,1,1
107002,1,7,0,7,15,0
54360,3,14,19,-5,8,0
363611,4,18,15,3,8,0
9692,4,12,28,-16,5,1
86432,3,20,7,13,5,1
232348,3,6,12,-6,1,0
168218,4,29,15,14,7,1
379022,2,7,6,1,15,0
116753,3,13,26,-13,2,0
300171,3,21,3,18,14,0
10609,2,0,10,-10,5,0
242881,2,14,10,4,6,0
12147,4,14,21,-7,6,1
203900,5,37,37,0,6,1
32152,4,27,24,3,15,1
180790,3,10,19,-9,13,0
128944,2,25,3,22,7,0
161468,3,10,3,7,4,1
116801,4,34,26,8,2,0
234043,3,20,0,20,2,1
188976,1,0,0,0,16,0
82301,2,3,10,-7,3,1
108244,3,6,0,6,15,0
96959,4,22,10,12,10,1
255398,3,24,6,18,12,0
213692,3,14,17,-3,10,1
225663,3,14,10,4,16,1
330548,3,7,7,0,11,1
30708,2,10,14,-4,15,1
91367,4,14,7,7,8,1
105142,4,33,14,19,14,1
197856,2,8,7,1,3,1
257459,1,0,0,0,13,0
144365,2,0,3,-3,14,0
152275,4,28,0,28,17,0
236907,2,19,0,19,3,1
313437,3,17,7,10,3,1
328673,4,27,38,-11,10,0
310809,4,13,13,0,2,1
232799,3,13,14,-1,2,1
86752,4,27,14,13,5,0
133113,1,0,3,-3,9,1
114594,1,3,0,3,1,1
364619,4,21,37,-16,9,0
194466,3,16,3,13,2,0
290037,2,7,3,4,10,0
234137,1,0,0,0,2,0
50551,2,0,6,-6,6,1
360189,3,17,13,4,7,1
259341,3,21,27,-6,13,0
33953,2,0,27,-27,16,1
273997,4,13,29,-16,2,0
388965,4,17,27,-10,3,1
18320,3,16,17,-1,9,1
71451,2,30,7,23,16,0
331342,4,0,30,-30,11,1
106782,3,20,22,-2,14,1
254990,1,0,6,-6,12,0
251808,1,0,7,-7,10,0
169296,1,0,0,0,8,1
59905,2,3,0,3,11,0
296801,3,7,7,0,13,0
247282,3,28,28,0,8,1
232028,2,0,10,-10,1,0
275140,2,7,10,-3,3,1
70095,1,3,0,3,15,1
10481,2,3,0,3,5,1
227423,2,7,7,0,16,1
409606,4,42,20,22,12,0
259815,4,23,20,3,14,0
266724,1,0,0,0,16,0
86759,4,27,14,13,5,0
409600,4,42,20,22,12,0
341552,3,13,10,3,16,1
246193,2,14,6,8,7,1
326952,2,2,0,2,9,0
187501,2,3,10,-7,16,1
256410,2,9,7,2,12,0
166107,2,14,3,11,6,0
178052,4,13,23,-10,12,1
223889,4,30,6,24,15,1
64602,3,20,14,6,13,0
224686,4,19,17,2,15,1
353732,4,10,17,-7,4,1
241959,1,7,0,7,5,1
296449,2,14,0,14,13,1
64444,2,7,6,1,13,1
283651,4,23,20,3,7,0
113776,3,10,17,-7,17,0
71803,4,38,33,5,16,0
30145,2,10,10,0,14,1
348129,4,17,19,-2,1,0
362590,1,0,0,0,8,1
106981,4,22,13,9,14,1
415391,1,6,0,6,15,0
113872,2,7,3,4,17,0
399939,3,3,13,-10,8,1
73710,4,20,9,11,17,0
122711,2,7,10,-3,4,0
352513,2,14,6,8,3,1
311424,1,0,0,0,2,0
381017,1,0,0,0,16,0
133924,3,6,6,0,9,1
203588,1,0,0,0,6,0
81212,1,0,7,-7,3,0
307625,2,7,7,0,17,1
137950,4,30,22,8,11,1
392744,1,7,0,7,4,0
87750,4,6,20,-14,6,1
31913,2,6,10,-4,15,0
379152,2,6,3,3,16,0
239748,4,13,13,0,4,0
148083,4,14,10,4,15,0
239258,2,0,7,-7,4,1
51831,1,0,0,0,7,1
29081,1,0,6,-6,14,0
56444,3,0,35,-35,9,0
291843,2,0,7,-7,11,0
345824,1,0,7,-7,17,0
368297,3,9,6,3,11,0
92013,4,27,23,4,8,0
357778,1,3,7,-4,6,0
245609,4,40,13,27,7,1
397741,3,9,14,-5,7,0
136734,2,13,10,3,11,0
354563,4,36,37,-1,4,0
100479,2,7,10,-3,12,1
133021,3,9,14,-5,9,1
187929,1,0,7,-7,16,1
10569,1,0,0,0,5,1
139535,2,6,0,6,12,1
91867,4,30,13,17,8,0
382722,4,9,13,-4,17,1
138603,1,3,0,3,12,1
265065,2,13,3,10,16,0
229517,1,10,6,4,17,1
232419,1,0,0,0,1,1
77208,2,6,0,6,1,1
160520,3,20,14,6,4,0
242113,1,7,0,7,6,0
15705,4,37,17,20,8,0
395940,2,24,3,21,6,0
421754,4,31,17,14,17,0
74178,1,3,0,3,17,1
149517,2,14,6,8,16,0
116006,2,13,0,13,1,1
401142,3,34,13,21,8,0
48999,2,10,7,3,6,1
285165,5,3,3,0,7,1
209785,4,23,6,17,8,0
419742,3,10,10,0,17,1
230941,4,31,10,21,1,1
215278,1,0,0,0,11,1
333961,2,14,10,4,12,1
31982,4,19,13,6,15,0
91032,3,6,0,6,7,1
52309,1,0,0,0,7,1
199159,4,14,45,-31,4,0
116599,3,13,0,13,2,0
155914,4,17,13,4,2,0
282780,2,0,10,-10,6,1
389176,1,7,0,7,3,1
355702,2,7,3,4,5,1
88127,1,0,0,0,6,0
183496,1,0,0,0,14,1
100804,3,9,3,6,12,0
64449,2,14,13,1,13,1
324013,4,20,22,-2,8,0
87798,1,3,0,3,6,0
252633,2,6,3,3,10,1
310975,4,9,37,-28,2,1
18991,2,0,0,0,10,0
28208,2,3,0,3,13,1
101037,1,0,0,0,12,0
26949,4,16,6,10,13,1
371867,2,21,10,11,12,1
355809,1,6,0,6,5,0
163796,4,17,12,5,5,1
333283,4,6,24,-18,12,1
306127,1,0,0,0,17,1
167292,1,3,3,0,7,1
108365,2,0,14,-14,15,1
180622,2,10,6,4,13,1
417719,4,35,19,16,16,1
72362,3,7,20,-13,16,1
130480,2,3,3,0,8,1
403922,3,20,14,6,10,1
389362,3,23,13,10,3,1
135882,4,21,24,-3,10,1
377088,2,7,7,0,15,1
286435,3,17,3,14,8,1
43560,4,24,3,21,3,0
175474,1,0,0,0,11,0
329693,4,36,17,19,11,1
38300,4,19,14,5,1,0
98973,1,0,0,0,11,1
414996,2,10,10,0,15,0
59428,1,0,7,-7,11,0
278406,1,0,0,0,4,0
312406,3,20,34,-14,3,1
154080,1,0,0,0,1,1
302530,3,3,13,-10,15,0
43711,4,14,17,-3,3,1
110666,4,23,10,13,16,0
388625,3,14,0,14,3,0
315824,3,3,19,-16,4,0
336747,3,10,10,0,14,1
272611,4,16,9,7,2,1
156115,1,7,7,0,2,0
59085,3,3,17,-14,10,0
40095,4,20,14,6,1,1
415630,4,30,13,17,15,0
400825,3,17,13,4,8,1
401759,4,27,14,13,8,0
58968,4,20,32,-12,10,0
256901,2,14,18,-4,12,1
268472,3,16,9,7,17,1
182211,4,33,7,26,13,0
397989,1,0,0,0,7,0
259199,4,14,32,-18,13,1
260766,2,3,6,-3,14,1
307667,3,14,17,-3,17,1
39884,3,6,7,-1,1,1
243318,4,14,10,4,6,0
142712,1,0,7,-7,13,1
307451,2,21,10,11,17,1
267615,1,0,0,0,17,1
135686,3,14,10,4,10,1
79922,3,10,16,-6,2,1
393717,3,0,7,-7,5,1
56492,4,7,41,-34,9,0
311238,3,6,0,6,2,0
243499,4,10,37,-27,6,1
315731,4,17,22,-5,4,1
48157,3,10,13,-3,5,0
263362,4,24,10,14,15,1
376778,1,7,0,7,15,1
327768,4,16,23,-7,10,0
53586,3,14,15,-1,8,1
227286,2,10,20,-10,16,0
1539,3,6,13,-7,1,1
91854,4,24,13,11,8,0
267397,3,0,10,-10,17,1
242504,4,15,13,2,6,0
15750,2,0,5,-5,8,1
22039,4,17,17,0,11,0
328618,3,17,35,-18,10,1
50195,1,0,0,0,6,1
392116,1,0,6,-6,4,1
93892,3,17,6,11,9,0
106991,4,29,13,16,14,0
236836,4,3,9,-6,3,1
92261,2,10,0,10,8,1
287679,4,9,13,-4,9,1
215891,2,3,7,-4,11,0
301665,4,10,6,4,15,1
121625,1,0,6,-6,4,0
165749,4,23,7,16,6,0
393144,4,24,3,21,4,1
80215,3,21,24,-3,2,0
309635,1,0,0,0,1,0
67322,2,14,3,11,14,0
299708,2,17,3,14,14,1
392170,2,3,13,-10,4,0
44664,4,23,31,-8,3,0
114666,3,3,10,-7,1,0
407663,1,0,0,0,11,0
185723,2,20,3,17,15,1
95631,1,0,0,0,10,1
373143,1,0,0,0,13,0
307614,2,6,7,-1,17,1
155525,2,20,3,17,2,0
170970,1,7,0,7,8,0
123436,1,0,0,0,4,0
240077,4,20,27,-7,5,1
149815,2,3,7,-4,16,0
77659,3,7,10,-3,1,1
19951,1,0,3,-3,10,1
89438,4,17,20,-3,7,0
383026,1,0,0,0,17,1
388873,1,10,7,3,3,0
100853,4,19,19,0,12,0
39831,1,3,0,3,1,0
334030,4,20,16,4,12,0
73256,4,7,16,-9,16,1
407611,3,10,17,-7,11,0
332752,3,21,9,12,12,0
383223,2,21,3,18,17,0
202477,4,9,10,-1,5,0
98332,4,35,27,8,11,0
103465,1,3,0,3,13,1
414724,3,3,17,-14,14,1
264630,4,20,17,3,16,0
421207,1,6,0,6,17,0
138228,4,10,12,-2,11,1
302945,2,20,6,14,16,0
118072,1,3,6,-3,2,0
201141,2,6,21,-15,5,1
198381,4,23,14,9,3,1
105461,1,0,0,0,14,1
392973,3,9,10,-1,4,1
93077,4,20,20,0,8,0
74021,4,37,7,30,17,1
406176,1,7,0,7,11,0
171240,4,9,14,-5,8,1
177141,4,30,13,17,11,1
124018,1,0,0,0,5,1
9067,3,28,13,15,4,0
74614,1,0,0,0,17,0
187420,3,41,7,34,16,0
338302,1,0,0,0,14,0
244168,1,7,7,0,6,0
390527,2,10,7,3,3,1
273434,1,0,0,0,2,0
271763,3,23,10,13,2,0
421751,4,31,17,14,17,0
322474,2,15,3,12,7,1
129907,3,13,0,13,7,0
74495,2,0,0,0,17,1
268019,3,21,9,12,17,0
14677,4,33,14,19,7,0
72929,2,17,7,10,16,1
350506,4,10,19,-9,2,1
184127,3,16,14,2,14,0
234006,2,14,0,14,2,0
128206,2,14,7,7,7,1
237574,4,38,22,16,3,1
65165,3,3,3,0,13,0
275433,2,13,10,3,3,1
332825,1,0,0,0,12,1
276373,3,25,35,-10,3,0
328133,2,6,0,6,10,0
258970,2,0,13,-13,13,0
219546,4,21,21,0,13,0
158467,2,3,7,-4,3,1
248791,3,30,14,16,9,0
395208,2,10,10,0,5,0
110520,4,20,13,7,16,0
126574,4,16,6,10,6,0
150822,1,0,0,0,17,0
208357,3,17,27,-10,8,0
233761,3,13,27,-14,2,1
83876,3,23,16,7,4,0
328745,2,14,6,8,10,0
404305,2,0,3,-3,10,0
104940,3,3,6,-3,14,0
177681,2,10,14,-4,12,1
11674,2,14,0,14,6,0
212499,3,10,13,-3,10,1
245246,2,3,3,0,7,1
170318,4,0,12,-12,8,0
413100,2,27,28,-1,14,1
5944,3,14,23,-9,3,1
170563,2,20,3,17,8,1
342526,1,0,6,-6,16,1
365993,2,23,7,16,10,0
168900,3,17,6,11,7,1
263747,2,0,0,0,15,0
153783,4,2,27,-25,1,1
265644,3,6,15,-9,16,1
193274,3,3,20,-17,1,1
400606,1,0,0,0,8,0
273610,2,10,3,7,2,1
418359,4,15,31,-16,16,0
276200,3,24,3,21,3,0
353086,2,7,16,-9,3,0
100232,4,17,7,10,12,0
98060,5,24,24,0,11,0
320823,1,3,4,-1,6,0
153967,1,7,7,0,1,1
294616,1,0,0,0,12,1
336757,3,10,10,0,14,0
237318,1,0,0,0,3,1
219541,4,15,21,-6,13,0
222084,4,27,17,10,14,1
238214,3,3,16,-13,4,0
219564,4,21,21,0,13,0
152502,3,17,7,10,17,0
227547,1,0,0,0,16,1
360757,2,17,21,-4,7,0
239094,2,7,10,-3,4,1
131003,4,10,30,-20,8,1
290832,3,16,14,2,10,1
282247,3,10,14,-4,6,1
416248,4,10,39,-29,15,1
134888,2,7,13,-6,10,1
11173,1,0,0,0,6,1
48247,2,3,10,-7,5,0
322481,3,15,3,12,7,1
113759,3,3,17,-14,17,1
220709,3,13,6,7,13,0
218262,1,6,7,-1,12,1
312687,3,28,14,14,3,1
304901,1,7,3,4,16,0
209258,4,27,7,20,8,1
253425,3,14,28,-14,11,0
293223,3,16,7,9,11,0
49955,2,21,0,21,6,0
155927,4,17,16,1,2,1
28689,3,3,10,-7,14,0
107458,2,0,17,-17,15,1
35044,3,15,10,5,16,1
138164,2,7,9,-2,11,0
225643,3,7,10,-3,16,1
354402,4,48,10,38,4,0
225753,2,10,7,3,16,1
417537,4,24,28,-4,16,0
293865,4,31,26,5,12,1
198684,4,15,21,-6,3,0
375761,2,13,0,13,14,0
22071,4,24,24,0,11,0
409722,3,10,6,4,12,0
184776,2,17,7,10,15,0
43604,1,0,0,0,3,1
341591,4,19,17,2,16,0
74999,3,27,17,10,17,0
169989,3,21,10,11,8,1
290987,3,20,13,7,10,1
395342,2,14,3,11,5,0
200808,4,37,17,20,4,1
411617,3,14,21,-7,13,0
24561,3,10,13,-3,12,0
246007,2,0,3,-3,7,1
392252,4,10,16,-6,4,1
62628,3,9,17,-8,12,0
51562,1,0,0,0,7,1
77294,4,32,17,15,1,0
344745,4,13,34,-21,17,1
331655,4,31,33,-2,11,1
389197,2,21,7,14,3,1
27564,1,0,0,0,13,1
284531,4,24,15,9,7,1
224689,4,19,17,2,15,1
59820,4,15,13,2,11,0
184061,1,3,0,3,14,0
150970,4,22,14,8,17,0
41883,2,7,3,4,2,0
85094,4,31,16,15,4,1
299276,2,23,0,23,14,0
100818,3,9,6,3,12,0
331154,2,7,13,-6,11,1
368658,1,0,3,-3,11,0
74363,2,7,3,4,17,0
111589,4,35,21,14,16,0
38725,4,24,17,7,1,1
381320,1,6,0,6,16,0
13471,3,3,21,-18,7,1
209903,3,30,16,14,8,0
132785,1,0,0,0,9,0
259678,4,16,19,-3,13,0
191979,2,7,13,-6,1,0
177459,4,24,10,14,11,1
71602,2,3,17,-14,16,0
301191,3,20,14,6,15,1
72215,3,17,10,7,16,0
74222,2,3,7,-4,17,1
96492,3,17,24,-7,10,1
359741,2,24,9,15,6,0
289287,2,14,14,0,9,0
386318,1,7,3,4,2,1
133303,2,7,0,7,9,0
16680,4,14,30,-16,8,0
390808,2,0,7,-7,3,0
2992,3,13,24,-11,2,1
118442,4,20,10,10,2,0
103173,1,0,0,0,13,1
201834,3,20,23,-3,5,0
243402,2,3,10,-7,6,0
411223,4,11,23,-12,13,1
26628,4,10,6,4,13,0
85190,3,7,10,-3,4,1
258473,4,21,21,0,13,0
55382,2,10,7,3,9,0
267878,4,26,24,2,17,1
184176,1,0,0,0,14,1
4118,4,23,28,-5,2,1
408343,3,10,7,3,12,1
389223,3,21,7,14,3,1
248751,2,20,7,13,9,1
226691,1,7,3,4,16,1
259276,2,13,7,6,13,1
370594,2,14,14,0,12,1
96067,4,13,14,-1,10,1
41088,4,3,16,-13,2,0
218096,1,0,0,0,12,1
324120,2,0,10,-10,8,1
155726,3,20,20,0,2,0
177978,2,7,6,1,12,0
163225,1,0,3,-3,5,0
364695,2,6,0,6,9,0
359107,1,7,0,7,6,0
47173,2,6,0,6,5,1
162224,3,20,20,0,4,0
75590,2,7,3,4,17,0
357720,3,33,13,20,5,1
189744,2,7,6,1,17,1
245337,4,23,13,10,7,1
13020,3,14,7,7,6,0
167773,5,26,26,0,7,1
86236,1,6,10,-4,5,0
234844,3,0,12,-12,2,0
48234,2,0,10,-10,5,1
52344,2,3,10,-7,7,1
316564,2,3,6,-3,4,1
354057,2,13,0,13,4,0
55107,3,23,9,14,8,0
298657,2,6,0,6,14,0
339654,4,31,24,7,15,0
92963,1,3,0,3,8,1
95533,2,6,7,-1,10,0
421410,3,24,20,4,17,1
231360,4,9,16,-7,1,1
137680,1,0,13,-13,11,1
397157,2,6,0,6,6,1
379587,2,16,6,10,16,0
84030,3,27,15,12,4,1
175694,2,23,6,17,11,1
365460,3,10,19,-9,9,1
6456,4,15,20,-5,3,1
302062,2,13,24,-11,15,1
162326,2,3,7,-4,4,1
51183,3,24,3,21,7,0
391023,3,27,27,0,4,0
417746,4,35,33,2,16,0
125255,1,0,0,0,5,0
415975,1,0,0,0,15,0
354984,3,7,12,-5,4,0
83232,2,6,7,-1,4,1
187493,1,3,3,0,16,0
414625,4,28,12,16,14,0
39739,3,9,0,9,1,0
296673,4,10,16,-6,13,1
236222,4,27,16,11,3,0
242571,1,3,0,3,6,1
143490,2,14,21,-7,14,1
214107,2,3,3,0,11,0
284496,3,17,15,2,7,0
86754,4,27,14,13,5,0
275606,2,21,3,18,3,0
171365,4,16,17,-1,9,0
283054,1,0,0,0,7,0
356571,4,9,6,3,5,0
295598,4,31,32,-1,12,0
342330,4,23,6,17,16,0
138294,2,17,0,17,11,0
399655,3,16,9,7,8,0
211185,2,0,10,-10,9,1
164192,2,17,21,-4,5,0
274287,4,29,16,13,3,1
275220,4,17,29,-12,3,1
223213,2,3,6,-3,15,1
413977,2,3,14,-11,14,0
408095,4,20,17,3,12,0
349173,3,27,7,20,2,0
237586,4,38,22,16,3,0
172599,4,17,24,-7,9,1
68216,3,10,14,-4,14,1
83581,3,0,17,-17,4,0
321277,2,9,10,-1,6,0
293242,3,23,7,16,11,0
162739,4,35,24,11,5,0
89769,1,0,0,0,7,1
419191,3,10,6,4,16,1
208931,3,14,6,8,8,1
280648,1,0,0,0,5,0
245412,2,9,3,6,7,1
58073,2,7,10,-3,10,0
109348,1,0,6,-6,16,0
255056,3,3,21,-18,12,0
187865,3,7,20,-13,16,0
52561,4,19,7,12,7,0
339467,3,10,23,-13,15,0
196316,4,24,17,7,2,0
375766,2,13,0,13,14,1
104353,3,45,31,14,13,1
93612,3,13,6,7,9,0
46287,1,0,7,-7,4,0
345458,4,3,22,-19,17,1
128621,2,3,10,-7,7,1
260923,2,0,0,0,14,0
156247,4,24,23,1,2,1
196796,1,0,7,-7,3,0
183759,1,7,14,-7,14,0
163060,1,0,0,0,5,0
94623,2,7,19,-12,9,1
280670,2,0,3,-3,5,1
206223,2,0,3,-3,7,0
401725,3,17,14,3,8,0
381580,4,42,16,26,17,0
243461,3,3,23,-20,6,0
263535,4,20,29,-9,15,1
268956,4,6,36,-30,17,1
24262,4,13,17,-4,12,0
70583,2,7,7,0,15,0
286743,3,20,14,6,8,0
344405,3,28,21,7,17,0
125979,4,23,23,0,6,0
61925,1,0,0,0,12,0
66147,1,3,0,3,13,0
71867,2,9,0,9,16,1
256865,2,0,3,-3,12,1
263773,3,0,21,-21,15,0
123612,2,0,0,0,4,1
34905,3,27,10,17,16,1
103484,2,6,0,6,13,1
21682,2,3,7,-4,11,1
154796,4,21,23,-2,1,0
185708,2,17,3,14,15,0
89548,3,0,20,-20,7,1
176611,1,0,0,0,11,0
217922,4,25,28,-3,12,1
399021,2,10,9,1,7,0
286508,1,3,7,-4,8,1
5654,2,0,14,-14,3,0
4916,2,14,7,7,3,0
255503,2,17,7,10,12,0
213162,1,3,0,3,10,0
416581,1,0,0,0,15,1
266810,3,10,14,-4,16,1
202915,4,28,0,28,5,1
331069,4,52,24,28,11,1
267922,1,0,0,0,17,1
198836,4,13,29,-16,3,1
400261,3,17,6,11,8,0
130336,2,7,0,7,8,1
191917,1,0,0,0,1,0
352150,4,9,20,-11,3,1
228078,3,3,10,-7,17,1
279054,1,7,0,7,5,1
41250,4,10,13,-3,2,1
353005,4,23,10,13,3,0
307124,1,0,0,0,17,1
400025,1,7,3,4,8,0
223030,1,7,0,7,14,0
335565,2,6,7,-1,13,1
33769,2,0,3,-3,16,0
77701,4,17,24,-7,1,0
64705,2,14,0,14,13,1
107048,2,17,0,17,15,1
179124,3,9,13,-4,12,1
83874,3,23,10,13,4,0
343295,1,0,3,-3,16,0
404491,3,21,19,2,10,1
36349,2,13,13,0,17,1
353464,4,25,12,13,4,0
346046,2,3,6,-3,1,1
371385,1,0,7,-7,12,1
1618,1,0,0,0,1,1
178154,1,0,7,-7,12,0
187634,1,0,3,-3,16,1
76873,1,0,0,0,1,0
302826,3,9,20,-11,15,0
90774,3,20,7,13,7,1
86627,4,47,3,44,5,0
15571,1,0,0,0,8,0
276615,2,7,6,1,4,1
78009,3,9,16,-7,1,0
139782,1,0,0,0,12,0
396442,3,20,25,-5,6,0
234494,3,20,20,0,2,1
285816,4,14,24,-10,8,0
308552,2,6,9,-3,1,0
16261,3,6,16,-10,8,1
358599,3,27,9,18,6,0
359472,2,0,14,-14,6,1
245,3,12,17,-5,1,0
118473,4,27,10,17,2,0
245738,3,13,10,3,7,1
406239,3,14,24,-10,11,1
91819,3,24,0,24,8,0
348774,1,0,0,0,2,0
151204,3,10,20,-10,17,0
371583,2,10,3,7,12,0
388748,2,11,0,11,3,0
121358,3,7,0,7,3,0
412175,2,14,3,11,13,0
323845,3,16,15,1,8,0
302828,3,9,23,-14,15,0
296075,4,9,7,2,13,0
340124,1,6,0,6,15,0
81326,1,0,0,0,3,0
343271,4,22,0,22,16,0
161667,4,39,24,15,4,0
311349,2,14,10,4,2,1
64650,4,20,24,-4,13,0
129342,1,14,7,7,7,1
411302,2,0,10,-10,13,1
41715,1,0,0,0,2,0
191547,3,14,21,-7,17,0
229304,4,24,27,-3,17,1
274346,1,3,7,-4,3,0
98271,2,14,24,-10,11,0
295734,4,10,16,-6,12,1
5025,1,0,0,0,3,1
415878,2,7,20,-13,15,0
163962,4,26,13,13,5,0
263832,4,7,24,-17,15,0
166331,4,13,9,4,6,1
347398,5,21,21,0,1,0
361067,3,16,9,7,7,1
241128,3,20,10,10,5,1
315574,4,7,14,-7,4,1
301694,1,0,0,0,15,0
142563,1,0,3,-3,13,1
207198,4,14,20,-6,7,1
297278,4,24,6,18,13,0
7962,4,9,27,-18,4,1
86796,1,0,3,-3,5,0
84391,1,3,0,3,4,0
90466,3,0,20,-20,7,1
22914,3,3,20,-17,11,0
128291,1,0,0,0,7,1
346033,2,3,6,-3,1,1
305245,2,14,21,-7,16,1
201422,1,9,0,9,5,1
119408,2,0,14,-14,3,0
83930,1,0,0,0,4,0
18305,3,13,17,-4,9,1
166441,3,17,7,10,6,0
159367,2,0,10,-10,3,1
140339,3,17,20,-3,12,1
370441,2,10,6,4,12,0
208950,4,17,14,3,8,1
312157,4,33,23,10,2,0
184523,3,24,14,10,14,1
110836,4,13,13,0,16,1
103901,1,0,0,0,13,0
153392,2,10,10,0,1,0
95490,1,0,0,0,10,1
124725,3,3,3,0,5,1
210639,3,13,24,-11,9,1
102225,4,24,14,10,13,0
150425,2,20,0,20,16,0
102804,3,10,3,7,13,0
11055,2,10,7,3,5,0
360030,2,3,26,-23,7,0
118958,2,0,17,-17,3,1
151409,1,0,0,0,17,0
39805,1,0,0,0,1,1
132875,3,6,14,-8,9,0
57918,2,13,10,3,10,0
404741,2,7,6,1,10,1
222685,3,14,24,-10,14,0
252943,3,9,0,9,11,0
30181,3,13,17,-4,14,1
82858,4,18,16,2,3,0
329480,2,10,0,10,10,0
370252,1,0,14,-14,12,1
320023,4,43,30,13,6,0
269599,1,0,0,0,1,0
19407,2,14,7,7,10,0
418274,2,6,0,6,16,0
100133,1,0,0,0,12,0
162539,3,35,10,25,4,1
297528,2,14,0,14,13,1
383352,2,0,0,0,17,1
333953,2,14,7,7,12,0
357884,4,13,34,-21,6,1
48973,1,3,0,3,6,0
234225,4,20,10,10,2,0
280417,2,6,10,-4,5,1
173884,2,6,10,-4,10,0
87137,3,14,10,4,5,0
4007,1,0,0,0,2,1
359408,1,0,0,0,6,1
106656,4,46,9,37,14,0
361435,4,17,24,-7,7,1
166657,4,29,20,9,6,1
80309,2,7,6,1,2,1
58816,4,18,36,-18,10,1
234093,4,26,14,12,2,1
182804,3,19,10,9,14,1
346012,2,0,3,-3,1,1
93148,2,0,0,0,9,1
342059,1,0,0,0,16,1
359943,4,23,30,-7,6,0
263221,4,17,17,0,15,0
46467,2,14,6,8,4,1
4614,2,10,10,0,2,1
200222,1,0,0,0,4,1
237968,2,3,3,0,4,0
290417,4,28,10,18,10,1
27462,2,10,0,10,13,0
418897,3,13,17,-4,16,1
337742,1,3,0,3,14,1
257208,2,10,16,-6,12,1
304121,4,16,30,-14,16,0
375114,2,7,7,0,14,1
287182,3,10,13,-3,8,0
208820,4,6,22,-16,8,1
135335,1,7,10,-3,10,1
362100,3,21,10,11,8,0
219744,1,7,0,7,13,1
47613,1,0,7,-7,5,1
416528,4,38,17,21,15,0
155588,4,23,10,13,2,0
305264,3,21,21,0,16,1
39405,2,3,3,0,1,0
395335,2,14,3,11,5,1
96244,4,3,29,-26,10,1
295506,1,7,7,0,12,1
263977,4,23,7,16,15,1
310566,1,3,13,-10,2,1
218084,4,28,30,-2,12,0
97199,2,6,6,0,10,1
33861,4,9,41,-32,16,1
45851,1,7,0,7,4,0
64402,1,0,3,-3,13,1
223739,4,40,13,27,15,1
134448,2,3,20,-17,10,0
12639,1,0,0,0,6,0
38125,4,9,6,3,1,0
162705,4,23,24,-1,5,1
375593,1,7,7,0,14,0
42045,2,13,7,6,2,1
357673,2,13,3,10,5,0
210271,1,3,0,3,9,1
234409,1,0,0,0,2,1
198215,4,13,9,4,3,1
7361,5,20,19,1,4,0
232015,2,0,7,-7,1,0
163614,3,14,19,-5,5,1
240227,4,16,12,4,5,0
352912,1,0,0,0,3,1
156830,3,23,20,3,2,0
231237,4,10,16,-6,1,0
284386,4,28,17,11,7,0
406967,2,3,19,-16,11,0
182729,1,0,0,0,14,1
238645,2,6,14,-8,4,1
367903,4,23,20,3,10,0
343610,2,15,7,8,17,0
317045,2,7,10,-3,4,1
33809,2,0,24,-24,16,1
337855,4,30,12,18,14,1
245049,4,14,27,-13,7,1
140394,4,17,29,-12,12,0
400638,2,3,0,3,8,0
338389,3,17,10,7,14,0
185656,1,0,0,0,15,1
374003,3,10,7,3,13,1
54930,2,0,3,-3,8,0
48418,3,17,17,0,5,0
18750,3,13,10,3,9,0
321685,1,0,0,0,7,0
33889,1,0,3,-3,16,1
330708,4,6,6,0,11,1
69010,3,21,17,4,15,1
92658,1,0,3,-3,8,1
405699,2,10,0,10,10,1
362628,2,0,7,-7,8,0
133791,3,16,10,6,9,0
271083,1,0,0,0,1,1
108199,1,6,0,6,15,1
349206,4,27,20,7,2,0
200650,4,27,28,-1,4,1
160302,2,3,7,-4,4,1
268712,1,0,0,0,17,0
250790,2,3,0,3,10,0
409790,1,7,0,7,12,1
364814,2,3,7,-4,9,1
287863,4,28,20,8,9,0
129730,3,17,14,3,7,1
408532,4,10,13,-3,12,0
144456,4,10,26,-16,14,0
156243,4,24,23,1,2,1
224494,3,15,10,5,15,1
324279,3,15,0,15,8,1
261145,4,21,24,-3,14,0
81166,4,16,22,-6,3,0
340101,4,20,15,5,15,0
112208,1,7,0,7,17,0
309957,2,3,3,0,2,0
205791,2,7,0,7,7,0
132721,3,10,17,-7,9,0
354968,2,7,9,-2,4,0
56269,2,3,14,-11,9,0
105182,1,7,0,7,14,0
304877,4,12,10,2,16,0
99539,4,10,17,-7,11,1
55859,3,13,14,-1,9,0
161164,4,3,33,-30,4,0
156702,4,14,17,-3,2,0
7810,4,30,17,13,4,1
20090,4,22,23,-1,10,1
135921,5,24,24,0,10,0
4539,3,24,19,5,2,0
360812,4,24,30,-6,7,0
108001,4,6,20,-14,15,0
261969,2,14,10,4,14,1
56830,5,20,20,0,9,0
245187,4,17,28,-11,7,0
321783,4,18,9,9,7,0
329834,4,17,23,-6,11,1
344476,1,0,0,0,17,0
327780,4,16,23,-7,10,0
116395,1,3,0,3,1,0
129003,4,35,13,22,7,1
96100,1,0,6,-6,10,1
166548,1,3,0,3,6,0
124297,3,34,20,14,5,1
417711,4,35,12,23,16,0
335785,4,24,14,10,13,0
214741,2,3,10,-7,11,0
349275,2,7,21,-14,2,1
421840,3,0,13,-13,17,0
227355,4,20,37,-17,16,0
354216,3,13,10,3,4,1
167250,4,30,17,13,7,0
170547,2,14,0,14,8,0
13664,4,19,17,2,7,0
373884,4,34,16,18,13,1
110618,3,17,10,7,16,1
206609,4,10,13,-3,7,0
235846,2,0,14,-14,3,1
76170,2,9,6,3,1,0
116586,2,10,0,10,2,1
322179,2,0,17,-17,7,0
7790,4,30,9,21,4,1
106908,2,9,3,6,14,1
55420,3,20,10,10,9,0
206287,3,10,6,4,7,1
169273,4,23,6,17,7,0
125588,2,7,10,-3,5,1
162993,3,6,3,3,5,1
218181,3,17,3,14,12,0
176012,2,17,0,17,11,1
102504,3,31,3,28,13,0
208341,3,17,24,-7,8,1
412449,2,7,7,0,14,0
393994,2,3,7,-4,5,0
173674,4,20,22,-2,10,0
167348,3,23,16,7,7,0
382421,3,0,21,-21,17,0
273552,4,28,35,-7,2,0
79854,1,3,6,-3,2,0
213108,4,20,3,17,10,0
54558,4,21,18,3,8,1
122068,1,0,7,-7,4,1
331651,4,31,33,-2,11,0
349337,4,28,42,-14,2,1
84240,1,0,7,-7,4,1
385281,3,7,6,1,1,0
49692,3,14,24,-10,6,1
190571,4,17,20,-3,17,1
338478,2,13,0,13,14,1
234859,4,3,12,-9,2,0
258725,3,3,20,-17,13,0
115532,2,0,3,-3,1,0
59078,3,3,17,-14,10,1
293595,1,0,0,0,12,1
297727,4,24,20,4,13,0
4937,3,14,17,-3,3,0
139802,2,7,3,4,12,0
115020,4,13,19,-6,1,1
93090,5,20,20,0,8,1
199304,1,0,0,0,4,0
84243,1,0,7,-7,4,1
401880,4,14,28,-14,9,1
81623,4,30,31,-1,3,1
53639,1,0,0,0,8,1
65765,3,14,25,-11,13,1
222883,1,0,0,0,14,0
342291,3,20,3,17,16,0
396567,3,17,10,7,6,1
182459,2,7,0,7,14,0
111286,4,16,16,0,16,1
274763,4,24,20,4,3,0
24003,4,26,6,20,12,0
403223,4,24,17,7,9,0
121372,3,7,3,4,3,1
157536,1,0,0,0,2,1
358528,1,7,3,4,6,1
289508,4,21,7,14,10,0
402893,3,17,6,11,9,0
155256,3,28,14,14,1,0
227550,1,6,0,6,16,1
115238,2,0,3,-3,1,0
63120,1,7,10,-3,12,0
3750,2,13,3,10,2,0
163144,3,16,25,-9,5,0
179183,1,0,0,0,12,1
293395,3,16,10,6,11,0
15538,4,23,6,17,8,1
115950,1,0,0,0,1,1
181721,2,7,7,0,13,0
225867,4,27,24,3,16,0
316341,4,24,26,-2,4,0
409669,2,10,3,7,12,0
127070,4,31,23,8,6,0
281713,4,31,30,1,6,1
164228,3,27,38,-11,5,1
293627,2,7,7,0,12,1
59858,5,15,16,-1,11,0
211817,2,14,7,7,9,0
166370,1,3,0,3,6,0
169142,1,0,0,0,7,1
321603,2,10,6,4,7,1
129923,4,13,0,13,7,0
63213,4,17,23,-6,12,0
289229,4,30,13,17,9,0
270813,2,3,0,3,1,1
119710,1,0,0,0,3,1
189010,2,7,7,0,16,1
30479,4,31,35,-4,14,1
282544,3,17,17,0,6,0
187155,4,16,0,16,16,0
142660,4,20,13,7,13,0
97980,3,14,10,4,11,1
219801,2,38,0,38,13,0
350223,4,27,0,27,2,0
285117,3,3,0,3,7,1
290795,2,10,0,10,10,0
332606,2,20,6,14,12,1
181147,4,24,14,10,13,1
252807,3,9,6,3,11,1
82596,2,0,10,-10,3,0
390385,3,7,20,-13,3,0
402416,2,14,7,7,9,1
52161,1,0,0,0,7,0
17792,1,7,3,4,9,1
106121,2,0,0,0,14,0
158936,2,14,12,2,3,0
337110,4,26,15,11,14,0
303803,4,20,17,3,16,0
173617,3,7,13,-6,10,0
337875,1,9,0,9,14,1
186724,1,0,0,0,15,0
279117,3,21,20,1,5,0
163287,3,13,13,0,5,1
17279,4,21,34,-13,9,0
167461,2,0,0,0,7,0
12901,4,13,13,0,6,1
32045,2,7,10,-3,15,1
99744,2,0,0,0,12,0
100393,4,9,20,-11,12,1
305196,1,6,0,6,16,1
314534,4,24,10,14,3,1
53220,2,3,0,3,8,0
414390,2,7,17,-10,14,0
5732,1,0,0,0,3,0
326259,4,16,48,-32,9,1
184973,3,7,20,-13,15,1
370231,1,0,0,0,12,0
144179,4,30,19,11,14,0
80689,4,17,26,-9,3,1
214737,2,3,7,-4,11,0
365191,4,14,28,-14,9,0
308579,3,9,9,0,1,0
111557,4,35,10,25,16,0
377212,1,0,0,0,15,1
230502,1,0,0,0,1,1
37777,2,7,3,4,1,0
188201,1,0,0,0,16,0
239611,4,20,10,10,4,0
161556,2,6,9,-3,4,0
138088,4,49,24,25,11,1
407441,3,14,10,4,11,1
277366,2,17,6,11,4,1
303577,2,14,6,8,16,1
58565,3,10,10,0,10,1
378981,1,0,0,0,15,0
264783,3,16,23,-7,16,1
369499,1,0,0,0,11,1
229555,2,17,6,11,17,1
267003,4,19,17,2,17,1
419009,2,7,14,-7,16,0
152071,3,3,7,-4,17,1
90223,4,6,3,3,7,0
267251,2,10,14,-4,17,1
368420,3,20,7,13,11,0
401874,3,14,28,-14,9,0
342686,1,0,0,0,16,0
400778,2,14,0,14,8,0
374961,1,7,6,1,14,1
233573,2,14,27,-13,2,1
339754,3,24,6,18,15,0
304383,4,28,21,7,16,1
101385,2,9,7,2,12,1
406159,1,0,0,0,11,1
308612,4,21,16,5,1,1
410122,2,17,10,7,13,1
11988,3,24,14,10,6,0
12782,1,0,0,0,6,0
125658,4,21,24,-3,5,1
17568,4,13,17,-4,9,1
296345,3,6,19,-13,13,1
81518,2,0,14,-14,3,0
394874,2,0,14,-14,5,0
196440,4,20,21,-1,2,1
350726,2,7,0,7,2,0
399474,2,0,24,-24,7,0
122428,2,6,26,-20,4,1
290087,3,10,9,1,10,1
293006,1,3,6,-3,11,0
210367,4,22,17,5,9,1
260286,4,24,3,21,14,0
17551,3,13,10,3,9,1
113223,1,0,0,0,17,0
367462,4,26,24,2,10,1
49936,2,14,0,14,6,0
144507,1,0,7,-7,14,1
217150,3,3,9,-6,12,0
15008,1,0,7,-7,7,0
169447,1,0,0,0,8,0
21935,4,35,9,26,11,1
359471,2,0,14,-14,6,1
324003,4,17,16,1,8,0
310393,1,0,0,0,2,1
127508,3,3,23,-20,6,1
298919,1,0,6,-6,14,1
293131,4,17,30,-13,11,0
270636,1,0,0,0,1,0
369970,1,7,0,7,12,1
116124,2,0,3,-3,1,1
376356,2,3,0,3,14,0
209692,2,9,0,9,8,0
201631,2,7,10,-3,5,1
215193,2,7,9,-2,11,1
95732,4,13,9,4,10,1
217022,3,13,3,10,12,1
118705,3,17,6,11,2,0
166349,4,20,12,8,6,1
97319,1,0,3,-3,10,0
212647,3,7,31,-24,10,1
328987,4,30,7,23,10,1
318548,2,7,0,7,5,0
318542,2,0,0,0,5,1
274423,3,10,17,-7,3,0
212927,2,7,7,0,10,0
120021,4,23,38,-15,3,1
273039,3,6,3,3,2,1
274890,3,7,16,-9,3,1
229331,4,24,34,-10,17,1
238003,2,10,10,0,4,0
56717,2,0,10,-10,9,0
310092,1,0,0,0,2,1
262789,4,35,17,18,15,0
332084,4,17,9,8,12,0
208203,3,0,10,-10,8,1
92976,2,10,0,10,8,1
25089,1,3,0,3,12,1
416945,3,10,7,3,15,0
12621,4,3,27,-24,6,0
334528,2,14,14,0,13,1
162023,2,14,6,8,4,0
276144,1,7,0,7,3,1
361301,1,0,0,0,7,0
371676,1,0,0,0,12,0
363256,3,24,7,17,8,1
162366,3,10,10,0,4,0
57362,3,14,3,11,10,1
350627,3,13,3,10,2,0
373880,4,34,16,18,13,0
274936,4,17,16,1,3,0
324603,4,16,9,7,8,1
319622,2,16,3,13,6,1
389852,4,24,6,18,3,1
140350,3,17,26,-9,12,1
265190,2,6,3,3,16,0
121215,3,21,27,-6,3,1
70109,1,10,0,10,15,0
178117,5,26,26,0,12,1
103983,3,6,13,-7,13,0
254261,2,6,6,0,11,0
147354,1,0,0,0,15,1
201270,1,7,0,7,5,1
356503,3,6,3,3,5,1
4131,4,26,28,-2,2,1
228001,1,0,0,0,17,1
272722,3,12,3,9,2,0
179501,1,0,13,-13,12,0
387529,2,3,0,3,2,1
5811,3,24,7,17,3,1
283234,1,10,0,10,7,1
92746,3,3,17,-14,8,0
71353,4,10,20,-10,16,1
24088,3,7,7,0,12,0
131133,4,27,9,18,8,0
237293,1,0,0,0,3,1
390536,2,10,7,3,3,1
189856,4,33,17,16,17,0
217925,4,25,28,-3,12,1
225103,4,13,14,-1,15,0
64269,1,0,3,-3,13,1
42691,4,7,10,-3,3,0
74858,4,20,20,0,17,0
68884,4,6,20,-14,15,0
309697,2,10,6,4,1,1
177232,2,7,7,0,11,0
271946,4,23,20,3,2,1
222001,1,7,0,7,14,0
238072,4,13,13,0,4,1
161922,3,13,9,4,4,1
62162,3,7,14,-7,12,0
262123,2,20,3,17,15,1
312490,2,13,0,13,3,1
348753,4,31,17,14,2,0
293035,2,10,13,-3,11,0
166917,3,13,6,7,6,0
47297,1,0,7,-7,5,0
376069,2,0,3,-3,14,0
316398,2,13,0,13,4,0
80884,1,0,0,0,3,1
333050,2,10,12,-2,12,0
296090,4,9,17,-8,13,1
259292,2,13,7,6,13,0
258219,1,0,0,0,13,0
418868,2,7,10,-3,16,1
281050,3,17,13,4,6,0
246612,2,14,3,11,8,0
28180,1,3,0,3,13,1
226991,2,3,3,0,16,0
365672,1,7,0,7,9,0
22695,1,3,0,3,11,1
32850,3,6,7,-1,15,0
171716,1,0,0,0,9,1
265320,2,7,0,7,16,1
47855,3,10,6,4,5,0
140824,1,7,0,7,13,1
411985,4,20,20,0,13,1
203899,5,37,37,0,6,1
387483,4,21,16,5,2,0
31929,3,6,13,-7,15,1
313028,3,17,0,17,3,1
27687,4,14,30,-16,13,1
76268,4,19,27,-8,1,1
270283,3,10,24,-14,1,0
238466,1,6,0,6,4,1
20691,3,17,17,0,10,1
237865,3,7,27,-20,4,0
29323,3,21,7,14,14,0
272222,2,6,0,6,2,0
217142,2,3,9,-6,12,0
21269,2,3,7,-4,11,0
143865,4,12,15,-3,14,1
150732,2,13,9,4,17,0
169055,3,26,14,12,7,0
410228,1,7,0,7,13,0
329674,3,23,17,6,11,1
260680,3,10,22,-12,14,0
161750,3,24,6,18,4,1
144839,2,14,0,14,14,1
386418,4,23,17,6,2,0
296009,2,3,0,3,13,0
146568,3,14,24,-10,15,1
212082,1,0,0,0,10,1
392452,1,0,0,0,4,0
247548,2,13,10,3,8,0
118505,1,14,0,14,2,1
366176,4,7,45,-38,10,0
236129,2,0,3,-3,3,0
314302,2,7,14,-7,3,0
218682,1,0,0,0,13,0
152164,1,0,0,0,17,0
17903,4,24,17,7,9,1
29431,2,7,14,-7,14,1
11451,1,0,0,0,6,0
129271,4,17,13,4,7,1
390437,4,14,27,-13,3,0
52481,1,3,0,3,7,1
276248,4,31,17,14,3,1
202360,4,20,13,7,5,0
248910,2,17,0,17,9,0
163166,4,22,28,-6,5,1
350732,2,7,0,7,2,1
365900,3,14,21,-7,9,1
76439,1,0,7,-7,1,1
76558,4,7,41,-34,1,0
7512,4,29,6,23,4,1
369776,4,45,43,2,11,0
157226,2,7,0,7,2,0
240939,3,14,9,5,5,0
51960,4,13,16,-3,7,0
14554,1,0,0,0,7,0
172929,4,41,24,17,9,0
324576,3,13,9,4,8,1
260111,4,6,28,-22,14,1
275976,4,26,21,5,3,0
27261,4,22,13,9,13,1
110427,2,10,0,10,16,1
382066,1,7,0,7,17,0
304801,2,0,0,0,16,0
347726,1,0,0,0,1,1
45701,1,0,0,0,4,0
291927,4,24,17,7,11,1
118207,1,3,0,3,2,0
350961,4,14,17,-3,3,1
119127,2,10,7,3,3,1
31111,1,0,3,-3,15,1
284515,4,24,15,9,7,1
197633,4,26,0,26,3,1
353163,4,20,29,-9,3,0
169047,3,26,14,12,7,1
24628,1,0,0,0,12,1
40828,4,32,35,-3,2,1
216077,3,17,12,5,11,1
371096,4,13,27,-14,12,1
17429,4,17,7,10,9,1
193904,4,24,10,14,1,1
163011,4,16,3,13,5,0
333044,2,3,12,-9,12,1
243955,4,25,19,6,6,0
107400,4,26,13,13,15,0
102304,2,10,10,0,13,1
145515,4,26,17,9,14,0
66095,4,10,6,4,13,0
329287,1,0,0,0,10,0
296104,4,9,17,-8,13,1
60711,3,21,3,18,11,0
249105,3,21,20,1,9,1
59031,2,3,10,-7,10,1
48589,3,14,24,-10,5,1
371620,3,17,17,0,12,0
255644,2,3,7,-4,12,1
14436,2,24,3,21,7,0
88070,4,24,3,21,6,1
184145,4,16,14,2,14,1
13970,1,0,0,0,7,0
286261,2,13,13,0,8,0
143268,4,17,16,1,13,0
355624,4,24,17,7,5,1
132919,4,6,21,-15,9,1
124949,1,0,3,-3,5,0
136548,1,0,10,-10,11,0
128171,2,7,0,7,7,1
13226,4,22,33,-11,6,1
418800,4,14,24,-10,16,1
358007,3,24,13,11,6,0
321891,2,14,21,-7,7,1
416986,4,10,17,-7,15,1
399442,1,0,10,-10,7,1
255605,1,0,6,-6,12,0
367990,2,17,14,3,11,0
134044,2,20,3,17,9,0
115279,3,14,9,5,1,1
146908,4,41,0,41,15,0
3639,4,20,28,-8,2,1
189090,4,24,30,-6,16,1
133242,4,23,20,3,9,0
13354,4,7,27,-20,7,0
96446,2,10,14,-4,10,0
264426,3,3,28,-25,15,0
34068,1,0,0,0,16,0
350109,4,30,27,3,2,1
298139,4,9,41,-32,13,1
374757,4,8,39,-31,14,1
49144,1,3,0,3,6,0
252275,2,0,10,-10,10,0
87785,1,0,0,0,6,1
134853,4,55,20,35,10,0
249287,4,33,17,16,9,0
78712,2,13,7,6,2,0
167584,4,3,17,-14,7,0
359978,1,0,13,-13,7,1
15832,4,8,12,-4,8,1
352524,2,14,6,8,3,0
154128,2,0,6,-6,1,1
129986,1,0,10,-10,8,1
331209,4,10,20,-10,11,1
171594,2,3,3,0,9,0
170176,4,17,27,-10,8,1
243534,1,3,0,3,6,0
109912,4,23,7,16,16,1
295481,1,0,0,0,12,1
300318,3,0,7,-7,14,0
116489,4,6,19,-13,1,0
193319,4,10,26,-16,1,1
23970,4,16,6,10,12,1
165643,2,0,0,0,6,0
335361,4,3,23,-20,13,1
287100,1,0,0,0,8,1
282852,4,9,20,-11,6,0
114157,1,0,0,0,1,1
327039,4,8,10,-2,9,1
420392,4,20,20,0,17,0
113267,2,7,14,-7,17,1
179394,2,6,13,-7,12,1
273185,3,24,6,18,2,0
170940,4,31,20,11,8,1
203212,3,10,17,-7,5,1
65025,3,0,17,-17,13,0
104767,2,20,16,4,14,0
324425,3,14,3,11,8,0
191260,3,7,17,-10,17,0
317547,4,10,27,-17,5,1
56466,3,0,38,-38,9,0
292732,2,7,10,-3,11,1
166398,2,10,7,3,6,0
245736,3,13,10,3,7,1
196801,2,0,7,-7,3,0
101540,2,10,21,-11,12,1
114932,1,0,3,-3,1,0
39259,2,3,10,-7,1,0
128191,2,14,7,7,7,0
304860,4,12,10,2,16,0
178037,4,7,23,-16,12,1
20989,3,14,24,-10,10,0
55712,4,23,21,2,9,1
73006,1,0,0,0,16,0
204773,3,21,21,0,6,1
272000,1,0,0,0,2,1
302732,1,0,0,0,15,0
315309,1,3,0,3,4,0
199736,4,35,10,25,4,0
139419,3,24,0,24,12,1
272578,3,13,3,10,2,1
309454,4,14,6,8,1,1
14258,1,0,7,-7,7,1
222903,2,7,3,4,14,0
402591,3,10,16,-6,9,1
17963,2,13,21,-8,9,0
236623,1,0,0,0,3,0
401011,4,22,15,7,8,1
386994,4,14,21,-7,2,0
369861,2,7,3,4,12,1
189478,3,14,0,14,17,0
413913,4,20,9,11,14,0
239828,2,0,0,0,4,1
364829,2,3,13,-10,9,0
417288,1,0,0,0,16,1
48712,2,10,19,-9,5,1
262118,2,14,3,11,15,1
130271,4,9,29,-20,8,1
250767,2,3,0,3,10,1
360579,2,7,10,-3,7,0
250898,1,0,0,0,10,0
221910,3,19,10,9,14,0
247378,1,3,6,-3,8,1
17531,2,13,0,13,9,1
33110,3,10,21,-11,16,1
187277,4,10,6,4,16,1
71827,1,0,0,0,16,1
403231,4,24,17,7,9,0
221184,4,0,23,-23,14,0
299455,3,7,20,-13,14,0
337706,4,24,24,0,14,1
384195,4,29,20,9,1,1
294623,2,0,0,0,12,0
280548,2,14,3,11,5,0
349091,1,7,0,7,2,1
55811,2,0,7,-7,9,0
114695,3,6,10,-4,1,1
47328,2,0,10,-10,5,1
55777,1,0,0,0,9,0
30793,4,31,35,-4,15,0
172047,2,7,0,7,9,0
61910,4,27,30,-3,12,1
105708,3,28,3,25,14,1
376596,4,15,6,9,14,0
181787,4,10,17,-7,13,0
341914,1,0,0,0,16,0
266203,2,24,0,24,16,0
375499,3,26,7,19,14,1
373145,1,0,0,0,13,0
12333,1,0,0,0,6,1
356904,1,3,0,3,5,0
290157,1,3,0,3,10,0
360680,4,17,37,-20,7,1
34010,4,17,27,-10,16,0
40795,4,17,28,-11,2,0
151041,2,3,3,0,17,0
66430,1,0,7,-7,14,1
64389,1,0,3,-3,13,1
26491,4,30,22,8,13,1
245064,1,0,0,0,7,1
137454,4,6,28,-22,11,0
4724,1,7,0,7,3,0
347633,3,17,10,7,1,0
311563,1,0,0,0,2,1
323671,3,20,0,20,8,0
400586,4,13,31,-18,8,1
329584,1,10,0,10,11,0
284607,2,14,7,7,7,0
200309,3,27,14,13,4,0
295041,1,0,0,0,12,0
251407,4,37,14,23,10,0
42758,1,3,7,-4,3,1
294145,1,0,0,0,12,0
152011,1,0,0,0,17,0
385803,3,27,3,24,1,1
406226,2,14,17,-3,11,1
165753,4,23,7,16,6,0
49790,2,7,7,0,6,1
55554,3,17,7,10,9,0
134511,4,3,33,-30,10,1
391380,1,7,3,4,4,0
151631,3,23,13,10,17,0
281468,2,7,10,-3,6,0
80245,4,28,31,-3,2,1
329957,3,7,10,-3,11,0
133017,3,9,14,-5,9,0
321076,1,0,0,0,6,1
242941,4,24,23,1,6,1
262519,4,28,35,-7,15,1
320115,2,17,0,17,6,1
322950,3,13,0,13,7,0
389216,3,21,7,14,3,0
17550,3,13,9,4,9,0
301203,3,20,14,6,15,1
179589,3,14,23,-9,12,0
116765,3,13,26,-13,2,1
351533,3,0,27,-27,3,0
414283,3,21,28,-7,14,1
132766,4,20,24,-4,9,0
124208,1,0,7,-7,5,0
43966,3,3,14,-11,3,1
231208,4,10,10,0,1,1
48277,3,10,13,-3,5,1
301234,4,27,17,10,15,0
315416,4,16,30,-14,4,1
188018,4,23,14,9,16,0
315014,1,14,0,14,4,1
408439,2,0,0,0,12,1
409881,4,30,8,22,12,0
124066,2,0,14,-14,5,1
274610,4,27,26,1,3,0
32511,2,14,3,11,15,1
111234,2,10,3,7,16,1
397160,2,6,0,6,6,1
167541,3,0,10,-10,7,0
328337,3,3,30,-27,10,1
119297,3,14,10,4,3,0
74676,3,7,17,-10,17,1
291045,4,20,20,0,10,1
318849,2,21,6,15,5,0
79860,2,3,6,-3,2,0
127150,2,10,9,1,6,0
167903,4,21,19,2,7,1
285197,5,6,6,0,7,1
25681,2,7,7,0,12,1
256820,4,13,19,-6,12,1
314809,3,28,7,21,4,0
22253,1,0,0,0,11,0
11445,4,26,0,26,6,1
54066,3,10,3,7,8,1
191684,2,7,10,-3,17,1
145670,4,35,7,28,14,1
352593,4,34,23,11,3,1
343956,2,16,6,10,17,0
150906,3,7,7,0,17,1
113663,4,9,13,-4,17,0
165324,1,0,0,0,6,0
196043,1,0,14,-14,2,1
300899,3,10,10,0,15,1
421728,3,17,17,0,17,1
204528,1,0,7,-7,6,1
287512,3,14,26,-12,9,0
8056,2,17,7,10,4,0
149904,4,6,23,-17,16,1
12123,3,7,14,-7,6,1
282782,2,0,10,-10,6,1
128809,3,13,13,0,7,0
72969,4,31,15,16,16,1
337475,2,7,9,-2,14,0
328549,1,0,0,0,10,1
354334,2,28,3,25,4,1
346744,4,27,13,14,1,0
348188,2,6,10,-4,1,1
73685,4,13,6,7,17,0
404895,1,3,3,0,10,0
318436,3,21,7,14,5,1
102360,4,13,13,0,13,1
47314,2,0,7,-7,5,0
359211,4,21,21,0,6,0
233351,4,19,26,-7,2,0
135037,1,14,3,11,10,1
272350,2,20,0,20,2,1
285654,4,27,27,0,8,1
1741,4,28,0,28,1,0
33101,2,3,21,-18,16,1
245087,1,7,3,4,7,1
284498,3,17,15,2,7,1
111410,3,0,17,-17,16,0
268544,1,7,3,4,17,0
318936,4,31,28,3,5,0
415960,1,0,0,0,15,0
312595,4,44,7,37,3,1
286081,2,10,3,7,8,1
56454,3,0,38,-38,9,0
192246,1,3,3,0,1,1
416515,4,28,17,11,15,1
282729,4,16,27,-11,6,0
1191,1,3,0,3,1,1
123492,2,0,0,0,4,1
71679,4,3,34,-31,16,0
163188,4,30,28,2,5,1
268828,4,38,10,28,17,0
342705,2,0,0,0,16,0
261,4,12,24,-12,1,0
93113,1,0,0,0,9,0
173253,1,0,0,0,10,0
257084,3,7,14,-7,12,1
282562,4,17,24,-7,6,0
406692,3,24,0,24,11,0
224626,3,16,10,6,15,1
210443,2,9,14,-5,9,1
160478,2,20,7,13,4,1
226425,2,0,7,-7,16,1
304720,4,21,14,7,16,0
46242,4,21,31,-10,4,0
339278,2,24,0,24,15,1
98106,2,14,7,7,11,1
195248,3,16,17,-1,2,1
31057,3,10,13,-3,15,1
81879,3,0,27,-27,3,0
41934,3,21,6,15,2,1
131281,4,21,17,4,8,0
330346,2,7,13,-6,11,1
212714,1,0,14,-14,10,1
205609,1,7,3,4,7,0
301564,1,7,0,7,15,0
221085,1,0,0,0,14,1
187121,3,10,0,10,16,1
369436,3,31,7,24,11,0
300549,4,30,23,7,14,1
294852,3,42,21,21,12,0
144823,1,14,0,14,14,1
111407,3,0,17,-17,16,1
300321,3,0,7,-7,14,1
141362,2,10,17,-7,13,0
382351,1,0,0,0,17,0
301151,2,10,11,-1,15,1
360598,2,7,10,-3,7,0
264923,2,17,17,0,16,1
256898,2,14,16,-2,12,0
90108,1,0,0,0,7,1
132901,4,6,21,-15,9,0
412626,2,3,3,0,14,1
222225,3,13,17,-4,14,1
283564,2,6,17,-11,7,0
403474,3,17,12,5,9,1
387285,3,6,10,-4,2,0
86040,4,25,35,-10,5,1
279849,3,14,13,1,5,0
165044,2,10,17,-7,6,0
223503,2,7,10,-3,15,1
240191,4,16,6,10,5,0
389079,3,20,0,20,3,0
289385,4,31,25,6,9,1
222150,1,7,3,4,14,1
349325,3,28,35,-7,2,1
360274,2,0,6,-6,7,1
356130,2,7,0,7,5,1
167702,3,16,20,-4,7,1
272525,2,7,3,4,2,1
381184,1,7,3,4,16,1
90805,4,34,7,27,7,0
389278,1,0,0,0,3,1
180430,1,7,7,0,13,0
191926,1,0,3,-3,1,1
12208,2,0,0,0,6,1
199475,1,0,0,0,4,1
133796,3,16,10,6,9,1
366030,3,36,14,22,10,1
90718,2,13,0,13,7,1
257961,2,0,7,-7,13,0
235133,3,0,10,-10,2,1
357926,1,0,6,-6,6,1
202812,1,0,0,0,5,1
376050,2,0,0,0,14,0
93568,2,6,3,3,9,0
45095,1,0,0,0,4,0
351357,2,10,7,3,3,1
358025,4,24,16,8,6,0
109511,1,0,0,0,16,0
322533,4,15,3,12,7,1
284780,3,26,17,9,7,0
346979,2,7,3,4,1,0
169083,4,36,17,19,7,0
142495,3,27,10,17,13,0
94876,4,13,13,0,9,0
278576,1,7,0,7,4,0
35385,4,30,23,7,16,0
264718,2,7,13,-6,16,0
87607,4,17,10,7,6,0
119334,4,14,16,-2,3,1
122374,1,0,7,-7,4,0
60356,2,3,7,-4,11,1
213530,3,10,14,-4,10,1
75228,1,7,0,7,17,0
43890,1,0,0,0,3,0
330547,3,7,7,0,11,1
24436,4,16,7,9,12,0
74976,3,20,17,3,17,0
69868,3,21,9,12,15,1
140419,1,0,7,-7,12,1
118308,4,19,7,12,2,1
255345,2,14,3,11,12,0
211513,3,26,14,12,9,1
405536,1,0,7,-7,10,0
266394,3,36,8,28,16,0
120657,1,0,0,0,3,0
205115,1,0,0,0,6,0
88131,1,0,3,-3,6,0
115696,2,10,3,7,1,1
341226,3,13,7,6,16,1
271977,4,23,27,-4,2,1
67465,2,26,7,19,14,1
319263,1,0,3,-3,6,1
116821,1,0,0,0,2,1
106209,4,0,10,-10,14,1
111860,4,13,10,3,17,0
360088,4,10,40,-30,7,0
216664,2,14,6,8,12,1
67636,3,7,35,-28,14,0
163868,1,6,7,-1,5,0
27194,3,16,7,9,13,1
143606,2,10,3,7,14,0
326352,3,14,10,4,9,1
83642,1,0,0,0,4,0
374121,2,13,7,6,13,0
301348,3,17,7,10,15,1
363659,2,0,10,-10,8,0
174794,2,13,14,-1,10,1
254478,3,23,10,13,11,0
172566,3,7,24,-17,9,1
188087,2,0,3,-3,16,0
312014,1,0,0,0,2,1
175146,3,28,10,18,10,0
357211,1,0,0,0,5,0
414990,2,10,10,0,15,1
324378,2,7,3,4,8,1
400248,3,10,6,4,8,0
413722,3,21,13,8,14,0
199364,2,0,10,-10,4,0
220336,1,0,0,0,13,1
8289,1,0,0,0,4,1
100330,2,9,17,-8,12,1
249186,1,9,0,9,9,1
21736,3,24,14,10,11,0
204591,2,0,38,-38,6,1
256406,2,9,7,2,12,0
394011,2,6,10,-4,5,0
373236,3,6,13,-7,13,0
102560,1,2,0,2,13,1
348935,1,0,0,0,2,1
299842,2,10,0,10,14,0
86098,2,28,3,25,5,0
299862,2,13,5,8,14,0
222823,3,17,13,4,14,0
334077,1,0,0,0,13,0
232944,2,7,3,4,2,1
31259,1,0,0,0,15,1
414529,2,14,3,11,14,1
174414,4,17,10,7,10,1
386851,4,19,27,-8,2,0
212251,1,0,0,0,10,1
403475,3,17,12,5,9,1
105158,1,0,0,0,14,0
55191,1,7,0,7,9,0
402627,4,20,23,-3,9,1
253793,4,24,17,7,11,1
7839,1,0,7,-7,4,0
182587,1,0,3,-3,14,0
349163,3,27,7,20,2,0
239770,4,20,13,7,4,1
80398,4,27,16,11,2,0
10600,2,0,10,-10,5,1
349402,2,0,7,-7,2,1
37022,1,3,0,3,17,1
208448,2,10,0,10,8,0
362663,3,3,7,-4,8,0
83877,3,23,17,6,4,1
293231,3,16,7,9,11,1
51544,5,37,34,3,7,1
3051,4,20,41,-21,2,0
82241,4,16,13,3,3,1
419324,3,0,17,-17,16,1
359959,4,30,30,0,6,1
379535,1,6,3,3,16,1
391710,2,3,10,-7,4,1
48641,4,33,27,6,5,0
138741,1,0,0,0,12,1
22052,4,17,24,-7,11,1
166974,1,0,0,0,7,1
146864,3,31,0,31,15,0
73799,3,6,0,6,17,1
278615,2,14,0,14,4,0
265824,4,20,12,8,16,0
216743,4,27,9,18,12,0
80988,3,20,10,10,3,0
39393,2,0,3,-3,1,1
202121,2,13,3,10,5,0
120235,2,7,3,4,3,1
108988,2,16,24,-8,15,0
175137,3,28,10,18,10,1
86646,1,0,0,0,5,1
257505,2,16,10,6,13,0
302117,4,27,34,-7,15,1
106601,2,31,0,31,14,0
8413,1,0,0,0,4,1
271006,3,10,21,-11,1,0
70567,2,0,7,-7,15,1
217462,2,9,0,9,12,0
243348,4,20,30,-10,6,0
392850,4,17,20,-3,4,1
146560,3,14,24,-10,15,0
332121,1,0,0,0,12,0
212486,3,10,6,4,10,1
330538,3,7,7,0,11,1
366295,3,28,10,18,10,1
281900,1,0,0,0,6,1
231822,4,32,20,12,1,1
355039,4,18,32,-14,4,0
79868,2,3,13,-10,2,1
114563,4,17,40,-23,1,1
275422,2,6,10,-4,3,1
194793,3,10,23,-13,2,1
1006,4,6,6,0,1,1
230465,4,21,14,7,1,1
28305,4,27,14,13,13,0
90580,2,14,7,7,7,0
90865,2,28,0,28,7,0
185272,3,27,9,18,15,0
233260,2,0,3,-3,2,0
296402,1,7,0,7,13,0
181618,4,23,6,17,13,0
353965,5,34,31,3,4,1
228393,3,10,17,-7,17,0
242940,4,24,22,2,6,0
330964,2,9,7,2,11,1
71497,4,33,14,19,16,0
117735,1,0,0,0,2,0
168474,4,0,24,-24,7,1
392273,1,0,7,-7,4,1
19703,2,3,6,-3,10,0
30733,3,17,21,-4,15,1
390155,4,20,35,-15,3,1
343084,3,12,13,-1,16,0
213228,3,10,16,-6,10,1
202897,3,28,0,28,5,0
60831,3,10,16,-6,11,0
323315,1,0,0,0,7,0
289281,2,14,14,0,9,0
59804,3,12,13,-1,11,0
215422,1,7,3,4,11,1
143006,4,10,20,-10,13,1
332136,1,0,7,-7,12,1
292575,2,6,9,-3,11,1
123138,2,3,7,-4,4,0
87328,4,24,24,0,6,1
273328,3,27,0,27,2,1
372390,1,6,0,6,13,0
25799,1,3,0,3,12,0
417624,2,14,3,11,16,1
191784,1,0,0,0,1,1
418120,2,14,0,14,16,0
353877,3,10,21,-11,4,0
278333,2,14,14,0,4,1
202405,2,3,3,0,5,1
132700,2,3,10,-7,9,0
356611,5,12,9,3,5,1
5662,3,0,14,-14,3,1
365829,1,0,0,0,9,0
234781,2,0,3,-3,2,1
130990,3,10,27,-17,8,0
158210,3,23,0,23,3,1
51734,2,0,10,-10,7,1
235526,2,3,13,-10,3,0
374043,4,24,10,14,13,0
37236,3,10,14,-4,17,1
199279,4,17,38,-21,4,1
304203,2,13,7,6,16,1
354855,4,33,35,-2,4,1
401252,2,7,14,-7,8,1
321671,4,27,27,0,7,1
392,3,28,17,11,1,1
191754,4,16,17,-1,17,0
39542,2,0,3,-3,1,1
370383,1,0,0,0,12,1
340639,2,16,3,13,15,0
29430,2,7,14,-7,14,0
62195,4,13,17,-4,12,0
144270,3,16,7,9,14,1
204644,4,17,45,-28,6,0
15053,2,10,26,-16,7,1
307806,3,17,14,3,1,1
145957,3,7,21,-14,15,1
233386,1,7,0,7,2,0
320017,4,43,30,13,6,1
182548,4,42,21,21,14,0
169068,3,33,14,19,7,0
93861,2,14,0,14,9,1
159468,4,20,23,-3,3,1
257725,4,3,24,-21,13,1
108706,3,34,13,21,15,0
166052,4,20,31,-11,6,1
22767,3,3,21,-18,11,1
52369,3,6,17,-11,7,0
247334,4,42,42,0,8,1
137433,4,6,21,-15,11,0
351630,1,0,7,-7,3,1
292033,3,15,9,6,11,0
117650,2,13,13,0,2,1
135880,4,21,24,-3,10,1
314888,2,0,0,0,4,0
233795,4,19,37,-18,2,1
206805,1,0,0,0,7,0
112554,2,17,19,-2,17,1
14040,3,3,21,-18,7,0
401060,1,7,3,4,8,1
156090,1,0,0,0,2,1
193801,1,0,0,0,1,1
246615,2,14,3,11,8,1
409474,1,0,0,0,12,0
279444,4,16,30,-14,5,0
412085,3,31,0,31,13,0
204870,2,3,9,-6,6,0
254210,4,3,25,-22,11,0
243864,2,6,0,6,6,0
341510,2,3,7,-4,16,1
174363,3,17,0,17,10,0
267181,4,20,10,10,17,0
154480,3,14,10,4,1,1
338401,3,24,10,14,14,1
30042,4,33,0,33,14,0
164084,3,12,6,6,5,1
299961,1,0,7,-7,14,0
25364,1,3,0,3,12,1
412762,1,13,10,3,14,1
358431,3,29,19,10,6,0
28792,1,0,0,0,14,1
70956,4,15,39,-24,15,1
284640,3,14,20,-6,7,1
282746,1,0,0,0,6,0
258201,5,20,20,0,13,0
38374,2,13,9,4,1,1
258585,3,13,10,3,13,1
131514,2,3,6,-3,8,1
81079,2,0,14,-14,3,1
4730,1,7,0,7,3,1
370744,2,12,7,5,12,0
9683,4,12,28,-16,5,0
141204,3,3,21,-18,13,1
74443,4,13,20,-7,17,0
411916,2,17,3,14,13,0
155843,2,7,10,-3,2,0
106629,3,37,7,30,14,1
20213,4,17,10,7,10,1
371527,1,0,0,0,12,0
366229,1,7,0,7,10,0
149028,1,0,6,-6,16,0
353455,4,25,12,13,4,0
309855,3,21,7,14,1,0
18137,3,6,17,-11,9,1
257965,2,0,7,-7,13,0
227304,3,13,20,-7,16,0
348450,1,0,0,0,2,0
222430,1,3,7,-4,14,1
141671,2,23,14,9,13,1
258561,2,0,0,0,13,1
101339,1,3,0,3,12,0
35676,4,23,10,13,17,1
154883,2,6,3,3,1,1
196644,1,7,0,7,3,1
102763,2,10,0,10,13,0
190851,4,22,10,12,17,1
185796,4,25,3,22,15,0
201904,1,0,0,0,5,0
154500,4,14,17,-3,1,1
188141,3,10,10,0,16,0
294309,1,10,0,10,12,0
34341,4,23,9,14,16,0
379108,4,7,12,-5,15,1
230652,1,0,0,0,1,1
290189,2,3,0,3,10,1
21652,1,0,0,0,11,1
184404,3,24,6,18,14,0
100182,2,14,0,14,12,0
321536,1,0,3,-3,7,1
214538,1,0,0,0,11,1
357511,2,7,6,1,5,1
266630,2,10,3,7,16,1
78626,4,30,13,17,2,0
377606,4,20,12,8,15,1
230469,4,28,14,14,1,0
223548,3,10,10,0,15,0
176180,3,14,14,0,11,0
329805,3,17,20,-3,11,1
293016,2,3,13,-10,11,0
204146,3,10,10,0,6,0
387010,4,14,28,-14,2,1
395269,4,10,16,-6,5,1
46676,4,16,3,13,4,1
320261,2,14,7,7,6,1
166569,2,6,7,-1,6,0
176726,4,36,19,17,11,1
191631,1,0,0,0,17,1
144066,2,7,0,7,14,1
351811,2,17,14,3,3,0
296399,1,0,0,0,13,1
162683,3,16,24,-8,5,1
358304,3,0,20,-20,6,1
202785,4,19,17,2,5,1
138076,4,42,24,18,11,1
154414,2,7,0,7,1,0
358889,3,6,28,-22,6,0
385858,1,0,0,0,1,1
300153,2,21,3,18,14,0
369214,1,0,6,-6,11,0
76196,2,9,20,-11,1,1
8930,3,28,0,28,4,0
393726,3,0,7,-7,5,1
1758,4,28,0,28,1,0
211168,2,0,10,-10,9,1
195011,1,7,7,0,2,1
92394,2,10,7,3,8,1
308879,4,10,13,-3,1,0
164001,1,0,3,-3,5,1
190587,4,20,20,0,17,0
298513,2,10,0,10,14,1
90890,2,31,7,24,7,1
8964,4,35,20,15,4,0
122485,4,13,33,-20,4,1
419692,1,0,0,0,17,0
21571,2,7,17,-10,11,1
314180,2,7,20,-13,3,0
194883,2,0,10,-10,2,0
263211,3,17,17,0,15,0
221599,3,20,18,2,14,0
351466,1,0,7,-7,3,0
362180,2,3,0,3,8,0
193165,1,0,0,0,1,1
391060,4,27,34,-7,4,1
20065,4,19,16,3,10,1
341152,1,0,0,0,16,1
376593,4,15,6,9,14,1
305991,2,3,3,0,17,0
256720,2,0,6,-6,12,0
230721,3,9,27,-18,1,1
69570,2,7,10,-3,15,0
351719,4,21,17,4,3,0
363570,4,3,12,-9,8,0
329229,3,17,13,4,10,0
21504,1,0,0,0,11,1
334158,4,23,7,16,13,0
18389,1,0,0,0,9,0
90541,1,7,0,7,7,0
404710,1,0,0,0,10,0
40989,1,3,7,-4,2,0
280246,2,3,13,-10,5,0
333942,2,7,7,0,12,1
410332,4,7,26,-19,13,1
357480,1,0,3,-3,5,1
350782,4,17,3,14,2,0
13629,3,13,10,3,7,0
247149,3,20,6,14,8,1
138850,4,12,33,-21,12,0
399304,1,14,7,7,7,1
42287,4,37,7,30,2,1
408704,1,0,0,0,12,1
2123,3,10,13,-3,1,1
273672,4,22,13,9,2,0
281815,3,10,0,10,6,1
73142,1,0,0,0,16,0
367907,4,23,20,3,10,0
93132,2,0,0,0,9,1
227579,2,21,0,21,16,1
102387,4,16,27,-11,13,1
239622,4,20,17,3,4,0
41035,2,3,10,-7,2,0
314299,1,0,14,-14,3,1
284225,4,9,26,-17,7,1
32890,4,19,7,12,15,1
363030,4,33,26,7,8,0
297368,2,6,10,-4,13,1
402302,3,20,16,4,9,0
252036,3,14,20,-6,10,0
354234,3,19,10,9,4,1
786,2,6,3,3,1,1
212865,1,0,0,0,10,0
287460,2,7,13,-6,9,0
28139,4,30,10,20,13,0
154524,1,0,0,0,1,1
231261,1,0,3,-3,1,1
74324,1,0,0,0,17,0
374703,2,0,23,-23,14,0
186589,1,14,0,14,15,1
207483,4,21,14,7,7,1
22205,4,10,15,-5,11,1
198369,4,20,14,6,3,0
203167,2,0,10,-10,5,0
349038,4,14,17,-3,2,1
215870,1,0,7,-7,11,1
343289,1,0,0,0,16,0
367078,1,7,0,7,10,0
248260,1,0,0,0,8,1
401023,4,29,15,14,8,1
287844,4,28,20,8,9,0
137626,5,37,34,3,11,0
182014,2,14,14,0,13,1
20993,3,14,24,-10,10,0
80591,1,0,7,-7,3,1
102851,4,17,10,7,13,0
286512,1,3,7,-4,8,0
355509,1,0,0,0,5,1
45947,4,17,3,14,4,1
92366,1,7,0,7,8,1
86921,1,0,0,0,5,1
366191,4,7,51,-44,10,1
242572,1,3,0,3,6,1
17791,1,7,3,4,9,1
188032,4,23,17,6,16,0
99644,3,23,3,20,11,0
209206,2,7,7,0,8,1
37453,1,0,7,-7,17,1
167333,2,16,16,0,7,1
72841,4,38,17,21,16,0
417461,2,3,13,-10,16,0
81353,1,0,7,-7,3,1
42793,2,6,21,-15,3,0
310929,3,3,9,-6,2,1
374241,1,7,0,7,13,0
17520,2,13,0,13,9,0
246207,3,21,13,8,7,1
199479,1,0,0,0,4,0
59680,4,24,6,18,11,0
33076,2,3,7,-4,16,0
45157,2,7,7,0,4,0
306722,2,10,10,0,17,0
388192,4,6,13,-7,2,0
31492,3,3,17,-14,15,1
234645,2,20,17,3,2,0
210800,4,24,10,14,9,1
103049,2,20,0,20,13,1
388692,4,20,7,13,3,0
224614,2,9,7,2,15,0
3359,4,10,6,4,2,0
75345,4,21,33,-12,17,1
166683,1,0,0,0,6,1
367668,2,0,3,-3,10,1
236870,1,0,0,0,3,0
272497,1,7,0,7,2,0
297873,4,21,27,-6,13,1
284797,3,26,17,9,7,0
85466,2,14,3,11,5,1
420086,4,31,21,10,17,0
212621,3,7,24,-17,10,1
91633,2,14,7,7,8,0
107268,1,0,0,0,15,1
253262,3,3,13,-10,11,1
67583,2,0,20,-20,14,1
131539,3,6,16,-10,8,1
419720,2,0,10,-10,17,1
252955,3,9,7,2,11,1
95513,2,3,7,-4,10,1
205129,1,0,0,0,6,1
65749,3,14,16,-2,13,1
300795,3,10,33,-23,15,0
202208,1,0,0,0,5,1
303745,2,17,10,7,16,1
323547,4,24,17,7,7,1
162962,2,6,0,6,5,0
411022,2,17,14,3,13,1
294592,1,0,0,0,12,0
88728,1,3,0,3,6,0
102673,4,22,20,2,13,1
116845,1,7,7,0,2,1
41716,1,0,0,0,2,0
194019,2,14,7,7,1,0
392806,2,17,6,11,4,0
179772,3,6,17,-11,12,0
213190,2,3,10,-7,10,0
199891,4,10,24,-14,4,1
220683,2,10,0,10,13,0
193502,1,0,0,0,1,0
341958,2,6,0,6,16,0
321618,3,17,6,11,7,0
168228,1,0,0,0,7,0
274016,1,0,0,0,3,0
289951,4,6,6,0,10,0
411894,2,14,3,11,13,0
115725,3,13,10,3,1,0
373175,2,3,3,0,13,1
96650,4,3,10,-7,10,0
101298,4,17,20,-3,12,1
59558,1,0,0,0,11,0
191419,3,0,31,-31,17,0
163112,2,13,19,-6,5,1
43830,3,20,16,4,3,1
30785,4,31,35,-4,15,1
75342,4,21,33,-12,17,1
137928,4,27,15,12,11,1
392099,1,0,0,0,4,0
186216,4,29,13,16,15,0
38697,3,14,14,0,1,1
42634,2,0,7,-7,3,0
23125,1,0,0,0,11,1
205021,2,9,10,-1,6,0
239827,2,0,0,0,4,1
70790,4,23,27,-4,15,1
18950,1,0,0,0,10,1
317239,4,7,16,-9,5,1
285214,1,0,0,0,7,1
257325,1,17,0,17,13,0
193236,2,3,7,-4,1,1
323836,3,13,15,-2,8,1
65287,2,3,21,-18,13,1
26666,1,0,0,0,13,1
121262,4,21,30,-9,3,1
169366,3,6,14,-8,8,0
336503,1,0,0,0,14,1
276252,4,31,17,14,3,0
416745,2,7,0,7,15,0
404030,2,3,28,-25,10,1
16623,2,7,27,-20,8,1
200984,1,14,0,14,5,0
372291,2,10,7,3,13,1
25630,1,0,0,0,12,0
199446,4,22,17,5,4,1
274118,4,20,0,20,3,1
117716,4,34,20,14,2,0
187332,1,7,7,0,16,1
109554,2,0,7,-7,16,1
45412,1,7,0,7,4,1
126407,4,33,17,16,6,0
376903,1,0,0,0,15,0
212221,4,3,24,-21,10,1
68354,2,3,7,-4,14,0
347339,4,7,21,-14,1,0
2165,4,13,23,-10,1,1
233143,3,29,3,26,2,1
220839,3,7,21,-14,14,1
291451,3,14,20,-6,10,1
76326,2,13,3,10,1,0
194285,2,10,0,10,2,0
146415,3,13,3,10,15,1
356390,4,31,20,11,5,1
57519,3,21,13,8,10,1
177156,4,40,13,27,11,0
296953,3,29,7,22,13,1
336145,3,10,3,7,13,0
278824,3,13,21,-8,5,1
87924,4,19,15,4,6,1
94450,1,0,0,0,9,1
420767,2,0,3,-3,17,1
270975,2,0,7,-7,1,0
9979,4,3,3,0,5,1
82260,1,0,0,0,3,0
386803,2,10,7,3,2,0
297948,2,17,7,10,13,1
307056,3,24,0,24,17,0
394255,1,0,0,0,5,0
72738,1,7,0,7,16,0
334717,3,18,3,15,13,1
224463,2,9,10,-1,15,0
103889,1,0,0,0,13,0
224258,1,6,6,0,15,1
405400,2,7,10,-3,10,1
349156,3,20,7,13,2,1
632,2,0,3,-3,1,0
343030,2,6,0,6,16,1
204792,4,28,21,7,6,0
321209,4,3,19,-16,6,0
203628,2,7,7,0,6,0
32014,1,6,0,6,15,1
370804,4,26,17,9,12,1
203302,2,0,24,-24,6,1
319005,2,7,16,-9,5,0
59512,3,6,20,-14,11,0
248157,2,3,10,-7,8,1
30238,1,0,0,0,14,1
105341,2,7,7,0,14,0
20207,3,17,10,7,10,1
35029,2,9,3,6,16,1
247122,3,20,6,14,8,1
317758,1,0,0,0,5,0
344021,4,23,9,14,17,1
316101,2,17,13,4,4,1
156399,4,38,20,18,2,1
383576,4,21,21,0,17,0
66528,4,31,24,7,14,0
175103,2,14,10,4,10,0
292896,2,7,0,7,11,0
348882,4,9,14,-5,2,1
315650,2,3,7,-4,4,0
286181,5,24,24,0,8,0
83888,4,23,17,6,4,0
272195,2,0,0,0,2,0
394677,4,24,21,3,5,0
168740,3,10,6,4,7,1
384019,3,10,23,-13,1,1
55129,4,26,10,16,8,0
272899,3,20,17,3,2,1
3074,1,0,0,0,2,1
53748,4,10,3,7,8,0
307144,1,0,3,-3,17,1
386166,2,3,3,0,2,1
366664,1,14,3,11,10,1
338098,3,6,7,-1,14,1
18712,2,3,7,-4,9,0
199700,3,21,7,14,4,1
214449,3,7,14,-7,11,0
317535,4,10,27,-17,5,1
279053,1,7,0,7,5,1
383137,4,23,14,9,17,0
224133,2,0,17,-17,15,1
176257,1,0,0,0,11,1
69100,2,7,7,0,15,0
373001,1,0,0,0,13,1
165095,3,10,24,-14,6,1
289910,2,6,3,3,10,1
326036,2,9,0,9,9,1
280142,3,21,0,21,5,0
311210,2,6,0,6,2,1
293218,2,16,7,9,11,1
132747,4,20,17,3,9,0
296713,1,0,0,0,13,0
254711,1,3,0,3,11,0
352325,1,0,0,0,3,1
9146,1,0,13,-13,5,1
182873,1,0,0,0,14,0
312860,3,14,0,14,3,0
123135,2,3,7,-4,4,1
156484,3,0,6,-6,2,0
26464,3,27,19,8,13,1
44002,4,3,28,-25,3,1
71595,2,3,17,-14,16,1
394488,3,10,18,-8,5,0
17697,3,14,6,8,9,0
54519,3,14,10,4,8,1
6959,2,0,7,-7,3,1
68719,4,31,0,31,15,1
80956,3,20,0,20,3,0
180361,3,15,14,1,13,1
38600,4,38,13,25,1,1
175328,4,22,19,3,10,0
31034,3,10,6,4,15,1
350914,3,3,14,-11,3,1
83769,4,32,23,9,4,0
355687,1,7,0,7,5,1
223728,4,37,13,24,15,0
26461,3,27,19,8,13,1
70965,1,0,0,0,16,0
294008,1,0,0,0,12,1
212620,3,7,24,-17,10,1
220661,2,10,0,10,13,1
217900,3,17,28,-11,12,1
374201,4,29,28,1,13,1
282268,3,25,14,11,6,0
163917,3,23,10,13,5,0
135534,3,14,6,8,10,1
233365,1,0,0,0,2,1
357295,4,6,19,-13,5,1
39002,4,30,17,13,1,1
353076,2,7,9,-2,3,0
196084,2,6,21,-15,2,1
350002,2,10,7,3,2,0
301698,1,0,0,0,15,0
274921,4,14,16,-2,3,1
403945,4,20,17,3,10,0
58049,1,7,7,0,10,1
278618,2,14,0,14,4,1
334425,3,10,10,0,13,1
329716,4,40,17,23,11,0
166815,4,30,16,14,6,0
170691,2,7,3,4,8,0
400588,4,13,31,-18,8,0
252212,4,23,24,-1,10,0
202562,2,7,6,1,5,1
215980,4,20,42,-22,11,1
81526,2,0,14,-14,3,0
348846,2,3,14,-11,2,1
268920,3,6,30,-24,17,0
63389,4,17,10,7,12,1
265681,4,12,18,-6,16,0
101248,3,7,7,0,12,1
133725,1,0,0,0,9,0
331390,1,3,6,-3,11,0
376749,4,20,0,20,14,0
152937,2,14,17,-3,1,0
204379,1,0,3,-3,6,1
252551,4,29,32,-3,10,0
313258,1,3,0,3,3,0
412506,3,24,7,17,14,0
418660,4,28,37,-9,16,0
341736,4,26,13,13,16,1
324961,1,6,7,-1,8,0
169698,4,20,17,3,8,0
361146,5,23,23,0,7,0
291967,1,0,0,0,11,1
9366,4,31,7,24,5,0
164162,2,14,7,7,5,1
256719,2,0,6,-6,12,0
213125,4,20,6,14,10,0
266187,2,21,0,21,16,1
9262,1,7,0,7,5,0
209558,3,34,20,14,8,1
172206,2,7,6,1,9,0
256939,4,20,21,-1,12,1
94741,1,0,0,0,9,1
100627,2,7,7,0,12,0
18036,4,22,28,-6,9,1
248296,2,17,0,17,8,0
33264,3,10,0,10,16,1
41723,1,0,0,0,2,0
54394,4,24,19,5,8,1
53848,1,0,0,0,8,0
199982,2,17,10,7,4,1
336686,1,0,3,-3,14,1
6693,3,3,20,-17,3,0
266624,2,10,0,10,16,0
152154,1,0,0,0,17,0
340702,4,22,20,2,15,0
359375,4,10,20,-10,6,1
190747,1,0,0,0,17,1
379943,4,21,6,15,16,1
40831,4,32,35,-3,2,0
358888,3,6,28,-22,6,0
127823,4,17,35,-18,6,0
137190,1,7,0,7,11,0
141051,3,7,10,-3,13,1
262143,3,21,3,18,15,0
372274,2,10,7,3,13,0
260376,3,6,0,6,14,0
120085,2,3,0,3,3,0
334333,1,0,0,0,13,0
265937,3,0,23,-23,16,1
381313,1,0,0,0,16,0
25450,4,13,17,-4,12,0
357576,3,13,13,0,5,0
146381,2,10,3,7,15,0
77493,2,0,7,-7,1,1
118908,4,27,21,6,2,1
29206,4,3,26,-23,14,1
372663,4,14,9,5,13,0
177059,1,3,3,0,11,1
232965,2,10,3,7,2,1
169356,2,6,14,-8,8,0
114240,4,10,17,-7,1,1
156516,3,7,6,1,2,0
230359,1,0,0,0,1,0
395568,4,35,14,21,6,0
12531,2,0,17,-17,6,1
115907,4,7,23,-16,1,0
249757,4,35,28,7,9,1
419155,2,10,3,7,16,1
404790,3,17,13,4,10,1
94812,3,3,9,-6,9,1
151230,4,17,23,-6,17,0
365316,3,17,16,1,9,0
349748,3,20,7,13,2,0
62867,2,3,3,0,12,1
202660,4,41,20,21,5,1
153168,4,20,17,3,1,0
291890,3,10,10,0,11,1
179690,1,0,0,0,12,1
309224,1,0,0,0,1,0
334904,4,27,10,17,13,0
83903,4,23,17,6,4,1
63021,3,9,21,-12,12,1
127789,3,10,21,-11,6,0
177372,2,10,7,3,11,1
48299,3,13,13,0,5,1
114963,2,7,6,1,1,1
263324,3,17,7,10,15,1
386707,4,17,19,-2,2,1
398863,1,3,0,3,7,0
78416,2,14,0,14,2,1
229392,2,3,0,3,17,0
89075,2,13,6,7,6,0
329553,4,45,14,31,10,0
233649,4,23,47,-24,2,1
410740,3,17,6,11,13,0
339201,1,0,0,0,15,0
305108,2,21,10,11,16,0
19923,4,16,21,-5,10,1
85557,4,17,22,-5,5,0
177394,2,17,7,10,11,0
34506,1,0,0,0,16,0
52397,3,9,17,-8,7,1
271245,1,3,0,3,1,0
64783,4,31,7,24,13,1
300330,3,0,7,-7,14,1
419197,3,10,6,4,16,1
59561,1,0,0,0,11,0
300339,3,3,7,-4,14,0
189528,4,20,0,20,17,0
141784,1,7,7,0,13,1
388423,1,0,6,-6,2,0
247768,4,10,6,4,8,0
260084,3,6,14,-8,14,0
380990,4,9,14,-5,16,0
34952,4,27,27,0,16,0
412941,2,15,6,9,14,1
78811,1,0,0,0,2,1
220539,2,7,17,-10,13,0
403721,2,9,3,6,9,0
306904,3,6,16,-10,17,1
72350,3,0,17,-17,16,1
196945,2,13,0,13,3,1
36483,2,3,6,-3,17,1
289998,1,0,0,0,10,1
222118,1,0,0,0,14,0
337285,1,0,0,0,14,0
145806,3,13,10,3,15,0
359726,2,17,6,11,6,0
365866,2,7,7,0,9,0
282521,3,17,3,14,6,0
57169,2,7,0,7,10,1
236090,4,51,10,41,3,0
43027,2,0,0,0,3,1
75501,4,31,7,24,17,0
145956,3,7,21,-14,15,1
289620,3,10,13,-3,10,1
163952,4,26,13,13,5,1
13998,2,3,7,-4,7,1
259444,2,6,10,-4,13,1
175932,4,37,27,10,11,0
324806,1,0,0,0,8,1
162037,2,14,13,1,4,1
86494,1,0,0,0,5,0
360666,4,17,34,-17,7,0
321293,3,9,13,-4,6,0
416363,4,16,6,10,15,1
180348,3,12,14,-2,13,0
255020,2,3,9,-6,12,0
121965,2,3,7,-4,4,1
39551,2,0,3,-3,1,0
15644,3,21,10,11,8,1
244490,2,19,3,16,7,0
147791,1,0,7,-7,15,0
238521,3,13,6,7,4,0
370550,1,7,0,7,12,0
116875,2,7,7,0,2,0
78571,2,16,7,9,2,0
144528,2,7,7,0,14,0
296527,4,26,3,23,13,0
165297,4,17,24,-7,6,1
181187,1,0,0,0,13,0
345678,2,7,0,7,17,1
240462,2,3,7,-4,5,1
137129,4,30,6,24,11,1
273414,1,0,0,0,2,1
399063,3,10,19,-9,7,0
139166,4,19,13,6,12,1
418362,4,15,31,-16,16,0
421643,2,3,7,-4,17,1
249457,5,18,18,0,9,0
125409,1,7,0,7,5,1
379188,3,9,10,-1,16,1
55038,1,7,0,7,8,0
371995,2,10,0,10,13,0
92442,3,20,10,10,8,0
92531,2,10,0,10,8,1
226978,1,3,3,0,16,1
223779,1,0,0,0,15,0
104059,1,7,7,0,13,1
232527,3,20,10,10,1,0
221461,3,3,38,-35,14,0
367820,2,10,7,3,10,0
250136,2,10,0,10,9,1
158097,4,22,9,13,3,1
194873,2,0,10,-10,2,1
6907,1,0,0,0,3,0
420457,2,0,21,-21,17,1
376079,2,0,3,-3,14,0
5278,4,24,31,-7,3,1
38627,1,0,0,0,1,1
374307,3,14,13,1,13,1
334687,2,15,3,12,13,1
18149,3,13,17,-4,9,0
164128,4,22,6,16,5,1
360344,4,7,20,-13,7,1
235376,2,14,7,7,3,0
411818,4,0,34,-34,13,1
403869,2,10,0,10,10,0
88806,3,13,13,0,6,1
144375,2,0,3,-3,14,1
138256,4,10,12,-2,11,1
297811,2,14,7,7,13,0
346852,3,16,6,10,1,0
63106,1,7,3,4,12,0
105884,4,19,10,9,14,1
315220,3,17,10,7,4,1
115447,4,39,14,25,1,1
161652,4,39,16,23,4,0
52654,2,3,7,-4,7,1
60655,2,7,3,4,11,1
149730,3,34,0,34,16,1
164447,2,14,0,14,5,0
74390,2,7,10,-3,17,1
7175,4,41,24,17,4,1
375954,3,17,12,5,14,1
184815,3,17,20,-3,15,1
317541,4,10,27,-17,5,0
292004,2,6,3,3,11,1
55068,2,13,3,10,8,1
75087,2,7,6,1,17,1
68725,4,34,0,34,15,0
195359,2,3,3,0,2,1
187506,2,3,10,-7,16,0
234386,4,17,10,7,2,1
172479,4,13,49,-36,9,1
24095,3,7,7,0,12,0
254825,4,20,13,7,11,1
347765,2,7,0,7,1,1
143401,4,7,26,-19,14,1
160564,4,23,20,3,4,1
392491,2,3,17,-14,4,0
14728,2,20,0,20,7,1
160050,3,13,26,-13,3,1
266821,4,10,14,-4,16,0
210671,4,20,24,-4,9,0
139349,1,0,0,0,12,1
237467,1,7,0,7,3,1
404861,4,23,27,-4,10,1
39954,4,9,10,-1,1,0
161002,3,16,7,9,4,0
17960,2,13,21,-8,9,1
211959,2,0,10,-10,9,1
73764,2,3,0,3,17,1
13196,4,22,23,-1,6,0
168114,2,6,2,4,7,1
26649,4,24,20,4,13,0
198378,4,20,14,6,3,1
281680,3,30,17,13,6,1
5414,4,20,16,4,3,1
324202,1,0,0,0,8,1
262104,2,14,3,11,15,0
58545,2,10,10,0,10,1
220738,4,13,13,0,13,1
151861,1,9,0,9,17,1
381077,2,17,14,3,16,0
243265,2,7,10,-3,6,0
287113,1,0,0,0,8,0
416550,1,0,0,0,15,0
34297,3,20,9,11,16,0
360620,3,7,17,-10,7,0
88719,1,0,0,0,6,1
25917,4,38,17,21,12,0
96731,2,0,10,-10,10,1
113851,1,6,0,6,17,1
94353,3,17,7,10,9,0
378609,4,20,13,7,15,0
85451,2,7,3,4,5,1
242229,4,30,14,16,6,1
86374,1,7,0,7,5,1
179898,3,17,9,8,13,1
222089,4,27,17,10,14,0
91970,3,13,23,-10,8,0
226986,2,3,3,0,16,0
76044,2,10,13,-3,1,0
419319,3,0,17,-17,16,1
405841,5,24,24,0,10,0
43615,1,0,0,0,3,0
213372,2,10,13,-3,10,0
409028,1,0,0,0,12,1
164884,2,0,3,-3,6,1
309601,4,16,3,13,1,1
84077,4,30,25,5,4,0
285593,3,13,10,3,8,1
254634,4,28,14,14,11,0
23674,4,7,27,-20,12,0
327411,3,3,14,-11,9,0
197665,1,0,0,0,3,0
64940,4,10,6,4,13,1
166526,1,0,0,0,6,0
360748,2,17,21,-4,7,1
154867,2,3,3,0,1,1
170289,3,0,12,-12,8,1
84223,1,0,0,0,4,1
203645,3,7,13,-6,6,0
60862,4,17,23,-6,11,0
30680,1,3,0,3,15,0
184484,2,7,7,0,14,1
7266,3,7,13,-6,4,0
276801,2,17,17,0,4,1
168431,2,0,17,-17,7,1
242809,4,14,34,-20,6,1
256700,1,0,3,-3,12,0
362214,3,6,10,-4,8,1
379170,2,6,10,-4,16,1
27621,2,7,10,-3,13,1
364819,2,3,7,-4,9,0
62017,3,10,7,3,12,1
345604,4,17,23,-6,17,0
141208,3,3,21,-18,13,0
328675,4,27,38,-11,10,1
47748,4,6,20,-14,5,0
419797,4,24,20,4,17,0
308727,3,10,13,-3,1,0
358934,4,14,38,-24,6,1
86658,1,7,0,7,5,1
385690,5,27,27,0,1,1
202735,3,13,10,3,5,1
380227,3,13,16,-3,16,0
216128,1,0,0,0,12,0
402684,1,0,0,0,9,1
419987,2,3,7,-4,17,1
406460,1,0,3,-3,11,0
325559,1,0,0,0,9,1
339651,4,31,23,8,15,0
107,3,7,7,0,1,1
362341,2,10,7,3,8,1
346328,2,3,3,0,1,0
302224,3,28,13,15,15,1
258432,3,21,13,8,13,0
163323,4,13,23,-10,5,1
356356,3,24,8,16,5,1
254930,3,31,7,24,12,0
310232,1,0,0,0,2,1
157148,4,19,20,-1,2,0
411736,2,0,10,-10,13,1
385477,4,35,10,25,1,0
22375,4,7,6,1,11,0
142063,1,0,0,0,13,1
208283,1,0,14,-14,8,1
368417,3,20,7,13,11,0
122766,4,10,27,-17,4,1
354174,2,3,7,-4,4,1
58589,3,10,10,0,10,0
211518,3,26,14,12,9,1
78050,4,12,23,-11,1,1
343568,1,6,0,6,17,0
282943,2,7,0,7,6,0
282144,4,23,8,15,6,1
62609,3,9,17,-8,12,1
129362,2,16,7,9,7,0
48740,3,10,19,-9,5,0
285635,4,27,24,3,8,1
57007,2,0,10,-10,9,1
280606,4,20,9,11,5,0
374180,4,23,21,2,13,1
60759,1,0,0,0,11,1
54608,1,7,6,1,8,0
350206,3,19,0,19,2,1
47625,1,3,17,-14,5,1
420323,3,17,3,14,17,0
382270,3,17,3,14,17,1
121987,3,16,7,9,4,1
96380,4,9,37,-28,10,0
108427,4,13,21,-8,15,0
264732,2,10,13,-3,16,0
245471,4,23,6,17,7,0
21155,3,0,16,-16,10,1
348068,2,0,10,-10,1,1
168627,4,17,16,1,7,1
269822,3,13,10,3,1,1
82654,3,12,10,2,3,1
136193,4,13,10,3,10,0
153307,4,2,10,-8,1,0
245633,4,43,20,23,7,0
191854,3,17,10,7,1,1
334524,2,14,14,0,13,1
129997,2,0,10,-10,8,0
170138,3,7,10,-3,8,0
371373,4,45,10,35,12,0
11865,4,41,17,24,6,0
325976,4,22,7,15,9,0
108119,3,13,35,-22,15,0
406950,2,3,13,-10,11,0
374403,2,15,0,15,14,0
42706,4,7,13,-6,3,1
276545,4,22,7,15,4,0
259595,2,0,3,-3,13,1
377270,3,14,3,11,15,0
15218,3,13,0,13,8,0
125042,4,3,19,-16,5,1
418483,4,24,6,18,16,0
125713,1,0,7,-7,5,1
10163,2,6,0,6,5,0
317984,3,10,10,0,5,1
368767,4,21,22,-1,11,0
149183,5,31,31,0,16,0
349718,2,14,7,7,2,1
372178,3,9,13,-4,13,0
25857,2,24,10,14,12,0
277517,2,3,7,-4,4,0
225848,4,24,24,0,16,1
28255,3,17,0,17,13,0
252754,2,3,3,0,11,0
405859,1,7,0,7,11,0
327937,1,0,0,0,10,1
19580,3,14,21,-7,10,1
382894,1,0,7,-7,17,1
377417,3,7,13,-6,15,1
12041,4,27,14,13,6,1
98720,2,21,3,18,11,1
51628,3,21,20,1,7,1
126079,3,20,3,17,6,1
367228,1,0,0,0,10,0
133935,3,6,6,0,9,0
174770,1,6,7,-1,10,1
4575,1,0,7,-7,2,1
268480,3,23,9,14,17,0
387947,1,3,0,3,2,0
257239,3,19,23,-4,12,1
226371,4,25,13,12,16,0
271784,4,30,10,20,2,1
146871,3,31,0,31,15,0
192000,3,17,20,-3,1,0
165869,4,6,19,-13,6,1
389483,2,13,0,13,3,0
319540,4,13,23,-10,6,1
237015,1,0,7,-7,3,1
175991,2,14,0,14,11,0
375063,4,28,30,-2,14,1
261566,3,12,9,3,14,0
113763,3,3,17,-14,17,0
296424,1,7,0,7,13,0
244822,3,7,3,4,7,0
364157,4,31,3,28,9,1
321098,1,0,3,-3,6,0
175561,3,20,0,20,11,0
91081,4,9,0,9,7,0
285967,3,29,14,15,8,1
278782,2,7,0,7,5,1
406566,4,20,36,-16,11,0
137029,1,7,0,7,11,0
296064,3,6,7,-1,13,1
55538,2,10,7,3,9,1
38059,2,3,0,3,1,1
83102,3,6,24,-18,4,0
51354,4,19,20,-1,7,0
375248,5,27,24,3,14,0
141813,2,10,14,-4,13,0
211364,3,10,10,0,9,1
248517,4,23,20,3,8,0
234464,2,17,12,5,2,0
89445,4,17,20,-3,7,1
362118,4,35,20,15,8,0
379494,4,23,3,20,16,1
322249,4,0,27,-27,7,1
214544,1,0,0,0,11,1
249311,1,3,0,3,9,0
63098,1,7,0,7,12,0
299791,5,17,17,0,14,1
323575,4,34,24,10,7,1
229374,1,3,0,3,17,0
176707,3,29,19,10,11,1
123621,2,0,0,0,4,0
147691,2,10,3,7,15,0
99923,2,10,3,7,12,0
180577,1,0,0,0,13,0
378141,2,21,6,15,15,0
253071,2,14,0,14,11,0
129677,1,0,3,-3,7,1
353002,4,23,10,13,3,0
406233,3,14,24,-10,11,1
82128,1,3,0,3,3,0
280526,2,7,0,7,5,0
4709,1,0,0,0,3,0
77548,3,20,14,6,1,1
181145,4,24,14,10,13,1
305602,4,20,10,10,17,1
312196,2,7,7,0,2,0
19315,3,14,17,-3,10,0
41400,4,14,15,-1,2,1
386829,3,13,14,-1,2,0
170434,3,21,3,18,8,0
305559,3,13,0,13,17,0
250154,2,17,0,17,9,0
337909,2,10,0,10,14,0
21873,3,21,0,21,11,0
164020,2,0,3,-3,5,1
234335,3,17,0,17,2,1
51643,3,27,20,7,7,1
89195,2,3,0,3,7,0
235909,4,10,14,-4,3,0
350713,2,7,0,7,2,1
75617,3,7,6,1,17,1
259322,3,13,20,-7,13,1
352465,4,38,27,11,3,1
87874,3,10,12,-2,6,1
25615,4,36,10,26,12,1
285603,3,20,10,10,8,0
199885,4,10,24,-14,4,1
402279,3,13,16,-3,9,0
3368,4,10,6,4,2,0
62657,4,17,20,-3,12,1
295953,4,13,27,-14,12,0
31019,2,3,6,-3,15,1
348719,3,24,10,14,2,1
350030,2,13,7,6,2,0
349027,3,14,10,4,2,1
162765,1,0,0,0,5,0
377394,2,7,13,-6,15,1
163056,1,0,0,0,5,1
24611,4,10,26,-16,12,1
91040,3,6,0,6,7,1
300766,3,10,13,-3,15,0
412106,4,31,3,28,13,1
279197,1,3,3,0,5,1
297424,4,30,24,6,13,1
377025,4,22,19,3,15,0
250287,2,7,0,7,9,1
353013,4,23,10,13,3,0
114178,2,0,0,0,1,1
354124,4,19,0,19,4,0
368967,2,7,7,0,11,0
222723,1,0,0,0,14,0
365555,2,14,14,0,9,0
35982,4,6,14,-8,17,0
225208,3,3,7,-4,15,1
119072,1,0,7,-7,3,1
156319,2,17,0,17,2,1
290732,4,47,25,22,10,0
354425,1,7,0,7,4,0
100560,4,20,20,0,12,0
144959,1,0,0,0,14,1
259020,3,3,16,-13,13,1
79751,3,20,7,13,2,1
349105,2,7,0,7,2,0
83053,2,6,14,-8,4,1
408144,2,3,0,3,12,1
365680,1,7,0,7,9,0
290061,3,7,6,1,10,1
242441,2,0,7,-7,6,0
150209,4,6,26,-20,16,1
203170,2,0,17,-17,5,1
201565,4,32,28,4,5,0
40012,2,14,7,7,1,1
172960,1,7,0,7,9,1
167000,2,0,13,-13,7,0
45028,3,13,10,3,4,1
301247,4,27,17,10,15,0
309378,2,0,0,0,1,1
174720,4,9,10,-1,10,1
290745,4,47,25,22,10,1
49160,1,3,0,3,6,1
31776,3,0,17,-17,15,0
415278,2,0,7,-7,15,1
311680,4,6,6,0,2,0
336716,2,3,3,0,14,1
273433,1,0,0,0,2,0
255998,3,19,12,7,12,0
390216,2,0,6,-6,3,0
368956,2,7,7,0,11,0
32095,3,14,13,1,15,1
421871,4,7,19,-12,17,1
77617,1,0,7,-7,1,1
131170,1,0,0,0,8,1
14142,2,0,14,-14,7,0
278565,1,0,0,0,4,1
261956,2,7,10,-3,14,1
284198,3,9,20,-11,7,0
396278,3,3,3,0,6,0
231097,1,0,0,0,1,1
363024,4,33,26,7,8,0
277590,3,12,14,-2,4,1
360607,3,7,10,-3,7,0
370491,3,20,9,11,12,1
348480,1,14,0,14,2,0
357916,4,13,34,-21,6,1
275169,3,14,16,-2,3,1
76958,3,17,13,4,1,1
397949,4,10,17,-7,7,0
127802,3,10,28,-18,6,1
387160,4,10,41,-31,2,0
253334,1,7,0,7,11,0
202145,3,13,3,10,5,1
74618,1,0,0,0,17,0
19129,2,13,3,10,10,1
325106,1,3,6,-3,8,0
375169,3,17,10,7,14,0
381897,4,35,36,-1,17,1
102844,4,17,10,7,13,0
359932,4,23,30,-7,6,1
80542,4,8,10,-2,3,0
176932,2,7,0,7,11,1
108481,1,7,7,0,15,1
223675,2,13,6,7,15,0
107968,4,6,13,-7,15,1
14894,2,7,7,0,7,1
86580,3,30,3,27,5,1
239610,4,20,10,10,4,0
84638,4,23,13,10,4,0
127534,4,3,23,-20,6,0
203166,2,0,10,-10,5,0
419924,4,16,18,-2,17,1
315973,3,0,21,-21,4,0
223006,4,13,23,-10,14,0
131869,3,24,7,17,8,1
44534,1,0,7,-7,3,1
420860,4,17,33,-16,17,0
320040,4,49,36,13,6,1
185849,2,3,3,0,15,0
365532,1,7,0,7,9,0
141358,2,3,17,-14,13,1
340642,2,16,3,13,15,0
72196,2,10,10,0,16,0
393069,2,6,3,3,4,1
346684,3,21,6,15,1,0
81320,4,17,14,3,3,1
378789,4,14,10,4,15,1
86903,4,17,26,-9,5,1
107041,2,17,0,17,15,1
57864,1,0,0,0,10,1
183094,2,7,3,4,14,1
323920,1,7,7,0,8,1
271893,2,7,13,-6,2,1
134600,2,24,10,14,10,0
412464,2,10,7,3,14,0
285393,2,10,0,10,8,1
301804,4,3,34,-31,15,1
278720,1,0,0,0,5,1
65201,4,3,10,-7,13,1
389972,3,28,25,3,3,1
348933,1,0,0,0,2,1
225793,3,10,14,-4,16,1
401750,4,24,14,10,8,1
264946,3,23,17,6,16,1
190085,2,17,3,14,17,0
97589,4,44,7,37,10,0
294237,3,13,14,-1,12,0
351841,3,27,14,13,3,0
335537,2,0,0,0,13,1
285725,1,0,3,-3,8,0
309644,1,0,0,0,1,0
51194,3,24,6,18,7,0
46813,4,14,33,-19,4,1
45555,1,0,13,-13,4,1
205372,3,27,0,27,6,0
289762,2,0,10,-10,10,1
67714,2,7,0,7,14,1
133067,4,15,14,1,9,0
20595,1,0,0,0,10,1
171528,4,17,10,7,9,1
99577,1,0,0,0,11,0
75497,4,31,7,24,17,0
90320,3,14,17,-3,7,0
401499,1,0,0,0,8,0
100606,1,0,0,0,12,0
285060,2,0,0,0,7,1
367649,1,0,3,-3,10,1
129810,1,7,0,7,7,1
275613,2,21,3,18,3,1
178165,2,0,7,-7,12,0
221134,3,0,6,-6,14,0
420666,3,21,16,5,17,0
73882,1,0,0,0,17,1
89751,4,16,23,-7,7,1
319932,2,23,7,16,6,0
182299,2,14,0,14,14,0
101251,3,7,7,0,12,0
348472,1,7,0,7,2,1
293457,1,0,0,0,11,0
42796,2,6,21,-15,3,0
30893,3,3,17,-14,15,0
237433,4,12,24,-12,3,1
418773,4,14,21,-7,16,0
11811,2,26,10,16,6,1
4871,1,14,0,14,3,0
303918,3,14,24,-10,16,1
339404,2,7,3,4,15,0
238892,4,41,21,20,4,1
59419,1,0,7,-7,11,1
318520,1,0,0,0,5,0
171020,2,10,10,0,8,1
374696,2,0,22,-22,14,0
132128,3,10,3,7,9,0
237525,3,24,7,17,3,1
385315,4,14,20,-6,1,1
236546,3,10,9,1,3,1
297363,2,6,10,-4,13,0
125034,3,3,12,-9,5,0
225880,1,7,0,7,16,1
124792,1,0,0,0,5,1
185630,4,20,27,-7,15,1
66525,4,31,24,7,14,1
171191,3,3,7,-4,8,1
148763,2,13,6,7,16,0
132836,2,3,7,-4,9,0
123546,4,13,10,3,4,1
67083,4,10,9,1,14,1
357336,1,0,0,0,5,0
359496,3,0,21,-21,6,1
113993,5,20,20,0,17,1
287808,3,21,10,11,9,0
87635,1,0,0,0,6,1
111700,3,31,13,18,16,0
66102,4,10,6,4,13,1
104907,2,3,3,0,14,1
328215,4,14,17,-3,10,1
255229,3,13,14,-1,12,1
18047,4,30,28,2,9,0
406322,1,0,7,-7,11,1
366859,3,3,6,-3,10,0
282387,3,10,20,-10,6,0
62502,4,13,16,-3,12,1
127968,4,23,20,3,6,1
47259,4,19,9,10,5,0
393437,4,28,24,4,5,1
369584,3,14,0,14,11,0
376953,2,3,13,-10,15,0
262426,2,7,7,0,15,0
31655,4,24,9,15,15,1
352572,3,27,20,7,3,1
47130,1,3,0,3,5,0
86679,2,10,0,10,5,0
42062,3,20,7,13,2,0
401207,1,0,0,0,8,0
35241,4,0,17,-17,16,1
321082,1,0,0,0,6,0
188245,2,14,7,7,16,0
44120,3,3,13,-10,3,1
206078,2,20,3,17,7,0
48897,3,12,0,12,5,0
293941,3,7,21,-14,12,0
38030,2,3,0,3,1,1
93486,4,3,28,-25,9,0
242356,4,27,13,14,6,1
101073,2,7,10,-3,12,1
214296,3,14,10,4,11,0
398105,4,24,28,-4,7,1
15011,1,0,13,-13,7,1
147313,4,7,31,-24,15,0
20526,3,3,0,3,10,1
394419,1,0,3,-3,5,0
16559,4,30,13,17,8,0
284692,4,17,34,-17,7,1
204324,4,0,17,-17,6,1
166377,1,3,0,3,6,0
402248,2,3,10,-7,9,1
75803,4,42,26,16,1,0
360777,3,24,24,0,7,0
146350,2,3,3,0,15,0
341379,3,0,10,-10,16,1
295762,4,23,16,7,12,1
213766,1,7,0,7,10,0
416716,1,0,0,0,15,0
126941,1,3,6,-3,6,0
284016,2,3,0,3,7,0
97057,2,19,3,16,10,0
331316,3,0,24,-24,11,0
56944,4,43,7,36,9,0
36932,2,0,25,-25,17,1
267149,4,10,10,0,17,1
389713,1,0,0,0,3,0
90171,3,3,0,3,7,0
92418,2,17,10,7,8,1
198168,3,10,3,7,3,1
315376,3,16,17,-1,4,0
44264,2,17,13,4,3,1
255128,1,0,0,0,12,1
415443,2,12,3,9,15,1
130863,4,20,15,5,8,1
417971,2,14,21,-7,16,0
8591,2,0,10,-10,4,1
376678,2,3,0,3,14,1
340842,4,24,19,5,15,1
204250,2,0,7,-7,6,0
34201,1,7,0,7,16,1
128288,1,0,0,0,7,0
203872,5,34,34,0,6,1
318581,2,10,7,3,5,0
207573,2,14,3,11,7,1
122899,4,31,6,25,4,1
124586,3,6,17,-11,5,1
378152,2,21,6,15,15,0
331252,1,0,0,0,11,0
172958,1,7,0,7,9,0
298330,1,0,0,0,14,1
83185,1,3,0,3,4,0
347953,3,0,21,-21,1,0
354263,4,23,17,6,4,0
406188,1,7,3,4,11,1
359036,3,10,3,7,6,1
374848,2,7,3,4,14,0
199939,1,3,10,-7,4,1
106590,2,31,0,31,14,1
379737,2,9,7,2,16,1
262485,3,13,35,-22,15,1
323752,1,6,0,6,8,0
360517,4,17,21,-4,7,1
236596,1,0,0,0,3,1
39824,1,3,0,3,1,0
73418,4,30,3,27,17,0
224801,3,11,10,1,15,1
382782,1,14,0,14,17,0
56634,4,26,17,9,9,0
181540,2,6,0,6,13,0
380639,2,7,7,0,16,1
263974,4,23,7,16,15,1
2635,1,0,0,0,2,1
62381,1,0,7,-7,12,0
112104,2,7,17,-10,17,1
232625,2,0,0,0,1,0
254033,3,7,13,-6,11,1
399767,2,0,24,-24,8,1
282753,1,0,0,0,6,0
216887,3,13,17,-4,12,1
275005,2,24,3,21,3,0
383805,2,3,7,-4,1,1
266146,1,0,0,0,16,1
217850,2,3,14,-11,12,1
234375,4,17,10,7,2,1
238447,1,0,0,0,4,1
339225,1,7,0,7,15,0
352523,2,14,6,8,3,0
171892,2,0,7,-7,9,1
55027,1,0,0,0,8,1
379364,4,10,16,-6,16,1
153591,3,12,14,-2,1,1
155691,2,10,13,-3,2,0
80098,4,24,22,2,2,1
218471,3,24,17,7,13,1
298275,3,20,13,7,14,0
216500,2,27,8,19,12,0
353116,3,10,29,-19,3,1
299927,4,16,11,5,14,1
102333,3,13,10,3,13,0
19198,4,21,19,2,10,1
23018,2,0,14,-14,11,1
284065,4,13,9,4,7,0
406923,1,0,6,-6,11,0
29191,4,3,26,-23,14,0
129117,3,27,28,-1,7,1
366149,3,7,35,-28,10,0
339021,4,20,3,17,15,0
11803,2,20,9,11,6,0
258516,1,0,0,0,13,1
243364,1,0,0,0,6,0
44226,1,7,10,-3,3,1
409460,4,34,3,31,12,1
59831,4,15,16,-1,11,0
7698,1,10,0,10,4,1
112651,4,45,41,4,17,0
287115,1,0,3,-3,8,1
333052,3,10,12,-2,12,1
53944,4,14,19,-5,8,1
261446,4,17,24,-7,14,0
158776,2,7,3,4,3,0
289967,4,6,9,-3,10,0
60582,4,30,41,-11,11,1
344286,4,14,13,1,17,1
261663,2,6,0,6,14,1
137808,1,0,6,-6,11,1
125194,3,31,7,24,5,0
370120,2,7,3,4,12,1
200115,2,7,17,-10,4,1
59839,4,15,16,-1,11,1
310353,4,29,0,29,2,1
161277,3,20,3,17,4,1
216668,2,14,6,8,12,1
320230,2,14,0,14,6,0
102261,1,7,0,7,13,0
172439,4,13,49,-36,9,1
83358,2,7,14,-7,4,0
19066,4,10,6,4,10,1
401552,2,14,14,0,8,1
195057,2,7,17,-10,2,1
317033,2,0,10,-10,4,1
212690,1,0,0,0,10,1
187185,1,0,0,0,16,1
309302,3,0,23,-23,1,1
410528,1,7,7,0,13,1
207162,3,14,10,4,7,0
260346,2,6,0,6,14,0
294114,4,14,27,-13,12,0
172057,2,7,3,4,9,1
80025,2,7,3,4,2,1
37824,4,14,9,5,1,1
254732,2,3,3,0,11,1
180633,2,10,6,4,13,1
89483,1,0,0,0,7,0
25428,3,13,10,3,12,1
86251,2,6,10,-4,5,0
331054,4,45,17,28,11,1
25230,1,7,0,7,12,0
147345,1,0,0,0,15,0
415233,1,0,0,0,15,0
420021,3,10,7,3,17,0
258803,1,7,7,0,13,1
385015,3,24,16,8,1,0
42469,2,0,5,-5,3,0
69934,1,6,0,6,15,1
58519,1,7,3,4,10,0
61192,1,0,0,0,11,0
173657,4,13,20,-7,10,0
349589,3,13,28,-15,2,0
175565,3,20,7,13,11,1
411990,1,0,0,0,13,0
371548,1,3,0,3,12,0
243313,4,14,10,4,6,0
122904,4,34,6,28,4,0
169295,1,0,0,0,8,1
87464,4,20,17,3,6,0
129415,3,16,13,3,7,1
270631,1,0,0,0,1,1
174706,4,9,7,2,10,1
421305,4,19,10,9,17,0
118325,4,26,7,19,2,1
253961,1,0,0,0,11,1
229806,1,0,0,0,17,0
135790,2,6,14,-8,10,1
6269,3,13,17,-4,3,0
293375,2,7,10,-3,11,1
179245,2,23,3,20,12,0
371368,4,42,10,32,12,1
362137,4,42,23,19,8,1
271397,1,7,0,7,1,1
377625,1,0,0,0,15,0
104612,2,7,3,4,14,1
83901,4,23,17,6,4,1
236661,2,10,0,10,3,0
283060,1,0,0,0,7,1
275042,3,31,17,14,3,1
354001,1,0,0,0,4,0
102155,2,14,7,7,13,1
276759,1,14,3,11,4,1
288971,2,16,7,9,9,1
62378,1,0,7,-7,12,0
189569,1,0,0,0,17,0
315404,3,16,23,-7,4,0
199689,2,21,7,14,4,1
406680,3,21,0,21,11,0
15124,4,10,26,-16,7,1
264221,1,3,7,-4,15,0
18350,4,25,20,5,9,1
293271,4,26,7,19,11,0
340730,1,0,0,0,15,0
328998,4,33,7,26,10,0
258549,2,0,0,0,13,0
121646,2,0,7,-7,4,0
227956,4,30,27,3,16,0
313700,1,7,3,4,3,1
140633,3,31,10,21,12,1
168170,3,19,12,7,7,1
241134,3,20,10,10,5,0
26660,1,0,0,0,13,0
212359,4,13,9,4,10,0
197770,4,21,17,4,3,1
8065,3,17,7,10,4,1
302804,2,9,13,-4,15,1
224312,3,9,12,-3,15,1
335300,3,3,9,-6,13,0
54756,2,3,0,3,8,1
140565,1,7,7,0,12,1
281229,4,27,16,11,6,0
242361,4,34,13,21,6,0
293308,1,0,0,0,11,0
341034,2,7,7,0,15,0
335405,1,6,3,3,13,1
148696,1,0,0,0,16,1
176333,2,16,14,2,11,0
193242,3,3,10,-7,1,0
293384,3,13,10,3,11,1
397598,3,6,20,-14,7,0
113632,3,9,13,-4,17,0
329376,3,16,34,-18,10,1
57022,2,7,10,-3,9,0
198288,2,6,7,-1,3,0
289822,4,17,17,0,10,0
226300,3,16,7,9,16,1
374302,3,14,13,1,13,0
144669,1,0,0,0,14,0
12558,3,3,17,-14,6,1
28910,1,0,0,0,14,1
246234,4,21,16,5,7,0
111536,3,21,10,11,16,0
8919,3,21,0,21,4,1
18901,4,9,13,-4,9,1
82666,4,12,10,2,3,0
407908,3,9,24,-15,11,1
307844,4,27,28,-1,1,1
250204,3,17,16,1,9,1
340042,3,14,12,2,15,1
384216,4,32,27,5,1,1
197424,2,13,3,10,3,0
260320,1,0,0,0,14,1
295087,2,7,0,7,12,0
117443,1,7,7,0,2,1
71737,2,10,20,-10,16,1
256971,4,39,30,9,12,0
213341,2,10,6,4,10,0
21671,2,3,7,-4,11,1
121989,3,16,7,9,4,1
333193,2,0,7,-7,12,1
45960,4,17,3,14,4,1
290624,1,20,0,20,10,1
238679,3,16,17,-1,4,1
188824,1,0,0,0,16,1
385646,4,16,24,-8,1,0
391809,1,3,0,3,4,0
419007,2,7,14,-7,16,0
78273,2,0,14,-14,2,1
23947,3,16,0,16,12,0
119406,2,0,14,-14,3,0
35648,3,20,3,17,17,0
29107,2,0,6,-6,14,1
419021,3,7,17,-10,16,1
91796,2,10,0,10,8,1
110695,1,0,3,-3,16,1
179691,1,0,0,0,12,0
390170,4,20,38,-18,3,0
194247,1,0,0,0,2,0
306409,1,0,10,-10,17,1
221151,3,0,17,-17,14,1
36223,3,10,17,-7,17,0
416210,3,10,25,-15,15,1
155955,1,0,7,-7,2,1
254556,1,0,0,0,11,0
43533,3,10,3,7,3,1
173240,4,20,24,-4,9,0
217951,1,0,0,0,12,1
58961,4,20,32,-12,10,1
109299,3,13,3,10,15,0
110169,3,20,23,-3,16,1
198630,2,3,14,-11,3,1
219275,1,7,0,7,13,1
221202,1,0,0,0,14,0
215659,4,14,6,8,11,1
174782,2,6,7,-1,10,1
252066,4,14,29,-15,10,0
331099,1,0,6,-6,11,1
143410,4,7,26,-19,14,1
153699,2,2,14,-12,1,0
179258,3,26,3,23,12,0
6813,2,3,21,-18,3,1
65961,4,24,21,3,13,0
182802,3,19,10,9,14,1
374450,3,32,0,32,14,0
379596,3,16,13,3,16,1
171021,2,10,10,0,8,0
15790,3,0,12,-12,8,1
408541,4,10,13,-3,12,0
81488,1,0,7,-7,3,0
156341,3,24,0,24,2,0
78987,2,3,7,-4,2,1
256330,4,21,17,4,12,0
297996,4,30,7,23,13,1
337054,3,19,0,19,14,1
238639,2,6,7,-1,4,1
275064,4,34,20,14,3,0
269100,4,13,16,-3,17,1
108860,4,7,17,-10,15,0
408923,2,17,9,8,12,0
50751,4,21,14,7,6,0
369278,2,14,14,0,11,1
22998,2,0,7,-7,11,0
305167,4,27,10,17,16,0
115558,2,10,3,7,1,1
1583,4,16,19,-3,1,0
301905,2,8,13,-5,15,1
342726,2,0,7,-7,16,0
164581,1,0,3,-3,5,1
72238,4,24,17,7,16,1
313473,4,17,14,3,3,0
186621,2,24,3,21,15,0
30363,4,10,20,-10,14,1
307533,4,38,19,19,17,1
21596,3,7,31,-24,11,1
112873,2,10,3,7,17,0
356750,4,29,31,-2,5,1
319493,3,3,10,-7,6,0
144946,4,20,7,13,14,0
130,4,7,10,-3,1,1
205146,2,7,7,0,6,1
6229,2,13,0,13,3,0
366737,3,24,10,14,10,1
251306,4,13,37,-24,10,1
409765,4,13,9,4,12,1
379247,1,0,0,0,16,0
176149,2,14,7,7,11,1
45365,4,20,16,4,4,0
397212,4,13,0,13,6,1
190922,1,6,0,6,17,1
333535,3,16,3,13,12,0
270855,3,9,13,-4,1,1
348507,2,21,7,14,2,1
80174,2,7,10,-3,2,0
397447,2,7,13,-6,6,1
365526,1,0,0,0,9,1
420821,3,10,10,0,17,1
153437,3,20,17,3,1,0
141983,3,10,14,-4,13,0
366833,2,0,3,-3,10,1
250103,1,0,0,0,9,1
288523,2,3,21,-18,9,1
181438,3,24,24,0,13,1
299677,2,14,0,14,14,0
416030,3,7,3,4,15,1
104817,4,27,33,-6,14,1
117512,3,14,17,-3,2,1
2193,1,0,0,0,1,1
246472,2,9,0,9,8,1
150857,2,0,7,-7,17,1
203895,5,37,37,0,6,1
366698,2,17,10,7,10,1
239498,1,0,0,0,4,0
67043,3,10,3,7,14,0
8122,4,27,20,7,4,0
187324,1,7,0,7,16,1
324861,2,10,10,0,8,1
421856,3,7,13,-6,17,0
358742,3,14,17,-3,6,0
82045,3,17,7,10,3,0
93257,1,7,0,7,9,0
218784,4,3,16,-13,13,0
339194,4,30,13,17,15,0
161882,2,13,9,4,4,0
152496,2,17,7,10,17,1
67957,4,29,6,23,14,0
137017,1,6,0,6,11,1
380931,2,6,7,-1,16,1
405425,2,14,10,4,10,1
186115,1,0,0,0,15,1
352283,3,3,6,-3,3,1
15830,4,8,12,-4,8,1
273002,2,3,3,0,2,1
171512,3,17,10,7,9,0
57517,3,21,10,11,10,0
250368,4,21,20,1,9,0
106082,1,0,0,0,14,0
247169,4,20,6,14,8,0
321466,3,21,27,-6,7,0
15258,4,23,7,16,8,0
6447,4,15,20,-5,3,1
234059,3,20,0,20,2,0
403324,3,9,0,9,9,0
243055,2,0,9,-9,6,1
315858,4,9,19,-10,4,1
10821,3,21,7,14,5,1
325356,4,12,20,-8,8,1
354962,2,7,9,-2,4,0
229334,4,24,34,-10,17,1
368077,1,7,0,7,11,0
14129,1,0,14,-14,7,0
11421,4,26,0,26,6,1
283163,3,13,9,4,7,1
387,3,28,10,18,1,0
139365,1,7,0,7,12,1
255129,1,0,0,0,12,1
203700,4,20,30,-10,6,1
205560,4,14,24,-10,6,0
269115,4,16,16,0,17,1
4157,1,0,3,-3,2,1
223573,4,17,13,4,15,1
258811,2,7,7,0,13,0
259675,4,16,16,0,13,0
132893,4,6,21,-15,9,1
144058,1,7,0,7,14,1
368494,1,0,0,0,11,0
358574,2,10,9,1,6,1
418384,1,14,0,14,16,1
409537,3,14,3,11,12,0
235895,3,7,14,-7,3,1
172498,1,0,0,0,9,0
280818,2,7,0,7,6,1
377996,2,0,7,-7,15,1
206780,4,14,27,-13,7,1
174659,2,9,0,9,10,1
217500,4,19,3,16,12,1
177239,2,7,10,-3,11,1
7283,4,17,13,4,4,1
198347,3,20,14,6,3,0
347119,2,13,3,10,1,1
249082,3,21,17,4,9,0
21406,2,6,7,-1,11,1
419081,4,13,27,-14,16,1
117245,4,30,17,13,2,0
56564,2,16,14,2,9,0
324019,4,20,22,-2,8,0
222369,3,24,3,21,14,0
48113,2,7,3,4,5,0
131156,4,27,12,15,8,0
284824,4,29,20,9,7,0
334112,2,16,0,16,13,0
53888,2,7,10,-3,8,0
176943,2,10,3,7,11,1
375073,4,28,30,-2,14,0
419113,1,9,0,9,16,1
326351,3,14,10,4,9,1
17301,1,0,0,0,9,1
208034,3,21,0,21,8,0
369957,1,7,0,7,12,1
248057,4,34,13,21,8,0
278741,1,0,0,0,5,0
375193,4,17,17,0,14,1
208065,4,21,13,8,8,0
133064,4,15,14,1,9,0
341182,2,10,0,10,16,0
108708,3,34,13,21,15,1
222119,1,0,0,0,14,0
257495,2,9,3,6,13,0
417412,4,24,17,7,16,0
309578,3,16,0,16,1,0
92879,3,24,0,24,8,1
6491,2,0,0,0,3,1
150549,1,3,3,0,17,0
85108,1,0,0,0,4,0
215792,3,32,6,26,11,1
212062,4,17,40,-23,9,1
284701,4,17,34,-17,7,0
142150,3,2,7,-5,13,0
103961,3,3,10,-7,13,1
264641,5,20,20,0,16,1
102325,3,13,10,3,13,1
254265,2,6,9,-3,11,1
281120,1,0,0,0,6,0
110885,2,7,0,7,16,0
274084,3,10,0,10,3,1
196126,3,22,21,1,2,1
160989,3,10,7,3,4,0
213562,4,10,14,-4,10,1
257396,3,20,14,6,13,1
147553,2,6,0,6,15,1
293051,2,10,13,-3,11,0
75876,2,14,7,7,1,1
177904,4,21,23,-2,12,1
406447,1,0,0,0,11,0
149266,3,10,20,-10,16,1
150230,4,6,26,-20,16,1
71512,4,33,14,19,16,1
382019,4,7,30,-23,17,0
377886,3,20,10,10,15,0
351024,2,7,7,0,3,0
236390,4,14,23,-9,3,1
294351,2,10,3,7,12,1
403551,1,7,0,7,9,1
205761,1,7,0,7,7,1
227148,2,7,7,0,16,1
354813,3,20,28,-8,4,0
85638,2,17,0,17,5,1
378653,4,23,23,0,15,1
250005,2,7,6,1,9,1
298321,1,0,0,0,14,0
7516,4,29,6,23,4,1
329754,1,10,0,10,11,1
24336,1,3,0,3,12,0
240184,3,16,6,10,5,1
198018,3,0,30,-30,3,1
176225,4,14,24,-10,11,0
240765,2,7,7,0,5,1
14935,3,14,24,-10,7,1
328481,3,6,3,3,10,0
365724,2,10,3,7,9,0
407895,3,9,16,-7,11,0
55625,1,0,0,0,9,0
297172,1,0,0,0,13,0
247128,3,20,6,14,8,0
233617,3,23,41,-18,2,0
336364,1,0,0,0,14,0
94888,4,13,13,0,9,0
284996,4,16,27,-11,7,1
342148,3,15,16,-1,16,0
11016,4,9,31,-22,5,1
387878,3,10,28,-18,2,0
337712,4,31,24,7,14,0
357188,4,12,27,-15,5,1
297870,4,21,27,-6,13,1
138649,3,3,28,-25,12,1
116713,2,6,10,-4,2,0
28722,4,10,13,-3,14,1
324646,1,0,0,0,8,0
320964,1,7,0,7,6,0
16480,2,10,0,10,8,1
138185,2,7,9,-2,11,1
100950,2,10,10,0,12,1
348541,3,28,14,14,2,1
339932,4,33,0,33,15,0
41804,3,13,14,-1,2,0
69429,3,24,3,21,15,0
417702,4,28,12,16,16,1
343062,3,9,13,-4,16,1
168416,2,0,3,-3,7,0
130562,4,13,13,0,8,1
211968,2,0,10,-10,9,1
381577,4,35,16,19,17,1
247815,1,0,0,0,8,0
150467,3,27,6,21,16,0
302093,3,20,24,-4,15,0
295625,1,0,0,0,12,1
157548,2,0,0,0,2,1
117596,1,0,7,-7,2,1
278932,2,7,23,-16,5,0
348962,2,14,0,14,2,0
394129,1,7,7,0,5,0
256187,4,30,22,8,12,0
253588,3,6,10,-4,11,1
239220,1,0,0,0,4,0
351890,4,27,14,13,3,1
359084,4,19,13,6,6,0
167180,2,16,7,9,7,0
299162,3,10,16,-6,14,0
388885,2,10,14,-4,3,1
1548,3,6,13,-7,1,1
243569,2,10,7,3,6,1
59488,3,6,20,-14,11,0
64453,2,14,13,1,13,0
91342,3,14,7,7,8,0
192315,3,27,10,17,1,0
421749,4,31,17,14,17,0
320988,2,7,0,7,6,0
26609,3,10,6,4,13,0
297339,2,3,10,-7,13,1
168975,1,0,7,-7,7,1
179521,2,0,16,-16,12,0
191705,3,10,17,-7,17,1
121542,3,16,7,9,4,0
407888,3,9,10,-1,11,0
167190,2,23,7,16,7,0
80065,3,17,12,5,2,0
133470,3,20,17,3,9,1
190705,4,42,17,25,17,0
210381,1,0,0,0,9,0
226688,1,7,3,4,16,1
372111,1,3,7,-4,13,0
30552,2,10,0,10,14,0
287950,3,14,13,1,9,1
42747,1,3,0,3,3,0
265059,2,10,3,7,16,1
66032,2,7,0,7,13,1
317552,4,10,27,-17,5,1
272985,2,3,3,0,2,0
158399,4,16,20,-4,3,1
203031,2,17,3,14,5,1
193167,1,0,0,0,1,1
188880,2,10,7,3,16,0
120101,2,3,0,3,3,1
68032,2,0,10,-10,14,1
333599,4,24,23,1,12,0
155596,4,23,17,6,2,1
361225,3,7,17,-10,7,0
243053,2,0,9,-9,6,1
369948,1,6,0,6,12,1
393561,2,7,9,-2,5,0
399808,4,11,24,-13,8,0
178704,4,3,20,-17,12,0
178473,2,10,3,7,12,0
303977,4,20,34,-14,16,1
255859,4,20,7,13,12,1
245327,4,22,13,9,7,1
206834,2,0,7,-7,7,0
123155,2,3,14,-11,4,1
52862,3,14,51,-37,7,0
268087,1,0,0,0,17,0
388995,4,24,27,-3,3,1
133825,4,19,17,2,9,0
273978,4,7,28,-21,2,0
107938,3,6,3,3,15,0
146796,2,10,0,10,15,1
254907,2,17,7,10,12,1
283732,2,8,3,5,7,0
216794,1,0,0,0,12,0
373372,3,10,7,3,13,0
269361,2,7,14,-7,1,0
231586,2,7,3,4,1,1
376109,3,0,9,-9,14,1
121930,1,3,7,-4,4,0
230437,3,21,3,18,1,0
144798,4,10,17,-7,14,1
359288,2,3,13,-10,6,1
96437,2,10,14,-4,10,1
68921,1,0,0,0,15,0
135286,4,31,17,14,10,1
141490,2,7,0,7,13,0
369505,1,3,0,3,11,0
308617,4,21,16,5,1,0
388678,4,20,7,13,3,1
177776,4,13,17,-4,12,0
264280,3,10,17,-7,15,0
35071,4,15,16,-1,16,0
393374,2,21,7,14,5,0
78168,3,20,3,17,2,1
363966,2,3,9,-6,8,1
32289,4,30,28,2,15,0
83448,4,10,23,-13,4,1
318109,2,9,7,2,5,1
371474,3,14,17,-3,12,0
74172,1,3,0,3,17,1
420225,4,3,10,-7,17,0
339363,1,0,3,-3,15,0
405778,4,10,21,-11,10,0
158388,4,16,17,-1,3,0
68655,2,7,0,7,15,1
176733,4,39,19,20,11,0
150418,1,14,0,14,16,0
379404,1,0,0,0,16,1
279360,2,0,7,-7,5,0
15518,3,23,6,17,8,0
407140,3,10,20,-10,11,0
21487,4,15,17,-2,11,1
61952,2,0,0,0,12,0
266767,2,0,14,-14,16,0
403643,4,30,20,10,9,0
256229,2,6,7,-1,12,0
267445,4,20,24,-4,17,1
206256,3,7,6,1,7,0
182953,3,10,37,-27,14,0
224618,3,9,10,-1,15,0
382830,3,21,3,18,17,0
323806,2,12,9,3,8,1
238743,1,0,0,0,4,1
305248,2,14,21,-7,16,1
136849,1,0,0,0,11,1
214646,4,3,16,-13,11,1
145505,4,23,17,6,14,0
304530,4,10,14,-4,16,0
131104,3,20,6,14,8,0
377586,4,17,12,5,15,1
296420,1,7,0,7,13,1
378047,3,0,14,-14,15,0
393725,3,0,7,-7,5,1
158553,4,10,17,-7,3,1
326275,4,17,51,-34,9,0
112600,3,31,26,5,17,0
338953,2,6,0,6,15,1
141151,1,3,7,-4,13,0
249136,4,28,28,0,9,0
349619,4,13,28,-15,2,0
388837,4,21,17,4,3,0
295799,5,27,24,3,12,0
216710,3,24,6,18,12,1
320886,3,3,14,-11,6,0
131576,4,9,23,-14,8,0
225201,2,3,7,-4,15,1
66916,3,12,7,5,14,1
20228,4,24,10,14,10,1
257105,4,14,21,-7,12,1
261462,1,0,0,0,14,1
19229,4,28,19,9,10,0
364554,2,9,21,-12,9,1
408555,1,0,0,0,12,1
222669,3,14,24,-10,14,1
417894,4,13,10,3,16,0
122686,2,7,3,4,4,0
206254,3,7,6,1,7,1
13843,1,0,0,0,7,0
138310,2,20,0,20,11,1
129995,2,0,10,-10,8,0
380408,3,10,24,-14,16,1
271696,1,6,3,3,2,1
316411,2,13,3,10,4,0
307713,4,24,31,-7,17,0
409809,2,10,0,10,12,0
148979,3,13,12,1,16,0
27788,3,14,14,0,13,1
202274,2,3,0,3,5,1
72839,4,31,17,14,16,1
217826,1,3,7,-4,12,0
268895,2,6,30,-24,17,1
408087,4,20,17,3,12,0
1934,2,0,0,0,1,1
247736,3,7,6,1,8,1
249958,1,0,0,0,9,0
106100,1,0,0,0,14,0
173269,1,7,3,4,10,0
298663,2,6,7,-1,14,1
25038,4,16,24,-8,12,1
323550,4,31,17,14,7,0
110974,4,7,20,-13,16,1
69003,3,21,14,7,15,0
307340,3,14,19,-5,17,1
206205,2,0,3,-3,7,1
59521,4,13,20,-7,11,0
63780,3,14,24,-10,12,1
330673,3,6,3,3,11,1
217265,2,0,0,0,12,0
210843,1,0,0,0,9,1
365476,4,10,19,-9,9,1
50596,3,3,6,-3,6,1
91615,2,14,7,7,8,0
343500,3,7,10,-3,16,0
240502,3,3,7,-4,5,1
394525,4,10,25,-15,5,0
69616,4,7,17,-10,15,1
31528,4,3,17,-14,15,1
242272,1,6,7,-1,6,1
321787,4,18,9,9,7,1
199341,2,0,0,0,4,0
414736,3,3,17,-14,14,1
356910,1,3,0,3,5,1
14281,2,0,7,-7,7,0
25552,2,17,7,10,12,0
61367,2,7,0,7,11,0
354639,2,10,7,3,4,1
293631,2,7,7,0,12,0
142061,1,0,0,0,13,1
63027,3,16,21,-5,12,0
106536,1,7,0,7,14,0
418332,4,9,21,-12,16,0
133057,4,12,14,-2,9,1
159454,4,20,23,-3,3,0
201323,3,28,13,15,5,1
322108,4,26,0,26,7,1
281426,1,0,10,-10,6,1
7280,3,14,13,1,4,1
364201,1,0,0,0,9,0
364811,1,3,6,-3,9,0
281056,3,24,13,11,6,0
389180,2,13,0,13,3,1
7259,3,7,13,-6,4,1
201896,1,0,0,0,5,0
344149,3,27,3,24,17,0
144577,3,7,19,-12,14,1
35751,2,3,0,3,17,1
172196,2,0,6,-6,9,1
413821,2,14,0,14,14,1
216344,2,7,13,-6,12,1
96851,1,10,0,10,10,1
202359,4,20,13,7,5,0
228,3,12,10,2,1,0
334921,4,30,10,20,13,0
193979,1,14,0,14,1,0
118507,2,14,0,14,2,1
207679,1,0,0,0,7,0
324590,3,16,9,7,8,0
395941,2,24,9,15,6,0
190870,4,27,17,10,17,0
216759,4,27,9,18,12,1
210877,2,7,3,4,9,1
356224,4,29,7,22,5,1
145220,4,49,0,49,14,1
388081,1,0,0,0,2,1
260985,4,10,3,7,14,1
238045,4,13,13,0,4,1
304938,2,7,3,4,16,1
308454,4,7,25,-18,1,1
336574,3,7,0,7,14,1
156744,1,7,7,0,2,0
129232,3,14,6,8,7,0
328085,1,0,0,0,10,0
375969,3,20,12,8,14,1
75286,3,7,23,-16,17,1
398173,2,7,3,4,7,0
247084,2,2,3,-1,8,0
91263,1,7,0,7,8,0
36886,1,0,0,0,17,0
363022,4,33,26,7,8,1
281001,2,14,13,1,6,1
322045,2,13,0,13,7,0
37501,2,7,7,0,17,0
95945,1,0,0,0,10,0
337874,1,3,0,3,14,1
227317,3,13,27,-14,16,1
399192,2,10,13,-3,7,1
418633,4,21,31,-10,16,1
359112,1,7,0,7,6,0
128126,4,13,6,7,7,0
255000,1,0,9,-9,12,1
157114,3,13,14,-1,2,0
313138,2,7,10,-3,3,0
294324,2,10,3,7,12,1
221226,1,0,16,-16,14,1
83350,2,0,14,-14,4,1
261402,3,10,17,-7,14,0
149689,2,20,0,20,16,1
398609,2,0,0,0,7,1
299350,4,28,16,12,14,1
167860,2,7,16,-9,7,1
35660,3,23,3,20,17,0
25647,1,7,0,7,12,0
250325,2,7,7,0,9,0
193534,2,0,0,0,1,0
226836,1,0,0,0,16,0
287101,1,0,0,0,8,1
177056,1,3,0,3,11,0
243416,2,3,17,-14,6,1
298844,3,21,9,12,14,0
68954,2,14,7,7,15,1
208267,1,0,7,-7,8,0
271387,1,0,0,0,1,1
298644,2,3,0,3,14,1
113849,1,0,0,0,17,1
57805,3,19,10,9,10,0
19327,3,14,17,-3,10,1
282309,4,34,17,17,6,1
302843,4,12,23,-11,15,0
242844,1,7,0,7,6,0
100772,2,6,3,3,12,0
26668,1,0,0,0,13,0
402736,3,17,0,17,9,0
342035,4,20,3,17,16,0
119786,3,17,6,11,3,0
106652,4,46,9,37,14,0
323384,3,17,0,17,7,1
175229,2,12,0,12,10,0
10620,2,6,10,-4,5,1
332827,1,0,0,0,12,1
295093,2,7,7,0,12,0
248907,2,17,0,17,9,0
49415,4,17,20,-3,6,1
392694,4,16,0,16,4,1
317474,2,10,10,0,5,1
43386,4,21,17,4,3,0
39762,4,9,7,2,1,0
287715,5,16,16,0,9,0
60570,4,30,41,-11,11,1
182092,1,0,0,0,13,1
373294,4,16,30,-14,13,1
214614,3,3,16,-13,11,1
363919,1,0,0,0,8,0
261396,3,10,17,-7,14,1
310628,3,13,30,-17,2,1
207935,4,35,21,14,8,1
322347,2,14,7,7,7,1
110839,5,13,13,0,16,0
302508,3,3,10,-7,15,1
8343,2,16,3,13,4,1
405761,3,10,14,-4,10,1
94424,1,0,0,0,9,0
109021,3,16,34,-18,15,1
219782,2,28,0,28,13,1
7411,2,6,3,3,4,1
238303,1,0,9,-9,4,1
78000,3,9,16,-7,1,0
395155,1,3,0,3,5,0
210128,2,0,0,0,9,1
34320,4,23,9,14,16,1
289578,2,7,13,-6,10,0
257806,2,7,0,7,13,0
237377,3,12,14,-2,3,0
260755,1,3,3,0,14,0
104436,1,0,7,-7,13,0
65880,2,7,7,0,13,0
82144,2,3,3,0,3,1
373630,1,0,3,-3,13,1
60542,3,30,27,3,11,1
285405,2,24,0,24,8,0
51688,1,0,0,0,7,0
80373,3,26,9,17,2,1
221935,4,19,19,0,14,0
8029,2,10,7,3,4,0
396016,4,38,20,18,6,0
63541,1,7,0,7,12,0
213075,3,17,3,14,10,0
389141,4,30,14,16,3,0
39200,1,0,0,0,1,0
120086,2,3,0,3,3,0
408948,3,24,15,9,12,0
80737,1,0,0,0,3,1
394083,4,16,23,-7,5,0
407939,4,17,24,-7,11,1
194649,3,24,7,17,2,1
182977,4,10,44,-34,14,1
312846,3,7,0,7,3,1
319102,1,0,0,0,5,0
1589,4,16,20,-4,1,1
362166,1,3,0,3,8,0
340299,1,9,0,9,15,1
325560,1,0,0,0,9,1
67944,4,22,3,19,14,0
59720,1,6,0,6,11,0
344115,2,17,3,14,17,1
386365,2,17,6,11,2,0
403513,4,24,19,5,9,1
412153,1,7,3,4,13,0
404297,2,0,3,-3,10,0
31117,1,0,3,-3,15,0
397466,3,13,16,-3,6,1
266926,2,13,0,13,17,1
161703,1,10,0,10,4,0
117819,3,9,6,3,2,0
37305,1,7,0,7,17,1
65138,2,0,0,0,13,0
135336,1,7,10,-3,10,1
298017,4,37,7,30,13,1
3250,1,3,0,3,2,0
104243,2,3,0,3,13,1
361240,3,14,20,-6,7,0
276222,3,24,10,14,3,0
147806,1,0,7,-7,15,0
77313,1,0,0,0,1,1
223203,2,3,3,0,15,0
170507,4,21,18,3,8,1
215026,2,13,0,13,11,1
338424,4,30,23,7,14,0
205365,3,20,0,20,6,1
170597,3,34,6,28,8,0
307732,1,7,0,7,1,1
222376,4,24,3,21,14,0
174093,4,8,36,-28,10,1
112956,1,0,0,0,17,1
82445,2,0,7,-7,3,0
140304,2,14,12,2,12,0
228008,1,0,0,0,17,1
307633,2,14,7,7,17,0
42851,4,6,37,-31,3,1
217262,1,0,0,0,12,0
77432,4,27,21,6,1,0
200312,3,27,14,13,4,1
49329,2,7,10,-3,6,0
101269,3,10,7,3,12,1
195434,4,24,10,14,2,0
191660,2,0,10,-10,17,1
193444,3,23,20,3,1,0
163249,2,3,6,-3,5,1
335672,1,7,0,7,13,0
336018,3,13,25,-12,13,1
341063,2,7,17,-10,15,0
203777,2,14,10,4,6,1
144682,2,0,0,0,14,0
32555,3,20,13,7,15,1
383057,2,17,7,10,17,0
80541,4,8,10,-2,3,0
401182,4,51,13,38,8,1
268185,4,9,17,-8,17,1
297773,1,7,0,7,13,0
106054,4,24,3,21,14,1
105779,1,0,0,0,14,0
41043,3,3,13,-10,2,1
307586,1,0,0,0,17,1
77751,1,0,0,0,1,1
210727,2,14,0,14,9,0
197835,1,6,0,6,3,0
2649,2,3,0,3,2,0
52365,2,3,17,-14,7,1
162853,3,6,3,3,5,1
254828,4,20,13,7,11,0
381930,1,0,7,-7,17,0
373798,1,6,0,6,13,1
147625,4,15,0,15,15,1
210947,4,26,16,10,9,0
22810,4,13,21,-8,11,1
62704,1,0,0,0,12,1
57232,4,20,14,6,10,1
121478,2,6,0,6,4,0
105007,1,0,0,0,14,0
286833,1,3,7,-4,8,0
390038,1,0,0,0,3,1
408428,1,0,0,0,12,1
236537,3,10,9,1,3,1
421399,3,16,20,-4,17,1
364792,1,0,0,0,9,0
228699,3,19,23,-4,17,0
138987,3,14,9,5,12,1
227321,3,13,27,-14,16,1
415349,4,14,21,-7,15,0
328291,2,3,7,-4,10,0
145023,3,6,3,3,14,1
239840,2,7,0,7,4,0
175630,1,0,0,0,11,0
275221,4,17,29,-12,3,1
232722,1,0,0,0,2,0
241389,2,7,21,-14,5,1
334657,2,2,0,2,13,0
240973,4,21,16,5,5,1
218316,3,17,14,3,12,0
35437,1,7,0,7,17,0
15861,1,0,0,0,8,0
322396,4,17,19,-2,7,1
3729,2,10,3,7,2,1
163788,4,16,12,4,5,1
377002,4,15,16,-1,15,0
147710,3,10,10,0,15,1
346625,1,7,3,4,1,1
292965,4,10,7,3,11,1
171284,2,0,3,-3,9,1
62685,1,0,0,0,12,0
387265,3,6,10,-4,2,1
87547,2,17,3,14,6,0
31934,3,6,13,-7,15,1
339195,4,30,13,17,15,0
73373,3,20,3,17,17,0
92017,4,27,26,1,8,1
83968,2,14,0,14,4,0
65599,2,6,6,0,13,0
410254,2,7,7,0,13,1
342166,4,15,19,-4,16,1
16848,4,26,38,-12,8,1
21797,1,0,0,0,11,0
13712,2,0,14,-14,7,0
275431,2,13,10,3,3,1
111490,2,7,0,7,16,1
382320,4,20,3,17,17,1
282465,1,0,0,0,6,1
393146,4,24,3,21,4,1
245588,3,40,0,40,7,0
217782,4,10,13,-3,12,0
280234,1,3,7,-4,5,1
109301,3,13,3,10,15,0
157619,4,19,3,16,2,1
94470,2,0,0,0,9,1
198337,3,13,14,-1,3,1
151900,2,13,6,7,17,0
181984,2,13,0,13,13,1
275053,4,34,17,17,3,0
38545,3,24,6,18,1,0
192771,2,0,9,-9,1,0
302321,2,7,3,4,15,0
378947,4,22,30,-8,15,1
139883,4,23,24,-1,12,1
264900,2,17,14,3,16,0
391924,4,23,27,-4,4,0
17002,4,34,23,11,8,1
332830,1,0,0,0,12,1
115754,4,13,13,0,1,0
102230,4,30,14,16,13,0
152092,3,6,10,-4,17,1
289440,2,0,0,0,10,1
61402,2,13,3,10,11,1
309663,1,0,3,-3,1,1
118064,1,0,6,-6,2,1
309794,1,0,0,0,1,1
80186,2,14,10,4,2,0
37272,4,13,21,-8,17,0
417387,3,13,17,-4,16,1
324200,1,0,0,0,8,1
233462,3,23,10,13,2,0
349802,5,29,29,0,2,0
59037,2,3,10,-7,10,1
345904,3,10,23,-13,17,1
179575,3,7,23,-16,12,0
134707,1,0,0,0,10,1
210539,1,0,0,0,9,0
23581,1,7,0,7,12,0
53134,3,19,38,-19,7,0
50338,4,13,23,-10,6,1
32504,2,14,3,11,15,0
128898,1,2,3,-1,7,1
401385,2,17,0,17,8,0
164982,4,17,19,-2,6,0
409064,2,3,7,-4,12,0
212570,1,7,10,-3,10,1
315938,2,0,7,-7,4,1
263801,3,6,24,-18,15,1
398563,4,30,23,7,7,0
315094,4,37,14,23,4,1
219749,1,14,0,14,13,0
164674,4,21,27,-6,5,0
293164,1,6,0,6,11,0
409771,1,0,0,0,12,0
272414,3,31,3,28,2,0
152481,2,10,7,3,17,1
395293,1,0,0,0,5,0
383854,3,3,7,-4,1,0
391009,3,20,27,-7,4,0
331111,1,6,6,0,11,1
362986,3,27,16,11,8,1
103208,2,3,0,3,13,0
336768,3,10,10,0,14,0
229700,2,13,7,6,17,0
177698,2,13,14,-1,12,1
222280,1,0,0,0,14,1
169780,2,0,14,-14,8,1
8940,3,28,7,21,4,1
151056,3,10,10,0,17,1
337438,1,0,6,-6,14,1
391831,2,10,3,7,4,1
342487,4,27,3,24,16,0
388005,3,6,3,3,2,1
279287,4,19,16,3,5,1
36277,4,24,27,-3,17,0
143668,3,19,10,9,14,1
287669,4,9,10,-1,9,1
76247,4,12,27,-15,1,1
172465,4,13,49,-36,9,1
147952,4,34,41,-7,15,0
396081,2,17,3,14,6,0
244686,3,14,23,-9,7,1
13336,3,7,27,-20,7,1
2031,1,0,0,0,1,1
48927,4,15,13,2,5,0
212005,3,3,16,-13,9,0
303776,3,20,10,10,16,0
152503,3,17,7,10,17,0
334201,1,0,0,0,13,1
293338,1,7,0,7,11,0
279062,1,13,0,13,5,1
152646,2,7,6,1,17,0
188168,4,17,10,7,16,0
37607,1,7,0,7,17,1
147456,4,23,10,13,15,0
265557,1,0,0,0,16,0
150404,1,7,0,7,16,1
182712,4,14,26,-12,14,1
231154,2,10,0,10,1,0
76832,4,33,0,33,1,0
146321,1,0,3,-3,15,1
181354,1,14,0,14,13,0
68705,3,24,0,24,15,1
150529,1,0,0,0,17,1
125123,2,7,7,0,5,1
237204,2,3,0,3,3,0
232040,2,0,17,-17,1,0
53526,2,7,6,1,8,1
298394,3,7,14,-7,14,1
267274,3,17,14,3,17,0
208025,3,21,0,21,8,0
262817,1,0,0,0,15,0
416843,4,22,17,5,15,0
148024,2,7,3,4,15,0
163094,2,13,12,1,5,0
131688,2,10,22,-12,8,1
120797,4,26,6,20,3,0
95137,3,9,17,-8,9,1
133278,1,0,0,0,9,0
44766,4,13,12,1,3,0
307328,2,14,19,-5,17,1
225892,1,7,0,7,16,0
296010,2,3,0,3,13,0
53408,3,3,21,-18,8,1
415640,4,30,13,17,15,0
44887,3,7,24,-17,4,0
373596,4,30,33,-3,13,0
168931,4,24,13,11,7,1
84991,2,19,7,12,4,0
112188,4,27,34,-7,17,1
371495,4,17,24,-7,12,1
313090,1,0,0,0,3,0
334611,4,36,31,5,13,1
343517,3,10,10,0,16,0
273059,4,9,3,6,2,1
394812,4,31,6,25,5,0
268273,2,10,0,10,17,0
261848,3,6,17,-11,14,0
420145,2,0,3,-3,17,0
88920,2,16,3,13,6,1
360160,2,10,6,4,7,0
289610,2,10,13,-3,10,0
416709,1,0,0,0,15,1
16964,3,27,20,7,8,0
195740,1,0,0,0,2,0
189632,3,10,6,4,17,0
34863,2,17,7,10,16,1
87666,2,0,13,-13,6,0
48255,2,3,10,-7,5,1
132454,4,0,24,-24,9,0
11826,2,33,17,16,6,1
106040,4,24,3,21,14,0
137629,5,37,34,3,11,0
211404,4,10,13,-3,9,1
86190,4,31,10,21,5,1
262327,4,13,9,4,15,1
65897,2,7,14,-7,13,1
87314,4,24,24,0,6,1
150239,4,12,26,-14,16,0
412514,3,24,7,17,14,0
373603,4,30,40,-10,13,1
28292,4,24,14,10,13,1
525,3,7,13,-6,1,0
305447,4,20,3,17,17,1
306842,1,0,3,-3,17,0
359679,1,0,0,0,6,1
5192,1,7,3,4,3,0
131555,3,9,23,-14,8,1
23764,2,10,0,10,12,0
37074,3,13,14,-1,17,1
19105,1,0,3,-3,10,1
222586,1,0,0,0,14,0
224758,2,5,3,2,15,1
344878,4,30,10,20,17,0
223155,4,43,37,6,14,1
291082,1,12,3,9,10,0
116755,3,13,26,-13,2,1
180064,4,28,20,8,13,0
44960,1,0,0,0,4,0
125406,1,7,0,7,5,0
364888,3,13,20,-7,9,1
247375,1,3,0,3,8,1
413492,1,0,0,0,14,1
4028,1,10,7,3,2,0
318541,1,0,0,0,5,1
206564,2,10,10,0,7,0
178302,2,7,3,4,12,0
165268,3,17,14,3,6,0
404459,2,14,7,7,10,0
181141,4,24,14,10,13,0
388054,4,20,9,11,2,1
231604,2,14,10,4,1,1
245204,4,19,28,-9,7,1
284029,3,3,3,0,7,0
309419,3,0,3,-3,1,1
164064,3,3,6,-3,5,0
180444,2,14,7,7,13,1
177791,1,0,0,0,12,1
242246,4,30,21,9,6,1
198149,2,6,3,3,3,1
261281,4,38,0,38,14,0
161839,1,6,0,6,4,0
51131,2,7,3,4,7,1
58051,1,7,7,0,10,1
232507,3,20,9,11,1,0
346972,2,7,3,4,1,1
240683,4,36,24,12,5,1
260490,2,13,0,13,14,0
325369,4,15,20,-5,8,0
66687,4,10,24,-14,14,0
337189,2,9,10,-1,14,1
284951,3,10,14,-4,7,1
26113,2,0,10,-10,13,1
400019,1,0,3,-3,8,1
213986,3,29,7,22,10,1
207743,3,24,13,11,7,1
297688,3,10,13,-3,13,1
260387,3,12,7,5,14,1
168012,3,3,14,-11,7,0
279546,3,10,6,4,5,1
388175,3,3,6,-3,2,0
257902,4,16,19,-3,13,1
206739,4,7,21,-14,7,0
265747,2,3,0,3,16,0
281448,2,0,10,-10,6,1
107526,4,3,23,-20,15,0
29193,4,3,26,-23,14,1
414799,1,0,0,0,15,1
133826,4,19,17,2,9,0
15344,2,7,6,1,8,1
206348,1,0,0,0,7,1
219495,2,3,21,-18,13,1
180838,4,17,20,-3,13,1
98689,1,7,3,4,11,1
197798,4,21,20,1,3,0
158622,2,7,7,0,3,0
380149,1,0,0,0,16,1
366810,1,0,0,0,10,0
202353,4,20,13,7,5,1
394709,1,14,0,14,5,0
337608,2,14,7,7,14,0
212376,4,13,17,-4,10,1
100060,2,6,3,3,12,0
57341,3,7,3,4,10,1
243294,3,7,10,-3,6,1
37586,1,6,0,6,17,1
141736,4,33,21,12,13,0
200435,2,13,18,-5,4,1
174038,2,0,19,-19,10,0
260176,1,7,0,7,14,0
113634,4,9,13,-4,17,0
126005,1,0,0,0,6,0
396175,4,24,23,1,6,0
392477,2,3,10,-7,4,0
308972,2,0,3,-3,1,1
315635,2,3,0,3,4,0
349734,3,17,7,10,2,1
276710,4,30,27,3,4,1
118304,3,19,7,12,2,1
43673,3,14,10,4,3,1
306711,2,10,9,1,17,0
195084,3,7,26,-19,2,1
174843,3,13,17,-4,10,1
309342,1,0,0,0,1,0
108549,3,17,14,3,15,1
111153,4,31,10,21,16,1
148783,3,13,16,-3,16,0
208598,2,6,3,3,8,1
57896,2,10,3,7,10,0
376590,4,15,6,9,14,1
101226,2,7,7,0,12,1
344688,3,6,20,-14,17,0
111520,2,7,3,4,16,1
365360,4,17,19,-2,9,1
306984,1,7,0,7,17,0
385059,5,30,24,6,1,1
231107,1,3,0,3,1,0
140982,1,7,0,7,13,0
364483,4,42,28,14,9,1
332356,4,16,13,3,12,1
99661,4,26,3,23,11,0
152784,3,7,7,0,17,1
233599,3,20,34,-14,2,0
180128,2,7,0,7,13,1
172333,1,0,0,0,9,0
259167,3,14,13,1,13,1
58405,2,34,10,24,10,0
295539,2,17,7,10,12,1
304016,2,0,13,-13,16,1
217367,4,21,10,11,12,1
229434,3,10,6,4,17,1
214628,3,3,16,-13,11,1
151859,1,3,0,3,17,1
360501,4,17,14,3,7,1
128684,4,6,17,-11,7,0
79796,4,26,14,12,2,1
6391,2,0,13,-13,3,1
129594,3,13,20,-7,7,0
129698,2,7,3,4,7,0
405385,1,7,7,0,10,0
185353,1,0,3,-3,15,1
321489,4,24,30,-6,7,0
229381,2,3,0,3,17,1
165946,2,10,7,3,6,0
40280,2,6,0,6,2,1
268649,4,17,20,-3,17,1
308507,1,0,6,-6,1,0
199653,2,7,0,7,4,0
245955,4,21,37,-16,7,1
188730,3,0,17,-17,16,1
85124,1,0,3,-3,4,0
36158,1,0,7,-7,17,1
227291,2,10,20,-10,16,1
293170,1,6,0,6,11,0
412057,2,21,0,21,13,1
70134,2,13,7,6,15,1
268262,1,3,0,3,17,1
114604,2,3,3,0,1,1
374900,4,14,18,-4,14,1
266574,1,0,0,0,16,1
50565,2,0,6,-6,6,0
239740,3,10,13,-3,4,1
325945,3,16,7,9,9,0
132806,1,3,0,3,9,0
414247,2,14,21,-7,14,1
282388,3,10,20,-10,6,0
195210,2,16,3,13,2,0
148391,1,0,0,0,16,1
280935,4,21,10,11,6,0
132449,3,0,21,-21,9,0
200260,2,10,7,3,4,0
206738,4,7,21,-14,7,0
377474,4,14,13,1,15,1
103610,1,0,0,0,13,1
249355,2,10,9,1,9,0
382557,3,0,10,-10,17,0
190309,4,7,20,-13,17,1
95034,4,20,16,4,9,0
170028,4,35,17,18,8,0
277038,1,3,0,3,4,0
92282,3,13,0,13,8,1
119820,4,24,16,8,3,1
326413,4,20,17,3,9,0
202441,2,6,10,-4,5,1
29800,1,0,0,0,14,1
384002,3,10,16,-6,1,0
135719,4,17,29,-12,10,1
84928,4,48,17,31,4,0
415449,3,15,3,12,15,1
303482,3,25,10,15,16,0
187741,4,16,20,-4,16,1
21635,1,0,0,0,11,1
90542,1,7,0,7,7,0
304129,4,16,30,-14,16,0
1041,1,7,3,4,1,0
52617,1,0,0,0,7,1
150536,1,0,0,0,17,0
107354,3,16,6,10,15,0
263868,1,0,0,0,15,1
294117,4,14,27,-13,12,1
14941,4,14,24,-10,7,0
396454,4,20,25,-5,6,1
65788,4,27,25,2,13,0
190110,3,27,3,24,17,0
77682,3,10,17,-7,1,0
17668,2,7,6,1,9,1
222312,2,7,3,4,14,0
210608,3,13,17,-4,9,1
333047,2,3,12,-9,12,1
114017,1,0,0,0,17,0
81461,4,10,16,-6,3,1
119128,2,10,7,3,3,1
1925,2,0,0,0,1,0
39215,1,3,0,3,1,1
263421,1,0,13,-13,15,1
31451,2,3,7,-4,15,1
195394,3,17,3,14,2,1
364411,2,35,7,28,9,0
226676,1,7,3,4,16,1
123669,3,7,22,-15,4,1
58218,2,0,3,-3,10,1
304707,4,21,7,14,16,0
149043,1,0,7,-7,16,0
51166,2,17,3,14,7,1
350332,3,21,3,18,2,1
11425,4,26,0,26,6,0
175290,3,15,16,-1,10,1
245336,4,23,13,10,7,1
339681,1,7,0,7,15,0
96005,2,6,7,-1,10,1
135574,4,21,6,15,10,1
323064,2,17,14,3,7,1
163857,1,0,7,-7,5,0
201303,2,21,3,18,5,0
390077,2,7,7,0,3,1
234145,1,0,7,-7,2,1
271499,4,21,0,21,1,1
259193,4,14,25,-11,13,0
106704,1,0,5,-5,14,1
413587,3,9,17,-8,14,0
61962,2,0,0,0,12,1
277241,3,0,13,-13,4,0
73359,2,13,0,13,17,1
98950,4,7,17,-10,11,0
34799,4,20,6,14,16,0
245249,2,3,3,0,7,1
138369,4,32,7,25,11,0
242468,2,3,10,-7,6,1
146215,2,0,10,-10,15,0
271618,3,23,20,3,2,0
37016,1,3,0,3,17,1
255868,4,20,7,13,12,0
285831,4,14,27,-13,8,0
110390,1,0,0,0,16,0
397194,3,13,0,13,6,0
341646,2,10,3,7,16,0
326874,4,10,20,-10,9,1
346531,3,24,33,-9,1,1
86795,1,0,3,-3,5,1
212877,1,0,0,0,10,1
347457,2,6,13,-7,1,1
258733,3,3,27,-24,13,1
141361,2,9,17,-8,13,1
345161,4,15,9,6,17,1
5523,2,13,10,3,3,0
162045,2,21,13,8,4,0
339726,2,14,6,8,15,1
265750,2,3,3,0,16,1
196557,3,17,6,11,2,0
4956,3,21,17,4,3,1
314104,4,33,20,13,3,1
134937,3,7,16,-9,10,0
384146,3,7,20,-13,1,1
379913,3,14,6,8,16,1
385050,4,24,24,0,1,1
290627,2,21,0,21,10,0
130025,2,7,20,-13,8,1
174710,4,9,7,2,10,1
4386,3,7,14,-7,2,1
388676,4,20,7,13,3,1
28415,3,13,6,7,14,0
356087,4,34,16,18,5,1
118398,2,6,10,-4,2,1
208151,2,0,0,0,8,1
299065,1,3,0,3,14,1
137435,4,6,21,-15,11,0
160149,2,10,0,10,3,1
146406,3,13,3,10,15,0
256130,3,14,16,-2,12,1
98128,2,21,10,11,11,0
216037,2,10,12,-2,11,0
231807,4,26,20,6,1,0
264263,2,10,17,-7,15,0
267381,2,0,7,-7,17,0
154670,4,31,28,3,1,1
151986,4,34,34,0,17,1
141958,2,10,7,3,13,1
380155,1,0,0,0,16,1
165719,4,14,7,7,6,0
99393,4,23,16,7,11,0
66973,1,0,0,0,14,0
174811,2,13,17,-4,10,0
80256,4,35,31,4,2,0
65824,5,34,33,1,13,0
108183,1,3,0,3,15,0
174861,4,19,17,2,10,0
153018,4,42,27,15,1,1
140861,2,14,0,14,13,1
361084,3,16,9,7,7,1
44792,4,16,19,-3,3,1
227152,2,10,7,3,16,0
273970,4,7,22,-15,2,1
165556,4,3,28,-25,6,0
257315,1,3,0,3,13,1
167472,2,0,0,0,7,0
41501,3,8,7,1,2,1
65468,3,16,14,2,13,0
146128,4,25,17,8,15,0
178307,2,7,3,4,12,0
222984,4,13,13,0,14,0
30659,4,24,9,15,14,1
159674,1,0,7,-7,3,1
19471,3,17,17,0,10,1
305554,2,6,0,6,17,1
153826,1,0,0,0,1,0
259752,3,10,10,0,14,1
3055,4,22,41,-19,2,1
256778,3,10,13,-3,12,1
48911,3,15,7,8,5,1
379006,2,7,3,4,15,0
266324,2,7,0,7,16,0
1756,4,28,0,28,1,0
401494,1,0,0,0,8,0
406752,1,0,3,-3,11,0
357038,1,6,0,6,5,1
188867,2,3,7,-4,16,0
299072,1,3,0,3,14,0
403218,4,24,17,7,9,1
22581,2,13,3,10,11,0
372280,2,10,7,3,13,1
237812,2,0,13,-13,4,0
278838,4,14,24,-10,5,1
39669,1,3,0,3,1,0
45240,1,0,0,0,4,1
114101,3,21,7,14,17,1
213833,3,42,0,42,10,0
400651,2,3,0,3,8,0
62667,4,24,20,4,12,0
386069,3,14,0,14,1,0
167347,3,23,16,7,7,0
383930,1,0,0,0,1,1
206047,1,0,3,-3,7,1
163806,4,17,12,5,5,0
21560,2,7,10,-3,11,0
253717,3,10,3,7,11,1
236065,3,37,10,27,3,1
78387,1,6,0,6,2,1
26757,3,6,24,-18,13,0
330170,1,0,0,0,11,1
236156,2,7,10,-3,3,1
12818,2,6,3,3,6,0
377360,1,0,0,0,15,1
94778,2,3,3,0,9,0
9616,2,6,14,-8,5,0
300125,1,7,3,4,14,1
271515,4,28,0,28,1,0
185664,1,7,0,7,15,0
41002,1,3,7,-4,2,0
325886,1,3,0,3,9,0
223430,4,20,26,-6,15,0
344381,2,21,14,7,17,0
280492,1,0,0,0,5,1
219228,4,13,3,10,13,1
334040,4,23,16,7,12,0
180151,2,7,0,7,13,1
280027,3,3,20,-17,5,0
22678,1,0,0,0,11,0
409482,1,0,0,0,12,1
220776,1,0,0,0,14,1
415694,2,7,3,4,15,0
418531,1,0,0,0,16,1
278420,1,0,0,0,4,1
93487,4,3,28,-25,9,0
351097,4,29,23,6,3,0
317184,2,7,3,4,5,0
113230,1,0,0,0,17,1
244476,1,0,3,-3,7,1
216484,2,20,1,19,12,0
254068,4,14,23,-9,11,0
372497,4,23,14,9,13,0
49995,3,28,10,18,6,0
144053,1,7,0,7,14,0
103202,2,3,0,3,13,1
323202,2,7,0,7,7,0
222812,3,10,13,-3,14,1
239995,2,0,13,-13,5,1
235448,4,28,25,3,3,0
90483,3,0,20,-20,7,0
198918,2,6,16,-10,3,1
5756,1,7,0,7,3,1
297686,3,10,6,4,13,0
117248,4,30,24,6,2,1
99401,1,0,0,0,11,0
418158,3,24,3,21,16,0
83665,2,9,10,-1,4,1
402257,2,3,10,-7,9,0
420353,4,17,10,7,17,0
12866,3,13,3,10,6,0
380758,1,3,7,-4,16,0
368007,3,17,21,-4,11,1
239245,2,0,7,-7,4,0
29760,3,41,3,38,14,0
39991,2,7,7,0,1,1
52835,3,7,37,-30,7,1
112225,1,14,7,7,17,0
30974,1,0,0,0,15,1
213923,1,10,7,3,10,1
404776,2,10,13,-3,10,1
369087,1,3,0,3,11,1
256709,2,0,3,-3,12,0
345905,3,16,23,-7,17,1
258580,3,13,3,10,13,0
257164,1,0,6,-6,12,1
371179,2,11,19,-8,12,1
49829,3,14,10,4,6,1
292035,3,15,9,6,11,0
238923,1,7,0,7,4,0
160665,3,10,0,10,4,1
21404,2,6,7,-1,11,0
292556,1,0,6,-6,11,1
122221,1,3,7,-4,4,1
209295,1,0,0,0,8,1
345188,1,0,0,0,17,1
145585,2,21,0,21,14,1
172419,3,13,42,-29,9,1
11083,2,10,10,0,5,0
132838,2,3,7,-4,9,0
2160,4,13,23,-10,1,1
140905,3,17,10,7,13,1
352748,4,24,13,11,3,0
131676,2,7,22,-15,8,0
381354,2,6,0,6,16,1
108234,2,6,0,6,15,0
17824,2,13,10,3,9,0
135031,1,14,0,14,10,0
311776,2,10,20,-10,2,1
217616,3,19,9,10,12,0
283244,2,10,0,10,7,0
304309,2,7,0,7,16,0
121224,3,21,27,-6,3,0
207822,1,0,0,0,8,0
79466,3,12,14,-2,2,0
349298,3,21,21,0,2,0
96324,3,3,16,-13,10,1
264799,3,17,29,-12,16,0
133295,2,7,0,7,9,1
311706,4,12,9,3,2,1
33597,4,17,16,1,16,1
117317,2,14,0,14,2,1
39444,3,13,10,3,1,0
416765,2,7,10,-3,15,1
379953,4,24,6,18,16,1
190188,1,0,0,0,17,0
222301,1,7,0,7,14,0
217411,1,3,0,3,12,0
224060,4,14,9,5,15,1
142425,2,7,10,-3,13,1
243308,3,7,10,-3,6,1
2757,1,0,0,0,2,0
117247,4,30,24,6,2,1
202478,4,9,10,-1,5,0
59548,4,13,35,-22,11,0
163617,3,20,19,1,5,1
257523,3,19,10,9,13,1
238100,5,13,13,0,4,1
394248,4,47,32,15,5,0
413231,2,7,0,7,14,0
256161,4,27,22,5,12,1
331034,3,39,10,29,11,0
398216,3,28,10,18,7,0
46543,4,40,9,31,4,1
185885,3,9,16,-7,15,1
223689,3,13,13,0,15,1
307574,1,0,0,0,17,0
419882,3,6,11,-5,17,0
237363,3,6,14,-8,3,0
145513,4,26,17,9,14,0
374082,1,0,0,0,13,1
148908,2,3,9,-6,16,1
250718,1,0,0,0,10,1
177233,2,7,7,0,11,0
50144,3,0,17,-17,6,0
259896,2,14,10,4,14,0
395805,2,3,7,-4,6,0
311111,4,13,3,10,2,0
258729,3,3,26,-23,13,0
54479,2,7,7,0,8,0
102253,1,7,0,7,13,0
346710,3,24,6,18,1,0
362500,2,7,6,1,8,1
26598,3,10,6,4,13,0
71280,2,7,3,4,16,1
172411,3,13,42,-29,9,1
409586,4,42,17,25,12,0
149915,4,6,23,-17,16,0
270801,1,3,0,3,1,0
142301,2,0,0,0,13,0
61897,4,27,23,4,12,0
309966,2,3,3,0,2,1
109036,4,16,34,-18,15,1
103460,1,3,0,3,13,1
156052,4,20,24,-4,2,0
204781,4,21,21,0,6,0
77156,4,24,17,7,1,1
66100,4,10,6,4,13,1
80507,2,5,9,-4,3,0
219499,2,3,21,-18,13,1
85737,1,0,0,0,5,1
388171,3,3,6,-3,2,0
351870,4,27,14,13,3,1
396665,1,7,7,0,6,1
412589,1,0,0,0,14,1
326737,1,0,7,-7,9,1
350235,4,27,0,27,2,1
272775,4,15,10,5,2,0
391311,3,17,3,14,4,1
191507,2,14,14,0,17,0
199947,1,9,10,-1,4,1
332452,2,16,3,13,12,0
5717,4,0,24,-24,3,0
77291,4,26,17,9,1,0
332522,4,30,16,14,12,0
187254,3,7,6,1,16,1
172071,2,10,3,7,9,0
336460,3,10,17,-7,14,1
177982,2,7,6,1,12,1
376047,2,0,0,0,14,0
394588,2,14,0,14,5,1
222153,1,7,3,4,14,1
195267,4,23,24,-1,2,1
342243,2,3,0,3,16,1
245749,3,16,10,6,7,0
298030,1,0,0,0,13,1
211384,4,10,10,0,9,1
145235,1,0,0,0,14,1
152853,1,0,0,0,1,1
165678,3,7,7,0,6,0
76708,4,16,13,3,1,0
75801,4,42,26,16,1,0
47270,1,0,0,0,5,1
329161,1,3,3,0,10,1
400974,3,19,7,12,8,1
88205,3,14,17,-3,6,1
143842,4,12,7,5,14,0
6135,4,7,10,-3,3,1
413907,4,17,9,8,14,1
63074,4,23,35,-12,12,0
234705,4,30,23,7,2,0
181132,4,24,14,10,13,0
143761,2,3,0,3,14,0
136087,1,0,7,-7,10,0
198492,3,17,3,14,3,0
3941,3,19,14,5,2,0
378196,4,27,16,11,15,0
140497,3,21,26,-5,12,0
150406,1,7,0,7,16,1
258538,1,0,0,0,13,0
220357,1,3,0,3,13,1
381941,2,0,13,-13,17,1
407273,3,10,16,-6,11,1
190222,2,7,0,7,17,0
116028,3,13,7,6,1,1
83037,1,3,7,-4,4,1
254281,2,6,9,-3,11,0
64566,2,7,7,0,13,1
418110,1,14,0,14,16,1
258048,4,7,38,-31,13,0
227080,4,20,12,8,16,1
298690,3,13,14,-1,14,1
408828,4,13,28,-15,12,1
24497,1,0,7,-7,12,1
135955,2,0,3,-3,10,0
179180,1,0,0,0,12,1
406348,2,7,7,0,11,1
225961,3,27,14,13,16,1
134364,4,23,21,2,10,0
180615,2,7,6,1,13,1
221284,3,0,29,-29,14,0
377352,1,0,0,0,15,0
242630,3,13,0,13,6,0
75631,4,10,6,4,17,0
12599,4,3,24,-21,6,1
62133,2,7,7,0,12,0
383403,3,3,9,-6,17,0
301007,2,10,3,7,15,0
289909,2,6,3,3,10,1
170071,1,0,0,0,8,0
23629,2,7,10,-3,12,0
84475,3,20,10,10,4,0
52267,4,20,19,1,7,0
322559,1,0,3,-3,7,1
222709,4,14,24,-10,14,1
1208,2,10,0,10,1,1
282237,3,10,7,3,6,0
85458,2,14,3,11,5,0
77053,2,7,10,-3,1,0
387064,2,7,14,-7,2,1
166513,4,23,27,-4,6,0
221360,1,0,10,-10,14,1
109228,2,3,0,3,15,1
413141,4,33,35,-2,14,0
314829,4,35,7,28,4,0
342293,3,20,3,17,16,0
455,1,0,0,0,1,0
184702,4,17,24,-7,15,0
147106,2,14,31,-17,15,0
161753,3,24,6,18,4,1
365566,2,21,14,7,9,0
396102,2,17,9,8,6,0
76605,1,7,0,7,1,0
130147,1,0,9,-9,8,0
407775,4,10,7,3,11,0
134866,1,0,0,0,10,1
174059,3,0,33,-33,10,1
363388,2,14,10,4,8,0
126840,2,10,6,4,6,0
322522,4,15,3,12,7,1
303114,2,7,14,-7,16,1
216722,3,27,6,21,12,1
260254,4,17,3,14,14,0
392078,4,18,33,-15,4,0
24478,1,0,0,0,12,0
19307,3,14,17,-3,10,1
39447,3,13,10,3,1,0
309506,1,0,0,0,1,1
34667,1,0,3,-3,16,0
266980,3,19,10,9,17,0
255680,3,3,7,-4,12,0
276385,3,25,38,-13,3,1
89283,4,15,0,15,7,1
417415,4,24,17,7,16,0
125619,3,14,24,-10,5,1
203819,3,17,24,-7,6,0
19415,2,14,7,7,10,1
281425,1,0,10,-10,6,0
256851,1,0,3,-3,12,1
165641,2,0,0,0,6,0
269558,4,21,31,-10,1,0
294808,2,21,14,7,12,1
293851,4,31,19,12,12,0
114660,3,3,10,-7,1,1
298064,2,0,14,-14,13,1
395371,3,21,3,18,5,1
135129,4,31,6,25,10,0
132898,4,6,21,-15,9,0
368665,1,0,10,-10,11,1
61892,4,20,23,-3,12,1
216155,2,7,0,7,12,0
306969,1,0,0,0,17,1
187345,1,7,7,0,16,1
136095,1,0,7,-7,10,1
30036,3,33,0,33,14,0
14102,1,0,7,-7,7,1
343917,1,7,0,7,17,0
296576,1,0,0,0,13,1
118052,4,23,20,3,2,0
108253,3,6,0,6,15,0
31871,1,3,0,3,15,1
393339,1,7,7,0,5,1
390377,2,7,13,-6,3,0
385039,4,24,16,8,1,0
71376,1,0,0,0,16,1
89269,4,12,0,12,7,1
388690,4,20,7,13,3,0
115084,2,3,7,-4,1,0
287375,3,20,3,17,8,0
250675,4,10,22,-12,10,0
215608,2,14,3,11,11,1
209155,1,0,7,-7,8,1
39184,4,33,17,16,1,1
87978,1,3,0,3,6,1
320233,2,14,0,14,6,1
380300,4,29,30,-1,16,1
400106,3,17,23,-6,8,0
285267,2,14,6,8,7,0
341871,3,22,15,7,16,1
263869,1,0,0,0,15,1
183651,2,0,8,-8,14,1
338893,4,13,25,-12,15,1
37884,2,3,7,-4,1,0
145214,4,49,0,49,14,0
280700,2,0,3,-3,5,0
210072,4,17,17,0,8,1
240696,1,0,0,0,5,1
325278,2,3,3,0,8,0
86516,1,7,3,4,5,1
323564,4,34,17,17,7,0
291134,3,15,13,2,10,1
261484,1,6,0,6,14,0
72423,1,7,0,7,16,0
417166,2,3,10,-7,16,0
238830,3,27,0,27,4,0
222211,3,13,10,3,14,0
336146,3,10,3,7,13,0
155958,1,0,7,-7,2,1
82283,2,3,3,0,3,1
361622,2,0,10,-10,7,1
10023,1,14,0,14,5,0
265846,1,0,0,0,16,1
297380,3,9,17,-8,13,0
75716,2,21,7,14,1,0
296931,3,25,0,25,13,1
417277,4,20,23,-3,16,1
208225,4,6,10,-4,8,1
358802,1,0,6,-6,6,0
241819,2,3,3,0,5,1
330989,2,26,7,19,11,1
324913,4,17,23,-6,8,1
361996,4,20,12,8,7,1
221522,1,6,2,4,14,0
29009,3,7,7,0,14,1
360984,1,0,0,0,7,1
327472,4,10,30,-20,9,1
96262,1,0,6,-6,10,0
77298,4,32,17,15,1,0
17003,4,34,23,11,8,1
267296,4,17,17,0,17,0
274471,4,10,17,-7,3,0
164770,3,26,14,12,6,1
153745,3,2,21,-19,1,1
355476,4,23,20,3,4,1
364074,1,7,3,4,9,0
200380,1,0,6,-6,4,1
172903,3,27,24,3,9,0
88662,3,20,13,7,6,1
214738,2,3,7,-4,11,0
316321,4,17,19,-2,4,0
394476,3,7,18,-11,5,1
125463,3,13,0,13,5,0
378839,2,7,3,4,15,0
66432,1,0,7,-7,14,1
350309,2,14,3,11,2,1
141745,4,33,21,12,13,1
39979,1,0,0,0,1,0
75583,2,7,3,4,17,1
400875,4,31,19,12,8,0
17633,1,7,3,4,9,0
6551,3,3,6,-3,3,1
391467,4,10,27,-17,4,0
412108,4,37,3,34,13,1
200873,2,14,0,14,4,0
255940,2,6,3,3,12,0
109699,2,3,0,3,16,0
85617,2,7,0,7,5,0
75710,2,21,7,14,1,0
356345,3,24,0,24,5,0
32102,3,21,13,8,15,0
230718,2,6,27,-21,1,1
335891,3,28,14,14,13,0
335251,1,0,3,-3,13,1
124728,3,3,3,0,5,1
216590,4,43,18,25,12,1
101294,4,17,20,-3,12,0
69011,3,21,17,4,15,1
223109,3,31,17,14,14,1
141496,2,7,3,4,13,1
200327,4,30,14,16,4,0
34779,4,20,3,17,16,1
393651,1,0,0,0,5,1
260734,1,3,0,3,14,0
157371,1,3,0,3,2,1
393202,2,7,6,1,5,1
348556,3,28,17,11,2,1
362135,4,42,23,19,8,1
366814,2,0,3,-3,10,1
100812,3,9,6,3,12,1
1112,3,10,36,-26,1,1
115593,4,27,9,18,1,1
167933,4,21,19,2,7,0
233536,1,6,7,-1,2,1
393609,4,7,26,-19,5,0
364579,3,15,28,-13,9,0
246628,2,17,3,14,8,1
242948,4,24,23,1,6,0
70741,2,7,17,-10,15,1
388101,1,3,0,3,2,0
420781,2,3,3,0,17,0
280881,3,16,3,13,6,1
286643,1,0,0,0,8,1
269325,1,0,7,-7,1,1
104539,4,14,38,-24,13,0
196207,1,7,3,4,2,1
421402,3,16,20,-4,17,1
18657,4,20,33,-13,9,1
246914,2,14,7,7,8,1
176529,3,12,17,-5,11,1
369083,1,3,0,3,11,0
293938,3,7,21,-14,12,0
184508,2,14,14,0,14,1
150648,4,10,22,-12,17,1
118155,3,23,27,-4,2,1
384219,1,0,0,0,1,0
334802,1,7,0,7,13,0
32942,2,0,14,-14,15,0
418329,4,9,21,-12,16,0
304667,3,14,7,7,16,0
241546,2,3,9,-6,5,0
186169,3,16,6,10,15,1
204463,3,7,24,-17,6,0
2808,2,21,21,0,2,1
405126,3,0,10,-10,10,1
420958,3,7,14,-7,17,0
112179,4,20,34,-14,17,1
373480,1,0,10,-10,13,1
91896,1,0,0,0,8,1
123635,2,0,9,-9,4,1
178281,1,0,0,0,12,0
378648,4,23,23,0,15,0
312791,1,0,0,0,3,1
101017,4,23,16,7,12,0
101381,2,6,7,-1,12,1
114871,4,16,33,-17,1,0
240036,3,10,20,-10,5,1
385931,3,10,14,-4,1,0
386616,2,7,7,0,2,0
253091,3,14,7,7,11,1
23957,3,16,3,13,12,0
161067,1,3,0,3,4,1
106713,1,7,5,2,14,0
414288,3,21,28,-7,14,0
320705,2,14,17,-3,6,0
307216,3,3,10,-7,17,1
404098,4,13,49,-36,10,0
57832,4,22,10,12,10,0
18208,4,29,20,9,9,0
90289,2,0,14,-14,7,1
28171,1,3,0,3,13,1
263603,2,14,7,7,15,0
40708,2,7,7,0,2,0
378053,4,0,14,-14,15,1
156008,2,10,14,-4,2,1
295085,2,7,0,7,12,0
68375,3,3,14,-11,14,0
269796,2,10,7,3,1,1
136695,1,0,10,-10,11,1
110620,3,17,10,7,16,0
418738,2,7,7,0,16,0
200879,2,14,0,14,4,1
13091,4,21,14,7,6,0
53861,2,0,0,0,8,1
17852,3,16,10,6,9,0
416562,1,0,0,0,15,0
178722,4,11,26,-15,12,0
321778,3,18,9,9,7,1
94976,3,6,9,-3,9,1
158509,3,10,10,0,3,0
304215,3,26,7,19,16,0
250127,1,7,0,7,9,1
181884,3,21,27,-6,13,0
338618,1,3,0,3,14,0
375826,4,20,7,13,14,0
50472,4,17,10,7,6,1
243580,2,10,7,3,6,1
235517,2,0,13,-13,3,1
234461,2,17,6,11,2,0
358189,4,20,17,3,6,1
69554,2,0,7,-7,15,0
329888,1,0,7,-7,11,0
286528,2,3,14,-11,8,1
47513,2,17,6,11,5,1
226976,1,3,3,0,16,0
267280,3,17,17,0,17,1
420496,3,3,35,-32,17,1
224088,4,17,9,8,15,0
197320,3,17,3,14,3,1
68361,3,3,14,-11,14,0
86456,3,30,14,16,5,0
410010,4,6,42,-36,12,1
320875,3,3,14,-11,6,0
201534,4,32,14,18,5,0
224037,3,14,6,8,15,0
220093,2,19,3,16,13,0
53779,5,10,10,0,8,1
233530,1,0,7,-7,2,0
32084,3,14,13,1,15,1
24533,2,7,13,-6,12,1
165929,1,3,7,-4,6,0
284878,1,0,0,0,7,0
318028,4,17,16,1,5,1
279477,1,7,6,1,5,1
47041,3,17,7,10,5,0
243582,2,10,7,3,6,1
66825,4,13,6,7,14,0
341438,4,0,16,-16,16,1
9631,2,12,21,-9,5,1
170525,1,7,0,7,8,1
40207,4,34,7,27,2,1
275325,3,10,16,-6,3,1
316940,3,17,18,-1,4,1
105691,3,28,3,25,14,0
325364,4,15,20,-5,8,1
36474,2,3,6,-3,17,1
287731,1,7,0,7,9,0
65317,3,3,21,-18,13,0
75736,2,21,16,5,1,1
87499,1,0,0,0,6,1
230556,2,10,7,3,1,0
223653,2,13,3,10,15,0
409887,4,30,8,22,12,1
290281,4,17,15,2,10,0
203593,1,0,0,0,6,0
412880,1,0,0,0,14,1
332098,1,0,0,0,12,0
355520,1,7,0,7,5,1
264701,1,7,13,-6,16,1
274493,1,13,3,10,3,1
81942,4,7,36,-29,3,1
25581,3,24,10,14,12,1
1698,3,14,0,14,1,0
170183,4,24,27,-3,8,0
337611,2,14,7,7,14,1
100109,4,13,6,7,12,1
266552,4,10,22,-12,16,0
198106,1,0,0,0,3,0
381208,2,7,10,-3,16,1
384672,1,7,17,-10,1,1
367864,3,20,17,3,10,1
93848,2,7,0,7,9,1
211900,4,43,23,20,9,0
113191,4,41,16,25,17,0
20109,1,3,0,3,10,0
362902,1,6,0,6,8,1
212467,2,10,3,7,10,1
166450,3,17,10,7,6,1
317204,3,7,13,-6,5,1
20482,2,0,0,0,10,1
86463,4,30,21,9,5,0
37216,2,10,14,-4,17,0
338300,1,0,0,0,14,1
207141,2,7,7,0,7,0
951,3,0,3,-3,1,0
224173,3,0,20,-20,15,1
414360,1,7,3,4,14,1
312451,1,0,0,0,3,0
11626,1,14,0,14,6,0
85662,3,24,14,10,5,0
299045,4,16,25,-9,14,1
96693,1,0,7,-7,10,1
232514,3,20,10,10,1,1
258425,3,21,13,8,13,1
45670,4,13,13,0,4,1
395650,3,7,17,-10,6,0
208063,4,21,13,8,8,1
11144,4,24,27,-3,5,1
258387,2,14,6,8,13,0
100885,1,0,0,0,12,0
33788,2,0,17,-17,16,1
285124,4,3,0,3,7,1
289298,2,14,17,-3,9,0
224210,4,0,23,-23,15,0
16505,3,13,13,0,8,1
291605,3,23,3,20,11,0
44731,2,7,12,-5,3,0
246884,1,0,7,-7,8,1
42760,1,3,7,-4,3,1
279629,1,7,0,7,5,0
132324,4,31,17,14,9,1
92353,1,0,0,0,8,1
406956,2,3,13,-10,11,0
1780,1,3,0,3,1,1
86785,1,0,0,0,5,0
26226,1,0,7,-7,13,0
301168,2,13,11,2,15,0
353612,4,38,0,38,4,0
356151,2,10,0,10,5,1
204523,1,0,7,-7,6,1
235206,1,9,0,9,3,1
93024,3,13,3,10,8,0
287219,4,13,23,-10,8,1
312421,4,26,41,-15,3,1
100324,2,9,14,-5,12,0
291660,1,0,0,0,11,1
290969,3,20,10,10,10,0
267323,4,17,17,0,17,0
141497,2,7,3,4,13,1
58719,2,10,17,-7,10,0
327706,2,3,10,-7,10,1
289707,1,0,0,0,10,0
306949,4,6,37,-31,17,1
307505,3,38,13,25,17,1
129424,3,23,13,10,7,0
403838,1,0,0,0,10,1
263517,4,20,23,-3,15,0
89211,2,3,0,3,7,1
364092,2,14,3,11,9,0
83602,4,3,17,-14,4,1
319474,2,0,10,-10,6,1
90717,2,7,0,7,7,1
261287,4,38,0,38,14,0
186186,3,16,6,10,15,0
417602,1,14,0,14,16,1
161755,3,24,6,18,4,0
282510,2,17,3,14,6,1
294226,3,13,7,6,12,0
369138,2,13,7,6,11,1
60163,1,0,0,0,11,0
39591,3,26,6,20,1,1
108931,1,6,7,-1,15,1
125450,2,13,0,13,5,1
147795,1,0,7,-7,15,1
314479,2,14,0,14,3,0
235238,2,15,3,12,3,0
302076,3,20,24,-4,15,0
146837,2,17,0,17,15,1
101263,3,10,7,3,12,0
126030,2,7,0,7,6,0
339221,1,0,0,0,15,1
362770,2,7,7,0,8,0
63246,1,0,0,0,12,0
184502,2,14,14,0,14,1
290775,1,0,0,0,10,1
374357,1,0,0,0,14,1
51745,2,3,10,-7,7,0
91356,3,14,7,7,8,1
360337,3,7,20,-13,7,0
234267,1,0,0,0,2,0
84133,2,7,0,7,4,1
272164,1,0,0,0,2,0
108068,2,13,14,-1,15,0
257772,1,0,0,0,13,1
55210,2,7,0,7,9,1
210801,4,24,10,14,9,1
104582,2,7,3,4,14,1
228333,2,0,14,-14,17,1
71715,2,10,13,-3,16,1
236648,2,10,0,10,3,0
194214,4,12,17,-5,1,1
362428,4,30,23,7,8,1
95367,1,7,0,7,10,1
157993,1,0,0,0,3,0
342317,4,20,6,14,16,1
208216,4,3,10,-7,8,0
160871,4,34,27,7,4,1
234772,2,0,3,-3,2,0
152189,2,7,0,7,17,1
56075,1,7,0,7,9,0
305163,4,27,10,17,16,0
345956,4,27,23,4,17,0
408719,1,3,0,3,12,0
275385,1,0,0,0,3,0
213747,1,0,0,0,10,0
356090,4,34,16,18,5,0
205152,2,7,7,0,6,0
102236,4,30,14,16,13,1
391085,1,7,7,0,4,0
297299,1,0,0,0,13,1
93746,3,3,13,-10,9,1
113794,4,13,17,-4,17,1
409719,3,10,6,4,12,0
78413,2,14,0,14,2,1
65963,4,24,27,-3,13,0
291341,4,24,31,-7,10,1
135404,3,28,17,11,10,0
240513,4,6,7,-1,5,1
337546,4,7,33,-26,14,1
187318,1,0,0,0,16,1
232733,1,0,0,0,2,1
167771,5,26,26,0,7,0
173776,3,10,3,7,10,0
297136,4,31,6,25,13,0
238786,2,14,0,14,4,1
159138,4,31,7,24,3,0
163045,4,22,3,19,5,0
129946,4,13,0,13,7,0
371324,3,28,10,18,12,1
338194,2,7,21,-14,14,1
413210,1,7,0,7,14,0
162076,3,28,13,15,4,0
152517,3,17,7,10,17,0
357615,5,16,16,0,5,0
12469,4,13,9,4,6,0
47704,3,3,17,-14,5,1
63565,1,10,7,3,12,1
200614,3,27,14,13,4,0
405510,1,0,0,0,10,1
234712,4,30,30,0,2,1
93410,2,3,7,-4,9,1
125433,2,10,0,10,5,1
362856,4,14,28,-14,8,1
20019,3,19,6,13,10,1
189343,3,10,10,0,16,1
81635,1,7,0,7,3,0
233531,1,0,7,-7,2,1
320807,1,0,0,0,6,0
45748,2,10,7,3,4,1
406818,3,0,20,-20,11,1
330063,2,0,3,-3,11,0
173771,3,10,3,7,10,0
77087,2,7,17,-10,1,1
293275,4,26,7,19,11,1
37282,4,13,21,-8,17,0
147699,3,10,10,0,15,1
172984,1,14,0,14,9,1
207352,4,13,21,-8,7,0
316913,3,9,15,-6,4,1
243907,3,16,6,10,6,1
369122,2,6,7,-1,11,1
75058,1,0,0,0,17,1
303890,2,0,17,-17,16,1
48393,2,3,17,-14,5,0
180642,3,17,6,11,13,1
227572,2,21,0,21,16,1
19320,3,14,17,-3,10,0
345626,4,24,23,1,17,0
139979,3,25,3,22,12,0
403785,4,15,16,-1,9,0
46983,1,0,0,0,5,1
291877,2,7,10,-3,11,1
412906,1,0,3,-3,14,1
16533,4,29,13,16,8,1
16309,1,0,0,0,8,0
194548,1,0,0,0,2,1
222057,3,20,10,10,14,1
104567,1,7,3,4,14,0
221821,1,0,0,0,14,0
222091,4,27,17,10,14,0
8463,2,15,0,15,4,0
304355,3,20,7,13,16,0
329404,4,16,41,-25,10,1
174792,2,13,13,0,10,0
331816,1,0,0,0,12,0
202590,2,21,13,8,5,1
66069,3,7,3,4,13,1
34480,4,41,3,38,16,0
88506,3,16,14,2,6,1
246373,4,20,10,10,7,1
125568,1,7,7,0,5,0
324717,2,13,7,6,8,0
178450,1,7,3,4,12,0
311601,2,6,0,6,2,1
231759,2,10,20,-10,1,1
379250,1,0,3,-3,16,0
131711,3,17,22,-5,8,1
325180,3,13,17,-4,8,0
283144,3,6,9,-3,7,1
355393,2,3,10,-7,4,1
237533,3,24,7,17,3,1
251108,3,10,14,-4,10,0
101820,1,0,0,0,12,1
313326,3,13,24,-11,3,0
251712,3,21,3,18,10,0
386591,1,0,0,0,2,0
335974,2,0,15,-15,13,1
19470,3,17,17,0,10,1
44046,1,0,0,0,3,1
218424,2,10,14,-4,13,0
270259,3,3,21,-18,1,1
145018,3,6,3,3,14,0
391765,4,10,13,-3,4,0
156666,3,6,7,-1,2,0
131956,2,0,7,-7,8,1
56265,2,3,14,-11,9,0
184733,1,0,0,0,15,1
357878,4,13,34,-21,6,0
112335,1,0,0,0,17,1
340197,3,23,21,2,15,0
393704,2,0,7,-7,5,1
142909,2,3,10,-7,13,1
9848,1,0,0,0,5,1
320847,2,3,11,-8,6,0
129121,4,34,28,6,7,0
133292,2,7,0,7,9,0
359508,3,0,21,-21,6,1
188006,4,23,14,9,16,0
108134,4,13,42,-29,15,0
172668,2,7,3,4,9,0
286179,5,24,24,0,8,0
133774,2,13,7,6,9,0
233504,4,26,10,16,2,0
42627,2,0,7,-7,3,0
132694,2,3,10,-7,9,1
216744,4,27,9,18,12,0
205792,2,7,0,7,7,1
370848,1,3,0,3,12,0
15424,1,0,0,0,8,0
143069,2,3,14,-11,13,1
42383,3,14,16,-2,2,1
151816,4,21,16,5,17,1
323770,1,6,3,3,8,1
272684,2,9,3,6,2,0
288542,2,20,28,-8,9,0
26446,3,20,16,4,13,0
416018,2,7,0,7,15,0
171158,2,3,7,-4,8,1
323051,2,14,14,0,7,1
87677,2,0,14,-14,6,0
195881,1,0,0,0,2,0
36836,4,24,26,-2,17,0
286126,4,16,17,-1,8,0
398696,1,0,0,0,7,0
111256,3,10,10,0,16,0
199904,4,17,24,-7,4,0
284117,1,0,3,-3,7,1
197205,4,37,27,10,3,0
279043,1,0,0,0,5,1
401349,1,0,0,0,8,1
47932,1,0,7,-7,5,1
20389,4,10,13,-3,10,0
370255,1,0,14,-14,12,1
373996,3,10,7,3,13,0
213478,1,0,0,0,10,0
411638,3,20,28,-8,13,1
412133,1,0,0,0,13,0
229178,4,19,7,12,17,1
213494,2,0,7,-7,10,1
126381,3,13,14,-1,6,0
218927,4,41,24,17,13,1
57482,2,14,10,4,10,1
33672,2,21,0,21,16,1
106296,2,7,6,1,14,0
408972,4,31,24,7,12,0
399355,3,27,7,20,7,1
409315,4,16,16,0,12,0
333537,3,16,3,13,12,0
154349,4,27,24,3,1,1
192045,4,24,27,-3,1,1
264878,2,3,7,-4,16,1
330815,2,10,17,-7,11,1
371611,3,10,17,-7,12,0
289526,4,28,7,21,10,0
140133,3,10,0,10,12,0
224185,3,0,20,-20,15,0
345526,2,7,17,-10,17,1
42152,1,0,0,0,2,1
71044,3,20,0,20,16,1
26396,2,10,0,10,13,0
216233,4,17,17,0,12,1
401273,3,10,14,-4,8,1
233989,1,14,0,14,2,0
202727,2,6,10,-4,5,1
227672,4,42,7,35,16,0
162738,4,35,24,11,5,0
293240,3,22,7,15,11,1
172968,1,7,0,7,9,0
7796,4,30,9,21,4,1
4428,4,14,14,0,2,1
111123,4,31,10,21,16,0
339181,4,30,13,17,15,0
396119,2,17,16,1,6,0
108313,1,0,0,0,15,1
137147,4,31,6,25,11,1
321424,2,14,17,-3,7,1
327668,2,3,3,0,10,1
71438,2,24,7,17,16,1
347766,2,7,0,7,1,1
301264,4,27,26,1,15,0
211723,4,26,16,10,9,1
285013,4,16,27,-11,7,1
266491,2,0,15,-15,16,1
181603,3,16,6,10,13,1
73825,3,13,0,13,17,0
202117,2,13,3,10,5,1
134598,2,17,10,7,10,1
152140,4,20,13,7,17,0
180324,2,9,7,2,13,1
28761,1,0,0,0,14,0
301618,2,10,3,7,15,1
284862,5,29,30,-1,7,0
283458,3,23,14,9,7,0
294275,4,28,21,7,12,0
80638,2,7,16,-9,3,1
22915,3,3,20,-17,11,0
39402,2,3,3,0,1,0
391988,2,0,7,-7,4,0
235559,3,16,13,3,3,1
33496,2,14,0,14,16,0
179455,4,13,20,-7,12,0
309202,1,0,0,0,1,0
186970,4,10,12,-2,15,0
324129,3,0,10,-10,8,1
131605,4,16,26,-10,8,0
198878,1,0,13,-13,3,1
156794,2,20,13,7,2,0
286546,2,10,14,-4,8,0
401173,4,51,13,38,8,0
47308,2,0,7,-7,5,1
138162,2,7,9,-2,11,0
19911,4,16,21,-5,10,0
282026,4,31,28,3,6,1
25081,1,3,0,3,12,0
396892,3,27,13,14,6,0
166563,2,6,7,-1,6,1
409918,1,0,0,0,12,0
410844,2,14,3,11,13,0
392165,2,0,13,-13,4,1
14471,3,24,16,8,7,1
255538,3,30,7,23,12,0
415723,2,14,10,4,15,0
261183,1,14,0,14,14,0
267750,4,16,34,-18,17,1
105083,3,26,14,12,14,1
129771,4,17,24,-7,7,1
330819,2,10,17,-7,11,1
395312,1,7,0,7,5,1
53957,4,20,25,-5,8,1
351965,3,21,14,7,3,0
330270,4,24,21,3,11,0
190061,2,17,3,14,17,1
214306,4,14,10,4,11,1
380519,2,7,14,-7,16,0
374521,1,7,3,4,14,1
266244,4,31,19,12,16,1
269833,3,22,10,12,1,0
125541,1,0,0,0,5,1
271658,4,30,37,-7,2,0
106666,4,46,16,30,14,1
64644,4,20,24,-4,13,0
125177,3,17,7,10,5,1
16350,2,7,7,0,8,1
219301,2,10,7,3,13,1
46491,3,27,6,21,4,1
307329,2,14,19,-5,17,1
71480,3,33,7,26,16,0
190868,4,27,17,10,17,0
308333,1,0,3,-3,1,1
221088,2,0,0,0,14,1
270254,3,3,21,-18,1,0
90727,2,14,6,8,7,0
336355,4,20,20,0,13,0
231531,4,30,29,1,1,0
14097,1,0,0,0,7,1
175496,1,0,0,0,11,1
598,1,0,0,0,1,0
339987,2,14,3,11,15,0
142121,2,0,7,-7,13,1
171263,1,0,0,0,9,0
96533,1,0,0,0,10,1
299284,3,23,7,16,14,1
135082,3,17,6,11,10,0
415370,4,21,24,-3,15,0
312871,3,14,0,14,3,0
399254,4,13,20,-7,7,0
226238,2,6,0,6,16,1
409514,2,7,0,7,12,0
254050,4,14,20,-6,11,1
316680,5,12,12,0,4,0
44139,3,10,13,-3,3,0
146748,4,22,35,-13,15,1
265061,2,10,3,7,16,1
79722,2,10,7,3,2,0
112155,4,10,27,-17,17,1
254599,3,7,14,-7,11,1
337388,4,21,14,7,14,1
100369,3,9,20,-11,12,0
366625,4,26,14,12,10,0
416568,1,0,0,0,15,0
127547,4,3,26,-23,6,0
83557,3,0,17,-17,4,1
58021,5,20,20,0,10,0
318053,1,0,0,0,5,1
119001,3,6,23,-17,3,1
219327,2,16,7,9,13,0
74416,3,10,13,-3,17,0
380337,2,7,7,0,16,0
237088,3,0,26,-26,3,0
283528,1,6,7,-1,7,1
290840,3,17,20,-3,10,0
184518,2,17,14,3,14,1
65346,4,6,21,-15,13,1
69956,1,21,0,21,15,0
379482,4,23,3,20,16,0
130013,2,7,13,-6,8,1
155302,1,0,0,0,2,1
382664,2,0,6,-6,17,1
121658,2,0,7,-7,4,1
97175,1,0,3,-3,10,1
45023,3,13,10,3,4,1
306399,1,0,10,-10,17,1
320403,2,14,0,14,6,0
196817,2,0,10,-10,3,0
155998,2,10,14,-4,2,1
86148,3,28,10,18,5,1
360730,2,17,14,3,7,1
103794,2,6,0,6,13,0
212284,2,7,3,4,10,0
312681,2,28,13,15,3,0
347112,2,10,3,7,1,1
337627,2,14,10,4,14,1
384908,4,13,36,-23,1,1
385792,3,27,3,24,1,0
5928,2,7,23,-16,3,1
135555,3,14,6,8,10,0
255270,4,13,17,-4,12,1
230207,4,3,32,-29,17,1
331737,2,3,20,-17,12,1
415521,1,0,0,0,15,0
17685,3,14,6,8,9,1
117164,2,6,3,3,2,1
60795,2,10,3,7,11,1
216960,1,3,3,0,12,1
333594,4,24,23,1,12,1
214473,4,7,17,-10,11,0
48479,4,27,34,-7,5,1
417654,2,21,3,18,16,0
421857,3,7,13,-6,17,0
14209,4,0,31,-31,7,0
391633,4,17,31,-14,4,1
66174,2,17,3,14,13,1
330174,1,0,0,0,11,1
49397,4,16,20,-4,6,1
205848,3,20,0,20,7,0
218873,2,21,3,18,13,0
345439,3,0,19,-19,17,1
273337,3,28,0,28,2,1
322633,3,3,6,-3,7,1
230708,2,6,27,-21,1,0
136451,3,10,7,3,11,1
110061,4,48,16,32,16,0
168473,4,0,24,-24,7,1
322212,3,0,20,-20,7,1
269489,2,10,10,0,1,1
63891,2,6,21,-15,12,1
21207,1,0,0,0,11,1
136778,3,13,10,3,11,0
163730,2,0,9,-9,5,0
282289,4,25,17,8,6,1
338575,4,29,37,-8,14,0
302525,3,3,13,-10,15,0
288071,2,10,0,10,9,0
261710,3,14,0,14,14,0
134440,2,0,20,-20,10,1
163197,4,33,28,5,5,0
199335,1,0,0,0,4,0
224963,4,9,16,-7,15,1
303599,2,28,13,15,16,0
12964,1,0,0,0,6,1
2592,4,10,20,-10,2,0
104216,1,0,0,0,13,1
304913,1,7,3,4,16,0
196363,2,10,0,10,2,1
12821,2,6,3,3,6,0
308860,3,10,10,0,1,0
82969,3,13,16,-3,4,0
395524,3,21,14,7,6,1
64423,2,0,6,-6,13,1
176790,2,3,7,-4,11,1
315212,3,17,10,7,4,0
170043,4,35,17,18,8,1
32873,4,12,7,5,15,0
175723,3,30,6,24,11,1
380530,3,7,17,-10,16,0
181330,1,0,0,0,13,0
299850,2,10,0,10,14,1
358718,3,14,14,0,6,1
408264,1,0,0,0,12,0
22629,3,23,10,13,11,1
55060,2,13,3,10,8,1
372584,1,7,0,7,13,0
50828,2,7,7,0,6,0
21187,4,0,16,-16,10,0
202063,1,0,0,0,5,0
93286,2,14,3,11,9,1
74815,2,13,6,7,17,0
261905,4,6,27,-21,14,1
75799,4,42,26,16,1,1
369735,3,29,30,-1,11,1
75701,1,14,7,7,1,1
336295,3,17,3,14,13,0
276897,1,7,0,7,4,0
141402,3,10,17,-7,13,0
116469,3,6,16,-10,1,1
51231,4,38,25,13,7,1
999,4,0,6,-6,1,1
80315,2,7,6,1,2,0
297538,3,14,0,14,13,1
385997,1,0,0,0,1,1
257773,1,0,0,0,13,0
22828,1,0,0,0,11,1
352516,2,14,6,8,3,1
246893,1,0,7,-7,8,0
213824,2,35,0,35,10,1
81241,2,7,7,0,3,1
151824,4,28,16,12,17,1
201817,3,13,23,-10,5,1
19045,4,7,6,1,10,0
239591,3,20,10,10,4,0
73816,3,6,0,6,17,1
181975,1,7,0,7,13,0
3928,3,19,14,5,2,0
32140,4,24,21,3,15,0
97114,3,34,6,28,10,0
303405,1,10,0,10,16,1
35382,4,23,23,0,16,1
286705,2,10,7,3,8,1
270701,2,3,3,0,1,1
68721,4,31,0,31,15,1
75774,3,35,26,9,1,0
31435,2,3,0,3,15,0
377999,2,0,7,-7,15,0
3937,3,19,14,5,2,0
387149,3,10,34,-24,2,0
242380,4,34,13,21,6,0
265146,4,20,17,3,16,1
243899,3,16,6,10,6,0
296855,1,0,0,0,13,1
368295,3,9,6,3,11,0
93987,1,0,14,-14,9,1
350467,3,0,12,-12,2,1
319422,1,0,0,0,6,0
133572,1,3,0,3,9,0
130016,2,7,13,-6,8,0
346277,4,40,3,37,1,1
278416,1,0,0,0,4,1
248434,2,10,6,4,8,0
202432,2,3,10,-7,5,1
181527,1,3,0,3,13,1
350138,1,0,0,0,2,1
167628,1,7,13,-6,7,1
97723,4,9,13,-4,11,0
172040,2,7,0,7,9,0
22313,3,0,3,-3,11,0
173446,2,0,7,-7,10,1
369942,1,0,0,0,12,1
2315,4,13,17,-4,1,1
259399,1,0,0,0,13,0
162845,3,6,3,3,5,1
287601,1,0,3,-3,9,1
348449,4,13,32,-19,1,1
237673,3,13,7,6,4,1
410565,2,10,7,3,13,1
170002,3,28,10,18,8,0
57671,4,17,17,0,10,0
360820,4,24,37,-13,7,0
203853,4,34,31,3,6,1
166556,1,6,6,0,6,0
252111,2,7,10,-3,10,0
79653,4,24,21,3,2,1
97586,4,44,7,37,10,0
28713,4,10,13,-3,14,1
79027,3,10,7,3,2,0
92210,1,0,0,0,8,0
198551,5,20,20,0,3,1
133416,1,7,7,0,9,1
127270,1,3,7,-4,6,1
35088,4,15,19,-4,16,0
10346,2,10,34,-24,5,0
266192,2,21,0,21,16,1
395364,3,21,3,18,5,1
159717,2,7,10,-3,3,0
240102,1,6,0,6,5,0
16091,3,33,7,26,8,0
282663,2,6,10,-4,6,0
116627,4,13,3,10,2,1
362473,2,0,6,-6,8,1
279561,3,10,13,-3,5,0
77253,3,16,7,9,1,1
235919,4,10,14,-4,3,1
219985,3,13,27,-14,13,0
389943,2,25,10,15,3,1
163496,1,0,0,0,5,0
160086,4,23,39,-16,3,1
388700,1,0,0,0,3,0
40513,4,7,20,-13,2,1
172360,2,3,21,-18,9,1
353767,5,20,20,0,4,0
31479,3,3,14,-11,15,0
283631,4,20,20,0,7,0
53798,5,10,10,0,8,1
233695,2,7,14,-7,2,0
158302,1,6,7,-1,3,0
281015,2,17,13,4,6,0
410185,4,20,24,-4,13,1
112503,1,0,9,-9,17,1
256796,4,13,13,0,12,0
224759,2,5,3,2,15,1
386973,3,7,21,-14,2,1
194729,2,0,10,-10,2,1
82508,3,10,20,-10,3,0
387975,2,3,0,3,2,0
153780,4,2,27,-25,1,1
378945,4,16,30,-14,15,1
73824,3,13,0,13,17,0
296984,4,29,14,15,13,0
119102,2,7,7,0,3,1
348208,2,6,10,-4,1,1
323515,3,17,10,7,7,1
249884,3,9,20,-11,9,1
44154,4,13,20,-7,3,1
75110,2,7,6,1,17,0
311714,1,0,0,0,2,1
284233,4,9,26,-17,7,1
260799,2,3,12,-9,14,1
398452,2,7,0,7,7,0
379483,4,23,3,20,16,1
21055,4,28,34,-6,10,1
287840,4,28,17,11,9,0
254233,1,0,0,0,11,0
269394,3,7,17,-10,1,1
11312,1,7,0,7,6,0
370234,1,0,7,-7,12,1
5839,4,27,7,20,3,1
232556,4,23,24,-1,1,1
380872,1,0,0,0,16,0
106895,2,9,3,6,14,1
379433,2,7,0,7,16,1
140295,2,14,6,8,12,1
153768,4,2,27,-25,1,1
180617,2,7,6,1,13,1
297486,1,2,0,2,13,0
205865,4,20,0,20,7,0
255588,1,0,0,0,12,1
277877,3,7,17,-10,4,0
132301,3,24,14,10,9,0
178948,2,9,3,6,12,0
112735,2,10,0,10,17,0
287240,4,16,23,-7,8,1
172312,5,30,23,7,9,1
91280,2,7,0,7,8,0
85264,1,0,0,0,5,0
132087,1,7,0,7,9,0
156259,5,24,23,1,2,1
333861,4,27,21,6,12,1
188139,3,10,10,0,16,0
217159,3,3,16,-13,12,0
173035,3,21,6,15,9,1
89936,1,2,7,-5,7,0
45590,2,7,13,-6,4,0
157945,4,16,22,-6,3,0
312954,1,0,0,0,3,0
6034,1,0,7,-7,3,1
104170,4,27,27,0,13,1
234484,3,20,13,7,2,0
102040,2,21,3,18,12,0
244156,1,0,7,-7,6,0
257557,4,19,10,9,13,1
389865,4,31,6,25,3,0
410732,3,17,6,11,13,1
129257,3,17,13,4,7,0
221629,4,20,21,-1,14,1
46979,1,0,0,0,5,0
35406,5,30,30,0,16,0
331778,4,22,27,-5,12,1
342652,1,0,0,0,16,1
172487,1,0,0,0,9,1
159418,3,13,20,-7,3,1
370019,3,10,7,3,12,1
414719,3,3,17,-14,14,0
40392,1,0,0,0,2,1
147575,3,12,0,12,15,0
185666,1,7,0,7,15,0
271700,2,6,3,3,2,1
195671,2,7,10,-3,2,1
420242,1,0,0,0,17,1
309022,3,0,20,-20,1,1
85058,3,31,16,15,4,1
237492,2,14,7,7,3,1
53456,4,10,28,-18,8,0
190528,3,10,13,-3,17,0
244982,3,0,20,-20,7,1
188731,3,0,17,-17,16,1
409402,3,20,3,17,12,0
141880,4,24,21,3,13,0
101222,2,7,7,0,12,1
329167,1,3,3,0,10,1
278321,2,14,7,7,4,1
134806,3,41,17,24,10,1
282052,1,3,8,-5,6,1
279598,4,10,16,-6,5,0
83781,1,0,0,0,4,0
174740,4,9,10,-1,10,0
22496,4,31,29,2,11,0
98803,4,34,8,26,11,1
250802,3,3,9,-6,10,0
393809,1,0,10,-10,5,1
178065,4,20,23,-3,12,1
82668,4,12,13,-1,3,1
6183,1,7,0,7,3,0
229805,1,0,0,0,17,0
307584,1,0,0,0,17,1
28177,1,3,0,3,13,0
7104,2,21,14,7,4,0
184612,1,7,3,4,15,1
339251,2,21,0,21,15,0
28548,3,27,7,20,14,0
248209,4,12,10,2,8,0
64604,3,20,14,6,13,0
161389,1,0,0,0,4,1
157313,4,19,3,16,2,0
35193,3,0,14,-14,16,0
348889,4,9,14,-5,2,0
56698,2,0,7,-7,9,1
409412,3,20,3,17,12,1
358647,1,0,0,0,6,0
307278,1,7,3,4,17,1
79436,2,9,7,2,2,0
75304,3,14,26,-12,17,0
102382,4,16,26,-10,13,0
66074,3,10,3,7,13,0
48778,4,17,28,-11,5,1
203401,4,27,33,-6,6,0
50657,1,0,0,0,6,0
280861,3,10,3,7,6,1
237534,3,24,7,17,3,1
398037,2,14,14,0,7,0
374271,2,7,10,-3,13,0
97448,1,0,0,0,10,0
417212,3,17,17,0,16,0
69196,4,20,17,3,15,0
173045,3,21,6,15,9,1
320047,4,49,36,13,6,1
362205,2,6,3,3,8,0
344169,4,35,11,24,17,0
253205,2,0,7,-7,11,0
57508,3,21,10,11,10,1
126405,4,20,17,3,6,1
126510,2,0,6,-6,6,1
16930,2,27,13,14,8,0
328741,2,7,6,1,10,1
29777,4,41,3,38,14,0
85872,4,20,29,-9,5,1
358358,1,6,7,-1,6,1
15601,2,14,10,4,8,1
27796,3,14,14,0,13,1
130368,3,7,3,4,8,0
133471,3,20,17,3,9,1
253501,1,0,7,-7,11,1
357171,4,12,20,-8,5,1
254595,3,7,14,-7,11,0
321352,4,29,22,7,6,0
104768,2,20,16,4,14,0
216593,4,43,18,25,12,0
115218,1,0,3,-3,1,1
39394,2,0,3,-3,1,1
271396,1,7,0,7,1,1
387514,1,3,0,3,2,0
414590,4,21,9,12,14,1
327695,2,3,10,-7,10,0
47620,1,3,14,-11,5,0
104362,3,45,31,14,13,0
97894,4,21,27,-6,11,0
171610,2,6,3,3,9,0
378207,4,34,16,18,15,1
387733,4,0,23,-23,2,0
294965,3,17,7,10,12,0
318765,4,17,23,-6,5,0
42320,1,0,9,-9,2,0
315681,3,10,13,-3,4,0
82076,4,20,10,10,3,0
216437,1,7,0,7,12,1
379308,2,0,6,-6,16,1
390906,4,15,31,-16,3,0
341088,3,14,17,-3,15,0
69905,4,27,16,11,15,1
421011,4,14,28,-14,17,1
297338,2,3,10,-7,13,1
94834,3,6,13,-7,9,0
147085,2,7,23,-16,15,0
345298,4,19,17,2,17,0
9080,4,28,13,15,4,1
273856,4,17,14,3,2,1
253032,1,0,0,0,11,1
371660,4,24,17,7,12,0
361827,3,37,10,27,7,1
305566,3,13,0,13,17,0
144439,3,3,26,-23,14,1
260969,3,10,3,7,14,1
51381,4,22,23,-1,7,0
307022,2,10,0,10,17,0
209370,2,7,7,0,8,0
266619,2,10,0,10,16,0
250756,2,3,0,3,10,0
42700,4,7,13,-6,3,0
212971,4,14,7,7,10,1
39275,3,3,13,-10,1,0
345719,3,7,7,0,17,1
26415,2,10,10,0,13,1
14929,3,14,17,-3,7,0
98471,3,23,14,9,11,1
38157,1,0,0,0,1,1
229526,2,17,6,11,17,0
357438,4,31,30,1,5,1
212034,3,10,37,-27,9,0
126808,2,0,6,-6,6,1
236695,3,17,7,10,3,1
82152,2,9,3,6,3,1
286501,1,3,0,3,8,0
68618,1,7,0,7,15,0
121588,4,22,13,9,4,0
77515,2,7,14,-7,1,1
103255,3,3,10,-7,13,0
272417,3,31,3,28,2,0
227002,2,3,6,-3,16,1
71925,3,15,13,2,16,0
286201,1,0,0,0,8,0
357474,1,0,0,0,5,0
160728,4,10,10,0,4,1
350271,1,7,0,7,2,1
85927,2,7,14,-7,5,0
193282,4,3,20,-17,1,0
167979,2,0,14,-14,7,1
327715,3,6,10,-4,10,0
232991,3,10,10,0,2,1
29987,2,17,0,17,14,0
246046,2,10,13,-3,7,0
201613,2,7,10,-3,5,1
401619,4,24,31,-7,8,0
86605,4,40,3,37,5,0
109503,1,0,0,0,16,1
284370,4,14,17,-3,7,0
154667,4,31,28,3,1,1
76734,1,0,0,0,1,1
390908,4,15,31,-16,3,1
21374,1,0,7,-7,11,1
385590,3,3,17,-14,1,1
255786,2,10,0,10,12,0
202982,1,14,0,14,5,0
390156,4,20,35,-15,3,1
335268,2,0,3,-3,13,1
394678,4,24,21,3,5,1
150820,1,0,0,0,17,0
283987,2,0,0,0,7,1
277181,1,0,0,0,4,0
405980,4,14,7,7,11,1
273741,1,0,7,-7,2,1
291243,2,7,6,1,10,0
349219,4,27,21,6,2,0
179093,2,6,6,0,12,0
271223,4,21,23,-2,1,0
54744,1,3,0,3,8,0
235764,4,13,27,-14,3,1
46455,2,7,6,1,4,1
421232,2,6,7,-1,17,1
280734,3,14,6,8,5,0
65991,1,0,0,0,13,1
249179,1,9,0,9,9,0
384713,3,13,23,-10,1,1
180256,1,0,0,0,13,1
336433,3,10,10,0,14,0
2776,1,7,0,7,2,0
292660,4,22,16,6,11,1
57080,4,14,27,-13,9,0
33465,1,0,0,0,16,0
290855,4,17,21,-4,10,0
290841,3,17,21,-4,10,1
315988,3,0,24,-24,4,0
308304,4,16,23,-7,1,1
41388,4,14,15,-1,2,1
419060,4,10,20,-10,16,0
30801,4,31,35,-4,15,0
260237,3,10,3,7,14,1
396781,4,7,20,-13,6,1
353168,4,20,29,-9,3,1
151577,1,0,3,-3,17,0
327075,1,0,0,0,9,1
411844,4,7,34,-27,13,0
368887,3,31,3,28,11,1
419127,2,10,0,10,16,0
264514,1,7,7,0,16,0
252472,2,7,19,-12,10,0
107452,2,0,10,-10,15,0
417156,1,0,10,-10,16,1
329240,3,17,13,4,10,1
214720,2,3,7,-4,11,1
202689,1,3,7,-4,5,1
318721,2,10,23,-13,5,0
361979,4,20,6,14,7,0
202088,2,13,0,13,5,1
147614,4,15,0,15,15,1
239361,1,0,7,-7,4,1
362997,4,33,16,17,8,0
386176,2,3,3,0,2,1
321741,2,6,6,0,7,1
256425,3,9,21,-12,12,0
325010,2,20,21,-1,8,0
26538,1,3,3,0,13,0
215002,2,10,0,10,11,0
373502,2,0,10,-10,13,0
51035,3,0,17,-17,6,0
83915,4,23,24,-1,4,1
248546,5,23,26,-3,8,1
276747,1,13,0,13,4,1
88141,1,6,3,3,6,1
66103,4,10,6,4,13,1
233799,4,19,37,-18,2,0
38854,4,3,10,-7,1,0
47100,4,31,10,21,5,1
309675,2,3,3,0,1,0
309912,4,24,21,3,1,0
52723,4,6,23,-17,7,1
76675,3,13,7,6,1,1
119050,4,7,36,-29,3,1
25664,2,7,7,0,12,1
49101,4,13,20,-7,6,1
82350,3,13,10,3,3,1
298045,1,0,13,-13,13,0
377147,3,10,10,0,15,1
184533,3,27,14,13,14,1
202857,2,14,0,14,5,0
26025,4,10,19,-9,13,1
252088,1,0,0,0,10,0
390434,4,14,27,-13,3,0
237571,4,38,22,16,3,1
39374,1,0,0,0,1,0
300185,3,21,3,18,14,1
146138,4,25,17,8,15,1
77388,3,14,14,0,1,0
358698,2,7,7,0,6,1
323344,2,7,0,7,7,1
334443,4,17,10,7,13,0
83727,3,22,20,2,4,0
53448,4,10,28,-18,8,0
382201,1,3,3,0,17,0
375483,3,19,7,12,14,1
397928,3,7,9,-2,7,1
51450,2,10,24,-14,7,1
64952,4,10,6,4,13,0
419658,4,30,23,7,17,1
385340,4,17,20,-3,1,0
314483,2,14,0,14,3,1
336128,2,10,3,7,13,0
19844,2,10,7,3,10,0
332863,2,7,0,7,12,1
282755,1,0,0,0,6,0
140827,1,7,0,7,13,0
332210,4,10,16,-6,12,0
151718,1,7,0,7,17,0
279100,2,21,10,11,5,0
406922,1,0,6,-6,11,0
116865,2,7,7,0,2,0
308815,2,3,3,0,1,1
89312,5,15,15,0,7,1
267523,2,13,21,-8,17,1
325550,1,0,0,0,9,1
55406,2,13,10,3,9,1
112792,4,27,10,17,17,0
141688,3,23,21,2,13,1
221192,4,0,23,-23,14,1
265256,4,9,6,3,16,1
270788,1,0,0,0,1,1
328554,1,7,0,7,10,0
221739,3,10,7,3,14,1
385155,3,14,17,-3,1,0
261102,3,7,21,-14,14,1
138547,5,31,37,-6,12,0
243664,1,0,0,0,6,0
183457,4,27,6,21,14,1
67362,3,27,6,21,14,1
20327,2,10,13,-3,10,0
414592,4,21,9,12,14,1
320692,2,14,17,-3,6,0
104891,2,0,3,-3,14,1
19117,1,7,3,4,10,0
246031,2,7,12,-5,7,0
414798,1,0,0,0,15,1
220117,3,26,6,20,13,1
15172,2,3,0,3,8,1
272545,2,13,3,10,2,0
80703,4,32,26,6,3,0
229427,3,10,6,4,17,0
154503,4,14,17,-3,1,1
188349,1,0,0,0,16,0
400095,3,17,23,-6,8,1
216433,1,7,0,7,12,1
162116,4,48,13,35,4,1
344816,2,14,10,4,17,1
395600,1,0,3,-3,6,0
3829,4,23,10,13,2,1
245534,2,34,0,34,7,0
136944,4,3,13,-10,11,1
364009,3,6,12,-6,8,1
132474,4,8,30,-22,9,0
10899,1,3,7,-4,5,0
193009,4,17,20,-3,1,1
23551,4,17,17,0,11,0
208175,3,0,3,-3,8,0
199512,2,17,0,17,4,0
368677,2,7,10,-3,11,1
64680,1,14,0,14,13,1
146401,3,10,3,7,15,1
267924,1,0,0,0,17,1
386984,3,7,21,-14,2,1
248462,3,10,6,4,8,0
106561,1,14,0,14,14,1
37051,2,13,0,13,17,0
116112,2,0,0,0,1,0
120997,2,5,21,-16,3,1
190471,1,7,0,7,17,1
30551,2,10,0,10,14,0
56872,2,7,0,7,9,1
266773,2,0,14,-14,16,0
198450,2,10,3,7,3,1
62335,4,21,22,-1,12,1
401122,3,27,13,14,8,1
251823,2,7,7,0,10,0
184737,1,0,0,0,15,1
38143,5,9,9,0,1,0
351896,1,0,0,0,3,1
131203,2,7,10,-3,8,1
59283,1,0,0,0,11,1
371678,1,0,0,0,12,1
208594,2,6,0,6,8,0
158712,4,31,7,24,3,0
339935,4,33,7,26,15,1
145536,4,26,20,6,14,1
324428,3,14,3,11,8,0
73875,1,0,0,0,17,0
120124,3,10,3,7,3,1
110516,4,20,13,7,16,1
356277,1,7,0,7,5,0
95998,2,6,6,0,10,0
305397,2,17,3,14,17,1
174380,3,17,3,14,10,0
19744,3,9,9,0,10,0
29457,3,7,14,-7,14,1
72982,4,38,15,23,16,1
83217,2,3,7,-4,4,1
51403,1,3,0,3,7,0
395443,1,0,0,0,6,1
375531,4,33,14,19,14,0
275954,4,20,21,-1,3,0
383980,2,0,13,-13,1,1
124472,4,16,17,-1,5,1
279312,4,26,23,3,5,1
5884,1,0,3,-3,3,1
179139,3,12,13,-1,12,1
365996,2,23,7,16,10,0
144140,4,23,7,16,14,0
112275,3,24,17,7,17,1
40538,1,7,0,7,2,0
252025,3,14,20,-6,10,1
207477,3,21,14,7,7,1
247829,1,0,3,-3,8,1
227604,2,28,0,28,16,0
358348,1,6,0,6,6,0
326256,4,10,48,-38,9,1
331857,2,0,0,0,12,0
75212,1,0,0,0,17,1
98965,4,7,24,-17,11,0
158967,3,14,22,-8,3,0
93771,4,3,16,-13,9,0
49140,1,3,0,3,6,1
206229,2,0,3,-3,7,0
187694,3,13,6,7,16,0
124681,2,0,3,-3,5,1
281102,1,0,0,0,6,0
254365,4,13,30,-17,11,1
333787,2,6,14,-8,12,1
16867,1,0,7,-7,8,1
36379,3,13,19,-6,17,1
363959,2,0,9,-9,8,1
246056,3,16,13,3,7,0
404457,2,14,7,7,10,0
80766,2,3,0,3,3,0
77917,1,0,0,0,1,1
412093,4,31,3,28,13,1
399547,4,0,33,-33,7,1
261058,2,0,14,-14,14,1
412800,2,14,24,-10,14,1
21453,3,12,14,-2,11,0
332937,4,31,3,28,12,0
200321,4,27,14,13,4,1
7915,3,3,20,-17,4,1
165058,3,10,17,-7,6,1
90892,3,34,7,27,7,1
66551,4,38,31,7,14,0
271434,2,14,0,14,1,1
147320,4,7,31,-24,15,0
59644,3,21,3,18,11,0
421072,2,6,3,3,17,1
54625,2,14,13,1,8,1
143243,3,10,16,-6,13,1
279836,2,7,13,-6,5,1
144154,4,23,13,10,14,0
104679,4,7,3,4,14,0
382642,2,0,0,0,17,1
43549,3,17,3,14,3,1
354888,5,41,42,-1,4,1
286505,1,3,0,3,8,0
257024,2,0,14,-14,12,1
248471,3,10,6,4,8,1
101983,1,0,0,0,12,1
265009,1,0,0,0,16,1
236240,4,27,22,5,3,0
112599,3,31,26,5,17,0
51360,4,19,20,-1,7,0
130404,4,7,6,1,8,0
130242,4,3,26,-23,8,1
10355,3,10,35,-25,5,1
278591,1,7,0,7,4,1
101430,3,15,7,8,12,1
163918,3,23,10,13,5,0
116048,4,13,7,6,1,1
399637,3,13,6,7,8,0
337542,4,7,33,-26,14,1
187884,4,7,23,-16,16,0
153479,4,23,17,6,1,0
335829,2,7,7,0,13,0
89156,1,0,0,0,7,1
340676,3,16,13,3,15,0
194802,4,10,23,-13,2,0
347305,3,7,14,-7,1,1
252712,4,6,10,-4,10,1
310974,4,9,36,-27,2,0
38893,1,0,0,0,1,0
52323,1,3,0,3,7,0
123720,1,7,0,7,5,0
292943,4,10,0,10,11,1
310065,4,9,13,-4,2,0
133411,1,7,7,0,9,0
363613,4,18,15,3,8,0
217569,2,3,9,-6,12,0
227468,3,13,10,3,16,1
136602,3,15,16,-1,11,0
2374,2,7,10,-3,2,1
55486,1,0,0,0,9,1
110796,3,6,10,-4,16,0
126597,4,23,13,10,6,0
225734,1,3,0,3,16,0
17758,1,0,0,0,9,1
328057,4,17,17,0,10,1
148112,1,0,0,0,16,0
262047,4,24,31,-7,14,0
394587,2,14,0,14,5,0
266983,3,19,17,2,17,1
175536,2,17,0,17,11,0
196410,3,17,7,10,2,1
281765,1,0,0,0,6,1
359310,2,3,13,-10,6,1
15602,2,14,10,4,8,1
337893,2,10,0,10,14,0
126426,4,33,24,9,6,1
38787,2,3,10,-7,1,0
324517,1,0,7,-7,8,1
314489,2,14,0,14,3,0
370104,1,7,0,7,12,0
201334,3,28,13,15,5,0
4817,4,27,3,24,3,0
62682,1,0,0,0,12,1
55798,2,0,7,-7,9,1
409179,1,0,0,0,12,0
126872,3,17,6,11,6,1
385729,1,7,0,7,1,1
67287,1,7,0,7,14,1
404060,3,10,35,-25,10,0
87280,3,17,17,0,6,1
260782,2,3,6,-3,14,0
359764,3,24,16,8,6,1
144890,3,14,7,7,14,1
46710,1,7,0,7,4,0
23710,4,12,33,-21,12,0
367154,3,29,16,13,10,0
65505,4,23,14,9,13,1
197480,3,13,9,4,3,1
48651,1,0,0,0,5,1
273233,4,40,7,33,2,1
80713,4,32,33,-1,3,1
366775,4,34,10,24,10,1
233841,1,7,3,4,2,0
407105,2,7,20,-13,11,0
224145,2,0,20,-20,15,0
158920,2,14,9,5,3,1
348355,2,10,7,3,1,0
159232,2,14,24,-10,3,1
877,1,0,0,0,1,0
42438,1,0,0,0,3,0
154004,2,7,14,-7,1,1
377226,2,7,0,7,15,1
16150,4,40,17,23,8,1
211950,2,0,3,-3,9,0
56996,1,0,10,-10,9,1
340655,3,16,10,6,15,0
66163,1,10,0,10,13,1
86349,4,27,30,-3,5,1
369132,2,13,7,6,11,0
301840,1,0,0,0,15,1
405756,3,10,7,3,10,1
126205,3,21,6,15,6,0
35798,3,3,10,-7,17,0
49560,4,14,3,11,6,0
138559,5,31,37,-6,12,1
99624,2,7,3,4,11,1
282702,3,6,20,-14,6,1
66791,3,10,6,4,14,1
367036,4,10,38,-28,10,0
227226,1,0,0,0,16,0
244820,2,7,3,4,7,0
40645,4,34,7,27,2,1
186089,4,31,55,-24,15,1
273462,2,7,10,-3,2,1
29524,1,0,7,-7,14,0
285424,2,24,0,24,8,1
161555,2,6,3,3,4,0
258369,1,7,0,7,13,0
237810,2,0,10,-10,4,0
30256,1,3,7,-4,14,0
91881,1,0,0,0,8,0
294435,4,19,12,7,12,0
74449,4,13,23,-10,17,1
253804,1,0,0,0,11,0
254154,3,3,12,-9,11,0
46005,1,7,7,0,4,0
5196,2,7,3,4,3,0
94091,4,6,31,-25,9,1
346849,3,16,3,13,1,0
236857,4,6,12,-6,3,1
333976,3,17,10,7,12,1
420626,2,13,13,0,17,0
241988,2,7,0,7,5,0
185370,2,0,3,-3,15,1
187621,1,0,0,0,16,1
105905,4,19,13,6,14,1
256601,3,14,0,14,12,1
364023,4,6,12,-6,8,0
16489,2,13,7,6,8,0
90139,2,3,0,3,7,1
366851,2,3,6,-3,10,1
82978,4,13,16,-3,4,0
332016,2,0,3,-3,12,1
12247,2,0,3,-3,6,1
218898,3,21,16,5,13,0
89009,1,0,0,0,6,1
79803,4,28,14,14,2,0
189520,4,20,0,20,17,1
367966,2,3,14,-11,11,1
23776,2,10,0,10,12,0
137048,2,7,3,4,11,0
22184,3,10,15,-5,11,0
413539,2,0,10,-10,14,1
322417,4,17,26,-9,7,0
235991,2,10,0,10,3,0
170327,4,0,15,-15,8,1
382468,4,0,31,-31,17,0
158209,3,17,0,17,3,1
310970,4,9,30,-21,2,0
257748,4,3,24,-21,13,0
227249,1,3,10,-7,16,0
89789,1,3,0,3,7,1
15764,2,0,5,-5,8,1
94420,4,17,24,-7,9,1
328528,4,15,3,12,10,0
195509,2,3,0,3,2,0
402946,1,0,7,-7,9,1
372985,4,28,13,15,13,0
195902,1,0,7,-7,2,0
87228,1,7,7,0,6,0
317003,1,0,10,-10,4,1
421141,3,30,16,14,17,0
212155,2,3,17,-14,10,0
213680,3,14,17,-3,10,0
131109,3,20,9,11,8,0
34766,4,20,3,17,16,1
292508,4,10,12,-2,11,1
153302,3,2,10,-8,1,0
126854,3,10,6,4,6,1
98981,1,0,0,0,11,1
265125,4,20,10,10,16,0
246861,5,20,20,0,8,0
148849,4,16,23,-7,16,0
374387,2,9,0,9,14,0
261264,3,38,0,38,14,0
286365,1,0,0,0,8,1
9843,1,0,0,0,5,0
152326,2,7,0,7,17,0
310122,2,14,0,14,2,0
275246,1,3,0,3,3,1
335962,2,0,15,-15,13,0
383915,1,0,0,0,1,0
152703,4,27,6,21,17,0
259799,4,20,13,7,14,0
377616,4,20,12,8,15,1
191602,5,24,24,0,17,1
236698,3,24,7,17,3,0
104793,3,27,26,1,14,0
136824,4,20,13,7,11,0
302531,3,3,13,-10,15,0
269854,4,22,10,12,1,1
358772,4,14,20,-6,6,1
37868,1,0,0,0,1,1
130285,1,0,0,0,8,0
10906,1,6,7,-1,5,0
171992,4,21,28,-7,9,0
412023,2,7,0,7,13,1
15407,4,10,31,-21,8,1
411382,4,20,13,7,13,1
194638,3,24,7,17,2,0
379197,3,9,10,-1,16,0
241400,2,7,28,-21,5,1
319260,1,0,3,-3,6,1
208720,1,0,0,0,8,0
63948,4,6,27,-21,12,0
298418,3,7,21,-14,14,0
35043,3,9,10,-1,16,1
43908,1,0,6,-6,3,0
9303,2,7,0,7,5,1
275015,2,24,3,21,3,1
63931,4,6,24,-18,12,0
368432,3,23,7,16,11,0
306220,4,20,3,17,17,1
385284,3,7,6,1,1,0
369461,4,45,7,38,11,0
2029,4,21,15,6,1,1
373988,2,10,0,10,13,0
278362,3,17,14,3,4,0
168658,1,0,0,0,7,1
224793,3,8,10,-2,15,1
187600,4,13,30,-17,16,1
284691,4,17,34,-17,7,1
364654,1,0,0,0,9,1
143890,1,0,0,0,14,0
2292,4,10,10,0,1,1
207125,1,7,0,7,7,0
44104,2,0,13,-13,3,0
30937,4,16,24,-8,15,1
320312,4,14,24,-10,6,1
69370,1,0,0,0,15,0
171587,1,3,3,0,9,1
98445,3,17,7,10,11,1
284633,3,14,17,-3,7,0
198241,4,16,9,7,3,1
126052,2,7,3,4,6,0
71759,3,24,23,1,16,1
312183,1,0,7,-7,2,1
11066,2,10,7,3,5,0
144129,3,23,7,16,14,1
150559,2,3,3,0,17,0
164446,2,14,0,14,5,0
418222,1,0,0,0,16,1
253772,4,24,10,14,11,0
336607,4,7,0,7,14,0
387492,1,0,0,0,2,1
88617,2,20,7,13,6,1
260201,2,10,0,10,14,0
76659,3,10,0,10,1,1
198907,2,3,16,-13,3,1
94089,4,6,31,-25,9,1
36452,1,0,3,-3,17,0
270111,3,17,10,7,1,1
321697,1,0,3,-3,7,1
26898,3,10,6,4,13,0
207324,3,10,14,-4,7,1
344233,2,7,10,-3,17,0
114472,2,10,10,0,1,0
47305,2,0,7,-7,5,0
318291,3,6,7,-1,5,1
408441,2,0,0,0,12,1
15077,3,10,26,-16,7,0
334055,1,0,0,0,13,1
10319,2,7,14,-7,5,1
365867,2,7,13,-6,9,0
224947,3,3,9,-6,15,0
231324,3,9,10,-1,1,0
23622,2,7,10,-3,12,0
323753,1,6,0,6,8,0
79043,3,10,14,-4,2,1
404595,2,0,10,-10,10,0
286936,4,23,19,4,8,1
147326,1,0,0,0,15,1
355343,4,14,26,-12,4,1
252487,3,10,22,-12,10,1
251265,3,13,24,-11,10,0
403758,3,12,13,-1,9,1
118102,2,3,13,-10,2,1
194977,4,14,22,-8,2,1
118345,1,0,0,0,2,1
290943,2,17,7,10,10,0
310455,3,14,3,11,2,0
30621,3,17,3,14,14,1
410845,2,14,3,11,13,0
293149,1,0,0,0,11,0
303538,1,0,0,0,16,0
101550,2,13,21,-8,12,0
241667,2,0,0,0,5,0
283572,2,6,17,-11,7,1
277675,1,7,0,7,4,1
109559,2,3,7,-4,16,0
74498,2,0,0,0,17,0
256220,1,6,0,6,12,0
258213,1,0,0,0,13,0
314168,2,7,20,-13,3,1
22645,4,23,10,13,11,1
31138,2,3,10,-7,15,0
25662,2,7,7,0,12,1
337620,2,14,7,7,14,0
243296,3,7,10,-3,6,1
45808,4,13,14,-1,4,1
218924,3,41,24,17,13,0
322357,3,14,7,7,7,0
331635,4,23,30,-7,11,0
178893,1,0,0,0,12,0
83918,4,23,24,-1,4,1
295157,4,10,21,-11,12,1
253345,1,7,0,7,11,1
5404,3,20,16,4,3,0
322738,1,3,14,-11,7,0
171076,4,17,37,-20,8,0
89142,4,23,6,17,6,1
43198,2,14,7,7,3,0
235252,2,15,6,9,3,1
355898,3,20,10,10,5,1
145746,2,7,10,-3,15,0
131097,2,20,6,14,8,1
14238,1,0,0,0,7,0
347321,3,7,21,-14,1,0
22036,3,17,17,0,11,1
249861,2,6,17,-11,9,1
402972,2,7,14,-7,9,1
161330,4,20,19,1,4,1
89399,3,10,20,-10,7,0
70463,3,17,17,0,15,1
345833,1,0,7,-7,17,0
183285,4,16,20,-4,14,0
141302,1,0,7,-7,13,0
234849,3,0,12,-12,2,1
212065,4,23,40,-17,9,1
261732,4,14,7,7,14,0
35366,4,23,16,7,16,0
303260,2,10,0,10,16,0
130384,3,7,6,1,8,1
52937,2,14,7,7,7,0
383889,4,3,10,-7,1,1
317715,4,23,16,7,5,0
382273,3,17,3,14,17,1
331164,3,7,13,-6,11,1
105464,1,0,0,0,14,1
364426,3,35,14,21,9,0
89830,2,6,6,0,7,1
284687,4,17,27,-10,7,0
338458,1,7,0,7,14,0
255210,2,13,14,-1,12,1
354754,2,6,9,-3,4,1
371473,3,14,17,-3,12,0
50273,3,13,14,-1,6,0
6231,2,13,0,13,3,0
112389,2,10,13,-3,17,1
294298,1,7,0,7,12,0
151595,2,0,3,-3,17,0
105019,1,0,7,-7,14,1
253998,2,0,6,-6,11,0
11197,2,7,7,0,6,0
385880,1,0,0,0,1,0
366582,3,20,14,6,10,0
67902,3,19,3,16,14,0
267722,4,14,34,-20,17,1
385220,1,0,3,-3,1,1
278279,1,7,0,7,4,0
180211,4,19,7,12,13,0
149959,2,13,3,10,16,1
259232,4,28,32,-4,13,1
66029,2,7,0,7,13,1
282355,2,7,13,-6,6,1
83733,4,22,23,-1,4,0
300364,4,10,7,3,14,0
291528,1,3,0,3,11,0
10704,4,17,17,0,5,1
12532,2,0,17,-17,6,1
232291,1,3,0,3,1,0
285837,4,14,27,-13,8,0
113501,4,3,7,-4,17,0
44592,3,10,14,-4,3,1
46186,2,14,14,0,4,1
203464,2,14,3,11,6,1
97363,2,9,6,3,10,0
82925,2,3,3,0,4,0
247687,2,7,6,1,8,0
45544,1,0,0,0,4,0
217863,2,10,21,-11,12,1
31162,2,23,20,3,15,1
107808,3,7,20,-13,15,1
272243,3,6,3,3,2,0
321011,3,10,7,3,6,1
288488,1,3,0,3,9,0
43278,4,24,10,14,3,1
44052,1,0,0,0,3,0
317913,1,7,0,7,5,1
372209,4,9,16,-7,13,0
348379,3,13,10,3,1,0
23330,2,6,10,-4,11,1
193468,4,23,20,3,1,1
200804,4,31,17,14,4,1
123485,2,0,0,0,4,0
23902,2,3,0,3,12,1
216021,1,7,12,-5,11,1
402715,2,10,0,10,9,1
222533,4,17,14,3,14,0
389828,4,24,6,18,3,0
194678,4,34,10,24,2,1
22962,4,3,32,-29,11,1
142225,5,11,13,-2,13,1
15685,4,37,10,27,8,0
246568,4,36,7,29,8,0
76584,1,0,0,0,1,1
171746,1,3,7,-4,9,0
212120,2,3,7,-4,10,0
88758,2,6,3,3,6,0
285733,1,0,3,-3,8,1
351468,1,0,10,-10,3,1
310538,4,26,9,17,2,1
368243,2,3,3,0,11,0
126561,3,13,6,7,6,1
84832,1,0,0,0,4,0
129336,1,13,7,6,7,1
19779,4,12,12,0,10,0
210796,4,24,10,14,9,0
195707,4,14,13,1,2,0
187125,3,10,0,10,16,1
413948,1,3,7,-4,14,0
67035,2,7,3,4,14,1
52447,1,0,0,0,7,1
81874,2,0,24,-24,3,0
148990,4,13,12,1,16,1
326956,2,2,7,-5,9,1
38807,3,3,10,-7,1,0
319189,3,9,10,-1,5,0
68641,2,7,0,7,15,0
255564,4,30,7,23,12,0
302846,4,12,23,-11,15,0
138116,1,7,0,7,11,0
388286,2,3,3,0,2,1
75783,4,35,26,9,1,1
209946,1,0,0,0,8,1
366916,4,3,16,-13,10,0
218683,1,0,0,0,13,0
39770,4,9,7,2,1,0
304410,4,31,21,10,16,0
332199,3,10,16,-6,12,1
80683,4,17,26,-9,3,0
199595,4,41,17,24,4,1
244946,2,0,20,-20,7,1
266231,3,24,13,11,16,1
224403,1,0,0,0,15,0
82133,2,3,0,3,3,0
387408,3,21,10,11,2,0
186930,2,7,6,1,15,0
96725,2,0,10,-10,10,0
309259,2,0,7,-7,1,0
416026,2,7,3,4,15,1
91511,3,19,3,16,8,0
245276,3,9,3,6,7,1
254316,3,6,19,-13,11,0
340501,2,0,34,-34,15,1
179561,2,0,23,-23,12,1
377935,1,0,0,0,15,0
401512,1,0,7,-7,8,1
32872,4,12,7,5,15,0
90985,1,3,0,3,7,0
225928,2,20,7,13,16,1
325695,4,34,14,20,9,0
389531,4,20,17,3,3,1
148485,3,21,3,18,16,1
31208,4,23,27,-4,15,0
66642,3,7,17,-10,14,1
267393,3,0,10,-10,17,1
246312,2,7,3,4,7,1
216817,2,0,7,-7,12,1
136645,4,15,19,-4,11,1
265927,3,0,16,-16,16,0
296515,4,26,3,23,13,0
238318,1,3,9,-6,4,1
260567,4,27,8,19,14,1
344310,4,19,13,6,17,1
218948,4,48,27,21,13,1
126356,3,7,14,-7,6,0
342012,4,20,3,17,16,1
148212,4,16,21,-5,16,0
93584,2,6,3,3,9,0
329562,4,45,21,24,10,1
371339,3,35,10,25,12,1
386041,2,7,0,7,1,1
202120,2,13,3,10,5,0
196874,4,10,20,-10,3,0
43410,4,21,24,-3,3,0
373901,4,37,16,21,13,0
11007,4,9,31,-22,5,0
108701,3,33,13,20,15,1
12327,1,0,0,0,6,1
153409,2,13,10,3,1,0
74191,1,3,0,3,17,1
186567,1,0,0,0,15,1
110560,1,10,0,10,16,0
74717,4,7,17,-10,17,1
403655,4,30,20,10,9,1
415275,2,0,6,-6,15,0
419348,4,3,17,-14,16,0
137556,3,17,27,-10,11,1
238688,3,16,17,-1,4,0
50753,4,21,14,7,6,0
375371,3,14,24,-10,14,1
144021,4,21,16,5,14,1
237901,4,14,27,-13,4,1
64675,1,14,0,14,13,0
6406,3,9,13,-4,3,0
233268,2,0,3,-3,2,1
283538,1,6,7,-1,7,1
101312,4,17,23,-6,12,0
318802,1,0,0,0,5,1
71663,4,3,34,-31,16,1
332974,1,0,0,0,12,0
158908,2,14,3,11,3,1
297920,2,10,0,10,13,1
126209,3,21,6,15,6,0
38553,3,24,6,18,1,1
396356,1,14,6,8,6,0
379692,1,3,0,3,16,1
66052,3,7,0,7,13,0
170186,4,24,27,-3,8,0
356092,4,34,16,18,5,0
28828,2,10,7,3,14,1
235988,2,10,0,10,3,0
155736,4,20,20,0,2,0
255307,1,6,0,6,12,1
219770,2,21,0,21,13,0
67143,1,0,0,0,14,1
69323,4,19,3,16,15,1
400051,2,14,3,11,8,0
154834,1,0,0,0,1,1
206149,4,26,19,7,7,1
69704,2,10,7,3,15,0
401230,2,7,7,0,8,0
89231,3,6,0,6,7,1
207411,2,7,0,7,7,0
307715,1,0,0,0,1,1
334871,3,24,10,14,13,1
327520,2,7,7,0,10,0
407770,4,10,7,3,11,0
321212,4,3,19,-16,6,1
146090,3,19,10,9,15,1
123527,3,10,10,0,4,1
341912,1,0,0,0,16,0
305106,2,21,10,11,16,0
53303,4,10,10,0,8,1
404313,2,0,6,-6,10,1
317762,1,0,0,0,5,1
19381,1,0,0,0,10,0
226492,4,14,10,4,16,1
9521,4,13,13,0,5,1
369539,2,11,0,11,11,0
395615,2,7,10,-3,6,1
401772,1,0,0,0,9,1
137331,1,3,0,3,11,1
266123,4,17,13,4,16,0
191346,1,0,14,-14,17,0
239207,4,27,27,0,4,1
300230,4,38,10,28,14,0
396971,2,7,3,4,6,1
62984,2,6,7,-1,12,0
172213,2,7,6,1,9,0
279286,4,19,16,3,5,0
188109,2,0,10,-10,16,1
56691,1,0,0,0,9,0
253287,4,9,13,-4,11,1
62568,2,3,7,-4,12,0
243236,2,0,7,-7,6,1
388949,3,17,20,-3,3,0
106880,2,9,0,9,14,0
170214,1,0,0,0,8,0
119647,4,17,12,5,3,1
237961,1,3,3,0,4,1
68518,2,0,21,-21,14,1
230443,3,21,11,10,1,1
116004,2,13,0,13,1,0
143513,3,17,21,-4,14,0
54213,3,0,3,-3,8,1
173956,4,20,19,1,10,1
203712,4,22,37,-15,6,1
252035,3,14,20,-6,10,0
238487,2,6,0,6,4,1
139284,3,13,13,0,12,0
257224,3,19,16,3,12,0
377560,3,10,9,1,15,1
288205,2,3,7,-4,9,1
18810,1,0,0,0,9,1
223561,4,17,13,4,15,1
142252,1,0,0,0,13,1
73638,2,3,0,3,17,1
132272,3,21,7,14,9,1
153271,3,2,7,-5,1,1
260112,4,6,28,-22,14,1
163652,4,21,36,-15,5,1
117353,3,21,0,21,2,0
303247,1,3,0,3,16,1
95836,3,6,10,-4,10,0
175382,2,14,3,11,11,1
145650,3,28,7,21,14,1
42784,2,6,21,-15,3,1
367060,4,10,38,-28,10,0
391288,2,14,3,11,4,1
80454,1,2,0,2,3,0
384967,2,14,6,8,1,0
14039,3,3,21,-18,7,0
85174,2,7,10,-3,4,1
315251,4,20,16,4,4,0
323673,3,20,0,20,8,0
380823,3,9,24,-15,16,0
81859,2,0,21,-21,3,0
302305,1,7,3,4,15,0
393700,2,0,7,-7,5,1
223025,1,7,0,7,14,0
404013,2,3,14,-11,10,0
235588,4,27,13,14,3,1
313600,3,12,23,-11,3,1
65380,1,0,0,0,13,0
116895,3,7,10,-3,2,0
139863,4,20,17,3,12,0
186247,1,3,3,0,15,0
162942,2,3,0,3,5,1
354187,2,6,7,-1,4,0
345527,2,7,17,-10,17,1
377735,4,32,7,25,15,1
152845,4,28,18,10,17,0
72716,4,34,20,14,16,1
197878,2,11,7,4,3,1
305209,1,7,7,0,16,1
19546,2,0,7,-7,10,1
151246,4,17,26,-9,17,1
304230,3,33,14,19,16,1
220365,1,6,0,6,13,1
304459,2,0,7,-7,16,0
344294,4,16,13,3,17,1
174606,1,0,0,0,10,1
395823,3,3,14,-11,6,1
393963,1,3,0,3,5,0
306824,1,0,0,0,17,0
54094,4,17,3,14,8,1
31460,2,3,7,-4,15,0
216784,1,0,0,0,12,0
166065,1,0,0,0,6,1
293448,4,42,24,18,11,1
11699,3,17,3,14,6,0
274984,1,14,3,11,3,0
300714,1,7,0,7,15,0
383270,3,38,16,22,17,0
392333,2,14,21,-7,4,0
53536,2,7,6,1,8,0
311089,3,10,3,7,2,1
161646,4,39,16,23,4,0
32218,2,14,7,7,15,0
178440,1,7,3,4,12,0
328835,4,17,20,-3,10,1
222845,4,24,13,11,14,0
144790,4,10,17,-7,14,1
238288,1,0,0,0,4,1
60085,3,7,10,-3,11,1
319703,4,33,9,24,6,1
132012,3,0,24,-24,8,1
381543,3,21,13,8,17,1
223691,3,20,13,7,15,0
149477,4,13,27,-14,16,0
346155,1,7,0,7,1,1
138871,4,12,47,-35,12,0
384934,1,0,0,0,1,1
355413,2,10,10,0,4,1
233710,2,7,21,-14,2,0
297977,3,30,7,23,13,1
291231,1,7,3,4,10,0
74274,4,10,17,-7,17,0
305880,3,7,14,-7,17,1
104324,2,38,21,17,13,0
131788,1,0,0,0,8,1
72330,2,0,14,-14,16,1
261999,3,17,17,0,14,1
811,3,7,6,1,1,1
164800,4,26,21,5,6,0
173604,2,0,13,-13,10,1
358264,2,0,14,-14,6,1
296382,4,13,28,-15,13,1
215451,2,7,3,4,11,1
402508,1,0,0,0,9,0
415153,2,3,21,-18,15,0
183764,1,7,14,-7,14,1
85478,2,14,3,11,5,1
375133,2,7,10,-3,14,1
64199,3,31,6,25,13,0
400987,3,19,7,12,8,1
98163,3,21,13,8,11,0
389087,3,23,0,23,3,0
255480,2,7,0,7,12,1
212413,1,0,0,0,10,1
218492,4,31,17,14,13,1
245266,2,9,3,6,7,1
46216,3,14,21,-7,4,0
316754,2,10,0,10,4,0
269225,2,3,6,-3,17,0
356624,1,0,0,0,5,0
353364,2,3,0,3,4,1
161790,3,24,6,18,4,0
362854,4,14,28,-14,8,0
23435,1,7,0,7,11,0
341782,1,0,3,-3,16,1
129913,4,13,0,13,7,1
19484,4,24,17,7,10,0
159263,3,17,24,-7,3,1
4845,1,0,0,0,3,1
69544,2,0,0,0,15,0
43206,2,14,7,7,3,1
74587,4,10,3,7,17,0
208277,1,0,7,-7,8,0
340160,2,20,7,13,15,0
360216,4,20,13,7,7,1
313667,4,25,30,-5,3,1
215534,4,13,3,10,11,0
203999,3,13,7,6,6,1
248799,3,30,14,16,9,0
193861,3,24,7,17,1,1
134065,3,20,10,10,9,0
193442,3,23,20,3,1,0
198285,2,6,7,-1,3,0
379263,1,0,3,-3,16,1
181343,1,7,0,7,13,1
25126,2,10,0,10,12,1
117422,1,0,0,0,2,1
118151,3,23,27,-4,2,0
376799,2,14,7,7,15,1
266706,4,42,10,32,16,0
291773,4,9,17,-8,11,1
299989,2,0,14,-14,14,1
335079,1,0,0,0,13,1
39660,1,0,0,0,1,1
320005,4,43,24,19,6,1
386082,3,14,3,11,1,0
199794,2,3,3,0,4,1
197387,1,7,0,7,3,0
400691,3,16,7,9,8,0
151858,1,3,0,3,17,1
397114,1,3,0,3,6,0
53320,4,24,16,8,8,1
41058,3,3,13,-10,2,0
43442,5,24,24,0,3,0
67201,3,0,3,-3,14,0
10954,3,9,21,-12,5,0
297106,3,24,0,24,13,1
291372,1,7,7,0,10,1
288473,1,0,0,0,9,0
297721,4,17,20,-3,13,1
144027,4,21,16,5,14,0
293496,2,10,10,0,11,1
297064,2,14,0,14,13,1
324719,3,13,7,6,8,1
119329,4,14,16,-2,3,1
214621,3,3,16,-13,11,0
235610,4,27,27,0,3,1
261950,2,7,3,4,14,0
184120,3,16,14,2,14,1
131584,4,9,23,-14,8,0
56260,2,3,14,-11,9,1
258445,3,21,13,8,13,1
73464,1,0,14,-14,17,1
157573,2,5,0,5,2,1
244664,2,7,23,-16,7,1
139816,2,10,10,0,12,1
191702,3,10,17,-7,17,0
208922,3,7,6,1,8,1
312307,1,0,7,-7,3,1
278868,4,14,31,-17,5,1
148765,2,13,6,7,16,0
355378,1,3,3,0,4,1
418208,4,31,6,25,16,1
199529,2,17,3,14,4,1
100727,1,0,0,0,12,1
377578,3,17,12,5,15,1
13647,4,13,10,3,7,0
42447,1,0,3,-3,3,1
355974,1,0,7,-7,5,0
178396,4,31,34,-3,12,1
291924,4,24,10,14,11,0
421455,1,0,0,0,17,1
340924,2,0,10,-10,15,1
351558,4,0,27,-27,3,1
188239,2,7,7,0,16,0
178329,2,14,3,11,12,0
197510,4,20,9,11,3,1
292557,1,0,6,-6,11,1
118077,1,3,6,-3,2,1
68200,2,7,14,-7,14,1
408780,3,10,19,-9,12,0
124214,1,0,14,-14,5,1
348570,3,28,17,11,2,0
406788,2,0,17,-17,11,1
83990,2,17,3,14,4,0
414191,4,17,23,-6,14,0
351982,3,27,14,13,3,1
367284,3,3,17,-14,10,1
85678,3,24,14,10,5,0
246775,2,3,6,-3,8,0
379824,1,0,0,0,16,0
211923,1,0,0,0,9,0
222593,1,0,0,0,14,1
275421,2,6,10,-4,3,1
309426,3,7,3,4,1,0
5515,2,10,10,0,3,1
378502,4,23,0,23,15,1
159789,4,7,20,-13,3,1
222496,3,6,14,-8,14,0
373325,1,0,0,0,13,1
152715,1,0,0,0,17,1
26083,1,0,10,-10,13,1
139210,1,3,6,-3,12,0
18641,4,20,24,-4,9,0
58197,1,0,0,0,10,0
413110,3,30,28,2,14,0
107203,3,6,28,-22,15,0
23428,1,0,0,0,11,1
333314,1,7,0,7,12,1
92673,2,3,10,-7,8,1
398165,1,7,3,4,7,0
149865,3,3,16,-13,16,0
93957,1,0,0,0,9,0
121883,4,0,23,-23,4,0
179408,3,6,13,-7,12,1
3543,1,0,7,-7,2,1
314779,2,21,0,21,4,0
395274,4,10,16,-6,5,0
255873,4,20,14,6,12,1
286244,2,3,13,-10,8,1
260004,1,0,0,0,14,1
229792,1,0,0,0,17,1
84041,4,30,15,15,4,0
82383,4,13,10,3,3,1
139452,4,24,10,14,12,1
63134,2,7,10,-3,12,1
182920,2,0,30,-30,14,0
331732,2,3,13,-10,12,0
356190,3,19,0,19,5,1
304072,3,3,20,-17,16,1
189644,3,10,6,4,17,0
304486,2,0,14,-14,16,1
256621,3,21,7,14,12,1
81485,1,0,7,-7,3,1
70039,4,31,10,21,15,0
245154,3,17,25,-8,7,1
149462,4,13,27,-14,16,1
104200,1,0,0,0,13,1
57234,4,20,14,6,10,1
295052,1,0,0,0,12,0
253372,2,7,14,-7,11,1
359842,1,10,7,3,6,0
307959,3,7,6,1,1,0
238097,5,13,13,0,4,0
58396,2,34,6,28,10,0
90901,3,34,7,27,7,1
364245,2,0,19,-19,9,1
186101,1,0,0,0,15,0
112069,1,7,0,7,17,0
307383,4,16,25,-9,17,1
191825,2,10,10,0,1,1
131854,3,23,7,16,8,1
45075,4,23,20,3,4,0
223097,3,31,14,17,14,1
253041,1,0,0,0,11,1
257635,1,0,7,-7,13,0
83470,1,0,0,0,4,1
341280,4,23,16,7,16,1
370621,3,14,14,0,12,0
319034,3,7,23,-16,5,1
92443,3,20,10,10,8,0
153279,3,2,7,-5,1,1
160775,1,10,7,3,4,0
276788,2,17,10,7,4,0
407518,1,3,0,3,11,1
97249,3,12,13,-1,10,0
160834,3,34,17,17,4,0
324550,2,10,9,1,8,0
341992,3,13,3,10,16,1
193600,4,0,17,-17,1,0
130783,2,13,3,10,8,1
390354,2,7,7,0,3,1
291264,2,7,12,-5,10,1
229024,4,23,16,7,17,1
251059,1,7,7,0,10,0
123260,4,22,24,-2,4,0
289683,4,13,23,-10,10,1
328296,2,3,7,-4,10,0
109881,3,20,0,20,16,0
224017,2,14,6,8,15,1
216806,1,0,0,0,12,1
125343,3,24,3,21,5,1
370135,2,10,3,7,12,0
153762,4,2,21,-19,1,1
351213,2,28,10,18,3,0
304808,3,0,3,-3,16,1
59411,1,0,0,0,11,0
155117,4,19,33,-14,1,0
54634,2,14,19,-5,8,0
293665,3,10,7,3,12,0
326819,3,10,14,-4,9,0
38352,2,7,6,1,1,1
368399,2,14,7,7,11,1
336384,1,3,3,0,14,0
57564,4,31,16,15,10,1
403891,2,10,14,-4,10,1
371837,1,7,10,-3,12,1
391734,3,10,10,0,4,0
341928,1,0,0,0,16,0
22888,3,0,13,-13,11,0
106042,4,24,3,21,14,0
238726,4,19,17,2,4,0
244970,2,0,20,-20,7,1
354128,4,19,0,19,4,1
335177,3,20,7,13,13,0
35213,4,0,14,-14,16,0
70906,3,15,26,-11,15,0
92796,4,12,26,-14,8,1
200081,1,7,0,7,4,0
63922,3,6,24,-18,12,1
149074,2,14,7,7,16,0
126913,4,17,14,3,6,0
209681,2,6,0,6,8,1
373553,3,10,26,-16,13,1
76184,2,9,13,-4,1,0
322104,4,26,0,26,7,1
162940,2,3,0,3,5,1
390097,3,10,14,-4,3,1
404413,1,0,0,0,10,1
358640,4,27,16,11,6,1
2186,1,0,0,0,1,0
165901,4,6,19,-13,6,0
259405,1,0,3,-3,13,1
309740,4,19,9,10,1,1
93038,3,13,9,4,8,1
321354,4,29,22,7,6,0
400670,2,6,7,-1,8,1
227753,3,3,14,-11,16,1
372970,4,28,7,21,13,0
54644,2,14,19,-5,8,0
293732,1,0,0,0,12,1
17751,4,24,13,11,9,0
141845,3,17,14,3,13,1
310533,4,26,9,17,2,1
120283,3,17,13,4,3,1
142782,3,12,10,2,13,1
33983,3,10,27,-17,16,0
393047,1,0,3,-3,4,0
154172,3,7,13,-6,1,1
31518,4,3,17,-14,15,1
217898,3,17,21,-4,12,0
347540,4,28,37,-9,1,0
234777,2,0,3,-3,2,0
267207,1,3,0,3,17,0
93777,4,3,16,-13,9,0
193078,2,0,0,0,1,0
190433,4,7,13,-6,17,0
11214,2,7,14,-7,6,1
342283,3,13,3,10,16,0
73136,1,0,0,0,16,1
421097,2,20,3,17,17,0
94110,1,0,0,0,9,1
80147,1,7,0,7,2,0
64681,1,14,0,14,13,1
751,1,0,0,0,1,0
417400,4,16,17,-1,16,0
108136,4,13,42,-29,15,0
95216,1,3,0,3,10,1
137021,1,7,0,7,11,0
280076,1,0,0,0,5,1
314600,2,7,0,7,3,1
35323,2,13,0,13,16,1
315580,4,7,14,-7,4,0
136058,4,6,13,-7,10,1
240888,1,7,3,4,5,1
325767,2,0,7,-7,9,0
370483,3,20,9,11,12,0
18400,1,0,0,0,9,0
109605,3,22,14,8,16,1
125745,2,7,14,-7,5,1
26597,3,10,6,4,13,0
90118,2,0,0,0,7,1
78157,3,20,3,17,2,0
213379,2,10,20,-10,10,1
200551,1,14,7,7,4,0
91886,1,0,0,0,8,0
155703,3,10,13,-3,2,0
312359,2,13,17,-4,3,1
242857,1,7,3,4,6,0
198909,2,3,16,-13,3,1
172847,2,14,3,11,9,1
291402,2,7,7,0,10,1
225578,1,0,7,-7,16,1
301881,2,0,6,-6,15,1
273960,3,7,9,-2,2,0
352470,4,38,27,11,3,1
289761,2,0,10,-10,10,1
113235,1,0,0,0,17,1
298599,4,13,10,3,14,1
92597,3,17,3,14,8,0
74731,4,14,17,-3,17,0
103632,2,0,7,-7,13,0
156739,1,7,7,0,2,0
380507,2,0,14,-14,16,1
400714,4,16,10,6,8,1
84455,3,6,10,-4,4,1
58886,2,3,18,-15,10,1
55120,3,23,10,13,8,1
244295,4,26,7,19,6,0
276157,2,10,0,10,3,1
416456,2,14,7,7,15,0
42126,5,27,27,0,2,0
205766,1,7,0,7,7,0
385923,3,3,14,-11,1,1
238804,2,20,0,20,4,1
57308,2,7,0,7,10,1
38013,1,3,0,3,1,0
326378,3,20,10,10,9,0
129199,2,7,6,1,7,1
308540,2,6,9,-3,1,0
380419,4,10,24,-14,16,1
74474,1,0,0,0,17,0
421636,1,3,7,-4,17,1
262472,3,7,35,-28,15,1
209989,2,0,3,-3,8,1
107998,4,6,20,-14,15,0
399145,1,0,3,-3,7,0
243267,2,7,10,-3,6,0
195069,3,7,23,-16,2,0
253079,2,14,7,7,11,1
272410,3,24,3,21,2,1
319473,2,0,10,-10,6,1
323744,1,6,0,6,8,0
143644,3,13,10,3,14,1
353451,4,25,12,13,4,1
419628,3,23,16,7,17,0
58497,1,0,0,0,10,0
417066,3,20,0,20,15,1
146663,2,7,23,-16,15,0
325446,2,13,3,10,8,1
32108,3,21,13,8,15,1
92941,1,0,0,0,8,1
36123,4,44,7,37,17,1
142031,4,20,14,6,13,1
135982,2,3,10,-7,10,1
393199,1,7,6,1,5,1
37926,3,10,14,-4,1,1
420724,1,0,0,0,17,0
106826,4,34,29,5,14,0
131643,2,0,16,-16,8,0
380589,4,21,27,-6,16,1
262617,3,23,10,13,15,1
322290,1,7,0,7,7,0
138605,1,3,0,3,12,1
22493,4,31,29,2,11,0
337599,2,14,7,7,14,0
152933,2,14,14,0,1,0
412199,3,14,3,11,13,1
271463,3,14,0,14,1,0
17247,3,7,34,-27,9,1
324374,2,7,0,7,8,0
278191,3,24,21,3,4,1
339166,4,23,13,10,15,0
391862,2,13,10,3,4,1
37054,2,13,0,13,17,0
129890,3,13,0,13,7,0
312004,4,35,17,18,2,0
322622,3,3,6,-3,7,0
349759,4,20,14,6,2,1
326828,3,10,14,-4,9,1
358028,4,24,22,2,6,1
212140,2,3,14,-11,10,0
130683,3,7,38,-31,8,1
351802,2,17,14,3,3,0
232606,1,0,0,0,1,0
193762,4,10,27,-17,1,0
355697,1,7,3,4,5,1
34828,1,0,0,0,16,1
86390,2,7,7,0,5,1
190559,4,17,20,-3,17,1
375871,1,0,0,0,14,1
352188,1,0,0,0,3,0
17232,3,7,31,-24,9,0
42528,3,10,21,-11,3,0
22334,3,0,3,-3,11,0
317522,3,10,27,-17,5,1
112184,4,27,34,-7,17,0
415533,1,0,0,0,15,0
92435,3,17,10,7,8,1
233494,4,26,10,16,2,0
29611,3,14,13,1,14,1
55589,4,24,7,17,9,1
200923,4,33,7,26,4,1
29564,2,0,13,-13,14,1
377936,1,0,0,0,15,0
257549,4,19,10,9,13,1
318355,4,9,22,-13,5,0
306902,3,6,16,-10,17,1
370477,3,20,9,11,12,0
403855,1,10,0,10,10,1
245229,1,3,0,3,7,0
378641,4,23,23,0,15,1
219475,2,0,21,-21,13,1
46571,1,3,0,3,4,1
143898,1,0,0,0,14,1
56803,4,17,20,-3,9,1
309165,3,35,3,32,1,1
7649,4,31,3,28,4,1
226169,4,28,26,2,16,0
306006,2,3,10,-7,17,1
305279,3,28,21,7,16,1
103429,4,17,23,-6,13,0
397363,4,10,24,-14,6,1
320906,4,3,14,-11,6,0
127482,3,3,17,-14,6,1
150272,1,14,0,14,16,0
378492,4,23,0,23,15,0
188648,5,20,19,1,16,0
293663,3,10,7,3,12,0
142277,2,0,0,0,13,1
184696,4,17,24,-7,15,0
415164,3,3,24,-21,15,1
166876,2,7,3,4,6,1
331292,2,0,14,-14,11,1
7846,1,3,7,-4,4,1
217253,1,0,0,0,12,1
419609,2,20,16,4,17,0
79548,1,0,0,0,2,1
166151,3,20,12,8,6,1
8314,2,3,0,3,4,1
234516,4,20,20,0,2,0
134994,4,14,27,-13,10,0
180307,2,9,7,2,13,0
79904,3,3,16,-13,2,1
161532,1,0,0,0,4,0
226315,3,19,7,12,16,1
390958,2,10,7,3,4,1
219784,2,28,0,28,13,1
143193,2,7,3,4,13,0
178185,2,0,10,-10,12,0
361959,3,10,6,4,7,1
72977,4,38,15,23,16,1
195582,4,13,7,6,2,1
291283,3,14,19,-5,10,1
151993,1,0,0,0,17,0
166443,3,17,7,10,6,0
350493,3,10,19,-9,2,0
220324,4,29,9,20,13,0
161259,2,17,3,14,4,1
303813,4,20,17,3,16,0
979,4,0,6,-6,1,1
46128,1,0,6,-6,4,0
290246,3,17,3,14,10,1
329752,1,10,0,10,11,0
14092,4,3,31,-28,7,0
171160,2,3,7,-4,8,1
299436,3,0,20,-20,14,1
411876,1,7,0,7,13,1
85986,3,14,16,-2,5,1
299608,4,13,10,3,14,0
141952,2,10,7,3,13,0
347776,2,7,0,7,1,1
113661,4,9,13,-4,17,1
83777,1,0,0,0,4,1
361323,2,0,0,0,7,0
157360,1,3,0,3,2,1
53867,2,7,7,0,8,1
348474,1,7,0,7,2,1
189350,3,10,10,0,16,1
114142,4,31,14,17,17,0
242593,2,3,0,3,6,1
132142,3,10,3,7,9,0
408791,3,10,25,-15,12,0
204246,2,0,7,-7,6,1
117578,4,24,23,1,2,0
334932,1,0,0,0,13,0
389749,1,10,3,7,3,1
145787,3,13,10,3,15,1
93779,4,3,19,-16,9,0
283957,1,0,0,0,7,0
355169,4,26,26,0,4,1
24791,1,6,0,6,12,0
340064,4,17,12,5,15,0
368019,3,17,21,-4,11,0
68669,2,10,0,10,15,1
14272,2,0,7,-7,7,0
266246,4,31,19,12,16,1
360603,3,7,10,-3,7,1
398080,3,21,28,-7,7,1
301050,3,17,3,14,15,0
330562,3,7,7,0,11,1
360860,1,0,0,0,7,0
273667,4,16,13,3,2,0
282181,1,3,0,3,6,0
75626,3,10,6,4,17,1
186769,2,23,0,23,15,0
226069,1,0,7,-7,16,0
296980,4,29,13,16,13,0
248601,2,7,3,4,9,1
384630,4,10,59,-49,1,1
212969,3,14,7,7,10,1
320107,2,17,0,17,6,0
205466,2,14,0,14,6,1
29417,2,0,14,-14,14,1
188916,3,17,10,7,16,1
277150,4,10,27,-17,4,0
360952,4,31,5,26,7,1
299198,4,17,22,-5,14,1
5645,2,0,14,-14,3,0
95864,4,13,17,-4,10,0
248285,2,14,0,14,8,1
283125,2,3,3,0,7,1
243490,4,10,30,-20,6,1
61834,2,3,20,-17,12,1
245099,2,14,6,8,7,0
256346,1,0,0,0,12,1
378537,1,7,6,1,15,0
212010,3,3,23,-20,9,1
283303,3,10,9,1,7,0
306564,1,0,14,-14,17,0
295324,4,14,5,9,12,1
105900,4,19,13,6,14,1
203821,3,17,24,-7,6,0
155442,4,13,10,3,2,1
135135,4,31,6,25,10,1
308090,2,6,13,-7,1,1
361126,4,23,23,0,7,1
212784,3,10,21,-11,10,1
406568,4,20,37,-17,11,1
395019,2,0,14,-14,5,1
341456,1,0,0,0,16,1
16497,2,13,7,6,8,0
411290,2,0,3,-3,13,0
377945,1,0,0,0,15,1
241162,4,20,10,10,5,0
206461,4,17,0,17,7,1
148689,4,10,12,-2,16,0
361121,4,23,16,7,7,1
378373,1,0,0,0,15,1
371119,1,0,6,-6,12,1
153930,4,7,12,-5,1,0
142947,3,3,13,-10,13,1
24798,2,6,0,6,12,1
105812,2,6,3,3,14,0
133951,4,13,6,7,9,1
27518,3,23,9,14,13,0
119657,4,17,12,5,3,1
163884,2,16,10,6,5,0
397547,1,6,7,-1,7,1
408904,2,17,6,11,12,0
331642,4,23,30,-7,11,0
291027,4,20,13,7,10,1
281126,1,0,0,0,6,0
184064,1,3,0,3,14,1
182418,1,6,0,6,14,1
380241,3,16,16,0,16,0
40897,2,13,17,-4,2,0
144395,2,0,3,-3,14,1
121525,3,9,7,2,4,1
284963,3,13,20,-7,7,1
191515,2,14,14,0,17,0
192943,3,7,17,-10,1,1
41095,4,3,16,-13,2,0
398303,1,3,3,0,7,1
172586,4,17,24,-7,9,0
409057,2,3,7,-4,12,1
77450,4,27,21,6,1,1
30501,4,31,43,-12,14,1
213609,1,0,0,0,10,1
379544,1,7,3,4,16,0
386905,1,7,7,0,2,0
334968,2,3,7,-4,13,0
396208,1,0,0,0,6,0
58877,2,3,15,-12,10,1
193029,1,0,0,0,1,1
72292,1,0,0,0,16,0
298853,4,21,9,12,14,1
96719,2,0,10,-10,10,1
316481,4,16,17,-1,4,1
108050,2,6,7,-1,15,1
113343,4,26,31,-5,17,0
48489,4,27,34,-7,5,0
287553,4,20,40,-20,9,0
344600,4,0,6,-6,17,1
310670,4,13,33,-20,2,0
36675,3,20,3,17,17,1
334234,2,3,7,-4,13,1
335952,1,0,9,-9,13,1
53446,4,10,28,-18,8,0
111706,4,31,13,18,16,0
338191,2,7,21,-14,14,1
58819,4,18,36,-18,10,1
144673,1,0,0,0,14,1
125755,2,7,14,-7,5,0
290449,1,0,0,0,10,0
390538,2,17,7,10,3,0
164636,3,14,17,-3,5,0
351816,2,17,14,3,3,1
156931,2,7,10,-3,2,0
330720,4,6,6,0,11,1
130974,3,10,24,-14,8,0
151805,3,21,16,5,17,0
211089,4,37,0,37,9,1
224270,2,6,9,-3,15,0
287489,2,14,20,-6,9,0
218977,1,7,0,7,13,0
353453,4,25,12,13,4,1
364290,3,3,29,-26,9,1
172552,3,7,21,-14,9,0
98642,4,14,10,4,11,1
379639,4,26,13,13,16,0
324484,4,20,12,8,8,0
39588,3,20,6,14,1,1
205876,4,20,7,13,7,1
288230,2,3,20,-17,9,0
258579,3,13,3,10,13,0
383704,3,9,24,-15,17,0
319202,4,9,17,-8,5,1
33565,4,17,3,14,16,0
118156,4,29,27,2,2,1
209523,2,27,10,17,8,1
322847,4,10,40,-30,7,1
373144,1,0,0,0,13,0
353442,4,25,3,22,4,0
358693,2,7,7,0,6,0
366212,1,0,0,0,10,0
248495,4,23,6,17,8,0
266806,3,10,14,-4,16,0
356194,3,19,0,19,5,1
237422,4,12,17,-5,3,1
383413,3,10,9,1,17,0
116361,4,43,13,30,1,1
155095,3,6,33,-27,1,0
221916,3,19,16,3,14,1
85198,3,10,10,0,4,0
277016,4,31,20,11,4,0
124054,2,0,7,-7,5,0
132230,2,7,0,7,9,0
404718,1,0,3,-3,10,1
14011,2,3,14,-11,7,1
290713,4,41,25,16,10,0
43992,3,3,21,-18,3,1
271052,4,21,28,-7,1,1
342814,1,0,0,0,16,1
123597,1,0,0,0,4,0
118225,1,9,0,9,2,0
201076,4,41,10,31,5,1
164191,2,17,21,-4,5,0
359173,3,7,14,-7,6,1
322532,4,15,3,12,7,1
172619,5,24,24,0,9,0
260347,2,6,0,6,14,0
416741,2,7,0,7,15,0
339722,2,14,6,8,15,1
36726,1,0,6,-6,17,0
31600,2,10,6,4,15,0
260590,1,0,0,0,14,0
281710,4,31,30,1,6,1
112053,1,0,0,0,17,0
32715,3,7,21,-14,15,1
351246,4,28,17,11,3,1
378639,4,23,23,0,15,0
334372,2,0,10,-10,13,1
66608,2,0,14,-14,14,0
117059,3,0,17,-17,2,0
269136,5,16,16,0,17,1
22941,4,3,26,-23,11,1
187138,4,13,0,13,16,1
141403,3,10,17,-7,13,0
292512,4,10,12,-2,11,0
170437,3,21,3,18,8,0
141808,2,10,14,-4,13,1
71267,1,7,0,7,16,0
211350,3,10,10,0,9,1
191618,5,27,24,3,17,0
112878,3,10,3,7,17,0
64776,4,31,7,24,13,0
71386,1,7,0,7,16,0
26503,4,30,29,1,13,0
363534,3,3,5,-2,8,1
13971,1,0,0,0,7,0
350900,2,3,14,-11,3,0
130925,2,0,14,-14,8,1
324537,2,7,9,-2,8,1
154072,1,0,0,0,1,1
275775,3,16,3,13,3,1
88519,4,19,14,5,6,0
233148,3,29,3,26,2,0
202264,2,3,0,3,5,1
205590,1,7,0,7,7,0
92367,1,7,0,7,8,1
8529,4,15,10,5,4,1
326243,3,10,48,-38,9,1
390619,1,0,0,0,3,1
234566,1,0,0,0,2,1
199765,1,0,0,0,4,1
94522,3,0,10,-10,9,1
376874,4,28,14,14,15,0
274738,4,24,12,12,3,0
50661,1,0,0,0,6,0
253053,2,7,0,7,11,1
63758,3,14,15,-1,12,0
69575,2,7,10,-3,15,1
277641,1,0,0,0,4,1
258972,2,0,13,-13,13,0
300460,2,16,0,16,14,1
112088,2,7,14,-7,17,0
41454,2,2,7,-5,2,1
13905,3,21,7,14,7,1
185620,4,20,20,0,15,0
263769,2,0,14,-14,15,1
40950,4,16,20,-4,2,1
5472,1,0,3,-3,3,1
174416,4,17,10,7,10,1
63489,3,31,13,18,12,1
357391,2,14,17,-3,5,1
34438,3,24,3,21,16,0
235085,2,0,7,-7,2,0
168990,2,10,7,3,7,0
346306,1,0,0,0,1,0
126103,4,23,9,14,6,0
112457,4,13,16,-3,17,1
173107,1,3,0,3,9,0
157673,1,0,3,-3,2,0
247356,1,0,0,0,8,0
94452,1,0,0,0,9,1
328964,3,16,7,9,10,0
3245,1,0,0,0,2,1
213113,4,20,3,17,10,0
128477,2,21,14,7,7,1
158665,3,14,7,7,3,0
366361,1,6,0,6,10,0
108935,1,13,7,6,15,0
376277,4,10,14,-4,14,1
28351,2,3,0,3,14,1
196699,2,33,0,33,3,0
381895,4,35,28,7,17,0
316552,2,3,3,0,4,0
128210,3,20,7,13,7,0
100209,3,17,0,17,12,0
408337,3,10,7,3,12,1
418708,2,0,7,-7,16,0
79059,4,13,14,-1,2,1
245675,1,3,3,0,7,0
102529,4,31,10,21,13,0
379016,2,7,6,1,15,1
284992,4,16,27,-11,7,0
245350,1,6,0,6,7,0
418443,3,17,3,14,16,0
266471,2,0,9,-9,16,1
218625,3,10,30,-20,13,1
71634,3,3,31,-28,16,0
33516,2,17,0,17,16,0
118344,1,0,0,0,2,1
391361,1,0,0,0,4,0
104802,3,27,33,-6,14,1
288569,3,23,31,-8,9,0
408559,1,0,0,0,12,1
40729,2,17,7,10,2,0
353921,4,17,28,-11,4,1
55988,3,10,20,-10,9,1
205037,3,9,17,-8,6,0
222455,2,3,7,-4,14,1
223099,3,31,14,17,14,1
381055,2,14,6,8,16,1
323963,2,17,10,7,8,0
418657,4,28,31,-3,16,0
406036,1,0,3,-3,11,1
358291,3,0,20,-20,6,1
45918,3,17,3,14,4,0
394971,4,13,20,-7,5,1
153657,1,2,0,2,1,0
313506,4,17,17,0,3,0
418652,4,28,31,-3,16,0
322160,2,0,14,-14,7,0
383154,4,26,17,9,17,0
92377,2,10,0,10,8,0
301295,2,14,0,14,15,0
70578,2,7,7,0,15,0
244093,4,20,34,-14,6,1
201827,3,13,23,-10,5,1
367086,1,7,0,7,10,1
223054,2,14,7,7,14,1
21139,3,0,13,-13,10,1
58848,1,3,6,-3,10,1
227161,3,10,7,3,16,1
141112,5,17,17,0,13,0
191173,1,0,0,0,17,0
171617,2,6,3,3,9,0
166296,3,7,9,-2,6,0
213432,4,10,41,-31,10,0
25325,4,39,14,25,12,1
203403,4,27,33,-6,6,0
216860,3,10,14,-4,12,1
401976,2,3,9,-6,9,0
350441,2,0,6,-6,2,0
368593,4,16,6,10,11,0
85506,3,14,9,5,5,0
65436,2,0,14,-14,13,0
316817,4,16,7,9,4,0
327525,2,7,9,-2,10,0
68423,4,3,21,-18,14,0
364878,3,6,20,-14,9,1
415581,2,7,7,0,15,0
59572,1,0,3,-3,11,0
202619,3,24,13,11,5,0
69271,2,13,0,13,15,1
191319,1,0,0,0,17,1
104247,2,3,0,3,13,1
373231,3,3,13,-10,13,1
33500,2,14,0,14,16,0
384205,4,32,20,12,1,0
125895,2,13,10,3,6,1
275328,3,10,16,-6,3,1
81110,2,10,14,-4,3,1
113206,4,41,22,19,17,0
308981,2,0,10,-10,1,1
126246,4,28,9,19,6,1
17518,2,13,0,13,9,0
319237,1,0,0,0,6,0
288455,4,19,7,12,9,1
99414,1,0,0,0,11,0
20274,1,7,0,7,10,0
289876,2,6,3,3,10,0
323038,2,14,7,7,7,0
203316,2,14,24,-10,6,0
330726,4,6,6,0,11,0
28512,2,24,0,24,14,1
399520,3,0,26,-26,7,0
228007,1,0,0,0,17,1
187686,2,7,6,1,16,1
94402,4,17,21,-4,9,1
108612,4,26,28,-2,15,1
143404,4,7,26,-19,14,0
381219,2,14,10,4,16,1
183927,2,7,3,4,14,1
106745,2,14,12,2,14,0
187162,4,19,0,19,16,0
106985,4,29,13,16,14,0
236338,3,7,23,-16,3,1
115632,1,0,0,0,1,0
276088,3,34,3,31,3,0
66080,3,10,3,7,13,0
145715,1,0,10,-10,15,1
288588,4,23,31,-8,9,0
18368,4,25,20,5,9,0
393273,4,21,26,-5,5,1
213154,1,0,0,0,10,1
362284,1,0,0,0,8,0
353417,3,18,0,18,4,1
85204,3,10,10,0,4,1
87323,4,24,24,0,6,1
28092,3,21,10,11,13,1
37202,2,3,7,-4,17,1
127459,2,3,10,-7,6,1
359480,3,0,14,-14,6,0
9908,2,0,3,-3,5,1
320935,4,13,21,-8,6,1
158842,4,20,3,17,3,1
82682,4,12,13,-1,3,1
408324,2,0,7,-7,12,1
196290,4,21,10,11,2,0
19560,2,7,14,-7,10,1
125557,1,0,7,-7,5,1
152176,1,7,0,7,17,1
324987,2,13,14,-1,8,0
240789,3,10,10,0,5,1
161434,2,7,3,4,4,1
91438,2,3,0,3,8,0
142729,2,9,7,2,13,0
228229,3,10,27,-17,17,1
72226,3,17,17,0,16,1
258577,2,13,3,10,13,1
21830,1,0,0,0,11,0
378014,3,0,7,-7,15,1
409117,3,3,10,-7,12,0
40423,2,0,7,-7,2,1
50427,2,10,7,3,6,1
37169,1,0,0,0,17,0
236808,3,3,9,-6,3,0
102103,4,42,24,18,12,1
150178,3,6,26,-20,16,1
237585,4,38,22,16,3,0
68720,4,31,0,31,15,1
223042,1,7,7,0,14,1
157649,1,0,0,0,2,0
136660,4,22,19,3,11,1
276224,3,24,10,14,3,1
50420,2,7,7,0,6,0
92843,2,21,0,21,8,0
162473,2,7,3,4,4,0
200835,1,0,0,0,4,1
24631,1,7,0,7,12,0
390310,4,23,20,3,3,1
54051,3,10,3,7,8,0
79223,4,23,10,13,2,0
198373,4,20,14,6,3,1
333389,3,20,10,10,12,1
176176,2,14,14,0,11,1
355916,4,34,17,17,5,0
42298,1,0,2,-2,2,0
368825,2,7,0,7,11,1
273724,1,0,0,0,2,0
188200,4,24,13,11,16,1
346795,2,10,0,10,1,0
397172,3,6,0,6,6,1
75254,2,7,10,-3,17,0
136720,2,13,10,3,11,0
260531,3,27,0,27,14,0
150633,4,10,22,-12,17,1
52326,2,3,3,0,7,0
120559,2,0,6,-6,3,0
370853,2,3,0,3,12,0
195311,1,0,0,0,2,1
355637,4,31,17,14,5,0
287088,4,26,32,-6,8,1
420524,3,3,42,-39,17,1
396034,4,38,20,18,6,0
368990,3,10,7,3,11,1
91514,3,19,3,16,8,0
290779,1,0,0,0,10,1
14887,2,7,0,7,7,0
405187,1,0,7,-7,10,1
418432,2,14,3,11,16,1
138233,4,10,12,-2,11,0
205414,4,27,0,27,6,1
299785,4,17,17,0,14,0
50027,4,28,10,18,6,0
189500,4,17,0,17,17,0
44690,1,0,9,-9,3,0
31587,2,7,3,4,15,1
42100,4,27,20,7,2,0
127870,1,0,0,0,6,1
168512,4,17,30,-13,7,0
23684,4,7,27,-20,12,1
9315,2,21,7,14,5,0
254324,3,13,19,-6,11,0
61973,2,3,0,3,12,1
235285,3,18,6,12,3,1
108032,1,3,0,3,15,0
192397,1,0,7,-7,1,1
389720,1,0,0,0,3,1
171086,4,17,40,-23,8,1
215837,4,51,20,31,11,1
194324,3,10,6,4,2,1
123582,1,0,0,0,4,1
364617,4,21,37,-16,9,0
65370,4,13,28,-15,13,0
295905,3,10,17,-7,12,1
194824,4,10,26,-16,2,0
215557,4,13,6,7,11,0
309133,2,26,3,23,1,0
331303,3,0,17,-17,11,0
234199,3,13,10,3,2,1
111594,1,0,0,0,16,0
239732,3,10,13,-3,4,1
283753,3,11,3,8,7,0
374822,2,7,0,7,14,1
78332,4,24,27,-3,2,0
53562,3,14,12,2,8,1
72691,4,20,10,10,16,0
309819,2,7,7,0,1,0
77398,3,14,21,-7,1,1
112770,4,13,10,3,17,1
300618,2,10,0,10,15,0
317929,2,7,3,4,5,1
242623,3,10,0,10,6,1
405243,2,7,7,0,10,1
188432,3,3,3,0,16,1
331435,2,6,7,-1,11,0
1444,4,19,6,13,1,0
421495,2,0,3,-3,17,1
154406,1,0,0,0,1,1
259056,4,3,16,-13,13,1
97575,4,37,7,30,10,1
48335,4,22,20,2,5,1
293323,1,0,0,0,11,1
412367,3,20,17,3,13,1
96092,1,0,0,0,10,1
177584,3,10,10,0,11,1
395867,4,10,17,-7,6,0
134599,2,23,10,13,10,1
124564,3,6,7,-1,5,1
400546,3,13,17,-4,8,0
227233,1,0,3,-3,16,0
365921,4,14,21,-7,9,1
212584,2,7,10,-3,10,1
101668,1,3,0,3,12,1
316457,3,16,17,-1,4,1
347650,3,17,10,7,1,0
291218,1,7,3,4,10,0
126384,3,13,14,-1,6,1
156039,3,20,17,3,2,0
421365,2,6,10,-4,17,1
240730,1,0,7,-7,5,1
186439,2,10,10,0,15,1
327343,1,0,0,0,9,1
5502,2,10,10,0,3,1
113418,2,0,7,-7,17,1
22756,3,3,21,-18,11,0
10277,1,0,0,0,5,1
331186,3,10,13,-3,11,0
273488,3,7,13,-6,2,1
345613,4,24,23,1,17,0
145634,3,28,0,28,14,0
151518,4,35,7,28,17,1
85843,4,13,13,0,5,0
130115,1,0,0,0,8,0
259457,2,14,10,4,13,1
196049,1,3,14,-11,2,0
205135,1,7,0,7,6,0
329673,3,23,17,6,11,1
281335,3,14,13,1,6,1
35009,2,9,0,9,16,1
262665,4,29,16,13,15,0
420838,4,17,17,0,17,0
233033,4,24,17,7,2,1
288412,3,13,0,13,9,1
100214,3,17,0,17,12,0
46703,1,0,0,0,4,1
218998,2,14,0,14,13,0
421341,1,3,3,0,17,0
337232,3,16,23,-7,14,0
238901,4,41,21,20,4,0
224392,1,0,0,0,15,0
243361,4,20,30,-10,6,0
264545,2,10,14,-4,16,1
355937,4,40,17,23,5,0
418389,1,14,0,14,16,1
59103,4,10,23,-13,10,1
250750,1,3,0,3,10,0
392745,1,7,0,7,4,0
167007,2,0,14,-14,7,0
392261,1,0,0,0,4,0
338022,1,0,0,0,14,1
268804,4,31,10,21,17,1
377694,2,19,7,12,15,1
251485,2,16,3,13,10,1
172340,1,0,7,-7,9,1
70179,3,27,14,13,15,1
148841,4,16,23,-7,16,1
322698,5,9,9,0,7,1
277596,4,12,14,-2,4,0
52640,2,3,7,-4,7,1
50906,3,17,24,-7,6,0
157196,1,7,0,7,2,1
404946,2,3,13,-10,10,1
51036,3,0,17,-17,6,0
257028,2,0,14,-14,12,0
334433,4,17,10,7,13,1
158704,4,24,7,17,3,1
277774,4,17,6,11,4,0
163564,2,7,13,-6,5,0
153121,2,12,17,-5,1,1
338195,2,13,21,-8,14,1
30829,1,0,14,-14,15,1
163163,3,22,28,-6,5,0
257842,3,7,9,-2,13,0
213292,1,0,0,0,10,0
413535,2,0,10,-10,14,1
7358,5,20,19,1,4,0
128714,4,13,30,-17,7,1
382862,4,35,3,32,17,0
15524,4,23,6,17,8,0
197556,2,10,0,10,3,1
285255,2,7,6,1,7,1
123069,4,14,21,-7,4,1
208591,2,6,0,6,8,1
360649,4,17,27,-10,7,0
417566,4,31,31,0,16,1
178657,3,3,13,-10,12,0
84390,1,3,0,3,4,1
342714,2,0,7,-7,16,0
372511,4,23,17,6,13,1
144776,4,10,17,-7,14,0
255731,1,0,0,0,12,0
230176,3,3,26,-23,17,1
380479,1,0,7,-7,16,0
171933,3,7,7,0,9,1
320250,2,14,7,7,6,0
181364,2,14,7,7,13,0
103848,3,19,0,19,13,1
381719,4,20,31,-11,17,1
97775,1,7,0,7,11,0
382187,1,0,0,0,17,0
146893,4,31,0,31,15,1
171360,4,16,17,-1,9,1
417942,1,7,14,-7,16,1
158161,1,7,0,7,3,0
358200,4,23,17,6,6,0
359213,4,21,21,0,6,0
183239,2,10,14,-4,14,0
365920,4,14,21,-7,9,1
294848,3,41,21,20,12,1
353787,5,20,23,-3,4,1
293927,2,7,21,-14,12,1
191382,2,0,24,-24,17,0
379911,3,14,6,8,16,1
123666,3,7,22,-15,4,1
346344,2,3,6,-3,1,1
300767,3,10,13,-3,15,0
301300,2,14,7,7,15,1
158470,2,3,7,-4,3,0
367202,4,29,26,3,10,1
119144,3,10,7,3,3,0
63619,3,13,26,-13,12,1
397356,4,10,24,-14,6,0
201326,3,28,13,15,5,1
281787,2,3,0,3,6,1
101731,3,13,7,6,12,1
140976,1,6,0,6,13,1
370436,2,10,6,4,12,1
269982,3,16,13,3,1,0
37543,4,10,10,0,17,1
401290,3,13,21,-8,8,1
20875,4,28,16,12,10,0
85025,2,25,16,9,4,0
410881,2,14,12,2,13,0
183032,1,0,0,0,14,0
292911,3,7,0,7,11,1
5238,3,21,17,4,3,0
336013,3,13,18,-5,13,0
421600,4,16,9,7,17,0
227578,2,21,0,21,16,1
1449,4,19,7,12,1,1
32891,4,19,7,12,15,1
37537,3,10,10,0,17,1
195026,2,7,10,-3,2,1
78235,1,0,0,0,2,1
20392,4,10,13,-3,10,1
285320,4,24,9,15,7,0
41996,1,0,0,0,2,1
359398,4,13,23,-10,6,1
225234,3,10,7,3,15,1
231159,2,10,0,10,1,0
1198,1,10,0,10,1,0
262014,3,24,24,0,14,1
229422,3,9,6,3,17,1
112545,2,17,16,1,17,1
360155,2,10,6,4,7,0
22531,4,31,37,-6,11,1
28853,3,23,7,16,14,0
382467,4,0,31,-31,17,0
403022,3,13,21,-8,9,0
18266,2,7,17,-10,9,1
109963,1,10,0,10,16,0
136857,1,0,0,0,11,0
126018,1,0,0,0,6,0
248125,1,0,3,-3,8,1
184846,4,24,20,4,15,0
120206,1,7,0,7,3,0
50250,2,10,14,-4,6,1
25715,3,14,10,4,12,0
42624,2,0,7,-7,3,0
227405,1,0,7,-7,16,1
396823,2,3,7,-4,6,1
89678,2,6,17,-11,7,1
87485,1,0,0,0,6,0
258433,3,21,13,8,13,0
233410,2,14,0,14,2,0
59809,4,12,13,-1,11,0
147080,2,7,17,-10,15,1
175833,2,20,10,10,11,0
326446,1,7,3,4,9,1
85716,4,24,28,-4,5,1
95088,2,0,7,-7,9,1
257437,4,23,21,2,13,1
118469,4,27,10,17,2,1
61280,3,21,14,7,11,1
311798,3,17,20,-3,2,0
96879,2,10,7,3,10,1
338630,1,6,0,6,14,0
193577,3,0,10,-10,1,1
159799,4,7,27,-20,3,1
99816,4,8,24,-16,12,0
127123,2,3,9,-6,6,1
378386,1,7,0,7,15,0
327862,3,16,17,-1,10,1
275929,3,13,18,-5,3,1
415837,1,0,13,-13,15,1
346484,2,17,14,3,1,0
141531,3,24,10,14,13,0
177815,2,0,3,-3,12,1
294478,2,7,10,-3,12,1
357131,3,6,14,-8,5,1
108192,1,3,0,3,15,1
350891,2,0,14,-14,3,1
330848,3,13,17,-4,11,0
41652,3,17,7,10,2,1
10663,3,10,17,-7,5,0
379183,3,9,10,-1,16,0
257066,3,7,14,-7,12,0
22006,3,7,17,-10,11,0
297828,3,14,7,7,13,0
300622,2,10,3,7,15,1
284991,4,16,27,-11,7,0
232519,3,20,10,10,1,0
178510,3,16,12,4,12,0
243684,1,7,0,7,6,0
56277,3,3,17,-14,9,0
322458,2,12,0,12,7,0
32191,1,14,7,7,15,0
46273,1,0,0,0,4,1
400299,4,31,9,22,8,1
152989,4,35,17,18,1,0
200956,1,0,0,0,5,0
122774,4,10,27,-17,4,0
315759,1,0,0,0,4,0
15482,2,16,0,16,8,0
380894,1,0,0,0,16,0
144218,2,9,7,2,14,0
221138,3,0,6,-6,14,0
73964,3,30,0,30,17,1
165054,2,10,17,-7,6,0
322654,4,6,9,-3,7,1
136629,3,15,16,-1,11,0
292814,4,29,24,5,11,1
39135,3,20,10,10,1,0
122054,1,0,0,0,4,1
2795,2,14,7,7,2,1
286354,1,0,0,0,8,0
301326,2,14,7,7,15,1
165227,2,7,7,0,6,1
187019,1,0,0,0,16,1
120912,4,28,31,-3,3,0
75707,2,21,7,14,1,0
273999,4,13,29,-16,2,0
375011,3,21,27,-6,14,1
341219,3,13,7,6,16,1
119494,4,14,23,-9,3,0
121712,3,21,14,7,4,0
403139,2,7,7,0,9,1
351395,3,13,13,0,3,0
297852,3,21,16,5,13,0
280168,3,28,0,28,5,1
86724,3,17,14,3,5,0
417874,3,13,10,3,16,1
201317,2,28,10,18,5,1
161504,4,17,6,11,4,0
62909,4,17,10,7,12,0
78249,2,0,0,0,2,0
107366,4,19,6,13,15,1
233146,3,29,3,26,2,0
37098,3,13,17,-4,17,1
101736,3,13,7,6,12,0
319961,2,30,10,20,6,1
398449,2,7,0,7,7,1
261065,2,0,14,-14,14,1
336394,1,3,3,0,14,1
225068,3,10,14,-4,15,0
367081,1,7,0,7,10,0
367392,2,10,14,-4,10,0
324908,4,17,20,-3,8,0
210499,4,9,14,-5,9,0
165031,2,7,10,-3,6,0
342227,2,3,0,3,16,0
339628,4,31,17,14,15,0
403230,4,24,17,7,9,0
197605,3,19,0,19,3,1
151863,1,10,0,10,17,0
252215,4,23,24,-1,10,1
250640,2,3,9,-6,10,0
35873,1,0,0,0,17,0
248718,2,3,7,-4,9,1
16544,4,30,13,17,8,0
25049,4,24,24,0,12,1
263011,2,10,0,10,15,0
309020,3,0,20,-20,1,1
383968,2,0,10,-10,1,0
339753,3,24,6,18,15,1
261033,1,0,6,-6,14,0
205653,2,14,9,5,7,0
344715,3,6,27,-21,17,0
299726,3,17,3,14,14,0
14709,1,7,0,7,7,0
217669,4,26,23,3,12,1
96335,3,3,22,-19,10,0
305855,3,7,14,-7,17,1
167677,2,10,20,-10,7,0
99713,1,0,0,0,12,0
135753,1,0,0,0,10,1
104916,2,3,3,0,14,0
419170,3,10,6,4,16,0
123065,4,14,13,1,4,0
293952,3,7,21,-14,12,1
362715,4,3,13,-10,8,1
162459,1,7,3,4,4,0
75266,2,7,13,-6,17,0
8137,1,0,0,0,4,1
291619,4,23,13,10,11,1
64858,2,7,0,7,13,0
133317,2,7,3,4,9,0
329432,1,0,0,0,10,1
264989,4,32,17,15,16,0
398208,3,21,10,11,7,1
131002,4,10,30,-20,8,1
219395,4,30,20,10,13,0
283944,4,31,17,14,7,0
377834,2,17,0,17,15,0
229716,3,13,17,-4,17,1
330788,1,0,3,-3,11,1
330303,4,31,21,10,11,1
163850,1,0,7,-7,5,1
308835,2,3,10,-7,1,1
169493,2,0,21,-21,8,0
314210,3,14,20,-6,3,1
308750,4,10,20,-10,1,0
131783,1,0,0,0,8,0
291360,1,7,0,7,10,0
334843,2,16,3,13,13,0
231121,1,3,0,3,1,1
335200,4,27,20,7,13,1
219019,2,17,0,17,13,1
416473,3,21,10,11,15,0
87088,1,0,0,0,5,0
297960,2,20,7,13,13,1
368273,2,6,3,3,11,1
168239,1,0,7,-7,7,1
409350,1,3,3,0,12,0
256122,2,14,16,-2,12,1
46570,1,0,0,0,4,1
397732,2,9,14,-5,7,1
259684,1,0,0,0,14,1
420856,4,17,27,-10,17,1
393932,5,23,23,0,5,1
127375,4,16,23,-7,6,1
385018,4,24,16,8,1,0
51191,3,24,6,18,7,1
4029,2,10,7,3,2,0
384016,3,10,23,-13,1,1
346617,1,7,0,7,1,1
303309,3,27,0,27,16,0
8914,3,21,0,21,4,0
315148,1,7,7,0,4,0
55384,2,10,7,3,9,1
179825,1,0,0,0,13,0
56456,3,0,38,-38,9,0
18803,4,16,20,-4,9,0
47941,1,0,14,-14,5,0
130322,2,7,0,7,8,0
30533,1,0,0,0,14,1
198210,4,13,9,4,3,0
361983,4,20,6,14,7,0
258503,1,0,0,0,13,1
84288,2,7,21,-14,4,0
42396,4,14,19,-5,2,1
92875,3,24,0,24,8,1
303045,4,23,19,4,16,0
401024,4,29,15,14,8,1
266400,4,36,8,28,16,1
338050,2,0,7,-7,14,1
253935,4,44,14,30,11,0
218409,2,3,14,-11,13,1
209544,2,34,17,17,8,0
37731,1,7,0,7,1,0
156963,3,7,10,-3,2,0
364296,3,3,29,-26,9,0
161663,4,39,24,15,4,0
142172,4,2,10,-8,13,1
185764,3,23,3,20,15,1
59447,2,3,10,-7,11,0
285318,4,24,9,15,7,0
142621,2,13,6,7,13,1
391463,4,10,20,-10,4,0
53671,2,0,0,0,8,1
351715,4,21,17,4,3,0
220275,3,20,9,11,13,1
29508,4,10,14,-4,14,0
286478,4,20,13,7,8,1
72782,2,20,14,6,16,1
52472,1,3,0,3,7,1
353536,2,10,0,10,4,0
3008,3,13,31,-18,2,0
34295,3,20,9,11,16,1
374423,3,18,0,18,14,0
216997,2,3,3,0,12,1
127225,4,16,16,0,6,1
352355,1,14,0,14,3,0
354878,4,39,42,-3,4,1
212627,3,7,24,-17,10,0
303166,4,21,28,-7,16,1
283505,1,0,0,0,7,1
82703,4,19,19,0,3,0
29965,2,14,0,14,14,0
415218,4,17,31,-14,15,0
172594,4,17,24,-7,9,1
330664,2,6,3,3,11,0
101202,2,0,7,-7,12,1
33136,3,10,35,-25,16,0
415355,4,14,21,-7,15,0
74822,3,13,6,7,17,1
391804,1,3,0,3,4,0
91578,1,0,7,-7,8,1
281354,3,21,13,8,6,1
87895,3,13,15,-2,6,0
214357,1,0,0,0,11,0
1311,4,38,23,15,1,0
408653,3,28,10,18,12,0
283787,4,18,3,15,7,1
347480,2,12,16,-4,1,0
184871,4,27,20,7,15,0
183680,3,0,14,-14,14,1
71074,4,27,0,27,16,0
170018,4,28,17,11,8,0
3799,4,20,10,10,2,1
205439,1,7,0,7,6,0
51492,4,34,24,10,7,1
373796,1,0,0,0,13,1
360140,2,10,6,4,7,0
132423,3,0,21,-21,9,1
270515,2,0,7,-7,1,1
30097,1,0,0,0,14,0
336623,4,7,0,7,14,0
158378,3,16,17,-1,3,0
209119,4,9,30,-21,8,1
1439,4,19,0,19,1,0
53283,3,3,7,-4,8,0
325147,2,13,7,6,8,1
12421,3,10,6,4,6,1
149513,2,14,6,8,16,0
403482,3,17,12,5,9,0
398750,2,14,17,-3,7,1
199155,4,14,45,-31,4,1
501,2,7,6,1,1,0
246608,2,7,3,4,8,1
112749,3,10,7,3,17,1
84790,4,13,31,-18,4,0
346133,1,0,0,0,1,1
361415,4,17,21,-4,7,1
383591,4,24,21,3,17,0
319098,1,0,0,0,5,1
62241,1,14,7,7,12,0
372190,3,9,13,-4,13,0
365802,4,31,17,14,9,0
66274,1,0,0,0,14,0
209827,1,10,10,0,8,0
73293,1,0,0,0,17,1
153177,4,20,20,0,1,1
265628,3,6,15,-9,16,0
102856,4,17,10,7,13,1
167870,2,13,16,-3,7,1
166316,3,10,9,1,6,0
332666,4,27,20,7,12,1
1290,4,24,16,8,1,0
111398,3,0,14,-14,16,1
315674,3,10,13,-3,4,1
183289,4,22,20,2,14,1
251410,4,43,14,29,10,0
102008,2,7,3,4,12,0
131766,4,24,28,-4,8,1
309171,4,35,3,32,1,0
58,2,0,0,0,1,0
273739,1,0,7,-7,2,1
309200,1,0,0,0,1,0
236607,1,0,0,0,3,1
277684,2,7,0,7,4,0
24401,3,13,7,6,12,1
11462,1,6,7,-1,6,1
344537,3,0,0,0,17,0
199284,4,17,38,-21,4,0
279257,3,16,13,3,5,1
331865,2,0,0,0,12,0
7598,3,21,3,18,4,1
168846,2,14,0,14,7,0
369988,2,7,7,0,12,1
5355,2,10,7,3,3,1
177321,1,0,0,0,11,0
344253,3,7,13,-6,17,1
96859,2,10,0,10,10,0
53821,1,0,0,0,8,1
354138,1,0,0,0,4,0
138940,2,7,3,4,12,0
392977,3,9,10,-1,4,1
217702,1,7,0,7,12,1
244974,2,0,20,-20,7,1
393910,4,20,20,0,5,0
219439,1,0,0,0,13,0
267780,1,3,0,3,17,1
62288,3,21,13,8,12,1
375362,3,14,23,-9,14,0
242535,4,25,13,12,6,0
115055,1,0,0,0,1,1
130565,4,13,13,0,8,0
10314,2,7,14,-7,5,1
136630,3,15,16,-1,11,0
279382,2,13,14,-1,5,0
371689,1,0,7,-7,12,1
219328,2,16,7,9,13,0
319689,4,33,9,24,6,1
41987,4,38,6,32,2,0
195910,2,0,14,-14,2,0
212151,2,3,17,-14,10,1
157954,4,16,22,-6,3,0
58927,3,20,32,-12,10,1
117584,1,0,0,0,2,0
268995,1,0,3,-3,17,1
314001,1,0,0,0,3,1
273767,2,7,7,0,2,1
12660,2,10,0,10,6,0
162018,2,14,6,8,4,1
384887,3,13,22,-9,1,1
262013,3,24,23,1,14,0
209751,4,16,6,10,8,0
217293,2,0,7,-7,12,0
93234,4,3,27,-24,9,1
52759,1,0,0,0,7,0
191495,1,7,14,-7,17,1
168749,3,13,6,7,7,0
32158,1,7,0,7,15,0
323992,3,17,16,1,8,1
359067,4,10,13,-3,6,0
384399,1,14,0,14,1,1
177408,2,17,10,7,11,0
152644,2,7,6,1,17,1
282921,1,7,0,7,6,1
376589,4,15,6,9,14,1
260649,2,7,13,-6,14,0
52741,4,20,23,-3,7,0
384336,4,16,3,13,1,0
48014,3,10,24,-14,5,0
342873,2,16,7,9,16,1
306585,2,0,17,-17,17,0
29955,1,6,0,6,14,1
232784,2,13,7,6,2,1
92903,4,34,7,27,8,1
183773,1,10,14,-4,14,0
202665,4,41,20,21,5,1
95715,3,13,9,4,10,1
389396,4,30,19,11,3,1
170845,2,7,0,7,8,0
44723,2,0,12,-12,3,0
46452,2,7,6,1,4,1
200942,4,40,14,26,4,0
274452,4,10,17,-7,3,1
119836,4,24,19,5,3,1
91014,2,6,0,6,7,0
256594,3,14,0,14,12,0
164266,4,48,48,0,5,0
284735,1,6,7,-1,7,0
19480,4,17,17,0,10,1
56853,1,0,0,0,9,0
272428,3,31,10,21,2,0
202118,2,13,3,10,5,1
187950,2,3,7,-4,16,1
302436,1,0,3,-3,15,0
214379,2,0,7,-7,11,1
318729,2,10,23,-13,5,1
276947,3,17,17,0,4,0
153856,2,0,3,-3,1,1
198261,1,3,0,3,3,0
354000,1,0,0,0,4,0
275014,2,24,3,21,3,1
302485,2,3,10,-7,15,0
39959,1,0,0,0,1,0
43985,3,3,14,-11,3,1
223221,2,3,6,-3,15,0
148185,3,12,21,-9,16,1
404800,3,20,19,1,10,0
91824,3,24,0,24,8,1
329499,2,10,7,3,10,1
261822,2,6,10,-4,14,0
274189,1,3,0,3,3,1
224855,1,0,0,0,15,1
364482,4,42,28,14,9,1
326949,2,2,0,2,9,0
377279,3,14,6,8,15,0
70093,1,3,0,3,15,0
139267,2,13,12,1,12,0
175603,4,33,14,19,11,1
66381,4,14,27,-13,14,1
35617,2,7,3,4,17,0
123813,3,10,3,7,5,1
153031,4,49,27,22,1,1
403617,3,24,13,11,9,0
369293,3,14,17,-3,11,1
219854,4,45,0,45,13,0
159642,4,27,20,7,3,0
119298,3,14,10,4,3,0
146554,3,14,24,-10,15,1
79200,3,20,10,10,2,0
88056,3,24,3,21,6,0
385742,2,10,0,10,1,0
88469,2,10,7,3,6,0
246448,2,9,0,9,8,0
134143,1,0,0,0,10,0
347243,1,0,0,0,1,1
39187,4,34,24,10,1,1
140632,3,31,10,21,12,0
178147,1,0,7,-7,12,1
127603,2,3,9,-6,6,1
121756,4,28,42,-14,4,0
279631,1,7,0,7,5,1
341042,2,7,14,-7,15,1
5964,3,17,23,-6,3,0
216933,1,0,0,0,12,1
419606,2,20,16,4,17,0
71618,3,3,30,-27,16,0
228065,3,3,3,0,17,1
394599,2,17,0,17,5,1
125373,4,38,3,35,5,1
40351,4,9,7,2,2,1
175920,4,23,27,-4,11,1
16665,3,14,27,-13,8,0
17948,2,13,14,-1,9,0
322852,4,10,40,-30,7,0
100947,2,10,3,7,12,0
49168,2,10,0,10,6,1
17683,3,14,6,8,9,0
16426,4,24,16,8,8,0
136366,1,0,0,0,11,1
102550,1,0,0,0,13,1
344578,4,0,6,-6,17,0
346444,4,15,19,-4,1,1
171692,4,19,23,-4,9,1
280658,1,0,3,-3,5,1
176577,5,19,20,-1,11,0
183544,2,7,10,-3,14,1
368042,4,20,24,-4,11,0
357663,2,6,3,3,5,1
280087,1,7,0,7,5,1
326908,1,2,0,2,9,1
6508,2,3,0,3,3,0
333190,2,0,7,-7,12,0
43165,1,0,7,-7,3,1
19802,4,12,18,-6,10,0
48410,2,10,17,-7,5,0
197085,2,7,14,-7,3,1
10134,1,0,0,0,5,0
236798,3,3,9,-6,3,1
356535,4,9,6,3,5,1
276973,3,17,20,-3,4,0
318734,3,10,23,-13,5,0
211119,1,0,0,0,9,0
128615,2,3,10,-7,7,1
69597,3,7,17,-10,15,1
215726,1,16,0,16,11,0
48618,4,21,27,-6,5,1
205286,1,3,0,3,6,1
307504,3,38,13,25,17,1
65368,4,13,28,-15,13,1
272764,4,15,10,5,2,1
401219,1,0,7,-7,8,1
293697,4,10,13,-3,12,1
9510,4,13,10,3,5,0
307142,1,0,3,-3,17,1
74569,4,10,3,7,17,1
217571,2,3,9,-6,12,0
340989,4,17,20,-3,15,0
220305,4,26,9,17,13,1
349188,4,27,14,13,2,0
218773,3,0,16,-16,13,1
317918,1,7,0,7,5,0
300546,4,30,23,7,14,1
261718,3,14,7,7,14,1
359002,2,10,0,10,6,1
379256,1,0,3,-3,16,0
408246,4,20,3,17,12,1
50477,4,17,10,7,6,0
96709,2,0,7,-7,10,0
390471,1,0,0,0,3,1
14446,2,24,3,21,7,1
196464,4,20,28,-8,2,0
173817,4,17,3,14,10,1
377581,3,17,12,5,15,1
228018,2,0,0,0,17,1
122042,4,19,13,6,4,0
305286,3,35,21,14,16,0
157804,4,20,10,10,2,0
92100,2,3,10,-7,8,1
143374,3,7,16,-9,14,1
315680,3,10,13,-3,4,0
126725,3,13,13,0,6,0
329966,3,7,10,-3,11,0
330695,3,6,3,3,11,1
359661,4,37,7,30,6,1
174569,4,10,14,-4,10,1
113976,4,20,20,0,17,1
233370,1,0,0,0,2,1
202220,1,3,0,3,5,1
162702,4,23,24,-1,5,1
405455,3,21,10,11,10,1
347053,4,27,17,10,1,1
381113,4,24,28,-4,16,0
126195,2,14,6,8,6,1
53710,3,7,0,7,8,0
81944,4,7,36,-29,3,0
75825,1,0,0,0,1,1
140814,1,0,0,0,13,1
271571,2,7,13,-6,2,0
148028,3,7,3,4,15,0
320443,3,17,10,7,6,1
208209,4,3,10,-7,8,0
144429,3,3,13,-10,14,0
82901,2,3,0,3,4,0
77082,2,7,17,-10,1,0
187072,2,10,0,10,16,1
184451,4,31,13,18,14,1
124443,3,9,7,2,5,0
105887,4,19,10,9,14,0
170190,4,24,27,-3,8,1
203985,3,13,7,6,6,0
357148,4,6,14,-8,5,0
380604,1,0,0,0,16,1
117955,2,7,6,1,2,1
150108,1,0,6,-6,16,0
205028,2,9,10,-1,6,0
238767,1,7,0,7,4,1
391011,3,20,27,-7,4,0
387872,3,10,28,-18,2,1
357445,4,31,30,1,5,1
234468,2,17,13,4,2,1
421710,3,17,10,7,17,0
391544,2,10,21,-11,4,1
296394,1,0,0,0,13,1
108322,1,0,7,-7,15,1
178316,2,7,3,4,12,1
54530,3,21,10,11,8,0
300961,4,24,27,-3,15,1
76618,2,7,0,7,1,1
290387,3,23,10,13,10,1
316305,3,10,16,-6,4,0
270362,1,0,0,0,1,0
365315,3,17,16,1,9,0
118399,2,6,10,-4,2,1
223188,1,3,0,3,15,0
83704,3,22,20,2,4,0
123147,2,3,7,-4,4,0
327517,2,7,7,0,10,0
140836,1,7,0,7,13,1
24535,2,7,13,-6,12,1
137816,1,0,6,-6,11,0
61550,2,21,7,14,11,1
153962,1,7,0,7,1,0
882,1,0,0,0,1,1
21423,2,9,14,-5,11,1
182546,4,42,21,21,14,0
257119,4,17,21,-4,12,1
142502,4,27,13,14,13,1
211713,4,26,16,10,9,1
64733,3,21,0,21,13,0
59726,1,6,7,-1,11,1
150128,2,3,13,-10,16,1
391661,1,0,0,0,4,0
133469,3,20,17,3,9,1
90257,1,0,7,-7,7,1
279578,4,10,16,-6,5,0
13377,4,7,34,-27,7,1
152932,2,14,14,0,1,0
383923,1,0,0,0,1,1
238308,1,3,9,-6,4,0
212826,4,24,21,3,10,0
111870,4,16,10,6,17,0
94851,4,6,13,-7,9,1
165534,3,3,21,-18,6,0
54589,1,0,0,0,8,1
323924,1,7,7,0,8,1
122569,2,14,7,7,4,1
385342,4,17,23,-6,1,0
360351,4,7,20,-13,7,1
189106,4,31,30,1,16,1
138610,1,3,0,3,12,0
354857,4,33,35,-2,4,0
393701,2,0,7,-7,5,1
330860,3,13,17,-4,11,1
384100,2,0,10,-10,1,1
241692,2,7,3,4,5,0
221215,1,0,9,-9,14,0
169893,1,0,0,0,8,1
220282,3,23,9,14,13,0
112057,1,0,0,0,17,1
198582,1,0,0,0,3,0
50564,2,0,6,-6,6,1
82347,3,13,10,3,3,0
168973,1,0,7,-7,7,1
87639,1,0,0,0,6,1
97786,2,7,3,4,11,0
350741,2,10,0,10,2,0
212958,3,14,7,7,10,1
292771,3,26,17,9,11,0
333112,4,20,30,-10,12,1
323635,2,13,0,13,8,1
390281,4,17,13,4,3,1
201190,3,20,21,-1,5,0
278831,3,14,21,-7,5,1
325175,3,13,14,-1,8,0
172684,2,14,3,11,9,1
318120,2,9,7,2,5,0
389311,2,7,6,1,3,0
386521,3,7,20,-13,2,0
1315,1,0,0,0,1,1
123874,1,0,0,0,5,0
381358,2,6,0,6,16,1
133551,1,0,0,0,9,0
250716,1,0,0,0,10,1
86330,4,27,23,4,5,1
126613,4,23,20,3,6,0
250587,1,0,0,0,10,0
229962,1,0,3,-3,17,1
134646,3,31,24,7,10,1
330523,2,7,7,0,11,1
187077,2,10,0,10,16,0
364776,4,12,6,6,9,1
68070,3,3,10,-7,14,0
159471,4,26,23,3,3,1
421094,2,13,3,10,17,1
325578,1,7,0,7,9,0
1891,1,0,0,0,1,1
166583,2,15,14,1,6,1
362338,2,10,7,3,8,1
220250,2,17,9,8,13,1
176856,3,17,13,4,11,0
141392,3,10,17,-7,13,1
356032,3,21,10,11,5,1
200975,1,14,0,14,5,0
43764,1,14,0,14,3,1
81180,1,0,0,0,3,0
366423,3,26,10,16,10,1
387784,1,0,0,0,2,1
282074,2,3,8,-5,6,1
143905,1,0,0,0,14,0
217859,2,10,14,-4,12,0
68870,4,6,17,-11,15,0
415905,3,10,20,-10,15,0
131666,2,0,22,-22,8,1
392142,2,0,13,-13,4,1
86553,2,23,3,20,5,1
280765,4,14,14,0,5,0
107466,2,0,17,-17,15,0
111538,3,21,10,11,16,1
381183,1,7,3,4,16,1
305145,3,21,10,11,16,1
75889,2,21,7,14,1,1
139912,1,0,3,-3,12,0
284610,2,14,10,4,7,1
329761,2,10,6,4,11,1
33725,4,35,7,28,16,1
52480,1,3,0,3,7,1
325901,2,3,0,3,9,1
249328,1,10,0,10,9,0
83,3,7,7,0,1,0
49665,3,7,14,-7,6,1
304457,2,0,7,-7,16,0
4318,1,0,7,-7,2,0
306999,1,7,0,7,17,1
281550,4,20,16,4,6,0
257091,4,7,21,-14,12,1
237802,2,0,10,-10,4,1
258107,2,13,13,0,13,0
413413,2,3,30,-27,14,0
344161,4,27,11,16,17,1
152312,1,7,0,7,17,0
112963,1,7,0,7,17,0
363332,1,0,0,0,8,0
292334,3,12,13,-1,11,0
31650,3,24,9,15,15,1
97809,2,7,10,-3,11,0
269133,5,16,16,0,17,1
64946,4,10,6,4,13,1
405066,1,0,3,-3,10,0
1229,2,10,6,4,1,0
161695,1,7,0,7,4,1
250004,2,7,6,1,9,1
107862,1,0,0,0,15,0
62537,1,0,0,0,12,1
235060,1,0,7,-7,2,1
167801,1,0,6,-6,7,0
86024,4,22,22,0,5,1
378342,4,12,6,6,15,0
274533,2,21,16,5,3,1
35521,3,30,7,23,17,0
187011,1,0,0,0,16,0
148589,2,0,6,-6,16,0
354971,2,7,9,-2,4,0
318040,4,20,16,4,5,1
246074,3,19,13,6,7,0
368692,2,7,10,-3,11,1
321364,4,36,22,14,6,0
9086,4,28,13,15,4,1
156455,2,0,3,-3,2,0
86321,4,27,23,4,5,0
133505,4,27,20,7,9,0
32906,1,0,0,0,15,0
265764,2,10,3,7,16,0
227498,4,19,17,2,16,1
155995,2,10,14,-4,2,1
349558,2,3,21,-18,2,0
217914,4,25,28,-3,12,0
174450,5,17,17,0,10,1
130496,2,10,3,7,8,0
138489,3,24,27,-3,12,0
350185,2,11,0,11,2,1
226615,3,10,3,7,16,1
32579,4,27,13,14,15,1
251197,2,10,10,0,10,1
327733,3,6,13,-7,10,1
241619,4,6,30,-24,5,1
199531,2,17,3,14,4,1
367320,4,6,17,-11,10,0
395330,2,14,0,14,5,0
195958,3,0,17,-17,2,0
275766,3,16,3,13,3,1
66399,4,21,30,-9,14,1
329844,4,24,23,1,11,0
414094,2,0,10,-10,14,1
139579,3,9,14,-5,12,1
359039,3,10,3,7,6,0
295422,3,10,13,-3,12,1
68769,1,6,0,6,15,0
407396,2,7,7,0,11,0
52915,1,0,0,0,7,0
47917,1,0,0,0,5,0
321687,1,0,0,0,7,0
115833,2,0,3,-3,1,0
3132,2,3,6,-3,2,0
236339,3,7,23,-16,3,1
255737,1,0,0,0,12,1
29497,4,10,14,-4,14,0
186731,1,7,0,7,15,0
127819,4,17,34,-17,6,0
109154,3,31,7,24,15,1
219120,1,0,0,0,13,0
190765,1,3,3,0,17,1
6052,2,6,7,-1,3,1
408207,3,13,3,10,12,0
270868,3,16,13,3,1,1
387817,2,10,6,4,2,0
334673,2,15,3,12,13,0
216993,2,3,3,0,12,1
178984,3,12,3,9,12,1
171507,3,17,10,7,9,1
265468,2,7,7,0,16,1
68589,4,20,28,-8,14,1
141330,2,3,7,-4,13,0
250423,1,0,0,0,9,0
203423,1,0,0,0,6,0
292110,1,7,0,7,11,1
291475,4,21,20,1,10,0
318839,2,14,6,8,5,1
396537,2,17,7,10,6,1
193464,4,23,20,3,1,1
185660,1,0,0,0,15,1
27885,1,0,0,0,13,0
270811,1,3,0,3,1,1
404338,3,19,6,13,10,1
343592,1,15,7,8,17,1
85664,3,24,14,10,5,0
274197,2,10,0,10,3,1
413358,1,0,0,0,14,0
367725,3,6,13,-7,10,1
18337,4,22,17,5,9,1
349153,3,20,7,13,2,1
331267,2,0,7,-7,11,0
384256,2,6,0,6,1,1
398806,4,14,24,-10,7,1
181905,4,21,35,-14,13,1
193744,3,10,27,-17,1,0
21420,2,9,7,2,11,0
85518,3,14,9,5,5,0
52763,1,0,13,-13,7,1
26829,1,6,0,6,13,1
159185,1,7,0,7,3,0
57373,3,14,3,11,10,1
92029,4,27,26,1,8,1
260487,2,13,0,13,14,0
59938,2,3,10,-7,11,1
211562,4,42,21,21,9,0
1747,4,28,0,28,1,0
407448,3,14,10,4,11,1
158453,1,0,7,-7,3,0
37004,1,0,0,0,17,1
76112,4,13,30,-17,1,0
308026,4,21,12,9,1,1
286575,3,10,31,-21,8,1
210637,3,13,17,-4,9,0
256978,1,0,0,0,12,1
137120,4,24,6,18,11,0
149063,2,7,7,0,16,0
250688,4,10,22,-12,10,1
92280,3,13,0,13,8,1
277887,3,7,20,-13,4,0
210054,4,17,17,0,8,0
173237,4,20,24,-4,9,0
21137,3,0,13,-13,10,1
282807,2,3,13,-10,6,0
332179,3,3,13,-10,12,1
33060,1,3,0,3,16,0
275159,2,14,16,-2,3,1
114709,4,15,10,5,1,0
198242,4,16,9,7,3,1
391527,2,7,21,-14,4,1
8589,1,0,10,-10,4,1
68930,1,0,7,-7,15,1
383425,4,10,9,1,17,1
333461,1,3,0,3,12,0
55629,1,7,0,7,9,0
196344,1,7,0,7,2,1
94584,4,20,17,3,9,0
4193,2,10,6,4,2,0
342456,4,13,3,10,16,1
382328,1,0,0,0,17,0
259039,4,3,16,-13,13,0
83610,4,9,17,-8,4,1
236086,4,44,10,34,3,1
416544,4,38,23,15,15,0
237016,1,0,7,-7,3,1
417348,2,10,3,7,16,0
99770,2,0,7,-7,12,0
75612,3,7,6,1,17,1
38626,1,0,0,0,1,1
313413,2,7,0,7,3,0
183315,4,22,20,2,14,1
89827,2,6,6,0,7,0
48469,4,20,27,-7,5,1
247181,4,27,6,21,8,1
130809,3,13,12,1,8,1
370221,4,31,17,14,12,1
186085,4,31,55,-24,15,1
286933,4,23,13,10,8,1
286245,2,3,13,-10,8,1
86042,4,25,35,-10,5,1
197869,2,11,7,4,3,0
416837,4,19,17,2,15,1
39508,4,13,19,-6,1,1
288958,1,9,0,9,9,1
57876,1,3,0,3,10,0
271790,4,30,20,10,2,1
125252,1,0,0,0,5,1
380181,2,7,3,4,16,1
373048,2,0,0,0,13,0
155868,3,7,10,-3,2,0
272387,2,24,0,24,2,1
277999,2,3,10,-7,4,1
367776,1,0,0,0,10,0
54911,1,0,0,0,8,0
126398,4,20,14,6,6,0
370147,2,17,3,14,12,0
11251,3,17,21,-4,6,1
121862,3,0,10,-10,4,1
297997,4,30,7,23,13,1
271878,2,7,10,-3,2,1
172214,2,7,6,1,9,0
211245,4,21,26,-5,9,1
233300,3,7,17,-10,2,0
116025,3,13,7,6,1,1
89413,3,10,20,-10,7,0
46132,1,0,7,-7,4,1
148360,4,14,6,8,16,1
253376,2,7,14,-7,11,0
42520,3,10,21,-11,3,1
379528,1,0,3,-3,16,1
102111,4,48,24,24,12,1
194074,4,27,14,13,1,1
372679,4,21,17,4,13,0
164170,2,17,7,10,5,0
2743,4,9,7,2,2,1
332600,2,17,6,11,12,1
43928,2,0,7,-7,3,0
207648,4,42,10,32,7,1
391962,1,0,0,0,4,0
68504,2,0,14,-14,14,0
312584,4,44,0,44,3,1
264533,2,7,14,-7,16,1
93529,1,0,0,0,9,0
237338,2,0,0,0,3,0
326065,2,16,3,13,9,0
37978,4,17,14,3,1,0
167635,2,7,13,-6,7,1
312479,1,10,0,10,3,1
73462,1,0,14,-14,17,1
182347,3,24,10,14,14,0
359134,2,7,0,7,6,1
298511,2,10,0,10,14,1
303231,1,0,0,0,16,1
323240,3,7,10,-3,7,0
361710,4,10,39,-29,7,1
41604,2,7,0,7,2,1
263693,4,30,13,17,15,1
347992,4,6,24,-18,1,1
419975,1,3,0,3,17,0
381482,1,14,0,14,17,1
34091,2,0,0,0,16,0
316574,2,3,6,-3,4,0
185016,4,14,32,-18,15,1
820,3,14,6,8,1,0
252318,3,0,19,-19,10,0
371327,3,28,10,18,12,1
116722,2,6,17,-11,2,1
65152,2,0,0,0,13,0
29614,4,14,13,1,14,1
29322,3,21,7,14,14,0
278291,2,7,0,7,4,1
206028,4,16,17,-1,7,1
392698,4,16,0,16,4,0
35517,3,27,7,20,17,1
230836,1,0,0,0,1,1
76229,3,12,27,-15,1,1
233753,3,13,24,-11,2,0
172034,1,7,0,7,9,0
59067,3,3,17,-14,10,1
51085,4,3,23,-20,6,0
343023,2,3,0,3,16,1
348716,3,24,10,14,2,1
403676,1,0,0,0,9,0
57608,2,3,3,0,10,0
14732,2,21,0,21,7,0
410636,4,17,24,-7,13,1
391215,4,10,24,-14,4,1
204444,3,7,17,-10,6,0
90036,4,11,21,-10,7,1
387555,2,6,3,3,2,1
213464,1,0,0,0,10,1
52136,1,0,0,0,7,0
180005,2,7,13,-6,13,0
10376,3,10,38,-28,5,1
346106,4,10,12,-2,1,0
92343,4,23,0,23,8,0
362303,1,0,7,-7,8,1
193378,2,7,17,-10,1,1
176141,2,14,7,7,11,1
136350,4,18,14,4,11,0
405823,5,24,24,0,10,1
296425,1,7,0,7,13,0
218528,1,0,0,0,13,0
54121,4,20,10,10,8,0
374175,4,23,15,8,13,1
309611,4,16,3,13,1,0
108215,2,6,0,6,15,1
143976,3,7,10,-3,14,1
109782,4,27,0,27,16,0
82249,1,0,0,0,3,1
142628,3,13,12,1,13,0
66921,3,12,7,5,14,0
239039,4,36,21,15,4,1
52395,3,9,17,-8,7,1
161336,4,20,19,1,4,0
14628,3,17,7,10,7,0
179884,2,17,9,8,13,1
370230,1,0,0,0,12,0
419626,3,23,16,7,17,1
70524,4,39,23,16,15,1
207644,4,42,10,32,7,0
79553,1,0,0,0,2,0
373277,4,13,23,-10,13,1
8448,2,9,0,9,4,1
284624,2,14,17,-3,7,1
16137,4,40,17,23,8,0
176040,3,24,0,24,11,1
314420,4,10,24,-14,3,1
292816,4,29,24,5,11,0
302498,3,3,10,-7,15,1
414501,1,6,3,3,14,1
232156,2,6,0,6,1,1
131734,4,24,25,-1,8,1
305557,3,13,0,13,17,0
95539,2,6,7,-1,10,1
336684,1,0,3,-3,14,1
24804,2,6,0,6,12,0
405251,2,7,7,0,10,0
109337,4,20,3,17,15,1
182687,4,11,19,-8,14,0
384893,4,13,22,-9,1,0
68836,3,6,17,-11,15,0
154311,3,13,14,-1,1,0
331687,1,0,12,-12,12,0
419560,1,7,7,0,17,1
82011,2,7,0,7,3,1
381774,1,0,0,0,17,1
96498,4,17,24,-7,10,0
331087,1,0,0,0,11,0
175604,4,33,14,19,11,1
388577,2,14,0,14,3,0
174023,2,0,13,-13,10,1
98665,1,0,0,0,11,0
273260,1,7,0,7,2,0
300092,4,14,40,-26,14,0
235401,2,21,14,7,3,1
360406,1,0,0,0,7,1
256534,1,0,0,0,12,1
93523,1,0,0,0,9,1
383047,1,10,7,3,17,0
86960,2,14,0,14,5,0
10505,2,20,0,20,5,0
255036,2,3,9,-6,12,0
85136,1,0,3,-3,4,1
204593,2,0,38,-38,6,1
363538,3,3,5,-2,8,0
8473,2,15,3,12,4,1
96730,2,0,10,-10,10,1
153550,2,5,14,-9,1,1
246725,1,0,0,0,8,1
110928,3,7,10,-3,16,1
119089,2,7,7,0,3,0
67783,4,21,0,21,14,1
19283,2,7,14,-7,10,1
406333,1,6,7,-1,11,1
300158,2,21,3,18,14,1
305615,4,23,10,13,17,0
59216,3,21,45,-24,10,0
56865,2,7,0,7,9,0
368384,2,14,0,14,11,0
140945,4,20,13,7,13,1
38643,2,0,0,0,1,0
136786,4,13,10,3,11,0
321199,4,3,19,-16,6,1
343090,4,12,13,-1,16,0
384825,2,6,10,-4,1,1
2078,2,0,7,-7,1,1
18477,4,10,14,-4,9,0
229420,3,3,6,-3,17,1
56567,3,16,17,-1,9,0
269223,2,3,6,-3,17,0
319197,3,9,17,-8,5,1
416160,2,9,9,0,15,1
352183,1,0,0,0,3,1
44377,1,0,0,0,3,1
179228,2,14,3,11,12,1
131074,2,10,6,4,8,1
162685,3,23,24,-1,5,0
307039,2,17,0,17,17,1
325204,4,13,23,-10,8,0
374804,1,7,0,7,14,1
313548,2,0,10,-10,3,1
402679,1,0,0,0,9,0
369576,3,14,0,14,11,1
327891,4,23,24,-1,10,1
77091,2,7,17,-10,1,1
214168,4,12,9,3,11,1
421335,1,0,3,-3,17,1
34627,4,24,10,14,16,1
139527,2,6,0,6,12,0
51368,4,22,20,2,7,1
145364,4,45,26,19,14,1
278109,1,0,0,0,4,0
56087,1,7,0,7,9,1
96760,3,7,10,-3,10,0
361926,2,7,3,4,7,1
367227,1,0,0,0,10,0
375896,2,7,3,4,14,1
258950,1,0,7,-7,13,0
116982,1,0,3,-3,2,0
149059,2,7,7,0,16,0
35191,3,0,14,-14,16,1
73677,3,13,6,7,17,0
11049,2,10,7,3,5,0
197025,4,23,20,3,3,0
411578,2,7,10,-3,13,0
294028,2,7,7,0,12,1
267108,3,10,10,0,17,1
247689,2,7,6,1,8,0
110763,2,3,3,0,16,1
336180,4,17,9,8,13,0
9381,4,31,14,17,5,1
205599,1,7,0,7,7,0
58408,3,34,10,24,10,0
149532,2,14,9,5,16,0
29074,1,0,3,-3,14,0
286903,3,16,7,9,8,0
215128,1,0,0,0,11,0
400959,2,16,7,9,8,1
215375,4,24,20,4,11,0
143907,1,0,0,0,14,1
113549,1,0,0,0,17,0
418402,2,14,0,14,16,0
84582,2,10,7,3,4,1
159617,4,20,12,8,3,0
214490,4,7,20,-13,11,1
358910,4,6,35,-29,6,0
192559,4,33,17,16,1,0
177920,4,21,23,-2,12,1
50340,4,13,23,-10,6,1
387933,1,0,0,0,2,0
139056,1,6,0,6,12,0
137531,2,17,17,0,11,0
207240,1,0,0,0,7,0
249733,3,21,21,0,9,1
418419,2,14,3,11,16,1
340528,3,0,40,-40,15,1
33610,5,17,16,1,16,0
90130,2,3,0,3,7,0
287740,1,14,0,14,9,0
86280,3,13,20,-7,5,0
78509,1,0,0,0,2,0
59406,4,0,16,-16,11,1
84296,3,7,27,-20,4,0
155253,3,28,14,14,1,0
285286,3,14,9,5,7,1
304245,4,33,14,19,16,0
138242,4,10,12,-2,11,1
379013,2,7,6,1,15,1
21455,3,12,14,-2,11,1
260310,1,0,0,0,14,1
290762,1,0,0,0,10,0
100239,4,17,14,3,12,1
88510,4,19,14,5,6,1
304434,1,0,6,-6,16,0
191870,3,20,10,10,1,1
226050,1,0,0,0,16,0
90601,2,17,10,7,7,0
332997,1,3,3,0,12,0
65721,2,7,16,-9,13,1
325323,3,12,10,2,8,0
123433,1,0,0,0,4,1
335181,3,20,7,13,13,0
249603,4,21,16,5,9,1
283,4,12,34,-22,1,1
196003,4,7,30,-23,2,0
410380,1,0,7,-7,13,1
295349,1,3,0,3,12,0
200320,4,27,14,13,4,1
321857,1,7,14,-7,7,1
355556,2,14,3,11,5,0
168384,1,0,0,0,7,0
308044,1,0,7,-7,1,1
82832,4,12,16,-4,3,1
114951,2,7,3,4,1,1
281878,4,16,10,6,6,1
200899,3,17,0,17,4,0
205224,4,20,13,7,6,1
76142,1,9,3,6,1,0
238996,3,21,15,6,4,1
354433,1,7,7,0,4,1
290265,4,17,6,11,10,0
142671,4,20,20,0,13,1
208902,2,7,3,4,8,0
52514,2,10,0,10,7,1
242622,3,10,0,10,6,1
197432,2,13,6,7,3,1
83365,2,7,14,-7,4,0
63651,4,20,33,-13,12,0
319660,3,24,3,21,6,1
96546,1,0,0,0,10,0
275615,2,24,3,21,3,1
386029,2,7,0,7,1,0
160593,1,0,0,0,4,0
113811,4,16,24,-8,17,1
18343,4,25,17,8,9,0
207168,3,14,10,4,7,0
116818,1,0,0,0,2,1
75278,3,7,16,-9,17,1
323449,1,0,3,-3,7,1
321471,3,21,27,-6,7,0
70174,3,27,14,13,15,1
314006,2,0,0,0,3,1
374803,1,7,0,7,14,1
188365,1,0,0,0,16,1
377515,2,0,0,0,15,0
231471,3,10,12,-2,1,1
324178,4,3,17,-14,8,0
45314,3,10,10,0,4,0
275953,4,20,18,2,3,0
266181,2,21,0,21,16,0
119751,2,10,3,7,3,0
421594,4,16,9,7,17,1
200814,4,38,17,21,4,0
415163,3,3,24,-21,15,0
362526,3,16,6,10,8,0
219796,2,38,0,38,13,0
135138,4,31,6,25,10,0
212013,3,9,23,-14,9,1
200220,1,0,0,0,4,0
290234,3,17,3,14,10,1
183021,1,0,0,0,14,0
421001,4,14,28,-14,17,0
56379,1,0,0,0,9,0
224811,4,11,10,1,15,0
5088,3,13,7,6,3,1
356770,1,0,0,0,5,1
380537,3,7,17,-10,16,1
297093,3,24,0,24,13,0
233551,2,7,14,-7,2,1
379780,4,9,23,-14,16,0
375183,3,17,17,0,14,1
121446,1,0,0,0,4,0
216169,2,14,0,14,12,0
106118,2,0,0,0,14,1
334974,2,3,7,-4,13,0
30717,2,17,21,-4,15,1
209245,3,20,7,13,8,0
69763,4,19,10,9,15,1
20994,3,14,24,-10,10,0
267996,3,7,9,-2,17,1
250200,3,17,16,1,9,1
22968,1,0,0,0,11,0
269356,2,7,14,-7,1,1
381182,1,7,3,4,16,1
6063,2,7,7,0,3,1
388754,2,11,0,11,3,1
415628,4,30,13,17,15,0
175369,2,14,0,14,11,0
89466,4,27,20,7,7,0
326471,2,17,6,11,9,1
63334,3,17,3,14,12,1
125381,1,0,0,0,5,0
122885,3,24,6,18,4,1
145707,1,0,7,-7,15,0
233127,2,29,3,26,2,0
173572,1,0,10,-10,10,0
144402,2,0,10,-10,14,1
195443,4,24,10,14,2,1
246034,2,7,13,-6,7,1
292477,3,10,9,1,11,0
64534,1,0,0,0,13,0
102151,2,14,0,14,13,0
386229,3,12,17,-5,2,1
249857,2,6,17,-11,9,0
212275,1,7,3,4,10,0
96572,2,3,3,0,10,0
222728,1,0,0,0,14,1
296730,1,0,0,0,13,0
400752,1,0,0,0,8,1
855,4,14,12,2,1,0
401356,1,3,0,3,8,0
113909,3,10,3,7,17,1
86169,4,31,10,21,5,0
263678,4,27,13,14,15,1
125215,4,31,14,17,5,0
214458,3,7,17,-10,11,1
142093,2,0,7,-7,13,0
275337,3,10,16,-6,3,0
244407,4,3,17,-14,7,0
41262,1,0,0,0,2,0
149112,3,17,17,0,16,1
23566,1,0,0,0,12,1
303156,4,21,28,-7,16,0
107532,4,3,23,-20,15,0
192402,1,0,7,-7,1,0
123873,1,0,0,0,5,0
178890,1,0,0,0,12,1
258677,1,0,7,-7,13,1
99104,4,23,7,16,11,1
159047,1,10,0,10,3,1
107868,1,0,0,0,15,0
225871,1,6,0,6,16,1
279151,4,21,23,-2,5,0
304313,2,7,0,7,16,1
300688,4,24,3,21,15,0
318232,1,3,0,3,5,1
418551,2,14,0,14,16,0
114821,3,13,27,-14,1,1
141064,3,14,10,4,13,1
243523,1,0,0,0,6,1
103950,2,3,10,-7,13,1
324121,3,0,10,-10,8,0
38161,1,3,0,3,1,0
299034,4,16,18,-2,14,0
40371,4,12,10,2,2,0
136089,1,0,7,-7,10,0
315438,4,30,30,0,4,0
310474,3,17,9,8,2,1
82923,2,3,3,0,4,0
329094,3,17,7,10,10,0
108302,4,19,7,12,15,0
337447,1,0,6,-6,14,1
59853,5,15,16,-1,11,1
173990,1,0,6,-6,10,1
294845,3,35,21,14,12,1
254632,4,28,14,14,11,0
381091,3,24,14,10,16,0
24955,2,10,14,-4,12,0
42162,1,0,0,0,2,1
118636,1,7,6,1,2,1
190022,1,7,0,7,17,0
105403,3,23,17,6,14,1
205491,2,14,10,4,6,1
67645,3,7,35,-28,14,1
22591,2,13,3,10,11,1
82773,2,6,6,0,3,1
230487,4,28,14,14,1,0
228645,2,13,14,-1,17,1
319031,3,7,23,-16,5,1
8560,1,0,0,0,4,0
102780,2,10,3,7,13,1
90970,1,0,0,0,7,1
127122,2,3,9,-6,6,0
359944,4,23,30,-7,6,0
156911,1,7,10,-3,2,1
220344,1,3,0,3,13,0
387426,3,21,16,5,2,1
239048,4,36,21,15,4,0
59169,2,7,35,-28,10,0
100481,2,7,10,-3,12,1
133731,1,0,0,0,9,0
32195,2,14,7,7,15,0
405999,4,21,7,14,11,0
59199,2,14,42,-28,10,0
134004,1,0,0,0,9,0
305208,1,7,7,0,16,1
216575,4,40,11,29,12,1
133361,4,14,9,5,9,1
269958,2,16,10,6,1,0
114191,2,3,0,3,1,0
402454,3,21,15,6,9,1
159648,4,27,20,7,3,1
345465,4,9,22,-13,17,0
408805,3,10,25,-15,12,1
343410,4,6,34,-28,16,0
51657,4,27,20,7,7,0
119021,4,7,26,-19,3,0
217120,2,0,9,-9,12,1
160226,4,37,14,23,3,0
18397,1,0,0,0,9,1
303417,2,10,7,3,16,1
83272,3,15,10,5,4,0
257017,2,0,7,-7,12,1
324591,3,16,9,7,8,1
99621,2,7,3,4,11,1
262854,2,7,20,-13,15,1
27798,3,14,14,0,13,1
293907,2,7,14,-7,12,0
121491,2,9,0,9,4,0
153112,2,6,10,-4,1,0
119685,5,20,19,1,3,0
242761,3,14,17,-3,6,0
15250,4,23,7,16,8,0
285696,5,27,27,0,8,0
316013,4,0,31,-31,4,1
88311,2,14,7,7,6,0
282642,2,6,7,-1,6,0
101117,3,10,17,-7,12,1
275542,4,32,36,-4,3,1
64966,1,0,0,0,13,0
394705,1,7,0,7,5,0
74893,4,20,20,0,17,1
318435,2,21,7,14,5,0
193039,1,0,0,0,1,1
395557,4,28,14,14,6,1
2977,2,10,10,0,2,1
246363,3,17,10,7,7,1
169814,3,3,17,-14,8,1
65903,3,14,14,0,13,1
5342,2,10,0,10,3,0
301107,4,33,13,20,15,0
50362,1,0,0,0,6,1
400608,1,0,0,0,8,1
88841,4,13,13,0,6,0
340150,2,20,7,13,15,0
235070,1,0,7,-7,2,1
204256,2,0,7,-7,6,0
257356,2,17,0,17,13,1
50946,4,24,27,-3,6,0
417121,4,34,0,34,15,0
269283,4,13,19,-6,17,1
64598,3,20,14,6,13,1
190016,1,0,0,0,17,1
371599,3,10,10,0,12,1
121607,4,22,16,6,4,0
229880,3,13,14,-1,17,1
320039,4,49,36,13,6,1
310188,4,24,10,14,2,0
245985,1,0,0,0,7,0
276154,1,10,0,10,3,0
414104,2,3,10,-7,14,0
82992,4,13,19,-6,4,1
393351,1,7,7,0,5,1
35626,2,7,3,4,17,1
301229,4,27,17,10,15,0
241807,1,3,3,0,5,1
395503,2,14,14,0,6,1
349052,4,17,17,0,2,1
408663,4,28,17,11,12,1
126287,1,0,0,0,6,1
222244,4,13,24,-11,14,0
252675,4,6,3,3,10,0
367170,3,29,23,6,10,0
4112,4,23,28,-5,2,0
347998,4,6,24,-18,1,0
398467,2,7,6,1,7,0
250664,3,9,22,-13,10,1
80955,3,20,0,20,3,0
113937,3,17,10,7,17,1
321243,1,3,3,0,6,0
203412,1,0,0,0,6,0
227909,3,27,13,14,16,0
323563,4,34,17,17,7,0
7913,3,3,20,-17,4,1
99691,4,26,3,23,11,1
37171,1,0,0,0,17,0
287354,3,13,3,10,8,1
59265,4,28,58,-30,10,1
305297,4,41,21,20,16,1
278853,4,14,30,-16,5,0
311675,3,6,6,0,2,1
337455,1,7,6,1,14,0
301341,3,17,7,10,15,1
227940,4,27,27,0,16,1
294526,3,17,13,4,12,1
299624,4,20,16,4,14,0
92238,2,7,0,7,8,1
308606,4,15,16,-1,1,1
28628,1,0,0,0,14,0
357163,4,12,14,-2,5,1
45647,4,13,13,0,4,0
280588,3,17,9,8,5,0
412842,4,28,35,-7,14,1
32049,2,7,10,-3,15,0
201081,4,41,10,31,5,1
152614,2,0,6,-6,17,1
159413,3,13,20,-7,3,0
238856,3,41,0,41,4,0
183779,2,10,14,-4,14,1
11932,1,0,0,0,6,0
346603,1,7,0,7,1,1
407143,3,10,27,-17,11,1
146849,3,24,0,24,15,1
324875,3,10,13,-3,8,1
248888,1,14,0,14,9,0
107025,2,10,0,10,15,1
280746,3,14,14,0,5,1
238181,2,3,16,-13,4,0
51711,1,0,10,-10,7,1
86841,2,9,16,-7,5,1
283628,4,20,20,0,7,0
343709,4,18,10,8,17,1
154314,3,13,14,-1,1,0
402532,1,7,0,7,9,0
229740,3,13,17,-4,17,1
42253,3,30,7,23,2,1
27908,2,0,3,-3,13,1
61610,4,35,14,21,11,0
406285,4,27,35,-8,11,1
25031,4,16,24,-8,12,1
101698,2,10,0,10,12,0
140558,1,7,7,0,12,0
178649,2,3,10,-7,12,0
178481,2,13,3,10,12,1
304429,1,0,0,0,16,1
38751,1,0,3,-3,1,1
303721,2,14,10,4,16,0
336594,3,7,0,7,14,0
306589,2,0,17,-17,17,0
232485,2,10,3,7,1,1
198546,5,20,20,0,3,1
198591,1,0,0,0,3,0
11053,2,10,7,3,5,0
389239,3,28,7,21,3,1
322526,4,15,3,12,7,0
10301,1,7,14,-7,5,0
432,4,45,26,19,1,0
182621,2,0,6,-6,14,0
139997,3,28,10,18,12,0
394629,3,17,7,10,5,0
12157,4,20,21,-1,6,0
99036,2,6,0,6,11,1
174983,3,6,21,-15,10,0
182383,4,24,20,4,14,0
32170,1,7,6,1,15,0
95221,1,3,0,3,10,0
276732,1,0,0,0,4,1
216884,3,13,14,-1,12,0
378400,2,7,0,7,15,1
235146,3,0,10,-10,2,0
34602,3,24,7,17,16,0
78876,3,17,0,17,2,1
254422,2,13,0,13,11,1
169359,2,6,14,-8,8,1
60593,4,30,41,-11,11,1
283053,1,0,0,0,7,0
216822,2,0,7,-7,12,1
156019,3,17,17,0,2,0
114637,2,3,3,0,1,1
277941,4,7,27,-20,4,1
194320,3,10,6,4,2,1
248663,4,24,10,14,9,1
79370,4,32,3,29,2,1
329429,1,0,0,0,10,0
357550,3,10,13,-3,5,1
343505,3,7,10,-3,16,1
419285,2,0,10,-10,16,1
271459,3,14,0,14,1,1
6227,2,13,0,13,3,0
11397,3,23,0,23,6,1
44059,1,0,3,-3,3,1
225038,2,0,7,-7,15,0
359440,2,0,7,-7,6,0
233476,4,23,10,13,2,1
410125,3,17,10,7,13,1
266867,5,17,17,0,16,1
329622,2,10,7,3,11,1
409664,2,10,3,7,12,1
79175,3,10,10,0,2,1
235974,1,7,0,7,3,1
306937,4,6,30,-24,17,1
374936,1,0,0,0,14,0
100937,2,10,3,7,12,0
371475,3,14,17,-3,12,0
55744,4,23,29,-6,9,1
385520,1,0,0,0,1,1
39155,4,20,10,10,1,1
230723,3,9,27,-18,1,1
174254,4,10,33,-23,10,0
266945,2,13,7,6,17,1
395791,2,0,7,-7,6,0
134979,4,7,27,-20,10,0
121577,4,22,13,9,4,0
357437,4,31,30,1,5,0
391794,1,0,0,0,4,1
394264,1,0,0,0,5,1
253876,3,31,14,17,11,0
253453,4,14,38,-24,11,1
243479,4,10,23,-13,6,0
376164,1,7,0,7,14,0
78386,1,0,0,0,2,1
198856,4,19,36,-17,3,0
77289,4,19,10,9,1,0
237036,1,0,14,-14,3,0
131110,3,20,9,11,8,1
240079,4,20,27,-7,5,0
46368,3,6,17,-11,4,1
229690,2,10,7,3,17,1
78538,2,3,7,-4,2,0
28863,3,23,7,16,14,1
273523,4,21,21,0,2,0
191919,1,0,0,0,1,0
358624,4,27,9,18,6,0
211882,4,36,17,19,9,0
406741,1,0,0,0,11,0
359837,1,10,7,3,6,0
265777,3,17,3,14,16,0
259924,3,17,10,7,14,1
267925,1,0,0,0,17,1
360885,2,12,0,12,7,1
338872,4,13,22,-9,15,0
228260,4,17,27,-10,17,0
48776,4,17,28,-11,5,1
406624,1,0,0,0,11,1
282133,4,23,8,15,6,0
198114,1,0,3,-3,3,0
41441,2,2,0,2,2,0
137103,3,17,6,11,11,1
62810,4,20,0,20,12,0
317596,1,3,3,0,5,1
317092,4,17,17,0,4,1
23689,4,9,27,-18,12,1
135116,3,31,6,25,10,0
28093,3,21,10,11,13,1
239442,3,9,10,-1,4,0
298150,4,10,41,-31,13,1
215218,3,10,16,-6,11,0
178503,3,16,6,10,12,0
265665,4,9,15,-6,16,0
124926,1,0,0,0,5,1
57112,1,0,0,0,10,1
370835,1,0,0,0,12,1
281484,3,7,10,-3,6,1
281826,3,10,0,10,6,1
390093,2,10,14,-4,3,0
324238,2,3,0,3,8,0
402150,3,18,0,18,9,1
295688,2,0,9,-9,12,1
67153,2,0,0,0,14,1
405645,4,24,28,-4,10,0
55345,1,0,0,0,9,1
251138,4,10,20,-10,10,1
131261,3,14,17,-3,8,1
388457,2,3,13,-10,2,0
73740,1,3,0,3,17,1
170315,3,0,12,-12,8,0
239250,2,0,7,-7,4,0
384751,4,13,37,-24,1,1
156409,1,0,0,0,2,1
355767,4,10,6,4,5,0
255374,3,21,6,15,12,0
288207,2,3,7,-4,9,0
85778,2,13,7,6,5,0
240621,2,20,14,6,5,1
388845,4,21,17,4,3,1
256814,4,13,19,-6,12,1
54316,1,7,2,5,8,0
214740,2,3,7,-4,11,0
177911,4,21,23,-2,12,1
385481,4,35,10,25,1,1
17185,2,7,14,-7,9,0
380430,4,10,24,-14,16,1
416475,3,21,10,11,15,0
379883,2,14,0,14,16,0
357377,2,13,10,3,5,1
31808,3,16,17,-1,15,0
217552,1,3,0,3,12,0
175110,2,14,10,4,10,1
54463,1,0,0,0,8,0
104409,4,52,38,14,13,1
58431,3,41,10,31,10,0
203405,4,27,33,-6,6,1
85073,4,31,16,15,4,1
414175,4,17,20,-3,14,0
401724,3,17,14,3,8,0
217985,2,14,3,11,12,0
191426,4,0,31,-31,17,1
190835,3,16,3,13,17,1
34243,2,10,6,4,16,1
36004,1,0,0,0,17,1
163245,2,3,3,0,5,0
379662,4,26,20,6,16,1
45493,3,27,20,7,4,1
121905,4,0,33,-33,4,0
2509,2,3,0,3,2,0
189695,4,20,6,14,17,1
174748,1,6,0,6,10,0
184351,2,7,6,1,14,0
74050,1,3,0,3,17,1
279955,2,0,10,-10,5,1
271848,1,0,3,-3,2,0
95112,2,9,10,-1,9,0
360079,4,10,40,-30,7,1
371024,2,7,10,-3,12,0
228126,4,20,10,10,17,1
123496,2,0,0,0,4,1
152037,2,3,0,3,17,0
293509,2,10,10,0,11,1
161664,4,39,24,15,4,0
204400,2,7,3,4,6,0
355048,4,18,33,-15,4,0
85751,1,7,7,0,5,1
162291,1,0,0,0,4,1
10381,3,10,38,-28,5,0
183682,3,0,14,-14,14,1
364485,4,42,28,14,9,1
314746,2,14,0,14,4,0
30082,1,0,0,0,14,0
198447,2,10,3,7,3,1
96367,4,9,30,-21,10,0
179942,4,40,9,31,13,0
191851,3,17,10,7,1,0
30702,2,10,14,-4,15,1
295584,4,23,25,-2,12,0
108778,1,0,7,-7,15,1
277653,1,0,0,0,4,1
232152,1,6,0,6,1,0
146581,4,20,31,-11,15,1
77449,4,27,21,6,1,1
44677,1,0,0,0,3,1
317831,3,9,3,6,5,0
358904,3,6,35,-29,6,1
162966,2,6,0,6,5,0
133801,3,16,10,6,9,1
245948,4,21,37,-16,7,0
374421,2,18,0,18,14,1
246174,2,7,3,4,7,1
118698,3,17,6,11,2,0
402725,2,17,0,17,9,0
325894,2,3,0,3,9,1
159098,3,24,0,24,3,0
91335,3,7,7,0,8,1
191127,3,21,20,1,17,1
98714,2,21,3,18,11,1
166103,2,14,3,11,6,1
308189,1,0,7,-7,1,1
113981,4,20,20,0,17,0
337004,2,10,0,10,14,1
178651,2,3,13,-10,12,1
5826,3,27,7,20,3,1
56911,3,27,7,20,9,1
236239,4,27,22,5,3,0
76042,2,10,13,-3,1,0
84256,2,0,7,-7,4,1
34605,3,24,7,17,16,1
177843,2,14,16,-2,12,1
42622,2,0,7,-7,3,0
285228,1,0,3,-3,7,0
125674,4,28,24,4,5,1
249345,2,10,9,1,9,1
61176,4,0,21,-21,11,0
359034,3,10,3,7,6,1
229479,4,13,9,4,17,0
146286,4,10,30,-20,15,0
76237,4,12,27,-15,1,1
118931,1,0,7,-7,3,0
131513,2,3,6,-3,8,1
74267,3,10,17,-7,17,1
189066,3,21,17,4,16,0
20933,1,7,7,0,10,0
218080,4,28,24,4,12,0
375431,1,7,7,0,14,0
6397,3,9,13,-4,3,0
6120,3,7,10,-3,3,1
415422,2,9,0,9,15,1
197748,3,14,17,-3,3,1
333406,4,23,10,13,12,0
247644,1,0,0,0,8,1
175712,3,29,6,23,11,1
261800,1,3,7,-4,14,0
368130,2,10,7,3,11,0
317252,4,7,16,-9,5,1
387581,3,6,3,3,2,0
141321,1,0,7,-7,13,1
56218,1,3,0,3,9,0
6717,4,3,23,-20,3,0
106665,4,46,16,30,14,1
311492,3,10,3,7,2,0
28142,4,30,10,20,13,0
221446,3,3,31,-28,14,0
165812,2,3,6,-3,6,0
205156,2,7,7,0,6,0
209487,1,7,3,4,8,0
273783,2,7,7,0,2,1
291922,4,24,10,14,11,0
276405,4,32,44,-12,3,1
370388,1,0,0,0,12,1
261341,2,0,7,-7,14,0
44401,2,3,0,3,3,0
388982,4,24,27,-3,3,0
280849,2,10,3,7,6,1
409741,4,13,6,7,12,0
297266,4,24,6,18,13,0
372801,3,3,0,3,13,0
209813,1,7,7,0,8,0
135587,4,28,6,22,10,1
327406,3,3,14,-11,9,0
159527,2,7,6,1,3,1
257163,1,0,6,-6,12,1
182198,3,33,7,26,13,0
402232,1,0,3,-3,9,1
368584,3,16,0,16,11,0
183465,4,27,6,21,14,1
380480,1,0,7,-7,16,0
231826,4,33,20,13,1,0
411109,1,0,0,0,13,1
5422,4,20,22,-2,3,0
412344,3,10,17,-7,13,1
5017,1,0,0,0,3,0
247651,1,0,0,0,8,1
132771,4,20,31,-11,9,1
60047,2,7,3,4,11,1
149169,4,24,31,-7,16,1
413363,1,0,7,-7,14,1
103331,2,7,10,-3,13,0
232365,3,13,15,-2,1,0
304817,3,0,3,-3,16,1
236077,4,44,10,34,3,1
337292,1,0,7,-7,14,1
345079,2,6,3,3,17,1
369986,2,7,0,7,12,1
295071,1,0,0,0,12,1
215728,1,16,0,16,11,0
320363,1,7,0,7,6,1
355358,1,3,0,3,4,0
150691,1,0,3,-3,17,0
35729,1,3,0,3,17,0
57925,3,13,17,-4,10,0
265723,1,0,0,0,16,1
416340,3,16,3,13,15,1
411720,1,0,3,-3,13,0
264459,4,20,28,-8,15,0
199990,3,17,10,7,4,0
29895,4,16,23,-7,14,1
325588,2,7,7,0,9,1
312261,4,10,23,-13,2,1
11960,2,7,0,7,6,1
26524,1,3,0,3,13,0
68933,1,0,7,-7,15,1
266854,4,17,17,0,16,1
293904,2,7,14,-7,12,0
208077,4,21,19,2,8,0
28784,1,0,0,0,14,1
37707,4,37,0,37,17,1
215550,4,13,6,7,11,1
180794,3,10,20,-10,13,1
97966,2,7,10,-3,11,0
355855,2,13,7,6,5,0
371001,2,7,7,0,12,0
215611,2,14,3,11,11,1
237598,4,38,28,10,3,1
112670,1,3,0,3,17,0
275579,1,14,0,14,3,1
183965,3,20,3,17,14,1
118559,3,17,3,14,2,1
203220,4,10,17,-7,5,1
139990,3,25,10,15,12,1
91484,3,19,0,19,8,1
119045,4,7,33,-26,3,0
150181,3,6,26,-20,16,1
304689,4,14,7,7,16,1
204307,3,0,10,-10,6,0
269535,3,13,24,-11,1,0
332561,1,3,3,0,12,1
348616,4,34,23,11,2,0
219109,1,0,0,0,13,0
183066,2,7,0,7,14,1
158826,3,20,3,17,3,0
257547,4,19,10,9,13,1
329833,4,17,23,-6,11,1
114617,2,3,3,0,1,0
304527,3,10,14,-4,16,0
71856,1,9,0,9,16,0
235898,3,7,14,-7,3,1
82513,3,10,20,-10,3,1
134495,3,3,30,-27,10,0
266155,1,7,0,7,16,0
201022,2,27,0,27,5,0
2652,2,3,0,3,2,1
270110,3,17,10,7,1,1
44589,3,10,14,-4,3,1
162099,4,42,13,29,4,0
312309,1,0,7,-7,3,1
151799,3,21,16,5,17,0
314520,4,24,7,17,3,0
196961,2,14,0,14,3,0
254173,3,3,12,-9,11,1
417854,3,10,10,0,16,0
269005,1,0,3,-3,17,1
414430,3,7,23,-16,14,0
206008,4,16,10,6,7,0
282819,3,3,13,-10,6,1
283419,2,20,7,13,7,1
236229,4,27,22,5,3,1
367762,4,20,27,-7,10,1
246182,2,14,3,11,7,1
385257,2,6,3,3,1,0
374242,1,7,0,7,13,0
191879,3,22,10,12,1,1
132744,4,19,17,2,9,1
184911,2,0,7,-7,15,0
266116,4,17,13,4,16,1
194101,1,0,0,0,1,0
322747,1,3,14,-11,7,0
384547,2,0,28,-28,1,1
107843,4,20,30,-10,15,1
323720,4,33,0,33,8,0
416901,2,3,7,-4,15,1
270841,2,9,7,2,1,0
129763,4,17,24,-7,7,0
100936,2,10,3,7,12,0
365684,1,7,3,4,9,1
199248,3,17,24,-7,4,1
344517,2,0,0,0,17,0
133164,2,10,17,-7,9,1
235630,1,0,0,0,3,0
362090,3,21,10,11,8,0
152695,4,27,6,21,17,0
365389,1,7,0,7,9,0
110894,2,7,3,4,16,1
201648,3,10,13,-3,5,0
102689,4,29,28,1,13,1
3151,3,10,9,1,2,1
155781,1,0,0,0,2,1
139046,1,0,0,0,12,1
16446,1,0,0,0,8,1
251774,1,0,0,0,10,0
376276,4,10,14,-4,14,1
191220,2,0,17,-17,17,1
394521,4,10,25,-15,5,1
142855,1,0,0,0,13,1
16694,4,21,30,-9,8,0
228525,3,20,7,13,17,0
68503,2,0,14,-14,14,0
324412,3,14,3,11,8,0
173842,4,23,3,20,10,0
180781,3,7,13,-6,13,1
297926,2,10,0,10,13,1
390081,2,7,7,0,3,1
141449,1,0,0,0,13,1
308372,2,0,6,-6,1,1
172435,3,13,49,-36,9,1
317744,1,0,0,0,5,0
408645,3,28,10,18,12,1
198488,3,17,3,14,3,1
342303,4,20,3,17,16,1
12018,4,24,14,10,6,1
115023,4,19,19,0,1,1
420247,1,0,0,0,17,0
393174,1,0,3,-3,5,1
358510,1,0,0,0,6,0
179614,4,28,23,5,12,1
324785,4,33,14,19,8,0
70924,4,15,36,-21,15,0
90261,2,0,7,-7,7,1
346078,3,10,6,4,1,0
405112,3,0,10,-10,10,0
317031,2,0,10,-10,4,0
85038,3,25,16,9,4,0
384305,3,8,0,8,1,1
104790,3,20,26,-6,14,1
303541,1,0,0,0,16,1
91174,3,10,14,-4,8,0
237999,2,10,10,0,4,0
186705,4,27,16,11,15,0
91488,3,19,0,19,8,0
182272,2,7,0,7,14,1
416325,2,13,3,10,15,1
380785,2,9,14,-5,16,0
233237,1,0,3,-3,2,0
173767,2,10,3,7,10,1
98702,2,21,3,18,11,0
274327,1,0,0,0,3,1
330227,2,7,14,-7,11,1
98428,2,14,7,7,11,1
132763,4,20,24,-4,9,0
305103,2,21,10,11,16,1
78878,3,17,0,17,2,1
218517,4,34,17,17,13,0
159854,2,17,0,17,3,0
358621,4,27,9,18,6,0
223461,1,0,0,0,15,0
206370,1,0,0,0,7,1
2288,3,10,10,0,1,0
275397,1,0,7,-7,3,0
98698,2,14,3,11,11,1
176576,5,19,20,-1,11,0
40680,1,0,0,0,2,1
344193,1,0,0,0,17,0
261530,3,12,0,12,14,0
137229,2,7,10,-3,11,0
235550,3,10,13,-3,3,0
130533,4,10,6,4,8,1
402159,3,19,7,12,9,1
407579,3,10,9,1,11,0
401002,4,22,15,7,8,1
49059,3,10,13,-3,6,0
266820,4,10,14,-4,16,1
362192,2,3,3,0,8,1
111553,3,28,10,18,16,1
153669,1,2,7,-5,1,0
119915,1,6,14,-8,3,1
82688,4,12,19,-7,3,1
339908,3,26,0,26,15,0
15405,4,10,30,-20,8,0
185429,3,10,10,0,15,1
199845,3,3,17,-14,4,1
306370,4,37,10,27,17,0
167103,4,16,34,-18,7,1
210144,2,0,0,0,9,0
313456,3,17,13,4,3,0
390616,1,0,0,0,3,1
368688,2,7,10,-3,11,1
377649,1,6,7,-1,15,1
142036,4,20,14,6,13,1
7582,2,14,3,11,4,0
222774,2,10,7,3,14,1
248478,3,16,6,10,8,1
104735,1,10,13,-3,14,0
383578,4,21,21,0,17,0
132105,2,10,0,10,9,0
50001,3,28,10,18,6,1
344904,1,0,7,-7,17,1
347913,2,0,14,-14,1,1
226680,1,7,3,4,16,0
215165,2,7,6,1,11,0
37633,2,17,0,17,17,0
306210,4,20,3,17,17,0
96860,2,10,0,10,10,0
236403,4,14,23,-9,3,0
195648,2,7,7,0,2,0
320420,2,17,0,17,6,0
383449,4,16,12,4,17,0
107515,4,3,23,-20,15,0
299064,1,0,0,0,14,1
360523,1,0,6,-6,7,0
119679,4,17,19,-2,3,1
349749,3,20,7,13,2,0
122659,1,0,0,0,4,0
348236,3,16,17,-1,1,0
274708,3,10,12,-2,3,0
263761,2,0,7,-7,15,1
314162,2,7,13,-6,3,0
246829,4,10,20,-10,8,1
383682,3,9,17,-8,17,0
63942,4,6,27,-21,12,1
1329,1,0,0,0,1,1
336494,4,20,17,3,14,0
243058,2,0,9,-9,6,0
9166,2,3,13,-10,5,1
272476,1,0,0,0,2,1
105187,1,7,0,7,14,0
346920,1,0,0,0,1,0
115418,3,26,7,19,1,0
97791,2,7,3,4,11,0
125937,3,16,13,3,6,1
26552,2,10,3,7,13,0
52554,3,16,7,9,7,1
398029,2,14,14,0,7,1
359914,3,23,27,-4,6,0
268346,3,20,6,14,17,1
107852,4,23,30,-7,15,0
17584,4,13,17,-4,9,1
106926,3,12,3,9,14,0
88738,1,3,3,0,6,0
365095,1,0,7,-7,9,0
304004,1,0,10,-10,16,1
244678,3,7,23,-16,7,0
129949,4,13,0,13,7,0
224019,3,14,6,8,15,0
256356,1,3,0,3,12,1
70423,2,14,17,-3,15,1
160969,3,10,7,3,4,1
45516,4,27,26,1,4,0
335503,1,0,0,0,13,0
181628,4,23,6,17,13,0
187268,3,10,6,4,16,0
356769,1,0,0,0,5,1
311213,2,6,0,6,2,1
357501,2,6,6,0,5,1
353107,2,10,22,-12,3,0
20915,1,0,0,0,10,1
373557,3,16,26,-10,13,0
308874,4,10,13,-3,1,1
216690,3,24,6,18,12,1
218499,4,31,17,14,13,1
314032,2,6,0,6,3,1
333114,4,20,30,-10,12,1
47933,1,0,7,-7,5,0
219540,4,15,21,-6,13,0
77032,1,7,7,0,1,0
58712,2,10,17,-7,10,1
123692,4,10,25,-15,4,0
92175,4,3,43,-40,8,1
321526,1,0,0,0,7,0
301394,4,17,16,1,15,0
369573,3,14,0,14,11,1
399323,2,14,7,7,7,1
130806,3,13,12,1,8,1
41170,2,0,7,-7,2,0
153313,4,2,10,-8,1,1
280334,4,19,22,-3,5,1
140370,4,17,29,-12,12,0
9946,3,3,3,0,5,1
344873,4,30,10,20,17,0
413803,1,7,0,7,14,0
407946,4,17,24,-7,11,1
298814,2,14,9,5,14,0
141621,1,3,7,-4,13,1
140454,2,14,7,7,12,1
217362,4,21,10,11,12,0
292596,2,6,16,-10,11,1
251351,2,21,14,7,10,0
98921,3,7,17,-10,11,0
166371,1,3,0,3,6,0
58490,1,0,0,0,10,0
261322,1,0,7,-7,14,1
416735,2,0,0,0,15,1
138063,3,36,17,19,11,0
211064,3,27,0,27,9,1
364547,2,9,21,-12,9,1
50459,3,10,10,0,6,1
27357,3,24,10,14,13,1
360709,1,3,7,-4,7,1
147049,1,0,0,0,15,0
312436,4,33,41,-8,3,1
202519,1,0,0,0,5,0
243048,2,0,9,-9,6,1
349478,4,6,20,-14,2,1
377603,4,20,12,8,15,0
42005,1,3,0,3,2,1
258819,2,7,7,0,13,0
14743,2,21,0,21,7,1
345679,2,7,0,7,17,1
86972,2,14,3,11,5,0
210932,4,19,10,9,9,0
110338,3,17,17,0,16,0
290368,2,13,3,10,10,1
319087,4,26,41,-15,5,1
285928,2,23,0,23,8,0
99935,3,10,6,4,12,0
52604,1,0,0,0,7,1
403328,3,9,0,9,9,1
269904,1,7,0,7,1,1
111321,1,0,7,-7,16,1
79145,2,0,0,0,2,1
17461,1,0,0,0,9,1
362000,4,23,12,11,7,0
160136,1,10,0,10,3,0
3461,3,3,23,-20,2,0
371884,3,24,10,14,12,1
207971,1,7,0,7,8,0
87263,2,17,14,3,6,0
51897,2,6,10,-4,7,1
34549,2,7,0,7,16,0
251104,3,10,14,-4,10,1
326126,4,30,10,20,9,1
190013,1,0,0,0,17,1
177122,3,24,13,11,11,0
360108,1,0,0,0,7,0
119143,3,10,7,3,3,0
326455,1,17,3,14,9,0
244005,1,7,7,0,6,0
31649,3,24,9,15,15,1
218771,3,0,16,-16,13,1
103804,2,6,0,6,13,1
89216,2,6,0,6,7,1
37392,3,24,0,24,17,1
356724,4,26,16,10,5,0
120994,2,5,21,-16,3,1
309324,4,3,23,-20,1,1
226147,4,21,17,4,16,0
307626,2,7,7,0,17,1
85697,4,24,21,3,5,0
409982,3,6,34,-28,12,0
131033,4,17,30,-13,8,1
100877,1,0,0,0,12,1
283357,4,10,16,-6,7,1
72382,4,10,23,-13,16,1
9654,3,12,27,-15,5,0
404943,2,3,13,-10,10,1
47426,5,13,13,0,5,1
66110,4,10,6,4,13,0
116064,4,16,7,9,1,0
244624,1,0,10,-10,7,0
383072,2,17,7,10,17,1
5236,3,21,17,4,3,0
15637,3,21,10,11,8,0
144831,1,14,0,14,14,0
377097,2,10,7,3,15,0
355756,3,7,6,1,5,1
42173,1,7,0,7,2,0
140341,3,17,20,-3,12,0
7854,1,3,7,-4,4,0
265307,1,7,0,7,16,0
311489,3,10,3,7,2,0
188690,1,0,14,-14,16,0
331155,2,7,13,-6,11,1
344589,4,0,6,-6,17,0
208303,2,7,21,-14,8,0
418340,4,9,24,-15,16,1
268788,3,31,10,21,17,1
1316,1,0,0,0,1,1
294292,1,0,0,0,12,1
100735,1,0,0,0,12,0
388227,4,12,13,-1,2,1
59298,1,0,3,-3,11,0
302468,2,3,3,0,15,0
54596,1,7,0,7,8,0
199459,4,22,17,5,4,0
193706,2,3,27,-24,1,1
38884,4,10,15,-5,1,0
414214,1,7,6,1,14,0
220441,3,23,14,9,13,0
258572,2,13,0,13,13,0
359279,1,0,6,-6,6,1
97926,1,0,7,-7,11,1
61074,1,0,0,0,11,0
86674,2,7,0,7,5,1
306355,4,37,10,27,17,0
320356,1,7,0,7,6,0
217630,3,19,16,3,12,0
226187,4,37,35,2,16,0
420689,4,21,16,5,17,0
43239,3,24,10,14,3,0
27197,3,16,7,9,13,1
278907,1,7,7,0,5,0
303527,4,37,17,20,16,0
189749,2,7,6,1,17,1
302492,2,3,10,-7,15,0
122079,1,0,7,-7,4,0
85134,1,0,3,-3,4,0
419795,4,23,20,3,17,1
403440,2,14,6,8,9,1
144194,1,0,7,-7,14,0
381492,2,14,0,14,17,0
316170,4,30,32,-2,4,1
193072,2,0,0,0,1,1
177318,4,23,20,3,11,1
378363,1,0,0,0,15,0
28003,4,30,23,7,13,0
247175,4,27,6,21,8,0
26582,2,10,6,4,13,0
310682,4,20,36,-16,2,0
137886,3,17,8,9,11,1
202703,2,3,10,-7,5,0
336158,3,10,3,7,13,1
336103,2,10,0,10,13,0
166343,4,20,9,11,6,0
252911,2,6,0,6,11,0
41847,4,28,14,14,2,1
154139,2,0,6,-6,1,1
328975,3,30,7,23,10,0
140672,4,38,10,28,12,0
204428,2,7,10,-3,6,0
209248,3,20,7,13,8,1
82780,2,9,6,3,3,0
10679,4,10,17,-7,5,1
241322,4,13,14,-1,5,0
197774,4,21,17,4,3,0
316313,4,10,19,-9,4,1
252498,3,10,22,-12,10,0
193031,1,0,0,0,1,1
219471,2,0,14,-14,13,0
862,4,14,12,2,1,1
213899,1,0,0,0,10,1
98183,4,28,19,9,11,0
404383,4,20,13,7,10,1
56256,2,3,13,-10,9,0
401383,2,17,0,17,8,0
182877,1,0,3,-3,14,1
183658,2,0,8,-8,14,0
346051,3,3,6,-3,1,1
402929,4,23,9,14,9,1
340063,4,17,12,5,15,0
197589,3,19,0,19,3,1
400412,4,24,10,14,8,1
194817,4,10,26,-16,2,1
147861,3,3,17,-14,15,0
64119,1,0,0,0,13,1
155386,2,13,3,10,2,0
200784,4,31,10,21,4,1
35550,4,30,7,23,17,1
315935,2,0,7,-7,4,1
270842,2,9,7,2,1,0
20070,4,22,16,6,10,1
210014,3,7,3,4,8,0
330871,3,13,17,-4,11,0
385700,1,0,0,0,1,1
207289,2,0,14,-14,7,1
14881,2,7,0,7,7,0
7830,1,0,0,0,4,0
392510,3,3,20,-17,4,0
224107,1,0,6,-6,15,0
245951,4,21,37,-16,7,0
109883,3,20,0,20,16,1
202770,4,16,17,-1,5,1
339933,4,33,6,27,15,0
236443,1,0,0,0,3,1
211861,3,22,10,12,9,1
89823,2,6,3,3,7,0
235687,2,0,3,-3,3,0
40758,3,17,21,-4,2,0
124931,1,0,0,0,5,0
191497,1,7,14,-7,17,1
356880,4,25,16,9,5,0
370069,4,31,20,11,12,0
8524,4,15,10,5,4,1
326497,2,31,9,22,9,1
350843,1,0,0,0,3,1
366317,4,28,10,18,10,0
129295,4,17,13,4,7,0
285273,3,14,6,8,7,1
364679,2,3,0,3,9,0
188178,4,17,13,4,16,1
6969,3,0,7,-7,3,1
38208,2,3,7,-4,1,0
4462,1,7,9,-2,2,0
144615,4,20,22,-2,14,0
357366,2,7,7,0,5,0
310553,1,0,6,-6,2,1
110256,1,0,3,-3,16,0
233645,4,23,41,-18,2,0
411584,2,7,13,-6,13,1
294024,1,7,6,1,12,0
399799,3,11,24,-13,8,0
157287,4,13,3,10,2,1
23123,1,0,0,0,11,1
387348,1,7,0,7,2,1
143564,4,26,28,-2,14,1
279291,4,19,16,3,5,0
168007,3,3,14,-11,7,1
403966,4,20,24,-4,10,1
93318,3,24,3,21,9,0
193010,4,17,20,-3,1,1
18831,1,3,0,3,9,0
103846,3,19,0,19,13,1
281477,2,7,10,-3,6,1
170914,3,14,20,-6,8,1
63498,4,31,13,18,12,0
249783,4,35,28,7,9,0
336409,2,3,3,0,14,1
379630,4,26,13,13,16,0
151760,2,14,6,8,17,0
140104,2,7,0,7,12,0
338443,1,0,0,0,14,0
182271,2,7,0,7,14,1
127052,4,31,23,8,6,0
106828,4,34,29,5,14,0
315304,1,0,0,0,4,1
100466,2,7,7,0,12,0
380463,1,0,0,0,16,0
125305,2,10,3,7,5,1
410941,4,14,28,-14,13,0
226359,4,25,13,12,16,1
356400,4,31,20,11,5,0
312842,3,7,0,7,3,1
184077,2,6,7,-1,14,1
47537,3,37,6,31,5,0
143932,2,0,3,-3,14,1
281674,3,24,10,14,6,0
197100,2,7,17,-10,3,1
122225,1,3,7,-4,4,0
148224,4,16,31,-15,16,1
225560,4,8,31,-23,15,1
238698,3,16,17,-1,4,1
13996,2,3,6,-3,7,0
9467,2,10,3,7,5,1
211366,3,10,10,0,9,1
365122,2,0,14,-14,9,1
225217,3,3,7,-4,15,0
112966,1,7,0,7,17,0
261257,3,31,0,31,14,0
394309,2,10,10,0,5,1
372691,4,21,17,4,13,0
141224,3,3,24,-21,13,1
228639,2,13,14,-1,17,0
183142,4,7,12,-5,14,1
136662,4,22,19,3,11,1
321195,4,3,19,-16,6,1
165455,1,0,0,0,6,1
318093,2,9,7,2,5,0
26192,4,0,33,-33,13,0
159706,2,7,7,0,3,1
198305,2,6,14,-8,3,0
240927,2,14,6,8,5,1
185965,1,3,7,-4,15,0
74026,1,0,0,0,17,0
22612,3,23,3,20,11,0
7118,3,28,21,7,4,1
286376,2,7,0,7,8,0
211020,2,17,0,17,9,1
226804,4,14,23,-9,16,1
61009,3,34,16,18,11,0
252454,2,0,11,-11,10,0
66287,1,0,0,0,14,0
324726,3,16,7,9,8,1
327792,1,0,3,-3,10,1
14992,1,0,7,-7,7,0
27480,2,17,7,10,13,1
306550,1,0,7,-7,17,1
301313,2,14,7,7,15,1
352071,2,3,7,-4,3,0
13828,1,0,0,0,7,1
202161,4,13,6,7,5,1
364238,2,0,13,-13,9,0
28140,4,30,10,20,13,0
110380,4,27,23,4,16,0
123710,4,10,32,-22,4,1
347597,2,7,7,0,1,0
235121,3,0,10,-10,2,1
185017,4,14,32,-18,15,1
154501,4,14,17,-3,1,1
104894,2,3,3,0,14,1
214172,4,19,9,10,11,0
236961,3,38,7,31,3,1
1131,4,10,36,-26,1,0
80057,3,17,6,11,2,1
248686,4,31,10,21,9,1
158418,4,16,27,-11,3,1
160679,3,10,0,10,4,0
289185,3,20,10,10,9,0
389831,4,24,6,18,3,0
71221,4,19,20,-1,16,1
45420,2,7,0,7,4,0
51571,1,7,0,7,7,0
391686,2,0,3,-3,4,1
126848,2,10,6,4,6,1
98725,2,21,3,18,11,1
369575,3,14,0,14,11,1
354081,3,19,0,19,4,0
86308,3,20,23,-3,5,1
1144,4,10,36,-26,1,1
355208,1,0,14,-14,4,1
1668,2,6,0,6,1,1
192751,2,0,6,-6,1,0
340219,3,23,31,-8,15,1
57147,2,0,0,0,10,1
79907,3,3,16,-13,2,0
151037,2,3,3,0,17,1
307459,2,28,10,18,17,0
214922,3,7,19,-12,11,1
3289,2,3,3,0,2,1
343778,2,7,3,4,17,0
342081,1,3,3,0,16,0
240019,3,10,20,-10,5,1
50684,1,0,7,-7,6,0
110190,4,23,30,-7,16,0
211685,3,23,9,14,9,1
121863,3,0,10,-10,4,1
365795,4,24,17,7,9,1
97339,2,0,6,-6,10,1
302442,1,0,3,-3,15,1
371691,1,0,7,-7,12,1
290709,4,41,25,16,10,0
170583,3,34,6,28,8,0
44073,1,0,6,-6,3,1
77547,3,20,14,6,1,1
367394,2,10,14,-4,10,0
4106,3,23,28,-5,2,0
369275,2,14,14,0,11,1
40466,3,7,14,-7,2,0
229505,1,3,0,3,17,1
110795,3,6,10,-4,16,0
256837,1,0,0,0,12,0
317243,4,7,16,-9,5,0
9558,5,20,20,0,5,0
393413,3,28,24,4,5,1
297891,1,3,0,3,13,0
362475,2,7,6,1,8,0
59356,3,0,9,-9,11,0
119781,3,10,6,4,3,1
25385,2,6,0,6,12,0
373348,2,7,0,7,13,0
130977,3,10,27,-17,8,0
294821,2,28,21,7,12,1
274530,2,20,9,11,3,1
310578,2,3,20,-17,2,1
215260,4,10,16,-6,11,0
79086,4,22,21,1,2,1
232725,1,0,0,0,2,0
319387,4,23,28,-5,6,0
17190,2,7,21,-14,9,1
216192,3,14,3,11,12,1
213019,1,3,0,3,10,0
103189,2,0,0,0,13,1
167150,1,6,0,6,7,0
174025,2,0,13,-13,10,1
268163,3,9,14,-5,17,0
332050,3,10,3,7,12,1
348847,2,3,14,-11,2,0
117383,4,34,3,31,2,1
348022,1,0,6,-6,1,0
248564,1,0,0,0,9,1
356240,4,29,14,15,5,0
116539,1,0,0,0,2,1
14748,2,28,0,28,7,0
11779,1,7,0,7,6,1
234364,3,17,10,7,2,0
204820,1,0,0,0,6,0
123842,4,17,3,14,5,0
393566,2,7,12,-5,5,0
196612,4,27,20,7,2,0
232164,2,6,0,6,1,0
204254,2,0,7,-7,6,0
258455,4,21,13,8,13,1
418060,4,35,35,0,16,0
182174,3,26,7,19,13,1
412758,1,7,10,-3,14,0
225304,2,0,14,-14,15,0
197278,2,0,0,0,3,1
311731,1,0,3,-3,2,0
309323,4,3,23,-20,1,1
368373,2,13,0,13,11,1
83921,4,23,24,-1,4,0
29819,1,3,3,0,14,1
256821,4,13,19,-6,12,1
342687,1,0,0,0,16,0
95837,3,6,10,-4,10,0
353684,2,3,7,-4,4,0
342990,1,0,0,0,16,1
159728,2,7,10,-3,3,0
337068,3,19,0,19,14,1
124176,4,22,27,-5,5,0
46427,1,0,0,0,4,0
282253,3,10,14,-4,6,0
233332,4,13,23,-10,2,1
156202,4,14,10,4,2,0
300947,4,17,27,-10,15,1
369705,2,22,17,5,11,0
6900,1,0,0,0,3,1
307218,4,3,10,-7,17,0
371137,1,0,9,-9,12,1
372281,2,10,7,3,13,1
339308,3,38,7,31,15,1
69467,4,24,10,14,15,1
240970,3,21,16,5,5,1
394888,2,0,17,-17,5,1
87951,4,19,25,-6,6,1
316744,2,10,0,10,4,0
18486,4,17,14,3,9,0
43631,2,7,3,4,3,0
74083,2,9,0,9,17,0
61740,4,24,31,-7,12,0
252620,2,3,3,0,10,1
131839,2,14,7,7,8,1
235115,2,0,10,-10,2,0
404978,3,9,13,-4,10,0
98895,3,7,10,-3,11,1
81187,1,0,0,0,3,1
326832,3,10,14,-4,9,0
329892,1,0,7,-7,11,1
11089,3,10,13,-3,5,0
56175,4,27,21,6,9,0
132524,1,2,19,-17,9,1
228547,4,20,14,6,17,0
386891,1,7,0,7,2,0
279298,4,19,16,3,5,0
64739,3,21,0,21,13,0
260616,2,0,10,-10,14,1
4929,3,14,10,4,3,0
163194,4,33,28,5,5,0
221790,4,13,21,-8,14,0
280429,3,16,17,-1,5,0
128124,4,13,6,7,7,0
95721,4,13,9,4,10,0
366305,4,28,10,18,10,0
166647,4,22,20,2,6,1
312117,3,33,10,23,2,0
48205,1,0,0,0,5,0
91972,3,13,23,-10,8,0
258338,4,41,39,2,13,1
22618,3,23,3,20,11,1
56813,4,17,20,-3,9,0
316171,4,30,32,-2,4,0
169711,4,20,17,3,8,1
12881,3,13,13,0,6,1
410318,4,7,23,-16,13,0
306975,1,0,0,0,17,1
75336,4,21,33,-12,17,1
52399,3,9,17,-8,7,1
225415,4,27,38,-11,15,0
330546,3,7,7,0,11,1
387949,1,3,0,3,2,1
133990,1,0,0,0,9,0
277437,4,34,17,17,4,0
92237,1,7,0,7,8,1
222082,4,27,16,11,14,0
169642,2,13,7,6,8,1
203553,4,31,3,28,6,0
36739,1,0,7,-7,17,0
243280,3,7,10,-3,6,1
214747,2,3,10,-7,11,1
213575,4,17,14,3,10,0
28153,1,0,0,0,13,1
413216,1,7,0,7,14,0
308094,2,12,13,-1,1,1
97990,3,17,10,7,11,0
80094,4,24,22,2,2,1
211829,3,22,10,12,9,1
405693,1,9,0,9,10,1
301451,2,17,3,14,15,0
247610,4,19,23,-4,8,1
40981,1,0,7,-7,2,1
388958,4,17,27,-10,3,0
135865,4,21,17,4,10,0
251695,2,14,3,11,10,1
289019,3,19,21,-2,9,1
49247,4,17,10,7,6,0
246872,5,20,23,-3,8,1
51520,4,34,31,3,7,0
261570,4,12,9,3,14,0
334628,1,0,0,0,13,1
177083,2,10,10,0,11,1
102345,3,13,13,0,13,1
99975,4,17,19,-2,12,1
249577,3,21,13,8,9,1
293351,2,7,0,7,11,0
256878,2,7,9,-2,12,0
51574,1,7,0,7,7,0
40757,3,17,21,-4,2,0
363975,3,3,9,-6,8,1
48995,1,10,7,3,6,0
19518,1,0,0,0,10,1
214997,1,9,0,9,11,1
370318,3,14,35,-21,12,0
14162,2,0,21,-21,7,0
357220,1,0,3,-3,5,0
421823,2,0,13,-13,17,0
195119,4,7,29,-22,2,1
362416,4,30,20,10,8,0
65409,1,0,7,-7,13,0
190815,3,16,3,13,17,0
390894,4,15,28,-13,3,1
57149,2,6,0,6,10,1
14879,2,7,0,7,7,0
253534,2,3,7,-4,11,1
242340,3,20,13,7,6,1
300995,1,3,0,3,15,0
404112,1,6,0,6,10,0
337129,1,3,0,3,14,0
417101,4,34,0,34,15,0
331514,4,9,35,-26,11,0
53741,4,7,3,4,8,1
410885,2,14,12,2,13,0
112668,1,3,0,3,17,0
407807,1,0,0,0,11,1
104144,3,24,27,-3,13,0
140467,3,14,13,1,12,0
364892,4,13,20,-7,9,1
236092,4,51,10,41,3,0
174978,3,6,21,-15,10,0
71200,3,19,13,6,16,0
184913,2,0,7,-7,15,0
398740,2,14,17,-3,7,0
211398,4,10,13,-3,9,1
84877,2,26,17,9,4,1
210171,3,0,14,-14,9,1
393421,3,28,24,4,5,0
112169,4,13,27,-14,17,0
342320,4,20,6,14,16,0
247869,2,10,3,7,8,1
228204,3,10,27,-17,17,1
420229,4,3,13,-10,17,1
385547,2,0,10,-10,1,1
198945,3,13,22,-9,3,0
364633,1,0,0,0,9,1
273850,4,17,14,3,2,0
144065,2,7,0,7,14,1
329116,4,24,7,17,10,1
114357,2,24,13,11,1,0
148190,3,13,21,-8,16,0
144018,4,21,16,5,14,1
53333,1,0,0,0,8,1
357818,2,3,14,-11,6,1
17129,4,30,17,13,9,0
28028,1,0,7,-7,13,0
226130,3,14,17,-3,16,0
334276,3,9,7,2,13,1
323183,2,7,0,7,7,0
286948,4,26,19,7,8,0
333888,4,31,28,3,12,1
185594,3,10,20,-10,15,1
105048,2,0,14,-14,14,1
49461,1,0,0,0,6,0
11407,3,26,0,26,6,1
53288,4,3,7,-4,8,0
43911,1,0,7,-7,3,1
306184,3,10,3,7,17,1
52727,4,6,23,-17,7,1
169050,3,26,14,12,7,1
43013,1,0,0,0,3,1
5109,3,13,7,6,3,1
396673,2,7,7,0,6,0
377402,2,7,13,-6,15,1
68007,1,0,3,-3,14,0
406639,2,0,0,0,11,1
159428,3,13,20,-7,3,1
261868,3,6,20,-14,14,1
115912,4,13,23,-10,1,0
305980,1,3,0,3,17,0
169593,1,3,0,3,8,0
237105,3,8,26,-18,3,0
186021,2,17,34,-17,15,0
346234,3,40,0,40,1,0
158289,1,6,0,6,3,0
190655,2,21,7,14,17,0
287640,3,3,10,-7,9,1
376566,3,15,6,9,14,0
135743,4,23,29,-6,10,0
173305,2,14,17,-3,10,0
158973,3,20,29,-9,3,1
63707,1,7,0,7,12,0
333155,1,0,0,0,12,0
402798,4,30,20,10,9,1
356866,4,16,16,0,5,0
238083,4,13,13,0,4,1
410857,2,14,6,8,13,0
358890,3,6,28,-22,6,0
82899,2,3,0,3,4,0
115844,2,0,10,-10,1,1
48004,3,3,24,-21,5,0
404059,3,10,35,-25,10,1
142146,3,0,7,-7,13,1
277533,2,3,7,-4,4,0
153806,1,0,0,0,1,1
372725,1,0,0,0,13,0
69577,2,7,10,-3,15,1
207180,3,14,13,1,7,0
192048,4,24,27,-3,1,1
25470,4,13,17,-4,12,1
333947,2,14,7,7,12,0
41027,2,3,10,-7,2,1
402200,4,19,14,5,9,1
170889,3,7,20,-13,8,1
61316,4,31,28,3,11,1
143038,1,0,7,-7,13,1
389448,1,3,0,3,3,0
158792,2,14,3,11,3,0
255735,1,0,0,0,12,0
396708,3,7,7,0,6,1
180352,3,12,14,-2,13,1
78247,1,0,0,0,2,0
34617,4,24,7,17,16,1
268854,1,0,7,-7,17,0
194033,3,17,7,10,1,1
191276,4,10,17,-7,17,0
5909,2,0,9,-9,3,0
172270,4,21,13,8,9,1
358612,4,27,9,18,6,0
19054,4,10,6,4,10,1
152570,4,24,21,3,17,1
248691,1,0,0,0,9,1
89274,4,15,0,15,7,0
321965,4,28,28,0,7,1
174098,4,8,36,-28,10,1
366479,4,34,22,12,10,1
288612,4,23,41,-18,9,1
414882,3,28,7,21,15,0
261692,2,14,0,14,14,1
122478,4,13,26,-13,4,0
166733,2,13,3,10,6,0
358752,4,14,17,-3,6,1
324198,1,0,0,0,8,1
133402,1,0,7,-7,9,1
380545,3,14,17,-3,16,0
392164,2,0,13,-13,4,1
269579,4,24,31,-7,1,0
185466,4,17,20,-3,15,1
375663,3,17,20,-3,14,0
153941,1,0,0,0,1,1
350365,4,24,13,11,2,1
340319,2,10,7,3,15,1
397147,2,3,0,3,6,1
396471,4,28,25,3,6,0
115715,3,10,3,7,1,1
298682,3,13,7,6,14,1
304035,2,3,13,-10,16,0
221927,4,19,16,3,14,0
155215,2,14,7,7,1,0
262351,4,16,16,0,15,0
214603,3,3,9,-6,11,1
155109,4,13,33,-20,1,0
44191,4,13,27,-14,3,0
334997,2,16,7,9,13,0
187255,3,7,6,1,16,1
163212,1,0,3,-3,5,1
246845,4,13,20,-7,8,1
103265,4,3,10,-7,13,0
362529,3,16,12,4,8,1
341340,2,0,10,-10,16,1
172123,4,13,18,-5,9,1
293402,3,16,10,6,11,1
394383,4,31,17,14,5,1
337126,1,0,0,0,14,1
178317,2,7,3,4,12,0
61082,1,0,0,0,11,1
98034,4,17,24,-7,11,1
412540,4,31,14,17,14,1
289240,4,30,20,10,9,0
123718,1,0,0,0,5,1
1355,2,0,0,0,1,1
306790,4,19,33,-14,17,0
92459,4,23,10,13,8,0
361371,3,10,7,3,7,0
332982,1,0,0,0,12,0
262177,4,31,13,18,15,0
101367,2,6,0,6,12,1
280807,1,7,0,7,6,0
76648,3,10,0,10,1,1
27396,4,24,10,14,13,1
52871,4,14,58,-44,7,1
154373,4,34,24,10,1,1
204541,1,0,14,-14,6,0
226454,3,7,7,0,16,0
336177,4,17,3,14,13,0
90814,4,34,7,27,7,1
123943,2,7,0,7,5,1
318157,3,16,10,6,5,0
104531,4,14,38,-24,13,1
417441,1,3,7,-4,16,0
62154,3,7,14,-7,12,1
116863,2,7,7,0,2,0
147903,4,17,31,-14,15,1
307933,2,7,3,4,1,1
94611,1,7,7,0,9,1
400195,2,3,3,0,8,0
1358,2,7,0,7,1,0
290111,4,13,15,-2,10,1
345851,2,0,7,-7,17,1
411084,4,17,17,0,13,1
191816,2,10,7,3,1,0
194136,2,3,0,3,1,0
261476,1,3,0,3,14,1
149818,2,3,10,-7,16,1
254184,4,3,18,-15,11,0
248078,4,34,20,14,8,1
344991,4,10,23,-13,17,0
156746,1,7,7,0,2,1
233233,1,0,0,0,2,0
108971,2,16,17,-1,15,1
39313,4,17,27,-10,1,0
113156,3,41,7,34,17,0
248008,2,21,3,18,8,0
23849,4,24,7,17,12,0
38402,3,17,16,1,1,1
278254,4,34,35,-1,4,1
373821,2,13,0,13,13,1
152681,4,23,6,17,17,1
349822,1,0,0,0,2,0
300188,3,21,3,18,14,1
402614,3,17,16,1,9,1
349306,3,21,28,-7,2,1
153037,1,0,0,0,1,0
210787,4,24,10,14,9,1
294894,1,0,0,0,12,0
86430,3,20,7,13,5,1
149837,2,3,13,-10,16,0
204726,2,14,14,0,6,0
336484,4,17,17,0,14,1
140151,3,10,3,7,12,1
113281,2,13,21,-8,17,1
167967,2,0,7,-7,7,0
140327,3,17,19,-2,12,0
298388,2,7,14,-7,14,1
194968,4,14,22,-8,2,1
339387,1,0,3,-3,15,0
173608,2,0,13,-13,10,1
335041,4,16,13,3,13,0
227379,1,0,0,0,16,0
382361,1,0,7,-7,17,0
190034,1,14,0,14,17,1
81934,4,7,30,-23,3,0
373226,3,3,13,-10,13,1
368162,3,13,21,-8,11,1
390064,2,7,7,0,3,1
292204,4,21,14,7,11,0
7958,4,9,27,-18,4,1
289980,4,6,9,-3,10,0
215827,4,51,13,38,11,0
19343,4,14,17,-3,10,1
193944,4,31,24,7,1,1
105272,4,10,24,-14,14,1
119651,4,17,12,5,3,0
89123,4,23,6,17,6,0
403632,3,24,20,4,9,1
164553,4,26,17,9,5,0
187431,4,41,14,27,16,1
315952,2,0,7,-7,4,0
14679,4,33,21,12,7,1
140224,5,13,13,0,12,1
21832,2,0,0,0,11,1
200918,4,27,7,20,4,1
211325,2,10,3,7,9,0
60606,1,0,0,0,11,0
192367,4,27,27,0,1,0
302278,4,38,13,25,15,1
6600,4,22,13,9,3,1
326229,3,10,34,-24,9,1
5876,1,0,0,0,3,0
226384,1,0,0,0,16,0
123478,2,0,0,0,4,1
21244,2,3,0,3,11,0
303189,4,31,28,3,16,0
367246,2,3,0,3,10,1
347134,2,16,10,6,1,1
241518,1,3,3,0,5,0
242788,3,14,31,-17,6,1
253085,3,14,7,7,11,1
115476,4,39,28,11,1,1
79122,1,0,0,0,2,0
353995,1,0,0,0,4,1
348113,4,10,19,-9,1,0
214772,3,3,19,-16,11,0
380722,4,7,16,-9,16,0
143887,1,0,0,0,14,1
271310,3,6,24,-18,1,1
271461,3,14,0,14,1,1
236968,3,38,7,31,3,0
129998,2,0,10,-10,8,0
98265,2,14,24,-10,11,0
255540,4,30,7,23,12,0
319190,3,9,10,-1,5,0
272803,1,7,0,7,2,0
238148,1,3,3,0,4,0
293489,2,10,3,7,11,0
45029,3,13,10,3,4,1
3536,1,0,0,0,2,0
370013,3,10,7,3,12,0
50233,1,7,7,0,6,0
112936,4,19,13,6,17,1
265409,4,14,23,-9,16,1
327530,2,7,9,-2,10,1
32182,1,14,7,7,15,0
396891,3,27,13,14,6,0
279889,4,24,13,11,5,1
91809,3,17,0,17,8,1
390654,2,3,3,0,3,1
177387,2,17,7,10,11,0
411388,4,20,13,7,13,1
32313,1,0,0,0,15,0
112880,3,10,3,7,17,0
184305,4,37,14,23,14,0
71384,1,7,0,7,16,0
413898,4,17,9,8,14,1
288399,3,10,0,10,9,1
48629,4,27,27,0,5,0
115804,1,0,0,0,1,1
406571,4,20,37,-17,11,1
238722,4,19,17,2,4,0
331988,2,0,0,0,12,0
93030,3,13,6,7,8,0
188973,1,0,0,0,16,0
280878,3,16,3,13,6,1
214244,2,7,10,-3,11,1
312660,2,20,7,13,3,1
42061,3,20,7,13,2,0
115853,2,7,10,-3,1,0
70325,3,10,23,-13,15,0
179467,4,21,20,1,12,0
9260,1,7,0,7,5,0
101722,3,10,7,3,12,1
331023,3,39,10,29,11,1
318052,1,0,0,0,5,1
393222,2,14,6,8,5,1
140794,4,22,24,-2,12,0
97986,3,17,10,7,11,0
234105,4,27,14,13,2,0
171847,4,26,20,6,9,1
371309,2,21,10,11,12,0
170682,2,7,3,4,8,0
357333,1,0,0,0,5,0
240176,3,16,3,13,5,0
359199,4,13,21,-8,6,1
112219,1,7,7,0,17,1
99102,4,23,7,16,11,1
80086,4,24,22,2,2,0
186075,4,31,55,-24,15,1
265807,4,20,12,8,16,0
44472,4,17,12,5,3,0
66610,2,0,14,-14,14,0
329014,1,0,0,0,10,0
49856,4,21,17,4,6,0
359361,3,10,20,-10,6,0
311533,4,17,13,4,2,0
68130,4,6,10,-4,14,0
368065,1,0,0,0,11,1
198034,3,0,30,-30,3,1
174688,3,9,7,2,10,0
64867,2,7,3,4,13,1
323694,3,20,0,20,8,0
2360,1,0,3,-3,2,0
72644,2,13,3,10,16,1
328248,5,17,17,0,10,1
289934,3,6,3,3,10,0
404426,1,7,0,7,10,0
3167,3,13,9,4,2,0
217927,4,31,28,3,12,1
28768,1,0,0,0,14,1
408314,2,0,7,-7,12,0
211549,4,42,21,21,9,0
322435,1,6,0,6,7,0
94547,4,10,10,0,9,0
400303,1,0,0,0,8,0
169826,3,17,17,0,8,0
18523,1,0,0,0,9,1
257746,4,3,24,-21,13,0
155306,1,0,0,0,2,1
99049,3,9,0,9,11,1
59789,3,12,10,2,11,0
248593,2,7,3,4,9,0
230917,4,24,10,14,1,0
44576,2,10,14,-4,3,0
106253,1,0,0,0,14,0
48971,1,3,0,3,6,0
185249,3,17,9,8,15,0
291800,4,9,23,-14,11,1
413612,4,9,23,-14,14,0
359840,1,10,7,3,6,0
363621,1,0,0,0,8,0
30749,3,24,28,-4,15,1
262475,3,7,35,-28,15,1
257943,1,0,7,-7,13,1
150203,3,6,26,-20,16,0
177554,2,10,0,10,11,1
66054,3,7,0,7,13,0
357093,2,6,14,-8,5,1
328897,2,6,0,6,10,0
77007,4,17,20,-3,1,1
132731,3,10,17,-7,9,1
17515,2,13,0,13,9,0
150069,4,31,12,19,16,0
13734,2,0,17,-17,7,0
134123,4,27,13,14,9,0
378862,2,10,6,4,15,0
321470,3,21,27,-6,7,0
323157,1,0,0,0,7,0
368154,3,13,14,-1,11,0
410438,3,9,17,-8,13,0
284559,1,7,0,7,7,0
143225,3,10,13,-3,13,0
366087,1,0,0,0,10,0
251885,3,14,13,1,10,1
87369,1,7,0,7,6,1
28299,4,27,14,13,13,0
278458,2,22,0,22,4,0
156160,2,7,7,0,2,0
343404,4,6,34,-28,16,1
348657,2,3,3,0,2,0
314632,3,7,7,0,3,1
137090,3,17,3,14,11,1
93662,4,23,13,10,9,1
42376,3,14,9,5,2,0
167366,3,23,23,0,7,1
376259,4,10,14,-4,14,1
260460,1,7,0,7,14,0
166319,4,10,9,1,6,1
181043,1,7,0,7,13,0
302260,4,38,13,25,15,1
400457,1,0,0,0,8,1
408286,2,0,0,0,12,1
134190,2,0,17,-17,10,0
343154,1,3,0,3,16,0
397159,2,6,0,6,6,1
328957,3,16,7,9,10,1
384089,1,0,10,-10,1,1
239851,2,7,3,4,4,1
384052,4,20,30,-10,1,1
397297,2,0,21,-21,6,1
237893,4,14,27,-13,4,0
270054,1,3,3,0,1,0
414595,4,27,9,18,14,1
233067,1,0,0,0,2,0
180219,4,19,14,5,13,1
249535,2,14,3,11,9,0
362587,1,0,0,0,8,1
99984,4,17,19,-2,12,0
201803,2,13,9,4,5,0
96565,1,0,3,-3,10,1
420143,2,0,3,-3,17,0
4965,4,21,17,4,3,1
83178,1,0,0,0,4,1
102112,4,49,24,25,12,0
375154,3,17,10,7,14,0
266129,4,17,13,4,16,0
142464,3,7,10,-3,13,1
356805,2,0,7,-7,5,1
18809,1,0,0,0,9,1
48190,4,10,19,-9,5,1
164063,3,3,6,-3,5,0
108043,1,3,7,-4,15,1
91735,1,0,0,0,8,0
279533,2,10,6,4,5,0
420565,1,0,0,0,17,0
394423,1,0,3,-3,5,0
126368,3,7,14,-7,6,1
56173,4,27,21,6,9,1
385343,4,17,29,-12,1,1
397255,1,0,7,-7,6,1
412782,2,14,17,-3,14,1
324453,4,17,6,11,8,0
201675,3,10,20,-10,5,1
276049,2,13,3,10,3,1
20270,1,7,0,7,10,1
93533,1,0,0,0,9,1
95908,4,20,23,-3,10,1
96048,4,13,7,6,10,1
259956,4,20,20,0,14,1
9606,2,6,7,-1,5,0
342465,4,20,3,17,16,0
181789,4,10,17,-7,13,0
389028,1,13,0,13,3,1
13705,1,0,14,-14,7,1
25442,4,13,17,-4,12,1
371519,1,0,0,0,12,1
345665,1,7,0,7,17,0
309357,1,0,0,0,1,1
332244,4,10,16,-6,12,1
58588,3,10,10,0,10,0
345324,4,22,24,-2,17,1
228633,2,10,14,-4,17,1
191410,3,0,31,-31,17,1
1761,1,0,0,0,1,1
161813,4,37,13,24,4,0
266299,1,0,0,0,16,1
235300,4,25,6,19,3,0
2228,2,7,7,0,1,0
129917,4,13,0,13,7,1
330692,3,6,3,3,11,1
380572,4,21,27,-6,16,1
292560,1,0,6,-6,11,1
317229,3,7,16,-9,5,0
110453,2,17,0,17,16,0
31114,1,0,3,-3,15,1
244800,2,7,0,7,7,0
303141,3,14,21,-7,16,0
74842,3,20,13,7,17,0
165884,4,6,19,-13,6,1
225252,4,17,7,10,15,0
269282,4,13,19,-6,17,1
135004,4,14,34,-20,10,1
69437,3,24,3,21,15,0
356717,4,19,16,3,5,1
273860,4,17,14,3,2,1
344199,1,0,3,-3,17,1
212624,3,7,24,-17,10,1
398454,2,7,0,7,7,0
372860,1,3,0,3,13,0
414460,4,16,23,-7,14,1
81192,1,0,0,0,3,1
185368,2,0,3,-3,15,1
260196,2,10,0,10,14,0
368894,4,31,3,28,11,1
393986,2,3,7,-4,5,0
267564,3,27,27,0,17,1
286949,4,26,19,7,8,0
281336,3,14,13,1,6,1
404726,1,7,3,4,10,0
23453,1,7,0,7,11,0
373741,4,16,21,-5,13,0
360436,2,10,0,10,7,0
345008,4,16,23,-7,17,0
142145,3,0,7,-7,13,1
62584,2,6,10,-4,12,0
409277,4,13,13,0,12,0
382017,4,7,30,-23,17,0
400715,4,16,10,6,8,1
177668,1,7,7,0,12,1
83242,3,9,7,2,4,0
221716,2,10,0,10,14,1
337400,4,21,14,7,14,1
68974,2,21,7,14,15,1
65262,1,0,7,-7,13,0
338091,3,6,7,-1,14,0
240467,2,3,7,-4,5,0
277531,2,3,7,-4,4,0
54222,3,0,3,-3,8,0
7080,2,14,14,0,4,1
164148,1,7,0,7,5,1
195118,4,7,29,-22,2,0
194639,3,24,7,17,2,0
214500,4,7,20,-13,11,1
111016,4,14,29,-15,16,1
88341,3,14,7,7,6,1
410538,1,7,7,0,13,1
318444,3,21,7,14,5,1
276772,2,17,10,7,4,1
192806,3,0,15,-15,1,0
348487,1,14,0,14,2,1
291488,4,21,20,1,10,0
267928,1,0,0,0,17,1
28323,1,0,0,0,14,1
128551,4,21,35,-14,7,1
65550,1,6,0,6,13,0
291105,2,12,13,-1,10,1
261076,2,0,14,-14,14,0
260076,2,6,14,-8,14,1
206448,3,17,0,17,7,0
295466,4,17,22,-5,12,1
401164,4,44,13,31,8,0
12773,1,0,0,0,6,0
168689,2,7,3,4,7,1
55694,3,20,14,6,9,1
169480,2,0,14,-14,8,0
314664,4,14,14,0,3,0
280247,2,3,13,-10,5,0
51420,2,3,10,-7,7,1
17092,3,23,3,20,9,0
259415,1,3,3,0,13,1
204454,3,7,24,-17,6,1
36883,1,0,0,0,17,0
21496,4,15,17,-2,11,0
176781,1,3,0,3,11,0
105767,4,37,10,27,14,0
82918,2,3,3,0,4,1
126050,2,7,3,4,6,1
257508,2,16,10,6,13,1
43335,2,14,7,7,3,0
82147,2,3,3,0,3,1
72629,2,13,0,13,16,1
14571,1,0,7,-7,7,0
169785,2,0,14,-14,8,1
119199,4,16,7,9,3,0
331118,2,7,12,-5,11,0
139278,3,13,13,0,12,1
241848,2,13,3,10,5,0
320181,4,17,20,-3,6,1
234257,4,20,24,-4,2,1
58824,1,0,0,0,10,1
292243,1,0,0,0,11,1
37061,2,13,7,6,17,1
27793,3,14,14,0,13,0
147618,4,15,0,15,15,0
201481,2,12,7,5,5,1
180966,3,17,21,-4,13,1
262024,3,24,24,0,14,0
220182,4,29,13,16,13,1
277017,4,31,20,11,4,0
413912,4,20,9,11,14,0
329008,1,0,0,0,10,0
211300,2,3,3,0,9,1
84217,4,17,10,7,4,0
319224,4,17,17,0,5,0
268422,2,14,3,11,17,1
282317,1,0,0,0,6,1
365593,3,35,17,18,9,0
154783,3,13,16,-3,1,0
300427,1,2,0,2,14,1
232042,2,0,24,-24,1,1
362701,4,3,13,-10,8,1
32783,1,0,0,0,15,0
348701,3,17,10,7,2,1
189743,2,7,6,1,17,0
373068,2,3,7,-4,13,1
60275,4,10,16,-6,11,1
290584,4,26,20,6,10,0
106401,1,7,0,7,14,0
135704,3,17,16,1,10,0
387130,3,10,31,-21,2,1
17784,1,7,3,4,9,1
208677,4,9,6,3,8,1
91418,1,3,0,3,8,0
3954,4,22,14,8,2,1
113883,2,7,3,4,17,1
9977,4,3,3,0,5,1
120962,1,5,0,5,3,0
177074,2,10,3,7,11,0
222099,4,27,17,10,14,1
38873,4,10,13,-3,1,0
204809,4,28,30,-2,6,0
168155,3,16,5,11,7,1
356083,4,34,16,18,5,0
93039,3,13,9,4,8,0
315449,1,0,0,0,4,0
420836,4,17,17,0,17,0
203791,3,17,10,7,6,1
349684,2,13,7,6,2,1
198822,3,6,23,-17,3,1
288478,1,0,0,0,9,1
79566,2,0,0,0,2,1
245547,2,34,0,34,7,0
340108,1,0,0,0,15,1
52237,3,7,16,-9,7,1
203893,5,37,37,0,6,1
90294,2,7,14,-7,7,0
198096,1,0,0,0,3,0
192577,1,3,0,3,1,1
199167,1,0,0,0,4,1
205276,1,3,0,3,6,0
317827,3,9,3,6,5,0
369422,2,23,7,16,11,1
199926,1,0,10,-10,4,1
90194,4,3,3,0,7,1
284027,3,3,3,0,7,0
380052,3,21,17,4,16,0
272533,2,10,3,7,2,1
195566,3,13,7,6,2,0
139824,2,10,10,0,12,0
411670,4,34,28,6,13,1
253244,3,3,7,-4,11,1
179222,2,14,3,11,12,1
2072,2,0,7,-7,1,1
211552,4,42,21,21,9,0
19965,1,6,3,3,10,1
399668,4,16,9,7,8,1
41003,1,3,7,-4,2,0
405910,2,14,0,14,11,1
5018,1,0,0,0,3,0
37893,2,3,7,-4,1,1
415491,4,23,3,20,15,1
73268,4,14,22,-8,16,0
60032,1,7,0,7,11,0
110471,3,17,0,17,16,0
381034,2,7,3,4,16,0
31523,4,3,17,-14,15,1
372126,2,9,7,2,13,0
397972,4,10,27,-17,7,1
49932,2,14,0,14,6,1
386876,1,0,0,0,2,1
113241,1,7,0,7,17,0
401132,3,34,13,21,8,0
209232,3,20,7,13,8,0
271920,3,17,13,4,2,0
201497,3,25,7,18,5,0
99513,4,3,10,-7,11,0
138463,3,21,14,7,12,1
69253,2,6,0,6,15,1
63626,3,13,33,-20,12,1
284032,3,3,3,0,7,1
213191,2,3,10,-7,10,1
297766,1,7,0,7,13,0
329782,2,17,13,4,11,0
282638,2,6,7,-1,6,0
311960,3,35,10,25,2,0
17036,1,7,0,7,9,1
325787,2,6,10,-4,9,0
295088,2,7,6,1,12,0
170040,4,35,17,18,8,0
218609,3,7,23,-16,13,0
144231,2,9,7,2,14,0
391607,4,10,24,-14,4,1
1174,1,0,0,0,1,1
304540,4,10,21,-11,16,1
250834,4,3,9,-6,10,0
396907,4,27,27,0,6,1
10286,1,0,7,-7,5,1
218593,2,7,17,-10,13,0
374336,4,25,13,12,13,1
114638,2,3,3,0,1,0
2898,4,31,34,-3,2,0
83419,4,10,20,-10,4,0
322485,3,15,3,12,7,0
357432,3,31,24,7,5,0
99656,3,23,3,20,11,1
66285,1,0,0,0,14,0
189586,2,0,0,0,17,0
320473,4,20,17,3,6,0
417375,3,13,10,3,16,0
211101,4,37,0,37,9,1
278079,4,13,10,3,4,0
26748,3,6,17,-11,13,0
240655,3,23,24,-1,5,1
223835,2,9,0,9,15,1
174778,1,6,7,-1,10,1
117390,4,34,3,31,2,0
42850,4,6,37,-31,3,1
113723,2,3,10,-7,17,0
266261,4,38,19,19,16,1
87356,1,7,0,7,6,0
81000,4,20,17,3,3,0
389303,1,0,6,-6,3,1
331283,2,0,7,-7,11,0
143385,3,7,23,-16,14,0
2129,3,10,13,-3,1,0
328927,2,6,7,-1,10,1
407176,4,17,33,-16,11,1
61945,1,0,0,0,12,1
19743,3,9,9,0,10,0
362958,3,27,9,18,8,0
260779,2,3,6,-3,14,1
331727,2,3,13,-10,12,1
72778,2,14,14,0,16,1
414081,1,0,3,-3,14,1
396207,1,0,0,0,6,0
359972,1,0,6,-6,7,0
148251,1,0,0,0,16,1
170381,1,14,0,14,8,0
8045,2,10,7,3,4,1
377892,3,20,13,7,15,1
54522,3,14,10,4,8,1
9705,4,19,28,-9,5,1
389073,3,20,0,20,3,1
286667,1,10,0,10,8,1
315277,5,20,19,1,4,0
319964,3,30,10,20,6,0
1372,2,7,0,7,1,0
34816,1,0,0,0,16,1
307749,1,7,7,0,1,1
407746,3,10,0,10,11,0
279535,2,10,6,4,5,0
246260,4,24,16,8,7,0
324677,1,0,7,-7,8,0
321634,3,17,13,4,7,1
126333,2,7,7,0,6,1
354722,1,0,0,0,4,1
312747,4,31,21,10,3,0
12374,2,7,3,4,6,1
417258,4,20,20,0,16,0
382129,3,27,3,24,17,0
85613,1,7,0,7,5,1
67997,1,0,0,0,14,0
156488,3,0,6,-6,2,0
253674,2,3,0,3,11,1
53862,2,0,0,0,8,1
295137,4,7,14,-7,12,1
50791,1,0,0,0,6,0
82295,2,3,9,-6,3,0
29178,4,3,19,-16,14,1
359590,2,17,0,17,6,1
228522,3,20,7,13,17,0
286788,4,20,31,-11,8,1
4588,1,7,7,0,2,0
418630,4,21,31,-10,16,1
33319,1,0,0,0,16,1
175288,3,15,10,5,10,0
335768,4,17,7,10,13,0
141128,1,3,7,-4,13,0
1353,2,0,0,0,1,1
38690,3,14,7,7,1,0
88209,4,17,17,0,6,0
177070,1,9,3,6,11,1
361148,5,23,23,0,7,1
348403,3,13,13,0,1,0
298266,3,20,13,7,14,1
58473,4,48,23,25,10,0
308055,1,0,7,-7,1,1
40417,1,0,7,-7,2,0
151404,4,34,20,14,17,1
389452,1,3,0,3,3,1
196083,2,6,21,-15,2,0
79533,1,0,0,0,2,0
163924,3,23,10,13,5,1
369728,3,29,23,6,11,0
46604,2,3,0,3,4,0
176289,2,0,14,-14,11,0
357910,4,13,34,-21,6,0
97200,2,6,6,0,10,1
328625,3,17,35,-18,10,1
415728,2,14,10,4,15,0
82836,4,15,16,-1,3,1
116953,4,28,13,15,2,1
84937,4,48,23,25,4,1
89773,1,0,0,0,7,1
154396,1,0,0,0,1,0
371693,1,0,7,-7,12,1
28346,2,3,0,3,14,0
100729,1,0,0,0,12,1
140213,5,13,13,0,12,1
131392,3,7,13,-6,8,1
314071,3,22,14,8,3,1
8983,1,0,0,0,4,0
314399,4,10,17,-7,3,0
171826,4,26,17,9,9,0
138477,3,24,20,4,12,0
36542,4,13,20,-7,17,1
66452,2,0,7,-7,14,1
236435,1,0,0,0,3,1
36615,2,3,3,0,17,0
29827,2,6,3,3,14,0
379217,4,12,13,-1,16,0
82420,1,0,7,-7,3,1
203991,3,13,7,6,6,0
375025,3,21,27,-6,14,0
37976,4,17,14,3,1,1
387040,1,0,6,-6,2,0
288051,1,7,0,7,9,0
2113,3,10,13,-3,1,1
421784,1,0,0,0,17,0
360769,3,24,21,3,7,0
211675,3,23,3,20,9,1
158631,2,7,7,0,3,1
348944,1,7,0,7,2,0
26234,1,0,7,-7,13,0
398435,1,7,0,7,7,0
186278,2,13,3,10,15,0
33840,3,3,34,-31,16,1
257623,1,0,7,-7,13,1
407916,3,17,24,-7,11,0
114197,2,3,0,3,1,1
137335,1,3,0,3,11,0
79746,2,17,7,10,2,1
176037,3,24,0,24,11,0
414596,4,28,9,19,14,0
277337,1,7,0,7,4,0
130288,1,0,0,0,8,1
202819,1,0,0,0,5,1
74233,2,3,7,-4,17,0
375339,3,7,17,-10,14,1
413298,3,17,0,17,14,1
230048,4,19,6,13,17,0
172954,1,7,0,7,9,0
359708,1,10,6,4,6,0
153500,1,0,0,0,1,0
70964,1,0,0,0,16,0
54739,1,3,0,3,8,1
293485,2,10,3,7,11,0
237842,2,7,20,-13,4,1
230870,2,7,10,-3,1,1
127242,5,16,16,0,6,0
223651,2,6,3,3,15,1
214453,3,7,14,-7,11,0
230450,3,21,11,10,1,0
118153,3,23,27,-4,2,1
333,1,14,3,11,1,1
159909,3,31,7,24,3,0
63747,2,7,15,-8,12,1
322157,2,0,14,-14,7,0
394929,3,6,17,-11,5,0
418465,3,17,3,14,16,0
223506,2,7,10,-3,15,0
391747,3,10,10,0,4,0
324967,1,6,14,-8,8,1
150895,2,7,7,0,17,0
309850,3,14,7,7,1,1
342472,4,20,3,17,16,1
11398,3,23,0,23,6,1
393035,1,0,0,0,4,0
18438,2,7,7,0,9,0
395442,1,0,0,0,6,1
5912,2,0,16,-16,3,1
159798,4,7,27,-20,3,1
10763,2,7,0,7,5,0
112077,2,7,7,0,17,1
391781,4,10,13,-3,4,0
174628,1,3,0,3,10,0
276418,4,32,44,-12,3,1
55886,4,19,22,-3,9,1
29218,1,0,0,0,14,1
379585,2,16,6,10,16,0
171572,1,0,0,0,9,1
62463,4,7,13,-6,12,1
249898,3,12,20,-8,9,0
52555,3,16,7,9,7,1
411640,3,26,28,-2,13,1
184819,3,17,20,-3,15,1
62953,1,0,0,0,12,0
239174,3,20,16,4,4,1
392172,2,3,13,-10,4,1
313073,4,20,0,20,3,0
80637,2,7,16,-9,3,1
409206,2,10,3,7,12,0
336075,1,0,0,0,13,1
333560,4,16,10,6,12,1
35070,3,15,16,-1,16,0
156901,1,6,3,3,2,1
159708,2,7,7,0,3,0
188174,4,17,10,7,16,0
567,4,14,27,-13,1,1
92313,4,20,0,20,8,1
359876,2,20,21,-1,6,1
163159,3,22,25,-3,5,0
31610,2,17,6,11,15,0
189070,3,21,30,-9,16,1
178766,1,21,7,14,12,0
247538,2,6,10,-4,8,1
247747,3,10,6,4,8,0
297642,2,7,0,7,13,1
48070,1,0,0,0,5,0
65071,4,6,17,-11,13,0
382248,2,17,3,14,17,0
32082,3,14,13,1,15,0
244660,2,7,23,-16,7,0
385508,1,0,0,0,1,1
138255,4,10,12,-2,11,1
305466,4,20,10,10,17,0
262465,3,7,28,-21,15,0
333480,2,3,0,3,12,0
301757,2,0,17,-17,15,0
194446,2,9,0,9,2,1
390531,2,10,7,3,3,1
407944,4,17,24,-7,11,0
213122,4,20,6,14,10,1
154446,2,14,7,7,1,1
320019,4,43,30,13,6,1
187968,2,6,14,-8,16,1
181092,3,17,7,10,13,1
24348,2,3,0,3,12,0
18909,4,9,13,-4,9,0
193900,4,24,10,14,1,0
102254,1,7,0,7,13,0
163674,1,0,0,0,5,0
245674,1,3,3,0,7,1
160566,4,23,20,3,4,1
421688,2,17,7,10,17,0
182357,3,24,17,7,14,1
411104,1,0,0,0,13,0
150746,3,13,9,4,17,1
333621,1,0,0,0,12,0
390688,2,3,3,0,3,1
118211,1,9,0,9,2,0
104455,2,7,10,-3,13,0
385629,4,9,24,-15,1,0
51266,1,6,0,6,7,0
186494,3,17,20,-3,15,1
105444,4,23,30,-7,14,0
142229,5,11,13,-2,13,1
365107,2,0,7,-7,9,0
30466,3,30,28,2,14,1
171595,2,3,3,0,9,0
194352,4,23,6,17,2,0
26675,1,0,7,-7,13,1
71811,4,38,33,5,16,0
354585,1,0,7,-7,4,1
291658,1,0,0,0,11,1
337933,3,13,0,13,14,1
250761,2,3,0,3,10,1
326975,3,2,7,-5,9,1
308505,1,0,6,-6,1,0
362513,3,14,6,8,8,0
187258,3,10,6,4,16,0
25918,4,38,17,21,12,0
343099,4,12,20,-8,16,1
179279,3,33,3,30,12,0
134633,3,31,17,14,10,0
391133,2,7,24,-17,4,1
206977,1,21,0,21,7,0
247433,3,10,9,1,8,1
148919,2,3,9,-6,16,0
202427,2,3,3,0,5,0
90945,4,61,7,54,7,1
83933,1,0,0,0,4,1
290113,4,13,15,-2,10,1
121399,4,7,6,1,3,0
25221,1,0,0,0,12,0
224092,4,17,9,8,15,1
241332,1,0,0,0,5,1
241327,4,13,14,-1,5,0
373250,4,13,16,-3,13,0
294101,4,7,27,-20,12,1
207189,3,14,13,1,7,0
14171,3,0,24,-24,7,0
276992,4,24,20,4,4,1
2673,2,6,0,6,2,0
253894,3,38,14,24,11,0
152376,3,21,3,18,17,1
368237,1,0,3,-3,11,1
198640,3,10,14,-4,3,0
360419,2,6,0,6,7,1
237819,2,7,13,-6,4,0
66081,3,10,3,7,13,0
359760,3,24,16,8,6,1
3348,4,3,6,-3,2,0
152419,4,38,3,35,17,0
267710,3,14,27,-13,17,1
222810,3,10,13,-3,14,0
274574,3,24,23,1,3,0
231232,4,10,16,-6,1,1
27911,2,0,3,-3,13,0
294711,4,6,14,-8,12,0
220491,1,0,7,-7,13,1
72831,4,31,17,14,16,1
399460,2,0,17,-17,7,0
282620,1,3,7,-4,6,0
350410,1,0,3,-3,2,0
364952,1,7,0,7,9,0
420098,1,0,0,0,17,0
396324,4,6,13,-7,6,0
409132,4,3,10,-7,12,0
267981,2,7,6,1,17,0
72624,2,13,0,13,16,1
175090,2,7,10,-3,10,1
217727,2,7,7,0,12,1
167409,4,43,40,3,7,1
361627,2,0,12,-12,7,0
249339,2,10,6,4,9,0
284970,3,13,20,-7,7,1
261258,3,31,0,31,14,0
196278,3,21,10,11,2,1
254744,2,3,3,0,11,0
314061,3,15,14,1,3,1
38632,1,0,0,0,1,1
298939,2,3,9,-6,14,1
255833,3,17,0,17,12,1
144197,1,0,7,-7,14,0
100422,4,12,20,-8,12,1
169193,2,10,6,4,7,1
94692,4,24,36,-12,9,1
24827,2,6,3,3,12,1
142668,4,20,13,7,13,0
58781,4,10,29,-19,10,1
182113,1,9,0,9,13,1
45033,3,20,10,10,4,1
212238,4,3,24,-21,10,0
189011,2,7,7,0,16,1
47205,3,9,6,3,5,0
203278,1,0,10,-10,6,0
330190,1,0,0,0,11,1
419552,1,7,7,0,17,1
347391,5,21,21,0,1,0
81816,1,0,7,-7,3,0
34476,4,41,3,38,16,0
297394,3,9,24,-15,13,1
295350,1,3,0,3,12,0
155472,1,0,0,0,2,1
39503,4,13,19,-6,1,1
288597,4,23,38,-15,9,0
42346,2,7,9,-2,2,1
76557,4,7,41,-34,1,0
341136,4,21,24,-3,15,0
95750,4,20,9,11,10,1
239782,4,20,20,0,4,1
243008,5,37,34,3,6,1
334844,2,16,3,13,13,0
41453,2,2,7,-5,2,1
369409,2,17,7,10,11,0
55223,2,7,0,7,9,1
102762,2,10,0,10,13,0
187170,1,0,0,0,16,1
58836,1,0,0,0,10,1
201009,2,20,0,20,5,1
387998,2,3,3,0,2,1
128091,3,3,6,-3,7,1
358985,2,7,0,7,6,0
381748,1,0,0,0,17,1
292239,4,24,17,7,11,1
162123,4,51,13,38,4,0
327843,2,16,10,6,10,0
89885,4,30,13,17,7,0
336229,1,3,0,3,13,0
288398,3,10,0,10,9,1
324016,4,20,22,-2,8,0
162963,2,6,0,6,5,0
295895,3,10,14,-4,12,0
291446,3,14,20,-6,10,0
159417,3,13,20,-7,3,1
5836,4,27,7,20,3,1
172139,4,13,18,-5,9,1
27199,3,16,7,9,13,1
365961,1,6,7,-1,10,1
160211,4,30,14,16,3,1
367208,4,29,26,3,10,0
339536,1,7,0,7,15,0
175339,1,0,0,0,11,1
322370,3,14,13,1,7,0
398960,4,23,20,3,7,1
363650,2,0,10,-10,8,0
179595,3,20,23,-3,12,1
11756,4,33,31,2,6,0
60009,4,3,31,-28,11,1
14227,4,0,38,-38,7,1
278429,1,15,0,15,4,0
326910,1,2,0,2,9,1
128969,3,28,3,25,7,0
31160,2,17,13,4,15,0
67393,4,30,13,17,14,1
77920,1,3,0,3,1,1
113520,4,3,7,-4,17,1
325494,3,19,6,13,8,0
332853,1,7,0,7,12,0
387275,3,6,10,-4,2,0
337623,2,14,10,4,14,0
68351,2,3,7,-4,14,0
154151,3,7,6,1,1,1
343531,4,10,10,0,16,0
301471,2,20,6,14,15,0
330545,3,7,7,0,11,1
308049,1,0,7,-7,1,0
198457,2,17,3,14,3,0
215270,1,0,0,0,11,0
131420,3,7,19,-12,8,1
362937,2,21,6,15,8,1
65869,2,7,7,0,13,0
293877,1,0,6,-6,12,0
206698,2,0,14,-14,7,0
130216,3,3,26,-23,8,0
61691,3,17,10,7,12,0
367606,4,28,12,16,10,1
420326,3,17,3,14,17,0
190255,3,7,14,-7,17,0
320990,2,7,0,7,6,0
420842,4,17,20,-3,17,1
106214,4,7,10,-3,14,0
113627,3,6,13,-7,17,1
364735,4,6,3,3,9,0
164302,1,13,0,13,5,0
78613,3,23,13,10,2,1
112494,1,0,9,-9,17,0
13728,2,0,17,-17,7,0
274237,2,17,7,10,3,1
67253,4,7,3,4,14,0
338104,4,6,7,-1,14,1
160104,1,0,0,0,3,1
58904,3,6,25,-19,10,1
22814,4,13,21,-8,11,1
361372,3,10,7,3,7,0
28098,3,24,10,14,13,0
271617,3,23,20,3,2,0
163203,1,0,0,0,5,1
357423,3,24,17,7,5,0
421491,2,0,3,-3,17,1
168400,1,0,3,-3,7,0
392352,3,17,28,-11,4,1
284292,2,3,3,0,7,0
124649,1,0,0,0,5,0
201128,1,6,14,-8,5,1
177906,4,21,23,-2,12,0
421398,3,16,20,-4,17,1
217106,1,0,7,-7,12,1
235138,3,0,10,-10,2,0
280711,3,0,6,-6,5,1
121885,4,0,23,-23,4,0
344223,2,7,3,4,17,0
3109,2,0,3,-3,2,0
326830,3,10,14,-4,9,0
365472,4,10,19,-9,9,1
351473,1,0,17,-17,3,1
1963,2,10,2,8,1,0
50203,1,7,0,7,6,0
2481,1,0,0,0,2,0
82632,3,12,10,2,3,1
103814,2,9,0,9,13,1
189143,1,14,0,14,16,1
402164,3,19,7,12,9,1
175056,1,0,0,0,10,1
307380,4,16,25,-9,17,0
230848,2,0,7,-7,1,1
415512,1,0,0,0,15,0
404689,4,27,32,-5,10,1
131247,3,14,17,-3,8,0
393373,2,21,7,14,5,1
417226,3,17,20,-3,16,1
149254,2,7,13,-6,16,1
347714,1,0,0,0,1,0
96230,4,3,22,-19,10,0
39260,2,3,10,-7,1,0
142362,4,7,6,1,13,1
69793,1,7,0,7,15,1
104402,4,52,38,14,13,0
48784,4,24,28,-4,5,0
78281,2,3,21,-18,2,1
95102,2,0,10,-10,9,1
61290,4,28,14,14,11,1
351648,2,7,7,0,3,0
366836,2,0,3,-3,10,1
102240,4,30,14,16,13,1
129781,4,17,24,-7,7,1
47619,1,3,14,-11,5,1
354732,1,6,0,6,4,0
158886,1,14,0,14,3,0
84968,1,9,7,2,4,0
172409,3,13,42,-29,9,1
381450,4,26,14,12,16,0
401845,3,7,21,-14,9,0
35942,3,3,6,-3,17,0
22751,3,3,21,-18,11,1
298597,4,13,10,3,14,1
324221,1,3,0,3,8,1
68191,2,7,7,0,14,0
111368,2,0,7,-7,16,1
415514,1,0,0,0,15,0
59196,2,14,42,-28,10,1
277925,4,7,27,-20,4,1
62842,1,3,0,3,12,0
338527,3,20,17,3,14,1
308261,3,10,13,-3,1,0
230946,4,31,10,21,1,1
217746,3,10,7,3,12,1
131095,2,20,6,14,8,0
342860,2,16,0,16,16,0
142777,3,12,10,2,13,0
288282,4,10,35,-25,9,1
151232,4,17,23,-6,17,0
77565,4,20,14,6,1,1
184106,3,16,14,2,14,1
283524,1,6,0,6,7,0
64972,1,0,0,0,13,0
404601,2,7,10,-3,10,0
299617,4,13,16,-3,14,1
159824,1,7,0,7,3,1
102181,2,17,7,10,13,0
42022,2,6,7,-1,2,1
181847,2,21,7,14,13,0
219987,3,13,28,-15,13,1
37937,3,10,14,-4,1,1
364993,2,14,6,8,9,1
66652,3,7,23,-16,14,0
188879,2,10,7,3,16,0
228372,3,7,17,-10,17,1
395216,2,10,10,0,5,0
319936,2,23,7,16,6,0
254379,1,0,0,0,11,0
249974,1,0,3,-3,9,1
132512,1,0,6,-6,9,1
34748,3,13,3,10,16,1
69239,1,3,0,3,15,1
202038,5,17,17,0,5,1
235125,3,0,10,-10,2,1
40572,2,10,7,3,2,1
145946,3,7,21,-14,15,1
276340,2,14,21,-7,3,0
220029,4,16,35,-19,13,1
137144,4,31,6,25,11,1
131703,3,17,22,-5,8,0
253569,3,6,10,-4,11,1
230270,2,16,10,6,17,0
263565,1,0,0,0,15,0
332571,2,3,3,0,12,1
46814,4,14,39,-25,4,1
28518,2,24,6,18,14,0
417639,2,21,3,18,16,0
60030,1,0,0,0,11,1
52125,4,23,19,4,7,0
237256,4,20,0,20,3,1
213998,3,29,7,22,10,0
285411,2,24,0,24,8,0
392690,4,16,0,16,4,1
376954,2,3,16,-13,15,0
316711,1,0,0,0,4,1
339311,3,38,7,31,15,0
385419,2,21,7,14,1,0
234952,2,10,3,7,2,1
391680,2,0,3,-3,4,1
189539,4,20,7,13,17,1
32848,3,6,7,-1,15,1
100225,3,17,7,10,12,1
40390,1,0,0,0,2,0
29975,2,14,0,14,14,1
393912,4,20,20,0,5,1
286523,2,3,14,-11,8,0
378873,2,10,13,-3,15,1
115525,2,0,3,-3,1,1
157766,4,17,10,7,2,1
32889,4,19,7,12,15,1
302211,2,28,7,21,15,0
176619,1,0,12,-12,11,1
353108,2,10,22,-12,3,0
283942,4,31,17,14,7,0
71546,1,3,0,3,16,0
289450,2,3,7,-4,10,1
139731,3,7,14,-7,12,1
161638,4,36,16,20,4,1
147286,3,0,31,-31,15,0
185522,1,3,3,0,15,1
220353,1,3,0,3,13,1
18453,3,7,7,0,9,0
372963,4,25,7,18,13,1
279549,3,10,6,4,5,1
388378,4,17,20,-3,2,1
176643,2,14,12,2,11,1
58116,3,10,10,0,10,1
54472,2,0,7,-7,8,1
125190,3,24,7,17,5,1
343745,1,7,0,7,17,1
130345,2,7,0,7,8,0
313143,2,7,10,-3,3,1
134313,2,10,14,-4,10,1
213053,2,17,0,17,10,1
236144,2,0,10,-10,3,1
70813,4,30,27,3,15,0
287744,1,14,0,14,9,0
213785,2,21,0,21,10,0
356741,4,26,24,2,5,1
222179,2,10,10,0,14,1
226858,2,0,7,-7,16,0
318161,3,16,10,6,5,0
319483,3,3,10,-7,6,0
321002,2,7,7,0,6,1
85534,3,17,12,5,5,0
285461,4,33,8,25,8,1
115958,1,0,0,0,1,1
22225,4,18,15,3,11,0
278672,4,17,3,14,4,0
311707,4,12,9,3,2,1
65209,4,10,10,0,13,1
332757,3,21,9,12,12,1
395622,2,7,17,-10,6,1
147189,1,0,0,0,15,0
154342,3,27,23,4,1,0
242439,2,0,7,-7,6,0
251985,2,0,13,-13,10,1
58754,3,10,20,-10,10,0
81764,4,31,17,14,3,0
149334,1,0,0,0,16,1
292848,1,6,0,6,11,1
335321,3,3,16,-13,13,0
237869,3,7,27,-20,4,1
132772,4,20,31,-11,9,1
237421,4,12,17,-5,3,1
168503,4,10,30,-20,7,1
327535,2,7,9,-2,10,0
319178,3,2,3,-1,5,0
382630,1,0,0,0,17,1
244823,3,7,3,4,7,0
116097,1,0,0,0,1,0
339732,3,21,6,15,15,0
67535,4,39,14,25,14,0
153859,2,0,3,-3,1,1
23526,4,17,17,0,11,0
324209,1,0,0,0,8,0
206663,1,0,0,0,7,0
278285,1,7,0,7,4,1
345751,4,13,7,6,17,1
213415,3,10,41,-31,10,1
22940,4,3,26,-23,11,1
336692,2,3,3,0,14,0
282254,3,12,14,-2,6,0
220193,1,7,0,7,13,0
198019,3,0,30,-30,3,1
177043,1,3,0,3,11,1
261075,2,0,14,-14,14,0
35844,4,10,20,-10,17,1
263909,2,9,0,9,15,1
342103,2,6,3,3,16,1
330746,4,9,6,3,11,0
65941,4,17,14,3,13,1
177047,1,3,0,3,11,0
197379,1,0,0,0,3,1
379920,3,20,6,14,16,1
409157,4,3,17,-14,12,1
18681,1,0,7,-7,9,1
198153,2,7,3,4,3,0
70552,1,0,7,-7,15,0
289130,2,13,0,13,9,0
153692,2,2,14,-12,1,1
261139,4,21,24,-3,14,1
177853,3,14,16,-2,12,1
162621,1,0,10,-10,5,1
252495,3,10,22,-12,10,0
46853,1,10,3,7,5,1
380481,1,0,7,-7,16,0
31731,1,0,7,-7,15,0
171782,3,20,14,6,9,1
76969,3,17,13,4,1,0
262839,1,7,13,-6,15,1
240240,1,0,0,0,5,1
210244,1,0,0,0,9,1
348955,1,13,0,13,2,1
259121,2,7,0,7,13,1
289138,2,13,0,13,9,0
40762,3,17,21,-4,2,1
66301,2,0,7,-7,14,0
270330,4,27,27,0,1,0
55497,1,10,0,10,9,1
264929,3,20,17,3,16,1
100224,3,17,7,10,12,1
151010,1,0,0,0,17,0
55650,1,10,14,-4,9,1
298338,1,0,6,-6,14,0
107824,4,7,23,-16,15,1
251345,2,14,14,0,10,1
173962,4,23,19,4,10,1
259004,3,3,16,-13,13,0
142937,3,3,10,-7,13,0
227890,2,17,6,11,16,1
114959,2,7,3,4,1,0
313756,3,28,10,18,3,1
111249,3,10,10,0,16,0
117295,1,0,0,0,2,1
65531,1,0,0,0,13,1
147241,2,0,21,-21,15,0
382168,4,37,3,34,17,0
389241,3,28,7,21,3,1
211902,4,43,23,20,9,0
75571,2,7,3,4,17,1
163252,2,3,6,-3,5,1
65822,5,34,33,1,13,0
167530,3,0,10,-10,7,0
178308,2,7,3,4,12,0
207337,3,13,21,-8,7,1
200153,3,7,24,-17,4,1
179331,1,0,0,0,12,0
368597,4,16,6,10,11,1
94727,4,38,43,-5,9,0
360521,1,0,0,0,7,0
95336,4,17,24,-7,10,0
40332,3,6,7,-1,2,1
341537,3,6,10,-4,16,1
200604,3,24,14,10,4,1
361040,2,16,2,14,7,1
101534,2,10,20,-10,12,0
288171,1,0,0,0,9,1
74986,3,20,17,3,17,1
335939,1,0,3,-3,13,0
343247,4,22,0,22,16,0
316949,4,30,18,12,4,1
217327,3,7,10,-3,12,0
378396,2,7,0,7,15,1
404985,3,9,13,-4,10,0
217209,4,12,19,-7,12,1
234466,2,17,13,4,2,1
39461,3,13,10,3,1,1
18897,4,9,13,-4,9,0
341406,4,0,13,-13,16,1
195583,4,13,7,6,2,1
38676,3,13,7,6,1,1
6968,3,0,7,-7,3,1
349977,1,0,0,0,2,1
116531,1,0,0,0,2,0
411411,1,0,7,-7,13,1
301109,4,33,13,20,15,0
409114,3,3,10,-7,12,0
188442,3,3,3,0,16,1
233041,4,24,17,7,2,0
284153,2,3,13,-10,7,1
12354,1,0,0,0,6,0
31701,1,0,0,0,15,1
9300,2,7,0,7,5,0
267420,4,10,17,-7,17,1
156741,1,7,7,0,2,0
307510,4,38,13,25,17,1
311745,2,0,10,-10,2,0
286824,1,3,7,-4,8,0
199410,3,16,10,6,4,1
278274,1,0,0,0,4,1
117171,2,13,3,10,2,0
241764,4,7,15,-8,5,1
304804,2,0,0,0,16,0
381612,1,0,0,0,17,1
256316,4,14,17,-3,12,1
98810,1,0,0,0,11,1
89519,2,0,3,-3,7,0
312996,2,10,0,10,3,0
374107,2,13,7,6,13,1
311465,2,3,3,0,2,1
265926,3,0,16,-16,16,0
46027,2,14,14,0,4,1
396770,4,7,20,-13,6,0
390591,4,17,27,-10,3,1
355657,4,38,17,21,5,0
155019,1,6,12,-6,1,0
263360,4,24,10,14,15,0
318449,3,24,7,17,5,0
361856,4,44,10,34,7,0
188161,3,10,10,0,16,1
192831,3,6,15,-9,1,1
263277,1,7,0,7,15,1
418740,2,7,7,0,16,0
1399,3,10,0,10,1,0
94431,1,0,0,0,9,1
204011,4,16,7,9,6,0
153872,3,7,3,4,1,0
59204,3,14,45,-31,10,1
403398,1,0,0,0,9,0
17142,4,30,17,13,9,0
254747,2,3,3,0,11,0
65307,3,3,21,-18,13,0
92867,3,24,0,24,8,0
1284,4,17,16,1,1,1
86470,4,30,24,6,5,0
136008,3,3,10,-7,10,1
296554,1,0,0,0,13,1
107546,4,3,23,-20,15,1
296162,2,13,13,0,13,1
376348,2,3,0,3,14,1
11989,3,24,14,10,6,0
399114,4,10,36,-26,7,1
176625,1,0,12,-12,11,0
167778,5,26,26,0,7,1
38508,2,10,3,7,1,1
78937,4,20,17,3,2,0
136117,2,3,10,-7,10,1
233448,3,17,10,7,2,1
341735,4,26,13,13,16,1
173324,3,14,24,-10,10,0
164970,4,10,19,-9,6,0
256576,2,7,0,7,12,1
405220,1,6,7,-1,10,1
254243,1,0,3,-3,11,1
66198,2,24,3,21,13,1
262289,2,10,9,1,15,0
362149,1,0,0,0,8,0
87447,4,20,10,10,6,0
385107,2,0,3,-3,1,1
88419,1,0,0,0,6,1
242084,4,20,16,4,5,0
397403,1,0,10,-10,6,0
313885,3,21,19,2,3,1
258730,3,3,27,-24,13,1
271195,4,14,20,-6,1,1
135115,3,31,6,25,10,0
205515,3,14,17,-3,6,1
8467,2,15,0,15,4,0
107809,3,7,20,-13,15,1
176854,3,17,13,4,11,0
410870,2,14,12,2,13,1
385180,4,21,17,4,1,0
118337,4,26,7,19,2,0
135858,4,7,17,-10,10,1
349529,1,0,7,-7,2,0
5840,4,27,7,20,3,1
319762,2,7,0,7,6,0
147980,1,0,3,-3,15,1
390201,1,0,6,-6,3,1
354577,1,0,0,0,4,1
238332,2,3,9,-6,4,0
396790,1,0,0,0,6,0
109136,3,24,7,17,15,0
241191,1,0,0,0,5,1
407458,4,14,10,4,11,1
153720,2,2,21,-19,1,1
52885,4,14,58,-44,7,0
338225,2,14,24,-10,14,0
370368,4,20,35,-15,12,1
104896,2,3,3,0,14,0
255453,1,7,0,7,12,0
219094,4,45,13,32,13,1
56914,3,34,7,27,9,0
142106,2,0,7,-7,13,0
87262,2,17,14,3,6,0
79478,3,12,14,-2,2,1
288180,1,3,0,3,9,0
350733,2,7,0,7,2,1
36852,4,24,35,-11,17,1
171437,1,7,0,7,9,0
338531,3,20,17,3,14,0
32090,3,14,13,1,15,0
157230,2,7,0,7,2,0
263643,3,20,10,10,15,0
279326,1,0,0,0,5,0
15089,4,10,26,-16,7,0
70212,4,30,30,0,15,1
112200,1,0,0,0,17,1
258090,2,13,6,7,13,0
366312,4,28,10,18,10,1
32861,3,6,7,-1,15,0
67589,2,0,20,-20,14,0
18248,1,0,17,-17,9,0
214824,1,0,0,0,11,0
22252,1,0,0,0,11,0
295132,3,7,14,-7,12,1
111021,1,0,0,0,16,1
149089,2,14,14,0,16,0
18771,3,13,10,3,9,0
89105,3,16,6,10,6,0
272553,3,13,3,10,2,0
308545,2,6,9,-3,1,1
297235,3,13,6,7,13,1
100985,4,10,16,-6,12,1
208257,1,0,0,0,8,0
96892,2,16,7,9,10,1
208353,3,17,27,-10,8,1
188519,2,0,3,-3,16,1
397201,4,13,0,13,6,0
395885,4,10,17,-7,6,1
89589,4,7,40,-33,7,1
33306,4,23,3,20,16,1
244812,2,7,3,4,7,1
7633,4,28,3,25,4,1
29479,4,10,14,-4,14,0
199747,4,38,10,28,4,0
13519,4,6,41,-35,7,1
24569,3,10,16,-6,12,1
139797,2,7,3,4,12,0
66068,3,7,3,4,13,1
99930,3,10,6,4,12,0
157153,4,19,20,-1,2,1
293491,2,10,3,7,11,0
156714,4,17,20,-3,2,0
190135,4,27,3,24,17,1
197533,1,0,0,0,3,1
768,2,0,0,0,1,0
252401,1,0,0,0,10,0
259936,3,20,10,10,14,0
161976,1,0,0,0,4,0
42351,2,7,9,-2,2,1
359414,1,0,0,0,6,0
260432,4,20,14,6,14,1
161089,2,3,9,-6,4,1
166849,1,0,3,-3,6,0
218601,2,7,23,-16,13,0
244217,2,13,7,6,6,0
5317,1,7,0,7,3,0
110,4,7,7,0,1,1
35292,2,6,0,6,16,0
331969,1,0,0,0,12,1
147925,4,31,38,-7,15,1
107976,4,6,13,-7,15,0
74347,1,7,3,4,17,1
359187,3,10,21,-11,6,1
16020,1,7,0,7,8,0
128569,4,28,35,-7,7,0
43698,3,14,10,4,3,0
281105,1,0,0,0,6,0
5961,3,17,23,-6,3,0
209513,2,20,10,10,8,1
414753,4,10,17,-7,14,1
66259,4,45,3,42,13,1
351735,1,0,0,0,3,1
26770,3,6,27,-21,13,1
234357,3,17,10,7,2,1
15493,3,16,0,16,8,0
16595,1,7,7,0,8,0
213246,3,10,16,-6,10,1
286688,2,10,7,3,8,0
7769,3,30,3,27,4,1
103710,4,3,17,-14,13,1
1412,4,16,0,16,1,1
124048,1,0,7,-7,5,1
47356,3,3,10,-7,5,0
57868,1,3,0,3,10,1
49846,4,21,10,11,6,0
215035,2,13,7,6,11,1
211491,2,19,7,12,9,1
109038,4,23,34,-11,15,0
149667,2,17,0,17,16,0
151335,2,19,14,5,17,0
397956,4,10,17,-7,7,1
343513,3,7,10,-3,16,1
258366,1,7,0,7,13,0
323898,1,0,0,0,8,1
96123,1,0,13,-13,10,0
339973,1,7,3,4,15,1
130038,3,10,20,-10,8,0
238290,1,0,0,0,4,0
341789,1,0,3,-3,16,1
29392,1,0,0,0,14,0
3439,2,3,16,-13,2,0
373867,3,27,10,17,13,0
421788,1,0,3,-3,17,0
125998,1,0,0,0,6,1
130071,3,17,30,-13,8,1
342123,3,12,9,3,16,1
8054,2,17,7,10,4,0
344907,1,3,7,-4,17,1
286513,1,3,7,-4,8,0
210695,1,0,0,0,9,1
113493,4,3,7,-4,17,1
100756,1,6,0,6,12,0
75735,2,21,16,5,1,1
361403,4,17,14,3,7,0
368311,4,9,19,-10,11,1
232738,1,0,0,0,2,0
111831,3,6,10,-4,17,0
300409,1,2,0,2,14,1
277669,1,7,0,7,4,0
407054,1,0,0,0,11,0
161508,4,17,6,11,4,1
8571,1,0,0,0,4,0
379248,1,0,0,0,16,0
33968,3,3,27,-24,16,1
345072,2,6,0,6,17,0
37706,4,37,0,37,17,1
136344,4,18,14,4,11,1
264840,4,24,37,-13,16,1
50974,1,0,7,-7,6,1
236809,3,3,9,-6,3,0
281981,3,21,21,0,6,1
97145,4,34,13,21,10,1
112664,1,0,0,0,17,1
44246,2,16,13,3,3,1
107855,1,0,0,0,15,1
191449,4,0,34,-34,17,1
114846,3,13,30,-17,1,1
188226,1,0,7,-7,16,1
204089,2,3,7,-4,6,0
348358,2,10,7,3,1,0
210252,1,3,0,3,9,0
188154,3,10,10,0,16,1
204314,3,0,10,-10,6,0
242840,1,6,0,6,6,1
340677,4,16,13,3,15,0
306506,4,17,17,0,17,1
276491,2,16,7,9,4,1
353910,4,17,28,-11,4,0
390582,4,17,21,-4,3,0
417798,1,7,0,7,16,1
414929,1,0,0,0,15,0
59227,3,21,58,-37,10,1
354192,2,6,7,-1,4,0
153764,4,2,27,-25,1,1
402897,3,17,6,11,9,0
334167,4,23,14,9,13,1
345955,4,27,23,4,17,0
174192,2,3,16,-13,10,1
32939,2,0,14,-14,15,0
214959,4,7,26,-19,11,1
18563,2,9,10,-1,9,1
14852,1,0,0,0,7,1
355800,1,0,0,0,5,1
20583,1,0,0,0,10,0
78539,2,3,7,-4,2,1
86297,3,13,23,-10,5,1
293009,2,3,12,-9,11,0
37904,2,3,14,-11,1,1
393346,1,7,7,0,5,1
147754,4,24,24,0,15,1
146054,2,10,0,10,15,0
328029,3,17,9,8,10,1
218600,2,7,20,-13,13,0
227596,2,28,0,28,16,0
386781,2,7,7,0,2,0
253152,4,21,20,1,11,0
90492,3,0,20,-20,7,1
373933,1,0,0,0,13,1
253222,2,0,7,-7,11,0
82964,3,13,16,-3,4,0
360833,4,31,37,-6,7,0
320791,4,17,23,-6,6,0
103505,2,13,0,13,13,1
162657,2,16,10,6,5,0
54301,1,0,2,-2,8,1
198863,1,0,6,-6,3,1
40400,1,0,0,0,2,0
354219,3,13,10,3,4,1
49601,1,0,0,0,6,0
406266,4,21,27,-6,11,1
292838,1,0,0,0,11,1
177192,1,0,0,0,11,1
408834,4,16,28,-12,12,0
78280,2,3,21,-18,2,1
265589,1,0,8,-8,16,0
100354,3,9,20,-11,12,0
405944,3,14,0,14,11,0
135315,1,0,7,-7,10,0
59173,2,7,35,-28,10,0
361892,2,0,0,0,7,0
385674,5,27,24,3,1,0
56249,2,3,7,-4,9,0
82448,2,0,13,-13,3,0
350764,3,10,3,7,2,1
48951,4,22,20,2,5,0
60024,1,0,0,0,11,1
231749,2,10,20,-10,1,0
252248,1,0,7,-7,10,1
289680,4,13,23,-10,10,1
309368,1,0,0,0,1,0
189592,2,0,0,0,17,0
344055,1,0,0,0,17,0
409934,1,0,14,-14,12,1
178431,1,0,0,0,12,1
85590,1,0,0,0,5,1
296529,4,26,3,23,13,0
2213,2,7,0,7,1,1
215846,4,51,20,31,11,0
91255,1,7,0,7,8,0
354363,3,38,3,35,4,1
271606,3,23,20,3,2,1
12747,4,59,0,59,6,0
33449,4,20,20,0,16,1
303208,5,31,31,0,16,0
284684,4,17,27,-10,7,1
253960,1,0,0,0,11,1
365402,2,7,12,-5,9,1
408375,4,19,7,12,12,0
179943,4,40,9,31,13,0
362133,4,42,23,19,8,1
330825,2,10,17,-7,11,0
405483,4,24,16,8,10,1
113792,4,13,17,-4,17,1
246892,1,0,7,-7,8,0
348623,4,34,23,11,2,0
65757,3,14,16,-2,13,0
413863,3,17,6,11,14,0
176751,4,39,19,20,11,0
246482,2,12,0,12,8,1
135623,1,7,7,0,10,1
36399,4,20,26,-6,17,0
317141,1,0,0,0,5,0
365770,3,17,17,0,9,1
41040,2,3,10,-7,2,0
244620,1,0,7,-7,7,0
22705,1,3,0,3,11,0
73213,2,7,6,1,16,1
93386,1,0,0,0,9,1
408184,3,13,0,13,12,0
194238,1,0,0,0,2,0
161036,4,30,7,23,4,0
329873,1,0,0,0,11,0
81031,4,23,23,0,3,0
328376,4,3,40,-37,10,0
194598,2,21,0,21,2,0
115509,1,0,0,0,1,0
299768,4,17,14,3,14,1
247566,3,13,16,-3,8,1
233789,4,13,37,-24,2,1
150727,2,13,9,4,17,0
192328,3,27,17,10,1,0
370658,4,21,14,7,12,1
262958,1,0,0,0,15,0
312672,2,28,7,21,3,0
258857,3,14,14,0,13,1
374739,3,0,39,-39,14,1
143314,1,0,10,-10,14,0
262932,4,14,26,-12,15,1
135530,2,14,6,8,10,1
335561,2,6,6,0,13,0
239404,2,6,7,-1,4,0
379365,4,10,16,-6,16,1
194000,2,14,7,7,1,0
5048,2,7,0,7,3,1
185653,1,0,0,0,15,1
59483,3,3,20,-17,11,1
315893,4,9,26,-17,4,1
209936,4,44,23,21,8,1
316623,4,9,12,-3,4,0
372177,3,9,13,-4,13,1
269797,2,10,7,3,1,1
252268,1,0,10,-10,10,1
375872,1,0,0,0,14,1
174210,3,3,23,-20,10,0
95724,4,13,9,4,10,0
26824,1,0,0,0,13,1
109657,1,0,0,0,16,0
377882,3,20,10,10,15,0
248869,1,7,0,7,9,0
220286,3,23,9,14,13,0
305207,1,7,7,0,16,1
180700,1,0,0,0,13,1
32536,3,20,3,17,15,0
123233,4,19,21,-2,4,0
41948,3,24,6,18,2,0
188915,3,17,10,7,16,1
51028,2,0,17,-17,6,1
162872,4,13,3,10,5,0
69881,3,24,16,8,15,1
179290,4,33,3,30,12,0
71402,1,14,0,14,16,0
172255,4,21,13,8,9,0
193950,1,6,0,6,1,1
402117,2,12,0,12,9,0
311445,2,0,3,-3,2,1
98844,1,7,0,7,11,0
414444,4,13,23,-10,14,1
369426,3,24,7,17,11,1
266042,2,10,0,10,16,0
360705,1,0,7,-7,7,1
144802,1,0,0,0,14,1
211982,2,3,10,-7,9,0
386287,4,14,20,-6,2,0
267079,2,3,3,0,17,1
408959,3,30,18,12,12,1
421822,2,0,10,-10,17,0
367482,4,36,31,5,10,1
223576,4,17,13,4,15,1
326637,2,16,6,10,9,0
260678,3,10,22,-12,14,0
343878,4,26,6,20,17,0
126085,3,20,3,17,6,0
63390,4,17,10,7,12,1
401110,2,27,3,24,8,1
2434,4,21,13,8,2,1
244324,1,0,7,-7,7,0
386159,1,3,3,0,2,0
226101,2,7,14,-7,16,1
183897,1,0,0,0,14,1
318478,4,31,7,24,5,0
201327,3,28,13,15,5,1
212179,3,3,17,-14,10,0
288761,4,3,13,-10,9,1
415732,2,14,10,4,15,1
151152,2,3,10,-7,17,0
37240,3,10,14,-4,17,1
70121,2,10,0,10,15,1
359809,4,37,33,4,6,1
59287,1,0,0,0,11,0
114376,3,34,13,21,1,0
361865,1,0,0,0,7,1
395471,2,7,0,7,6,1
105645,1,7,3,4,14,1
390043,1,0,0,0,3,1
370073,4,31,20,11,12,1
386008,1,7,0,7,1,0
80295,1,7,3,4,2,0
292923,3,7,0,7,11,0
99131,1,0,0,0,11,0
115870,3,7,16,-9,1,1
373401,3,10,10,0,13,1
359249,1,0,0,0,6,1
84690,1,3,7,-4,4,1
153231,1,2,0,2,1,0
305525,2,6,0,6,17,0
412544,4,31,14,17,14,0
388473,3,3,16,-13,2,1
347539,4,28,37,-9,1,0
107082,3,40,0,40,15,0
36652,3,13,3,10,17,0
12011,4,24,14,10,6,0
398194,2,14,10,4,7,0
247841,2,0,3,-3,8,1
38389,3,14,16,-2,1,1
46652,4,10,0,10,4,0
239536,2,9,0,9,4,1
195474,1,0,0,0,2,0
124112,3,3,21,-18,5,1
55552,2,17,7,10,9,0
35877,1,0,0,0,17,1
257190,2,3,16,-13,12,1
2637,1,0,0,0,2,1
186380,4,36,31,5,15,1
34039,1,0,0,0,16,0
368970,2,7,7,0,11,0
298186,1,0,3,-3,14,1
415377,1,0,0,0,15,0
55291,4,13,10,3,9,1
271469,3,14,0,14,1,1
412852,4,31,35,-4,14,0
367563,2,14,9,5,10,0
98338,4,35,35,0,11,1
179737,2,3,10,-7,12,1
292818,4,29,24,5,11,0
321842,1,7,7,0,7,1
31861,1,0,0,0,15,1
214312,4,14,10,4,11,1
99260,1,0,0,0,11,1
190001,4,16,10,6,17,1
24597,4,10,26,-16,12,1
86595,3,33,3,30,5,1
104859,1,0,3,-3,14,0
29864,3,9,16,-7,14,0
304976,3,10,14,-4,16,0
253131,4,21,20,1,11,1
416163,2,10,9,1,15,0
405158,4,12,10,2,10,0
58670,1,7,0,7,10,0
348140,4,24,22,2,1,0
18684,1,0,7,-7,9,1
405567,2,7,14,-7,10,1
323941,2,10,7,3,8,0
262077,1,7,0,7,15,0
238919,1,7,0,7,4,0
54899,1,0,0,0,8,1
311038,2,10,0,10,2,0
81844,2,0,21,-21,3,1
62468,4,10,13,-3,12,1
379738,2,9,7,2,16,1
240484,3,3,7,-4,5,0
310960,4,3,23,-20,2,0
119168,4,10,7,3,3,1
77649,2,0,10,-10,1,1
300921,3,10,20,-10,15,1
179159,4,12,16,-4,12,1
310499,4,20,9,11,2,1
109659,1,0,0,0,16,0
188814,4,7,33,-26,16,1
204767,3,21,14,7,6,0
221782,4,13,21,-8,14,1
184455,1,0,0,0,14,0
405249,2,7,7,0,10,0
175653,2,3,0,3,11,0
388770,2,14,0,14,3,1
152110,4,13,13,0,17,1
311880,1,7,0,7,2,0
81568,3,17,21,-4,3,0
57102,4,21,27,-6,9,1
166435,2,17,7,10,6,1
83737,4,22,23,-1,4,1
333734,4,21,7,14,12,0
265880,2,0,9,-9,16,0
235036,4,27,17,10,2,0
277670,1,7,0,7,4,0
127833,4,17,42,-25,6,1
71974,1,0,0,0,16,0
334127,3,16,7,9,13,0
266755,2,0,7,-7,16,0
310108,2,7,0,7,2,1
89343,1,3,6,-3,7,1
114455,1,0,7,-7,1,1
191223,2,0,17,-17,17,1
217381,4,21,13,8,12,1
290415,4,28,10,18,10,1
93249,1,0,0,0,9,1
21298,3,3,14,-11,11,1
256315,4,14,17,-3,12,1
391008,3,20,27,-7,4,0
342647,4,22,27,-5,16,1
82996,4,13,19,-6,4,1
136020,3,6,10,-4,10,1
136444,3,10,7,3,11,0
420395,4,20,20,0,17,1
167820,1,0,13,-13,7,1
368051,4,27,24,3,11,0
404167,2,9,7,2,10,0
125842,1,0,0,0,6,1
130563,4,13,13,0,8,1
377137,3,10,10,0,15,0
51208,3,24,25,-1,7,1
378298,3,9,3,6,15,0
111898,1,0,0,0,17,0
114987,3,13,12,1,1,1
18872,3,3,6,-3,9,0
217846,2,3,14,-11,12,1
247698,2,7,6,1,8,0
32310,4,36,36,0,15,1
216700,3,24,6,18,12,0
283582,2,12,17,-5,7,1
341233,3,16,7,9,16,0
421634,1,3,7,-4,17,1
192499,3,14,17,-3,1,0
222503,3,6,14,-8,14,1
386524,3,7,21,-14,2,1
303344,4,41,0,41,16,0
132964,1,0,7,-7,9,0
50394,2,6,7,-1,6,1
19522,1,0,0,0,10,1
48142,3,10,6,4,5,0
222744,1,3,0,3,14,0
302302,1,7,0,7,15,0
70272,2,7,7,0,15,0
274313,4,32,18,14,3,1
289291,2,14,17,-3,9,1
380325,1,7,0,7,16,0
217198,4,12,19,-7,12,1
347749,2,0,0,0,1,0
319990,3,43,17,26,6,1
363291,3,27,7,20,8,0
49545,3,14,3,11,6,0
233009,4,17,10,7,2,1
320500,4,26,24,2,6,0
131126,3,27,9,18,8,0
138853,4,12,33,-21,12,0
94304,2,3,6,-3,9,0
69116,2,14,7,7,15,0
360991,1,0,2,-2,7,0
233197,4,43,18,25,2,0
177468,4,27,10,17,11,1
219368,3,23,13,10,13,1
334363,2,0,3,-3,13,0
30991,2,0,3,-3,15,0
340607,2,6,3,3,15,0
339670,1,7,0,7,15,0
84535,1,0,0,0,4,0
197219,4,37,34,3,3,1
374256,2,7,3,4,13,1
221882,2,13,7,6,14,0
79673,1,0,0,0,2,0
337116,4,26,15,11,14,0
310022,3,9,10,-1,2,1
253947,1,0,0,0,11,1
69530,1,0,0,0,15,0
179748,3,6,10,-4,12,1
130105,4,17,36,-19,8,1
208119,1,0,0,0,8,1
247935,4,20,6,14,8,0
195337,2,3,3,0,2,0
129102,3,20,28,-8,7,1
50943,4,24,27,-3,6,1
43871,4,27,16,11,3,0
309712,3,16,6,10,1,1
217310,2,0,7,-7,12,0
127701,4,37,26,11,6,1
360608,3,7,10,-3,7,0
338216,2,14,21,-7,14,0
45066,4,23,20,3,4,1
67071,4,10,9,1,14,0
336676,1,0,3,-3,14,1
134670,4,34,24,10,10,0
388875,1,10,7,3,3,0
163942,3,23,13,10,5,1
122263,2,3,13,-10,4,1
330477,1,0,7,-7,11,1
21003,3,14,24,-10,10,0
32959,2,0,24,-24,15,1
42093,4,27,20,7,2,1
94388,4,17,21,-4,9,1
163975,4,33,20,13,5,0
131211,2,7,17,-10,8,1
11535,3,6,10,-4,6,1
273045,4,6,3,3,2,1
228795,2,3,14,-11,17,1
250282,1,7,0,7,9,1
198003,2,0,20,-20,3,0
154009,3,10,14,-4,1,0
118268,2,12,7,5,2,0
387643,1,0,0,0,2,0
216294,1,7,0,7,12,0
244399,3,0,17,-17,7,1
165080,3,10,24,-14,6,0
312665,2,21,7,14,3,0
119878,5,24,24,0,3,0
233591,3,20,27,-7,2,0
398420,1,0,0,0,7,0
387089,2,7,21,-14,2,1
318552,2,7,0,7,5,1
185077,2,0,3,-3,15,0
219760,1,20,0,20,13,1
417049,2,17,0,17,15,0
207788,4,24,16,8,7,1
49190,2,10,0,10,6,1
144693,2,0,0,0,14,1
70315,3,10,17,-7,15,0
305363,2,14,3,11,17,0
265448,1,0,7,-7,16,1
98640,4,14,10,4,11,1
95176,4,23,27,-4,9,0
189098,4,31,30,1,16,0
75489,4,31,7,24,17,1
241212,1,0,0,0,5,0
237772,1,0,0,0,4,0
417081,3,27,0,27,15,0
268303,2,17,3,14,17,0
246475,2,9,0,9,8,1
190344,1,7,0,7,17,0
283881,2,14,10,4,7,1
34115,2,3,0,3,16,0
201711,4,27,20,7,5,1
151758,2,7,6,1,17,1
156733,1,0,7,-7,2,1
160332,3,3,20,-17,4,0
320965,1,7,0,7,6,0
303180,4,24,28,-4,16,1
53139,3,19,38,-19,7,1
351501,2,0,24,-24,3,0
268442,2,14,9,5,17,1
194208,4,12,17,-5,1,0
23879,1,0,0,0,12,1
369597,4,14,6,8,11,1
181318,4,3,23,-20,13,0
187478,1,0,3,-3,16,0
231494,4,23,12,11,1,0
6789,2,3,0,3,3,0
173639,3,10,20,-10,10,0
117903,1,0,0,0,2,0
205258,4,23,20,3,6,1
195978,3,0,27,-27,2,1
292368,4,12,16,-4,11,1
330394,3,10,20,-10,11,0
270595,4,20,14,6,1,0
12243,2,0,3,-3,6,1
375694,4,26,20,6,14,0
5233,3,21,17,4,3,0
62347,4,24,22,2,12,1
356069,4,27,10,17,5,0
169027,2,19,14,5,7,1
22332,3,0,3,-3,11,0
110780,3,3,3,0,16,0
150475,3,27,6,21,16,1
259634,3,6,6,0,13,1
354,2,14,10,4,1,1
97876,4,14,27,-13,11,0
399908,2,0,6,-6,8,1
214175,4,19,9,10,11,0
201447,2,12,0,12,5,1
187526,2,6,10,-4,16,0
52477,1,3,0,3,7,0
105858,3,16,10,6,14,0
375108,1,7,0,7,14,0
99586,1,0,3,-3,11,1
93804,4,9,19,-10,9,1
223164,1,0,0,0,15,0
131428,4,7,19,-12,8,1
46404,4,12,17,-5,4,0
405238,2,7,7,0,10,0
71128,1,12,0,12,16,1
126474,1,0,6,-6,6,1
318668,1,0,0,0,5,0
415502,4,23,3,20,15,0
265772,3,10,3,7,16,1
164648,3,14,17,-3,5,0
168867,3,17,3,14,7,1
358101,2,14,0,14,6,1
13929,4,21,13,8,7,0
352657,2,0,0,0,3,1
274,4,12,27,-15,1,0
417983,2,14,21,-7,16,0
307927,2,7,0,7,1,0
89883,4,30,13,17,7,0
267950,2,0,0,0,17,0
291697,2,0,3,-3,11,0
26738,3,6,14,-8,13,1
96444,2,10,14,-4,10,0
10968,3,9,28,-19,5,1
88110,1,0,0,0,6,1
270215,2,3,7,-4,1,0
161724,2,10,3,7,4,1
157105,3,10,14,-4,2,0
315633,2,3,0,3,4,1
291554,2,3,3,0,11,1
163582,2,7,16,-9,5,0
298666,2,6,7,-1,14,1
289339,3,28,17,11,9,1
418543,1,14,0,14,16,0
365753,3,17,17,0,9,1
125784,3,7,17,-10,5,0
314679,4,14,21,-7,3,1
203335,2,14,27,-13,6,1
269928,2,7,10,-3,1,1
123665,3,7,22,-15,4,1
24038,1,0,0,0,12,0
364898,4,13,20,-7,9,0
81270,3,10,7,3,3,0
16362,2,14,7,7,8,1
37616,2,10,0,10,17,0
383499,2,13,3,10,17,1
341378,3,0,10,-10,16,1
294411,4,19,9,10,12,1
210924,3,19,10,9,9,1
395086,3,10,31,-21,5,0
25518,2,7,0,7,12,0
172918,4,34,24,10,9,1
340646,3,16,10,6,15,0
312142,4,33,23,10,2,1
238294,1,0,3,-3,4,0
419541,1,0,7,-7,17,1
244923,1,0,7,-7,7,0
234988,3,13,10,3,2,0
273941,3,7,9,-2,2,1
57395,4,14,3,11,10,0
78170,3,20,3,17,2,1
316800,3,16,7,9,4,1
213473,1,0,0,0,10,0
391559,2,10,21,-11,4,1
67087,4,10,9,1,14,1
31716,1,0,0,0,15,1
270059,2,3,10,-7,1,1
272907,4,20,17,3,2,0
154711,2,0,7,-7,1,1
1857,4,19,10,9,1,1
25561,2,17,7,10,12,1
133842,1,0,0,0,9,1
52058,3,13,10,3,7,0
87941,4,19,15,4,6,0
31765,2,0,17,-17,15,0
354514,3,27,28,-1,4,0
5250,3,24,24,0,3,1
164408,4,33,3,30,5,1
282892,5,23,23,0,6,0
225787,2,10,14,-4,16,1
145663,4,35,7,28,14,0
121055,3,11,24,-13,3,1
322026,2,6,0,6,7,0
404643,3,20,19,1,10,0
239191,4,27,19,8,4,0
274711,3,10,12,-2,3,0
192398,1,0,7,-7,1,1
210514,4,9,28,-19,9,1
275442,2,20,10,10,3,0
331080,1,0,0,0,11,1
259954,4,20,20,0,14,1
167930,4,21,19,2,7,0
226338,4,22,7,15,16,1
8690,4,10,10,0,4,0
53215,2,3,0,3,8,0
83377,2,7,14,-7,4,1
910,2,0,0,0,1,0
333265,4,6,21,-15,12,0
138792,2,0,26,-26,12,1
340852,4,24,27,-3,15,1
169977,3,21,10,11,8,1
111617,1,7,3,4,16,0
227045,4,17,6,11,16,0
328787,3,17,13,4,10,1
172784,4,21,18,3,9,1
73717,4,20,12,8,17,0
324753,3,19,7,12,8,1
319810,3,14,10,4,6,1
144462,4,10,33,-23,14,1
314584,1,7,0,7,3,1
68795,2,6,0,6,15,0
252806,3,6,6,0,11,1
365538,1,7,7,0,9,1
112473,4,13,16,-3,17,0
396169,4,24,23,1,6,0
141645,2,17,14,3,13,1
343110,4,12,20,-8,16,0
380539,3,7,17,-10,16,1
368915,4,38,3,35,11,0
392304,2,0,7,-7,4,0
404320,2,0,6,-6,10,1
248037,3,31,13,18,8,0
227561,1,14,0,14,16,1
356354,3,24,8,16,5,1
43964,2,3,14,-11,3,1
249494,1,7,3,4,9,1
62174,4,7,17,-10,12,1
314458,2,7,0,7,3,1
6408,3,9,13,-4,3,0
188079,1,0,3,-3,16,0
302202,2,21,7,14,15,1
173316,3,14,24,-10,10,0
297488,1,2,0,2,13,1
401072,2,14,3,11,8,1
67529,4,39,14,25,14,0
72749,1,14,0,14,16,0
379206,3,9,13,-4,16,1
103863,4,26,0,26,13,0
14735,2,21,0,21,7,1
347677,4,20,24,-4,1,1
305374,2,14,3,11,17,1
240586,2,3,6,-3,5,0
59792,3,12,10,2,11,0
295389,2,10,10,0,12,1
397520,4,20,22,-2,6,1
146294,4,17,33,-16,15,0
373429,4,10,17,-7,13,1
358320,4,0,27,-27,6,1
189941,3,6,7,-1,17,1
102428,1,3,0,3,13,0
12047,1,0,0,0,6,0
408312,2,0,7,-7,12,1
220038,4,24,35,-11,13,1
24000,4,26,6,20,12,1
217956,1,0,0,0,12,1
388677,4,20,7,13,3,1
230287,2,19,10,9,17,0
193272,3,3,20,-17,1,1
264874,1,3,7,-4,16,1
131581,4,9,23,-14,8,0
178026,3,7,20,-13,12,0
65516,4,30,14,16,13,0
140977,1,7,0,7,13,0
281665,3,24,10,14,6,0
50292,3,13,16,-3,6,0
32686,3,7,3,4,15,0
19809,1,0,0,0,10,0
340951,3,10,10,0,15,0
203283,1,0,16,-16,6,0
120887,3,14,24,-10,3,1
395022,2,0,14,-14,5,0
283437,3,20,7,13,7,0
163934,3,23,10,13,5,1
219342,3,16,10,6,13,0
337245,4,16,23,-7,14,1
374769,4,16,39,-23,14,1
50902,3,17,24,-7,6,0
352653,2,0,0,0,3,1
349949,4,18,12,6,2,0
155518,2,20,3,17,2,0
63963,4,6,27,-21,12,0
130717,4,7,45,-38,8,1
60698,3,21,3,18,11,0
378250,1,0,3,-3,15,1
406351,2,10,7,3,11,0
419553,1,7,7,0,17,1
358372,1,9,7,2,6,0
187075,2,10,0,10,16,0
189365,4,20,10,10,16,0
224119,1,0,7,-7,15,0
188952,4,26,13,13,16,0
219700,4,13,14,-1,13,1
99076,3,23,0,23,11,1
283011,3,21,3,18,6,0
145900,2,0,0,0,15,1
203234,4,10,17,-7,5,0
97013,1,10,0,10,10,0
70590,2,7,10,-3,15,1
405866,1,7,0,7,11,1
12794,1,0,3,-3,6,1
34092,2,0,0,0,16,0
221356,1,0,7,-7,14,0
73092,3,7,10,-3,16,1
73043,2,7,10,-3,16,0
126747,4,13,13,0,6,1
188996,1,7,6,1,16,0
90416,2,0,13,-13,7,1
236473,2,7,3,4,3,1
59041,2,3,10,-7,10,1
14652,3,24,14,10,7,1
115859,2,7,10,-3,1,0
407360,1,0,0,0,11,0
211587,4,42,21,21,9,1
12508,2,0,14,-14,6,0
279606,4,10,16,-6,5,1
393093,3,10,3,7,4,1
344075,1,3,3,0,17,0
308655,1,0,6,-6,1,0
369250,2,14,7,7,11,0
369814,1,0,0,0,12,1
11403,3,26,0,26,6,0
247914,4,17,6,11,8,1
202087,2,13,0,13,5,0
209324,2,0,7,-7,8,1
182131,2,16,6,10,13,0
66199,2,24,3,21,13,0
126846,2,10,6,4,6,0
230872,2,7,10,-3,1,1
287253,4,23,23,0,8,0
11927,1,0,0,0,6,0
33837,3,3,31,-28,16,0
39539,2,0,3,-3,1,0
238395,3,17,30,-13,4,0
239333,4,3,17,-14,4,1
410873,2,14,12,2,13,1
45101,1,0,0,0,4,0
7310,4,20,13,7,4,0
413184,1,0,0,0,14,0
160785,2,10,7,3,4,0
1591,4,16,20,-4,1,0
391725,3,3,10,-7,4,0
263452,2,6,13,-7,15,0
133389,4,21,9,12,9,0
160588,1,0,0,0,4,1
276387,3,25,38,-13,3,1
16487,2,13,7,6,8,1
193931,4,31,23,8,1,0
215408,1,7,0,7,11,0
196237,2,14,10,4,2,1
237138,4,14,40,-26,3,1
319591,1,3,0,3,6,1
40963,4,16,27,-11,2,0
215670,4,14,6,8,11,0
142532,4,30,16,14,13,1
343471,2,7,7,0,16,1
193592,3,0,10,-10,1,0
107729,2,7,7,0,15,1
278540,4,43,7,36,4,1
241994,2,7,3,4,5,1
94094,4,6,31,-25,9,0
281279,1,7,6,1,6,1
235057,1,0,6,-6,2,0
241294,4,10,7,3,5,1
78064,4,19,23,-4,1,0
323971,3,17,13,4,8,0
32541,3,20,3,17,15,0
141643,2,17,14,3,13,1
67452,2,13,7,6,14,1
4447,1,0,3,-3,2,1
358457,4,32,27,5,6,1
228118,4,20,10,10,17,0
231959,4,14,41,-27,1,1
401638,1,0,7,-7,8,1
31119,1,0,3,-3,15,1
94840,4,6,13,-7,9,1
316781,3,10,7,3,4,1
332633,3,27,13,14,12,1
53045,1,7,0,7,7,1
177749,4,13,17,-4,12,0
11610,1,6,0,6,6,1
378294,2,3,3,0,15,0
21192,4,0,16,-16,10,1
66315,2,0,14,-14,14,1
327276,3,9,20,-11,9,1
227220,4,16,17,-1,16,0
325495,3,19,6,13,8,0
30491,4,31,35,-4,14,0
393760,4,7,14,-7,5,1
148157,2,3,14,-11,16,0
282003,4,21,28,-7,6,1
12402,3,10,6,4,6,0
231277,1,3,3,0,1,1
262550,1,7,0,7,15,0
398015,1,7,7,0,7,1
149037,1,0,7,-7,16,0
236891,1,12,0,12,3,1
204990,1,9,7,2,6,1
126210,3,21,6,15,6,0
143487,2,14,21,-7,14,0
184476,1,0,7,-7,14,1
8661,4,7,10,-3,4,0
284807,3,26,20,6,7,1
421443,4,37,20,17,17,1
163168,4,22,28,-6,5,1
395295,1,0,0,0,5,0
36766,2,7,7,0,17,0
179283,3,33,3,30,12,1
188821,1,0,0,0,16,0
240199,4,16,6,10,5,0
40458,3,7,14,-7,2,1
400547,3,13,17,-4,8,0
138285,1,10,0,10,11,1
414588,4,21,9,12,14,0
145347,4,42,26,16,14,0
212424,1,10,0,10,10,0
10970,3,9,28,-19,5,0
282115,3,16,8,8,6,0
200970,1,7,0,7,5,1
385475,4,35,10,25,1,0
396602,4,20,10,10,6,1
394517,4,10,25,-15,5,1
230677,1,6,14,-8,1,1
86956,2,14,0,14,5,0
47299,1,0,7,-7,5,0
187614,4,13,37,-24,16,0
343297,1,0,3,-3,16,0
352676,2,7,3,4,3,1
111922,1,0,14,-14,17,0
21360,1,0,0,0,11,0
269034,2,10,3,7,17,0
4567,4,31,29,2,2,0
421678,2,17,7,10,17,1
291728,3,0,14,-14,11,0
70349,4,10,33,-23,15,1
85417,1,0,0,0,5,0
184294,4,34,14,20,14,1
172219,2,7,13,-6,9,1
356394,4,31,20,11,5,1
264906,2,17,14,3,16,1
204506,4,17,24,-7,6,0
94588,4,20,17,3,9,0
331021,3,39,10,29,11,0
262807,4,35,17,18,15,0
207798,4,27,16,11,7,1
409631,1,0,0,0,12,1
81812,1,0,7,-7,3,0
28935,1,0,0,0,14,0
420972,3,7,21,-14,17,1
110254,1,0,3,-3,16,1
228700,3,19,23,-4,17,0
280203,4,28,14,14,5,1
71505,4,33,14,19,16,0
133869,1,0,6,-6,9,0
287550,4,20,40,-20,9,0
176112,1,7,0,7,11,0
160202,3,30,7,23,3,1
198819,3,6,16,-10,3,0
121893,4,0,26,-26,4,1
201863,4,28,30,-2,5,1
114898,4,31,40,-9,1,0
175846,2,20,24,-4,11,1
172893,3,24,24,0,9,1
115060,1,3,0,3,1,1
252709,4,6,10,-4,10,1
247384,1,3,6,-3,8,0
304126,4,16,30,-14,16,1
106947,3,12,6,6,14,1
369619,4,20,14,6,11,1
369813,1,0,0,0,12,1
33947,2,0,27,-27,16,1
363795,2,7,7,0,8,1
245253,2,6,3,3,7,0
293698,4,10,13,-3,12,1
368756,4,21,19,2,11,0
252299,2,0,13,-13,10,0
158052,2,15,6,9,3,0
129854,2,10,0,10,7,1
115493,1,0,0,0,1,1
104657,4,7,3,4,14,1
219836,3,38,0,38,13,1
341058,2,7,17,-10,15,1
39345,1,0,0,0,1,0
45594,2,7,13,-6,4,1
167134,1,6,0,6,7,0
335362,4,3,23,-20,13,1
305450,4,20,3,17,17,1
314951,4,0,13,-13,4,0
213262,4,17,24,-7,10,1
175241,2,15,0,15,10,0
131169,1,0,0,0,8,1
203391,4,27,33,-6,6,1
354070,3,16,0,16,4,1
274477,1,0,0,0,3,1
175250,2,15,0,15,10,0
178939,2,6,3,3,12,1
103858,4,26,0,26,13,0
149941,1,7,0,7,16,0
98690,1,7,3,4,11,1
156929,2,7,10,-3,2,1
290888,4,24,30,-6,10,1
390372,2,7,13,-6,3,0
8556,1,0,0,0,4,0
37264,4,13,21,-8,17,1
295214,2,14,0,14,12,1
349821,1,0,0,0,2,0
314762,2,14,0,14,4,0
110286,2,0,17,-17,16,1
320616,4,31,18,13,6,1
370678,4,24,21,3,12,1
24376,2,10,0,10,12,0
224859,1,0,0,0,15,0
88088,4,24,3,21,6,0
35616,2,7,3,4,17,0
56223,1,3,7,-4,9,1
139690,2,0,0,0,12,1
386380,3,17,6,11,2,0
15819,4,0,12,-12,8,1
31403,1,0,0,0,15,1
99184,2,10,3,7,11,0
18157,3,13,17,-4,9,0
345813,1,0,7,-7,17,0
142212,5,11,13,-2,13,0
281860,4,13,7,6,6,1
123025,3,7,13,-6,4,0
158137,1,0,0,0,3,1
154285,2,6,14,-8,1,1
210230,4,10,28,-18,9,0
378267,2,0,3,-3,15,0
381641,2,7,0,7,17,1
343265,4,22,0,22,16,1
103409,4,10,20,-10,13,0
398425,1,0,0,0,7,1
71320,3,10,20,-10,16,0
215987,4,20,42,-22,11,0
58946,4,20,32,-12,10,0
173456,2,0,7,-7,10,0
122352,4,13,19,-6,4,1
64332,3,6,20,-14,13,1
147673,2,10,0,10,15,0
262081,1,7,0,7,15,1
178384,4,28,27,1,12,1
292888,2,7,0,7,11,0
132848,2,3,14,-11,9,1
329099,3,17,7,10,10,0
297378,3,9,17,-8,13,0
75459,3,31,7,24,17,0
67759,3,21,0,21,14,1
88288,2,14,7,7,6,0
268718,2,0,3,-3,17,1
6914,1,0,0,0,3,1
143807,3,6,0,6,14,0
275749,2,16,0,16,3,0
320297,3,14,21,-7,6,0
396124,3,17,23,-6,6,0
30788,4,31,35,-4,15,1
225653,3,14,10,4,16,0
383736,4,16,27,-11,17,1
356437,1,0,3,-3,5,1
260301,1,0,0,0,14,0
267236,2,10,14,-4,17,1
63402,1,0,0,0,12,0
372571,1,7,0,7,13,1
225674,4,14,10,4,16,0
225521,3,0,21,-21,15,0
374251,2,7,3,4,13,1
21616,4,7,38,-31,11,1
189317,2,3,7,-4,16,1
11413,3,26,0,26,6,0
256193,1,0,0,0,12,1
78110,2,7,3,4,2,1
344744,4,13,34,-21,17,1
209140,4,9,30,-21,8,0
196754,4,54,13,41,3,1
27588,1,7,3,4,13,1
12358,1,7,3,4,6,0
95701,3,10,9,1,10,1
98969,1,0,0,0,11,0
315960,2,0,14,-14,4,1
243695,1,7,3,4,6,1
114457,1,3,7,-4,1,0
4012,1,7,0,7,2,0
254345,4,13,27,-14,11,1
373628,1,0,3,-3,13,0
130995,4,10,30,-20,8,1
410835,1,14,3,11,13,1
140160,3,10,3,7,12,0
94540,3,3,10,-7,9,1
44555,2,0,14,-14,3,1
55032,1,0,0,0,8,1
291055,1,0,0,0,10,1
32114,3,24,13,11,15,0
80549,4,8,10,-2,3,1
144414,2,0,13,-13,14,1
32413,3,31,6,25,15,0
168361,4,24,24,0,7,1
269107,4,13,16,-3,17,1
71374,1,0,0,0,16,1
34691,2,3,3,0,16,1
303732,2,14,10,4,16,1
233639,4,23,41,-18,2,0
413763,4,24,16,8,14,1
199180,1,6,0,6,4,1
91668,3,21,21,0,8,1
363247,2,21,7,14,8,0
83443,4,10,23,-13,4,0
266226,3,24,12,12,16,0
22079,5,24,24,0,11,0
118661,2,14,6,8,2,1
219762,1,21,0,21,13,0
6536,3,3,3,0,3,0
250832,4,3,9,-6,10,0
229204,1,0,0,0,17,1
138621,2,3,7,-4,12,1
245102,2,14,6,8,7,1
374401,2,15,0,15,14,0
269516,2,13,17,-4,1,1
108904,4,17,17,0,15,1
386351,2,17,6,11,2,0
97158,1,0,0,0,10,0
376862,4,21,14,7,15,1
338615,1,3,0,3,14,1
206044,1,0,3,-3,7,0
369400,2,17,0,17,11,0
194378,1,0,0,0,2,1
256379,2,6,6,0,12,0
148660,4,10,9,1,16,1
181973,1,7,0,7,13,0
154942,4,26,17,9,1,1
346405,3,9,13,-4,1,1
99163,2,3,3,0,11,0
28052,2,7,7,0,13,0
18271,2,7,17,-10,9,1
193068,2,0,0,0,1,0
164160,2,14,7,7,5,1
109399,2,3,10,-7,16,0
181672,1,0,0,0,13,1
236038,3,23,3,20,3,0
109979,2,17,7,10,16,0
129205,2,14,6,8,7,0
7424,2,19,3,16,4,1
172609,4,24,24,0,9,0
408975,4,31,24,7,12,0
117077,3,7,17,-10,2,0
49567,4,14,3,11,6,1
150310,2,24,7,17,16,0
210369,4,22,17,5,9,1
399532,4,0,26,-26,7,0
394609,3,17,0,17,5,1
97924,1,0,7,-7,11,0
142716,1,0,7,-7,13,1
133342,3,14,9,5,9,1
417238,3,17,20,-3,16,1
104591,2,7,3,4,14,0
326296,1,0,3,-3,9,1
59425,1,0,7,-7,11,0
17325,1,7,0,7,9,1
80424,4,27,16,11,2,0
106872,1,9,0,9,14,0
322501,3,15,3,12,7,0
390608,4,20,27,-7,3,1
186618,2,23,3,20,15,1
172036,2,7,0,7,9,0
366669,1,17,3,14,10,0
182270,2,7,0,7,14,1
186940,3,7,9,-2,15,0
39032,4,37,24,13,1,1
269485,2,10,3,7,1,0
32623,1,0,0,0,15,0
396290,3,6,6,0,6,0
370145,2,17,3,14,12,0
179433,3,13,20,-7,12,0
378374,1,0,0,0,15,1
312857,3,7,0,7,3,1
345644,1,0,0,0,17,1
89402,3,10,20,-10,7,1
382460,4,0,31,-31,17,1
295550,3,23,7,16,12,0
346463,1,7,7,0,1,1
251834,2,7,7,0,10,0
210308,3,9,10,-1,9,1
74521,2,0,3,-3,17,1
13901,3,21,0,21,7,0
11351,2,14,0,14,6,0
179621,4,31,23,8,12,0
209413,3,14,10,4,8,1
42024,2,13,7,6,2,0
75015,4,34,17,17,17,0
98304,3,28,27,1,11,0
389671,3,24,16,8,3,1
97957,2,0,10,-10,11,0
115864,2,7,13,-6,1,1
250672,3,10,22,-12,10,1
227748,2,3,14,-11,16,0
94767,1,3,3,0,9,0
235341,1,6,0,6,3,1
406059,2,0,13,-13,11,0
277289,4,0,16,-16,4,0
215235,4,10,16,-6,11,1
211176,2,0,10,-10,9,1
406769,1,0,10,-10,11,1
160921,2,0,0,0,4,1
411729,2,0,10,-10,13,1
276028,2,10,3,7,3,0
403704,1,3,3,0,9,0
292665,4,22,16,6,11,1
413921,1,0,0,0,14,1
233059,1,0,0,0,2,1
363018,4,33,26,7,8,1
356964,2,17,3,14,5,0
173284,2,13,10,3,10,1
341494,2,0,7,-7,16,1
101362,2,6,0,6,12,0
185559,2,10,17,-7,15,1
73082,3,7,10,-3,16,1
167644,2,10,13,-3,7,0
23477,2,14,7,7,11,0
308935,1,0,0,0,1,0
371522,1,0,0,0,12,0
254860,1,0,0,0,12,0
278939,2,7,23,-16,5,0
396652,1,7,0,7,6,0
95148,3,23,17,6,9,0
392021,2,7,10,-3,4,1
297685,3,10,6,4,13,0
198324,3,6,14,-8,3,1
77115,3,14,17,-3,1,1
112942,4,19,13,6,17,1
255607,1,0,7,-7,12,0
420535,4,10,42,-32,17,1
369227,1,7,7,0,11,0
74848,3,20,20,0,17,1
179157,4,12,16,-4,12,1
110031,3,34,10,24,16,0
333487,2,3,0,3,12,0
287801,2,21,10,11,9,1
385755,2,10,0,10,1,1
227916,3,27,13,14,16,0
216689,3,24,6,18,12,1
136010,3,3,10,-7,10,0
42663,3,0,10,-10,3,0
138170,2,7,9,-2,11,0
350512,4,10,19,-9,2,1
240597,2,6,7,-1,5,0
49509,2,7,3,4,6,0
410791,4,22,6,16,13,1
296629,3,3,10,-7,13,1
5035,1,0,0,0,3,1
319455,2,0,3,-3,6,0
270578,3,13,14,-1,1,1
382416,3,0,21,-21,17,0
310435,2,14,3,11,2,1
389534,4,20,17,3,3,1
222587,1,0,0,0,14,0
58249,2,14,10,4,10,0
18556,2,3,9,-6,9,0
251568,3,16,13,3,10,0
76070,3,10,23,-13,1,1
99717,1,0,0,0,12,1
31589,2,10,3,7,15,1
91826,3,24,6,18,8,1
182798,2,19,3,16,14,1
86775,4,30,21,9,5,0
268527,1,0,0,0,17,1
97416,4,16,23,-7,10,0
57747,2,16,0,16,10,0
381886,4,35,28,7,17,1
378300,3,9,3,6,15,0
35603,2,7,3,4,17,1
357393,2,14,17,-3,5,1
302414,4,16,19,-3,15,1
112591,3,24,25,-1,17,0
155810,1,7,9,-2,2,0
420428,1,0,7,-7,17,0
167042,3,10,17,-7,7,1
36461,1,3,3,0,17,0
246381,4,20,10,10,7,1
260180,2,7,0,7,14,0
99408,1,0,0,0,11,0
80492,2,5,3,2,3,1
344184,1,0,0,0,17,1
275353,4,10,19,-9,3,0
21439,3,12,14,-2,11,0
93670,1,0,0,0,9,0
178455,2,7,3,4,12,1
347688,4,27,24,3,1,0
382827,2,21,3,18,17,1
104874,2,0,3,-3,14,1
56287,3,3,20,-17,9,1
384857,2,6,12,-6,1,1
221032,4,21,35,-14,14,1
62683,1,0,0,0,12,1
277136,4,10,24,-14,4,0
325516,4,22,13,9,8,1
214896,3,7,12,-5,11,0
220675,2,10,0,10,13,1
401215,1,0,7,-7,8,1
130205,3,3,19,-16,8,0
178520,3,16,13,3,12,1
30281,2,3,10,-7,14,1
112105,2,7,17,-10,17,1
181474,4,31,24,7,13,0
295606,4,31,32,-1,12,1
211636,2,16,3,13,9,0
307085,4,24,6,18,17,1
40743,2,17,14,3,2,1
399380,3,27,10,17,7,1
346224,3,26,0,26,1,1
188346,1,0,0,0,16,0
123512,3,7,3,4,4,1
371812,1,0,0,0,12,0
412450,2,7,7,0,14,0
322488,3,15,3,12,7,0
154771,3,13,16,-3,1,1
169786,2,0,14,-14,8,1
363608,4,10,15,-5,8,1
321177,3,3,19,-16,6,1
156544,4,14,6,8,2,1
134200,2,0,17,-17,10,1
417905,4,13,10,3,16,1
68963,2,21,7,14,15,0
255330,2,14,0,14,12,0
396018,4,38,20,18,6,0
20695,3,17,17,0,10,0
108141,4,13,42,-29,15,1
282291,4,25,17,8,6,1
104535,4,14,38,-24,13,1
305744,3,9,10,-1,17,1
209296,1,0,0,0,8,1
202223,1,3,0,3,5,0
416438,2,7,0,7,15,1
349965,1,0,0,0,2,0
260166,1,6,0,6,14,1
332434,2,10,3,7,12,1
312021,1,7,0,7,2,0
314062,3,16,14,2,3,0
297801,2,14,7,7,13,0
75311,4,14,26,-12,17,0
164985,4,17,19,-2,6,0
93589,2,6,6,0,9,1
29148,3,0,19,-19,14,0
418655,4,28,31,-3,16,0
229628,4,39,13,26,17,1
321595,2,10,6,4,7,1
283885,3,21,10,11,7,0
172613,4,24,24,0,9,0
233177,4,29,10,19,2,1
317722,5,23,23,0,5,1
1178,1,3,0,3,1,0
142644,3,13,13,0,13,1
25219,1,0,0,0,12,0
240712,1,0,0,0,5,1
205418,4,27,0,27,6,0
404692,4,27,32,-5,10,0
127315,2,10,17,-7,6,1
82479,2,10,17,-7,3,0
399115,4,10,36,-26,7,1
254337,4,13,27,-14,11,0
68970,2,21,7,14,15,1
127042,4,24,23,1,6,1
65625,3,6,16,-10,13,0
96690,1,0,7,-7,10,1
193223,2,3,7,-4,1,1
16456,1,3,0,3,8,1
206333,4,24,6,18,7,1
353132,3,13,29,-16,3,1
261016,4,10,3,7,14,0
56653,4,26,24,2,9,0
341686,3,20,13,7,16,1
18741,3,6,10,-4,9,1
83044,2,6,7,-1,4,1
278934,2,7,23,-16,5,1
186288,2,13,3,10,15,1
157675,1,0,3,-3,2,0
369379,1,3,0,3,11,1
392987,4,12,10,2,4,0
71319,3,10,20,-10,16,0
192240,1,3,0,3,1,0
313347,4,13,27,-14,3,0
279807,2,7,3,4,5,0
356768,1,0,0,0,5,1
225035,2,0,7,-7,15,1
160376,4,3,28,-25,4,1
369073,1,0,0,0,11,1
271111,1,0,10,-10,1,0
295837,1,6,7,-1,12,1
219242,4,19,3,16,13,0
214138,3,3,6,-3,11,0
356712,3,19,16,3,5,1
339339,4,45,7,38,15,0
211789,1,0,7,-7,9,1
8642,3,7,10,-3,4,0
383706,3,9,24,-15,17,0
90910,3,41,7,34,7,1
387841,2,10,14,-4,2,1
314000,1,0,0,0,3,1
88274,1,7,0,7,6,1
231743,2,3,20,-17,1,1
31800,3,13,17,-4,15,0
322623,3,3,6,-3,7,0
46259,4,24,31,-7,4,1
276426,1,0,0,0,4,1
63502,4,31,16,15,12,1
217962,1,0,0,0,12,1
387914,4,10,28,-18,2,1
325121,1,10,7,3,8,0
26972,1,0,0,0,13,0
103817,2,9,0,9,13,1
217498,4,19,3,16,12,0
172909,4,33,24,9,9,1
36748,1,0,7,-7,17,0
138686,3,6,28,-22,12,0
210424,2,9,7,2,9,0
420029,3,17,14,3,17,0
102224,4,24,14,10,13,0
233297,3,7,17,-10,2,0
224116,1,0,7,-7,15,0
6460,1,0,0,0,3,1
287852,4,28,20,8,9,0
384112,2,0,17,-17,1,0
259339,3,21,27,-6,13,0
345680,2,7,0,7,17,1
82751,2,6,6,0,3,0
207978,1,7,0,7,8,1
189516,4,20,0,20,17,0
217199,4,12,19,-7,12,1
363100,2,7,3,4,8,0
262939,4,14,32,-18,15,1
279684,2,23,3,20,5,1
145508,4,23,17,6,14,1
66947,4,18,7,11,14,0
13183,3,22,16,6,6,0
237426,4,12,17,-5,3,0
123321,2,14,7,7,4,1
222507,3,9,14,-5,14,0
181019,1,0,0,0,13,1
266038,2,10,0,10,16,0
77981,2,3,10,-7,1,0
12480,4,13,9,4,6,1
234688,4,30,20,10,2,0
293007,1,3,6,-3,11,0
292236,4,24,17,7,11,1
353857,2,7,14,-7,4,0
230367,1,0,0,0,1,1
212390,4,13,17,-4,10,0
130904,1,0,7,-7,8,1
141352,2,3,17,-14,13,1
358716,2,13,14,-1,6,1
407457,4,14,10,4,11,0
392423,4,40,48,-8,4,1
46603,2,3,0,3,4,1
274333,1,3,0,3,3,0
159024,1,0,0,0,3,0
150891,2,0,7,-7,17,1
62270,2,21,10,11,12,0
53954,4,20,25,-5,8,1
3366,4,10,6,4,2,0
225736,1,3,0,3,16,0
106675,4,46,16,30,14,1
218969,1,0,0,0,13,1
65780,4,27,25,2,13,0
241374,2,7,14,-7,5,1
393898,4,20,20,0,5,1
75128,3,7,6,1,17,0
63997,2,14,3,11,13,0
226089,2,0,14,-14,16,1
28573,4,33,7,26,14,0
390102,3,10,14,-4,3,1
359857,2,17,14,3,6,1
43723,4,24,17,7,3,1
269939,2,13,10,3,1,1
262386,1,0,7,-7,15,1
123316,2,14,7,7,4,1
319759,1,0,0,0,6,0
27025,2,10,0,10,13,0
21672,2,3,7,-4,11,1
142512,4,27,13,14,13,1
353963,5,31,31,0,4,1
320450,3,17,10,7,6,0
6664,2,3,13,-10,3,1
86909,4,23,26,-3,5,0
88464,2,7,7,0,6,1
358856,2,3,14,-11,6,1
200811,4,38,17,21,4,0
274159,1,0,0,0,3,1
300582,1,0,0,0,15,1
360126,1,7,3,4,7,1
94760,1,3,3,0,9,1
189181,2,21,0,21,16,1
285042,1,0,0,0,7,1
41892,2,14,3,11,2,0
258325,4,41,32,9,13,0
227719,2,0,0,0,16,1
368935,1,0,7,-7,11,1
248946,3,20,3,17,9,1
3077,1,0,0,0,2,1
414186,4,17,23,-6,14,1
244710,4,21,26,-5,7,1
327207,1,0,3,-3,9,0
165111,4,17,24,-7,6,0
345139,3,15,3,12,17,0
213377,2,10,20,-10,10,1
37398,4,24,0,24,17,1
418446,3,17,3,14,16,0
342497,4,27,9,18,16,0
142037,4,20,14,6,13,1
363206,1,0,7,-7,8,0
131168,4,27,12,15,8,0
125092,1,0,0,0,5,0
410762,3,22,6,16,13,0
100999,4,13,16,-3,12,1
413861,3,17,6,11,14,1
323831,3,13,15,-2,8,1
140405,1,0,0,0,12,1
197721,2,7,10,-3,3,0
4490,2,14,12,2,2,0
80308,1,7,6,1,2,0
290472,1,7,0,7,10,1
181534,1,3,0,3,13,1
81406,3,10,10,0,3,0
104687,4,14,3,11,14,0
276931,2,14,14,0,4,1
132762,4,20,24,-4,9,0
117156,1,6,3,3,2,0
258556,2,0,0,0,13,1
342410,2,10,3,7,16,0
306925,3,6,30,-24,17,1
264686,1,7,0,7,16,0
321579,2,10,6,4,7,1
330248,3,17,14,3,11,0
250025,3,17,13,4,9,0
248449,3,10,6,4,8,1
158274,1,0,0,0,3,0
158343,2,13,17,-4,3,1
413195,1,0,0,0,14,0
108596,4,26,21,5,15,1
372317,3,24,10,14,13,0
354755,2,6,9,-3,4,1
256163,4,27,22,5,12,0
65508,4,23,14,9,13,1
324479,4,17,12,5,8,0
330366,2,7,13,-6,11,0
359462,2,0,14,-14,6,0
178588,1,0,3,-3,12,1
15975,3,12,14,-2,8,1
378029,3,0,7,-7,15,0
415669,1,0,0,0,15,1
35371,4,23,16,7,16,1
393857,2,10,17,-7,5,1
80171,2,7,10,-3,2,1
97178,1,3,3,0,10,0
40031,2,20,7,13,1,0
322655,4,6,9,-3,7,0
65453,3,3,14,-11,13,1
338940,2,6,0,6,15,1
119671,4,17,19,-2,3,1
52849,3,14,43,-29,7,0
377167,4,13,17,-4,15,1
274811,1,0,0,0,3,1
295176,4,10,21,-11,12,1
179657,5,31,30,1,12,0
243496,4,10,30,-20,6,0
122224,1,3,7,-4,4,0
251648,1,3,3,0,10,1
4161,1,0,3,-3,2,1
118063,1,0,6,-6,2,1
349051,4,17,17,0,2,1
360792,3,24,30,-6,7,0
324793,1,0,0,0,8,0
313648,4,25,30,-5,3,0
414809,1,7,0,7,15,0
324939,4,23,23,0,8,1
84046,4,30,22,8,4,1
300963,4,24,27,-3,15,1
320367,1,7,0,7,6,0
136144,3,10,10,0,10,0
10083,3,31,7,24,5,1
419476,3,10,9,1,16,0
33027,4,12,44,-32,15,1
362062,2,14,7,7,8,0
208084,4,21,19,2,8,1
366235,2,7,0,7,10,0
123849,4,17,3,14,5,0
95459,4,34,7,27,10,1
116170,3,13,13,0,1,1
280109,2,14,0,14,5,0
418139,2,21,3,18,16,1
309143,3,26,3,23,1,1
1483,1,0,6,-6,1,0
397392,1,0,9,-9,6,0
169571,4,10,41,-31,8,1
88784,3,13,10,3,6,1
377650,1,6,7,-1,15,1
264668,1,0,0,0,16,1
253992,2,0,6,-6,11,1
352920,1,3,0,3,3,0
158668,3,14,7,7,3,0
95425,3,28,7,21,10,1
302705,4,23,20,3,15,1
339728,2,20,6,14,15,1
213371,2,10,13,-3,10,1
28766,1,0,0,0,14,0
234293,1,7,0,7,2,1
415402,1,6,0,6,15,1
161737,2,17,6,11,4,1
257739,4,3,24,-21,13,1
239062,1,0,0,0,4,1
265627,3,6,15,-9,16,0
276614,2,7,6,1,4,1
7664,4,34,10,24,4,0
130953,2,7,21,-14,8,0
412846,4,28,35,-7,14,1
254026,3,7,13,-6,11,1
192841,4,7,15,-8,1,1
5762,2,14,0,14,3,0
172675,2,7,3,4,9,1
78959,1,0,0,0,2,0
126342,2,7,14,-7,6,0
18774,4,13,13,0,9,0
124919,4,9,16,-7,5,0
420549,4,10,42,-32,17,1
245582,3,40,0,40,7,0
169912,1,0,0,0,8,0
181726,3,7,7,0,13,0
92921,4,34,7,27,8,1
416660,4,34,7,27,15,0
61928,1,0,0,0,12,0
67239,4,7,3,4,14,0
413890,4,17,9,8,14,0
334762,4,32,11,21,13,1
348097,3,3,19,-16,1,1
420338,3,17,3,14,17,0
37394,3,24,0,24,17,1
366462,4,34,10,24,10,0
402895,3,17,6,11,9,0
71410,2,14,0,14,16,1
175756,4,40,21,19,11,1
211063,3,27,0,27,9,1
141612,1,3,0,3,13,0
110331,3,10,17,-7,16,1
294814,2,28,14,14,12,0
73527,3,3,38,-35,17,1
418133,2,21,3,18,16,0
185412,3,7,10,-3,15,1
217289,2,0,7,-7,12,1
255051,2,3,21,-18,12,0
172861,2,17,10,7,9,1
142967,4,10,13,-3,13,0
1808,2,10,0,10,1,0
31868,1,3,0,3,15,1
402241,2,3,3,0,9,0
103567,4,33,0,33,13,0
347056,4,27,17,10,1,0
105027,1,0,7,-7,14,1
107445,2,0,3,-3,15,0
117715,4,34,20,14,2,0
14901,2,14,10,4,7,0
335884,3,28,14,14,13,1
247275,3,28,28,0,8,1
369142,3,13,7,6,11,1
207524,1,0,0,0,7,1
213631,1,7,7,0,10,1
251938,1,0,0,0,10,0
129476,5,26,26,0,7,1
108407,3,3,21,-18,15,1
212935,3,7,7,0,10,1
220303,4,26,9,17,13,1
142428,2,7,10,-3,13,1
71429,2,24,0,24,16,0
357808,2,3,14,-11,6,1
413947,1,3,7,-4,14,0
144220,2,9,7,2,14,0
37767,2,7,3,4,1,1
348916,4,9,21,-12,2,1
213521,2,10,14,-4,10,1
222867,1,0,0,0,14,1
219813,3,38,0,38,13,0
43552,3,17,3,14,3,1
311917,2,21,7,14,2,0
295493,1,0,0,0,12,1
172443,4,13,49,-36,9,1
296069,4,9,7,2,13,0
67372,4,30,6,24,14,0
179960,1,0,6,-6,13,1
392545,4,3,20,-17,4,1
109818,2,10,0,10,16,1
147825,2,0,7,-7,15,1
124163,4,19,21,-2,5,1
327735,3,6,13,-7,10,0
151949,3,27,24,3,17,1
182891,1,0,10,-10,14,1
208135,2,0,0,0,8,1
10583,1,0,7,-7,5,0
189215,3,33,3,30,16,1
326881,4,10,20,-10,9,1
344404,3,28,21,7,17,0
34349,4,23,9,14,16,0
183968,3,20,3,17,14,1
380264,4,29,16,13,16,0
380405,3,10,24,-14,16,1
306794,4,19,33,-14,17,0
308801,1,0,3,-3,1,1
397835,1,0,0,0,7,0
379003,2,7,3,4,15,0
411805,3,0,34,-34,13,0
125032,3,3,12,-9,5,0
281989,3,21,21,0,6,0
196933,1,7,0,7,3,0
17572,4,13,17,-4,9,1
84084,4,30,32,-2,4,1
288702,3,0,7,-7,9,0
360034,2,3,26,-23,7,0
216793,1,0,0,0,12,0
278113,1,0,7,-7,4,1
299006,4,16,12,4,14,0
69748,4,16,10,6,15,1
31177,3,23,27,-4,15,1
122160,4,24,21,3,4,1
113502,4,3,7,-4,17,0
188204,1,0,0,0,16,0
217711,2,7,0,7,12,1
79799,4,28,14,14,2,0
48427,3,17,17,0,5,1
168802,1,7,0,7,7,0
291997,2,6,3,3,11,0
148746,2,13,3,10,16,0
389405,4,30,19,11,3,0
84058,4,30,22,8,4,1
135252,3,16,3,13,10,1
29048,4,20,10,10,14,0
64762,4,28,7,21,13,1
235292,4,25,6,19,3,0
88876,1,7,0,7,6,0
155890,4,17,13,4,2,1
81731,3,17,17,0,3,0
176511,2,12,17,-5,11,1
305648,1,3,6,-3,17,0
384063,4,27,30,-3,1,0
146638,2,0,7,-7,15,1
254089,1,0,0,0,11,1
69747,4,16,10,6,15,1
161335,4,20,19,1,4,1
245839,2,3,16,-13,7,0
10413,4,10,45,-35,5,1
85348,3,21,3,18,5,1
411765,2,0,17,-17,13,0
404836,4,23,20,3,10,0
124760,4,3,9,-6,5,1
206344,1,0,0,0,7,1
48690,2,7,10,-3,5,0
342909,3,23,17,6,16,0
10201,3,6,3,3,5,1
357677,2,13,6,7,5,1
185414,3,7,10,-3,15,1
392382,3,20,31,-11,4,0
15890,1,3,7,-4,8,1
303987,1,0,0,0,16,0
95351,1,0,0,0,10,1
160842,3,34,17,17,4,0
416792,3,10,10,0,15,1
249043,2,14,10,4,9,1
331645,4,23,33,-10,11,1
357130,3,6,14,-8,5,1
285036,1,0,0,0,7,1
361021,2,9,2,7,7,1
346083,3,10,6,4,1,1
133688,4,32,35,-3,9,0
76375,3,29,6,23,1,0
167439,1,0,0,0,7,0
200962,1,7,0,7,5,0
98854,2,7,0,7,11,1
385807,3,30,3,27,1,0
342302,4,20,3,17,16,1
358899,3,6,34,-28,6,0
381050,2,14,6,8,16,0
67662,4,7,35,-28,14,1
74683,3,7,17,-10,17,0
196885,4,10,20,-10,3,0
28442,4,13,6,7,14,0
402792,4,30,14,16,9,0
201520,3,31,7,24,5,1
386389,3,17,9,8,2,1
394429,2,0,10,-10,5,1
154429,2,14,0,14,1,0
188425,3,3,3,0,16,1
136933,3,3,13,-10,11,1
267302,4,17,17,0,17,0
15114,4,10,26,-16,7,0
119645,4,17,12,5,3,0
191585,4,21,24,-3,17,1
266699,4,42,10,32,16,0
84531,1,0,0,0,4,1
337731,1,3,0,3,14,0
284143,2,3,6,-3,7,0
124659,1,0,0,0,5,1
82229,4,16,10,6,3,0
358903,3,6,35,-29,6,1
257209,2,10,16,-6,12,1
406115,3,0,26,-26,11,1
243260,2,7,10,-3,6,1
62961,1,0,7,-7,12,0
156749,1,7,7,0,2,1
344262,3,7,13,-6,17,1
259829,1,0,0,0,14,0
68973,2,21,7,14,15,1
183776,2,10,14,-4,14,0
171049,3,17,23,-6,8,0
418449,3,17,3,14,16,1
326160,1,7,7,0,9,0
257113,4,17,21,-4,12,0
388047,4,20,6,14,2,0
328499,3,9,3,6,10,1
357430,3,24,24,0,5,1
243409,2,3,10,-7,6,0
228703,3,19,23,-4,17,1
124993,2,3,3,0,5,1
63296,2,3,0,3,12,0
201348,3,28,13,15,5,1
187168,1,0,0,0,16,1
400414,4,24,10,14,8,0
30086,1,0,0,0,14,1
287330,2,13,0,13,8,0
239290,3,3,7,-4,4,0
327148,3,14,17,-3,9,1
284026,3,3,3,0,7,0
299807,1,0,0,0,14,0
22335,3,0,3,-3,11,0
103667,2,0,10,-10,13,1
310011,3,9,10,-1,2,0
390207,2,0,6,-6,3,0
308523,2,0,9,-9,1,0
61109,2,0,7,-7,11,1
297547,3,14,0,14,13,1
279718,3,23,6,17,5,1
291836,1,0,7,-7,11,1
57001,2,0,10,-10,9,0
124465,4,16,14,2,5,0
88904,2,16,0,16,6,0
150743,3,13,9,4,17,0
387230,2,6,7,-1,2,1
120218,1,7,0,7,3,0
116820,1,0,0,0,2,1
335940,1,0,9,-9,13,0
404602,2,7,10,-3,10,0
138171,2,7,9,-2,11,0
92330,4,20,0,20,8,1
34653,1,0,0,0,16,0
70544,1,0,7,-7,15,1
117552,4,17,20,-3,2,0
237854,3,7,27,-20,4,1
264938,3,23,17,6,16,1
396847,2,17,10,7,6,1
320298,3,14,21,-7,6,0
227344,4,20,37,-17,16,1
267024,4,22,17,5,17,1
104199,1,0,0,0,13,1
87069,1,0,0,0,5,1
386258,4,14,17,-3,2,0
113447,3,0,7,-7,17,1
386342,2,10,6,4,2,1
251562,3,16,13,3,10,1
387284,3,6,10,-4,2,0
356657,2,16,3,13,5,1
35596,2,7,3,4,17,1
219150,2,0,3,-3,13,0
401501,1,0,6,-6,8,0
207027,3,28,3,25,7,0
283296,3,10,9,1,7,1
119515,4,14,24,-10,3,1
261667,2,7,0,7,14,0
372140,2,9,7,2,13,1
181731,3,7,7,0,13,0
14264,1,0,7,-7,7,1
94762,1,3,3,0,9,1
156592,1,0,0,0,2,0
28508,2,24,0,24,14,1
138200,3,7,9,-2,11,0
154662,4,31,28,3,1,0
88143,2,7,3,4,6,0
251312,1,0,0,0,10,1
23370,3,20,17,3,11,0
384059,4,26,30,-4,1,1
98443,3,14,7,7,11,1
359037,3,10,3,7,6,1
317633,2,3,3,0,5,1
290116,4,19,15,4,10,1
249572,3,20,13,7,9,1
43761,1,14,0,14,3,0
400088,3,17,15,2,8,1
209297,1,0,0,0,8,1
107972,4,6,13,-7,15,0
411889,2,14,0,14,13,0
209541,2,34,17,17,8,1
330773,1,0,0,0,11,1
339563,2,10,7,3,15,0
294422,4,19,9,10,12,0
10930,2,6,14,-8,5,1
71792,4,38,33,5,16,0
248442,2,10,6,4,8,1
90699,1,7,0,7,7,0
384762,4,19,37,-18,1,0
195214,2,16,3,13,2,0
191812,2,10,7,3,1,0
24042,2,0,0,0,12,0
301015,2,10,3,7,15,1
275350,4,10,19,-9,3,0
246184,2,14,3,11,7,1
59424,1,0,7,-7,11,0
120004,4,23,31,-8,3,1
215383,4,24,20,4,11,1
291160,3,18,16,2,10,0
361425,4,17,21,-4,7,0
25487,1,0,0,0,12,1
355677,1,0,0,0,5,1
106466,3,16,9,7,14,1
118870,3,27,7,20,2,0
361490,2,7,0,7,7,1
332977,1,0,0,0,12,0
108908,5,17,17,0,15,0
324088,2,0,7,-7,8,0
373982,2,10,0,10,13,1
144730,3,3,0,3,14,0
129685,2,7,3,4,7,0
79950,4,13,23,-10,2,0
191806,2,3,7,-4,1,1
374184,4,23,21,2,13,0
191053,1,0,0,0,17,1
308327,1,0,0,0,1,0
218902,3,28,17,11,13,0
279131,4,21,20,1,5,1
343325,2,0,10,-10,16,1
89835,2,6,6,0,7,1
308964,2,0,3,-3,1,0
235955,1,0,0,0,3,1
215312,2,14,7,7,11,0
168565,2,7,10,-3,7,1
395926,2,10,3,7,6,0
277862,2,7,14,-7,4,0
104341,2,45,27,18,13,0
239424,2,9,10,-1,4,1
1610,1,0,0,0,1,1
225172,2,3,7,-4,15,1
48580,3,14,17,-3,5,0
239190,4,27,19,8,4,0
372674,4,21,17,4,13,0
355925,4,34,17,17,5,1
376918,1,0,3,-3,15,1
100456,1,7,7,0,12,0
64754,3,28,7,21,13,1
282697,3,6,20,-14,6,1
88596,2,10,7,3,6,1
106445,2,16,0,16,14,0
314898,2,0,0,0,4,0
8103,4,24,20,4,4,1
4987,4,24,17,7,3,0
118689,3,14,6,8,2,1
358489,4,41,27,14,6,0
187932,1,0,7,-7,16,1
132642,1,0,0,0,9,0
21714,3,17,7,10,11,0
38318,1,0,0,0,1,0
202490,4,9,16,-7,5,0
152317,1,7,0,7,17,0
337533,4,7,26,-19,14,0
381775,1,0,0,0,17,1
108671,2,27,9,18,15,0
237803,2,0,10,-10,4,0
331392,1,3,7,-4,11,1
363862,4,13,26,-13,8,0
46399,4,12,17,-5,4,0
49985,3,21,7,14,6,0
230084,1,0,0,0,17,0
76925,2,14,13,1,1,1
139499,1,3,0,3,12,1
144109,3,16,0,16,14,1
141320,1,0,7,-7,13,1
336707,2,3,3,0,14,0
253216,2,0,7,-7,11,1
376455,5,23,23,0,14,1
62388,1,0,7,-7,12,0
62663,4,24,20,4,12,0
316993,1,0,7,-7,4,0
175554,3,20,0,20,11,1
199833,2,3,17,-14,4,1
96428,2,7,14,-7,10,1
254153,3,3,12,-9,11,0
103491,2,13,0,13,13,0
162396,4,10,20,-10,4,1
196813,2,0,10,-10,3,1
166433,2,17,7,10,6,1
329978,4,7,10,-3,11,1
272326,1,7,0,7,2,0
148747,2,13,3,10,16,0
228468,2,9,0,9,17,1
188777,4,0,20,-20,16,0
118357,1,3,0,3,2,0
143419,4,13,26,-13,14,0
41272,1,0,0,0,2,0
99961,4,17,16,1,12,0
292967,4,10,7,3,11,1
328647,4,20,35,-15,10,0
47524,2,29,6,23,5,1
155465,4,13,10,3,2,0
117063,3,0,17,-17,2,0
1461,1,0,0,0,1,0
354152,1,0,0,0,4,0
262912,3,14,23,-9,15,1
199802,2,3,3,0,4,1
357519,2,7,6,1,5,1
162181,2,7,7,0,4,1
101150,4,19,27,-8,12,0
346996,3,7,3,4,1,0
314752,2,14,0,14,4,0
337942,3,13,0,13,14,1
364649,1,0,0,0,9,0
283574,2,6,17,-11,7,1
229489,1,0,0,0,17,1
193650,1,0,6,-6,1,1
396343,1,7,6,1,6,1
138361,4,30,7,23,11,0
41077,4,3,16,-13,2,1
355091,2,6,13,-7,4,0
110050,4,48,16,32,16,0
279875,3,17,13,4,5,1
403078,4,34,27,7,9,0
77011,4,17,20,-3,1,0
53424,3,3,28,-25,8,0
208118,1,0,0,0,8,1
250027,3,17,13,4,9,0
128775,2,7,10,-3,7,1
284660,3,14,27,-13,7,0
232492,2,10,3,7,1,1
383074,2,17,7,10,17,1
316242,2,0,10,-10,4,0
155916,4,17,13,4,2,0
309723,3,19,6,13,1,1
16986,4,27,23,4,8,1
186020,2,17,34,-17,15,0
266486,2,0,15,-15,16,1
29988,2,17,0,17,14,0
4872,1,14,0,14,3,0
246066,3,16,13,3,7,1
115036,4,20,22,-2,1,0
203324,2,14,24,-10,6,0
301461,2,17,6,11,15,1
263862,1,0,0,0,15,0
328157,3,6,14,-8,10,0
414914,4,42,21,21,15,1
266241,3,31,19,12,16,1
281683,3,31,17,14,6,0
271126,2,0,10,-10,1,0
193187,1,0,0,0,1,0
226934,4,3,13,-10,16,0
118326,4,26,7,19,2,1
6757,1,0,0,0,3,1
388533,4,3,23,-20,2,0
179973,1,0,6,-6,13,1
78106,2,7,3,4,2,0
304476,2,0,7,-7,16,1
332740,2,21,9,12,12,0
24641,1,7,0,7,12,1
28427,4,13,6,7,14,0
158788,2,7,3,4,3,1
206282,3,10,6,4,7,1
414685,2,3,10,-7,14,1
417248,4,20,20,0,16,1
33453,4,23,20,3,16,0
17609,4,20,17,3,9,0
405261,2,14,7,7,10,0
35497,3,24,7,17,17,1
294604,1,0,0,0,12,0
405021,4,9,26,-17,10,1
161868,2,13,3,10,4,1
223106,3,31,17,14,14,1
279260,3,16,13,3,5,1
29277,2,21,7,14,14,0
272648,1,2,0,2,2,1
245368,1,9,0,9,7,0
241339,1,0,0,0,5,1
246943,2,20,7,13,8,1
339058,1,0,0,0,15,0
152596,1,0,0,0,17,0
14778,3,31,3,28,7,1
187782,1,7,0,7,16,0
133424,1,13,7,6,9,1
30866,2,3,14,-11,15,1
102495,3,24,3,21,13,1
316194,4,30,35,-5,4,0
195019,1,7,7,0,2,0
220890,4,28,38,-10,14,0
182434,1,7,0,7,14,1
142282,2,0,0,0,13,1
136822,4,20,13,7,11,0
132299,3,24,14,10,9,0
28838,2,13,7,6,14,0
327449,4,10,20,-10,9,0
153630,4,15,14,1,1,1
248202,4,12,10,2,8,0
67318,2,14,3,11,14,0
297434,4,38,24,14,13,0
60372,2,13,7,6,11,0
239192,4,27,19,8,4,0
120770,4,23,6,17,3,0
17534,2,13,0,13,9,0
32147,4,24,24,0,15,1
271033,3,18,28,-10,1,1
58351,1,7,0,7,10,1
304584,1,0,0,0,16,0
118816,2,13,0,13,2,1
242680,4,16,10,6,6,0
328192,4,14,17,-3,10,1
381862,4,24,21,3,17,1
106431,2,16,0,16,14,0
60773,1,7,0,7,11,0
241557,2,3,10,-7,5,1
273082,4,9,3,6,2,0
418707,2,0,7,-7,16,0
258769,4,3,37,-34,13,0
350050,3,20,13,7,2,1
133609,2,10,7,3,9,0
156677,3,6,14,-8,2,1
402490,4,26,15,11,9,0
211262,4,29,26,3,9,1
251162,1,0,0,0,10,1
104583,2,7,3,4,14,0
263483,3,13,16,-3,15,1
46208,3,14,21,-7,4,1
47879,4,21,13,8,5,0
121736,4,21,34,-13,4,0
284089,4,20,17,3,7,0
237207,2,3,0,3,3,0
10791,2,20,0,20,5,1
371188,3,11,19,-8,12,1
145073,4,20,13,7,14,0
117985,3,17,6,11,2,1
278548,4,43,7,36,4,0
332573,2,10,3,7,12,0
182421,1,7,0,7,14,0
135589,4,28,6,22,10,1
61336,1,0,0,0,11,1
336930,4,14,21,-7,14,0
61968,2,3,0,3,12,0
337298,1,7,7,0,14,0
241222,1,0,0,0,5,1
71577,2,3,14,-11,16,1
30679,1,3,0,3,15,0
325242,1,0,0,0,8,0
29998,2,17,0,17,14,1
265983,4,0,33,-33,16,1
15379,3,10,9,1,8,0
241728,3,7,9,-2,5,1
58811,4,18,36,-18,10,1
145999,4,13,21,-8,15,1
356414,4,31,20,11,5,0
117540,4,17,17,0,2,0
225451,1,0,0,0,15,0
308930,1,0,0,0,1,0
206807,1,0,0,0,7,0
317566,4,24,27,-3,5,0
61747,4,24,38,-14,12,0
317978,3,10,10,0,5,0
193425,3,20,20,0,1,0
167478,2,0,0,0,7,1
248742,2,20,7,13,9,0
208262,1,0,6,-6,8,0
347986,4,6,24,-18,1,1
295778,4,24,22,2,12,0
318649,4,10,13,-3,5,1
75373,1,0,0,0,17,1
348031,1,0,7,-7,1,0
400735,4,16,17,-1,8,0
162211,3,13,20,-7,4,1
254418,2,13,0,13,11,1
9098,4,30,13,17,4,0
4532,3,24,19,5,2,0
421380,2,13,17,-4,17,1
218140,2,7,3,4,12,0
5273,4,24,31,-7,3,0
411470,3,10,17,-7,13,0
110335,3,10,17,-7,16,1
351951,2,20,14,6,3,1
226684,1,7,3,4,16,1
230397,2,7,0,7,1,0
195387,3,10,3,7,2,1
377014,4,15,19,-4,15,1
138404,1,7,0,7,12,1
6255,3,13,14,-1,3,1
73340,2,13,0,13,17,1
106325,3,7,19,-12,14,1
173965,4,23,19,4,10,0
143132,4,37,27,10,13,0
30244,1,3,0,3,14,0
149501,1,13,6,7,16,1
12553,3,3,17,-14,6,0
56900,3,27,7,20,9,1
153262,2,2,0,2,1,0
11589,4,20,16,4,6,0
42236,3,24,7,17,2,1
229383,2,3,0,3,17,0
247675,1,7,3,4,8,0
388874,1,10,7,3,3,0
89339,1,3,6,-3,7,1
76343,2,13,3,10,1,1
261560,3,12,7,5,14,0
405273,2,14,7,7,10,0
139810,2,7,10,-3,12,0
193717,3,3,27,-24,1,0
380516,2,7,14,-7,16,0
22524,4,31,37,-6,11,1
378528,1,7,6,1,15,0
380011,2,7,0,7,16,1
133760,2,13,7,6,9,0
277371,2,17,6,11,4,0
211895,4,36,23,13,9,0
231003,2,10,0,10,1,0
384918,4,13,43,-30,1,1
327566,3,10,15,-5,10,0
188063,1,0,0,0,16,0
360284,2,0,6,-6,7,0
270501,1,0,7,-7,1,1
38647,2,0,0,0,1,0
226605,3,10,3,7,16,1
27274,1,7,0,7,13,0
350923,3,3,14,-11,3,1
235544,2,10,13,-3,3,0
147174,4,17,49,-32,15,0
314640,3,7,14,-7,3,1
365251,2,3,7,-4,9,0
354368,3,45,3,42,4,0
180530,4,21,20,1,13,0
236817,3,3,9,-6,3,1
105616,4,32,28,4,14,0
206270,3,10,6,4,7,0
402090,1,3,0,3,9,1
325719,1,0,0,0,9,0
396436,3,20,25,-5,6,1
103976,3,6,10,-4,13,0
162687,3,23,24,-1,5,0
152971,3,35,17,18,1,1
383645,2,0,14,-14,17,1
96797,4,7,17,-10,10,1
356518,3,9,3,6,5,0
155986,2,10,14,-4,2,1
153588,3,12,14,-2,1,1
365005,3,17,6,11,9,1
57685,4,24,17,7,10,0
28174,1,3,0,3,13,0
371394,1,7,7,0,12,0
264771,3,10,16,-6,16,0
175109,2,14,10,4,10,1
186369,4,36,24,12,15,0
891,1,0,0,0,1,1
179550,2,0,23,-23,12,0
352505,1,7,6,1,3,1
355829,1,6,0,6,5,1
11261,3,17,27,-10,6,0
193914,4,31,16,15,1,0
361139,5,23,23,0,7,1
257352,2,17,0,17,13,0
284304,2,3,10,-7,7,1
156441,1,0,3,-3,2,0
165299,4,17,24,-7,6,1
357697,2,26,6,20,5,1
114731,4,15,10,5,1,0
280632,4,23,9,14,5,0
91093,4,9,7,2,7,1
64627,4,20,17,3,13,1
202225,1,3,0,3,5,1
173117,1,3,7,-4,9,1
315676,3,10,13,-3,4,1
208510,3,44,7,37,8,1
152279,4,28,0,28,17,0
322510,4,15,3,12,7,0
10143,1,0,0,0,5,1
178545,4,16,13,3,12,1
322073,3,26,0,26,7,0
190359,2,7,0,7,17,1
107297,2,3,0,3,15,1
48088,1,0,0,0,5,0
298838,3,21,9,12,14,1
351727,4,27,17,10,3,1
353031,4,26,10,16,3,0
287194,3,10,20,-10,8,1
100025,1,3,3,0,12,1
203541,4,31,3,28,6,0
353845,2,7,14,-7,4,0
194860,1,0,7,-7,2,0
79988,1,7,0,7,2,0
225063,2,7,14,-7,15,1
359805,4,37,33,4,6,0
24562,3,10,13,-3,12,0
36324,2,7,7,0,17,0
161338,5,20,19,1,4,1
263429,2,3,13,-10,15,0
35960,3,3,7,-4,17,0
214759,3,3,13,-10,11,1
198031,3,0,30,-30,3,0
161159,4,3,33,-30,4,1
234432,1,10,3,7,2,0
416831,4,19,16,3,15,0
264766,3,10,16,-6,16,0
198882,1,0,13,-13,3,1
392070,4,18,30,-12,4,0
361310,1,0,0,0,7,1
355493,4,23,27,-4,4,1
185227,2,10,6,4,15,1
145821,4,13,26,-13,15,0
235548,3,10,13,-3,3,0
1778,1,3,0,3,1,1
242554,1,0,0,0,6,1
332699,1,14,0,14,12,0
43897,1,0,0,0,3,1
80301,1,7,6,1,2,1
395171,2,10,7,3,5,0
63957,4,6,27,-21,12,1
226747,3,7,13,-6,16,1
203079,4,36,17,19,5,0
359673,4,40,7,33,6,1
63193,3,14,23,-9,12,0
326583,1,3,0,3,9,0
59947,3,3,17,-14,11,0
249821,1,6,3,3,9,0
126584,4,16,13,3,6,0
358662,1,0,0,0,6,0
359925,4,23,30,-7,6,1
248391,1,3,0,3,8,1
1755,4,28,0,28,1,0
79616,3,14,13,1,2,0
414396,2,7,17,-10,14,1
69830,2,14,3,11,15,1
112898,3,13,6,7,17,1
354270,4,23,24,-1,4,1
33623,1,0,0,0,16,0
326395,4,20,10,10,9,1
330202,2,7,0,7,11,0
281636,2,21,3,18,6,1
128007,4,23,33,-10,6,0
278180,3,24,14,10,4,0
181071,2,7,7,0,13,1
361831,4,37,10,27,7,1
197388,1,7,0,7,3,0
394021,3,6,13,-7,5,1
221473,4,3,41,-38,14,1
360983,1,0,0,0,7,0
419805,4,24,20,4,17,0
240644,3,20,17,3,5,0
404939,2,3,13,-10,10,1
200045,4,24,20,4,4,0
212069,4,24,40,-16,9,0
251561,3,16,13,3,10,1
112464,4,13,16,-3,17,1
23782,2,10,0,10,12,1
120615,3,3,20,-17,3,1
200378,1,0,6,-6,4,1
396639,4,23,17,6,6,1
76811,3,33,0,33,1,0
186187,3,16,6,10,15,0
99022,2,6,0,6,11,1
364472,4,42,28,14,9,0
97656,2,3,3,0,11,1
233682,1,7,7,0,2,1
247219,1,7,7,0,8,1
338008,1,0,0,0,14,1
41824,4,21,14,7,2,0
295920,4,13,17,-4,12,0
114199,2,3,0,3,1,1
213344,2,10,6,4,10,0
134678,4,34,31,3,10,1
268104,1,3,7,-4,17,0
151285,1,7,7,0,17,1
189177,2,21,0,21,16,1
238408,4,17,33,-16,4,0
387631,4,13,12,1,2,0
195209,2,16,3,13,2,0
268389,1,0,0,0,17,1
191092,2,7,10,-3,17,0
297466,1,0,0,0,13,1
57735,1,3,0,3,10,1
307525,4,38,19,19,17,0
127676,4,30,20,10,6,0
270756,4,6,3,3,1,1
248141,2,3,3,0,8,1
320009,4,43,24,19,6,0
369084,1,3,0,3,11,0
224304,3,9,12,-3,15,1
248536,5,23,23,0,8,0
380843,4,9,24,-15,16,0
307112,4,24,6,18,17,1
244011,2,7,7,0,6,0
142763,2,9,10,-1,13,1
408081,4,20,17,3,12,1
293135,4,17,30,-13,11,0
139702,2,7,6,1,12,0
365103,2,0,7,-7,9,1
157277,3,13,3,10,2,0
419646,4,30,16,14,17,0
65999,1,0,0,0,13,1
309842,2,14,7,7,1,1
157446,3,16,17,-1,2,0
177302,4,17,20,-3,11,1
394563,1,0,0,0,5,0
387571,3,6,3,3,2,1
357095,2,6,14,-8,5,1
42994,4,38,30,8,3,1
116840,1,7,0,7,2,0
285584,3,7,10,-3,8,1
200116,2,7,17,-10,4,1
164122,4,22,6,16,5,0
21732,3,24,14,10,11,0
312697,3,28,14,14,3,1
16328,1,7,0,7,8,0
17388,3,17,0,17,9,1
106488,3,29,9,20,14,1
226856,2,0,7,-7,16,0
296097,4,9,17,-8,13,0
290271,4,17,12,5,10,1
15495,3,16,0,16,8,0
257246,4,19,23,-4,12,0
94352,3,17,7,10,9,0
56597,3,19,17,2,9,1
211314,2,10,3,7,9,0
128096,3,9,6,3,7,1
356139,2,10,0,10,5,0
307310,2,14,13,1,17,1
119240,2,7,3,4,3,0
125164,3,17,7,10,5,0
409285,4,13,16,-3,12,1
296790,3,7,0,7,13,0
101482,1,6,0,6,12,1
56480,4,7,41,-34,9,0
187381,2,20,7,13,16,1
147844,2,3,14,-11,15,0
284983,4,16,27,-11,7,1
19678,1,0,0,0,10,1
122280,3,6,19,-13,4,1
339922,4,33,0,33,15,0
144557,2,7,16,-9,14,0
49524,3,7,3,4,6,1
262299,3,10,9,1,15,0
307047,3,17,0,17,17,1
183552,2,7,10,-3,14,0
236151,2,7,10,-3,3,0
26795,4,13,40,-27,13,0
399759,2,0,17,-17,8,0
404326,2,7,6,1,10,0
183460,4,27,6,21,14,0
223057,2,14,7,7,14,1
419798,4,24,20,4,17,0
179619,4,31,23,8,12,0
50779,4,24,21,3,6,1
332327,3,13,6,7,12,1
310839,1,0,0,0,2,0
346288,4,47,3,44,1,1
139227,1,3,6,-3,12,1
359896,3,23,24,-1,6,1
392968,3,9,3,6,4,0
84137,2,7,0,7,4,1
70020,3,24,10,14,15,0
287474,2,14,13,1,9,0
166032,4,20,27,-7,6,0
118688,3,14,6,8,2,1
16218,2,3,0,3,8,1
264143,4,20,27,-7,15,1
217601,3,6,9,-3,12,0
81668,2,7,14,-7,3,1
216025,2,7,12,-5,11,1
125603,2,14,10,4,5,0
397032,3,21,9,12,6,1
159286,3,24,24,0,3,1
294284,1,0,0,0,12,1
255166,1,7,0,7,12,0
173968,4,23,19,4,10,1
375252,1,0,0,0,14,0
6705,4,3,20,-17,3,0
248110,1,0,0,0,8,0
243866,2,6,3,3,6,1
105371,2,23,7,16,14,1
122410,2,0,20,-20,4,0
140399,1,0,0,0,12,0
19970,1,6,3,3,10,1
89044,1,6,3,3,6,0
239797,1,0,0,0,4,0
75678,1,0,0,0,1,1
103918,2,3,0,3,13,1
236247,4,27,22,5,3,0
410661,1,0,0,0,13,0
397707,2,6,7,-1,7,1
78733,2,13,7,6,2,1
394549,1,0,0,0,5,1
234342,3,17,0,17,2,0
47135,1,3,0,3,5,0
117471,2,7,14,-7,2,0
105127,4,26,14,12,14,1
152039,2,3,0,3,17,0
292945,4,10,0,10,11,0
235471,4,28,39,-11,3,1
280860,3,10,3,7,6,1
152253,3,21,0,21,17,1
16750,2,3,7,-4,8,0
251615,4,19,20,-1,10,0
195056,2,7,17,-10,2,1
131773,1,0,0,0,8,0
2121,3,10,13,-3,1,1
12778,1,0,0,0,6,0
138155,2,7,9,-2,11,1
185558,2,10,16,-6,15,0
213598,4,29,14,15,10,0
179457,4,13,20,-7,12,1
345607,4,17,23,-6,17,0
16897,2,7,13,-6,8,1
409609,4,42,20,22,12,1
56649,4,26,24,2,9,1
279121,3,21,20,1,5,1
412475,2,10,7,3,14,1
288644,1,0,0,0,9,0
418300,3,6,14,-8,16,0
353701,3,3,10,-7,4,0
149109,3,17,17,0,16,0
415802,4,27,24,3,15,0
381709,4,20,24,-4,17,1
122180,4,24,28,-4,4,1
122140,3,24,14,10,4,0
370117,1,7,3,4,12,1
242287,2,10,7,3,6,1
103760,1,0,0,0,13,1
129292,4,17,13,4,7,1
344422,4,28,24,4,17,0
348100,3,3,19,-16,1,0
44512,4,27,20,7,3,1
389574,1,7,0,7,3,0
419538,1,0,6,-6,17,0
269705,4,10,21,-11,1,1
265387,3,14,13,1,16,0
106840,1,0,0,0,14,1
225828,4,24,14,10,16,0
112660,1,0,0,0,17,0
400574,4,13,24,-11,8,0
85195,3,10,10,0,4,1
66239,4,38,3,35,13,1
37191,2,3,7,-4,17,0
156329,2,24,0,24,2,1
262170,4,28,6,22,15,0
405195,1,0,7,-7,10,0
168664,1,0,0,0,7,0
324963,1,6,14,-8,8,1
415633,4,30,13,17,15,1
324883,3,10,13,-3,8,1
25473,4,13,17,-4,12,1
299720,3,17,3,14,14,0
264468,4,20,35,-15,15,1
322746,1,3,14,-11,7,0
257867,3,13,12,1,13,1
303834,4,20,17,3,16,0
81619,4,30,31,-1,3,1
45951,4,17,3,14,4,0
418047,4,28,35,-7,16,1
170882,3,7,7,0,8,1
60755,4,34,3,31,11,1
34122,2,3,3,0,16,0
244211,2,13,7,6,6,0
263119,1,0,7,-7,15,1
328424,2,3,0,3,10,0
265104,3,13,10,3,16,1
69659,1,0,7,-7,15,1
152643,2,7,6,1,17,1
347525,4,20,36,-16,1,0
270481,1,0,0,0,1,1
217336,3,7,10,-3,12,0
24538,2,7,13,-6,12,1
402027,4,3,19,-16,9,1
280912,4,21,3,18,6,0
100282,1,6,0,6,12,0
271853,1,0,3,-3,2,0
93938,4,24,16,8,9,1
142870,1,0,0,0,13,1
357349,1,0,0,0,5,1
49138,1,0,0,0,6,1
33227,2,10,0,10,16,1
11396,3,23,0,23,6,1
32620,1,0,0,0,15,0
343048,2,6,7,-1,16,1
254301,3,6,16,-10,11,0
368547,2,9,0,9,11,0
43279,4,24,10,14,3,1
303111,2,7,14,-7,16,0
248867,1,7,0,7,9,1
314004,2,0,0,0,3,1
268664,4,20,20,0,17,1
386678,3,17,13,4,2,0
168513,4,17,30,-13,7,0
410597,3,17,14,3,13,1
120336,1,0,0,0,3,0
403845,1,3,0,3,10,0
12865,3,13,3,10,6,0
110597,2,17,7,10,16,0
365701,2,7,3,4,9,1
413443,3,10,38,-28,14,1
401986,3,3,9,-6,9,1
153910,4,7,6,1,1,0
138277,1,10,0,10,11,0
18087,1,0,14,-14,9,1
246219,3,21,16,5,7,1
71781,4,38,30,8,16,0
23179,2,23,6,17,11,1
288817,2,10,14,-4,9,0
240508,3,6,7,-1,5,0
391366,1,0,0,0,4,0
101832,1,3,0,3,12,0
276550,4,22,7,15,4,0
9326,3,21,7,14,5,1
152458,1,7,0,7,17,1
243718,2,14,3,11,6,1
272876,3,20,17,3,2,1
389770,2,10,3,7,3,0
155862,3,7,10,-3,2,0
400531,3,7,17,-10,8,1
403910,3,20,14,6,10,0
100384,4,9,20,-11,12,1
46620,3,3,0,3,4,0
282589,4,26,24,2,6,1
196216,2,7,3,4,2,0
233356,4,19,26,-7,2,1
408236,4,20,3,17,12,0
98309,3,28,27,1,11,1
34496,4,48,10,38,16,1
257292,1,0,0,0,13,0
362853,4,14,28,-14,8,0
319138,2,2,0,2,5,1
99992,4,17,19,-2,12,1
196718,3,46,0,46,3,1
369215,1,0,7,-7,11,1
145279,2,14,6,8,14,0
392129,1,0,13,-13,4,0
275703,1,0,0,0,3,1
396265,3,3,3,0,6,1
303001,4,20,16,4,16,1
262964,1,0,0,0,15,1
44084,2,0,6,-6,3,0
285346,4,27,9,18,7,0
108126,4,13,42,-29,15,1
118446,4,20,10,10,2,1
242937,4,24,16,8,6,0
203822,4,17,24,-7,6,0
21198,4,0,16,-16,10,0
196074,2,3,21,-18,2,1
63693,1,0,0,0,12,1
213843,3,45,0,45,10,0
308806,1,0,3,-3,1,1
83911,4,23,17,6,4,0
248650,4,17,10,7,9,1
92483,4,23,10,13,8,0
297360,2,6,10,-4,13,0
142659,4,20,13,7,13,0
142027,4,20,14,6,13,1
237082,3,0,26,-26,3,0
45276,2,0,6,-6,4,0
346025,2,3,3,0,1,0
334135,3,16,7,9,13,0
8922,3,21,0,21,4,1
308284,4,13,23,-10,1,1
194666,4,34,7,27,2,0
403090,4,34,34,0,9,1
417343,2,10,3,7,16,0
338019,1,0,0,0,14,1
345871,2,3,14,-11,17,1
150501,4,34,6,28,16,1
78972,1,0,7,-7,2,1
261572,4,12,9,3,14,0
200865,2,14,0,14,4,1
333200,2,0,7,-7,12,1
413069,2,20,13,7,14,0
101582,3,13,31,-18,12,0
328367,4,3,37,-34,10,0
128172,2,7,0,7,7,0
245321,4,16,13,3,7,1
74287,4,10,24,-14,17,1
404460,2,14,7,7,10,0
51560,1,0,0,0,7,1
95614,4,12,13,-1,10,1
196567,3,17,6,11,2,1
94287,1,3,0,3,9,0
229362,1,0,0,0,17,1
30938,4,17,24,-7,15,0
66457,2,6,7,-1,14,1
5735,1,0,0,0,3,0
149323,4,20,27,-7,16,1
74652,2,0,3,-3,17,0
59291,1,0,0,0,11,0
246885,1,0,7,-7,8,1
217675,1,0,0,0,12,1
59113,4,18,29,-11,10,0
61217,1,7,0,7,11,1
271824,4,45,27,18,2,1
240940,3,14,9,5,5,0
21903,4,28,3,25,11,1
246773,2,3,6,-3,8,0
91781,2,3,0,3,8,0
222466,2,6,7,-1,14,0
407079,2,0,13,-13,11,1
159907,3,31,7,24,3,0
95380,2,14,0,14,10,0
273340,3,28,0,28,2,0
44527,1,0,7,-7,3,0
153490,1,0,0,0,1,0
262597,2,23,3,20,15,1
73408,4,30,3,27,17,0
420832,3,17,17,0,17,0
201106,1,0,0,0,5,0
55558,3,17,7,10,9,0
406210,2,7,10,-3,11,1
275789,3,16,3,13,3,1
406170,1,7,0,7,11,1
400040,1,7,3,4,8,0
356932,2,3,3,0,5,0
51985,1,0,7,-7,7,1
39513,1,0,0,0,1,0
38616,1,0,0,0,1,1
89276,4,15,0,15,7,0
139969,2,25,3,22,12,1
207888,3,20,7,13,8,1
364589,3,15,34,-19,9,1
97566,4,37,7,30,10,0
356592,5,9,9,0,5,0
210753,3,21,10,11,9,1
374247,2,7,3,4,13,0
90997,2,3,0,3,7,1
277288,4,0,16,-16,4,0
410959,4,21,29,-8,13,1
225512,3,0,21,-21,15,0
122915,4,34,6,28,4,1
351258,4,28,17,11,3,1
171709,1,0,0,0,9,0
263721,1,0,0,0,15,1
414811,1,7,0,7,15,0
391596,3,10,24,-14,4,0
219260,4,22,10,12,13,1
73823,3,13,0,13,17,0
62112,2,7,7,0,12,0
223253,3,3,6,-3,15,0
85795,2,13,13,0,5,0
275527,4,26,36,-10,3,1
90760,3,17,7,10,7,1
169799,2,3,14,-11,8,0
77883,4,17,31,-14,1,1
247542,2,6,10,-4,8,1
66807,4,10,6,4,14,0
263504,3,20,23,-3,15,0
215934,3,10,21,-11,11,1
43642,2,7,3,4,3,1
61138,3,0,7,-7,11,0
178094,5,26,23,3,12,0
53897,3,7,13,-6,8,1
152641,2,7,6,1,17,1
140189,4,13,10,3,12,1
352644,1,0,0,0,3,1
45397,1,7,0,7,4,0
234899,1,0,0,0,2,1
319529,4,13,17,-4,6,1
277574,3,6,14,-8,4,1
173605,2,0,13,-13,10,1
137442,4,6,28,-22,11,1
28471,1,10,0,10,14,0
380288,4,29,23,6,16,0
383611,1,0,0,0,17,0
105204,2,7,14,-7,14,0
380619,1,7,0,7,16,0
602,1,0,0,0,1,1
365570,2,21,14,7,9,0
134237,3,3,23,-20,10,0
94454,1,0,0,0,9,1
407897,3,9,17,-8,11,1
247425,3,10,9,1,8,1
148957,3,10,12,-2,16,1
45302,2,7,7,0,4,0
259784,4,20,13,7,14,0
49707,4,21,24,-3,6,0
124198,1,0,0,0,5,0
185255,3,24,9,15,15,0
337935,3,13,0,13,14,1
203527,4,31,3,28,6,0
382428,3,0,21,-21,17,0
136542,1,0,10,-10,11,0
152762,2,0,7,-7,17,1
52966,2,14,17,-3,7,0
11275,4,17,28,-11,6,0
311393,4,42,13,29,2,0
364731,3,6,3,3,9,0
114340,2,17,6,11,1,0
409696,3,10,6,4,12,1
46637,3,3,0,3,4,1
142929,3,3,10,-7,13,0
239038,4,36,21,15,4,0
48358,1,0,7,-7,5,0
69561,2,0,10,-10,15,1
129921,4,13,0,13,7,0
220157,4,26,13,13,13,1
156363,3,31,0,31,2,0
209842,2,10,13,-3,8,1
410745,3,17,6,11,13,1
394057,4,9,13,-4,5,0
155582,4,23,10,13,2,0
63418,1,7,3,4,12,1
172673,2,7,3,4,9,1
21540,2,7,7,0,11,0
103954,2,3,10,-7,13,0
279937,1,0,7,-7,5,0
408598,2,21,0,21,12,0
214024,4,36,7,29,10,1
411321,2,10,10,0,13,0
260801,2,3,12,-9,14,1
27384,4,24,10,14,13,0
297526,2,11,0,11,13,1
116098,1,0,0,0,1,0
320657,1,7,7,0,6,1
393164,1,0,0,0,5,1
153406,2,13,10,3,1,0
56987,1,0,10,-10,9,0
357221,1,0,3,-3,5,0
26186,4,0,33,-33,13,0
3800,4,20,10,10,2,1
245239,1,3,3,0,7,1
38559,3,31,6,25,1,0
134303,1,7,14,-7,10,0
401799,1,7,0,7,9,0
333688,3,14,0,14,12,1
24517,2,7,7,0,12,0
97324,1,0,6,-6,10,1
320254,2,14,7,7,6,1
58562,2,10,10,0,10,1
340356,3,17,10,7,15,0
247247,2,21,14,7,8,1
115206,1,0,0,0,1,0
248563,1,0,0,0,9,1
55157,4,29,17,12,8,0
339984,2,13,3,10,15,1
304304,1,0,0,0,16,1
271804,4,33,27,6,2,1
20806,2,14,0,14,10,0
362885,1,0,0,0,8,0
214051,4,43,21,22,10,1
244147,1,0,7,-7,6,1
297511,2,11,0,11,13,0
46535,4,40,6,34,4,0
350363,4,24,13,11,2,0
6626,1,0,0,0,3,0
374791,1,7,0,7,14,0
262604,3,23,3,20,15,1
144215,1,3,7,-4,14,0
384920,4,13,43,-30,1,1
132177,4,29,6,23,9,0
379898,3,14,0,14,16,0
233194,4,43,18,25,2,0
302381,3,16,13,3,15,1
303836,4,20,17,3,16,0
191259,3,7,17,-10,17,1
82676,4,12,13,-1,3,0
17351,2,17,0,17,9,0
292864,1,7,0,7,11,0
196634,1,7,0,7,3,0
306134,2,0,0,0,17,0
275928,3,13,18,-5,3,1
410191,4,20,24,-4,13,1
352029,4,31,21,10,3,0
269235,3,3,6,-3,17,0
365881,3,14,14,0,9,0
366822,2,0,3,-3,10,1
285102,3,3,0,3,7,1
216081,3,24,12,12,11,0
15088,4,10,26,-16,7,0
91649,3,21,14,7,8,0
397425,2,0,13,-13,6,1
215167,2,7,6,1,11,0
195655,2,7,7,0,2,1
313242,1,0,0,0,3,1
13830,1,0,0,0,7,1
68737,4,34,7,27,15,0
182041,3,17,14,3,13,0
181293,4,3,20,-17,13,0
334422,3,10,10,0,13,1
86490,4,30,24,6,5,1
413552,2,3,10,-7,14,1
374341,4,28,13,15,13,0
209492,1,7,3,4,8,1
130045,3,10,27,-17,8,1
316466,3,16,17,-1,4,0
349708,2,14,7,7,2,0
84666,1,0,0,0,4,1
172869,3,24,10,14,9,1
329615,2,10,7,3,11,0
266764,2,0,14,-14,16,0
216976,2,3,3,0,12,1
418996,2,7,7,0,16,1
94504,3,0,0,0,9,1
112006,3,28,21,7,17,0
239260,2,0,7,-7,4,1
256019,4,25,12,13,12,0
143942,2,0,10,-10,14,1
98866,2,7,7,0,11,0
287373,3,20,3,17,8,0
23795,3,17,0,17,12,0
91114,1,0,0,0,8,0
140577,2,17,7,10,12,0
194864,1,0,7,-7,2,0
156972,3,7,13,-6,2,1
372294,2,10,7,3,13,1
115544,2,3,3,0,1,0
378324,3,9,6,3,15,0
372633,3,14,6,8,13,0
272083,3,10,6,4,2,0
73779,2,6,0,6,17,1
31709,1,0,0,0,15,0
199698,3,21,7,14,4,1
346130,4,18,12,6,1,0
182893,1,0,10,-10,14,1
46480,2,27,6,21,4,0
214226,1,0,3,-3,11,0
52587,4,22,10,12,7,1
395444,1,0,0,0,6,1
155032,2,6,12,-6,1,0
88990,4,39,10,29,6,1
413858,3,14,6,8,14,1
309776,1,0,0,0,1,1
223903,4,30,6,24,15,0
48269,2,10,13,-3,5,0
316808,4,16,7,9,4,0
242448,2,0,7,-7,6,1
379686,1,3,0,3,16,0
312035,1,7,7,0,2,1
213444,4,10,41,-31,10,0
323619,2,7,0,7,8,1
217285,2,0,7,-7,12,0
387134,3,10,31,-21,2,0
345024,4,23,23,0,17,0
28324,1,0,0,0,14,1
323699,3,20,0,20,8,0
251945,1,0,7,-7,10,0
308047,1,0,7,-7,1,0
365782,4,17,17,0,9,1
11862,3,41,17,24,6,1
21715,3,17,7,10,11,0
173746,2,3,3,0,10,0
149007,4,13,18,-5,16,0
252176,3,20,16,4,10,0
299855,2,13,0,13,14,0
198778,2,3,6,-3,3,1
83512,2,0,7,-7,4,0
72183,2,10,10,0,16,0
322446,1,6,0,6,7,1
60462,1,0,0,0,11,1
338308,1,0,0,0,14,0
229057,1,3,0,3,17,1
133738,2,0,0,0,9,0
376844,3,21,14,7,15,1
332430,2,10,3,7,12,0
151944,3,26,17,9,17,1
245702,2,3,10,-7,7,1
61357,1,0,0,0,11,1
223847,2,9,3,6,15,0
179693,1,0,0,0,12,0
141915,1,7,0,7,13,0
329254,4,24,13,11,10,1
287693,4,9,13,-4,9,1
225547,4,8,24,-16,15,1
354803,3,13,28,-15,4,1
129539,2,3,14,-11,7,0
80779,2,3,0,3,3,0
99622,2,7,3,4,11,1
84397,1,3,0,3,4,0
134294,1,7,7,0,10,0
381591,4,42,16,26,17,0
53565,3,14,12,2,8,1
368289,3,6,6,0,11,1
7866,2,3,14,-11,4,1
220435,3,23,14,9,13,1
130118,1,0,0,0,8,0
380388,3,10,17,-7,16,1
192465,2,0,17,-17,1,1
42810,3,6,28,-22,3,1
25299,3,37,14,23,12,0
16023,1,7,0,7,8,1
191477,1,7,7,0,17,0
118379,2,6,7,-1,2,0
239665,1,0,3,-3,4,1
95132,3,9,17,-8,9,1
116866,2,7,7,0,2,1
251872,3,14,13,1,10,1
56380,1,0,6,-6,9,0
225054,2,0,14,-14,15,0
146033,1,10,0,10,15,0
31106,1,0,0,0,15,0
398527,4,28,16,12,7,1
275033,3,31,16,15,3,0
59093,4,3,23,-20,10,1
292956,4,10,0,10,11,0
166354,4,20,12,8,6,1
91888,1,0,0,0,8,0
388778,3,14,0,14,3,0
389998,4,28,25,3,3,1
127749,2,0,14,-14,6,1
117565,4,17,23,-6,2,1
358854,2,3,14,-11,6,1
220677,2,10,0,10,13,1
302853,4,12,23,-11,15,1
100648,2,14,14,0,12,0
332737,2,21,9,12,12,1
153149,3,20,17,3,1,1
391106,2,7,14,-7,4,0
305089,2,21,10,11,16,1
83408,3,10,17,-7,4,0
185787,4,25,3,22,15,1
408,3,31,20,11,1,0
284829,4,29,26,3,7,0
316881,2,9,2,7,4,0
269737,1,0,0,0,1,1
308253,3,10,13,-3,1,0
82816,4,12,16,-4,3,1
19884,3,13,21,-8,10,1
107394,4,26,13,13,15,0
331714,2,3,13,-10,12,0
4404,4,7,14,-7,2,1
201545,4,32,21,11,5,1
154054,4,24,21,3,1,0
249233,3,19,7,12,9,0
284021,3,3,3,0,7,0
354175,2,3,7,-4,4,1
338990,3,20,3,17,15,0
195706,4,14,13,1,2,1
190519,2,10,6,4,17,0
146015,1,3,0,3,15,1
317882,4,15,10,5,5,1
63317,2,10,3,7,12,1
168352,4,24,24,0,7,0
63789,3,14,24,-10,12,0
211702,3,23,9,14,9,0
73390,3,23,3,20,17,1
394680,4,24,21,3,5,1
279295,4,19,16,3,5,0
31472,3,3,14,-11,15,0
179042,1,3,0,3,12,0
219904,1,3,0,3,13,0
25567,3,24,7,17,12,0
46245,4,21,31,-10,4,1
324709,2,7,7,0,8,0
147462,4,23,10,13,15,0
376754,1,0,0,0,15,0
170614,4,41,9,32,8,0
80714,4,32,33,-1,3,1
192911,2,7,7,0,1,1
25260,2,14,7,7,12,1
131173,1,0,0,0,8,1
390835,2,0,21,-21,3,0
183195,1,0,0,0,14,1
394786,3,21,0,21,5,1
397316,3,0,24,-24,6,1
420041,3,24,14,10,17,0
379931,4,21,6,15,16,1
400486,1,0,3,-3,8,1
305134,3,21,10,11,16,1
57498,3,21,10,11,10,1
177088,2,17,10,7,11,0
330595,4,24,7,17,11,0
189274,1,3,0,3,16,0
331536,1,0,14,-14,11,1
58648,4,20,17,3,10,0
17611,4,20,17,3,9,0
324357,1,7,0,7,8,0
61213,1,7,0,7,11,1
150242,1,0,0,0,16,0
215373,4,24,20,4,11,0
294994,4,31,14,17,12,0
295819,1,0,0,0,12,0
114265,4,10,24,-14,1,1
320098,2,10,0,10,6,0
126424,4,33,24,9,6,0
352145,4,9,20,-11,3,0
128797,2,13,13,0,7,1
272483,1,0,0,0,2,0
78935,4,20,17,3,2,0
27708,1,0,0,0,13,0
49970,2,21,0,21,6,0
278155,2,17,14,3,4,0
191214,2,0,17,-17,17,0
108741,4,44,19,25,15,1
50122,3,0,17,-17,6,0
80288,1,0,3,-3,2,1
414940,1,0,7,-7,15,1
141635,2,10,7,3,13,1
338152,1,7,0,7,14,0
366871,3,3,6,-3,10,1
257669,2,0,7,-7,13,0
139358,1,7,0,7,12,1
71508,4,33,14,19,16,0
348557,3,28,17,11,2,1
260570,4,30,8,22,14,0
264411,2,3,21,-18,15,1
184601,1,7,0,7,15,0
372331,4,24,17,7,13,1
297275,4,24,6,18,13,1
355933,4,40,17,23,5,0
220916,1,0,0,0,14,1
402951,1,7,7,0,9,0
115877,3,7,16,-9,1,0
400749,1,0,0,0,8,0
233406,2,14,0,14,2,0
405073,2,0,3,-3,10,1
394640,3,17,20,-3,5,0
345858,2,3,7,-4,17,1
100779,2,6,3,3,12,1
134954,3,7,22,-15,10,1
120462,4,19,19,0,3,0
17962,2,13,21,-8,9,0
295617,4,34,32,2,12,0
259384,4,35,41,-6,13,1
316294,3,10,16,-6,4,0
304778,2,0,0,0,16,1
97195,2,3,6,-3,10,1
282450,1,0,0,0,6,1
324586,3,16,9,7,8,0
145332,3,35,19,16,14,1
56690,1,0,0,0,9,0
91033,3,6,0,6,7,1
27716,1,0,0,0,13,0
331144,2,7,13,-6,11,1
372814,4,6,0,6,13,0
5834,4,27,7,20,3,0
126553,3,10,6,4,6,1
356252,4,29,14,15,5,1
228556,4,20,14,6,17,1
126332,2,7,7,0,6,1
378829,1,0,3,-3,15,1
316375,1,7,0,7,4,1
316105,2,23,13,10,4,1
39886,3,6,7,-1,1,1
358991,2,7,0,7,6,1
8145,1,0,7,-7,4,0
148709,1,7,0,7,16,1
35449,2,7,7,0,17,0
78842,2,7,0,7,2,0
72900,2,3,7,-4,16,1
227669,4,42,7,35,16,0
181659,1,0,0,0,13,1
315763,1,0,3,-3,4,0
115988,2,10,0,10,1,1
330974,2,23,7,16,11,0
47549,3,37,6,31,5,1
416976,4,10,17,-7,15,1
201353,4,28,13,15,5,0
340145,2,13,7,6,15,1
278668,3,17,3,14,4,0
64947,4,10,6,4,13,1
113262,2,7,13,-6,17,0
27962,3,21,17,4,13,1
282936,1,7,0,7,6,0
338217,2,14,21,-7,14,0
61853,3,13,23,-10,12,1
285559,2,7,10,-3,8,1
416225,4,10,25,-15,15,0
378005,2,0,7,-7,15,0
80681,4,17,26,-9,3,1
124392,2,6,0,6,5,0
205016,2,9,10,-1,6,1
372021,3,13,0,13,13,0
315299,5,20,19,1,4,1
32305,4,30,36,-6,15,1
335070,5,19,20,-1,13,1
160484,2,20,7,13,4,0
118005,4,20,6,14,2,1
205251,4,23,13,10,6,1
60697,3,21,3,18,11,0
253712,2,10,3,7,11,0
51941,4,13,16,-3,7,0
63351,3,17,3,14,12,0
35688,4,23,10,13,17,0
168819,1,7,0,7,7,1
61761,4,24,45,-21,12,1
254273,2,6,9,-3,11,0
135639,2,7,7,0,10,0
262735,2,21,0,21,15,0
73789,2,6,0,6,17,1
221363,1,0,10,-10,14,0
495,2,7,6,1,1,0
184840,3,24,20,4,15,1
275957,4,20,21,-1,3,1
345782,4,22,10,12,17,0
412612,2,3,3,0,14,1
295343,1,3,0,3,12,0
114582,1,3,0,3,1,0
44365,1,0,0,0,3,0
266284,1,0,0,0,16,1
201685,4,17,20,-3,5,1
238409,4,17,33,-16,4,0
191204,2,0,17,-17,17,1
185821,1,0,0,0,15,1
167430,1,0,0,0,7,0
139103,2,9,3,6,12,0
327727,3,6,13,-7,10,0
395640,2,7,17,-10,6,1
64026,2,17,10,7,13,0
399343,2,24,7,17,7,0
401765,4,27,14,13,8,1
153510,1,2,0,2,1,0
39380,2,0,3,-3,1,1
389500,2,19,3,16,3,1
305500,1,6,0,6,17,1
265464,2,7,7,0,16,0
308229,2,7,10,-3,1,1
208844,1,0,0,0,8,1
404600,2,6,10,-4,10,1
365688,1,7,3,4,9,1
92218,1,0,0,0,8,0
311590,1,3,0,3,2,1
117910,1,0,0,0,2,0
252243,1,0,0,0,10,0
323018,1,7,0,7,7,1
27681,4,14,30,-16,13,0
158693,4,24,7,17,3,0
15647,3,21,10,11,8,0
317832,3,9,3,6,5,0
214160,3,12,9,3,11,0
55967,2,10,7,3,9,0
193185,1,0,0,0,1,0
122131,3,17,14,3,4,0
236895,1,12,0,12,3,1
147998,2,7,3,4,15,0
151765,2,14,6,8,17,1
293638,2,10,7,3,12,1
419867,2,3,8,-5,17,0
58682,1,7,7,0,10,1
169490,2,0,21,-21,8,1
387668,2,0,7,-7,2,0
337107,4,26,15,11,14,0
308408,3,0,18,-18,1,1
380760,1,3,7,-4,16,0
382841,3,27,3,24,17,1
408715,1,3,0,3,12,1
95275,3,9,17,-8,10,1
10891,1,0,7,-7,5,1
396853,2,17,10,7,6,1
402057,4,3,26,-23,9,1
144735,3,3,7,-4,14,1
200696,1,7,0,7,4,0
244454,1,0,0,0,7,1
58716,2,10,17,-7,10,1
181966,1,7,0,7,13,1
228540,4,20,14,6,17,1
395120,4,24,34,-10,5,1
304920,2,7,3,4,16,1
305686,2,3,7,-4,17,0
234126,1,0,0,0,2,1
366055,4,51,14,37,10,1
42857,4,12,37,-25,3,1
94274,1,0,0,0,9,1
65811,5,34,33,1,13,1
59213,3,21,45,-24,10,0
107045,2,17,0,17,15,0
24587,4,10,23,-13,12,0
85619,2,7,0,7,5,1
213817,2,35,0,35,10,0
234533,4,20,20,0,2,1
162057,2,21,13,8,4,1
340660,3,16,13,3,15,0
204825,1,0,0,0,6,1
51023,2,0,17,-17,6,1
149785,1,3,0,3,16,0
414544,2,14,3,11,14,1
47891,4,21,13,8,5,0
414115,2,3,10,-7,14,1
400181,1,0,3,-3,8,1
93806,4,11,19,-8,9,0
236973,4,38,7,31,3,0
126110,4,29,9,20,6,1
126304,1,0,7,-7,6,1
207572,2,14,3,11,7,1
348324,1,7,7,0,1,1
224373,4,19,12,7,15,0
41945,3,24,6,18,2,0
38324,1,0,3,-3,1,0
49835,3,21,10,11,6,0
385626,4,6,24,-18,1,1
96052,4,13,7,6,10,0
177111,3,24,13,11,11,0
268678,4,27,20,7,17,0
201908,1,0,0,0,5,1
331516,4,9,35,-26,11,0
135365,2,14,17,-3,10,0
99676,4,26,3,23,11,0
400380,3,17,10,7,8,1
307768,2,10,7,3,1,1
293862,4,31,26,5,12,1
129496,1,0,0,0,7,1
33835,3,3,31,-28,16,0
70049,4,31,10,21,15,0
250814,3,3,9,-6,10,1
111453,4,0,20,-20,16,1
268799,4,31,10,21,17,0
298969,3,9,9,0,14,1
224382,1,0,0,0,15,0
36492,2,10,6,4,17,0
417891,4,13,10,3,16,0
20033,3,19,6,13,10,0
345147,4,15,3,12,17,1
313205,4,23,16,7,3,0
23726,1,0,0,0,12,1
156514,3,7,6,1,2,1
61465,4,24,17,7,11,1
357859,3,6,24,-18,6,0
41861,1,7,0,7,2,1
296173,2,13,13,0,13,0
124933,1,0,0,0,5,1
94604,1,7,0,7,9,0
99431,1,0,0,0,11,0
200334,4,30,14,16,4,1
173838,4,23,3,20,10,0
292174,3,21,7,14,11,1
399481,2,0,24,-24,7,1
26178,4,0,26,-26,13,0
32877,4,12,7,5,15,0
94386,4,17,21,-4,9,1
270937,1,0,0,0,1,1
22512,4,31,37,-6,11,1
193309,4,10,26,-16,1,1
413434,3,10,38,-28,14,0
298324,1,0,0,0,14,0
409673,2,10,3,7,12,0
87444,4,20,10,10,6,1
215231,4,10,16,-6,11,0
381073,2,14,14,0,16,1
363514,2,3,2,1,8,0
343368,3,0,20,-20,16,1
400784,2,14,7,7,8,1
37788,3,7,9,-2,1,0
257366,2,17,0,17,13,1
103499,2,13,0,13,13,1
148680,4,10,9,1,16,1
219251,4,19,10,9,13,1
358992,2,7,0,7,6,1
26169,3,0,26,-26,13,1
397215,4,13,0,13,6,0
270118,3,17,10,7,1,0
321032,3,10,7,3,6,0
388254,1,3,0,3,2,1
51137,2,10,3,7,7,0
245316,4,16,10,6,7,0
334516,2,14,14,0,13,0
237085,3,0,26,-26,3,0
233128,2,29,3,26,2,0
366995,2,0,31,-31,10,1
177473,4,27,10,17,11,0
174441,5,17,17,0,10,0
93731,2,0,13,-13,9,1
241701,2,7,3,4,5,0
409240,2,13,6,7,12,0
217804,4,17,13,4,12,1
256029,4,25,12,13,12,1
37082,3,13,14,-1,17,0
263681,4,27,13,14,15,1
398415,1,0,0,0,7,0
231303,2,3,3,0,1,0
28501,2,24,0,24,14,1
420526,3,10,42,-32,17,0
325863,1,0,0,0,9,1
19837,1,10,7,3,10,0
75036,4,34,17,17,17,0
273744,1,0,7,-7,2,1
185112,3,0,16,-16,15,1
375345,3,7,17,-10,14,1
121567,4,22,10,12,4,0
409688,3,10,6,4,12,1
372523,4,26,17,9,13,0
200377,1,0,6,-6,4,1
384807,2,6,3,3,1,1
156549,4,14,6,8,2,1
141323,1,3,7,-4,13,1
395854,4,9,17,-8,6,1
395558,4,28,14,14,6,1
194989,1,0,0,0,2,1
63311,2,10,3,7,12,0
274827,1,0,0,0,3,0
51087,4,3,23,-20,6,0
97449,1,0,0,0,10,0
271572,2,7,13,-6,2,0
90461,3,0,13,-13,7,0
219168,2,0,3,-3,13,1
219052,3,24,13,11,13,1
94615,1,7,13,-6,9,1
223668,2,13,6,7,15,0
199638,1,0,0,0,4,1
376912,1,0,3,-3,15,1
301615,2,10,3,7,15,1
242078,4,20,16,4,5,0
82981,4,13,19,-6,4,1
335626,4,19,10,9,13,0
78297,3,10,21,-11,2,0
287544,4,14,40,-26,9,1
46469,2,14,6,8,4,1
157286,3,13,3,10,2,1
302107,3,27,27,0,15,0
372665,4,14,17,-3,13,1
25506,1,0,0,0,12,1
22580,2,13,3,10,11,0
158,1,0,0,0,1,1
362855,4,14,28,-14,8,0
24382,2,13,0,13,12,1
79177,3,16,10,6,2,1
205993,3,13,10,3,7,1
86703,2,10,7,3,5,1
234218,3,20,10,10,2,0
359461,2,0,14,-14,6,1
333316,1,7,0,7,12,1
417376,3,13,16,-3,16,0
288763,4,3,13,-10,9,1
250523,3,16,7,9,9,0
246434,1,7,0,7,8,0
120006,4,23,31,-8,3,1
386345,2,10,6,4,2,1
414980,2,10,7,3,15,0
77417,4,14,21,-7,1,1
209708,3,9,6,3,8,1
20257,4,27,10,17,10,1
417945,1,7,14,-7,16,1
195695,3,14,10,4,2,0
55495,1,10,0,10,9,1
357772,1,0,7,-7,6,1
79772,3,20,7,13,2,0
232809,3,16,14,2,2,0
29079,1,0,3,-3,14,0
323571,4,34,24,10,7,1
361963,3,10,6,4,7,1
388371,4,17,12,5,2,0
104921,3,3,6,-3,14,1
384702,2,13,20,-7,1,0
210739,2,14,0,14,9,0
385713,1,0,0,0,1,1
409013,4,31,31,0,12,1
55330,4,20,17,3,9,0
220012,4,16,35,-19,13,0
374171,3,23,15,8,13,1
102416,1,3,0,3,13,0
299256,2,17,0,17,14,0
96629,3,3,9,-6,10,0
333689,3,14,0,14,12,1
52427,4,12,17,-5,7,1
127558,1,0,3,-3,6,1
382032,4,13,33,-20,17,1
77019,4,17,27,-10,1,0
117414,4,34,17,17,2,0
321141,2,3,10,-7,6,1
368060,4,27,24,3,11,1
195249,3,16,17,-1,2,1
72513,3,13,17,-4,16,1
389363,3,23,13,10,3,1
411540,1,0,6,-6,13,0
265283,4,16,6,10,16,1
291464,4,20,20,0,10,1
293735,1,7,0,7,12,0
40199,4,34,7,27,2,0
1954,2,10,2,8,1,0
22130,2,3,6,-3,11,1
313325,3,12,24,-12,3,1
106114,2,0,0,0,14,1
348686,2,10,10,0,2,0
72579,4,26,31,-5,16,0
315435,4,30,30,0,4,0
263487,3,13,16,-3,15,1
110379,4,27,17,10,16,0
356827,3,0,13,-13,5,0
172342,1,3,7,-4,9,1
61801,2,0,17,-17,12,0
81594,4,17,24,-7,3,0
381304,4,38,28,10,16,0
39141,3,20,10,10,1,0
254743,2,3,3,0,11,0
28499,2,24,0,24,14,0
174443,5,17,17,0,10,0
400991,3,22,7,15,8,0
55295,4,13,10,3,9,1
345928,4,20,23,-3,17,0
308266,3,10,13,-3,1,0
135344,2,14,10,4,10,0
148229,4,16,31,-15,16,1
61809,2,0,17,-17,12,1
299643,1,7,0,7,14,0
28720,4,10,13,-3,14,0
395258,4,10,13,-3,5,0
408296,2,0,0,0,12,0
142356,4,7,3,4,13,0
149864,3,3,16,-13,16,0
141552,4,27,10,17,13,1
218506,4,34,17,17,13,0
276097,4,34,3,31,3,1
4248,3,13,6,7,2,1
142761,2,9,10,-1,13,1
97711,4,9,10,-1,11,0
249031,1,14,3,11,9,0
341161,1,3,0,3,16,0
284955,3,13,14,-1,7,0
292361,4,12,16,-4,11,0
56305,3,3,20,-17,9,1
108092,3,13,28,-15,15,1
227841,1,6,6,0,16,1
234081,4,20,7,13,2,0
118857,3,27,7,20,2,0
258702,2,0,17,-17,13,0
159273,3,17,24,-7,3,1
370362,4,20,35,-15,12,0
52367,2,6,17,-11,7,1
401373,1,17,0,17,8,0
297562,3,21,7,14,13,0
94430,1,0,0,0,9,1
210033,3,10,10,0,8,0
155201,2,14,7,7,1,1
117385,4,34,3,31,2,1
77860,4,17,28,-11,1,0
293761,2,7,3,4,12,0
100031,2,3,3,0,12,0
133178,3,13,17,-4,9,0
57745,2,15,0,15,10,1
119730,1,7,3,4,3,1
283027,4,21,3,18,6,1
365176,3,14,28,-14,9,1
348075,3,0,16,-16,1,0
106018,4,24,3,21,14,1
397449,2,10,13,-3,6,0
205912,1,3,0,3,7,0
103112,4,34,7,27,13,1
356374,3,24,14,10,5,1
360758,2,17,21,-4,7,0
253813,1,7,0,7,11,0
18499,4,17,14,3,9,1
138049,3,29,17,12,11,0
161495,4,10,6,4,4,1
135042,1,14,3,11,10,1
209152,1,0,0,0,8,0
135612,1,7,0,7,10,0
213585,4,23,14,9,10,0
256246,2,6,7,-1,12,0
415207,4,17,24,-7,15,1
305651,1,3,7,-4,17,1
403772,3,12,13,-1,9,0
239063,1,0,0,0,4,1
41473,2,5,7,-2,2,0
3862,1,16,0,16,2,1
367215,1,0,0,0,10,1
110837,4,13,13,0,16,1
309256,2,0,7,-7,1,0
332139,2,0,7,-7,12,1
385862,1,0,0,0,1,1
79271,1,9,3,6,2,1
319784,2,14,7,7,6,1
6841,3,10,21,-11,3,1
300219,4,31,9,22,14,0
65966,4,24,28,-4,13,1
44467,3,17,12,5,3,1
285994,4,29,14,15,8,0
223815,2,9,0,9,15,0
107140,1,0,6,-6,15,0
394420,1,0,3,-3,5,0
403453,2,17,9,8,9,0
407171,4,17,27,-10,11,0
320193,1,0,0,0,6,1
92924,4,34,7,27,8,1
233379,1,7,0,7,2,0
253603,4,9,16,-7,11,0
136909,2,0,13,-13,11,0
57651,3,17,10,7,10,1
175794,1,7,0,7,11,0
385448,3,28,10,18,1,0
5614,1,0,7,-7,3,0
186305,2,19,3,16,15,0
304840,4,3,3,0,16,1
101352,1,6,0,6,12,0
390160,4,20,35,-15,3,0
190144,4,30,3,27,17,0
205343,2,20,0,20,6,1
389454,1,3,0,3,3,1
300243,1,0,0,0,14,1
147668,2,10,0,10,15,0
417127,4,34,7,27,15,1
87844,2,10,9,1,6,1
347928,3,0,21,-21,1,1
125611,2,14,17,-3,5,1
396236,2,0,3,-3,6,0
116618,3,13,3,10,2,1
241837,2,10,3,7,5,1
170817,1,7,0,7,8,0
170025,4,28,17,11,8,1
155909,4,17,13,4,2,1
43621,1,0,3,-3,3,1
302071,2,20,24,-4,15,0
384871,3,6,15,-9,1,0
90570,2,7,7,0,7,1
12090,2,7,7,0,6,1
124097,2,3,21,-18,5,0
164028,2,0,3,-3,5,1
98920,3,7,17,-10,11,0
229370,1,3,0,3,17,0
180002,2,7,13,-6,13,0
116252,1,10,0,10,1,0
401489,1,0,0,0,8,0
254291,2,6,15,-9,11,0
235458,4,28,32,-4,3,0
30672,1,0,0,0,15,1
50821,1,7,7,0,6,0
366469,4,34,16,18,10,0
247502,1,0,0,0,8,1
144148,4,23,13,10,14,1
343207,2,10,0,10,16,0
296603,2,3,7,-4,13,1
60965,2,21,6,15,11,0
157920,3,9,15,-6,3,0
201371,4,28,15,13,5,0
205349,3,20,0,20,6,0
185880,3,9,10,-1,15,1
130779,2,13,3,10,8,0
400308,1,0,0,0,8,1
185497,1,0,3,-3,15,0
238365,3,10,16,-6,4,0
169689,4,20,17,3,8,1
380796,2,9,21,-12,16,1
249750,4,35,21,14,9,0
312743,4,31,21,10,3,1
45507,4,27,26,1,4,1
372182,3,9,13,-4,13,0
74028,1,0,0,0,17,0
397518,4,20,22,-2,6,1
22140,2,10,6,4,11,1
91663,3,21,14,7,8,0
11131,4,24,20,4,5,0
412720,4,40,13,27,14,0
396804,1,0,7,-7,6,1
17867,4,24,17,7,9,0
198626,2,0,14,-14,3,1
316469,4,16,17,-1,4,1
337727,1,3,0,3,14,1
143197,2,7,3,4,13,0
316895,2,9,8,1,4,1
118400,2,12,10,2,2,1
81747,4,31,17,14,3,0
157329,4,19,9,10,2,0
30149,2,10,10,0,14,0
51913,3,13,10,3,7,0
121167,2,7,13,-6,3,0
128456,1,14,0,14,7,0
360224,4,20,13,7,7,0
321743,2,6,6,0,7,1
207126,2,7,6,1,7,0
55661,2,10,14,-4,9,1
354083,3,19,0,19,4,0
256201,1,0,0,0,12,1
172988,2,14,0,14,9,0
174371,3,17,3,14,10,1
66476,2,7,10,-3,14,0
383837,3,3,7,-4,1,1
90690,1,0,0,0,7,1
149460,4,13,27,-14,16,1
47072,4,17,7,10,5,1
229320,4,24,27,-3,17,1
290301,1,0,0,0,10,0
272705,2,12,3,9,2,0
342154,3,15,16,-1,16,0
332532,1,0,0,0,12,0
175017,4,13,28,-15,10,1
177918,4,21,23,-2,12,1
216756,4,27,9,18,12,1
367998,3,17,21,-4,11,0
10933,2,6,14,-8,5,1
372442,2,6,14,-8,13,1
200722,2,7,0,7,4,1
300398,1,0,0,0,14,0
262190,4,31,16,15,15,1
35614,2,7,3,4,17,1
365311,3,10,16,-6,9,1
251249,3,10,24,-14,10,0
28085,3,21,10,11,13,0
371129,1,0,6,-6,12,0
176566,4,19,17,2,11,0
382067,1,7,0,7,17,0
170271,2,0,12,-12,8,1
215538,4,13,3,10,11,1
34888,3,20,10,10,16,1
239555,2,13,0,13,4,0
77441,4,27,21,6,1,0
348069,2,0,10,-10,1,1
317537,4,10,27,-17,5,1
362861,4,14,28,-14,8,1
247040,1,0,3,-3,8,0
13142,2,10,16,-6,6,1
265008,1,0,0,0,16,1
292195,3,21,14,7,11,0
301553,1,0,0,0,15,1
269365,2,7,14,-7,1,0
138885,4,19,47,-28,12,0
399137,1,0,0,0,7,0
169951,2,7,7,0,8,0
44184,4,13,27,-14,3,1
382504,1,0,3,-3,17,1
371290,2,7,10,-3,12,0
354493,3,27,28,-1,4,0
226539,1,0,0,0,16,1
177743,4,13,17,-4,12,1
356734,4,26,24,2,5,1
159406,3,10,20,-10,3,1
190426,4,7,13,-6,17,1
284628,2,14,17,-3,7,1
157199,1,7,0,7,2,1
44499,4,27,20,7,3,1
82652,3,12,10,2,3,1
225810,3,17,14,3,16,0
411462,2,10,17,-7,13,0
346865,3,23,6,17,1,0
190006,4,16,10,6,17,1
212840,5,24,24,0,10,1
333529,3,13,3,10,12,1
274839,1,0,7,-7,3,0
243914,3,19,6,13,6,0
339401,2,0,3,-3,15,1
50452,3,10,10,0,6,1
123511,3,7,3,4,4,1
292683,4,22,16,6,11,0
244824,3,7,3,4,7,0
264546,2,10,14,-4,16,1
366400,2,26,0,26,10,0
184379,3,21,6,15,14,1
49555,4,14,3,11,6,1
398702,1,0,7,-7,7,1
126329,2,7,7,0,6,0
247615,4,19,23,-4,8,0
7501,4,29,6,23,4,1
354569,1,0,0,0,4,0
2787,1,14,7,7,2,0
113097,1,0,0,0,17,1
220732,4,13,6,7,13,0
65066,4,6,17,-11,13,0
274565,3,21,23,-2,3,1
247108,2,13,3,10,8,0
389235,3,28,7,21,3,0
94409,4,17,21,-4,9,1
202383,1,0,0,0,5,1
144212,1,3,7,-4,14,0
336006,3,13,18,-5,13,0
418788,4,14,24,-10,16,0
233340,4,19,23,-4,2,0
273987,4,7,29,-22,2,1
76243,4,12,27,-15,1,1
248056,4,34,13,21,8,0
87385,2,7,7,0,6,1
334816,2,7,0,7,13,1
54079,3,10,3,7,8,1
393643,1,0,0,0,5,1
45563,2,0,13,-13,4,1
366991,2,0,30,-30,10,0
380648,2,7,7,0,16,1
131543,3,6,16,-10,8,1
388344,3,17,12,5,2,1
354198,2,6,10,-4,4,0
112704,2,3,0,3,17,1
18819,1,3,0,3,9,0
13177,3,22,16,6,6,0
232497,2,20,3,17,1,0
369916,4,13,16,-3,12,1
151618,2,13,13,0,17,1
200333,4,30,14,16,4,1
114304,1,7,6,1,1,0
58615,4,10,17,-7,10,1
267035,1,0,0,0,17,1
313321,3,6,24,-18,3,1
88925,2,23,3,20,6,0
305871,3,7,14,-7,17,0
254181,3,3,18,-15,11,0
381248,3,17,10,7,16,0
325745,2,0,7,-7,9,1
221551,2,20,12,8,14,0
268700,1,0,0,0,17,0
6930,2,0,0,0,3,1
329722,4,40,17,23,11,0
105042,2,0,14,-14,14,0
125705,1,0,7,-7,5,1
221394,2,3,17,-14,14,1
76837,4,33,0,33,1,1
417844,2,10,3,7,16,1
213375,2,10,19,-9,10,0
162143,1,0,0,0,4,1
39695,2,3,0,3,1,1
61108,2,0,7,-7,11,1
363224,2,14,7,7,8,0
140312,2,14,13,1,12,1
353576,3,24,0,24,4,1
303912,2,14,24,-10,16,0
92114,2,3,17,-14,8,1
382899,1,0,7,-7,17,0
378082,4,0,17,-17,15,1
356730,4,26,22,4,5,0
76402,4,29,12,17,1,1
91975,3,13,23,-10,8,1
125972,4,16,23,-7,6,1
130499,2,10,3,7,8,0
263822,4,7,24,-17,15,1
138121,1,7,3,4,11,1
98868,2,7,7,0,11,0
90659,4,27,33,-6,7,0
142432,2,7,10,-3,13,0
106173,3,0,7,-7,14,0
156709,4,17,20,-3,2,1
348272,4,16,46,-30,1,1
300726,2,7,0,7,15,0
302589,1,0,0,0,15,0
390938,1,7,0,7,4,1
390861,3,9,28,-19,3,0
225269,1,0,0,0,15,0
81916,4,7,30,-23,3,1
344130,3,20,3,17,17,1
323184,2,7,0,7,7,0
285462,4,33,8,25,8,1
164872,2,0,3,-3,6,0
110396,1,0,0,0,16,1
234866,4,3,12,-9,2,0
118734,4,20,12,8,2,1
317925,1,7,3,4,5,0
279200,1,3,3,0,5,1
71610,3,3,24,-21,16,0
143409,4,7,26,-19,14,0
134339,3,16,21,-5,10,1
156716,4,17,20,-3,2,0
145971,4,10,21,-11,15,1
315188,2,10,10,0,4,0
270672,2,3,0,3,1,0
421095,2,13,3,10,17,1
6659,2,3,10,-7,3,0
301160,2,13,11,2,15,1
235565,3,24,13,11,3,0
56805,4,17,20,-3,9,1
97400,3,9,23,-14,10,1
157135,3,16,20,-4,2,1
75407,2,10,6,4,17,0
244958,2,0,20,-20,7,0
251397,3,30,14,16,10,0
107130,1,0,0,0,15,1
334702,3,15,3,12,13,0
305036,1,0,0,0,16,1
228254,4,10,27,-17,17,1
307401,1,0,0,0,17,0
293132,4,17,30,-13,11,0
386583,1,0,0,0,2,1
345676,2,7,0,7,17,0
43812,2,14,13,1,3,0
388814,4,14,14,0,3,1
158888,1,14,0,14,3,0
220740,4,13,13,0,13,1
2819,2,21,21,0,2,0
203029,2,17,3,14,5,0
417808,2,7,0,7,16,1
38708,4,17,14,3,1,0
109785,4,27,0,27,16,0
177720,3,13,14,-1,12,1
49490,2,0,3,-3,6,1
188218,1,0,0,0,16,0
199807,2,3,3,0,4,0
240556,1,0,0,0,5,1
64065,3,20,17,3,13,0
226818,1,0,0,0,16,1
231005,2,10,0,10,1,0
319837,3,17,10,7,6,1
59070,3,3,17,-14,10,0
217949,1,0,0,0,12,0
353802,1,7,0,7,4,0
136851,1,0,0,0,11,1
92748,3,3,17,-14,8,1
82239,4,16,13,3,3,1
319652,3,24,3,21,6,0
385940,3,10,21,-11,1,1
4340,2,0,7,-7,2,0
321999,1,3,0,3,7,0
53714,3,7,0,7,8,0
143913,2,0,0,0,14,0
63289,2,3,0,3,12,1
71068,3,27,0,27,16,0
226118,3,7,17,-10,16,0
378372,1,0,0,0,15,1
65819,5,34,33,1,13,1
121098,4,18,31,-13,3,1
15953,3,12,14,-2,8,1
367699,2,3,6,-3,10,0
338717,4,27,17,10,14,1
122055,1,0,0,0,4,1
375981,4,20,12,8,14,0
340941,3,7,10,-3,15,1
220915,1,0,0,0,14,1
115107,2,3,13,-10,1,0
205748,1,0,0,0,7,0
327550,2,7,12,-5,10,0
274662,2,7,3,4,3,0
74839,3,20,13,7,17,0
404852,4,23,27,-4,10,0
171175,3,3,7,-4,8,0
316174,4,30,32,-2,4,0
337364,3,14,7,7,14,1
394392,4,31,24,7,5,1
311,1,7,0,7,1,1
260045,2,3,7,-4,14,0
287565,4,26,43,-17,9,1
147834,2,3,13,-10,15,0
217725,2,7,7,0,12,1
388787,3,14,0,14,3,0
134127,4,27,13,14,9,1
206831,2,0,7,-7,7,0
231399,1,0,0,0,1,0
171838,4,26,17,9,9,0
334410,3,10,10,0,13,0
47521,2,23,6,17,5,1
204667,4,17,48,-31,6,0
183218,2,7,7,0,14,0
412652,2,10,10,0,14,1
6923,1,0,0,0,3,0
400841,3,24,19,5,8,1
337180,2,3,9,-6,14,0
106437,2,16,0,16,14,0
245512,1,14,0,14,7,0
222217,3,13,10,3,14,0
134914,2,7,16,-9,10,0
115056,1,0,0,0,1,1
120773,4,23,6,17,3,1
253967,1,0,0,0,11,0
118294,3,19,7,12,2,0
10272,1,0,0,0,5,0
160873,4,34,27,7,4,1
179214,2,7,3,4,12,1
416311,2,10,3,7,15,1
135707,4,17,17,0,10,1
86145,3,28,10,18,5,1
58132,3,20,10,10,10,0
170729,3,21,6,15,8,0
186486,3,17,13,4,15,0
322192,2,0,20,-20,7,0
265166,1,0,3,-3,16,1
277186,1,0,6,-6,4,0
146547,3,14,17,-3,15,0
169194,2,10,6,4,7,1
266864,5,17,17,0,16,1
312495,2,13,0,13,3,1
227903,3,20,6,14,16,0
106940,3,12,3,9,14,0
389694,4,27,16,11,3,0
164158,2,14,7,7,5,1
20020,3,19,6,13,10,1
55423,3,20,10,10,9,0
420866,4,17,34,-17,17,1
54728,1,0,0,0,8,0
396484,4,28,32,-4,6,0
16508,3,13,13,0,8,1
338746,4,27,17,10,14,1
240083,4,20,27,-7,5,0
131184,1,0,0,0,8,0
188701,2,0,17,-17,16,0
171970,4,14,20,-6,9,0
400285,4,24,9,15,8,0
83089,3,6,21,-15,4,1
314470,2,7,0,7,3,1
311168,1,3,0,3,2,1
174494,2,7,7,0,10,0
295884,2,10,14,-4,12,0
60401,3,20,7,13,11,0
338481,2,14,0,14,14,0
42682,3,7,10,-3,3,1
69137,3,14,10,4,15,0
64018,2,17,10,7,13,1
67672,4,7,35,-28,14,0
182057,4,17,21,-4,13,0
303500,4,25,17,8,16,1
268404,1,7,0,7,17,1
286581,3,16,31,-15,8,1
1276,4,17,16,1,1,0
300762,2,10,13,-3,15,1
328960,3,16,7,9,10,1
125155,2,14,7,7,5,1
296292,2,0,10,-10,13,1
366990,2,0,24,-24,10,0
135431,4,28,27,1,10,1
314426,1,0,0,0,3,1
288011,4,27,23,4,9,1
303442,2,19,7,12,16,0
375651,3,17,17,0,14,0
244825,3,7,3,4,7,0
246432,1,7,0,7,8,0
400748,1,0,0,0,8,0
110172,3,20,23,-3,16,1
139339,4,20,13,7,12,1
15554,1,0,0,0,8,1
329309,1,6,14,-8,10,0
188616,4,20,19,1,16,1
82216,4,16,10,6,3,1
108456,1,0,0,0,15,1
132578,3,12,29,-17,9,0
195997,4,7,30,-23,2,0
1336,1,0,0,0,1,0
215028,2,13,0,13,11,0
62021,3,10,7,3,12,1
252297,2,0,13,-13,10,0
339073,1,0,0,0,15,1
78410,2,14,0,14,2,1
183476,4,27,6,21,14,1
93795,4,3,19,-16,9,1
334748,4,25,9,16,13,0
87514,2,7,0,7,6,1
252394,4,12,29,-17,10,1
220448,4,23,21,2,13,1
390128,3,20,28,-8,3,1
130786,2,13,3,10,8,1
74788,2,6,3,3,17,0
378249,1,0,3,-3,15,0
223095,3,31,14,17,14,1
203524,4,30,3,27,6,1
271830,1,0,0,0,2,0
264691,1,7,6,1,16,1
318336,4,9,22,-13,5,0
202107,2,13,3,10,5,1
198342,3,20,14,6,3,0
384203,4,32,20,12,1,0
109597,3,19,14,5,16,1
343286,1,0,0,0,16,0
394931,4,7,17,-10,5,0
353044,1,0,0,0,3,0
248804,4,30,14,16,9,1
320152,4,17,14,3,6,1
100981,4,10,16,-6,12,1
375314,2,7,7,0,14,1
103056,2,21,0,21,13,0
293028,2,3,13,-10,11,1
94108,1,0,0,0,9,1
327245,2,6,3,3,9,0
89759,4,16,23,-7,7,0
147554,2,6,0,6,15,1
158488,2,3,10,-7,3,0
54904,1,0,0,0,8,0
353271,3,28,20,8,4,1
187291,4,10,13,-3,16,1
41775,2,7,14,-7,2,1
222768,2,10,7,3,14,0
144273,3,16,7,9,14,1
109518,1,0,7,-7,16,1
362211,3,6,10,-4,8,1
244494,2,25,3,22,7,1
233579,2,14,27,-13,2,1
322909,2,13,0,13,7,0
395196,2,10,10,0,5,0
188600,4,20,13,7,16,0
135019,1,7,0,7,10,0
132752,4,20,24,-4,9,1
97427,4,16,36,-20,10,1
24941,2,10,7,3,12,0
297047,2,14,0,14,13,1
20778,1,7,0,7,10,0
225106,4,13,14,-1,15,1
338410,4,24,10,14,14,1
160345,3,3,21,-18,4,1
169713,4,20,17,3,8,1
116352,4,40,13,27,1,1
256589,3,14,0,14,12,0
363442,4,28,28,0,8,0
230345,4,19,17,2,17,1
105899,4,19,13,6,14,0
379109,4,7,12,-5,15,1
259649,4,9,6,3,13,1
121054,3,11,24,-13,3,1
193853,2,24,0,24,1,0
138665,3,6,28,-22,12,1
196938,1,7,0,7,3,0
57604,2,3,3,0,10,1
373785,1,0,0,0,13,0
367657,1,0,3,-3,10,0
1694,3,14,0,14,1,0
55683,2,20,14,6,9,1
313124,2,7,3,4,3,0
401870,3,14,28,-14,9,1
72211,3,17,10,7,16,0
3528,1,0,0,0,2,1
25501,1,0,0,0,12,0
81407,3,10,10,0,3,0
262591,2,20,3,17,15,1
71565,1,3,7,-4,16,0
166891,2,7,3,4,6,1
213559,4,10,14,-4,10,1
346318,1,0,3,-3,1,1
384190,4,29,20,9,1,1
182415,1,0,0,0,14,1
389922,2,15,10,5,3,1
253624,4,9,17,-8,11,1
239718,3,7,10,-3,4,1
5803,3,24,7,17,3,0
381470,1,7,0,7,17,0
757,1,0,0,0,1,1
267440,4,20,24,-4,17,0
362926,2,14,0,14,8,0
74753,1,0,0,0,17,1
59582,1,0,3,-3,11,0
302382,3,16,13,3,15,1
92245,2,7,0,7,8,0
150563,2,3,3,0,17,0
6984,3,9,7,2,3,1
31509,4,3,17,-14,15,1
252673,3,6,3,3,10,0
87763,4,6,20,-14,6,1
420649,3,21,16,5,17,0
362509,3,14,6,8,8,1
34108,2,3,0,3,16,1
341544,3,13,10,3,16,0
258124,2,13,13,0,13,0
107022,1,10,0,10,15,0
195882,1,0,0,0,2,0
167207,3,23,10,13,7,0
328244,5,17,17,0,10,0
235270,3,15,6,9,3,1
183668,3,0,8,-8,14,0
281753,1,0,0,0,6,0
14107,1,0,7,-7,7,0
164955,4,3,16,-13,6,1
158240,4,38,0,38,3,0
198574,1,0,0,0,3,1
1104,3,10,36,-26,1,0
80254,4,35,31,4,2,0
220,2,12,10,2,1,1
51061,3,3,20,-17,6,0
217988,2,14,10,4,12,1
52187,2,0,3,-3,7,1
134730,2,10,0,10,10,0
111242,3,10,3,7,16,0
139722,3,7,7,0,12,0
288734,4,0,7,-7,9,0
233588,3,20,27,-7,2,1
99841,4,8,27,-19,12,1
190549,3,17,19,-2,17,0
350145,1,0,0,0,2,0
270442,3,10,7,3,1,0
417923,1,0,0,0,16,0
58282,3,17,13,4,10,1
297836,3,14,10,4,13,1
48023,4,10,27,-17,5,1
368424,3,20,7,13,11,1
356136,2,10,0,10,5,0
207253,1,0,0,0,7,0
334457,4,17,13,4,13,0
114858,4,16,30,-14,1,0
17747,4,24,13,11,9,0
205739,4,27,25,2,7,0
292884,2,7,0,7,11,0
112364,1,10,0,10,17,0
215497,3,10,3,7,11,1
269576,4,24,31,-7,1,0
301108,4,33,13,20,15,0
2342,1,0,3,-3,2,1
301096,4,33,13,20,15,1
244900,1,0,0,0,7,0
195735,4,17,16,1,2,0
23429,1,0,0,0,11,1
382312,4,20,3,17,17,1
43449,1,0,0,0,3,1
22421,2,16,24,-8,11,1
398089,3,24,28,-4,7,0
261340,2,0,7,-7,14,0
106357,4,21,19,2,14,0
366711,2,24,10,14,10,0
221969,4,22,25,-3,14,1
404099,4,13,49,-36,10,0
78573,2,16,7,9,2,0
232934,2,7,3,4,2,0
331289,2,0,14,-14,11,1
36587,1,3,0,3,17,0
51983,1,0,7,-7,7,1
50080,2,0,13,-13,6,0
126918,4,17,14,3,6,0
21147,3,0,13,-13,10,0
320899,4,3,14,-11,6,1
170486,4,21,10,11,8,1
127205,4,13,16,-3,6,0
38019,1,3,0,3,1,1
416109,4,21,13,8,15,1
184691,4,10,24,-14,15,1
216577,4,40,11,29,12,0
276527,3,19,7,12,4,1
343367,3,0,20,-20,16,1
17200,2,7,21,-14,9,0
104434,1,0,7,-7,13,0
345704,2,7,0,7,17,0
124345,1,0,0,0,5,0
192913,2,7,7,0,1,1
300465,2,16,0,16,14,0
252933,2,6,0,6,11,1
283647,4,23,20,3,7,0
164678,4,21,27,-6,5,1
204065,1,0,7,-7,6,1
390788,1,0,7,-7,3,0
54640,2,14,19,-5,8,0
208875,2,7,0,7,8,1
72693,4,20,10,10,16,0
275853,1,3,0,3,3,1
325629,3,10,7,3,9,1
333988,3,17,10,7,12,0
253989,2,0,6,-6,11,0
79311,3,15,3,12,2,0
385928,3,10,14,-4,1,0
338382,3,10,0,10,14,0
311618,2,6,0,6,2,1
35837,4,10,17,-7,17,0
194484,3,16,10,6,2,1
300674,4,24,3,21,15,1
190114,3,27,3,24,17,0
147198,1,0,7,-7,15,1
23868,1,0,0,0,12,1
81674,2,7,14,-7,3,1
103549,3,33,0,33,13,0
90147,2,3,0,3,7,1
255811,3,17,0,17,12,1
327049,4,14,17,-3,9,1
131721,3,24,22,2,8,1
138966,3,7,6,1,12,1
289347,3,28,17,11,9,0
377286,3,14,14,0,15,1
163010,3,16,3,13,5,0
23431,1,0,0,0,11,1
106220,4,7,10,-3,14,1
204962,4,13,27,-14,6,0
214551,2,3,0,3,11,1
389847,4,24,6,18,3,0
57310,2,7,0,7,10,1
361405,4,17,14,3,7,0
269716,4,10,21,-11,1,0
71727,2,10,13,-3,16,0
416566,1,0,0,0,15,0
103973,3,6,10,-4,13,0
276436,1,3,0,3,4,1
386890,1,7,0,7,2,0
359376,4,13,20,-7,6,1
81071,1,0,7,-7,3,0
417773,5,35,35,0,16,1
325626,3,10,7,3,9,0
417626,2,14,3,11,16,1
237111,4,8,33,-25,3,1
389085,3,23,0,23,3,1
399164,2,7,3,4,7,0
247222,1,13,7,6,8,1
297556,3,14,7,7,13,1
61943,1,0,0,0,12,1
184153,4,16,14,2,14,0
378269,2,0,3,-3,15,0
66976,1,0,0,0,14,0
34599,3,17,7,10,16,1
341130,4,21,24,-3,15,0
223991,2,7,6,1,15,1
298069,2,0,14,-14,13,1
256191,4,30,22,8,12,1
388757,2,14,0,14,3,1
11785,1,14,0,14,6,0
351122,4,37,37,0,3,1
299367,1,0,7,-7,14,0
324086,2,0,7,-7,8,0
99870,1,0,0,0,12,0
250896,1,0,0,0,10,0
276684,4,23,13,10,4,1
304131,4,16,30,-14,16,0
372115,1,3,7,-4,13,1
359017,3,10,0,10,6,0
398356,3,3,13,-10,7,0
105168,1,7,0,7,14,0
51155,2,17,3,14,7,0
361581,4,19,17,2,7,0
281385,4,28,13,15,6,0
294051,2,7,14,-7,12,1
231135,2,3,0,3,1,0
356646,2,13,3,10,5,1
133767,2,13,7,6,9,1
339372,1,0,3,-3,15,1
189532,4,20,7,13,17,1
159036,1,7,0,7,3,0
218914,3,34,24,10,13,1
167160,1,6,0,6,7,1
210352,4,16,17,-1,9,0
190791,2,13,3,10,17,0
64582,2,10,14,-4,13,1
119080,1,0,7,-7,3,1
389791,2,10,6,4,3,1
313011,3,10,0,10,3,1
28367,2,6,0,6,14,0
187876,4,7,23,-16,16,1
352674,2,7,3,4,3,1
326618,2,10,6,4,9,1
403982,1,0,6,-6,10,0
139303,4,20,13,7,12,0
98236,1,0,3,-3,11,0
1913,1,0,0,0,1,1
353741,4,13,17,-4,4,1
230032,3,6,6,0,17,0
41616,2,14,0,14,2,0
116938,4,21,13,8,2,1
118625,1,7,0,7,2,0
392006,2,0,7,-7,4,1
36392,4,13,26,-13,17,1
64029,2,17,10,7,13,1
411795,3,0,34,-34,13,0
372185,3,9,13,-4,13,0
142227,5,11,13,-2,13,1
329081,3,10,7,3,10,1
358676,1,7,0,7,6,0
406715,4,27,0,27,11,1
219803,2,38,0,38,13,0
357851,3,6,24,-18,6,0
41253,4,10,13,-3,2,1
38934,2,10,0,10,1,1
283226,1,10,0,10,7,0
315619,1,0,0,0,4,1
313759,3,28,10,18,3,1
108344,2,0,7,-7,15,0
92905,4,34,7,27,8,1
44675,1,0,0,0,3,1
302360,3,10,10,0,15,0
54485,2,7,7,0,8,1
23983,4,23,6,17,12,1
302651,2,17,6,11,15,0
246759,2,3,3,0,8,0
197782,4,21,17,4,3,0
233643,4,23,41,-18,2,0
327457,4,10,27,-17,9,0
53353,1,3,7,-4,8,0
207666,1,0,0,0,7,1
335994,2,13,15,-2,13,0
158991,4,21,29,-8,3,1
300399,1,0,0,0,14,0
339438,3,10,17,-7,15,0
381955,2,0,13,-13,17,0
190382,2,7,0,7,17,0
421845,3,0,13,-13,17,1
39495,4,13,19,-6,1,1
312281,4,10,23,-13,2,1
128932,2,22,3,19,7,0
266837,4,17,14,3,16,0
383376,2,0,9,-9,17,1
100325,2,9,14,-5,12,0
372951,4,25,7,18,13,1
6463,1,0,0,0,3,1
100159,1,7,0,7,12,1
273447,2,0,3,-3,2,1
367023,3,10,31,-21,10,0
102737,1,3,0,3,13,0
78850,2,7,0,7,2,1
263989,4,23,7,16,15,0
415668,1,0,0,0,15,1
248769,3,27,14,13,9,0
377662,2,16,7,9,15,0
388306,2,10,3,7,2,0
270375,1,3,0,3,1,1
262106,2,14,3,11,15,0
31412,1,0,0,0,15,1
41639,3,17,0,17,2,1
236426,1,0,0,0,3,0
305810,1,0,7,-7,17,0
232899,1,0,3,-3,2,0
394846,1,0,14,-14,5,1
129815,1,7,0,7,7,0
398307,2,3,3,0,7,0
357707,3,26,13,13,5,1
32103,3,21,13,8,15,0
2912,1,0,0,0,2,0
217171,3,9,16,-7,12,1
19940,4,22,21,1,10,0
269219,2,3,6,-3,17,0
102777,2,10,3,7,13,0
247205,1,0,0,0,8,0
204281,2,0,7,-7,6,0
41858,1,7,0,7,2,0
271324,4,9,24,-15,1,1
316064,1,3,3,0,4,1
215153,2,7,3,4,11,0
340265,4,29,34,-5,15,1
48135,3,7,6,1,5,1
221481,4,3,41,-38,14,1
104749,2,17,13,4,14,0
371403,1,7,7,0,12,0
393302,4,30,29,1,5,0
64951,4,10,6,4,13,1
102357,4,13,13,0,13,1
267773,1,3,0,3,17,1
239249,2,0,7,-7,4,1
317531,4,10,27,-17,5,0
398408,4,10,30,-20,7,0
292201,4,21,14,7,11,0
168801,1,7,0,7,7,0
208925,3,7,6,1,8,1
58460,4,48,17,31,10,0
190205,2,0,0,0,17,1
108618,1,0,0,0,15,1
152120,4,13,13,0,17,0
164102,4,12,6,6,5,1
19424,2,17,13,4,10,0
285190,5,6,6,0,7,0
100949,2,10,9,1,12,0
327829,2,10,10,0,10,0
414042,4,10,45,-35,14,1
333955,2,14,7,7,12,0
196064,2,3,20,-17,2,0
293719,4,10,13,-3,12,1
358915,4,6,35,-29,6,1
68465,1,0,0,0,14,0
52971,3,14,17,-3,7,1
405393,2,7,10,-3,10,1
165224,2,7,7,0,6,1
334448,4,17,10,7,13,0
267484,1,3,7,-4,17,0
63621,3,13,26,-13,12,0
57496,3,21,10,11,10,1
25236,1,7,0,7,12,1
96543,1,0,0,0,10,0
193881,3,24,7,17,1,0
292078,4,22,19,3,11,1
406877,4,27,23,4,11,0
280302,3,16,16,0,5,1
309624,4,19,3,16,1,0
178412,4,38,34,4,12,0
260052,2,3,7,-4,14,1
300525,4,23,17,6,14,0
76153,1,9,6,3,1,1
271080,1,0,0,0,1,1
317681,4,16,6,10,5,0
300625,3,10,3,7,15,1
362299,1,0,6,-6,8,0
360019,2,3,26,-23,7,0
311591,1,3,0,3,2,1
206606,4,10,13,-3,7,0
265918,2,0,16,-16,16,0
329127,4,27,7,20,10,0
131249,3,14,17,-3,8,0
341891,4,30,15,15,16,1
229535,2,17,6,11,17,0
62261,2,21,7,14,12,0
161254,2,17,3,14,4,1
229414,3,3,3,0,17,0
292429,2,3,0,3,11,0
213527,3,10,14,-4,10,1
397143,2,3,0,3,6,0
209212,3,17,7,10,8,0
31925,3,6,13,-7,15,1
99302,2,13,0,13,11,0
221439,3,3,31,-28,14,1
348093,3,0,19,-19,1,1
265969,4,0,33,-33,16,0
141324,2,3,7,-4,13,0
65802,4,27,33,-6,13,1
282106,3,16,8,8,6,1
360192,3,17,13,4,7,1
182716,4,14,26,-12,14,1
159994,2,3,17,-14,3,0
134032,2,13,3,10,9,0
388552,1,7,0,7,3,0
350183,2,11,0,11,2,1
306007,2,3,10,-7,17,1
7778,3,30,3,27,4,0
141561,4,34,10,24,13,0
117967,2,10,6,4,2,1
368302,3,9,6,3,11,0
279668,2,17,0,17,5,0
2009,4,13,12,1,1,0
188601,4,20,13,7,16,0
96374,4,9,30,-21,10,0
96338,3,3,23,-20,10,1
405591,3,14,17,-3,10,0
282120,3,16,8,8,6,1
75399,2,10,0,10,17,1
370627,3,14,14,0,12,0
94622,2,7,19,-12,9,1
109786,4,27,0,27,16,0
146360,2,3,3,0,15,0
111716,4,37,16,21,16,0
52192,2,7,3,4,7,0
382895,1,0,7,-7,17,1
83819,2,10,3,7,4,0
225796,3,10,14,-4,16,1
230036,4,6,6,0,17,1
74503,2,0,0,0,17,0
3961,4,28,14,14,2,1
164439,1,7,0,7,5,1
90436,2,0,13,-13,7,0
325944,3,16,7,9,9,1
111058,2,10,0,10,16,1
282488,2,7,0,7,6,0
237335,2,0,0,0,3,0
284512,4,24,15,9,7,1
5564,4,19,10,9,3,0
275441,2,20,10,10,3,0
303222,5,31,31,0,16,0
273847,4,17,14,3,2,0
42874,1,0,3,-3,3,1
170423,2,21,3,18,8,0
49206,3,17,3,14,6,1
70489,3,23,20,3,15,0
412323,2,7,14,-7,13,1
78197,4,41,3,38,2,1
399447,1,0,10,-10,7,0
149433,4,13,27,-14,16,1
98399,2,7,7,0,11,0
399256,4,13,20,-7,7,0
272251,3,6,3,3,2,1
380314,1,0,0,0,16,1
224150,2,0,20,-20,15,1
301971,4,20,20,0,15,0
39282,3,3,20,-17,1,1
376495,2,3,3,0,14,1
41612,2,14,0,14,2,0
102314,3,13,10,3,13,0
120617,3,3,20,-17,3,0
73952,3,23,0,23,17,1
63331,3,17,3,14,12,1
244763,1,0,0,0,7,1
35613,2,7,3,4,17,1
1179,1,3,0,3,1,0
361107,4,23,16,7,7,0
384263,2,6,0,6,1,1
387749,4,0,37,-37,2,1
121833,2,0,7,-7,4,0
21133,3,0,0,0,10,0
10996,4,9,28,-19,5,0
163431,3,7,20,-13,5,0
318559,2,10,0,10,5,0
32880,4,12,7,5,15,1
119605,3,10,9,1,3,1
388231,4,14,13,1,2,0
312541,3,23,0,23,3,0
25144,3,17,3,14,12,1
67247,4,7,3,4,14,0
40108,1,3,0,3,2,0
263424,2,0,13,-13,15,1
156527,4,7,6,1,2,0
320808,1,0,0,0,6,0
178518,3,16,13,3,12,1
371246,4,22,22,0,12,1
345691,2,7,0,7,17,1
201731,1,0,0,0,5,1
292135,2,21,0,21,11,0
75042,1,0,0,0,17,0
215672,4,14,6,8,11,0
232684,3,10,0,10,1,0
260821,3,22,12,10,14,0
118798,2,10,0,10,2,1
144778,4,10,17,-7,14,1
275968,4,20,21,-1,3,0
50525,1,0,3,-3,6,1
267650,2,0,21,-21,17,1
133179,3,13,17,-4,9,1
258659,1,0,0,0,13,1
330705,4,6,3,3,11,0
52786,1,0,23,-23,7,0
63137,2,7,10,-3,12,0
402274,2,13,16,-3,9,1
76054,3,10,16,-6,1,1
69056,4,27,24,3,15,1
177437,3,17,10,7,11,1
174550,3,10,14,-4,10,0
30880,2,3,14,-11,15,0
109247,2,6,0,6,15,0
304265,4,33,22,11,16,1
140254,1,0,0,0,12,1
362797,2,7,21,-14,8,1
306082,4,17,13,4,17,1
391651,1,0,0,0,4,1
298437,4,7,24,-17,14,1
12087,2,7,7,0,6,1
159578,3,20,6,14,3,0
121470,1,0,0,0,4,1
21645,1,0,0,0,11,0
301499,3,20,12,8,15,0
110987,4,7,20,-13,16,1
33232,2,10,0,10,16,0
176723,4,36,19,17,11,1
47240,4,12,9,3,5,1
2681,2,6,7,-1,2,1
132130,3,10,3,7,9,0
141533,3,24,10,14,13,0
124099,2,3,21,-18,5,1
71379,1,0,0,0,16,1
108559,3,17,14,3,15,0
36448,1,0,3,-3,17,1
315104,4,47,14,33,4,1
385226,1,0,3,-3,1,1
386243,4,12,17,-5,2,1
128529,3,21,28,-7,7,0
272178,1,0,0,0,2,1
397777,4,17,14,3,7,0
30349,4,10,17,-7,14,0
218985,1,14,0,14,13,0
321403,2,14,10,4,7,1
111329,1,0,7,-7,16,1
108218,2,6,0,6,15,1
178214,3,6,10,-4,12,0
146151,1,0,0,0,15,1
395774,2,0,0,0,6,0
264944,3,23,17,6,16,1
399270,4,16,30,-14,7,0
321565,2,3,6,-3,7,1
159043,1,7,0,7,3,1
399095,4,10,29,-19,7,1
128624,2,3,10,-7,7,0
195382,3,10,3,7,2,0
61241,2,14,7,7,11,1
393662,1,0,0,0,5,0
4134,4,26,28,-2,2,0
32897,4,26,7,19,15,0
233704,2,7,21,-14,2,0
356042,3,21,10,11,5,1
353459,4,25,12,13,4,1
372626,3,14,6,8,13,0
399336,2,21,7,14,7,1
10928,2,6,14,-8,5,1
208402,4,23,43,-20,8,0
9449,2,10,0,10,5,1
101717,3,10,7,3,12,0
258104,2,13,13,0,13,1
110054,4,48,16,32,16,1
340656,3,16,10,6,15,0
257319,1,10,0,10,13,0
176405,4,22,28,-6,11,1
135967,2,3,3,0,10,0
394213,4,33,17,16,5,0
313076,4,20,6,14,3,0
322265,4,0,27,-27,7,1
248519,4,23,20,3,8,0
373435,4,17,17,0,13,0
378296,3,9,3,6,15,0
43122,4,6,27,-21,3,1
353669,2,3,0,3,4,1
277388,3,17,9,8,4,1
219689,4,13,14,-1,13,1
403914,3,20,14,6,10,1
105437,4,23,24,-1,14,1
58169,4,29,17,12,10,0
288117,3,13,7,6,9,1
39747,3,9,0,9,1,1
21170,4,0,16,-16,10,0
17354,2,17,0,17,9,0
403614,3,17,13,4,9,0
299638,1,0,0,0,14,0
396509,1,14,7,7,6,0
159028,1,0,0,0,3,1
356492,2,6,3,3,5,0
355267,3,14,14,0,4,1
308255,3,10,13,-3,1,1
371920,4,27,17,10,12,1
345383,2,0,10,-10,17,1
314482,2,14,0,14,3,1
137100,3,17,6,11,11,1
82160,2,13,3,10,3,0
98101,2,14,0,14,11,0
230570,2,10,10,0,1,1
167425,1,0,0,0,7,1
143567,5,28,28,0,14,0
277662,1,7,0,7,4,0
54358,2,14,19,-5,8,0
198974,4,16,23,-7,3,0
342512,1,0,0,0,16,0
284341,3,6,10,-4,7,1
39414,2,3,10,-7,1,0
92927,4,34,7,27,8,0
283167,4,20,9,11,7,0
369998,2,7,7,0,12,1
314393,4,10,17,-7,3,0
97002,1,7,0,7,10,1
166641,4,22,20,2,6,1
175300,4,15,19,-4,10,1
268844,1,0,0,0,17,0
220853,3,7,28,-21,14,1
210589,2,12,14,-2,9,1
412182,2,14,3,11,13,1
317539,4,10,27,-17,5,0
54214,3,0,3,-3,8,1
51004,2,0,14,-14,6,1
53917,3,14,13,1,8,0
362801,2,7,21,-14,8,0
196195,1,7,0,7,2,1
119391,1,0,14,-14,3,0
86794,1,0,3,-3,5,1
402389,2,7,7,0,9,0
253524,2,0,7,-7,11,1
393656,1,0,0,0,5,0
31067,4,13,13,0,15,0
386274,4,14,20,-6,2,1
334644,1,0,0,0,13,1
114388,3,34,13,21,1,1
405833,5,24,24,0,10,0
327849,2,16,10,6,10,0
338032,2,0,0,0,14,1
389519,3,20,10,10,3,0
199419,4,16,10,6,4,1
26285,3,10,21,-11,13,1
131090,2,17,6,11,8,1
63401,1,0,0,0,12,1
367628,4,31,12,19,10,1
279973,2,3,10,-7,5,0
222325,2,7,3,4,14,1
43777,2,14,10,4,3,1
8202,2,0,7,-7,4,0
284291,2,3,3,0,7,0
224230,1,0,0,0,15,0
378763,3,14,7,7,15,0
329876,1,0,0,0,11,1
67785,4,24,0,24,14,1
298425,4,7,21,-14,14,0
191944,1,0,6,-6,1,1
307690,4,17,23,-6,17,0
22570,2,6,3,3,11,1
87996,2,10,0,10,6,0
236368,3,7,23,-16,3,1
88544,4,29,14,15,6,1
391484,4,10,30,-20,4,0
156350,3,24,0,24,2,0
351765,1,10,14,-4,3,0
217776,4,10,10,0,12,0
284094,1,0,0,0,7,0
333544,3,16,10,6,12,1
100665,3,14,14,0,12,1
84618,3,20,13,7,4,0
160962,2,10,7,3,4,0
393319,4,30,29,1,5,1
263651,3,20,10,10,15,0
273282,2,14,0,14,2,0
96949,4,22,10,12,10,0
13251,1,0,6,-6,7,1
398722,2,0,14,-14,7,0
228474,2,10,0,10,17,0
184995,4,14,20,-6,15,0
420095,1,0,0,0,17,0
166814,4,30,16,14,6,0
528,3,7,20,-13,1,1
113956,4,20,13,7,17,1
182724,4,27,26,1,14,0
238497,2,13,0,13,4,1
222902,2,6,3,3,14,1
284800,3,26,20,6,7,0
95594,4,12,10,2,10,1
282325,1,7,0,7,6,1
250721,1,0,0,0,10,1
21253,2,3,0,3,11,1
366989,2,0,24,-24,10,0
376713,4,3,0,3,14,1
266965,3,16,10,6,17,1
14494,3,27,16,11,7,0
19622,4,17,28,-11,10,0
241312,4,13,7,6,5,0
356243,4,29,14,15,5,0
220521,2,0,14,-14,13,0
26699,2,3,7,-4,13,0
353565,3,24,0,24,4,0
61225,2,13,0,13,11,1
394189,3,23,17,6,5,1
13007,2,7,7,0,6,1
137747,3,10,34,-24,11,1
221517,1,6,2,4,14,1
417934,1,0,7,-7,16,1
274520,2,14,9,5,3,0
283041,4,28,3,25,6,0
255117,4,14,31,-17,12,1
237904,4,14,27,-13,4,1
236212,4,20,16,4,3,1
115224,2,0,3,-3,1,0
57558,4,31,16,15,10,0
77021,1,0,7,-7,1,1
172868,3,24,10,14,9,1
293576,4,20,20,0,11,1
39217,1,3,0,3,1,0
17104,3,23,9,14,9,0
71771,3,38,30,8,16,0
372868,1,3,0,3,13,1
99746,2,0,0,0,12,0
410184,4,20,24,-4,13,1
301827,4,6,34,-28,15,0
153113,2,6,16,-10,1,0
314008,2,3,0,3,3,1
41260,1,0,0,0,2,1
193291,4,3,23,-20,1,1
338963,2,13,0,13,15,0
190228,2,7,7,0,17,1
24758,4,20,34,-14,12,1
192868,4,16,23,-7,1,1
392122,1,0,13,-13,4,1
196798,2,0,7,-7,3,0
317690,4,16,9,7,5,1
169741,1,0,0,0,8,0
88224,4,24,17,7,6,0
245772,4,16,20,-4,7,1
408119,1,0,0,0,12,1
204691,1,7,7,0,6,0
77663,3,7,10,-3,1,1
402149,3,12,0,12,9,1
307562,1,0,0,0,17,0
122181,4,27,28,-1,4,1
270409,2,10,7,3,1,1
158827,3,20,3,17,3,0
414340,1,7,0,7,14,0
179916,3,24,9,15,13,1
207037,3,35,3,32,7,0
273033,3,6,3,3,2,0
390330,1,0,7,-7,3,0
250780,2,3,0,3,10,0
118700,3,17,6,11,2,0
208883,2,7,0,7,8,0
203846,4,31,31,0,6,0
232496,2,19,3,16,1,1
285223,1,0,3,-3,7,1
279944,1,0,10,-10,5,1
65658,4,6,19,-13,13,1
17925,1,7,7,0,9,0
47906,4,21,20,1,5,1
166289,3,7,9,-2,6,1
270422,3,10,7,3,1,0
323825,3,13,15,-2,8,0
85080,4,31,16,15,4,0
103832,3,16,0,16,13,0
140431,2,7,7,0,12,1
213435,4,10,41,-31,10,0
116059,4,16,7,9,1,1
309756,4,26,12,14,1,1
394072,4,9,23,-14,5,1
152553,4,24,14,10,17,1
347358,4,14,21,-7,1,0
372365,4,24,17,7,13,0
323280,4,7,24,-17,7,1
199820,2,3,10,-7,4,1
212872,1,0,0,0,10,0
268843,1,0,0,0,17,0
109758,4,13,0,13,16,1
18876,3,9,6,3,9,0
305331,1,0,0,0,17,0
310789,3,12,10,2,2,1
169606,1,6,0,6,8,1
88293,2,14,7,7,6,0
331735,2,3,20,-17,12,1
243522,1,0,0,0,6,1
234531,4,20,20,0,2,1
151173,2,3,10,-7,17,0
142814,4,12,10,2,13,1
205,2,6,10,-4,1,0
266586,1,0,0,0,16,1
345748,3,13,7,6,17,1
230998,2,7,0,7,1,1
143199,2,7,3,4,13,0
7506,4,29,6,23,4,1
85433,1,7,0,7,5,0
42409,4,14,19,-5,2,0
94133,1,3,7,-4,9,1
141639,2,17,7,10,13,0
384226,1,0,0,0,1,1
14382,4,9,20,-11,7,0
12017,4,24,14,10,6,1
232986,3,10,10,0,2,1
279193,1,3,3,0,5,0
373229,3,3,13,-10,13,1
244467,1,0,3,-3,7,1
81478,1,0,0,0,3,0
333577,4,22,16,6,12,1
404910,2,3,3,0,10,0
48180,4,10,13,-3,5,1
128368,3,7,10,-3,7,0
408480,3,7,3,4,12,0
334497,1,7,14,-7,13,0
314238,4,17,20,-3,3,1
259877,2,13,7,6,14,1
245309,3,16,10,6,7,1
108707,3,34,13,21,15,1
253366,2,7,14,-7,11,1
71139,2,12,3,9,16,0
250553,4,19,14,5,9,0
84639,4,23,13,10,4,0
314240,4,17,20,-3,3,0
144736,3,3,7,-4,14,1
354897,5,41,42,-1,4,1
37248,3,13,14,-1,17,0
395375,3,28,3,25,5,0
368366,1,7,0,7,11,1
61696,3,17,10,7,12,1
362747,1,0,0,0,8,0
74931,1,10,0,10,17,0
309728,3,19,6,13,1,0
56816,4,17,20,-3,9,1
19636,4,17,28,-11,10,0
8255,4,16,10,6,4,0
133766,2,13,7,6,9,1
83604,4,3,17,-14,4,1
247135,3,20,6,14,8,1
45534,1,0,0,0,4,1
283406,2,13,7,6,7,1
279947,1,0,10,-10,5,1
140425,2,7,7,0,12,0
4507,3,17,19,-2,2,0
822,3,14,6,8,1,1
104260,2,10,0,10,13,0
223578,4,17,13,4,15,1
46830,1,0,0,0,5,1
115436,3,39,7,32,1,0
187252,3,7,6,1,16,1
248918,2,17,0,17,9,0
394177,3,16,17,-1,5,1
307217,3,3,10,-7,17,0
201846,4,20,30,-10,5,1
68885,4,6,20,-14,15,1
76395,4,29,6,23,1,1
404654,3,20,22,-2,10,1
285068,2,0,0,0,7,1
411907,2,17,3,14,13,0
351659,2,7,10,-3,3,1
137836,2,7,6,1,11,1
373205,2,3,10,-7,13,0
409754,4,13,9,4,12,0
53974,4,37,25,12,8,0
210644,3,13,24,-11,9,0
169546,3,10,28,-18,8,0
418434,2,14,3,11,16,1
108067,2,13,14,-1,15,0
69971,2,21,0,21,15,0
125509,4,30,7,23,5,0
13932,4,21,14,7,7,1
331656,4,31,33,-2,11,1
385125,2,7,10,-3,1,1
151888,2,13,0,13,17,0
51445,2,10,24,-14,7,1
48465,4,20,26,-6,5,0
39658,1,0,0,0,1,1
367095,1,7,7,0,10,1
59625,2,14,3,11,11,1
330133,4,0,13,-13,11,0
96329,3,3,16,-13,10,0
293306,1,0,0,0,11,0
297551,3,14,6,8,13,0
338534,3,20,17,3,14,0
46566,1,0,0,0,4,1
171807,3,23,14,9,9,0
103492,2,13,0,13,13,0
327772,4,16,23,-7,10,0
231979,1,0,0,0,1,0
161690,1,7,0,7,4,1
384092,1,0,10,-10,1,1
3026,4,20,34,-14,2,1
183592,1,0,0,0,14,1
76266,4,19,27,-8,1,0
41490,3,5,7,-2,2,1
375673,4,23,20,3,14,0
209275,4,34,7,27,8,0
259099,1,0,0,0,13,0
177835,2,14,10,4,12,0
197655,4,33,7,26,3,1
339134,3,10,6,4,15,0
78779,4,13,23,-10,2,1
313985,1,0,0,0,3,0
380802,3,9,21,-12,16,1
93964,1,0,7,-7,9,1
205623,2,7,6,1,7,0
50135,3,0,17,-17,6,1
237199,2,3,0,3,3,1
420572,1,0,7,-7,17,0
39540,2,0,3,-3,1,0
338346,2,3,0,3,14,0
18576,2,10,10,0,9,0
288437,4,19,7,12,9,1
28856,3,23,7,16,14,0
308481,1,0,0,0,1,0
300877,2,3,7,-4,15,1
358184,4,20,17,3,6,1
361414,4,17,21,-4,7,1
35350,3,23,6,17,16,0
165917,1,0,7,-7,6,0
35020,2,9,0,9,16,0
349687,2,14,7,7,2,0
39419,2,3,10,-7,1,1
47056,3,17,7,10,5,0
399242,4,13,20,-7,7,1
218665,4,10,33,-23,13,1
35336,3,16,0,16,16,1
73068,3,7,10,-3,16,1
270490,1,0,0,0,1,0
175189,4,49,17,32,10,1
290883,4,24,24,0,10,1
176258,1,0,0,0,11,1
351135,5,37,37,0,3,0
64326,3,6,13,-7,13,0
108021,1,3,0,3,15,1
200448,3,13,18,-5,4,0
121384,3,7,3,4,3,0
213130,4,20,6,14,10,1
338631,1,6,0,6,14,1
265581,1,0,8,-8,16,1
188001,3,20,14,6,16,1
152397,3,28,3,25,17,1
212983,4,21,7,14,10,1
156081,4,20,24,-4,2,1
159042,1,7,0,7,3,1
300410,1,2,0,2,14,1
53127,3,19,37,-18,7,0
77028,1,7,7,0,1,0
343355,3,0,20,-20,16,1
407695,1,0,0,0,11,0
163343,4,22,23,-1,5,0
396377,2,20,9,11,6,0
372451,2,6,14,-8,13,1
133421,1,7,7,0,9,1
35836,4,10,17,-7,17,0
340597,1,6,0,6,15,0
259055,4,3,16,-13,13,1
238340,2,3,16,-13,4,1
65123,2,0,0,0,13,0
186217,4,29,13,16,15,0
42592,1,0,0,0,3,0
16590,1,0,7,-7,8,1
737,1,0,0,0,1,1
392866,4,17,23,-6,4,0
389168,1,7,0,7,3,0
34829,1,6,0,6,16,1
249018,1,7,0,7,9,0
278370,4,17,21,-4,4,1
188451,4,3,6,-3,16,0
220386,2,16,7,9,13,1
3005,3,13,31,-18,2,0
62453,3,7,13,-6,12,0
233926,4,17,13,4,2,1
191541,3,14,21,-7,17,1
374304,3,14,13,1,13,0
400420,4,24,10,14,8,1
7004,4,13,7,6,3,1
151647,3,23,20,3,17,1
152087,3,6,10,-4,17,1
389272,4,34,7,27,3,0
235903,3,7,14,-7,3,1
100927,2,7,3,4,12,1
154096,1,0,0,0,1,0
77672,3,7,17,-10,1,1
140450,2,14,7,7,12,0
67911,3,19,3,16,14,1
54767,2,10,0,10,8,0
406468,1,0,3,-3,11,0
173623,3,7,19,-12,10,0
202743,3,13,17,-4,5,1
204331,4,0,17,-17,6,1
284556,1,7,0,7,7,0
27576,1,7,0,7,13,0
345757,4,16,7,9,17,0
137639,5,37,37,0,11,1
409535,3,7,3,4,12,1
264033,1,7,0,7,15,0
379101,4,7,12,-5,15,0
382565,4,0,17,-17,17,1
327693,2,3,10,-7,10,0
79742,2,17,7,10,2,0
373437,4,17,17,0,13,0
245166,4,17,28,-11,7,0
253978,1,0,0,0,11,1
265844,5,26,19,7,16,1
166469,3,17,17,0,6,1
337362,3,14,7,7,14,1
180704,1,0,0,0,13,0
82720,1,0,3,-3,3,1
421503,2,3,3,0,17,0
110740,2,3,3,0,16,0
227289,2,10,20,-10,16,1
10233,4,6,10,-4,5,0
332477,3,23,6,17,12,0
314217,3,14,20,-6,3,0
111894,1,0,0,0,17,0
68805,2,6,7,-1,15,0
311770,2,7,13,-6,2,1
279163,4,24,23,1,5,1
226893,3,3,10,-7,16,1
393640,1,0,0,0,5,1
229712,2,13,10,3,17,0
35386,4,30,23,7,16,0
397492,4,13,19,-6,6,0
371762,3,14,14,0,12,1
149110,3,17,17,0,16,1
169129,1,0,0,0,7,1
101250,3,7,7,0,12,0
217604,3,6,9,-3,12,1
272637,1,0,0,0,2,0
348009,1,0,0,0,1,1
171932,3,7,7,0,9,1
347615,2,14,10,4,1,1
208703,1,0,0,0,8,0
240306,3,7,10,-3,5,0
141555,4,34,10,24,13,0
91931,2,3,3,0,8,0
176142,2,14,7,7,11,0
18417,2,0,7,-7,9,1
297248,3,21,6,15,13,0
10397,4,10,38,-28,5,0
414744,4,10,17,-7,14,0
216115,4,24,26,-2,11,0
350642,4,13,3,10,2,1
228330,2,0,7,-7,17,0
2365,1,6,3,3,2,1
421627,1,3,0,3,17,1
284309,2,3,10,-7,7,1
318536,1,0,0,0,5,1
140762,3,15,21,-6,12,1
406637,2,0,0,0,11,1
412495,3,23,7,16,14,1
163904,2,16,10,6,5,1
268226,4,12,28,-16,17,1
115500,1,0,0,0,1,1
210534,1,0,0,0,9,1
314214,3,14,20,-6,3,0
122008,3,16,10,6,4,1
156158,2,7,7,0,2,1
12259,3,3,3,0,6,0
18966,1,0,0,0,10,0
55870,4,13,14,-1,9,1
295179,4,13,21,-8,12,1
373114,4,10,21,-11,13,0
346378,3,9,13,-4,1,0
288121,3,16,7,9,9,0
278360,3,17,14,3,4,0
408722,1,3,7,-4,12,1
7529,1,0,0,0,4,1
281193,3,24,13,11,6,0
177807,1,0,3,-3,12,1
409933,1,0,14,-14,12,1
46516,4,37,6,31,4,1
257362,2,17,0,17,13,0
261886,4,6,20,-14,14,0
8747,2,0,0,0,4,1
247863,2,10,3,7,8,0
25337,4,42,14,28,12,1
242550,1,0,0,0,6,0
169172,2,3,6,-3,7,1
124709,2,3,3,0,5,0
115857,2,7,10,-3,1,0
85304,2,13,3,10,5,1
68790,2,6,0,6,15,0
400833,3,24,13,11,8,0
376819,2,14,7,7,15,1
391600,4,10,24,-14,4,0
120907,4,21,31,-10,3,1
350715,2,7,0,7,2,0
318707,2,10,20,-10,5,0
173304,2,14,17,-3,10,0
361990,4,20,12,8,7,1
39318,4,17,27,-10,1,1
357847,2,6,24,-18,6,0
237988,2,3,10,-7,4,1
274843,2,0,7,-7,3,0
104745,2,17,13,4,14,0
386405,4,20,15,5,2,0
281971,3,14,14,0,6,1
325200,3,13,23,-10,8,1
358892,3,6,28,-22,6,0
404850,4,23,27,-4,10,0
91248,1,0,0,0,8,1
14375,4,9,17,-8,7,0
389027,1,13,0,13,3,1
325333,3,12,13,-1,8,0
312454,1,0,0,0,3,1
88132,1,0,3,-3,6,1
225145,1,0,0,0,15,1
180269,1,3,0,3,13,1
305527,2,6,0,6,17,1
367436,3,20,20,0,10,0
206261,3,7,6,1,7,1
275115,1,7,3,4,3,1
7180,4,48,24,24,4,0
84740,3,10,17,-7,4,0
234921,1,10,0,10,2,0
11337,1,14,0,14,6,0
196240,2,14,10,4,2,1
198602,2,0,0,0,3,1
358867,2,3,21,-18,6,1
78013,3,9,16,-7,1,1
256896,2,14,10,4,12,0
114298,1,0,6,-6,1,1
102698,4,32,31,1,13,1
280795,1,0,0,0,6,1
343885,4,26,6,20,17,0
229595,3,30,13,17,17,1
135869,4,21,17,4,10,0
273234,4,40,7,33,2,1
412326,2,7,14,-7,13,1
337426,1,0,0,0,14,1
202544,1,7,6,1,5,1
89328,1,0,6,-6,7,1
359845,1,10,7,3,6,1
303951,4,14,34,-20,16,0
81154,4,16,14,2,3,0
341881,4,23,15,8,16,1
33226,2,10,0,10,16,1
15605,2,14,10,4,8,1
59092,4,3,23,-20,10,1
19801,4,12,18,-6,10,1
396897,4,27,20,7,6,1
11205,2,7,14,-7,6,1
25610,4,30,10,20,12,1
185258,3,24,9,15,15,0
374771,4,16,39,-23,14,1
189517,4,20,0,20,17,0
365143,3,7,21,-14,9,0
197828,1,6,0,6,3,1
202235,1,3,0,3,5,0
272189,1,0,0,0,2,1
5249,3,21,24,-3,3,1
307787,2,17,7,10,1,0
69107,2,7,7,0,15,1
339978,1,7,3,4,15,1
131939,1,0,0,0,8,0
232994,3,10,10,0,2,1
355889,3,13,10,3,5,1
269003,1,0,3,-3,17,1
230201,4,3,32,-29,17,0
216188,2,14,3,11,12,0
241875,3,13,12,1,5,0
244568,4,25,16,9,7,0
167756,4,26,23,3,7,0
31344,3,7,3,4,15,0
139145,3,12,6,6,12,1
95377,1,14,0,14,10,0
90274,2,0,7,-7,7,1
421259,3,16,7,9,17,0
88460,2,7,7,0,6,1
144887,3,14,7,7,14,1
282748,1,0,0,0,6,1
244847,3,7,10,-3,7,0
330877,3,13,24,-11,11,1
306916,3,6,23,-17,17,0
135328,1,7,10,-3,10,0
178908,1,0,3,-3,12,1
407790,4,10,7,3,11,1
136177,4,13,10,3,10,1
205009,2,9,7,2,6,0
370709,1,3,7,-4,12,1
228279,4,17,43,-26,17,1
106494,4,29,9,20,14,1
407025,4,11,34,-23,11,0
322299,1,7,0,7,7,0
316182,4,30,32,-2,4,0
337367,3,14,7,7,14,1
308891,4,17,20,-3,1,0
150071,4,31,12,19,16,0
306535,4,24,20,4,17,0
187329,1,7,7,0,16,1
292532,4,16,19,-3,11,1
312977,2,0,0,0,3,1
294871,4,49,21,28,12,1
209790,4,23,6,17,8,0
292680,4,22,16,6,11,0
149152,4,17,31,-14,16,0
120487,4,39,27,12,3,0
313012,3,10,0,10,3,1
141239,3,10,24,-14,13,0
43037,2,3,0,3,3,0
333663,2,7,0,7,12,1
251169,1,7,7,0,10,1
61926,1,0,0,0,12,0
332626,3,27,12,15,12,0
13749,2,0,17,-17,7,0
281075,4,38,16,22,6,0
392391,4,20,38,-18,4,1
282896,5,23,23,0,6,1
132436,3,0,21,-21,9,1
208321,2,7,24,-17,8,1
356480,2,0,3,-3,5,0
87725,3,6,20,-14,6,0
417469,2,10,14,-4,16,0
178083,5,23,23,0,12,1
77489,1,0,7,-7,1,1
40999,1,3,7,-4,2,0
316788,3,13,7,6,4,1
37005,1,0,0,0,17,1
20166,2,10,0,10,10,0
303292,2,20,0,20,16,0
357812,2,3,14,-11,6,0
1405,3,10,0,10,1,0
294509,2,17,10,7,12,1
410136,3,17,10,7,13,1
35289,2,6,0,6,16,0
332164,2,0,10,-10,12,1
407737,3,10,0,10,11,0
143019,1,0,0,0,13,1
272104,3,17,6,11,2,0
399156,1,0,3,-3,7,1
370205,4,31,10,21,12,0
114096,3,21,7,14,17,0
285242,2,0,6,-6,7,1
91378,4,21,7,14,8,0
270143,4,24,13,11,1,1
82754,2,6,6,0,3,0
321054,4,16,14,2,6,0
68750,1,0,0,0,15,1
200289,3,17,14,3,4,1
180653,3,24,6,18,13,0
75995,1,7,13,-6,1,1
162571,4,38,17,21,4,0
281849,3,13,0,13,6,0
122724,3,7,17,-10,4,0
25315,4,37,14,23,12,0
83736,4,22,23,-1,4,0
328294,2,3,7,-4,10,0
71698,1,3,0,3,16,1
261390,3,10,17,-7,14,1
51665,4,27,20,7,7,1
232467,2,10,0,10,1,0
732,4,6,24,-18,1,0
406039,1,0,10,-10,11,1
177703,2,13,14,-1,12,1
182562,1,0,0,0,14,0
103579,4,33,7,26,13,1
109190,4,34,14,20,15,0
128570,4,28,35,-7,7,0
328566,1,7,7,0,10,1
186044,3,24,34,-10,15,1
354540,4,33,31,2,4,1
251425,4,46,14,32,10,0
147204,1,0,7,-7,15,0
413520,1,0,3,-3,14,0
344474,1,0,0,0,17,1
213071,3,17,3,14,10,1
177838,2,14,10,4,12,1
192061,4,31,34,-3,1,1
60402,3,20,7,13,11,0
253602,4,9,10,-1,11,0
175018,4,13,28,-15,10,1
319060,4,20,32,-12,5,1
409668,2,10,3,7,12,1
192633,2,9,7,2,1,1
9489,3,10,3,7,5,1
178013,3,7,20,-13,12,1
84569,2,7,7,0,4,1
328361,4,3,37,-34,10,0
158962,3,14,22,-8,3,1
256892,2,14,10,4,12,0
177898,4,21,23,-2,12,0
32893,4,19,7,12,15,1
379178,3,9,10,-1,16,1
49650,2,7,7,0,6,0
273231,4,40,7,33,2,1
88564,1,0,0,0,6,1
214032,4,43,7,36,10,0
73904,1,14,0,14,17,0
353948,4,31,31,0,4,0
103906,1,0,0,0,13,1
53451,4,10,28,-18,8,0
231155,2,10,0,10,1,0
345115,3,12,3,9,17,1
38598,4,38,13,25,1,1
292806,4,29,17,12,11,0
27517,3,23,9,14,13,0
269671,3,10,3,7,1,0
106756,3,17,15,2,14,0
188465,4,3,9,-6,16,1
15748,2,0,5,-5,8,1
29013,3,13,7,6,14,1
108447,4,13,28,-15,15,0
289099,1,3,0,3,9,0
306646,4,14,27,-13,17,1
368222,1,0,0,0,11,0
366788,1,0,0,0,10,1
51645,3,27,20,7,7,1
226270,2,16,0,16,16,0
88299,2,14,7,7,6,1
9372,4,31,7,24,5,0
379921,3,21,6,15,16,0
15883,1,0,7,-7,8,1
239151,3,13,13,0,4,0
179593,3,14,23,-9,12,1
306581,2,0,17,-17,17,0
261385,3,10,17,-7,14,0
211017,2,17,0,17,9,0
329908,2,7,10,-3,11,0
152257,3,21,0,21,17,0
381844,3,10,21,-11,17,1
215801,3,38,6,32,11,0
1164,4,10,36,-26,1,0
401940,1,0,3,-3,9,1
218878,2,21,3,18,13,0
128162,1,7,0,7,7,0
82309,2,3,10,-7,3,1
160046,3,13,26,-13,3,0
337325,2,14,7,7,14,0
413382,2,0,14,-14,14,0
289089,1,0,0,0,9,0
321192,4,3,19,-16,6,0
370652,4,21,14,7,12,1
307158,2,0,10,-10,17,1
145148,2,29,0,29,14,0
333797,2,14,14,0,12,0
129413,3,16,13,3,7,1
229876,3,13,14,-1,17,1
2946,1,7,10,-3,2,0
263093,4,10,13,-3,15,1
18645,4,20,24,-4,9,0
220396,2,16,7,9,13,0
48432,3,17,17,0,5,1
60199,2,3,7,-4,11,0
319396,4,23,28,-5,6,0
418272,2,6,0,6,16,0
158174,2,7,0,7,3,1
228116,4,13,10,3,17,1
87064,1,0,0,0,5,0
17652,2,7,3,4,9,1
153027,4,49,27,22,1,0
393188,1,0,6,-6,5,1
77841,3,14,21,-7,1,1
120835,2,7,14,-7,3,0
195243,3,16,17,-1,2,1
351691,3,7,17,-10,3,1
45154,2,7,7,0,4,0
252883,1,3,0,3,11,0
421847,3,0,13,-13,17,1
13293,2,0,20,-20,7,0
315885,4,9,26,-17,4,1
142238,1,0,0,0,13,0
344198,1,0,3,-3,17,1
344338,1,7,0,7,17,1
113572,2,0,0,0,17,1
239056,1,0,0,0,4,1
138822,3,3,33,-30,12,0
355857,2,13,10,3,5,1
269657,2,10,0,10,1,0
35624,2,7,3,4,17,1
217400,1,0,0,0,12,1
390404,3,7,27,-20,3,1
127972,4,23,20,3,6,1
302974,3,20,13,7,16,0
111667,2,21,10,11,16,0
1029,1,7,0,7,1,0
212205,4,3,24,-21,10,0
30629,4,17,9,8,14,0
298204,2,7,3,4,14,0
346141,1,0,0,0,1,1
55304,4,20,10,10,9,1
274110,3,20,0,20,3,0
105242,3,7,24,-17,14,1
201542,4,32,14,18,5,0
308670,1,0,6,-6,1,1
243851,1,3,0,3,6,1
182042,3,17,14,3,13,0
345921,3,17,23,-6,17,1
177422,3,17,10,7,11,1
370801,4,26,17,9,12,0
207576,2,14,3,11,7,1
180249,1,0,0,0,13,1
150477,3,27,6,21,16,1
176354,3,16,21,-5,11,0
270069,2,10,10,0,1,0
16452,1,3,0,3,8,1
410743,3,17,6,11,13,1
76520,3,7,20,-13,1,0
202751,3,13,17,-4,5,1
400143,4,27,23,4,8,1
327753,4,13,16,-3,10,0
220570,3,10,23,-13,13,0
292335,3,12,13,-1,11,0
384289,2,6,0,6,1,1
397596,3,6,20,-14,7,0
26343,4,19,21,-2,13,0
280179,4,28,0,28,5,0
407129,3,7,20,-13,11,1
188756,3,0,20,-20,16,1
388661,4,17,7,10,3,1
202543,1,7,6,1,5,0
113100,1,0,0,0,17,1
175130,3,28,10,18,10,0
82750,2,6,6,0,3,0
358555,2,10,3,7,6,1
420883,4,17,34,-17,17,1
181406,3,17,17,0,13,1
52045,3,10,10,0,7,0
60969,2,21,6,15,11,0
270592,4,13,14,-1,1,1
132575,3,11,29,-18,9,1
378904,3,13,20,-7,15,0
379731,2,9,0,9,16,0
374716,2,0,33,-33,14,0
265251,4,9,6,3,16,0
108325,1,0,7,-7,15,1
180023,3,14,20,-6,13,0
201855,4,26,30,-4,5,0
249380,3,10,15,-5,9,0
178965,3,12,3,9,12,0
352345,1,7,0,7,3,1
202594,3,21,13,8,5,1
113113,1,7,0,7,17,1
13380,4,7,34,-27,7,0
108662,2,27,0,27,15,0
257715,3,3,17,-14,13,0
204619,3,3,38,-35,6,1
19,1,0,0,0,1,0
410748,3,17,6,11,13,1
294065,2,7,21,-14,12,0
386115,4,24,9,15,1,0
341281,4,23,16,7,16,1
273993,4,13,29,-16,2,0
348654,1,3,3,0,2,1
81672,2,7,14,-7,3,1
245638,4,43,20,23,7,0
113303,3,16,24,-8,17,1
164059,2,3,6,-3,5,0
224735,2,5,0,5,15,0
375355,3,14,17,-3,14,0
189495,3,17,0,17,17,0
314157,1,7,7,0,3,0
338219,2,14,21,-7,14,0
414298,4,21,42,-21,14,1
165658,2,0,7,-7,6,0
26050,4,13,19,-6,13,0
267371,2,0,7,-7,17,1
115068,1,3,0,3,1,1
104451,2,0,10,-10,13,1
386056,2,14,0,14,1,0
118167,4,31,27,4,2,0
287716,5,16,16,0,9,0
73269,4,14,23,-9,16,1
185853,2,3,3,0,15,1
34160,4,10,10,0,16,1
10767,2,7,0,7,5,1
280855,3,10,3,7,6,0
219352,3,16,13,3,13,1
85306,2,14,3,11,5,0
55340,5,20,23,-3,9,0
281088,4,45,16,29,6,0
97765,1,0,0,0,11,1
140917,3,17,13,4,13,1
285877,1,6,0,6,8,0
101517,2,10,7,3,12,0
15154,1,0,0,0,8,1
165057,3,10,17,-7,6,1
375041,4,28,27,1,14,0
182453,2,7,0,7,14,1
72575,4,19,31,-12,16,1
311985,4,35,17,18,2,1
408965,3,31,18,13,12,0
115456,4,39,14,25,1,0
141862,3,24,14,10,13,0
179302,4,33,9,24,12,0
48477,4,27,34,-7,5,1
413227,2,7,0,7,14,1
158156,1,7,0,7,3,0
249718,3,21,20,1,9,0
143121,4,24,27,-3,13,1
13634,4,13,10,3,7,1
409220,2,10,3,7,12,1
176265,1,0,0,0,11,0
53753,4,10,3,7,8,0
351692,3,13,17,-4,3,1
111145,4,31,10,21,16,0
61408,3,13,3,10,11,1
295590,4,23,32,-9,12,1
141646,2,17,14,3,13,1
88799,3,13,13,0,6,0
362548,4,26,12,14,8,0
348,2,14,10,4,1,0
116144,2,7,3,4,1,0
63540,1,7,0,7,12,0
180517,3,21,20,1,13,1
304330,2,10,7,3,16,1
241298,4,10,7,3,5,1
367299,3,3,17,-14,10,0
31895,2,6,7,-1,15,0
279233,2,13,13,0,5,1
390224,2,0,6,-6,3,1
270132,3,24,10,14,1,0
131447,4,20,19,1,8,0
64293,2,6,10,-4,13,1
235747,4,10,27,-17,3,1
339066,1,0,0,0,15,0
192072,5,34,34,0,1,1
390114,3,17,21,-4,3,1
53723,3,7,0,7,8,0
397058,4,21,9,12,6,0
215450,2,7,3,4,11,1
370071,4,31,20,11,12,0
304350,3,20,7,13,16,0
23502,3,14,14,0,11,0
219911,1,3,0,3,13,1
252558,4,29,39,-10,10,1
345844,2,0,7,-7,17,0
268531,1,7,0,7,17,0
4889,2,14,6,8,3,0
160646,2,7,0,7,4,1
77926,1,3,0,3,1,0
390546,3,17,7,10,3,1
101803,5,13,13,0,12,1
114614,2,3,3,0,1,1
130218,3,3,26,-23,8,1
229729,3,13,17,-4,17,0
166017,3,17,21,-4,6,1
118859,3,27,7,20,2,1
220976,2,14,7,7,14,0
283268,2,10,9,1,7,1
165677,3,7,7,0,6,0
249062,2,21,17,4,9,1
106694,1,0,2,-2,14,0
354783,2,13,17,-4,4,1
348287,4,16,46,-30,1,0
351536,3,0,27,-27,3,0
158461,1,0,7,-7,3,1
309208,1,0,0,0,1,1
325381,4,15,20,-5,8,1
63819,4,14,34,-20,12,1
150915,3,7,7,0,17,1
260606,1,0,7,-7,14,0
375095,1,0,0,0,14,1
366043,3,37,14,23,10,1
367943,1,0,7,-7,11,1
201750,1,3,0,3,5,0
229164,4,19,7,12,17,1
416772,2,7,10,-3,15,1
409414,3,33,3,30,12,0
72284,4,27,33,-6,16,1
83816,2,10,3,7,4,1
214566,2,3,3,0,11,1
161578,2,23,10,13,4,0
406342,2,7,7,0,11,1
31855,1,0,0,0,15,1
54507,3,7,7,0,8,0
169037,3,26,14,12,7,0
387096,2,10,21,-11,2,0
45800,4,13,14,-1,4,1
272718,3,12,3,9,2,0
135715,4,17,29,-12,10,1
387964,1,3,0,3,2,0
30397,1,0,13,-13,14,1
63290,2,3,0,3,12,1
404887,1,0,3,-3,10,1
170359,1,6,0,6,8,1
165064,3,10,17,-7,6,0
70034,4,31,10,21,15,0
399251,4,13,20,-7,7,0
252927,2,6,0,6,11,1
213847,3,45,7,38,10,1
318001,3,10,13,-3,5,1
390176,1,0,0,0,3,0
5378,2,13,7,6,3,1
8913,3,21,0,21,4,0
105275,4,10,24,-14,14,0
342333,4,23,6,17,16,0
6899,1,0,0,0,3,1
50231,1,7,7,0,6,0
255049,2,3,18,-15,12,0
326394,4,20,10,10,9,1
337241,4,16,23,-7,14,1
86713,3,17,14,3,5,1
117170,2,13,3,10,2,0
295670,2,0,0,0,12,1
287129,1,7,3,4,8,1
189391,4,27,24,3,16,0
258755,4,3,34,-31,13,0
300247,1,0,0,0,14,0
233444,3,17,10,7,2,1
66039,2,7,0,7,13,0
17543,3,13,3,10,9,0
414738,3,3,17,-14,14,1
10736,1,7,0,7,5,0
29454,3,7,14,-7,14,1
190074,2,17,3,14,17,1
401872,3,14,28,-14,9,0
10124,4,44,7,37,5,1
61323,4,31,28,3,11,0
191723,3,16,17,-1,17,0
357459,4,31,33,-2,5,1
134257,4,9,23,-14,10,1
316316,4,16,19,-3,4,1
135767,1,0,7,-7,10,1
363032,4,33,32,1,8,0
42209,2,17,0,17,2,0
221781,4,13,20,-7,14,0
304153,1,0,0,0,16,1
166497,4,23,17,6,6,0
165109,4,10,24,-14,6,1
355820,1,6,0,6,5,1
378388,1,7,0,7,15,0
375757,2,13,0,13,14,0
200296,3,24,14,10,4,0
326646,3,16,6,10,9,1
156150,2,7,7,0,2,1
112802,4,34,10,24,17,0
285443,3,33,8,25,8,1
45254,1,0,0,0,4,1
357114,3,6,14,-8,5,1
410786,4,22,6,16,13,0
82364,4,13,10,3,3,0
370686,1,0,0,0,12,0
223590,4,24,13,11,15,1
119490,4,14,17,-3,3,0
159314,4,27,24,3,3,1
273538,4,21,28,-7,2,0
291753,3,3,14,-11,11,0
11709,3,20,10,10,6,0
155968,1,3,14,-11,2,1
204830,1,3,0,3,6,1
238101,5,13,13,0,4,1
47653,2,3,17,-14,5,0
411026,2,17,14,3,13,0
386107,4,21,9,12,1,0
151151,2,3,10,-7,17,0
89277,4,15,0,15,7,0
85723,4,24,28,-4,5,0
357804,2,3,14,-11,6,1
376279,4,16,14,2,14,1
325195,3,13,20,-7,8,0
420559,4,10,42,-32,17,0
410945,4,14,29,-15,13,1
145672,4,35,7,28,14,1
42841,4,6,37,-31,3,0
391920,4,23,27,-4,4,0
272463,4,31,24,7,2,0
12180,1,0,0,0,6,0
408635,3,28,3,25,12,0
249656,1,3,7,-4,9,0
214391,2,0,7,-7,11,1
37454,1,0,7,-7,17,0
375164,3,17,10,7,14,1
358494,4,41,33,8,6,0
324779,4,26,14,12,8,0
377278,3,14,6,8,15,1
292662,4,22,16,6,11,0
255966,3,6,12,-6,12,1
209660,1,6,0,6,8,0
182128,2,16,0,16,13,0
210056,4,17,17,0,8,0
418600,3,14,16,-2,16,0
131315,1,0,0,0,8,0
91166,2,3,14,-11,8,1
91509,3,19,3,16,8,1
389173,1,7,0,7,3,1
200365,1,0,0,0,4,0
211241,4,21,26,-5,9,1
289694,1,0,0,0,10,1
403181,3,17,14,3,9,1
339249,2,21,0,21,15,0
383082,2,20,7,13,17,1
354153,1,0,0,0,4,0
273402,1,0,0,0,2,0
80393,4,27,16,11,2,1
210634,3,13,17,-4,9,1
293623,2,7,7,0,12,1
258179,4,13,13,0,13,0
294281,4,28,21,7,12,1
312122,4,33,10,23,2,0
178729,4,11,26,-15,12,1
273793,3,10,7,3,2,0
39700,2,3,0,3,1,0
360254,1,0,3,-3,7,0
313582,2,12,20,-8,3,1
383457,1,0,0,0,17,0
149516,2,14,6,8,16,0
152277,4,28,0,28,17,0
358503,1,0,0,0,6,1
212449,2,10,0,10,10,0
258845,2,13,7,6,13,1
255928,2,6,3,3,12,0
67177,2,0,0,0,14,1
113971,4,20,20,0,17,0
218394,1,3,7,-4,13,0
209059,2,3,10,-7,8,1
169247,4,17,6,11,7,1
141322,1,0,7,-7,13,1
353138,3,13,29,-16,3,0
384600,3,10,49,-39,1,1
259098,1,0,0,0,13,0
409570,4,35,11,24,12,0
202706,2,3,10,-7,5,1
335717,2,10,7,3,13,0
190708,4,42,17,25,17,0
397299,3,0,21,-21,6,0
74177,1,3,0,3,17,1
304700,4,21,7,14,16,0
143751,1,3,0,3,14,1
323750,1,6,0,6,8,0
345447,4,3,19,-16,17,0
41949,3,24,6,18,2,1
322551,1,0,0,0,7,0
60407,3,20,7,13,11,1
167308,2,16,10,6,7,0
120705,2,10,0,10,3,1
44116,2,3,13,-10,3,0
187843,3,7,13,-6,16,1
103322,1,7,10,-3,13,1
329664,3,22,14,8,11,1
241429,3,7,35,-28,5,1
51215,4,32,25,7,7,0
112949,1,0,0,0,17,0
399048,2,10,12,-2,7,1
265175,1,0,3,-3,16,0
79594,2,14,7,7,2,1
88818,4,13,13,0,6,0
408860,4,16,35,-19,12,1
236872,1,6,0,6,3,0
406067,2,0,13,-13,11,0
418628,3,21,31,-10,16,1
13495,4,6,27,-21,7,1
243022,1,0,0,0,6,0
389378,3,23,13,10,3,1
343974,3,16,6,10,17,0
173928,3,13,16,-3,10,0
714,4,6,24,-18,1,1
293287,4,26,7,19,11,0
378597,3,17,13,4,15,1
212443,2,10,0,10,10,1
157162,4,19,20,-1,2,0
363377,2,13,10,3,8,1
193758,4,10,27,-17,1,0
115596,4,30,9,21,1,1
229546,2,17,6,11,17,1
123079,4,14,21,-7,4,1
82398,4,13,10,3,3,0
388493,3,3,16,-13,2,1
157223,2,7,0,7,2,0
237950,1,0,0,0,4,1
274336,1,3,6,-3,3,0
165784,1,3,0,3,6,0
95987,2,0,0,0,10,0
91439,2,3,0,3,8,0
182072,4,17,21,-4,13,0
69083,1,0,0,0,15,0
173722,1,0,3,-3,10,1
107233,4,14,31,-17,15,1
34228,1,10,3,7,16,0
43694,3,14,10,4,3,1
223016,4,13,23,-10,14,0
169000,2,10,14,-4,7,1
162677,3,16,17,-1,5,0
181425,3,17,24,-7,13,0
14273,2,0,7,-7,7,1
195151,1,0,0,0,2,0
61822,2,3,17,-14,12,0
409767,1,0,0,0,12,0
290882,4,24,24,0,10,0
200146,3,7,24,-17,4,0
353521,2,3,0,3,4,1
25971,2,10,6,4,13,0
268328,3,20,3,17,17,1
245755,3,16,17,-1,7,1
196727,3,47,0,47,3,1
369206,4,22,20,2,11,0
420456,2,0,21,-21,17,1
207093,1,0,0,0,7,1
304118,4,16,30,-14,16,0
404332,3,13,6,7,10,1
276830,3,20,20,0,4,1
397698,1,6,0,6,7,0
242015,3,7,3,4,5,1
154138,2,0,6,-6,1,1
371380,1,0,0,0,12,0
418467,3,17,3,14,16,0
221684,1,3,0,3,14,1
193537,2,0,0,0,1,0
357043,1,6,7,-1,5,0
269859,4,22,10,12,1,1
63377,4,17,3,14,12,0
186535,4,24,33,-9,15,1
220197,1,7,0,7,13,1
31357,3,7,3,4,15,0
154817,4,24,23,1,1,0
322164,2,0,14,-14,7,0
256448,3,12,21,-9,12,0
150054,4,31,6,25,16,0
168557,2,7,10,-3,7,0
23100,4,10,17,-7,11,1
185032,1,0,0,0,15,0
75517,4,37,7,30,17,0
126091,3,20,3,17,6,1
155169,1,7,0,7,1,0
205430,1,0,0,0,6,1
224399,1,0,0,0,15,0
367801,1,3,7,-4,10,1
124603,4,13,17,-4,5,0
5325,1,7,0,7,3,1
347561,1,0,0,0,1,1
101406,3,15,7,8,12,0
371063,3,13,13,0,12,0
92379,2,10,0,10,8,0
115079,1,3,7,-4,1,1
201478,2,12,7,5,5,1
165877,4,6,19,-13,6,0
108457,1,0,0,0,15,1
259508,4,35,10,25,13,1
390274,3,10,13,-3,3,1
396178,4,24,31,-7,6,1
90208,4,6,3,3,7,1
51176,3,24,3,21,7,0
142553,1,0,0,0,13,0
162466,1,7,3,4,4,1
271307,3,6,24,-18,1,1
207043,3,35,3,32,7,1
408297,2,0,0,0,12,0
306003,2,3,10,-7,17,0
48878,3,9,0,9,5,0
310833,4,27,13,14,2,0
163086,1,6,12,-6,5,1
176825,3,10,10,0,11,0
84472,3,13,10,3,4,0
86608,4,40,3,37,5,0
378626,4,23,20,3,15,0
390828,2,0,21,-21,3,0
252080,1,0,0,0,10,0
131785,1,0,0,0,8,0
349390,1,0,0,0,2,1
224471,3,9,10,-1,15,1
303950,4,14,31,-17,16,0
392401,4,27,45,-18,4,1
348500,2,21,0,21,2,0
113331,4,19,31,-12,17,0
257997,3,0,21,-21,13,0
158266,4,38,0,38,3,0
52836,3,7,37,-30,7,1
376071,2,0,3,-3,14,1
195082,3,7,26,-19,2,1
220351,1,3,0,3,13,1
270990,2,3,14,-11,1,0
188192,4,24,13,11,16,0
316606,3,9,9,0,4,0
37935,3,10,14,-4,1,1
318403,2,21,7,14,5,1
62623,3,9,17,-8,12,0
168357,4,24,24,0,7,0
256253,2,6,7,-1,12,0
13137,2,10,10,0,6,0
185307,4,41,22,19,15,0
341748,4,29,13,16,16,1
417851,3,10,10,0,16,0
216221,3,17,10,7,12,1
23259,1,0,0,0,11,0
70246,1,0,0,0,15,1
70668,4,17,22,-5,15,1
413583,3,9,17,-8,14,1
307004,2,7,0,7,17,1
95882,4,13,23,-10,10,1
231320,2,9,10,-1,1,1
183002,4,10,44,-34,14,0
342270,3,13,0,13,16,0
25424,3,6,3,3,12,0
417668,3,21,6,15,16,1
271335,4,16,24,-8,1,0
387380,2,21,7,14,2,1
254071,4,14,23,-9,11,0
32176,1,7,7,0,15,1
17989,3,16,21,-5,9,1
150021,3,20,6,14,16,1
186223,4,29,13,16,15,0
337259,4,16,23,-7,14,0
170346,4,0,15,-15,8,0
387602,4,13,3,10,2,0
8291,1,0,0,0,4,1
373584,4,23,33,-10,13,1
419818,1,0,0,0,17,0
343131,1,0,0,0,16,1
38258,4,13,14,-1,1,1
204052,1,0,0,0,6,0
186079,4,31,55,-24,15,0
136864,1,0,7,-7,11,1
293776,2,10,3,7,12,0
132900,4,6,21,-15,9,0
236084,4,44,10,34,3,1
207155,2,7,10,-3,7,1
209767,4,16,6,10,8,1
401869,3,14,28,-14,9,1
35834,4,10,17,-7,17,0
177432,3,17,10,7,11,1
38272,4,13,14,-1,1,0
287493,3,14,20,-6,9,0
226212,1,3,0,3,16,0
111702,4,31,13,18,16,0
216084,3,24,12,12,11,0
311179,1,3,0,3,2,1
349637,4,13,31,-18,2,0
344332,1,7,0,7,17,1
347255,2,0,0,0,1,0
385225,1,0,3,-3,1,1
309721,3,19,6,13,1,1
13954,4,24,21,3,7,1
275979,4,26,21,5,3,1
421648,2,3,7,-4,17,1
150942,4,13,13,0,17,0
69298,3,16,3,13,15,1
310816,4,20,13,7,2,0
30004,2,20,0,20,14,0
27340,2,21,10,11,13,1
299953,1,0,7,-7,14,1
362140,4,42,23,19,8,1
18458,3,7,7,0,9,1
378571,2,17,13,4,15,0
370040,3,17,13,4,12,0
29372,1,0,0,0,14,0
191885,4,29,10,19,1,0
345294,4,19,17,2,17,0
193189,1,0,0,0,1,0
197820,1,6,0,6,3,1
200460,3,20,18,2,4,0
59731,1,6,7,-1,11,0
195688,3,14,10,4,2,0
75798,4,42,26,16,1,1
47565,4,37,6,31,5,1
83588,4,0,17,-17,4,1
83995,2,17,3,14,4,0
337334,2,14,7,7,14,1
9322,2,21,7,14,5,0
192933,2,7,17,-10,1,1
285647,4,27,24,3,8,0
135959,2,0,3,-3,10,1
245708,2,9,10,-1,7,1
378382,1,7,0,7,15,0
7364,5,20,19,1,4,0
287065,4,26,24,2,8,1
190665,2,28,14,14,17,0
84244,1,0,7,-7,4,0
42712,4,7,20,-13,3,1
172754,4,21,16,5,9,0
35510,3,27,7,20,17,1
45623,3,13,13,0,4,1
416952,4,10,10,0,15,1
19804,4,12,18,-6,10,0
87973,1,3,0,3,6,0
340283,1,3,0,3,15,0
34110,2,3,0,3,16,0
401728,3,17,14,3,8,0
411013,2,14,14,0,13,1
124043,1,0,0,0,5,0
201991,3,10,7,3,5,1
66063,3,7,3,4,13,1
230212,4,3,32,-29,17,1
85949,2,7,14,-7,5,1
393110,3,24,3,21,4,0
361656,3,7,22,-15,7,1
291571,2,13,3,10,11,0
216775,4,34,9,25,12,0
30327,3,3,10,-7,14,1
224169,3,0,20,-20,15,0
73220,3,7,9,-2,16,0
99545,4,10,17,-7,11,0
376568,3,15,6,9,14,1
357028,4,26,10,16,5,1
141259,4,10,24,-14,13,1
243197,1,0,0,0,6,0
277314,4,0,16,-16,4,0
52107,4,13,19,-6,7,1
181860,2,21,14,7,13,1
374826,2,7,0,7,14,1
342574,3,12,13,-1,16,0
413442,3,10,38,-28,14,1
140716,2,6,14,-8,12,0
356528,3,9,3,6,5,0
246606,2,7,3,4,8,1
264559,2,10,17,-7,16,1
153497,1,0,0,0,1,1
311162,1,3,0,3,2,0
315268,4,20,19,1,4,1
377514,2,0,0,0,15,0
348263,3,16,46,-30,1,1
253173,1,0,0,0,11,1
56764,3,14,13,1,9,1
34408,2,14,0,14,16,0
33635,1,7,0,7,16,0
1349,2,0,0,0,1,1
352745,4,24,13,11,3,0
360011,2,3,26,-23,7,1
345367,1,0,7,-7,17,0
159299,4,27,24,3,3,0
143036,1,0,7,-7,13,1
348914,4,9,21,-12,2,1
273913,2,7,3,4,2,0
31839,4,23,24,-1,15,0
199360,2,0,10,-10,4,1
406138,4,3,29,-26,11,1
161539,1,0,3,-3,4,1
389562,4,27,24,3,3,1
40883,2,13,10,3,2,0
244360,2,0,10,-10,7,0
287323,2,6,0,6,8,1
199265,3,17,31,-14,4,1
331082,1,0,0,0,11,1
148261,1,0,0,0,16,0
125733,2,7,7,0,5,1
313215,4,23,16,7,3,1
68456,1,0,0,0,14,1
371440,2,7,7,0,12,1
268845,1,0,0,0,17,0
371315,2,21,10,11,12,1
333078,3,17,12,5,12,0
404016,2,3,14,-11,10,0
197725,2,7,10,-3,3,1
54956,3,3,3,0,8,1
67224,4,0,3,-3,14,1
96020,3,13,7,6,10,0
360100,4,10,43,-33,7,1
15912,2,6,7,-1,8,0
153952,1,7,0,7,1,0
361662,3,7,22,-15,7,0
219210,3,13,3,10,13,0
57214,4,13,7,6,10,1
55481,4,26,10,16,9,0
334319,4,9,14,-5,13,0
296135,1,10,6,4,13,0
1303,4,31,23,8,1,0
161802,4,30,6,24,4,0
225467,2,0,7,-7,15,1
56817,4,17,20,-3,9,1
59172,2,7,35,-28,10,0
238799,2,20,0,20,4,1
347921,2,0,14,-14,1,0
87374,2,7,0,7,6,0
140556,1,7,7,0,12,0
316069,1,3,3,0,4,1
163983,4,33,20,13,5,1
285023,1,0,0,0,7,0
121426,4,7,12,-5,3,0
354171,1,3,6,-3,4,0
240091,1,0,0,0,5,0
191624,5,27,24,3,17,0
248313,3,17,7,10,8,0
127343,3,10,20,-10,6,0
327181,4,28,17,11,9,1
62169,3,7,14,-7,12,0
117893,4,18,20,-2,2,1
386081,3,14,3,11,1,0
46489,3,27,6,21,4,1
390638,1,0,0,0,3,0
105304,4,10,26,-16,14,0
63169,3,14,13,1,12,0
296125,1,7,6,1,13,1
116274,2,17,3,14,1,1
278332,2,14,13,1,4,0
193149,4,13,6,7,1,1
206484,4,24,0,24,7,1
321640,4,17,13,4,7,1
16574,1,0,0,0,8,0
192456,2,0,17,-17,1,1
377382,2,7,6,1,15,0
165858,3,6,16,-10,6,0
401422,3,17,7,10,8,0
300160,2,21,3,18,14,1
298261,3,20,13,7,14,0
114738,4,15,17,-2,1,1
148037,3,7,3,4,15,1
215130,1,0,0,0,11,1
183584,3,20,24,-4,14,1
414503,1,7,3,4,14,0
121618,1,0,0,0,4,1
342648,4,22,27,-5,16,1
148158,2,3,14,-11,16,0
200858,2,14,0,14,4,0
385077,1,0,0,0,1,0
190801,2,13,3,10,17,0
334963,2,3,7,-4,13,1
230664,1,0,7,-7,1,0
53411,3,3,21,-18,8,1
201070,4,41,7,34,5,0
98434,2,14,7,7,11,0
338755,4,27,17,10,14,0
71440,2,24,7,17,16,1
383771,1,3,0,3,1,0
128307,1,0,0,0,7,0
217358,4,21,10,11,12,0
159099,3,24,0,24,3,0
188762,3,0,20,-20,16,1
305517,2,6,0,6,17,0
310360,4,29,0,29,2,0
48155,3,10,13,-3,5,0
289726,2,0,7,-7,10,0
77130,4,14,17,-3,1,1
384969,2,14,6,8,1,0
298455,4,19,27,-8,14,1
65321,3,3,21,-18,13,0
514,2,7,13,-6,1,1
334710,3,18,3,15,13,0
72082,4,10,10,0,16,0
77758,1,7,0,7,1,0
200375,1,0,6,-6,4,1
183458,4,27,6,21,14,0
236064,3,37,10,27,3,1
134489,3,3,30,-27,10,1
329545,4,38,14,24,10,1
195536,3,6,0,6,2,1
81659,1,7,7,0,3,0
332148,2,0,10,-10,12,1
395727,4,26,37,-11,6,1
157656,1,0,0,0,2,0
351903,1,0,0,0,3,0
225220,3,3,7,-4,15,1
6694,3,3,20,-17,3,0
192010,3,17,20,-3,1,1
62962,1,0,7,-7,12,0
53153,4,19,38,-19,7,1
354136,4,22,0,22,4,0
83553,3,0,14,-14,4,0
85082,4,31,16,15,4,1
417585,1,7,0,7,16,0
116654,4,23,10,13,2,0
7108,2,21,21,0,4,1
92931,4,34,7,27,8,0
177771,4,13,17,-4,12,0
69684,2,7,7,0,15,0
234530,4,20,20,0,2,0
271817,4,42,27,15,2,0
36070,2,24,0,24,17,1
200118,2,7,17,-10,4,1
155523,2,20,3,17,2,0
38565,4,38,6,32,1,0
147821,2,0,7,-7,15,1
126629,1,0,0,0,6,1
238122,1,0,0,0,4,0
54803,3,10,0,10,8,1
76472,2,0,14,-14,1,1
96734,2,0,10,-10,10,0
190652,2,21,7,14,17,0
242727,2,7,7,0,6,1
24241,3,13,17,-4,12,0
93825,1,0,0,0,9,0
316077,2,10,3,7,4,0
401414,3,17,7,10,8,0
217653,4,26,16,10,12,0
30339,4,10,10,0,14,0
176255,4,14,27,-13,11,0
201856,4,26,30,-4,5,0
113536,1,0,0,0,17,1
59439,1,0,10,-10,11,1
20961,2,7,24,-17,10,1
221283,3,0,29,-29,14,0
351456,1,0,0,0,3,0
219356,3,16,13,3,13,1
369001,3,10,7,3,11,1
300956,4,24,27,-3,15,1
344480,1,0,0,0,17,1
103440,1,0,0,0,13,0
241385,2,7,14,-7,5,0
310871,1,3,3,0,2,0
183050,2,7,0,7,14,0
318879,3,21,15,6,5,1
14695,1,0,0,0,7,1
107485,3,3,20,-17,15,1
328704,1,6,0,6,10,1
355565,2,14,3,11,5,1
118733,4,20,12,8,2,1
172441,4,13,49,-36,9,1
315901,1,0,0,0,4,1
74813,2,13,6,7,17,0
169307,1,0,0,0,8,0
203326,2,14,24,-10,6,0
4360,3,7,7,0,2,0
47159,2,6,0,6,5,1
204827,1,0,0,0,6,1
288604,4,23,41,-18,9,1
74992,3,20,17,3,17,1
396772,4,7,20,-13,6,0
241508,1,0,3,-3,5,1
162623,2,0,10,-10,5,1
77667,3,7,10,-3,1,0
368876,3,31,3,28,11,0
257010,1,0,7,-7,12,0
66363,3,14,24,-10,14,0
406990,3,3,20,-17,11,0
97798,2,7,10,-3,11,1
313430,2,14,7,7,3,0
200983,1,14,0,14,5,0
395983,3,24,17,7,6,0
36473,2,3,6,-3,17,1
374214,4,30,31,-1,13,0
119034,4,7,33,-26,3,1
420910,1,7,7,0,17,0
343155,1,3,0,3,16,0
279014,4,13,33,-20,5,1
235842,2,0,14,-14,3,1
157295,4,16,3,13,2,1
355035,4,18,26,-8,4,0
287084,4,26,32,-6,8,1
147828,2,0,7,-7,15,1
199414,3,16,10,6,4,1
206718,3,0,14,-14,7,1
276016,2,3,0,3,3,1
279401,3,13,21,-8,5,1
233486,4,23,10,13,2,1
400577,4,13,24,-11,8,0
356945,2,3,3,0,5,0
208338,3,17,24,-7,8,0
99020,2,6,0,6,11,1
181391,2,17,14,3,13,1
384140,3,7,20,-13,1,1
97011,1,10,0,10,10,0
151676,4,23,41,-18,17,1
400534,3,7,17,-10,8,1
135544,3,14,6,8,10,1
4689,4,20,20,0,2,1
295352,1,3,0,3,12,0
344839,3,23,10,13,17,0
379058,3,7,6,1,15,0
97374,3,9,13,-4,10,0
223388,3,7,19,-12,15,1
188829,1,0,0,0,16,1
208219,4,3,10,-7,8,1
325646,3,17,7,10,9,0
182268,1,7,0,7,14,0
89490,1,0,0,0,7,0
401655,1,0,7,-7,8,0
134376,4,29,21,8,10,0
415206,4,17,24,-7,15,1
262927,4,14,26,-12,15,0
111365,2,0,7,-7,16,1
48178,4,10,13,-3,5,1
247194,1,0,0,0,8,1
186526,4,17,33,-16,15,1
399737,2,0,10,-10,8,1
371889,3,24,10,14,12,1
74900,4,20,20,0,17,1
161947,4,13,16,-3,4,1
41039,2,3,10,-7,2,0
407145,3,10,27,-17,11,1
354900,5,41,42,-1,4,1
324347,1,0,0,0,8,1
251851,2,14,10,4,10,1
328189,4,14,14,0,10,0
315081,3,37,14,23,4,1
215622,2,14,3,11,11,0
261199,2,21,0,21,14,0
224704,1,0,0,0,15,0
210502,4,9,14,-5,9,0
353996,1,0,0,0,4,1
32716,3,7,21,-14,15,1
127608,2,3,9,-6,6,1
227908,3,26,13,13,16,1
306482,3,10,17,-7,17,1
59666,4,21,6,15,11,0
285365,1,0,0,0,8,1
62760,3,14,0,14,12,1
4079,3,16,21,-5,2,0
186003,2,10,27,-17,15,1
67812,1,0,0,0,14,0
134606,2,24,10,14,10,0
257818,2,7,3,4,13,1
373648,2,0,9,-9,13,0
338539,3,20,24,-4,14,1
119293,3,14,10,4,3,1
390150,4,20,35,-15,3,1
32744,4,7,24,-17,15,0
278658,3,17,3,14,4,1
158309,2,6,14,-8,3,1
361704,4,10,39,-29,7,0
54971,3,6,3,3,8,0
140819,1,7,0,7,13,0
282453,1,0,0,0,6,0
164717,1,6,7,-1,6,1
85588,1,0,0,0,5,1
400503,2,7,3,4,8,1
305774,4,16,10,6,17,0
412874,4,38,35,3,14,1
79461,3,12,14,-2,2,1
385364,1,0,0,0,1,0
245060,4,21,27,-6,7,0
54910,1,0,0,0,8,1
142409,1,7,0,7,13,0
170520,1,6,0,6,8,1
138709,4,21,35,-14,12,1
189009,2,7,7,0,16,1
162271,4,30,20,10,4,1
54674,3,20,29,-9,8,1
342750,3,7,7,0,16,0
174886,4,26,23,3,10,0
242947,4,24,23,1,6,0
59662,4,21,6,15,11,1
178192,2,0,10,-10,12,1
157439,3,9,17,-8,2,1
364790,1,0,0,0,9,0
241936,4,29,27,2,5,1
390620,1,0,0,0,3,1
96159,2,0,16,-16,10,1
178945,2,9,3,6,12,0
61284,3,27,14,13,11,1
310015,3,9,10,-1,2,0
285094,3,3,0,3,7,0
2632,1,0,0,0,2,1
407327,4,23,26,-3,11,1
281312,2,14,6,8,6,0
277058,2,3,0,3,4,0
366880,3,3,6,-3,10,0
118687,3,14,6,8,2,1
421844,3,0,13,-13,17,1
344111,2,17,3,14,17,1
134051,2,20,3,17,9,0
394683,4,24,21,3,5,0
279600,4,10,16,-6,5,0
164502,3,17,0,17,5,0
52248,4,10,16,-6,7,0
253855,2,21,14,7,11,1
29779,4,41,3,38,14,0
60968,2,21,6,15,11,0
37704,4,37,0,37,17,1
218832,1,0,3,-3,13,1
122438,3,6,26,-20,4,1
331621,3,23,30,-7,11,0
88960,3,33,10,23,6,1
108255,3,6,7,-1,15,1
232757,2,0,0,0,2,0
120775,4,23,6,17,3,1
184688,4,10,24,-14,15,1
3237,1,0,0,0,2,1
380945,3,9,7,2,16,1
222232,4,13,24,-11,14,1
319067,4,20,38,-18,5,1
6238,2,13,7,6,3,1
66409,4,21,30,-9,14,1
37614,2,10,0,10,17,0
239342,4,3,17,-14,4,0
139896,4,23,24,-1,12,0
276268,4,31,17,14,3,0
406501,2,0,16,-16,11,0
232518,3,20,10,10,1,0
363424,3,28,21,7,8,0
217926,4,25,28,-3,12,1
7814,4,37,17,20,4,0
110098,1,0,3,-3,16,0
343635,2,15,7,8,17,1
298199,1,0,3,-3,14,1
67130,1,0,0,0,14,1
362108,3,28,17,11,8,0
411878,1,7,0,7,13,1
6604,4,22,13,9,3,0
96907,3,19,7,12,10,0
160944,2,7,7,0,4,0
224225,1,0,0,0,15,0
388719,1,0,0,0,3,1
348946,1,7,0,7,2,0
37838,4,14,9,5,1,0
183549,2,7,10,-3,14,0
257180,2,0,9,-9,12,1
400550,3,13,24,-11,8,1
155925,4,17,16,1,2,1
322605,2,3,6,-3,7,1
63142,2,7,10,-3,12,0
85897,1,7,7,0,5,1
227318,3,13,27,-14,16,1
32005,1,0,0,0,15,1
397260,1,0,7,-7,6,0
2882,4,31,31,0,2,0
115771,4,20,16,4,1,0
38686,3,14,7,7,1,1
13098,1,0,0,0,6,0
385595,3,3,17,-14,1,0
49211,3,17,3,14,6,0
93625,3,13,6,7,9,1
65736,2,7,16,-9,13,1
179707,1,0,7,-7,12,1
190754,1,3,0,3,17,0
102805,3,10,3,7,13,1
407779,4,10,7,3,11,1
70373,4,18,33,-15,15,0
143102,3,17,24,-7,13,1
325650,3,17,7,10,9,1
365019,3,17,6,11,9,1
25719,3,14,10,4,12,1
75524,1,0,0,0,17,1
65144,2,0,0,0,13,1
135376,3,21,17,4,10,1
179824,1,0,0,0,13,0
36312,1,7,7,0,17,1
51519,4,34,31,3,7,1
124416,2,6,6,0,5,0
168229,1,0,0,0,7,0
61673,2,14,3,11,12,0
293166,1,6,0,6,11,0
197905,3,11,7,4,3,0
124866,3,9,6,3,5,0
152925,2,14,14,0,1,0
148033,3,7,3,4,15,1
389468,2,10,0,10,3,1
263432,2,3,13,-10,15,1
38976,3,30,3,27,1,0
235760,4,13,27,-14,3,0
305813,1,0,7,-7,17,1
174865,4,19,17,2,10,0
338671,2,13,7,6,14,0
307113,1,0,0,0,17,1
190621,1,7,7,0,17,1
181247,2,0,3,-3,13,1
90971,1,0,0,0,7,1
273413,1,0,0,0,2,1
309218,1,0,0,0,1,0
195617,1,0,0,0,2,1
384916,4,13,36,-23,1,0
387437,3,21,16,5,2,0
18244,1,0,14,-14,9,0
53493,1,7,0,7,8,0
416967,4,10,17,-7,15,0
128030,1,0,3,-3,7,1
402414,2,14,7,7,9,1
272673,2,9,3,6,2,1
150158,2,6,13,-7,16,1
396222,1,0,3,-3,6,1
251992,2,7,13,-6,10,0
17230,3,7,31,-24,9,0
338419,4,27,17,10,14,1
325099,1,0,0,0,8,1
85468,2,14,3,11,5,0
170901,3,14,20,-6,8,0
139053,1,6,0,6,12,0
260154,1,0,0,0,14,1
367233,1,0,0,0,10,1
119253,2,7,3,4,3,0
84172,3,10,7,3,4,1
320024,4,43,30,13,6,0
174457,1,0,0,0,10,1
306647,4,14,27,-13,17,1
298255,3,20,13,7,14,1
161416,2,7,3,4,4,0
376233,3,10,14,-4,14,1
348878,3,6,14,-8,2,1
306864,2,0,6,-6,17,1
401045,1,0,0,0,8,1
281562,4,27,23,4,6,0
16428,4,24,16,8,8,0
154938,3,26,17,9,1,1
322821,4,3,33,-30,7,0
186657,3,24,3,21,15,1
228923,2,7,9,-2,17,1
152602,1,0,3,-3,17,1
7717,2,10,3,7,4,1
13487,4,6,27,-21,7,1
296473,3,17,0,17,13,1
175688,2,23,3,20,11,0
386833,3,13,21,-8,2,1
57143,2,0,0,0,10,1
302793,2,9,13,-4,15,1
190343,1,6,0,6,17,1
160251,1,0,0,0,4,0
79543,1,0,0,0,2,1
360506,4,17,14,3,7,0
330451,4,20,20,0,11,0
265817,4,20,12,8,16,1
309096,1,9,3,6,1,0
375516,3,33,7,26,14,0
4431,1,0,0,0,2,1
354475,2,21,27,-6,4,0
225973,3,34,20,14,16,1
405661,4,24,28,-4,10,1
76872,1,0,0,0,1,0
277060,2,3,7,-4,4,1
87579,3,17,3,14,6,0
283288,3,10,9,1,7,1
78534,1,3,7,-4,2,1
419939,4,19,18,1,17,0
208700,1,0,0,0,8,0
353112,2,10,22,-12,3,0
98211,1,0,0,0,11,1
312507,2,19,0,19,3,1
331396,1,3,7,-4,11,1
163403,2,0,6,-6,5,1
417732,4,35,19,16,16,0
207022,2,28,0,28,7,0
131870,3,24,7,17,8,0
80402,4,27,16,11,2,1
319791,2,14,7,7,6,0
47020,2,17,0,17,5,0
113813,4,16,24,-8,17,0
390292,4,17,20,-3,3,1
207322,3,10,14,-4,7,1
50415,2,7,7,0,6,0
116823,1,6,0,6,2,1
175283,3,15,10,5,10,1
88674,4,23,20,3,6,1
261903,4,6,27,-21,14,0
275479,3,20,17,3,3,0
329285,1,0,0,0,10,0
268181,3,9,17,-8,17,1
17895,4,24,17,7,9,0
29900,4,23,23,0,14,0
289799,4,17,10,7,10,0
305457,4,20,3,17,17,0
334428,4,17,10,7,13,0
351000,1,0,7,-7,3,1
154729,2,3,7,-4,1,0
118465,4,27,10,17,2,0
335972,2,0,15,-15,13,1
235530,2,3,13,-10,3,1
162369,3,10,10,0,4,0
259476,3,28,10,18,13,1
74441,4,13,20,-7,17,0
111955,2,14,21,-7,17,0
291868,2,7,7,0,11,0
338805,2,7,0,7,15,1
288884,3,13,24,-11,9,0
21409,2,6,7,-1,11,1
406772,1,0,10,-10,11,1
175107,2,14,10,4,10,1
324811,1,3,0,3,8,0
141715,4,30,21,9,13,0
418688,1,0,7,-7,16,0
110025,3,27,10,17,16,1
207450,3,14,14,0,7,0
145709,1,0,10,-10,15,0
179259,3,26,3,23,12,0
324602,4,16,9,7,8,1
123237,4,19,21,-2,4,1
298310,4,20,13,7,14,0
63366,4,17,3,14,12,1
328359,4,3,37,-34,10,0
73869,4,13,7,6,17,0
320400,2,14,0,14,6,1
195963,3,0,24,-24,2,1
195413,4,24,3,21,2,1
175516,2,3,0,3,11,0
87495,1,0,0,0,6,1
33241,2,10,0,10,16,1
178325,2,13,3,10,12,1
56759,3,13,13,0,9,1
415593,3,14,10,4,15,0
217736,3,10,7,3,12,1
313796,4,34,17,17,3,0
373407,3,10,17,-7,13,1
319767,2,7,0,7,6,1
151127,1,0,0,0,17,1
354782,2,13,17,-4,4,1
252443,2,0,5,-5,10,0
96105,1,0,6,-6,10,1
370841,1,0,0,0,12,0
361846,4,44,10,34,7,1
122767,4,10,27,-17,4,1
215689,4,14,6,8,11,1
227371,4,27,37,-10,16,0
100009,1,3,0,3,12,0
330371,2,7,13,-6,11,0
198226,4,16,9,7,3,0
187665,2,7,3,4,16,0
309057,4,0,20,-20,1,1
164137,1,0,0,0,5,1
405186,1,0,6,-6,10,1
229758,4,20,17,3,17,1
258521,1,0,0,0,13,0
7328,5,20,19,1,4,0
263308,2,10,7,3,15,1
346149,1,7,0,7,1,1
94421,4,17,24,-7,9,1
171659,3,19,17,2,9,1
11145,4,24,27,-3,5,1
304561,4,25,31,-6,16,0
145714,1,0,10,-10,15,1
380003,1,7,0,7,16,0
215667,4,14,6,8,11,0
35079,4,15,19,-4,16,1
394417,1,0,3,-3,5,0
335630,4,19,10,9,13,0
19739,3,9,9,0,10,1
93507,4,3,31,-28,9,1
239524,1,3,0,3,4,1
258753,4,3,34,-31,13,0
215657,3,14,6,8,11,0
153589,3,12,14,-2,1,1
83537,2,0,14,-14,4,1
208834,4,6,25,-19,8,1
64797,4,31,7,24,13,0
2164,4,13,23,-10,1,1
24178,1,0,0,0,12,1
92262,2,10,0,10,8,1
178382,4,28,27,1,12,1
131163,4,27,12,15,8,1
97664,2,3,3,0,11,0
378882,3,13,13,0,15,0
163874,2,6,10,-4,5,1
163570,2,7,16,-9,5,1
101210,2,7,7,0,12,0
9349,3,28,7,21,5,0
112344,1,0,0,0,17,1
79762,3,20,7,13,2,0
317540,4,10,27,-17,5,0
352842,3,14,3,11,3,0
67503,3,39,14,25,14,0
95639,1,7,0,7,10,0
66418,1,0,0,0,14,0
197508,4,20,9,11,3,1
43472,1,0,0,0,3,0
84594,2,10,10,0,4,1
214658,4,17,16,1,11,0
322585,2,0,3,-3,7,1
184118,3,16,14,2,14,0
366861,3,3,6,-3,10,0
136624,3,15,16,-1,11,0
217081,1,0,0,0,12,1
396628,4,23,10,13,6,0
285940,3,26,7,19,8,1
327197,1,0,0,0,9,0
358256,2,0,14,-14,6,1
304710,4,21,7,14,16,0
289809,4,17,16,1,10,0
140545,1,0,0,0,12,1
86197,4,34,10,24,5,0
32970,2,0,24,-24,15,1
162905,1,0,0,0,5,0
288283,4,10,35,-25,9,1
137148,4,31,6,25,11,1
238470,2,6,0,6,4,0
400421,4,24,10,14,8,0
149125,3,17,24,-7,16,1
298834,3,21,9,12,14,1
256304,4,14,17,-3,12,1
92038,4,27,26,1,8,0
189663,3,16,6,10,17,1
253933,4,44,14,30,11,0
299903,3,13,8,5,14,0
145289,2,14,9,5,14,1
58804,4,18,29,-11,10,0
129173,1,7,0,7,7,0
263555,4,20,29,-9,15,1
311295,1,0,0,0,2,0
154305,2,6,14,-8,1,1
7991,1,3,0,3,4,0
374367,1,7,0,7,14,0
23955,3,16,3,13,12,1
133240,4,23,20,3,9,0
92549,2,10,0,10,8,1
263090,4,10,13,-3,15,0
45124,2,7,7,0,4,1
22447,2,24,24,0,11,0
237294,1,0,0,0,3,0
108551,3,17,14,3,15,1
397643,4,6,27,-21,7,1
350028,2,13,7,6,2,0
145280,2,14,6,8,14,0
408265,1,0,0,0,12,1
319943,2,23,10,13,6,1
58686,1,7,7,0,10,0
89816,2,6,3,3,7,1
48497,1,2,0,2,5,1
38048,2,3,0,3,1,1
390766,1,0,0,0,3,0
42125,5,27,27,0,2,0
399764,2,0,17,-17,8,0
120920,4,28,31,-3,3,1
23120,1,0,0,0,11,0
281913,1,7,6,1,6,0
205831,3,20,0,20,7,0
67162,2,0,0,0,14,0
82830,4,12,16,-4,3,1
244086,3,20,27,-7,6,0
327814,1,3,10,-7,10,0
136628,3,15,16,-1,11,0
32399,3,31,6,25,15,0
78255,2,0,6,-6,2,0
300863,2,0,7,-7,15,0
158030,2,0,6,-6,3,1
338334,2,3,0,3,14,0
76599,1,7,0,7,1,1
149825,2,3,10,-7,16,0
298675,3,13,7,6,14,0
54118,4,20,10,10,8,1
255582,4,30,7,23,12,0
371954,1,0,0,0,13,1
127601,2,3,9,-6,6,1
65083,4,6,17,-11,13,0
211754,1,0,0,0,9,0
87565,3,17,3,14,6,1
160903,1,0,0,0,4,1
208366,3,17,27,-10,8,0
132883,3,6,14,-8,9,1
204769,3,21,14,7,6,0
208384,4,17,43,-26,8,1
128773,2,7,10,-3,7,1
276459,1,10,7,3,4,0
47557,3,37,6,31,5,0
388065,4,27,9,18,2,1
412420,1,0,0,0,14,0
157744,3,10,10,0,2,1
14654,4,24,14,10,7,1
38800,2,3,10,-7,1,0
163293,3,13,13,0,5,0
267359,2,0,7,-7,17,0
215380,4,24,20,4,11,1
232673,3,7,0,7,1,1
333837,3,14,21,-7,12,1
79783,4,20,14,6,2,1
148079,4,14,10,4,15,1
199453,4,22,17,5,4,1
255096,4,6,31,-25,12,1
29750,3,34,3,31,14,0
16372,3,21,10,11,8,1
93906,3,24,6,18,9,0
4633,2,10,10,0,2,1
197457,3,13,9,4,3,0
185342,1,0,0,0,15,0
296463,2,17,0,17,13,0
367355,1,0,6,-6,10,0
360518,4,17,21,-4,7,1
180751,2,7,3,4,13,0
174666,2,9,0,9,10,0
216638,1,7,3,4,12,0
6999,4,10,7,3,3,1
303677,4,38,19,19,16,0
22528,4,31,37,-6,11,1
322949,3,13,0,13,7,0
107381,4,19,6,13,15,1
224749,2,5,0,5,15,0
280737,3,14,14,0,5,1
198818,3,6,16,-10,3,0
207421,2,7,7,0,7,1
317727,5,23,23,0,5,0
22525,4,31,37,-6,11,1
36211,3,10,17,-7,17,0
307712,4,23,31,-8,17,1
85569,4,17,22,-5,5,1
309188,4,37,9,28,1,1
340663,3,16,13,3,15,1
322668,4,6,9,-3,7,0
279833,2,7,13,-6,5,1
55429,3,20,10,10,9,1
146711,3,7,32,-25,15,1
71773,3,38,30,8,16,0
118014,4,20,6,14,2,1
172068,2,10,3,7,9,1
278442,2,22,0,22,4,1
356727,4,26,16,10,5,1
179785,4,6,24,-18,12,0
398537,4,28,16,12,7,1
215354,3,17,13,4,11,0
164374,3,23,3,20,5,0
403373,4,26,11,15,9,1
46595,2,3,0,3,4,1
70268,2,7,7,0,15,0
405590,3,14,17,-3,10,0
50645,4,17,9,8,6,1
104587,2,7,3,4,14,1
128681,4,6,17,-11,7,0
21944,1,7,0,7,11,1
3404,2,3,10,-7,2,1
22722,2,3,14,-11,11,1
125023,3,3,6,-3,5,0
214205,1,0,0,0,11,0
409579,4,42,17,25,12,0
325790,3,6,10,-4,9,0
64610,3,20,14,6,13,1
369494,1,0,0,0,11,1
149445,4,13,27,-14,16,0
76284,1,0,0,0,1,1
159422,3,13,20,-7,3,0
262837,1,7,13,-6,15,1
153501,1,2,0,2,1,0
364607,4,21,37,-16,9,1
183450,4,27,6,21,14,0
8636,3,7,10,-3,4,1
167089,4,16,34,-18,7,1
44806,1,0,0,0,4,0
419162,2,10,3,7,16,0
194097,1,0,0,0,1,0
289572,2,7,13,-6,10,1
25295,3,34,14,20,12,1
264843,4,24,37,-13,16,0
154546,1,6,0,6,1,1
3899,2,19,7,12,2,1
230126,2,3,10,-7,17,0
22022,3,14,17,-3,11,0
300268,1,0,7,-7,14,1
317044,2,7,10,-3,4,0
231950,4,14,41,-27,1,1
196959,2,14,0,14,3,1
351237,3,28,17,11,3,0
268957,4,6,36,-30,17,1
215983,4,20,42,-22,11,1
112044,1,0,0,0,17,0
340754,2,7,7,0,15,1
298627,1,3,0,3,14,1
97202,2,6,6,0,10,1
292909,3,7,0,7,11,0
386766,2,7,0,7,2,0
246592,1,7,3,4,8,0
370687,1,0,0,0,12,0
258536,1,0,0,0,13,1
35802,3,3,10,-7,17,0
242783,3,14,24,-10,6,0
88100,4,24,3,21,6,0
252791,2,6,6,0,11,0
196473,1,0,0,0,2,0
180692,4,27,6,21,13,1
199370,2,0,10,-10,4,1
37773,2,7,3,4,1,1
107571,1,0,7,-7,15,1
35282,1,3,0,3,16,1
4830,4,34,3,31,3,0
271072,4,34,34,0,1,1
130379,3,7,3,4,8,0
77730,4,23,24,-1,1,0
320492,4,26,17,9,6,0
53704,2,7,0,7,8,0
201852,4,26,30,-4,5,0
268747,2,17,3,14,17,0
296514,4,26,3,23,13,0
280391,2,3,7,-4,5,1
353266,3,28,20,8,4,1
315654,2,3,7,-4,4,1
224281,2,6,9,-3,15,1
123805,3,10,3,7,5,0
15210,3,13,0,13,8,0
126094,4,20,9,11,6,1
402693,2,3,0,3,9,0
170128,3,7,10,-3,8,0
185955,1,0,7,-7,15,1
377684,2,19,7,12,15,1
305349,1,7,0,7,17,0
242392,4,34,19,15,6,1
225120,4,16,14,2,15,1
70267,2,7,7,0,15,0
142932,3,3,10,-7,13,0
112520,1,3,9,-6,17,1
293843,4,24,19,5,12,1
34344,4,23,9,14,16,0
5530,3,13,10,3,3,1
325827,4,6,17,-11,9,0
109907,4,23,0,23,16,0
418308,3,6,14,-8,16,0
339755,3,24,6,18,15,0
134128,1,0,0,0,10,1
21760,4,31,17,14,11,0
182176,3,26,7,19,13,1
379968,4,24,6,18,16,0
168478,4,3,24,-21,7,0
288345,2,7,0,7,9,0
264798,3,17,29,-12,16,0
69006,3,21,17,4,15,1
219793,2,38,0,38,13,1
88592,2,10,7,3,6,0
34116,2,3,0,3,16,0
193398,2,10,17,-7,1,0
327141,3,14,17,-3,9,1
111838,3,6,10,-4,17,1
330030,1,0,0,0,11,0
317430,1,0,0,0,5,1
15118,4,10,26,-16,7,0
64384,1,0,0,0,13,0
333187,2,0,7,-7,12,0
122187,4,27,28,-1,4,1
291793,4,9,23,-14,11,1
235856,2,0,14,-14,3,0
403944,4,20,17,3,10,0
276860,4,26,20,6,4,1
39564,2,7,6,1,1,0
280147,3,21,0,21,5,0
235602,4,27,13,14,3,0
245566,2,40,0,40,7,0
194432,2,9,0,9,2,1
124194,4,30,27,3,5,0
151329,2,13,14,-1,17,0
194693,1,0,0,0,2,0
361069,3,16,9,7,7,1
328932,3,9,7,2,10,1
194042,3,20,7,13,1,0
2323,4,20,17,3,1,0
205109,1,0,0,0,6,1
176114,1,7,0,7,11,0
407154,4,17,27,-10,11,0
389012,1,6,0,6,3,1
263212,3,17,17,0,15,0
398300,1,3,3,0,7,1
383336,1,0,0,0,17,1
232046,3,0,24,-24,1,0
219385,4,23,20,3,13,1
270545,2,10,7,3,1,1
92935,1,0,0,0,8,0
286252,2,6,13,-7,8,1
257145,1,0,0,0,12,0
420569,1,0,6,-6,17,0
295542,2,17,7,10,12,0
5457,1,0,0,0,3,0
42819,3,6,28,-22,3,0
164359,3,20,3,17,5,0
89755,4,16,23,-7,7,1
55922,1,0,0,0,9,0
128509,3,21,28,-7,7,1
307084,4,24,6,18,17,0
184893,1,0,6,-6,15,0
208995,1,0,0,0,8,0
167983,2,0,14,-14,7,1
123076,4,14,21,-7,4,0
159059,2,10,0,10,3,1
118694,3,14,6,8,2,1
66286,1,0,0,0,14,0
134691,4,37,31,6,10,0
223961,1,0,6,-6,15,1
101516,2,10,7,3,12,0
30115,2,3,7,-4,14,1
90980,1,0,0,0,7,1
240802,3,23,10,13,5,0
24005,4,26,6,20,12,0
199413,3,16,10,6,4,1
62109,2,7,7,0,12,1
20277,1,7,0,7,10,0
152953,3,28,17,11,1,0
346374,3,6,13,-7,1,1
246840,4,13,20,-7,8,0
388139,2,3,6,-3,2,1
216807,1,0,0,0,12,0
395139,1,0,0,0,5,1
269164,1,0,0,0,17,0
113762,3,3,17,-14,17,1
35233,4,0,17,-17,16,0
57913,2,13,10,3,10,0
338263,4,34,31,3,14,0
117924,1,0,3,-3,2,1
341498,2,3,7,-4,16,1
308637,4,34,22,12,1,1
26166,3,0,26,-26,13,1
348174,1,6,6,0,1,0
54811,3,13,0,13,8,1
83468,1,0,0,0,4,1
186773,2,23,0,23,15,0
114735,4,15,10,5,1,0
269662,3,10,0,10,1,0
233063,1,0,0,0,2,1
21853,2,7,0,7,11,1
8175,2,0,7,-7,4,1
13988,1,0,0,0,7,1
299450,3,7,20,-13,14,0
153251,2,2,0,2,1,0
392014,2,7,7,0,4,0
327977,2,7,0,7,10,1
222628,2,7,7,0,14,0
80063,3,17,6,11,2,0
367006,3,3,31,-28,10,0
188050,1,0,0,0,16,1
324583,3,16,9,7,8,0
322098,4,26,0,26,7,1
343845,4,24,3,21,17,1
275031,3,31,10,21,3,0
126923,1,0,0,0,6,1
132331,4,31,17,14,9,1
313968,1,0,0,0,3,1
149575,3,14,23,-9,16,1
95656,2,7,3,4,10,1
334751,4,25,9,16,13,0
196263,3,21,10,11,2,0
118020,4,20,6,14,2,0
123453,1,0,0,0,4,0
303053,1,0,0,0,16,0
314678,4,14,21,-7,3,1
312725,4,28,14,14,3,1
83182,1,3,0,3,4,0
260441,1,0,0,0,14,1
401703,3,10,14,-4,8,1
232748,1,0,0,0,2,0
284321,3,6,10,-4,7,0
63926,3,6,24,-18,12,0
319147,2,2,0,2,5,0
44617,3,20,21,-1,3,0
188686,1,0,14,-14,16,0
8974,4,35,27,8,4,1
110422,2,10,0,10,16,0
47813,2,7,6,1,5,0
223267,3,3,9,-6,15,1
336870,2,7,14,-7,14,1
234855,4,0,12,-12,2,1
152910,2,7,14,-7,1,1
168586,3,14,10,4,7,0
401597,4,17,24,-7,8,1
102165,2,14,7,7,13,1
279255,3,16,13,3,5,1
321976,1,0,0,0,7,0
166130,2,14,6,8,6,0
362987,3,27,16,11,8,0
128839,4,20,13,7,7,0
237471,1,7,0,7,3,1
239560,2,13,0,13,4,0
73251,4,7,16,-9,16,1
399174,2,7,6,1,7,1
117433,1,0,0,0,2,1
45317,3,10,10,0,4,0
278428,1,15,0,15,4,0
58467,4,48,23,25,10,1
151431,1,14,0,14,17,1
63664,4,20,36,-16,12,1
244274,4,23,7,16,6,0
235444,3,28,25,3,3,0
388102,1,3,0,3,2,0
407796,4,17,7,10,11,0
293596,1,0,0,0,12,1
227008,2,10,6,4,16,0
302570,4,3,16,-13,15,1
120447,3,19,16,3,3,0
377365,1,0,0,0,15,0
110246,1,0,3,-3,16,0
44132,3,10,13,-3,3,0
247725,3,7,6,1,8,0
420937,2,7,14,-7,17,1
146813,2,10,0,10,15,1
124743,3,3,6,-3,5,1
342878,2,16,7,9,16,0
357815,2,3,14,-11,6,1
287625,2,3,3,0,9,0
54568,4,28,18,10,8,0
243237,2,0,7,-7,6,1
367351,1,0,0,0,10,0
318683,1,0,13,-13,5,1
257354,2,17,0,17,13,0
239408,2,6,10,-4,4,1
124911,4,9,16,-7,5,1
366650,1,7,3,4,10,1
368530,2,6,0,6,11,1
56695,2,0,0,0,9,0
77408,3,14,21,-7,1,0
159839,2,13,0,13,3,1
269377,3,7,17,-10,1,1
323088,3,23,14,9,7,1
160126,1,7,0,7,3,0
159551,2,14,6,8,3,1
202773,4,16,17,-1,5,1
13440,2,3,14,-11,7,0
387710,3,0,13,-13,2,0
118428,3,20,10,10,2,1
104298,2,30,14,16,13,1
152788,3,7,7,0,17,0
303484,4,25,10,15,16,1
234201,3,13,10,3,2,1
303394,1,10,0,10,16,1
13574,2,3,0,3,7,0
149343,1,0,0,0,16,1
346375,3,6,13,-7,1,1
109815,1,10,0,10,16,1
180632,2,10,6,4,13,1
329598,1,10,7,3,11,0
366757,4,27,10,17,10,0
228814,2,6,17,-11,17,1
212977,4,21,7,14,10,0
218929,4,41,24,17,13,1
133547,1,0,0,0,9,1
245191,4,17,28,-11,7,1
155057,2,6,19,-13,1,0
329843,4,24,23,1,11,0
176969,3,10,6,4,11,0
275029,3,31,10,21,3,0
355181,4,29,26,3,4,1
22811,4,13,21,-8,11,1
190693,3,28,17,11,17,1
111203,2,7,3,4,16,1
147181,4,17,49,-32,15,1
125759,2,7,14,-7,5,1
287278,1,0,0,0,8,0
392083,4,18,33,-15,4,0
163214,1,0,3,-3,5,1
323035,2,14,7,7,7,0
105791,1,0,3,-3,14,1
35793,3,3,10,-7,17,0
76718,4,16,14,2,1,0
33222,2,10,0,10,16,0
319100,1,0,0,0,5,0
213938,2,16,7,9,10,1
408357,3,19,7,12,12,1
358392,2,9,13,-4,6,0
277801,1,0,7,-7,4,1
281074,4,38,16,22,6,0
343946,2,14,6,8,17,0
391160,3,10,24,-14,4,0
301325,2,14,7,7,15,1
413437,3,10,38,-28,14,0
140054,1,0,0,0,12,1
56241,2,3,7,-4,9,1
136245,2,12,7,5,11,0
336063,4,16,31,-15,13,1
343826,3,21,3,18,17,0
21202,4,0,16,-16,10,0
159816,1,0,0,0,3,1
284338,3,6,10,-4,7,1
175601,4,33,14,19,11,1
66056,3,7,0,7,13,0
155889,4,14,13,1,2,1
4165,1,0,3,-3,2,1
160726,4,10,3,7,4,1
21530,2,7,7,0,11,0
375232,5,24,24,0,14,1
140273,2,7,6,1,12,1
163137,3,16,22,-6,5,1
242271,1,0,7,-7,6,1
237376,3,12,14,-2,3,0
325279,2,3,3,0,8,1
249324,1,10,0,10,9,0
372407,1,6,6,0,13,0
283310,3,10,9,1,7,0
22561,1,6,3,3,11,0
345598,4,14,23,-9,17,1
150290,2,14,7,7,16,1
124304,3,34,20,14,5,1
97299,1,0,0,0,10,0
212951,3,7,7,0,10,1
231862,1,0,20,-20,1,1
134476,3,3,23,-20,10,0
85582,4,20,22,-2,5,1
12097,2,7,7,0,6,1
361030,2,16,2,14,7,0
28273,4,17,14,3,13,0
304428,1,0,0,0,16,1
166840,1,0,3,-3,6,0
82091,1,0,0,0,3,0
331368,4,8,33,-25,11,1
16319,1,7,0,7,8,1
181215,2,0,0,0,13,0
41557,4,18,14,4,2,1
125363,4,38,3,35,5,0
255339,2,14,0,14,12,0
66190,2,24,3,21,13,1
145440,2,9,14,-5,14,0
393414,3,28,24,4,5,1
375179,3,17,16,1,14,0
179544,2,0,23,-23,12,1
377383,2,7,6,1,15,0
75450,3,24,7,17,17,0
99471,2,0,9,-9,11,0
328058,4,17,17,0,10,1
155130,4,19,33,-14,1,1
291199,4,30,35,-5,10,1
46937,4,20,30,-10,5,0
242259,1,0,0,0,6,0
14590,2,3,7,-4,7,0
152344,2,7,3,4,17,1
338747,4,27,17,10,14,1
218981,1,7,0,7,13,1
48615,4,21,27,-6,5,1
334166,4,23,14,9,13,1
151630,3,23,13,10,17,0
356794,2,0,0,0,5,0
407628,4,10,17,-7,11,1
227516,4,19,17,2,16,1
383959,2,0,10,-10,1,0
64355,4,19,27,-8,13,1
158765,2,0,3,-3,3,1
370663,4,21,14,7,12,1
115549,2,3,3,0,1,0
219955,2,6,14,-8,13,1
42314,1,0,9,-9,2,1
291342,4,24,31,-7,10,1
103746,4,10,23,-13,13,0
85252,4,23,17,6,4,1
361534,3,10,7,3,7,1
381405,3,16,0,16,16,0
203536,4,31,3,28,6,0
227884,2,17,6,11,16,1
290048,2,7,6,1,10,1
194412,1,6,0,6,2,1
39236,2,3,3,0,1,0
6615,1,0,0,0,3,0
241965,1,7,0,7,5,0
338412,4,27,10,17,14,1
170104,2,7,0,7,8,0
128094,3,3,6,-3,7,1
415473,3,23,3,20,15,1
354229,3,13,10,3,4,1
356509,3,6,3,3,5,1
275989,1,0,0,0,3,0
3226,1,0,0,0,2,1
53236,2,3,0,3,8,1
118995,3,0,23,-23,3,1
402851,2,10,3,7,9,1
107489,3,3,20,-17,15,1
124227,1,7,14,-7,5,0
196872,4,10,20,-10,3,0
110747,2,3,3,0,16,1
21602,3,7,31,-24,11,0
28891,4,23,10,13,14,1
218669,4,10,33,-23,13,1
179375,2,3,6,-3,12,0
260188,2,7,0,7,14,1
195230,3,16,10,6,2,0
300290,2,0,7,-7,14,0
312173,1,0,0,0,2,0
365896,3,14,14,0,9,0
99608,2,0,3,-3,11,1
136104,2,0,10,-10,10,1
295848,2,7,14,-7,12,1
107618,2,13,7,6,15,0
250383,4,21,23,-2,9,1
160711,4,10,3,7,4,1
331968,1,0,0,0,12,0
301503,3,20,12,8,15,0
76513,3,7,20,-13,1,0
171585,1,3,3,0,9,0
24968,2,10,14,-4,12,0
224459,2,9,10,-1,15,1
81936,4,7,30,-23,3,0
176067,4,24,8,16,11,1
133633,3,10,14,-4,9,0
142830,4,12,16,-4,13,0
398700,1,0,6,-6,7,0
98822,1,7,0,7,11,0
216445,1,14,0,14,12,1
149133,3,17,24,-7,16,0
322007,1,3,0,3,7,0
417685,3,28,12,16,16,1
305273,3,28,21,7,16,0
189290,2,3,0,3,16,1
207708,2,0,10,-10,7,0
404110,1,6,0,6,10,0
160340,3,3,21,-18,4,0
93759,3,3,16,-13,9,1
312162,1,0,0,0,2,0
21746,3,24,17,7,11,1
124151,4,19,21,-2,5,1
190171,1,0,0,0,17,1
246444,1,7,0,7,8,1
318572,2,10,7,3,5,1
227713,2,0,0,0,16,0
20417,4,10,16,-6,10,0
39337,4,20,27,-7,1,0
259487,3,28,10,18,13,1
44891,3,7,31,-24,4,1
367427,3,20,14,6,10,0
418029,4,28,35,-7,16,0
18946,1,0,0,0,10,1
382839,3,21,3,18,17,1
306052,3,10,13,-3,17,1
416477,3,21,10,11,15,0
258881,4,20,14,6,13,1
308830,2,3,10,-7,1,1
271332,4,16,24,-8,1,0
386685,4,17,13,4,2,1
212328,3,10,3,7,10,1
297331,1,3,3,0,13,0
390161,4,20,35,-15,3,0
201238,4,30,24,6,5,0
248152,2,3,10,-7,8,1
120569,2,0,6,-6,3,0
114375,3,34,13,21,1,0
31822,4,16,24,-8,15,1
17566,4,13,16,-3,9,0
255393,3,24,6,18,12,1
258160,4,13,13,0,13,0
12451,4,13,6,7,6,0
163215,1,0,3,-3,5,0
307241,4,10,10,0,17,0
169451,1,0,6,-6,8,0
242586,2,3,0,3,6,1
189970,4,13,7,6,17,0
202627,3,24,20,4,5,1
206004,4,16,10,6,7,0
137576,4,20,34,-14,11,1
366488,1,0,0,0,10,1
28644,2,0,7,-7,14,1
119540,1,7,0,7,3,0
270094,2,17,10,7,1,1
4323,2,0,7,-7,2,0
351830,3,20,14,6,3,1
279858,3,17,13,4,5,0
338021,1,0,0,0,14,1
24777,1,6,0,6,12,0
395849,4,3,17,-14,6,1
352759,4,24,13,11,3,0
264679,1,7,0,7,16,1
140975,1,0,0,0,13,1
361117,4,23,16,7,7,0
226772,4,7,20,-13,16,0
57430,1,6,0,6,10,1
231437,2,10,6,4,1,0
23789,2,17,0,17,12,0
241323,4,13,14,-1,5,0
4628,2,10,10,0,2,1
69776,4,19,17,2,15,1
164598,2,7,9,-2,5,0
20000,2,9,6,3,10,1
26061,1,0,0,0,13,1
293488,2,10,3,7,11,0
54873,4,32,3,29,8,1
386362,2,17,6,11,2,0
281924,1,7,7,0,6,0
265898,2,0,9,-9,16,1
25592,3,27,10,17,12,1
375825,4,20,7,13,14,0
99690,4,26,3,23,11,1
267461,1,0,7,-7,17,1
349659,1,0,0,0,2,0
205166,2,7,10,-3,6,1
154312,3,13,14,-1,1,0
348030,1,0,7,-7,1,0
4664,3,13,13,0,2,1
15021,2,0,16,-16,7,1
420503,3,3,35,-32,17,1
357902,4,13,34,-21,6,1
385509,1,0,0,0,1,1
70526,4,39,23,16,15,1
342500,1,0,0,0,16,0
226353,4,25,7,18,16,0
326389,4,20,10,10,9,0
148861,1,0,0,0,16,0
237703,4,20,14,6,4,0
123047,3,7,13,-6,4,0
147971,1,0,0,0,15,0
69421,2,17,3,14,15,1
108380,3,0,21,-21,15,0
49483,1,0,3,-3,6,1
300058,3,0,40,-40,14,1
215223,3,10,16,-6,11,1
102824,4,10,10,0,13,1
31810,3,16,17,-1,15,0
47316,2,0,10,-10,5,0
245361,1,9,0,9,7,0
419522,4,10,23,-13,16,1
382347,1,0,0,0,17,0
328276,1,3,7,-4,10,0
365736,2,17,10,7,9,0
24218,2,10,10,0,12,0
245172,4,17,28,-11,7,1
47706,3,3,17,-14,5,1
34102,2,0,0,0,16,0
285285,3,14,9,5,7,0
237268,4,23,0,23,3,1
27732,1,0,7,-7,13,1
212938,3,7,7,0,10,0
134438,2,0,20,-20,10,1
169052,3,26,14,12,7,1
73817,3,6,0,6,17,1
28133,4,27,10,17,13,1
153580,3,12,14,-2,1,0
56272,3,3,17,-14,9,1
258877,4,20,14,6,13,1
92008,4,27,23,4,8,0
377954,1,0,0,0,15,0
410424,2,6,17,-11,13,1
42174,1,7,0,7,2,0
220411,3,23,14,9,13,0
130709,4,7,45,-38,8,0
214938,4,7,26,-19,11,1
405346,4,17,12,5,10,0
118518,2,17,0,17,2,1
52738,4,13,23,-10,7,1
317692,4,23,9,14,5,0
144415,2,0,13,-13,14,1
408103,4,20,17,3,12,1
61025,4,34,16,18,11,0
25168,4,20,3,17,12,1
399445,1,0,10,-10,7,0
206165,4,27,26,1,7,1
320892,3,3,14,-11,6,1
176442,1,0,7,-7,11,1
350382,4,31,13,18,2,0
384763,4,19,40,-21,1,0
283087,1,3,0,3,7,1
116945,4,28,13,15,2,0
122274,2,6,13,-7,4,1
320591,3,31,6,25,6,1
281644,2,21,10,11,6,1
192834,3,7,15,-8,1,0
110544,1,0,0,0,16,0
3835,1,0,0,0,2,0
381852,3,18,21,-3,17,0
294303,1,7,0,7,12,1
297367,2,6,10,-4,13,1
307473,3,35,13,22,17,1
334427,3,17,10,7,13,0
185832,1,3,0,3,15,0
417607,1,14,0,14,16,0
403959,4,20,24,-4,10,1
192286,2,24,3,21,1,0
134061,3,20,3,17,9,1
10878,1,0,0,0,5,1
78732,2,13,7,6,2,1
238653,2,13,14,-1,4,1
21912,4,35,3,32,11,0
168596,3,14,10,4,7,0
109743,3,13,0,13,16,0
387781,1,0,0,0,2,1
208457,2,10,0,10,8,1
178124,1,0,0,0,12,0
406659,2,14,0,14,11,0
371443,2,14,7,7,12,0
13124,2,10,7,3,6,0
415860,2,7,20,-13,15,1
180376,4,15,14,1,13,0
253601,4,9,10,-1,11,0
4959,4,21,17,4,3,0
98692,1,13,3,10,11,1
103871,4,26,0,26,13,1
141596,1,0,0,0,13,1
159760,3,7,13,-6,3,0
192466,2,0,17,-17,1,1
402140,2,12,0,12,9,1
3900,2,19,7,12,2,1
289877,2,6,3,3,10,0
415712,2,7,10,-3,15,1
207531,1,7,0,7,7,0
292433,2,3,0,3,11,0
391091,1,7,7,0,4,0
85829,3,13,13,0,5,1
278821,3,7,21,-14,5,1
211177,2,0,10,-10,9,1
338691,3,20,10,10,14,1
54026,2,3,0,3,8,0
337047,3,19,0,19,14,1
282062,1,3,8,-5,6,1
29957,1,7,0,7,14,0
45451,2,21,7,14,4,0
40439,2,7,14,-7,2,1
167511,3,0,3,-3,7,0
1552,3,6,13,-7,1,1
186457,2,10,10,0,15,0
237814,2,0,13,-13,4,1
49291,1,0,0,0,6,0
88699,4,26,20,6,6,0
92997,2,10,3,7,8,1
313146,2,10,10,0,3,0
162126,4,51,20,31,4,1
239898,4,13,3,10,4,1
129778,4,17,24,-7,7,0
39192,1,0,0,0,1,0
234779,2,0,3,-3,2,1
270750,4,6,3,3,1,0
144671,1,0,0,0,14,0
273791,3,10,7,3,2,0
301225,4,20,17,3,15,1
401328,4,27,24,3,8,1
393787,1,0,0,0,5,1
370577,2,14,7,7,12,0
120247,2,14,3,11,3,0
365730,2,10,10,0,9,1
33513,2,17,0,17,16,0
244545,3,25,13,12,7,0
257828,2,7,3,4,13,0
124951,1,0,3,-3,5,1
300950,4,24,27,-3,15,0
399695,4,19,9,10,8,1
230592,3,16,17,-1,1,1
31628,3,24,6,18,15,0
198641,3,10,14,-4,3,0
146661,2,7,23,-16,15,0
155149,4,19,33,-14,1,1
73901,1,14,0,14,17,0
342080,1,3,3,0,16,0
390909,4,15,31,-16,3,1
292817,4,29,24,5,11,0
313013,3,16,0,16,3,1
280864,3,13,3,10,6,0
82549,4,17,27,-10,3,1
180783,3,7,13,-6,13,1
321657,4,20,20,0,7,0
239450,3,9,17,-8,4,1
197370,4,30,17,13,3,0
256455,3,12,24,-12,12,1
259912,2,14,10,4,14,1
326038,2,9,0,9,9,1
129491,1,0,0,0,7,0
40357,4,9,7,2,2,0
222949,3,13,13,0,14,1
322168,2,0,17,-17,7,0
402234,1,0,3,-3,9,1
274121,4,20,0,20,3,0
328939,3,9,7,2,10,0
139613,4,9,14,-5,12,0
99818,4,8,24,-16,12,0
217771,4,10,10,0,12,0
259386,4,35,41,-6,13,1
38519,2,17,3,14,1,0
154252,1,0,7,-7,1,1
276818,3,20,17,3,4,0
22477,3,31,27,4,11,0
355539,2,7,0,7,5,1
154298,2,6,14,-8,1,0
189435,2,7,0,7,17,0
130311,2,7,0,7,8,0
141185,2,3,21,-18,13,1
271254,1,3,0,3,1,1
251490,2,16,3,13,10,0
166317,3,10,9,1,6,0
322876,1,6,0,6,7,0
202647,4,34,20,14,5,0
5108,3,13,7,6,3,1
114259,4,10,24,-14,1,1
340254,4,29,34,-5,15,1
402482,4,26,15,11,9,0
276337,2,14,21,-7,3,1
298791,2,14,6,8,14,0
102458,2,3,3,0,13,1
86753,4,27,14,13,5,0
194554,1,7,0,7,2,0
370916,3,20,17,3,12,0
108986,2,16,24,-8,15,0
239773,4,20,13,7,4,1
15814,3,0,12,-12,8,1
177282,4,14,17,-3,11,0
272329,1,7,0,7,2,1
187034,1,3,0,3,16,1
385506,1,0,0,0,1,1
402362,1,0,0,0,9,0
248872,1,7,0,7,9,1
169580,4,10,41,-31,8,0
166703,1,7,3,4,6,1
344357,2,14,0,14,17,0
376606,4,15,6,9,14,0
347262,2,0,7,-7,1,1
255137,1,0,0,0,12,1
137050,2,7,3,4,11,1
84749,3,10,24,-14,4,1
60799,2,10,9,1,11,0
374536,2,14,6,8,14,1
356628,1,0,0,0,5,0
163657,4,21,36,-15,5,0
327574,3,10,15,-5,10,1
382548,3,0,10,-10,17,0
161230,2,7,3,4,4,1
216357,3,14,13,1,12,0
336677,1,0,3,-3,14,1
250527,3,16,7,9,9,0
420355,4,17,10,7,17,0
252126,2,7,10,-3,10,0
254857,1,0,0,0,12,1
164075,3,3,6,-3,5,1
267701,3,14,24,-10,17,0
117061,3,0,17,-17,2,0
182604,2,0,6,-6,14,1
58222,2,0,3,-3,10,1
28706,3,3,13,-10,14,0
102606,2,5,6,-1,13,1
400305,1,0,0,0,8,0
58757,3,10,20,-10,10,0
277982,2,0,7,-7,4,1
283385,1,7,7,0,7,0
155444,4,13,10,3,2,0
66698,4,10,31,-21,14,1
364012,4,6,12,-6,8,1
246146,2,7,0,7,7,0
165626,1,0,0,0,6,0
305092,2,21,10,11,16,1
1474,1,0,3,-3,1,1
294876,4,49,21,28,12,0
65360,4,13,21,-8,13,0
347979,4,0,24,-24,1,1
187306,4,10,13,-3,16,1
10862,4,27,21,6,5,0
184908,1,0,7,-7,15,1
196284,4,21,10,11,2,0
181233,2,0,0,0,13,0
91835,4,24,6,18,8,0
135,4,10,10,0,1,0
327048,4,14,17,-3,9,1
377664,2,16,7,9,15,0
377113,2,10,10,0,15,0
7469,3,29,6,23,4,1
192075,1,0,0,0,1,0
372443,2,6,14,-8,13,1
134609,2,24,10,14,10,0
149515,2,14,6,8,16,0
179032,1,0,0,0,12,1
317842,3,9,10,-1,5,0
401177,4,51,13,38,8,1
72461,2,7,10,-3,16,1
77577,4,27,14,13,1,0
223494,2,7,3,4,15,0
349414,2,0,7,-7,2,0
36076,3,31,0,31,17,0
233830,1,0,0,0,2,1
238555,4,16,20,-4,4,1
110293,2,0,17,-17,16,0
48887,3,12,0,12,5,0
237837,2,7,13,-6,4,0
313997,1,0,0,0,3,1
235066,1,0,7,-7,2,0
101906,3,6,13,-7,12,0
270503,1,0,7,-7,1,0
403918,3,20,14,6,10,0
58840,1,0,0,0,10,1
377268,3,14,3,11,15,0
370096,1,7,0,7,12,0
173267,1,0,3,-3,10,1
413563,2,6,10,-4,14,1
188515,1,0,3,-3,16,1
350114,4,30,27,3,2,0
38769,1,0,3,-3,1,0
118721,4,20,9,11,2,0
321398,2,14,10,4,7,0
132743,4,13,17,-4,9,1
287033,3,19,24,-5,8,0
5081,3,13,6,7,3,0
377922,4,30,16,14,15,0
187585,4,13,23,-10,16,1
71138,2,12,0,12,16,0
196710,3,33,0,33,3,0
156559,4,14,6,8,2,1
85106,1,0,0,0,4,0
161243,2,14,3,11,4,1
306529,4,17,20,-3,17,1
88212,4,17,17,0,6,0
186723,1,0,0,0,15,0
346905,4,23,16,7,1,1
12045,4,27,14,13,6,1
40050,3,20,7,13,1,1
238107,5,13,13,0,4,0
72432,1,7,0,7,16,0
89785,1,3,0,3,7,0
13714,2,0,14,-14,7,0
281247,4,27,19,8,6,1
391970,1,0,0,0,4,0
78867,2,10,0,10,2,1
234159,2,3,7,-4,2,0
39874,2,6,7,-1,1,1
166755,3,13,9,4,6,1
354677,4,10,17,-7,4,1
403129,1,7,0,7,9,0
325226,4,13,26,-13,8,1
201786,2,13,0,13,5,1
128284,1,0,0,0,7,1
168288,2,10,7,3,7,0
310365,4,29,0,29,2,1
100243,4,17,14,3,12,0
72245,4,24,17,7,16,1
420031,3,17,14,3,17,0
69603,3,7,17,-10,15,1
47660,2,3,17,-14,5,1
320628,4,38,18,20,6,0
357938,1,7,6,1,6,0
381663,2,16,0,16,17,1
274507,2,14,6,8,3,1
33337,1,3,0,3,16,0
78908,4,17,10,7,2,1
171535,4,30,10,20,9,0
395319,1,14,0,14,5,0
173803,3,17,3,14,10,1
338952,2,6,0,6,15,1
190637,2,14,7,7,17,1
416366,4,16,6,10,15,1
211670,2,23,3,20,9,0
239291,3,3,7,-4,4,0
112307,4,45,17,28,17,0
304813,3,0,3,-3,16,1
89073,2,12,6,6,6,1
363097,2,7,3,4,8,0
270555,3,10,14,-4,1,1
176329,2,13,14,-1,11,1
314096,4,33,20,13,3,0
289068,4,41,28,13,9,0
200420,2,10,18,-8,4,0
264598,3,12,17,-5,16,1
217841,2,3,14,-11,12,1
271100,1,0,7,-7,1,0
130255,4,9,26,-17,8,0
150721,2,6,6,0,17,0
222550,4,17,14,3,14,0
346773,1,0,0,0,1,0
288752,4,3,10,-7,9,0
265571,1,0,2,-2,16,0
52128,4,23,19,4,7,0
327737,3,6,13,-7,10,0
203829,4,17,24,-7,6,1
326533,3,44,9,35,9,0
228798,2,3,14,-11,17,0
52958,2,14,17,-3,7,1
74913,1,7,0,7,17,0
134875,1,7,0,7,10,1
39966,1,0,0,0,1,0
323633,2,10,0,10,8,1
331719,2,3,13,-10,12,0
300422,1,2,0,2,14,0
224135,2,0,17,-17,15,0
295887,3,10,14,-4,12,1
86089,2,28,0,28,5,1
237874,3,7,27,-20,4,0
22218,4,10,15,-5,11,1
39467,4,13,10,3,1,0
255159,1,7,0,7,12,0
1962,2,10,2,8,1,0
258813,2,7,7,0,13,0
370549,1,6,0,6,12,1
349141,2,20,7,13,2,0
19866,2,10,21,-11,10,1
172490,1,0,0,0,9,1
227266,2,3,13,-10,16,0
36927,2,0,16,-16,17,0
84558,1,7,7,0,4,0
351497,2,0,24,-24,3,0
54060,3,10,3,7,8,1
272480,1,0,0,0,2,0
390562,3,17,14,3,3,1
263251,4,17,23,-6,15,0
336797,4,10,17,-7,14,0
350931,3,6,14,-8,3,0
45950,4,17,3,14,4,0
348636,1,0,3,-3,2,1
133156,2,10,17,-7,9,0
62956,1,0,7,-7,12,1
366431,3,26,10,16,10,1
343463,2,7,7,0,16,0
353916,4,17,28,-11,4,1
146566,3,14,24,-10,15,1
345257,3,13,14,-1,17,0
278724,1,0,0,0,5,0
74369,2,7,10,-3,17,1
180759,2,7,6,1,13,1
346256,3,40,3,37,1,1
150798,4,20,9,11,17,0
1549,3,6,13,-7,1,1
11872,4,41,17,24,6,0
215263,4,10,16,-6,11,0
22765,3,3,21,-18,11,1
332006,2,0,3,-3,12,1
244428,4,3,20,-17,7,0
266921,2,13,0,13,17,0
363515,2,3,2,1,8,1
83596,4,3,17,-14,4,0
179814,1,0,0,0,13,1
112701,2,3,0,3,17,1
387579,3,6,3,3,2,0
391158,3,10,24,-14,4,0
45801,4,13,14,-1,4,1
197521,1,0,0,0,3,0
54208,2,0,3,-3,8,0
398576,1,0,0,0,7,1
84210,4,17,10,7,4,0
407593,3,10,17,-7,11,1
205391,4,27,0,27,6,1
361837,4,44,10,34,7,0
51841,1,0,0,0,7,1
365006,3,17,6,11,9,1
369670,1,13,7,6,11,1
228762,1,0,7,-7,17,0
230373,1,0,0,0,1,0
321527,1,0,0,0,7,0
368406,2,14,7,7,11,0
39129,3,13,10,3,1,1
121480,2,6,0,6,4,0
117148,1,6,3,3,2,1
383078,2,20,7,13,17,0
392663,3,13,0,13,4,1
109992,2,17,10,7,16,1
171987,4,21,28,-7,9,1
92053,1,0,0,0,8,1
314081,3,30,14,16,3,0
248659,4,24,10,14,9,1
180940,2,17,7,10,13,0
264176,4,34,27,7,15,0
207443,2,14,14,0,7,1
118654,2,14,6,8,2,0
82542,4,17,27,-10,3,0
214892,2,0,12,-12,11,1
367619,4,31,12,19,10,0
349384,1,0,0,0,2,1
142698,1,0,0,0,13,0
376924,1,3,3,0,15,1
107306,2,3,0,3,15,0
11725,4,27,10,17,6,0
35531,4,30,7,23,17,0
84743,3,10,17,-7,4,0
261968,2,14,10,4,14,1
71072,4,27,0,27,16,0
217848,2,3,14,-11,12,1
248396,1,10,0,10,8,0
70819,1,0,0,0,15,1
286599,3,17,38,-21,8,1
315726,4,17,22,-5,4,1
364292,3,3,29,-26,9,1
87308,4,24,17,7,6,0
192526,4,14,17,-3,1,1
261995,3,17,17,0,14,0
25380,2,6,0,6,12,1
368251,2,3,3,0,11,1
72846,4,38,17,21,16,1
111132,4,31,10,21,16,0
95678,2,10,3,7,10,0
247643,1,0,0,0,8,1
413458,4,17,38,-21,14,1
63977,1,7,0,7,13,0
103658,2,0,7,-7,13,1
419210,4,17,6,11,16,1
420676,4,21,16,5,17,0
194680,4,34,10,24,2,1
324448,4,14,6,8,8,1
326829,3,10,14,-4,9,1
40202,4,34,7,27,2,0
94057,3,6,21,-15,9,0
320485,4,20,17,3,6,1
418473,3,17,6,11,16,0
359444,2,0,14,-14,6,1
316554,2,3,3,0,4,0
255090,4,6,28,-22,12,0
295834,1,0,7,-7,12,1
319898,1,6,0,6,6,0
98808,1,0,0,0,11,1
300294,2,0,7,-7,14,0
214095,2,3,3,0,11,1
115641,1,0,0,0,1,0
388027,3,6,6,0,2,1
148552,1,0,0,0,16,0
101938,4,9,13,-4,12,0
243923,3,19,12,7,6,0
319673,3,26,3,23,6,1
245678,1,3,3,0,7,0
371293,2,7,10,-3,12,1
122553,2,14,0,14,4,0
175799,1,13,0,13,11,1
107560,1,0,0,0,15,1
200351,4,30,14,16,4,1
304472,2,0,7,-7,16,1
114495,2,17,17,0,1,0
300879,2,3,7,-4,15,0
140241,1,0,0,0,12,0
21623,4,7,38,-31,11,0
223027,1,7,0,7,14,0
144309,4,29,7,22,14,0
373426,4,10,17,-7,13,1
339631,4,31,17,14,15,0
17336,2,14,0,14,9,0
130659,3,7,35,-28,8,1
273884,1,0,3,-3,2,1
198950,3,13,23,-10,3,0
46707,1,0,0,0,4,1
336761,3,10,10,0,14,0
241282,3,10,0,10,5,0
162296,1,3,0,3,4,0
115032,4,20,19,1,1,0
68437,4,3,21,-18,14,1
252992,4,16,13,3,11,0
391585,3,10,21,-11,4,0
330588,4,21,7,14,11,1
298787,2,14,6,8,14,0
322080,3,26,0,26,7,1
8903,2,14,0,14,4,1
51563,1,0,0,0,7,1
130894,1,0,0,0,8,0
242817,4,21,34,-13,6,0
204856,2,3,3,0,6,1
305852,2,6,14,-8,17,1
352013,4,28,21,7,3,0
228273,4,17,36,-19,17,1
93958,1,0,0,0,9,0
361920,2,7,0,7,7,0
106681,1,0,0,0,14,1
90758,3,17,7,10,7,1
122923,4,37,6,31,4,0
377151,3,13,10,3,15,0
270475,4,13,7,6,1,1
89409,3,10,20,-10,7,1
214422,2,7,7,0,11,0
339361,1,0,0,0,15,0
273902,2,7,3,4,2,0
359046,3,10,6,4,6,0
256597,3,14,0,14,12,1
139148,3,18,6,12,12,1
18823,1,3,0,3,9,1
279428,3,16,24,-8,5,1
239799,1,0,0,0,4,0
307873,4,27,42,-15,1,1
240141,2,13,3,10,5,1
203180,2,7,17,-10,5,1
413155,4,33,42,-9,14,1
253375,2,7,14,-7,11,0
356432,1,0,0,0,5,0
357600,4,16,16,0,5,1
191264,3,7,17,-10,17,1
334705,3,15,3,12,13,1
383286,3,45,17,28,17,1
143719,4,19,17,2,14,0
64283,2,3,10,-7,13,1
113085,4,16,23,-7,17,1
396426,3,20,18,2,6,0
184367,2,14,6,8,14,0
120126,3,10,3,7,3,0
280257,2,6,13,-7,5,0
143552,4,20,28,-8,14,1
344299,4,19,13,6,17,0
166737,2,13,3,10,6,0
361515,3,7,7,0,7,1
36348,2,13,13,0,17,0
50370,1,0,0,0,6,1
71183,3,19,10,9,16,0
76483,2,0,14,-14,1,0
26623,4,10,6,4,13,0
414457,4,16,23,-7,14,1
151555,1,0,0,0,17,0
52843,3,14,37,-23,7,0
276979,4,17,20,-3,4,1
89242,3,6,0,6,7,1
329471,2,3,0,3,10,1
384192,4,29,20,9,1,1
396131,3,17,23,-6,6,0
185330,1,0,0,0,15,1
19548,2,0,7,-7,10,1
78547,2,10,7,3,2,1
411681,4,37,28,9,13,0
324554,2,10,9,1,8,1
243200,1,0,0,0,6,0
66593,2,0,14,-14,14,1
10863,4,27,21,6,5,0
107949,3,6,6,0,15,0
207818,1,0,0,0,8,0
13450,2,3,21,-18,7,1
75767,3,35,26,9,1,1
384354,4,16,17,-1,1,1
139831,3,10,10,0,12,1
25992,3,10,16,-6,13,0
101695,2,10,0,10,12,0
204957,4,13,27,-14,6,1
206154,4,27,19,8,7,0
128549,4,21,35,-14,7,1
154906,2,13,10,3,1,0
188086,2,0,3,-3,16,0
376871,4,28,14,14,15,0
68882,4,6,20,-14,15,0
13859,1,7,0,7,7,0
211206,3,14,10,4,9,0
153545,2,5,14,-9,1,1
169809,3,3,17,-14,8,0
58563,3,10,10,0,10,1
255554,4,30,7,23,12,1
14301,2,2,7,-5,7,1
11504,2,6,7,-1,6,0
223466,1,0,0,0,15,0
283557,2,6,17,-11,7,1
238664,3,16,14,2,4,0
206326,4,24,6,18,7,0
157235,2,7,3,4,2,1
200646,4,27,28,-1,4,1
115318,4,20,15,5,1,0
9879,2,0,0,0,5,0
318193,4,22,20,2,5,0
312958,1,0,0,0,3,1
340476,2,0,13,-13,15,1
65648,4,6,19,-13,13,1
392935,2,6,3,3,4,1
77867,4,17,31,-14,1,0
283759,3,11,3,8,7,1
155345,2,10,3,7,2,1
254496,4,29,13,16,11,0
34839,1,7,0,7,16,1
64901,3,10,3,7,13,1
385673,5,27,24,3,1,0
37518,3,10,7,3,17,0
321263,2,6,9,-3,6,0
362973,3,27,16,11,8,1
388739,2,11,0,11,3,1
66817,4,13,6,7,14,0
149696,2,20,0,20,16,1
417967,2,14,21,-7,16,1
312616,1,0,0,0,3,0
265555,4,20,13,7,16,1
372045,3,13,9,4,13,0
55647,1,10,7,3,9,0
70477,3,20,17,3,15,0
78604,3,23,13,10,2,0
145294,2,14,9,5,14,0
343674,3,15,10,5,17,1
342161,4,15,19,-4,16,1
217754,3,10,7,3,12,1
159326,4,27,24,3,3,0
149577,3,14,23,-9,16,1
132361,1,0,0,0,9,0
366619,4,26,14,12,10,1
410145,3,17,10,7,13,0
148895,1,3,6,-3,16,0
2958,2,7,10,-3,2,1
272690,2,9,3,6,2,1
234416,1,7,0,7,2,0
325868,1,0,0,0,9,1
411726,2,0,3,-3,13,0
2771,1,7,0,7,2,0
195527,2,6,0,6,2,0
408430,2,0,0,0,12,1
214347,1,0,0,0,11,1
174627,1,3,0,3,10,0
138584,1,0,0,0,12,1
147170,4,17,49,-32,15,1
378514,1,0,0,0,15,0
106407,1,7,0,7,14,1
118915,1,0,0,0,3,0
399873,1,0,0,0,8,0
303705,1,7,7,0,16,0
266369,3,30,0,30,16,0
175800,1,14,0,14,11,0
197342,4,20,10,10,3,0
181124,3,24,14,10,13,0
63703,1,7,0,7,12,0
269354,2,7,13,-6,1,0
7658,4,34,3,31,4,0
345254,3,13,14,-1,17,0
386400,4,20,9,11,2,1
251396,3,30,14,16,10,0
395069,3,0,24,-24,5,1
344661,2,3,10,-7,17,0
397551,1,6,7,-1,7,0
248465,3,10,6,4,8,1
224172,3,0,20,-20,15,1
377200,1,0,0,0,15,0
383783,2,3,0,3,1,1
124159,4,19,21,-2,5,1
325375,4,15,20,-5,8,1
84605,3,13,10,3,4,1
169598,1,3,0,3,8,1
389887,1,6,3,3,3,0
382236,2,10,3,7,17,1
334571,3,24,24,0,13,1
61414,3,13,3,10,11,1
206891,3,10,17,-7,7,0
156355,3,24,0,24,2,1
390389,3,7,20,-13,3,0
231589,2,14,3,11,1,0
277236,2,0,13,-13,4,1
206896,4,10,17,-7,7,0
228473,2,10,0,10,17,0
280229,1,3,0,3,5,0
318886,3,21,15,6,5,0
18883,3,9,13,-4,9,0
30726,3,17,21,-4,15,0
116141,2,7,3,4,1,0
151363,3,31,14,17,17,0
165421,4,6,36,-30,6,1
17110,3,23,10,13,9,0
390555,3,17,7,10,3,0
130142,1,0,9,-9,8,1
26560,2,10,3,7,13,0
149753,4,55,0,55,16,0
65480,3,23,14,9,13,1
24555,3,10,13,-3,12,1
94034,2,6,21,-15,9,0
384844,2,6,10,-4,1,1
283172,4,20,9,11,7,1
176514,3,12,17,-5,11,0
11969,2,14,7,7,6,1
39692,2,3,0,3,1,1
146421,4,16,3,13,15,0
351628,1,0,7,-7,3,1
211030,2,17,0,17,9,1
388157,3,3,6,-3,2,0
32414,3,31,6,25,15,0
362377,3,30,14,16,8,0
129755,4,17,17,0,7,0
346932,1,0,3,-3,1,0
296383,4,13,28,-15,13,1
136762,3,13,10,3,11,1
269098,4,13,16,-3,17,1
106259,1,0,0,0,14,0
85815,3,13,13,0,5,0
168223,1,0,0,0,7,1
63864,2,3,14,-11,12,0
357206,1,0,0,0,5,1
352638,1,0,0,0,3,0
382738,4,9,20,-11,17,1
62828,1,0,0,0,12,1
5415,4,20,16,4,3,0
277739,3,7,6,1,4,1
116189,4,14,19,-5,1,1
274915,4,14,16,-2,3,0
53063,1,10,7,3,7,1
396313,4,6,13,-7,6,0
149400,3,6,20,-14,16,0
369197,4,22,20,2,11,1
181635,4,23,6,17,13,1
104055,1,7,0,7,13,0
50063,1,0,7,-7,6,1
108809,2,0,10,-10,15,0
150629,4,10,22,-12,17,0
251969,2,0,10,-10,10,1
230960,1,0,0,0,1,1
338231,3,14,24,-10,14,1
59891,1,3,0,3,11,0
369298,3,14,17,-3,11,1
414668,2,0,7,-7,14,1
263448,2,6,13,-7,15,1
387455,4,21,16,5,2,1
145507,4,23,17,6,14,1
304128,4,16,30,-14,16,1
96404,1,0,7,-7,10,1
11544,3,6,10,-4,6,1
52004,2,3,7,-4,7,1
201806,3,13,10,3,5,0
239041,4,36,21,15,4,1
298268,3,20,13,7,14,1
82950,3,6,16,-10,4,0
223071,2,23,7,16,14,1
189250,4,53,11,42,16,0
21319,4,6,14,-8,11,0
6610,1,0,0,0,3,0
374427,3,18,0,18,14,0
264074,2,7,20,-13,15,1
419046,3,7,20,-13,16,0
185406,3,7,10,-3,15,0
163385,1,0,6,-6,5,0
7543,1,7,0,7,4,0
373962,2,7,0,7,13,1
180356,3,15,14,1,13,0
266969,3,16,10,6,17,1
273788,2,10,7,3,2,0
302979,3,20,16,4,16,1
287276,1,0,0,0,8,0
287911,2,7,10,-3,9,1
418892,3,13,10,3,16,0
224126,2,0,10,-10,15,0
293994,4,7,28,-21,12,1
272033,2,7,3,4,2,1
318796,4,17,29,-12,5,1
342765,3,7,14,-7,16,0
379329,3,10,13,-3,16,1
67628,3,7,35,-28,14,0
341977,2,6,0,6,16,1
109115,2,10,7,3,15,0
341693,3,23,13,10,16,0
242883,2,14,13,1,6,0
240136,2,13,3,10,5,1
393515,1,7,6,1,5,0
204814,4,28,31,-3,6,0
330100,3,0,13,-13,11,0
335828,2,7,7,0,13,0
126998,3,17,10,7,6,0
251119,3,10,14,-4,10,0
196068,2,3,21,-18,2,1
164291,1,6,0,6,5,1
371967,1,3,0,3,13,1
378475,4,20,0,20,15,1
62147,3,7,14,-7,12,1
329263,4,31,13,18,10,1
400705,4,16,10,6,8,1
293958,3,7,21,-14,12,1
95803,2,6,3,3,10,0
140808,4,22,30,-8,12,0
38317,1,0,0,0,1,1
156785,2,14,13,1,2,1
183481,4,27,6,21,14,0
19176,3,21,13,8,10,1
245916,3,6,37,-31,7,1
54242,3,0,3,-3,8,1
110156,3,13,17,-4,16,1
421774,1,0,0,0,17,1
371261,1,0,7,-7,12,1
407393,2,0,7,-7,11,1
372836,4,6,0,6,13,1
134781,3,33,10,23,10,1
388482,3,3,16,-13,2,1
140253,1,0,0,0,12,1
82988,4,13,19,-6,4,1
263576,1,0,7,-7,15,1
309451,4,14,6,8,1,0
237149,4,14,40,-26,3,1
295011,4,31,21,10,12,0
100515,3,10,17,-7,12,0
236832,4,3,9,-6,3,0
82922,2,3,3,0,4,0
353692,2,3,7,-4,4,1
24244,3,13,17,-4,12,0
379851,1,7,0,7,16,1
214587,2,3,3,0,11,0
359144,2,7,0,7,6,0
315352,2,10,10,0,4,1
230430,3,14,3,11,1,1
261295,4,38,0,38,14,1
263536,4,20,29,-9,15,1
205698,3,20,19,1,7,1
238307,1,3,9,-6,4,0
408848,4,16,28,-12,12,0
411599,2,14,13,1,13,0
307616,2,7,7,0,17,0
27163,2,6,7,-1,13,1
222945,3,13,13,0,14,0
210346,4,16,17,-1,9,1
61964,2,3,0,3,12,1
117697,4,27,20,7,2,1
415741,3,14,10,4,15,0
384507,4,28,12,16,1,1
108634,1,6,0,6,15,1
12124,3,7,14,-7,6,1
412718,4,40,13,27,14,0
134006,1,0,0,0,9,0
297471,1,0,0,0,13,0
46101,4,21,21,0,4,1
201537,4,32,14,18,5,0
34196,1,6,0,6,16,1
78307,3,10,21,-11,2,1
309637,1,0,0,0,1,0
283207,1,0,0,0,7,1
48246,2,3,10,-7,5,0
166459,3,17,10,7,6,0
328204,4,14,17,-3,10,1
352767,1,7,0,7,3,0
388694,1,0,0,0,3,1
71217,4,19,20,-1,16,0
369897,3,7,9,-2,12,1
163451,3,10,23,-13,5,0
323666,3,20,0,20,8,1
322001,1,3,0,3,7,0
165157,5,24,24,0,6,0
171790,3,23,14,9,9,0
286809,1,3,0,3,8,1
171942,3,14,7,7,9,0
253708,2,10,3,7,11,1
208369,3,17,30,-13,8,1
363128,3,7,3,4,8,1
160518,3,20,14,6,4,0
341973,2,6,0,6,16,1
233098,2,8,0,8,2,0
325803,3,6,10,-4,9,0
358145,3,17,6,11,6,1
296974,4,29,7,22,13,0
265894,2,0,9,-9,16,0
731,4,6,24,-18,1,0
143911,2,0,0,0,14,0
184514,2,17,14,3,14,0
150601,3,3,13,-10,17,0
233533,1,0,7,-7,2,1
19416,2,14,7,7,10,1
186443,2,10,10,0,15,1
111645,2,14,10,4,16,1
330070,2,0,3,-3,11,0
77436,4,27,21,6,1,1
9274,1,7,0,7,5,0
177913,4,21,23,-2,12,1
63408,1,0,3,-3,12,1
294914,1,0,7,-7,12,0
415360,4,14,24,-10,15,1
405105,2,0,10,-10,10,0
395686,4,10,34,-24,6,1
327170,4,27,17,10,9,1
224245,1,6,3,3,15,0
358005,3,24,13,11,6,1
210449,2,9,14,-5,9,1
20858,3,21,9,12,10,1
50516,1,0,0,0,6,0
257893,4,16,19,-3,13,0
421452,4,38,20,18,17,1
88863,4,20,16,4,6,0
185877,2,9,10,-1,15,1
302070,2,20,24,-4,15,0
189264,1,0,0,0,16,0
193700,2,3,20,-17,1,0
387886,3,10,28,-18,2,1
166630,3,22,20,2,6,0
396544,2,17,7,10,6,0
14086,4,3,31,-28,7,1
212771,3,10,21,-11,10,1
31056,3,10,13,-3,15,1
151749,2,7,6,1,17,0
167075,4,13,31,-18,7,1
252626,2,6,3,3,10,0
140831,1,7,0,7,13,0
122009,3,16,10,6,4,0
417437,1,0,7,-7,16,1
3503,4,16,30,-14,2,1
163862,1,0,7,-7,5,1
101355,1,6,0,6,12,1
121407,4,7,12,-5,3,0
259707,1,10,7,3,14,0
341698,3,23,13,10,16,1
71109,1,6,0,6,16,0
71851,1,9,0,9,16,1
288938,1,6,0,6,9,0
341542,3,6,10,-4,16,1
362398,4,30,20,10,8,0
267703,3,14,24,-10,17,0
345364,1,0,7,-7,17,0
140755,3,15,14,1,12,0
92348,1,0,0,0,8,1
95558,3,9,10,-1,10,0
401260,2,7,14,-7,8,1
99110,4,23,7,16,11,0
46151,1,7,7,0,4,0
52029,2,3,10,-7,7,1
280274,2,13,13,0,5,0
45612,3,10,13,-3,4,0
301412,1,0,0,0,15,1
263041,3,10,3,7,15,0
402042,4,3,19,-16,9,0
391767,4,10,13,-3,4,0
55410,3,13,10,3,9,0
127451,2,3,7,-4,6,0
282845,4,9,20,-11,6,1
63151,2,14,10,4,12,0
273312,2,21,0,21,2,1
406955,2,3,13,-10,11,0
360541,1,0,7,-7,7,0
403864,2,10,0,10,10,0
39355,1,0,0,0,1,0
389902,2,12,3,9,3,0
372829,4,6,0,6,13,0
98571,2,0,7,-7,11,1
208750,2,3,6,-3,8,0
400958,2,16,7,9,8,1
126987,2,10,10,0,6,1
44519,1,0,0,0,3,0
343657,3,15,10,5,17,0
129186,1,7,0,7,7,0
210322,3,16,10,6,9,0
116517,1,0,0,0,2,1
206003,4,16,10,6,7,0
337185,2,3,10,-7,14,1
66133,1,0,0,0,13,1
68482,2,0,7,-7,14,0
248122,1,0,3,-3,8,1
209645,1,3,0,3,8,0
108784,1,0,7,-7,15,1
22232,1,0,0,0,11,1
187003,4,16,15,1,15,0
45791,4,13,14,-1,4,0
252703,4,6,10,-4,10,0
1641,1,0,0,0,1,0
371247,4,25,22,3,12,1
177235,2,7,7,0,11,0
201487,3,19,7,12,5,1
145476,3,16,17,-1,14,0
343133,1,0,0,0,16,1
323374,3,17,0,17,7,0
326566,4,51,22,29,9,0
1482,1,0,3,-3,1,0
414608,4,28,9,19,14,0
211232,4,21,20,1,9,0
115199,1,0,0,0,1,0
340334,2,17,7,10,15,0
294810,2,27,14,13,12,1
85891,1,7,7,0,5,0
103293,4,3,10,-7,13,0
153852,2,0,3,-3,1,1
23498,3,14,14,0,11,1
369367,1,0,0,0,11,1
80646,3,10,16,-6,3,1
212313,2,10,3,7,10,1
223218,2,3,6,-3,15,0
377600,4,20,12,8,15,0
131328,1,0,0,0,8,0
202879,2,21,0,21,5,1
60002,4,3,31,-28,11,0
73720,4,20,12,8,17,1
366490,1,6,0,6,10,1
221229,2,0,16,-16,14,1
419433,2,10,3,7,16,0
361506,2,7,7,0,7,1
370614,3,14,14,0,12,0
260123,4,6,28,-22,14,0
414773,4,10,17,-7,14,1
249066,2,21,17,4,9,0
26074,1,0,3,-3,13,0
191071,2,7,0,7,17,0
335018,3,16,10,6,13,1
65750,3,14,16,-2,13,0
168389,1,0,3,-3,7,1
7359,5,20,19,1,4,0
312111,3,30,10,20,2,1
386020,1,7,0,7,1,0
212216,4,3,24,-21,10,0
281419,1,0,10,-10,6,0
162083,3,28,13,15,4,1
79994,1,7,0,7,2,0
158532,3,10,17,-7,3,1
199344,2,0,0,0,4,0
21326,4,6,17,-11,11,1
14573,1,0,7,-7,7,1
132481,4,8,31,-23,9,1
264939,3,23,17,6,16,0
398032,2,14,14,0,7,0
210891,2,12,3,9,9,0
285088,2,3,0,3,7,1
93238,4,3,27,-24,9,1
133383,4,21,9,12,9,0
386,3,28,10,18,1,0
359728,2,17,6,11,6,0
87615,4,17,10,7,6,0
117534,4,17,17,0,2,0
247919,4,20,6,14,8,0
162343,2,3,10,-7,4,1
244083,3,20,27,-7,6,1
208926,3,13,6,7,8,1
189886,1,0,7,-7,17,0
275307,2,10,8,2,3,0
349553,2,3,21,-18,2,1
291298,3,21,19,2,10,0
149096,3,14,17,-3,16,1
97289,4,27,20,7,10,1
192428,2,0,17,-17,1,1
236424,1,0,0,0,3,1
13606,3,10,7,3,7,1
274992,2,21,3,18,3,0
120130,3,10,3,7,3,0
234746,1,0,0,0,2,0
85247,4,17,17,0,4,1
229093,2,10,7,3,17,1
401465,4,27,10,17,8,0
150782,4,19,9,10,17,1
396244,2,0,3,-3,6,1
193014,5,20,20,0,1,1
312422,4,26,41,-15,3,1
262886,3,14,23,-9,15,0
88619,2,20,7,13,6,1
310152,3,21,7,14,2,1
403529,1,0,0,0,9,1
291907,3,17,10,7,11,1
194892,2,0,10,-10,2,1
389667,3,24,16,8,3,0
28372,2,6,0,6,14,1
162658,2,16,10,6,5,0
302068,2,19,24,-5,15,1
373826,2,13,0,13,13,0
35380,4,23,16,7,16,0
51555,1,0,0,0,7,0
250910,1,0,3,-3,10,1
229832,2,6,0,6,17,0
212660,4,7,31,-24,10,1
119955,2,6,24,-18,3,1
40909,3,13,20,-7,2,1
214581,2,3,3,0,11,1
164896,2,0,3,-3,6,1
112814,1,0,0,0,17,1
228198,2,10,27,-17,17,0
287659,3,9,10,-1,9,0
152201,2,14,0,14,17,1
290963,2,17,10,7,10,1
141382,3,10,17,-7,13,1
8073,3,17,7,10,4,0
34846,2,10,0,10,16,0
106920,3,9,3,6,14,1
44533,1,0,7,-7,3,1
25790,1,0,0,0,12,1
103479,2,6,0,6,13,0
402297,3,20,16,4,9,0
146918,4,41,0,41,15,0
255303,1,0,0,0,12,1
344685,3,6,20,-14,17,1
214206,1,0,0,0,11,0
148385,4,17,6,11,16,0
145889,2,0,0,0,15,0
107922,2,3,3,0,15,1
271479,3,14,0,14,1,1
405336,4,14,12,2,10,1
231990,1,0,7,-7,1,1
287095,4,33,32,1,8,0
363478,1,0,0,0,8,0
328965,3,16,7,9,10,0
150114,1,0,6,-6,16,1
83065,2,6,14,-8,4,0
183213,2,7,0,7,14,0
57758,2,16,3,13,10,1
245801,4,30,23,7,7,0
42955,3,24,23,1,3,1
195482,1,0,0,0,2,0
304702,4,21,7,14,16,0
294895,1,0,0,0,12,0
208254,1,0,0,0,8,1
147161,4,17,46,-29,15,0
34636,4,24,10,14,16,0
192631,2,3,7,-4,1,1
128298,1,0,0,0,7,0
325795,3,6,10,-4,9,1
48677,2,7,7,0,5,0
93053,4,13,12,1,8,1
412907,1,0,3,-3,14,1
369402,2,17,6,11,11,0
118600,4,31,10,21,2,1
21302,3,3,14,-11,11,0
421480,1,0,0,0,17,0
347826,4,16,0,16,1,0
315319,1,3,3,0,4,1
340705,4,22,20,2,15,0
43269,4,24,10,14,3,0
232346,3,6,12,-6,1,0
291971,1,0,0,0,11,0
404118,1,6,0,6,10,1
200003,3,17,17,0,4,1
111346,2,0,7,-7,16,1
284348,3,6,17,-11,7,1
401689,2,3,14,-11,8,0
88550,4,29,14,15,6,1
248587,2,7,3,4,9,1
310018,3,9,10,-1,2,1
138006,2,19,14,5,11,0
290568,4,23,20,3,10,0
169223,3,10,6,4,7,1
64285,2,3,10,-7,13,1
167553,4,3,10,-7,7,0
67745,3,21,0,21,14,1
47217,3,9,9,0,5,1
45097,1,0,0,0,4,0
347058,4,27,17,10,1,0
223517,2,7,10,-3,15,0
32731,4,7,24,-17,15,1
293472,1,0,3,-3,11,1
240425,1,0,0,0,5,1
30322,3,3,10,-7,14,1
220799,2,0,0,0,14,0
397819,1,0,0,0,7,1
93697,2,0,0,0,9,0
227720,2,0,0,0,16,1
225276,1,0,7,-7,15,1
163749,2,0,9,-9,5,0
111729,4,37,16,21,16,0
283130,2,6,3,3,7,0
367840,2,10,10,0,10,1
62498,4,13,16,-3,12,0
53547,2,14,9,5,8,1
386648,2,7,13,-6,2,0
332464,3,16,6,10,12,1
277890,3,7,20,-13,4,1
368910,4,38,3,35,11,0
384792,1,6,3,3,1,1
24094,3,7,7,0,12,0
185070,2,0,3,-3,15,1
276433,1,0,0,0,4,1
187475,1,0,3,-3,16,1
331493,4,9,29,-20,11,1
292934,3,7,0,7,11,1
312177,1,0,0,0,2,0
19689,1,3,6,-3,10,0
57492,2,21,10,11,10,0
176635,2,7,12,-5,11,1
209926,4,37,16,21,8,0
295392,2,10,10,0,12,1
344365,2,14,7,7,17,1
102450,2,3,3,0,13,1
273553,4,28,35,-7,2,0
227961,4,30,27,3,16,1
370870,2,3,3,0,12,1
149605,4,17,26,-9,16,0
372026,3,13,3,10,13,1
321758,3,9,6,3,7,1
202270,2,3,0,3,5,1
374614,4,20,20,0,14,0
298522,2,10,0,10,14,1
340,2,14,10,4,1,1
264699,1,7,6,1,16,0
297594,4,21,7,14,13,1
312352,2,10,17,-7,3,1
2644,1,3,0,3,2,0
232928,2,0,3,-3,2,1
398811,4,14,24,-10,7,1
410477,4,9,23,-14,13,0
79991,1,7,0,7,2,1
36939,2,0,25,-25,17,1
227856,1,7,6,1,16,0
258130,3,13,13,0,13,1
23404,4,20,24,-4,11,0
285989,4,29,14,15,8,0
48512,1,11,0,11,5,0
65281,2,3,14,-11,13,0
390413,3,7,27,-20,3,0
42859,4,13,37,-24,3,0
108474,1,7,0,7,15,0
228389,3,10,17,-7,17,0
157478,4,16,37,-21,2,0
241735,3,7,9,-2,5,1
305888,4,7,14,-7,17,1
404840,4,23,20,3,10,0
228679,3,16,23,-7,17,1
375120,2,7,7,0,14,0
222473,2,6,7,-1,14,0
145662,4,35,7,28,14,0
139259,2,13,6,7,12,0
99899,2,0,3,-3,12,1
114834,3,13,30,-17,1,1
42113,4,27,20,7,2,0
312275,4,10,23,-13,2,1
386660,3,14,13,1,2,0
330005,4,7,13,-6,11,0
403008,2,13,21,-8,9,1
185739,3,20,3,17,15,1
12807,2,3,3,0,6,1
393947,1,0,0,0,5,1
18410,2,0,7,-7,9,1
318873,3,21,15,6,5,1
67237,4,7,3,4,14,0
208848,1,0,0,0,8,1
298678,3,13,7,6,14,1
196443,4,20,21,-1,2,1
355996,2,14,7,7,5,0
145156,2,29,0,29,14,0
412064,3,21,0,21,13,1
257400,3,20,14,6,13,0
251643,1,3,3,0,10,1
245776,4,16,20,-4,7,1
158028,2,0,6,-6,3,1
125898,2,13,10,3,6,0
85768,2,10,7,3,5,1
81423,3,10,13,-3,3,1
83522,2,0,7,-7,4,1
331545,1,7,14,-7,11,0
247730,3,7,6,1,8,0
418218,4,38,6,32,16,1
189212,3,33,3,30,16,0
224698,1,0,0,0,15,1
48271,2,10,13,-3,5,1
119507,4,14,24,-10,3,1
309590,3,16,3,13,1,0
369709,2,22,17,5,11,0
253629,4,9,17,-8,11,0
380225,3,13,16,-3,16,1
284911,2,6,14,-8,7,1
212716,1,0,14,-14,10,1
282721,4,9,27,-18,6,1
262463,3,7,28,-21,15,1
37065,2,13,7,6,17,0
305623,4,23,17,6,17,1
171297,2,0,3,-3,9,1
277121,3,10,17,-7,4,0
149161,4,17,31,-14,16,1
366207,1,0,0,0,10,1
406712,4,27,0,27,11,1
394016,2,6,13,-7,5,0
410909,3,14,15,-1,13,1
1771,1,3,0,3,1,0
68956,2,14,7,7,15,1
112207,1,7,0,7,17,0
112371,2,10,7,3,17,1
32073,3,14,13,1,15,0
73030,2,0,9,-9,16,0
322884,1,6,0,6,7,0
393720,3,0,7,-7,5,0
67334,3,20,6,14,14,0
360574,2,7,10,-3,7,0
186597,2,17,0,17,15,0
340686,4,16,20,-4,15,1
72960,4,31,7,24,16,0
261623,1,0,0,0,14,1
396558,2,17,10,7,6,0
133290,2,7,0,7,9,0
380079,4,35,20,15,16,0
148174,3,6,21,-15,16,0
144524,1,7,7,0,14,0
204425,2,7,10,-3,6,0
3256,2,3,0,3,2,1
329654,3,16,14,2,11,1
208858,1,7,0,7,8,0
189277,1,3,0,3,16,0
231767,3,10,20,-10,1,1
30351,4,10,17,-7,14,0
24267,4,13,17,-4,12,1
235185,1,0,0,0,3,0
78526,1,0,7,-7,2,1
402787,4,30,14,16,9,0
371938,4,34,17,17,12,1
9091,4,30,13,17,4,0
283330,4,10,9,1,7,0
195627,1,7,0,7,2,0
122073,1,0,7,-7,4,1
105747,4,35,10,25,14,0
146542,3,14,17,-3,15,1
39832,1,3,0,3,1,0
184915,2,0,7,-7,15,1
387672,2,0,7,-7,2,0
107100,4,40,6,34,15,0
255954,2,6,12,-6,12,1
107822,4,7,23,-16,15,1
40383,4,15,10,5,2,1
80575,4,16,10,6,3,0
8390,4,30,10,20,4,0
379253,1,0,3,-3,16,1
241430,3,7,35,-28,5,1
33275,3,23,0,23,16,0
114079,3,21,0,21,17,1
152544,4,24,7,17,17,0
170627,4,47,9,38,8,1
169866,4,26,17,9,8,1
316547,2,3,3,0,4,0
111038,1,7,0,7,16,1
45391,4,20,26,-6,4,1
326084,3,30,3,27,9,0
305160,4,27,10,17,16,1
172691,2,14,3,11,9,1
13337,3,7,27,-20,7,1
307629,2,7,7,0,17,1
397102,1,3,0,3,6,0
412275,1,0,0,0,13,1
252108,2,7,7,0,10,0
340416,4,24,13,11,15,0
5399,3,13,16,-3,3,0
265335,2,7,7,0,16,0
267751,4,22,34,-12,17,1
19291,2,14,14,0,10,0
225505,3,0,14,-14,15,0
22380,1,0,0,0,11,0
279808,2,7,3,4,5,0
207575,2,14,3,11,7,1
284187,3,9,20,-11,7,0
269679,3,10,3,7,1,0
315016,1,14,0,14,4,1
319584,1,3,0,3,6,0
53091,2,19,14,5,7,1
266670,3,29,3,26,16,0
322664,4,6,9,-3,7,1
293435,4,35,24,11,11,1
99019,2,6,0,6,11,1
56732,2,0,10,-10,9,0
15741,2,0,3,-3,8,1
68094,3,3,10,-7,14,0
81325,1,0,0,0,3,0
275119,1,7,3,4,3,1
138141,1,7,9,-2,11,0
370264,2,0,14,-14,12,0
102891,1,0,14,-14,13,1
210100,1,0,0,0,9,1
231327,3,9,10,-1,1,0
254800,4,20,10,10,11,1
57551,4,24,16,8,10,1
218859,2,14,3,11,13,0
35568,1,7,0,7,17,0
421655,2,10,7,3,17,0
316299,3,10,16,-6,4,0
173953,4,20,19,1,10,1
259976,4,20,20,0,14,0
346587,4,40,47,-7,1,0
36472,2,3,6,-3,17,1
110418,1,10,0,10,16,0
228309,1,0,0,0,17,0
350490,3,10,19,-9,2,0
287627,2,3,3,0,9,0
242906,3,21,13,8,6,1
338075,3,0,7,-7,14,1
120810,1,7,7,0,3,0
224182,3,0,20,-20,15,0
194173,3,6,10,-4,1,1
17511,2,13,0,13,9,0
421548,3,10,3,7,17,1
227615,3,28,0,28,16,0
322531,4,15,3,12,7,1
361502,2,7,7,0,7,1
4,1,0,0,0,1,0
208670,4,6,6,0,8,1
295186,1,0,0,0,12,1
112909,3,16,6,10,17,1
43585,4,31,3,28,3,0
416466,2,14,10,4,15,1
106726,2,7,12,-5,14,1
333865,4,28,21,7,12,0
405815,5,24,24,0,10,0
266860,5,17,17,0,16,1
388992,4,24,27,-3,3,1
307362,3,16,22,-6,17,0
41794,3,10,14,-4,2,1
127351,3,10,20,-10,6,0
237423,4,12,17,-5,3,0
285909,2,20,0,20,8,1
193805,1,0,0,0,1,1
399351,3,27,7,20,7,1
22078,5,24,24,0,11,0
263163,2,3,13,-10,15,0
95748,4,20,9,11,10,1
225932,2,20,7,13,16,1
416506,4,28,17,11,15,0
393664,1,0,0,0,5,0
251792,1,0,0,0,10,1
342021,4,20,3,17,16,1
132548,2,2,29,-27,9,1
122710,2,7,10,-3,4,0
283006,3,20,3,17,6,1
97659,2,3,3,0,11,0
364409,2,35,7,28,9,0
70462,3,17,17,0,15,1
304660,3,14,7,7,16,1
84759,3,10,24,-14,4,1
98270,2,14,24,-10,11,0
344232,2,7,10,-3,17,0
129584,3,13,20,-7,7,0
337175,2,3,3,0,14,0
330553,3,7,7,0,11,1
415462,3,23,3,20,15,1
321328,3,15,19,-4,6,1
171809,3,23,14,9,9,0
248360,4,29,10,19,8,1
396737,3,7,17,-10,6,0
309674,2,3,3,0,1,0
189784,3,17,6,11,17,0
385889,2,0,7,-7,1,1
374461,4,32,7,25,14,1
160660,2,10,0,10,4,1
235106,2,0,10,-10,2,0
241945,1,0,0,0,5,0
370877,2,10,3,7,12,0
123664,3,7,22,-15,4,1
173689,4,20,28,-8,10,1
341779,1,0,3,-3,16,0
348220,2,6,17,-11,1,1
61330,4,31,28,3,11,1
23543,4,17,17,0,11,1
49784,2,7,7,0,6,0
107007,1,7,0,7,15,1
4986,4,24,17,7,3,0
55755,1,0,0,0,9,0
53924,3,14,13,1,8,1
54566,4,27,18,9,8,1
239570,2,13,3,10,4,0
323345,2,7,0,7,7,1
86999,3,14,6,8,5,0
215438,1,7,3,4,11,1
128663,3,6,17,-11,7,1
258844,2,7,7,0,13,1
8609,2,7,10,-3,4,0
363007,4,33,26,7,8,1
131800,1,7,0,7,8,0
366596,4,26,14,12,10,0
220880,4,13,38,-25,14,1
283002,3,14,3,11,6,1
177912,4,21,23,-2,12,1
257952,2,0,7,-7,13,1
139554,2,6,7,-1,12,1
43639,2,7,3,4,3,1
215439,1,7,3,4,11,1
257407,4,20,14,6,13,1
381519,2,14,0,14,17,0
364404,2,35,7,28,9,0
303130,3,7,21,-14,16,1
391542,2,10,21,-11,4,1
295864,2,7,14,-7,12,0
386906,1,7,7,0,2,0
143977,3,7,10,-3,14,0
48882,3,9,0,9,5,1
310361,4,29,0,29,2,0
83212,2,3,7,-4,4,1
105778,1,0,0,0,14,0
176833,3,10,10,0,11,0
194304,3,10,3,7,2,1
338999,3,20,3,17,15,1
314904,2,0,0,0,4,1
251818,2,0,7,-7,10,1
101877,2,3,10,-7,12,1
297099,3,24,0,24,13,0
340675,3,16,13,3,15,0
203644,3,7,13,-6,6,0
315546,3,7,14,-7,4,1
307252,4,10,13,-3,17,1
239167,3,20,16,4,4,1
215975,4,20,35,-15,11,0
16668,3,14,27,-13,8,0
316068,1,3,3,0,4,1
42703,4,7,13,-6,3,1
127021,3,24,20,4,6,0
387066,2,7,14,-7,2,0
141765,4,33,28,5,13,0
57070,4,7,26,-19,9,0
240954,3,21,9,12,5,0
76299,1,3,3,0,1,1
182443,2,7,0,7,14,0
409494,1,0,0,0,12,1
107595,2,6,7,-1,15,1
136714,2,6,10,-4,11,1
237276,4,26,0,26,3,0
281793,2,9,0,9,6,1
392089,4,18,40,-22,4,1
332093,4,20,9,11,12,0
358046,4,31,28,3,6,0
228850,3,6,17,-11,17,1
325716,1,0,0,0,9,0
229899,4,20,14,6,17,1
214745,2,3,10,-7,11,1
69217,1,0,0,0,15,0
304496,3,3,14,-11,16,1
213171,1,3,7,-4,10,1
111718,4,37,16,21,16,0
228780,1,3,7,-4,17,0
249028,1,14,3,11,9,0
225014,1,0,0,0,15,0
291355,1,0,0,0,10,1
210483,4,9,14,-5,9,1
364596,4,21,34,-13,9,0
188171,4,17,10,7,16,0
305091,2,21,10,11,16,1
248559,1,0,0,0,9,0
43692,3,14,10,4,3,1
133368,4,21,9,12,9,1
289481,3,6,7,-1,10,1
185882,3,9,16,-7,15,1
325547,1,0,0,0,9,1
6867,4,10,31,-21,3,0
345660,1,7,0,7,17,0
67107,4,16,17,-1,14,1
231714,1,0,7,-7,1,1
251404,3,30,14,16,10,1
342970,4,44,31,13,16,0
338464,1,7,0,7,14,0
393826,2,7,17,-10,5,1
3665,4,20,28,-8,2,0
230013,3,3,6,-3,17,0
349271,2,7,21,-14,2,1
144145,4,23,13,10,14,1
268791,3,31,10,21,17,1
86411,2,20,7,13,5,0
175984,2,14,0,14,11,0
80487,2,5,3,2,3,0
229160,4,19,7,12,17,0
83329,1,0,7,-7,4,1
55849,3,7,14,-7,9,1
348831,2,3,14,-11,2,1
61411,3,13,3,10,11,1
129026,1,0,0,0,7,0
235480,1,0,0,0,3,0
400288,4,24,9,15,8,1
29175,4,3,19,-16,14,0
223893,4,30,6,24,15,0
364161,4,31,3,28,9,0
315355,2,10,10,0,4,1
113958,4,20,13,7,17,1
119978,3,16,24,-8,3,1
120882,3,14,24,-10,3,1
310410,2,7,0,7,2,1
213085,3,17,3,14,10,1
186906,2,7,3,4,15,0
346903,4,23,16,7,1,1
205199,3,14,13,1,6,1
4235,3,10,6,4,2,1
244100,4,20,34,-14,6,1
364313,4,3,32,-29,9,1
103238,3,3,7,-4,13,0
723,4,6,24,-18,1,0
327255,2,9,10,-1,9,1
73040,2,7,10,-3,16,0
138714,4,28,35,-7,12,0
333935,2,0,7,-7,12,1
270900,4,19,13,6,1,0
379461,3,16,0,16,16,0
386084,3,14,3,11,1,0
94532,3,3,10,-7,9,0
136875,2,0,7,-7,11,0
38303,1,0,0,0,1,0
253956,1,0,0,0,11,0
70203,4,30,22,8,15,0
81529,2,0,20,-20,3,0
264564,3,10,17,-7,16,0
223552,3,10,13,-3,15,1
217404,1,0,0,0,12,1
390105,3,16,14,2,3,1
366329,4,28,16,12,10,0
74515,2,0,3,-3,17,0
38211,2,3,13,-10,1,0
377663,2,16,7,9,15,0
304965,3,10,14,-4,16,1
270683,2,3,3,0,1,1
204085,2,3,7,-4,6,0
405403,2,7,10,-3,10,1
371919,4,27,17,10,12,1
397052,4,21,9,12,6,1
128810,3,13,13,0,7,0
124952,1,0,3,-3,5,1
50267,2,10,14,-4,6,1
359374,4,10,20,-10,6,1
107888,2,0,3,-3,15,0
226867,2,0,7,-7,16,0
267040,1,0,0,0,17,1
75812,4,42,32,10,1,0
97654,2,3,3,0,11,0
234606,2,10,10,0,2,1
366215,1,0,0,0,10,0
407673,1,0,0,0,11,0
383795,2,3,7,-4,1,0
56867,2,7,0,7,9,0
120910,4,21,31,-10,3,1
234362,3,17,10,7,2,0
99637,3,16,3,13,11,1
222468,2,6,7,-1,14,0
6336,1,0,0,0,3,0
97144,4,34,13,21,10,1
203187,3,7,17,-10,5,1
188884,2,10,10,0,16,0
233478,4,23,10,13,2,0
289579,2,7,13,-6,10,0
384437,2,21,0,21,1,0
320905,4,3,14,-11,6,0
20468,2,0,0,0,10,1
337437,1,0,6,-6,14,1
414619,4,28,12,16,14,0
153536,2,5,7,-2,1,0
238631,2,6,0,6,4,0
379845,1,7,0,7,16,1
172235,3,14,13,1,9,0
52668,2,3,10,-7,7,1
309978,2,3,3,0,2,0
158503,2,10,10,0,3,0
4140,4,26,31,-5,2,1
247174,4,27,6,21,8,0
96376,4,9,37,-28,10,1
407407,2,7,7,0,11,1
209752,4,16,6,10,8,0
110875,1,7,0,7,16,0
98008,4,17,10,7,11,0
150669,1,0,0,0,17,0
99304,2,13,0,13,11,0
87756,4,6,20,-14,6,0
95733,4,13,9,4,10,1
180051,3,21,20,1,13,1
113208,4,41,22,19,17,1
336794,4,10,17,-7,14,1
258968,2,0,13,-13,13,0
152480,2,10,7,3,17,1
33151,4,10,42,-32,16,0
258680,2,0,7,-7,13,0
340233,4,29,31,-2,15,1
40941,4,16,20,-4,2,1
354312,2,14,3,11,4,1
21391,1,6,7,-1,11,0
308316,4,16,26,-10,1,1
364140,3,31,3,28,9,1
62095,1,7,7,0,12,1
210355,4,22,17,5,9,1
374635,4,23,27,-4,14,0
347715,1,0,0,0,1,0
232278,1,0,0,0,1,1
14365,4,9,17,-8,7,0
397081,4,24,16,8,6,0
229685,2,10,7,3,17,0
195867,4,27,21,6,2,0
406373,2,10,7,3,11,1
281592,1,7,0,7,6,1
294694,3,6,14,-8,12,0
250824,3,3,9,-6,10,0
250862,4,9,12,-3,10,1
390587,4,17,27,-10,3,1
309684,2,3,3,0,1,0
379235,4,19,16,3,16,0
366347,1,0,0,0,10,1
19151,2,14,10,4,10,1
104106,2,17,13,4,13,0
183,1,3,3,0,1,0
253829,1,7,7,0,11,1
124791,1,0,0,0,5,1
34284,3,20,9,11,16,0
245890,3,6,36,-30,7,0
81263,3,10,7,3,3,1
269234,3,3,6,-3,17,0
136267,2,15,7,8,11,0
178344,3,14,17,-3,12,1
355696,1,7,3,4,5,1
353941,4,23,31,-8,4,1
33040,1,0,0,0,16,1
390468,4,27,33,-6,3,1
284810,4,26,20,6,7,1
233859,2,7,3,4,2,1
157650,1,0,0,0,2,0
176174,2,14,14,0,11,0
239101,2,10,10,0,4,0
151323,2,7,14,-7,17,1
283451,3,20,14,6,7,1
162667,3,16,17,-1,5,1
334252,2,6,7,-1,13,1
63634,3,13,33,-20,12,0
268893,2,6,24,-18,17,0
54542,4,21,10,11,8,0
43536,3,10,3,7,3,0
394551,1,0,0,0,5,1
207275,2,0,7,-7,7,0
258280,2,20,12,8,13,1
310485,3,20,9,11,2,0
124901,4,9,13,-4,5,0
6557,3,10,6,4,3,0
261508,2,6,0,6,14,1
400314,1,0,0,0,8,1
322830,4,3,40,-37,7,1
95613,4,12,13,-1,10,1
193129,4,13,6,7,1,1
116966,4,35,13,22,2,1
349943,4,10,12,-2,2,1
87765,4,6,20,-14,6,1
386902,1,7,7,0,2,0
120301,4,24,13,11,3,0
213812,2,35,0,35,10,0
178877,4,41,21,20,12,0
283485,4,23,14,9,7,0
147652,1,3,0,3,15,1
370398,1,7,0,7,12,1
239710,2,7,10,-3,4,1
14235,1,0,0,0,7,1
111460,1,0,0,0,16,1
319782,2,14,7,7,6,0
363948,2,0,6,-6,8,0
13565,2,3,0,3,7,0
419957,1,0,0,0,17,0
131202,2,7,10,-3,8,1
361229,3,7,17,-10,7,0
42775,2,6,13,-7,3,0
393653,1,0,0,0,5,1
229000,3,14,16,-2,17,1
321650,4,20,20,0,7,1
126688,2,7,13,-6,6,1
76904,2,0,13,-13,1,1
10264,4,13,10,3,5,0
71982,1,0,3,-3,16,0
69208,5,20,20,0,15,0
43893,1,0,0,0,3,0
270602,4,20,14,6,1,1
20547,4,17,0,17,10,0
265949,3,0,30,-30,16,0
289433,2,0,0,0,10,0
388538,4,3,23,-20,2,1
95832,3,6,10,-4,10,0
281576,1,0,0,0,6,1
280543,2,7,3,4,5,1
226416,2,0,7,-7,16,0
46663,4,10,3,7,4,0
63550,1,7,0,7,12,1
331684,1,0,6,-6,12,1
252768,2,3,6,-3,11,1
304631,2,14,7,7,16,1
330917,4,31,31,0,11,0
66421,1,0,0,0,14,1
186408,1,3,0,3,15,0
352241,2,3,3,0,3,0
381502,2,14,0,14,17,0
320567,2,24,0,24,6,0
52166,1,0,0,0,7,0
98138,3,21,10,11,11,1
259870,2,7,7,0,14,1
284535,4,24,15,9,7,1
166939,4,16,6,10,6,0
47055,3,17,7,10,5,0
201056,3,41,0,41,5,0
48888,3,12,0,12,5,0
200855,2,13,0,13,4,1
195769,2,3,7,-4,2,1
199622,1,0,0,0,4,0
393849,2,10,17,-7,5,1
155571,3,23,3,20,2,0
186395,1,0,0,0,15,0
345400,2,0,10,-10,17,1
263983,4,23,7,16,15,1
263551,4,20,29,-9,15,0
52335,2,3,3,0,7,0
322704,5,9,9,0,7,0
62813,4,20,0,20,12,0
55997,3,10,20,-10,9,0
170719,3,21,6,15,8,1
375098,1,0,0,0,14,1
290020,2,7,0,7,10,1
330240,3,17,14,3,11,0
93982,1,0,7,-7,9,0
175410,3,17,6,11,11,0
145433,2,9,14,-5,14,0
217288,2,0,7,-7,12,1
179072,2,3,6,-3,12,1
22643,3,23,10,13,11,1
60389,3,13,7,6,11,0
86556,2,23,3,20,5,0
339590,3,17,14,3,15,0
71930,4,15,13,2,16,1
223118,3,34,17,17,14,0
180331,3,12,7,5,13,0
221537,1,13,12,1,14,1
239005,3,21,15,6,4,0
84978,1,9,7,2,4,1
245506,1,7,0,7,7,1
334553,3,21,17,4,13,1
323321,1,0,0,0,7,0
90149,2,3,0,3,7,1
417479,2,10,21,-11,16,1
79061,4,13,20,-7,2,0
24381,2,10,0,10,12,1
108758,1,0,0,0,15,0
102798,3,10,3,7,13,0
240798,3,17,10,7,5,0
262097,1,14,3,11,15,1
41338,2,14,9,5,2,1
362405,4,30,20,10,8,1
203308,2,0,24,-24,6,1
204439,3,7,17,-10,6,1
284048,3,10,3,7,7,1
192779,2,0,12,-12,1,0
214589,2,3,3,0,11,0
405288,3,14,7,7,10,1
258841,2,7,7,0,13,0
334803,1,7,0,7,13,0
34699,2,3,3,0,16,1
237510,2,17,7,10,3,1
98384,1,0,7,-7,11,0
298739,4,22,27,-5,14,1
101580,3,13,31,-18,12,0
149683,2,20,0,20,16,0
231823,4,33,20,13,1,0
28747,4,10,16,-6,14,0
263357,4,24,10,14,15,1
344481,1,0,0,0,17,1
170225,1,0,3,-3,8,0
243253,2,7,7,0,6,0
319876,4,23,10,13,6,0
352074,2,3,10,-7,3,1
121975,2,10,7,3,4,1
308682,2,7,6,1,1,1
75134,3,7,6,1,17,1
396228,2,0,3,-3,6,0
336029,4,16,25,-9,13,1
16045,1,13,0,13,8,1
6378,2,0,13,-13,3,0
6838,3,10,21,-11,3,1
221543,2,20,12,8,14,0
315537,3,7,14,-7,4,0
260187,2,7,0,7,14,1
391612,4,10,24,-14,4,1
192408,1,0,14,-14,1,1
144741,3,3,7,-4,14,1
40570,2,10,7,3,2,1
162490,2,14,3,11,4,0
386416,4,23,17,6,2,0
334192,1,0,0,0,13,0
28640,1,0,0,0,14,0
217160,3,3,16,-13,12,0
104877,2,0,3,-3,14,1
108153,4,20,42,-22,15,1
159663,4,27,20,7,3,0
227351,4,20,37,-17,16,1
66828,4,13,6,7,14,1
395341,2,14,3,11,5,0
273601,2,10,3,7,2,0
156221,4,16,17,-1,2,1
411981,4,20,17,3,13,0
197981,2,0,17,-17,3,1
379705,2,3,0,3,16,1
141047,3,7,10,-3,13,1
334587,4,27,24,3,13,1
232955,2,10,3,7,2,1
187928,1,0,7,-7,16,1
152474,2,10,7,3,17,1
310715,1,3,0,3,2,0
274403,3,3,17,-14,3,0
38338,2,7,6,1,1,0
13669,4,25,17,8,7,0
268971,4,6,36,-30,17,0
347118,2,10,3,7,1,1
125122,2,7,7,0,5,1
283062,1,0,0,0,7,1
146565,3,14,24,-10,15,0
233407,2,14,0,14,2,0
341767,1,0,0,0,16,0
60872,4,17,23,-6,11,0
68978,2,21,7,14,15,0
394792,3,24,0,24,5,0
256627,4,21,7,14,12,1
55141,4,26,17,9,8,1
246639,2,24,3,21,8,0
58656,5,20,20,0,10,1
59458,2,3,10,-7,11,1
179176,4,19,23,-4,12,1
320630,4,38,18,20,6,0
151750,2,7,6,1,17,0
242569,1,3,0,3,6,0
282560,4,17,24,-7,6,0
254227,1,0,0,0,11,1
58721,2,10,17,-7,10,0
31858,1,0,0,0,15,1
253625,4,9,17,-8,11,1
259203,4,14,32,-18,13,0
310552,1,0,6,-6,2,1
33048,1,3,0,3,16,0
299096,2,3,3,0,14,1
268510,4,23,9,14,17,0
101810,5,13,13,0,12,0
261471,1,3,0,3,14,0
40101,1,0,0,0,2,1
196376,2,10,0,10,2,0
92410,2,17,7,10,8,0
216186,2,14,3,11,12,0
293883,1,0,7,-7,12,1
232207,3,9,12,-3,1,1
47098,4,31,10,21,5,0
296304,2,3,10,-7,13,0
324108,2,0,7,-7,8,1
286011,1,0,0,0,8,1
400383,3,24,10,14,8,0
41930,3,21,6,15,2,0
234593,1,10,3,7,2,1
332154,2,0,10,-10,12,0
114699,4,6,10,-4,1,1
399951,3,6,13,-7,8,1
313630,4,25,30,-5,3,0
179504,1,0,13,-13,12,0
